Version 4 of Naughty Nurse by Fuxi begins here.
[ Originally Authored by Stripes]
[ Version 2.4 - Neuter player loss added ]
[ Version 3.0 - Rework by Leob ]
[ Version 4.0 - Expansion and Rewriting by Fuxi. Coding done by Prometheus.]

"Adds a Naughty Nurse Vixen creature to Flexible Survival's Wandering Monsters table"

Section 1 - Creature Responses

vixgender is a number that varies.

Section 1.1 - Loss Scenes

to say VixenFemNurseMaleRidingScene:
	say "     The vixen nurse pushes you down as you stop fighting. 'You'll hurt yourself by struggling so much, my dear. I'm only trying to help you, you know,' she tuts disappointedly above you, seeming genuinely concerned for you despite the beatdown that she's just delivered. Kneeling beside you, the sexy nurse removes any clothing you have on, leaving you bare before her. The cold breeze of the hospital makes you shiver as you gaze warily at the sly fox beside you. 'I need to complete a thorough inspection of your body to make sure you're healthy,' she says, but if the hungry gleam in her eyes is any indication, she's looking to do much more than a run-of-the-mill checkup! Leaning over you, the vixen starts with your [if Breast Size of Player < 0]pecs; squeezing[else]breasts; groping[end if], poking, and massaging your chest before moving onto your nipples teasing them with her pointy claws. Despite your initial wariness you can't help but feel a little excited at her touch and the excellent view you have of her four ample breasts certainly isn't helping your situation. Satisfied with her inspection, she moves on to the next part of your body with that and the next, following the same pattern as the first, gradually raising your lust.";
	say "     By the end of the rather sensual checkup, you're fully aroused and settled, your cock standing proud and begging for attention from the buxom fox, who notices your arousal and gives a fake gasp of surprise. 'Oh, my, look at this swelling! You must be so uncomfortable, my poor baby. It's okay. I'll take care of you just sit back and relax.' gently grasping your turgid shaft, she slowly strokes up and down, using the pre she milks from you to lube her movements. Her paw pads feel amazing gliding down your length, soft and supple like a pair of lips or tits squeezing your dick. Her other hand carefully squeezes and consoles your balls encouraging them to work up a thick load for her and to produce more pre to slicken up her movements. The vixen smirks playfully at you and continues to masturbate you, pushing you right to the edge of orgasm before slowing down, leaving you almost painfully blue-balled with your dick pulsing in the open air and demanding further attention. You can't help but whine pathetically as you weakly hump into her grasp, still too tired from your tussle with the grey fox to take charge in any capacity. Giggling at your futile attempts to increase your pleasure, she continues her edging taking you up again and again to the edge of euphoric bliss before letting you drop into frustration. By the end of her teasing, you're a mess huffing and groaning with frustration.";
	WaitLineBreak;
	say "     'Your symptoms seem to have worsened. It looks like we'll have to move onto stronger treatment methods.' Feigning shock again, the sultry fox completely stops her stroking, leaving you lacking miserably in pleasure, but your attention is quickly drawn away from your cock and onto her body, as the vixen begins to strip, slowly popping off the buttons of her ill-fitting uniform, exposing her swaying tits for your pleasure the view alone is nearly enough to make your needy prick erupt. It only gets better as she reveals herself completely, showing off her supermodel-esque figure. Climbing over you, the hypersexual nurse grabs your cock with an adept paw and positions you at her sex. She takes one last moment to tease you rubbing you against her dripping sex for a moment and delighting in your desperate whimpers before finally sheathing all of you into her warm wet pussy. It's a miracle you don't bust right then and there. The feeling of the vixen's inner walls tugging and squeezing at your dick is heavenly after being teased for so long, and you feel your eyes roll into the back of your head from the nigh indescribable pleasure you feel.";
	say "     The naughty nurse riding you doesn't give you a moment to rest either; she's starting intense and is continuing with that same energy riding you like a vixen in heat and moaning and yipping like a pornstar. She mashes her fat bubbly ass down on your balls, intent on riding you for all you're worth and draining you of every drop of cum in your balls. You grasp desperately at her running your hand along her plump thighs and groping her butt, feeling it ripple each time she slams that glorious ass down on you. You're hypnotized by her jiggly and bouncing breasts for a moment. The only thing you can focus on is how they shake and jump with the fox's every movement while you drool and pant dumbly, trying to hold back orgasm for as long as you can. She's seemingly just as lost in the sex as you are and sodden, her every movement met with lurid squelch as she bounces atop you. Dealing with this sensory overload and the past edging, it's little surprise you don't last very long howling loudly in pleasure as you blast your seed deep into the bosomy nurse. Your vixen, however, keeps on riding you for far longer, milking another two orgasms before she finally reaches her own, her snug cunny clenching vice-tight around you while her femcum drips down your balls and soaks your crotch. Satisfied at last, the nurse slides off your tired dick and lets your slump into unconsciousness. The last thing you remember is a soft kiss pressed to your cheek.";
	WaitLineBreak;
	say "     When you wake up, you're still in the same spot the vixen enjoyed you in and stink of sex but are fully clothed again and covered by a blanket. Despite her new debauched proclivities, the foxy nurse has retained her desire to ensure her patients are safe and healthy.";
	CreatureSexAftermath "Vixen Nurse" receives "PussyFuck" from "Player";

to say VixenFemNurseFemaleNursingScene:
	say "     The vixen nurse pushes you down as you stop fighting. 'You'll hurt yourself by struggling so much, my dear. I'm only trying to help you, you know,' she tuts disappointedly above you, seeming genuinely concerned for you despite the beatdown she's just delivered. Kneeling beside you, the sexy nurse removes any clothing you have on, leaving you bare before her. The cold breeze of the hospital makes you shiver as you gaze warily at the sly fox beside you. 'I need to complete a thorough inspection of your body to make sure you're healthy,' she says, but if the hungry gleam in her eyes is any indication, she's looking to do much more than a run-of-the-mill checkup! Leaning over you, the vixen starts with your [if Breast Size of Player < 0]pecs; squeezing[else]breasts; groping[end if], poking, and massaging at your chest, then teasing your nipples with her pointy claws. Despite your initial wariness you can't help but feel a little excited at her touch and the excellent view you have of her four ample breasts certainly isn't helping your situation. Satisfied with her inspection, she moves on to the next part of your body with that and the next, following the same pattern as the first, gradually raising your lust.";
	say "     Once she's gotten her fill of your body, the perverted fox plasters a reassuring grin on her face. 'I've completed my inspection, and I think I know exactly what you need!' the fox quickly starts to strip, removing her uniform and revealing her perky tits and supermodel-esque figure. 'Open up, baby, it's time to take your medicine,' she purrs, and you briefly consider resisting, but before you can muster up a plan to escape or attack, the cheery vixen presses you into her bountiful boobies. They're incredibly soft and squishy, and under normal circumstances, you'd be overjoyed to have a sexy nurse like this shove your face into her rack. Still, given that she's just beaten you black and blue a few minutes ago, you're more than a little suspicious. Nonetheless, you can't deny there's also something relaxing about your current situation; being hugged into her criminally soft boobs and fur feels relaxing after all you've been through. When was the last time somebody held you so gently, so lovingly? With the caring nurse whispering calming words and telling you she wants to help you, you can quickly feel yourself giving in to her influence, so when she presses you to one of her perky nips, you don't question it too much.";
	WaitLineBreak;
	say "     The first thing you notice is the smell of milk, sweet delicious milk. You feel your mouth watering in anticipation. At the same time, you grow bolder in your appreciation, your hand straying upwards to fondle the voluptuous vixen's chest, and of course, it feels just as amazingly soft and squishy to your hands as it does your face. Pressed against her nipples and remembering the naughty nurse's previous command, you open your mouth and let one of her tits enter your mouth and find yourself groaning in delight at the taste of her cream; it has an oddly medicinal taste, slightly minty but is also extraordinarily rich and sweet you can feel your aches and bruises from you battle fading with each eager gulp of milk you take as you drool against the sexy fox's boobs loudly licking and slurping while groping her breasts roughly in hopes of squeezing out just a bit more for you to drink. The buxom vixen seems to enjoy feeding you as much as you enjoy eating from her lustful gasps, moans, and praise pouring out from her as your drink your only interrupted from your feasting when she switches you to another of her full breast to give you more of the dairy you crave. The nurse's milk seems to have another after-effect besides its soothing effect on your wounds as you rapidly feel your arousal rising, your needy pussy drooling down your legs and onto the nurse.";
	say "     'Oh my, you need some help with that, sugar? Don't worry, just let me take care of you,' the vixen murrs happily into your ear and brings two of her fingers to your sex. Immediately the fox's experience is clear as she begins, starting with your clit. She rubs your love button gently against her soft paw pads and muffles your sounds of pleasure with her plush. Everything feels abnormally intense, every movement of her fingers sending shockwaves of pleasure through you; if you'd have to guess with your muddled mind, you'd assume it's another side effect of the milk you're gulping down seemingly by the gallon full. Moving on from your clit your caretaker takes a moment to tease you slowly, running her fingers along your nether lips and lubing her digits with your dripping excitement drawing longing whines and whimpers from you. Thankfully the sly fox decided to show mercy, spreading your folds and pushing two fingers into your sweltering depths. She seems to know exactly what to do to drive you wild, finding every single sensitive spot you have and setting you bucking desperately into her paws, wet schlicking sounds echoing across the hospital halls while your cunny clenches hungrily around her and you drink just as thirstily from her breasts. Hopped up on aphrodisiac milk and expertly pleasured by the lewd nurse, it doesn't take too long to climax, soaking yourself and the nurse in your femcum, but of course, the debauched fox isn't satisfied until she's completely drained you. So you endure two more earth-shifting climaxes before you finally pass out. The last thing you remember is a soft kiss on your cheek.";
	WaitLineBreak;
	say "     When you wake up, you're still in the same spot the vixen enjoyed you in and stink of sex but are fully clothed again and covered by a blanket. Despite her new amorous proclivities, the foxy nurse has retained her desire to ensure her patients are safe and healthy.";

to say VixenFemNurseMaleNursingScene:
	say "     The vixen nurse pushes you down as you stop fighting. 'You'll hurt yourself by struggling so much, my dear. I'm only trying to help you, you know,' she tuts disappointedly above you, seeming genuinely concerned for you despite the beatdown she's just delivered. Kneeling beside you, the sexy nurse removes any clothing you have on, leaving you bare before her. The cold breeze of the hospital makes you shiver as you gaze warily at the sly fox beside you. 'I need to complete a thorough inspection of your body to make sure you're healthy,' she says, but if the hungry gleam in her eyes is any indication, she's looking to do much more than a run-of-the-mill checkup! Leaning over you, the vixen starts with your [if Breast Size of Player < 0]pecs; squeezing[else]breasts; groping[end if], poking, and massaging at your chest, then teasing your nipples with her pointy claws. Despite your initial wariness you can't help but feel a little excited at her touch and the excellent view you have of her four ample breasts certainly isn't helping your situation. Satisfied with her inspection, she moves on to the next part of your body with that and the next, following the same pattern as the first, gradually raising your lust.";
	say "     Once she's gotten her fill of your body, the perverted fox plasters a reassuring grin on her face. 'I've completed my inspection, and I think I know exactly what you need!' the fox quickly starts to strip, removing her uniform and revealing her perky tits and supermodel-esque figure. 'Open up, baby, it's time to take your medicine,' she purrs, and you briefly consider resisting, but before you can muster up a plan to escape or attack, the cheery vixen presses you into her bountiful boobies. They're incredibly soft and squishy, and under normal circumstances, you'd probably be overjoyed to have a sexy nurse like this shove your face into her rack. Still, given that she's just beaten you black and blue a few minutes ago, you're more than a little suspicious. Nonetheless, you can't deny there's also something relaxing about your current situation; being hugged into her criminally soft boobs and fur feels relaxing after all you've been through. When was the last time somebody held you so gently, so lovingly? With the caring nurse whispering calming words and telling you she wants to help you, you can quickly feel yourself giving in to her influence, so when she presses you to one of her perky nips, you don't question it too much.";
	WaitLineBreak;
	say "     The first thing you notice is the smell of milk, sweet delicious milk. You feel your mouth watering in anticipation. At the same time, you grow bolder in your appreciation, your hand straying upwards to caress the voluptuous vixen's chest, and of course, it feels just as amazingly soft and squishy to your hands as it does your face. Pressed against her nipples and remembering the naughty nurse's previous command, you open your mouth and let one of her tits enter your mouth and find yourself groaning in delight at the taste of her cream; it has an oddly medicinal taste, slightly minty but is also extraordinarily rich and sweet you can feel your aches and bruises from you battle fading with each eager gulp of milk you take as you drool against the sexy fox's boobs loudly licking and slurping while groping her breasts roughly in hopes of squeezing out just a bit more for you to drink. The buxom vixen seems to enjoy feeding you as much as you enjoy eating from her lustful gasps, moans, and praise pouring out from her as your drink your only interrupted from your feasting when she switches you to another of her full breast to give you more of her delicious dairy. The nurse's milk seems to have another after-effect besides its soothing effect on your wounds as you rapidly feel your arousal rising, your needy dick drooling precum all down your shaft and onto your balls, splattering onto your thighs and on the nurse,";
	say "     'Oh my, you need some help with that, sugar? Don't worry, just let me take care of you,' the vixen murrs happily into your ear and wraps her hand around your shaft. Immediately the fox's experience is clear as she begins starting with your cocktip polishing the head of your prick with her plush paw pads and spreading your pre-all over you with slow strokes of her hand with her other paw she fondled and gropes your nuts encouraging them to work up more lube and your special kind of milk. Everything feels abnormally intense. Every movement of her hands sends shockwaves of pleasure through you; if you'd have to guess with your muddled mind, you'd assume it's another side effect of the milk you're gulping down seemingly by the gallon full. Moving on from her slower pace, the sexy nurse takes a firm grip on your [Cock of Player] meat and speeds up her stroking. She seems to know exactly how to handle you finding every sensitive spot you have and setting you humping desperately into her paws while you drink thirstily from her breasts, soft wet noises echoing through the hospital halls as her hand glides around you. Hopped up on aphrodisiac milk and expertly pleasured by the lewd nurse, it doesn't take too long to climax, shooting long sticky ropes of your seed onto yourself and the vixen, giving you an expert handjob, but of course, the debauched fox isn't satisfied until she's completely drained you. So you endure two more earth-shifting climaxes before you finally pass out. The last thing you remember is the beautiful vulpine licking your cum from her hands.";
	WaitLineBreak;
	say "     When you wake up, you're still in the same spot the vixen enjoyed you in and stink of sex but are fully clothed again and covered by a blanket. Despite her new amorous proclivities, the foxy nurse has retained her desire to ensure her patients are safe and healthy.";

to say VixenFemNurseFacesitting:
	say "     The vixen nurse pushes you down as you stop fighting. 'You'll hurt yourself by struggling so much, my dear. I'm only trying to help you, you know,' she tuts disappointedly above you, seeming genuinely concerned for you despite the beatdown she's just delivered. Kneeling beside you, the sexy nurse removes any clothing you have on, leaving you bare before her. The cold breeze of the hospital makes you shiver as you gaze warily at the sly fox beside you. 'I need to complete a thorough inspection of your body to make sure you're healthy,' she says, but if the hungry gleam in her eyes is any indication, she's looking to do much more than a run-of-the-mill checkup! Leaning over you, the vixen starts with your [if Breast Size of Player < 0]pecs; squeezing[else]breasts; groping[end if], poking, and massaging at your chest, then teasing your nipples with her pointy claws. Despite your initial wariness you can't help but feel a little excited at her touch and the excellent view you have of her four ample breasts certainly isn't helping your situation. Satisfied with her inspection, she moves on to the next part of your body with that and the next, following the same pattern as the first, gradually raising your lust.";
	say "     Once she's gotten her fill of your body, the vixen nurse stands up again and glances down at you, mildly upset. 'We at the hospital work so hard to ensure our patient's safety. It's grueling work. Don't you think you should apologize for the earlier ruckus you caused?' Before you can say a thing, she continued without you. 'Of course not a sweet [boygirl], like you would never just leave without apologizing, and I'm sure you understand the proper appreciation we medical staff deserve. Lucky for you, I have the perfect way for you to show your thanks. Just stand still' As she does this, she begins to strip slowly, popping the buttons off her uniform and revealing her full breasts and supermodel-esque body twirling around. The vixen is clearly showing off, and you're very interested in the goods she's displaying particularly her large bubbly ass. Noticing your attention, the slutty nurse giggles slightly. 'Oh, do you like what you see? That's good because you're about to be very closely acquainted with all of it' Before you can process anything she's saying, she's striding over to you and straddling your face silencing any of your incoming protests quickly by sitting right down on top of you.";
	WaitLineBreak;
	say "     Your first instinct is to, of course, push her off you, but it seems this nurse is packing a lot more muscle and weight than you might guess at a glance, and you're still tired from the fighting. Redoubling your efforts, you grab at her but quickly find yourself distracted. Your push transformed into a grope of the plush posterior trapping you. It's delightfully soft and squishy, and your fingers sink easily into the voluptuous vulpine's fur and fat. The second thing distracting you is her hot, dripping pussy spattering her juices all across your face, and despite yourself, you can't help but lick at your lips and catch a taste of her and its surprisingly alluring and sweet traits it shares with her smell so wonderful and packed with pheromones it's almost making you lightheaded. She smells and tastes like a vixen in heat, rapidly draining your will to fight back. This, combined with the loveliness of her substantial rear, it's not long before you give in completely and start hungrily eating out the naughty nurse, no longer pushing her away but pulling her towards you while squeezing her ass just as greedily as you devour her.";
	say "     'Yes! YES! Drink up, and you'll feel better in no time!' the curvaceous vixen pants grinding down on your tongue and smearing her juices across your lips in an unnecessary attempt to force you deeper into her. Tongue plunging far into her delivering cunny, you enthusiastically lap up the fox's nectar. There's no planning or thought behind your motions. It's simply animalistic vigor that drives you, and it seems to do wonders to drive the luscious vulpine wild with desire. It's a messy affair her juices run down your face mixed with your spittle, and you mourn every drop wasted by your sloppy pleasuring. You can feel the beautiful nurse trembling, pressing down harder on you to milk ever more pleasure out of your skilled tongue. You can feel her passage clenching around your tongue, telling you her orgasm is close, and it only invigorates you; you're desperate to taste even more of her to have your efforts rewarded with a gush of her sweet honey. With a loud squeal, your prize comes, and the fuzzy nurse orgasms, an explosion of her femcum soaking your face and tastebuds while also inundating you in her musk. Not long after, you pass with a dazed grin on your face. Being trapped under the fat fox's rump doesn't give you much air to breathe, not that you care when you've got her sweet snatch to take care of. The last thing you remember is the beautiful vulpine frenching you and stealing the last of your breath away.";
	WaitLineBreak;
	say "     When you wake up, you're still in the same spot the vixen enjoyed you in, and you stink of her pussy but are fully clothed again and covered by a blanket. Despite her new amorous proclivities, the foxy nurse has retained her desire to ensure her patients are safe and healthy.";

to say VixenHermNursePussyFuck:
	say "     The vixen nurse pushes you down as you stop fighting. 'You'll hurt yourself by struggling so much, my dear. I'm only trying to help you, you know,' she tuts disappointedly above you, seeming genuinely concerned for you despite the beatdown she's just delivered. Kneeling beside you, the sexy nurse removes any clothing you have on, leaving you bare before her. The cold breeze of the hospital makes you shiver as you gaze warily at the sly fox beside you. 'I need to complete a thorough inspection of your body to make sure you're healthy,' she says, but if the hungry gleam in her eyes is any indication, she's looking to do much more than a run-of-the-mill checkup! Leaning over you, the vixen starts with your [if Breast Size of Player < 0]pecs; squeezing[else]breasts; groping[end if], poking, and massaging at your chest, then teasing your nipples with her pointy claws. Despite your initial wariness you can't help but feel a little excited at her touch and the excellent view you have of her four ample breasts certainly isn't helping your situation. Satisfied with her inspection, she moves on to the next part of your body with that and the next, following the same pattern as the first, gradually raising your lust.";
	say "     Eventually, the voluptuous vulpine reaches your hips and ass, gently kneading and messaging you until you're calm and pliant to her desires. Rising to her feet again, the sexy vixen reveals her rubbing hasn't only affected you sporting quite a respectable tent under her skirt. 'I think I need to conduct a deeper inspection of your body to ensure you're healthy. Now be a good [boygirl] and stay still,' she purrs happily and starts stripping off her shirt and skirt, revealing her four large breasts and pink canine shaft. With that out of the way, she starts to adjust to you, ignoring your weak protests and putting you face down and ass up, presenting your rump for her pleasure. Still tired from your tussle with the naughty nurse, there's nothing you can do nothing to stop her. 'Now we have to get you nice and slick, dear, to avoid any pain,'  the cheerful caretaker says calmly, sending a jolt through your body when you feel her cold, damp canine snout press against your cleft, followed soon after by her warm wet tongue slathering your hole in her saliva. Your resistance in response to her munching is short-lived. It's not long before you're whining and humping your bum against her face, desperately trying to get more pleasure from your attacker as you let out shakey moans. The nurse between your thighs seems just as enthused as you are. You can feel her huffing in your scent, groping your rear, and pushing her tongue in deep, trying her best to taste every bit of you. Occasionally, the beautiful canine strays from your pussy to get a taste of your asshole as well.";
	WaitLineBreak;
	say "     All good things must come to an end, however, and the beautiful canine eventually withdraws her tongue from you, leaving you both panting. 'Now for the next step, we'll have to get you stretched out a bit to ensure maximum comfort and pleasure!' the silver fox exclaims merrily, spreading your legs again to press a finger to your cunny and pushing in. She's just as good with her hands as her mouth, finding your g spot right away and rubbing gently, coaxing a steady stream of nectar from your needy pussy and ragged groans of pleasure. Eventually, the lewd nurse notices your rocking against her digit, trying to fuck yourself on her paw. She adds another while adjusting her pace, giving your opening the proper fingerfucking it craves. When the fingerbanging stops, it feels all too soon, and you can't help but let out a longing whimper for more; however, your disappointment is quickly replaced by excitement as you feel the vulgar vixen grinding her hard canine cock between your cheeks, her precum spurting across your back and bathing you in her musk 'It's time for your injection, darling' she groans huskily firmly gripping onto your hips.";
	say "     Without further preamble, the lustful lady dips her cock lower and enters you. There's no pain, only pleasure. Her previous work to prepare you ensures you do nothing but enjoy your pounding and enjoy you do the nurses pace is relentless. It seems her prep also had quite the effect on her, and now she's taking it all out on your poor little pussy fucking you a mess with each slap of her hips and balls against you forcing ecstatic wails from you as you beg your attacker to fuck you even harder a request she all too eager to fulfill. Stars fill your vision with each thrust, and when her knot enters the equation, you nearly black out from the sheer bliss you feel as it pops loudly in and out of your snatch, crushing your bitch button into submission so intense you can't even keep your posture crumbling under the vulpine’s hammering hips and forcing her to yank you back up so you can take her every stab of her bitch breaker. You're cumming before you know it, your soaking muff clenching tight around the victorious nurse's invading cock as you thrash in orgasm, your femcum soaking your thighs and the nurse's balls. The vixen manages to endure a bit longer than you but still cums soon after forcing her knot into you and flooding your womb with her cum. Shortly after you lose consciousness, the last thing you remember is snuggling with the sexy fox before everything goes black.";
	WaitLineBreak;
	say "     When you wake up, you're still in the same spot the vixen enjoyed you in, and you smell like a bitch in heat but are fully clothed again and covered by a blanket. Despite her new sordid cravings, the furry nurse has retained her desire to ensure her patients are safe and healthy.";
	CreatureSexAftermath "Player" receives "PussyFuck" from "Vixen Nurse";

to say VixenHermNurseAssFuck:
	say "     The vixen nurse pushes you down as you stop fighting. 'You'll hurt yourself by struggling so much, my dear. I'm only trying to help you, you know,' she tuts disappointedly above you, seeming genuinely concerned for you despite the beatdown she's just delivered. Kneeling beside you, the sexy nurse removes any clothing you have on, leaving you bare before her. The cold breeze of the hospital makes you shiver as you gaze warily at the sly fox beside you. 'I need to complete a thorough inspection of your body to make sure you're healthy,' she says, but if the hungry gleam in her eyes is any indication, she's looking to do much more than a run-of-the-mill checkup! Leaning over you, the vixen starts with your [if Breast Size of Player < 0]pecs; squeezing[else]breasts; groping[end if], poking, and massaging at your chest, then teasing your nipples with her pointy claws. Despite your initial wariness you can't help but feel a little excited at her touch and the excellent view you have of her four ample breasts certainly isn't helping your situation. Satisfied with her inspection, she moves on to the next part of your body with that and the next, following the same pattern as the first, gradually raising your lust.";
	say "     Eventually, the voluptuous vulpine reaches your hips and ass, gently kneading and messaging you until you're calm and pliant to her desires. Rising to her feet again, the sexy vixen reveals her rubbing hasn't only affected you sporting quite a respectable tent under her skirt. 'I think I need to conduct a deeper inspection of your body to ensure you're healthy. Now be a good [boygirl] and stay still,' she purrs happily and starts stripping off her shirt and skirt, revealing her four large breasts and pink canine shaft. With that out of the way, she starts to adjust to you, ignoring your weak protests and putting you face down and ass up, presenting your rump for her pleasure. Still tired from your tussle with the naughty nurse, there's nothing you can do nothing to stop her. 'Now we have to get you nice and slick, dear, to avoid any pain,'  the cheerful caretaker says calmly, sending a jolt through your body when you feel her cold, damp canine snout press against your butt, followed soon after by her warm wet tongue slathering your hole in her saliva. Your resistance in response to her rimming is short-lived. It's not long before you're whining and humping your bum against her face, desperately trying to get more pleasure from your attacker as you let out shakey moans. The nurse between your cheeks seems just as enthused as you are. You can feel her huffing in your scent, groping your rear, and pushing her tongue in deep, trying her best to taste every bit of you[if Player is male]. Occasionally, the beautiful canine strays from your anus to lick your perineum and balls[end if].";
	WaitLineBreak;
	say "     All good things must come to an end, however, and the beautiful canine eventually withdraws her tongue from you, leaving you both panting. 'Now for the next step, we'll have to get you stretched out a bit to ensure maximum comfort and pleasure!' the silver fox exclaims merrily, spreading your ass again to press a finger to your pucker and pushing in. She's just as good with her hands as her mouth, finding your prostate right away and massaging gently, coaxing a steady stream of pre from your needy cock and ragged groans of pleasure. Eventually, the lewd nurse notices your rocking against her digit, trying to fuck yourself on her paw. She adds another while adjusting her pace, giving your opening the proper fingerfucking it craves. When the fingerbanging stops, it feels all too soon, and you can't help but let out a longing whimper for more; however, your disappointment is quickly replaced by excitement as you feel the vulgar vixen grinding her hard canine cock between your cheeks, her precum spurting across your back and bathing you in her musk 'It's time for your injection, darling' she groans huskily firmly gripping onto your hips.";
	say "     Without further preamble, the lustful lady enters you. There's no pain, only pleasure. Her previous work to prepare you ensures you do nothing but enjoy your pounding and enjoy you do the nurses pace is relentless. It seems her prep also had quite the effect on her, and now she's taking it all out on your poor little prostate fucking you a mess with each slap of her hips and balls against you forcing ecstatic wails from you as you beg your attacker to fuck you even harder a request she all too eager to fulfill. Stars fill your vision with each thrust, and when her knot enters the equation, you nearly black out from the sheer bliss you feel as it pops loudly in and out of your ass, crushing your bitch button into submission so intense you can't even keep your posture crumbling under the vulpine’s hammering hips and forcing her to yank you back up so you can take her every stab of her bitch breaker. You're cumming before you know it, your hole clenching vice-tight around the victorious nurse's invading cock as you thrash in orgasm[if Player is male] while your rock-hard prick shoots its wasted seed against the ground[end if]. The vixen nurse manages to endure a bit longer than you but still cums soon after forcing her knot into you and painting your walls white with her cum. Shortly after you lose consciousness, the last thing you remember is snuggling with the sexy fox before everything goes black.";
	WaitLineBreak;
	say "     When you wake up, you're still in the same spot the vixen enjoyed you in, and you smell like a bitch in heat but are fully clothed again and covered by a blanket. Despite her new sordid cravings, the furry nurse has retained her desire to ensure her patients are safe and healthy.";
	CreatureSexAftermath "Player" receives "AssFuck" from "Vixen Nurse";

Section 1.2 - Victory Scenes

to say VixenNursePussyFuck:
	say "     Well, what else are you supposed to do when you win these battles, especially when you win such a fine prize? Dragging over the punch-drunk nurse, you throw her onto a nearby desk to admire her beauty no longer hindered by her attacks, and indeed what a fine prize you've caught. The delusional vixen is stunning sprawled across the dusty table. One of the buttons of her ill-fitting uniform has popped off, revealing one pair of her full breasts. You're quick to uncover the other pair ripping off her shirt to reveal her chest in all its glory, exposing her four soft tits for you to with as you, please. Ignoring the rest of her body, you take a moment to enjoy her luscious tits taking one pair and then the next in each hand and groping them, delighting in how soft her fur is and how nigh addictively squishy her breasts are. You also take a moment to tease the naughty nurse's nipples drawing a low moan of pleasure from the weak vulpine, a growing wet spot[if vixgender is 1], and bulge[end if] underneath her bunched-up skirt. Tearing away the voluptuous vulpines' lower clothing, you're greeted by her dripping wet cunt[if vixgender is 1] and throbbing canine cock.[end if] Seeing the fox's clear excitement spikes your own, so you decide to cut your appreciation for her supermodel-esque body short and move on to the next part of the show.";
	say "     As amazing as your bitch looks, laid across the desk like this, it's not a good position for your upcoming actions, so you shift her so she’s laying on her belly, her head hanging off one end of the desk with her ass and legs on the opposite side facing you. Though you were going to move right into the good stuff, you can't just pay an ass this great the proper attention it deserves. So you take a moment to grope and play with the vulpine's big bouncy ass. You honestly could spend all day feeling her cheeks squeezing her, staring intently at the way her ass gives, and when you give her bum a quick spank and watch her bubble butt ripple a spurt of pre-shoots from your cock as you fantasize about just how great it'll look jiggling with your every thrust into the wanton slut beneath you. Snapping you out the trance the vixen's rear trapped you in, you reach your real prize, her dripping cunny advertising just how desperate the naughty nurse is for a good hard fucking with its arousal, but it'll have to wait a bit longer; you haven't gotten your fill of bullying your captured playmate just yet. You take a moment to tease her netherlips with your digits drawing up and down them and wetting the tips of your fingers with her nectar before moving to her clit it rubbing it in slow, gentle circles and torturing the poor fox with pleasure. She's trembling. You can feel her orgasm rising as her warm honey splashes audibly against the cold hospital floor's she is oh so close, but right as she's about to reach that heavenly peak, you snatch your fingers away, chuckling at her frustrated groans. Now this woman's ready for you.";
	WaitLineBreak;
	say "     Removing any clothing that may be constraining your hard [Cock of Player] shaft from the open air and press yourself against her opening, taunting her one last time. You run your head against her leaking petals several times and laugh mockingly at her desperate whines before sheathing yourself in her clenching cunny in one rough thrust. Immediately your bitch cums, her self-control long worn away by all your teasing. Her velvety snatch clenches deliciously tight around you, spasming desperately and soaking your balls in her femcum. You're not anywhere near done, though. So with a victorious laugh, you continue to ruthlessly bang the whorish vulpine throughout her orgasm, forcing her to wail out her ecstasy to the entire hospital. At that moment, you don't care about any potential threats that may come and harass you. You're completely immersed in the act of claiming the women pinned beneath you. The way her ass jiggles and ripples with your every thrust is everything you fantasized about, and more, giving it another quick smack gives you the delightful revelation that it causes your chosen cumdump to clench up sinfully tight around you so you show her no mercy truly just abusing her ass forcing her to squeeze your dick and let out animalistic yips of joy at being used by you soon you swear you can almost see a handprint forming underneath her fur.";
	say "     You feel the urge to cum rise quickly, and it takes everything you have not to give in and bust inside of her, but you can't, not yet. You want to fuck your bitch face to face for a bit and see what a royal mess you've made of her. Withdrawing almost mournfully from her soft silky slit, you turn over the cockdrunk caretaker and force her to face you before plunging back into her and resuming your back-breaking pace, and god, what a sight does she make! She's panting deliriously, eyes wild as she makes sloppy and vulgar pleads, slurring her words truly in every sense of the fuckdrunk her four perfect breasts bounce beautifully with your every thrust hypnotizing you as they sway to and from. With this last wish fulfilled, you finally allow yourself to cum, growling and groaning just as animalistic and feral at the moment the corrupted nurse while you blast everything you have into her womb. For a moment, all you can do is hold yourself in the buxom fox and pant alongside her, but you know, eventually, you have to get a move on, especially with how loud your coupling was. At any moment now, somebody could come to fight you, so you pull out, take one last risk and allow the skanky canine to suck you clean and are off on your merry way.";
	CreatureSexAftermath "Vixen Nurse" receives "PussyFuck" from "Player";
	decrease Libido of Player by 5;

to say VixenNursePlayWithHer:
	say "     Well, what else are you supposed to do when you win these battles, especially when you win such a fine prize? Dragging over the punch-drunk nurse, you throw her onto a nearby couch for waiting patients to admire her beauty no longer hindered by her attacks, and indeed what a fine prize you've caught. The delusional vixen is stunning sprawled across the dusty table. One of the buttons of her ill-fitting uniform has popped off, revealing one pair of her full breasts. You're quick to uncover the other pair ripping off her shirt to reveal her chest in all its glory, exposing her four soft tits for you to with as you, please. Ignoring the rest of her body, you take a moment to enjoy her luscious tits taking one pair and then the next in each hand and groping them, delighting in how soft her fur is and how nigh addictively squishy her breasts are smirking. You also take a moment to tease the naughty nurse's nipples drawing a low moan of pleasure from the weak vulpine, a growing wet spot[if vixgender is 1], and bulge[end if] underneath her bunched-up skirt. Tearing away the voluptuous vulpines' lower clothing, you're greeted by her dripping wet cunt[if vixgender is 1] and throbbing canine cock.[end if] Seeing the fox's clear excitement spikes your own, you can't help but think a body like this is made for others to worship, appreciate, and love, so it'd be a shame to explore every part of it in every way you can.";
	say "     Though you've already copped a feel of the buxom vulpine's chest, you'd like to experience other ways of enjoying her tits before moving forward to other body parts. You lay atop her body and press your face against her ample bosom and enjoy feeling her differently. Pillow-ish is the best way to describe her chest, so wonderfully soft her mammaries and fur make the perfect cradle for you, but something besides the feeling of the beautiful caretaker pinned beneath you draws your attention, the smell of milk coming from her perky nips, and upon closer inspection, it's evident your groping has squirted some for you to taste. For a moment you hesitate well aware the transformative effect this could have on you, and yet like a moth to a flame you can't seem to resist, eventually, after a few more second of deliberation you decide to rip the bandaid off and press your mouth to the shapely canines leaking nips. Right away, her flavor explodes into your mouth. Her dairy tastes deliciously sweet and creamy, and you can't suppress an elated groan at her taste. Soon you're eagerly sucking and lapping away, drooling around the voluptuous vulpines nipples. Closing your eyes, you allow yourself to be carried away completely by her flavor.";
	WaitLineBreak;
	say "     A soft pressure pushing you deeper into the fox's cleavage causes you to reluctantly flutter your eyes open to find the beautiful lady smiling gently while holding you against her breasts; any past aggression is forgotten as she feeds you while she does your hands begin to wander over her body squeezing her bubbly ass and ample hips before running to her waist as you try to memorize every curve of the fluffy woman's body. It seems you're touching, paired with your feeding, has awakened a different type of hunger in the both of you as she begins to masturbate. The sound of her self-pleasure paired with the sudden arousal her milk seems to have roused in you driving you to grind yourself against the curvaceous caretaker, unwilling to stop your hand from exploring her body or stop drinking to take of yourself. Your mutual climax is a slow and peaceful affair, a gradual and satisfying climb. You pop off first, quivering and shaking against her body as orgasm rolls through you, forcing you, at last, to stop eating, and the vixen nurse follows soon, her juices soaking the both of you and running down her thighs. You both enjoy the afterglow for a long while cuddled up cozily on the couch, but knowing your survival depends on being active and alert at all times, you force yourself to leave.";
	decrease Libido of Player by 5;

to say VixenHermNurseRideHer:
	say "     A";

to say VixenHermNurseGetFucked:
	say "     A";

to say VixenHermNurseGetAnal:
	say "     A";

to say LoseToVixenNurse:
	if vixgender is 0:
		project Figure of VixenNurse_fem_naked_icon;
	else:
		project Figure of VixenNurse_herm_naked_icon;
	choose row MonsterID from the Table of Random Critters;
	if vixgender is 0:
		if Player is herm:
			if a random number between 1 and 4 is:
				-- 1:
					say "[VixenFemNurseMaleRidingScene]";
				-- 2:
					say "[VixenFemNurseMaleNursingScene]";
				-- 3:
					say "[VixenFemNurseFemaleNursingScene]";
				-- 4:
					say "[VixenFemNurseFacesitting]";
		else if Player is male:
			if a random number between 1 and 3 is:
				-- 1:
					say "[VixenFemNurseMaleRidingScene]";
				-- 2:
					say "[VixenFemNurseMaleNursingScene]";
				-- 3:
					say "[VixenFemNurseFacesitting]";
		else if Player is female:
			if a random number between 1 and 2 is:
				-- 1:
					say "[VixenFemNurseFemaleNursingScene]";
				-- 2:
					say "[VixenFemNurseFacesitting]";
		else:
			say "[VixenFemNurseFacesitting]";
	else if vixgender is 1:
		say "     The silver-furred vixen grins at you as she looks over her [if fightoutcome is 22]willing [end if]patient. Moving in close, she rubs her sexy body against yours, grinding her throbbing knotted erection against you even as she grabs your ass meaningfully. Knowing you're going to be mounted shortly by the horny vixen if you don't do anything, you consider trying to suck her off to satisfy her instead. Shall you attempt an [link]oral distraction (Y)[as]y[end link] or simply accept to let the herm [link]fuck you (N)[as]n[end link]?";
		if Player consents:
			say "     Deciding you'd prefer that throbbing cock of hers in your mouth than elsewhere, you lower yourself to your knees and start licking and kissing at it. She moans in pleasure and runs her paws over your head, pushing her leaking shaft against your lips and into your mouth. As you suck her off, you grow increasingly aroused and eager to get her off, soon lusting for the sexy herm's seed. As you bob your head over her meaty rod, she scribbles some distracted notes on her clipboard, mumbling about her patient's ['][one of]cooperative nature[or]arousal response[or]satisfying progress[at random]['] and ['][one of]eagerness to take [if Player is female]her[else if Player is male]his[else]their[end if] medicine[or]oral fixation[or]lingum activity[at random]['] before turning her full attention back to you as you bump against her growing knot. You rub her plump ballsack with one hand and slide a pair of fingers into her puss with the other, pumping in time to her thrusting, getting her to cum hard and spew her hot load down your throat. You eagerly swallow down the musky mess and suck her cock clean before letting it go, having gotten quite turned on by the whole experience.";
			let x be Libido of Player;
			if fightoutcome is 22, increase x by 15; [submitted]
			if Player is female, increase x by 15; [F/H]
			if a random chance of x in 200 succeeds:
				WaitLineBreak;
				say "     The vixen nurse, panting a little from her orgasm, takes in the scent of your arousal and smiles. Reminded of her initial plan, her cock starts to rise again. Getting hard in your mouth again. Lost in your lust, you help her along, licking and sucking it to restore her erection. With some help from you, soon she's up and ready to go again, which you are far more eager for than before.";
				if Player is herm:
					if a random chance of 1 in 2 succeeds:
						say "[VixenHermNurseAssFuck]";
					else:
						say "[VixenHermNursePussyFuck]";
				else if Player is female:
					say "[VixenHermNursePussyFuck]";
				else:
					say "[VixenHermNurseAssFuck]";
					now Libido of Player is ( Libido of Player + Libido of Player + libido entry ) / 3;
					infect "Vixen Nurse"; [extra infection for double-sex]
			else:
				say "     The vixen nurse, panting a little from her orgasm, pushes you off her spent shaft and straightens her uniform and grins as she places her clipboard in front of the bulge in her skirt. She grins and heads off, perhaps to find another vict... ah... patient in need of her special brand of TLC.";
				increase Libido of Player by 15;
				if Libido of Player > 100, now Libido of Player is 100;
		else if Player is female:
			say "[VixenHermNursePussyFuck]";
		else:
			say "[VixenHermNurseAssFuck]";
	[value reset]
	now lev entry is 4;

to say BeatTheVixenNurse:
	if vixgender is 0:
		project Figure of VixenNurse_fem_naked_icon;
	else:
		project Figure of VixenNurse_herm_naked_icon;
	choose row MonsterID from the Table of Random Critters;
	say "The vixen nurse stops fighting and you move in to catch her, it seems you have a slutty vixen nurse on your hands [bold type]What would you like to do?[roman type][line break]";
	now sextablerun is 0;
	blank out the whole of table of fucking options;
	[]
	if Player is male:
		choose a blank row in table of fucking options;
		now title entry is "Fuck her pussy";
		now sortorder entry is 1;
		now description entry is "Give her a taste of her own medicine";
	[]
	choose a blank row in table of fucking options;
	now title entry is "Play with her";
	now sortorder entry is 2;
	now description entry is "Play with her using your hand";
	[
	if Player is female and vixgender is 1:
		choose a blank row in table of fucking options;
		now title entry is "Ride her cock";
		now sortorder entry is 3;
		now description entry is "Take her knotted cock on your own terms?";
	[]
	if Player is female and vixgender is 1:
		choose a blank row in table of fucking options;
		now title entry is "Let her fuck your pussy";
		now sortorder entry is 4;
		now description entry is "Let her breed your pussy";
	[]
	if vixgender is 1:
		Choose a blank row in table of fucking options;
		now title entry is "Let her fuck your ass";
		now sortorder entry is 5;
		now description entry is "Let her fill your ass";
	]
	sort the table of fucking options in sortorder order;
	repeat with y running from 1 to number of filled rows in table of fucking options:
		choose row y from the table of fucking options;
		say "[link][y] - [title entry][as][y][end link][line break]";
	say "[link]0 - Turn her down[as]0[end link][line break]";
	while sextablerun is 0:
		say "Pick the corresponding number> [run paragraph on]";
		get a number;
		if calcnumber > 0 and calcnumber <= the number of filled rows in table of fucking options:
			now current menu selection is calcnumber;
			choose row calcnumber in table of fucking options;
			say "[title entry]: [description entry]?";
			if Player consents:
				now sextablerun is 1;
				if title entry is:
					-- "Fuck her pussy":
						say "[VixenNursePussyFuck]";
					-- "Play with her":
						say "[VixenNursePlayWithHer]";
					-- "Ride her cock":
						say "[VixenHermNurseRideHer]";
					-- otherwise:
						say "Sex menu failed!";
				wait for any key;
		else if calcnumber is 0:
			now sextablerun is 1;
			say "     You let the vixen's hand go and she quickly disappears down a hallway, leaving you to gather your thoughts.";
			wait for any key;
		else:
			say "Invalid Option. Pick between 1 and [the number of filled rows in the table of fucking options] or 0 to exit.";
	clear the screen and hyperlink list;
	[value reset]
	choose row MonsterID from the Table of Random Critters;
	now lev entry is 4;


to say VixenNurseDesc:
	if vixgender is 0:
		say "     You find yourself face to face with a sensually curved vixen in a tight, little nurse's outfit. She has a short cut, white apron with a black top under it. There's even a traditional, white nurse's cap with a red cross on it on the vixen's head. She has lustrous, gray fur, indicating that her infection originated from a silver fox. Glancing down those long, slender legs you see they end in digitigrade paws. To her ample chest, she holds a large clipboard. You can still see the bumps that the perky nipples on her four breasts make in the fabric, unblocked by the clipboard. She looks you over quickly and tut-tuts, saying '[one of]It looks like one patient's gotten out of bed[or]Bend over, sweetie. It's time to take your temperature[or]You look like you need a little TLC[or]Please return to the waiting area. The doctor will see you shortly. Until then, let me take care of you[at random].' She raises her clipboard, seemingly intent on clubbing you with it.";
	else:
		say "     You find yourself face to face with one of those sensually curved vixen in the tight, little nurse's outfit. She has lustrous, gray fur, indicating that her infection originated from a silver fox. She has a traditional, white nurse's cap with a red cross on it on the vixen's head. She is wearing a short cut, white apron with a black top under it.";
		say "     And there your eyes stop, finding that something is amiss with this naughty nurse. Her tight dress has a rather sizable bulge in it and it is growing larger as you watch. It's a trap! Grinning, she rubs the firm lump and says, '[one of]It looks like one patient's gotten out of bed. I'll tuck you in good and tight[or]Bend over, sweetie. Mmm... I want to take your temperature[or]You look like you need a dose of my medicine[or]Let me give you a thorough examination, my pretty patient[at random].' She rubs her four breasts and moans lustfully before charging at you.";

Table of CombatPrep (continued)
name(text)	PrepFunction(text)
"Vixen Nurse"	"[PrepCombat_Vixen Nurse]"

to say PrepCombat_Vixen Nurse:
	choose row MonsterID from the Table of Random Critters;
	now lootchance entry is 20;
	let debit be 0;
	now vixgender is 0;
	if HermList is banned:			[always female if herm banned]
		now vixgender is 0;
	else if hospquest > 5:
		let hermvixchance be 30 + hospquest + hospquest; [increasingly likely as hospquest progresses]
		if hermvixchance > 75, now hermvixchance is 75;
		if a random chance of hermvixchance in 100 succeeds:
			now vixgender is 1; [now a herm]
	if vixgender is 0:
		setmongender 4; [creature is female]
		project Figure of VixenNurse_fem_clothed_icon;
		if HardMode is true and level of Player > 4, let debit be level of Player - 4;
		now HP entry is 36 + ( debit * 4 );
		now monsterHP is 36 + ( debit * 4 );
		now lev entry is 4 + debit;
		now wdam entry is 5 + ( debit / 3 );
		now dex entry is 14 + ( lev entry / 5 );
	else:
		setmongender 5; [creature is herm]
		project Figure of VixenNurse_herm_clothed_icon;
		if HardMode is true and level of Player > 7, now debit is level of Player - 7;
		now HP entry is 72 + ( debit * 4 );
		now monsterHP is 72 + ( debit * 4 );
		now lev entry is 7 + debit;
		now wdam entry is 8 + ( debit / 3 );
		now dex entry is 18 + ( ( lev entry - 7 ) / 5 );



Section 2 - Creature Insertion

Table of Random Critters (continued)
NewTypeInfection (truth state)	Species Name	Name	Enemy Title	Enemy Name	Enemy Type	Attack	Defeated	Victory	Desc	Face	Body	Skin	Tail	Cock	Face Change	Body Change	Skin Change	Ass Change	Cock Change	str	dex	sta	per	int	cha	sex	HP	lev	wdam	area	Cock Count	Cock Length	Ball Size	Nipple Count	Breast Size	Male Breast Size	Cunt Count	Cunt Depth	Cunt Tightness	SeductionImmune	Libido	Loot	Lootchance	TrophyFunction	MilkItem	CumItem	Scale (number)	Body Descriptor (text)	Type (text)	Magic (truth state)	Resbypass (truth state)	non-infectious (truth state)	Cross-Infection (text)	DayCycle	Altcombat (text)	BannedStatus (truth state)
--	--	--	--	--	--	--	--	--	--	--	--	--	--	--	--	--	--	--	--	--	--	--	--	--	--	--	--	--	--	--	--	--	--	--	--	--	--	--	--	--	--	--	--	--	--	--	--	--	--	--	--	--	--	--	--	--;

When Play begins:
	Choose a blank row from Table of Random Critters;
	now NewTypeInfection entry is false;
	now Species Name entry is "Fox"; [ Name of the overall species of the infection, used so a "male x" and "female x" have "pureblood X" children. ]
	add "Vixen Nurse" to infections of VulpineList;
	add "Vixen Nurse" to infections of FurryList;
	add "Vixen Nurse" to infections of NatureList;
	add "Vixen Nurse" to infections of FemaleList;
	add "Vixen Nurse" to infections of TaperedCockList;
	add "Vixen Nurse" to infections of KnottedCockList;
	add "Vixen Nurse" to infections of SheathedCockList;
	add "Vixen Nurse" to infections of BipedalList;
	add "Vixen Nurse" to infections of TailList;
	now Name entry is "Vixen Nurse";
	now enemy title entry is ""; [ Name of the encountered creature at combat start - Example: "You run into a giant collie." instead of using "Smooth Collie Shemale" infection name. ]
	now enemy Name entry is ""; [ Specific name of unique enemy. ]
	now enemy type entry is 0; [ 0 = non unique enemy; 1 = unique (unknown name); 2 = unique (known name) | Used to disqualify unique enemies from Vore/UB and showing the enemy name in encounters. ]
	now attack entry is "[one of]The naughty nurse gives you a hard slap![or]The vixen bonks you on the head with the clipboard she's carrying![or]The silver vixen gives you a scratch with her claws![or]The vixen nurse stomps her foot-paw down onto the top of your foot![or]Lunging at you, the nurse tries to smother you in her ample cleavage![or]The vixen nurse knees you in the side![or]The silver-furred nurse strikes you firmly at the temple, making your ear ring![or]The nurse moves in quick and grinds her body against you as she gives you a steaming kiss![or]The vixen swings wildly, managing to bop you on the nose with her clipboard![or]She sidesteps you as she grabs your upper arm in one paw and spanks you repeatedly with her clipboard![at random]";
	now defeated entry is "[BeatTheVixenNurse]";
	now victory entry is "[LoseToVixenNurse]"; [Text used when monster wins, can be directly entered like combat text or description. or if more complex it can be linked to a 'To Say' block as the demonstration text shows.]
	now desc entry is "[VixenNurseDesc]"; [ Description of the creature when you encounter it.]
	now face entry is "a vulpine head with a long muzzle and teeth. You have steely-gray eyes and silver fur covers your face"; [ Face description, format as "Your face is [Face of Player]." ]
	now body entry is "seductively curved, with a tight, bubble butt. Your hands have hard, black claws at their fingertips and your feet are digitigrade paws now"; [ Body Description, format as "Your Body is [Body of Player]." ]
	now skin entry is "smooth, silver-colored fur over your"; [ Skin Description, format as "Looking at yourself, your body is covered in [Skin of Player] skin." ]
	now tail entry is "From the base of your spine, you have a silver fox's luxurious tail."; [ Tail description, write a whole Sentence or leave blank. ]
	now cock entry is "steely-gray vulpine"; [ Cock Description, format as you have a 'size' (your text) cock]
	now face change entry is "it shifts and stretches, gaining a long, slender muzzle which ends in a black nose and whiskers. Silvery fur covers his muzzle as your ears move upwards and grow into pointed, vulpine ears"; [ Face change text, format as "Your face feels funny as [face change entry]." ]
	now body change entry is "it becomes a slender and seductively curved one. You can feel your butt shift as it becomes a taut bubble butt, ripe for mounting. Your hands become paw-like, with little black claws at the tips of your fingers. You can hear cracks and pops as your ankle and foot changes, becoming digitigrade paws"; [ Body change text, format as "Your body feels funny as [body change entry]." ]
	now skin change entry is "it grows a soft, fluffy layer of silvery fur"; [ Skin change text, format as "Your skin feels funny as [skin change entry]." ]
	now ass change entry is "a floofy fox tail extends from your spine. It is covered in soft, silvery fur"; [ Ass/tail change text, format as "Your ass feels funny as [ass change entry]." ]
	now cock change entry is "it takes on a steely-gray color. Changing shape, it becomes pointed at the glans with a knot at its base"; [ cock change text. format as "Your cock feels funny as (your text)." ]
	now str entry is 12;
	now dex entry is 14;
	now sta entry is 10;
	now per entry is 12;
	now int entry is 15;
	now cha entry is 18;
	now sex entry is "Female"; [ Defines which sex the infection will try and make you. current options are 'Male' 'Female' 'Both']
	now HP entry is 36;
	now lev entry is 4; [ Level of the Monster, you get this much XP if you win, or this much XP halved if you loose ]
	now wdam entry is 5; [ Amount of Damage monster Does when attacking. ]
	now area entry is "Hospital"; [ Location of monster, in this case the City Hospital]
	now Cock Count entry is 0; [ How many cocks will the infection try and cause if sex is 'Male' or 'Both']
	now Cock Length entry is 0; [ Length infection will make cock grow to if cocks]
	now Ball Size entry is 0; [ Size of balls 1-7: "acorn-sized", "dove egg-sized", "chicken egg-sized" "goose-egg sized", "ostrich-egg sized", "basketball-sized", "beachball-sized"]
	now Nipple Count entry is 4; [ Number of nipples infection will give you (males have nipples too) ]
	now Breast Size entry is 4; [Size of breasts infection will try to attain ]
	now Male Breast Size entry is 0; [ Breast size for if Sex="Male", usually zero. ]
	now Cunt Count entry is 1; [ if sex = "Female or both", indicates the number of female sexes infection will grant you.]
	now Cunt Depth entry is 12;
	now Cunt Tightness entry is 5;
	now SeductionImmune entry is false;
	now libido entry is 60; [ Set to zero in this monster to control elsewhere ]
	now loot entry is "healing booster"; [ Dropped item. Key will be used later ]
	now lootchance entry is 20; [ Chance of loot dropping 0-100 ]
	now MilkItem entry is "vixen nurse milk";
	now CumItem entry is ""; [ Item to be given to the player if they have this infection and jerk off. ]
	now TrophyFunction entry is "-"; [ Function to generate a list of optional loot items, of which the player can choose one after victory. ]
	now scale entry is 3; [ Number 1-5, approx size/height of infected PC body: 1=tiny, 3=avg, 5=huge ]
	now body descriptor entry is "[one of]curvaceous[or]sexy[or]effeminate[at random]";
	now type entry is "vulpine"; [ one-word creature type. Ex: feline, canine, lupine, robotic, human... Use [one of] to vary ]
	now magic entry is false;
	now resbypass entry is false;
	now non-infectious entry is false;
	now Cross-Infection entry is ""; [ Infection that this infection will give the player when they lose; can be left empty if they infect with the monster's own strain. ]
	now DayCycle entry is 0; [ 0 = Up at all times; 1 = Diurnal (day encounters only); 2 = Nocturnal (night encounters only);]
	now altcombat entry is "vixennurse"; [ Row used to designate any special combat features, "default" for standard combat. ]
	now BannedStatus entry is false;

[
Table of New Infection Parts (continued)
Species Name	Name	Body Weight	Body Definition	Androginity	Head Change	Head Description	Head Adjective	Head Skin Adjective	Head Color	Head Adornments	Hair Length	Hair Shape	Hair Color	Hair Style	Beard Style	Body Hair Length	Eye Color	Eye Adjective	Mouth Length	Mouth Circumference	Tongue Adjective	Tongue Color	Tongue Length	Torso Change	Torso Description	Torso Adjective	Torso Skin Adjective	Torso Adornments	Torso Color	Torso Pattern	Breast Adjective	Breast Size	Male Breast Size	Nipple Count	Nipple Color	Nipple Shape	Back Change	Back Adornments	Back Skin Adjective	Back Color	Arms Change	Arms Description	Arms Skin Adjective	Arms Color	Locomotion	Legs Change	Legs Description	Legs Skin Adjective	Legs Color	Ass Change	Ass Description	Ass Skin Adjective	Ass Color	Ass Width	Tail Change	Tail Description	tail skin adjective	Tail Color	Asshole Depth	Asshole Tightness	Asshole Color	Cock Change	Cock Description	Cock Adjective	Cock Color	Cock Count	Cock Girth	Cock Length	Ball Description	Ball Count	Ball Size	Cunt Change	Cunt Description	Cunt Adjective	Cunt Color	Cunt Count	Cunt Depth	Cunt Tightness	Clit Size
--	--	--	--	--	--	--	--	--	--	--	--	--	--	--	--	--	--	--	--	--	--	--	--	--	--	--	--	--	--	--	--	--	--	--	--	--	--	--	--	--	--	--	--	--	--	--	--	--	--	--	--	--	--	--	--	--	--	--	--	--	--	--	--	--	--	--	--	--	--	--	--	--	--	--	--	--	--	--	--;

When Play begins:
	Choose a blank row from Table of New Infection Parts;
	now Species Name entry is ""; [ Name of the overall species of the infection, used so a "male x" and "female x" have "pureblood X" children. ]
	now Name entry is ""; [matching infection name to Table of Random Critters]
	now Body Weight entry is 5; [scale of 1-9 for body weight, grouped into low weight (1-3), mid weight (4-6) and high weight (7-9)]
	now Body Definition entry is 5; [scale of 1-9 for body definition, grouped into low muscle (1-3), mid muscle (4-6), high muscle (7-9)]
	[Body Adjective is generated out of the body weight and body definition and can be used in scenes - one word descriptive adjective depending on weight and definition groups: low weight group: skinny/slender/lithe; mid weight group: average/fit/muscled; high weight group: pudgy/husky/jacked]
	now Androginity entry is 5; [1-9 scale of hypermasculine to hyperfeminine]
	[Gender Adjective is generated out of androginity 1-9: hypermasculine/masculine/effeminate/somewhat effeminate/androgynous/feminine butch/tomboyish/feminine/hyperfeminine]
	now Head Change entry is ""; [partial sentence that fits in: "Your head and face [one of]tingle[or]go flush[or]vibrate with odd pleasure[or]go cold[or]feel oily[at random] as [head change entry]."]
	now Head Description entry is ""; [partial sentence that fits in "Your face and head resemble that of [Head Description of Player]. You have [Eye Adjective of Player], [Eye Color of Player] eyes and an overall [Gender Adjective of Player] appearance."]
	now Head Adjective entry is ""; [one word descriptive adjective (avian/canine/...)]
	now Head Skin Adjective entry is ""; [one word descriptive adjective]
	now Head Color entry is ""; [single word color adjective for the dominant color of the skin/fur/feathers/scales]
	now Head Adornments entry is "";[partial sentence that fits in "Before moving on from your head, you give your [Head Adornments of Player] a proud glance followed by a light caress."]
	now Hair Length entry is 2; [hair length in inches]
	now Hair Shape entry is ""; [one word shape descriptor (curly/straight/...)]
	now Hair Color entry is ""; [one word color descriptor]
	now Hair Style entry is ""; [one word style descriptor (ponytail/mohawk/buzzcut/...) to fit "On top of your head you have [Hair Length of Player] inch long, [Hair Shape of Player] [Hair Color of Player] hair in the [Hair Style of Player] style."]
	now Beard Style entry is ""; [short beard style (goatee/3-day stubble beard/porn stache/mutton chops beard/...) to go into "You have a [Hair Color of Player] [Beard Style of Player]."]
	now Body Hair Length entry is 0; [numerical value, 0-4 (no body hair/light/moderate/heavy/furry) - only set to > 0 if the infection does not have fur/scales/etc. !]
	now Eye Color entry is ""; [one word color descriptor]
	now Eye Adjective entry is ""; [one word descriptive adjective (slitted/round/...)]
	now Mouth Length entry is 3; [inches deep for face fucking; maximum possible will be double this number (when deep throating)]
	[Mouth Length Adjective is generated by a function and can be used in scenes too - "petite, shallow, average, deep, bottomless"]
	now Mouth Circumference entry is 3; [mouth circumference 1-5, see Mouth Circumference Adjective]
	[Mouth Circumference Adjective is generated by a function and can be used in scenes too - "tiny, small, normal, wide, gaping"]
	now Tongue Adjective entry is ""; [one word descriptive adjective (wide/slobbery/...)]
	now Tongue Color entry is ""; [one word color descriptor]
	now Tongue Length entry is 3; [length in inches]
	now Torso Change entry is ""; [partial sentence that fits in: "Your torso [one of]tingles[or]goes flush[or]vibrates with odd pleasure[or]goes cold[or]feels oily[at random] as [Torso Change entry]."]
	now Torso Description entry is ""; [partial sentence, fitting in "Looking down at yourself, you appear [Gender Adjective of Player] with a [Body Adjective of Player] build. Your torso is [Torso Description of Player][if Body Hair Length of Player > 1], covered in [Torso Color of Player] skin and [Body Hair Description of Player][else if Body Hair Length of Player is 1], covered in smooth, [Torso Color of Player] skin[end if]."]
	now Torso Adjective entry is ""; [one word descriptive adjective (avian/canine/...)]
	now Torso Adornments entry is ""; [(pouch/udders/...); partial sentence to fit: "You take a moment to feel your [Torso Adornments of Player]."]
	now Torso Skin Adjective entry is ""; [one word adjective (feathered/furred/scaly/...); EMPTY "" for creatures with just skin]
	now Torso Color entry is ""; [single word color adjective for the dominant color of the skin/fur/feathers/scales]
	now Torso Pattern entry is ""; [single word color adjective for the dominant pattern of the skin/fur/feathers/scales]
	now Breast Adjective entry is ""; [adjective(s) example: round, pointy, perky, saggy, bouncy. This would serve as either a general appearance of a infections breasts or possibly something that may be effected by a item or NPC.]
	now Breast Size entry is 0; [cup size as number, counting Flat Pecs = 0, A = 1, B = 2, ...]
	now Male Breast Size entry is 0; [cup size as number, counting Flat Pecs = 0, A = 1, B = 2, ...]
	now Nipple Count entry is 2; [count of nipples]
	now Nipple Color entry is ""; [one word color descriptor]
	now Nipple Shape entry is ""; [shape example: any shape will do as long as it has a baseline with a current infection or item]
	now Back Change entry is ""; [partial sentence that fits in: "Your back [one of]tingles[or]goes flush[or]vibrates with odd pleasure[or]goes cold[or]feels oily[at random] as [Back Change entry]."]
	now Back Adornments entry is ""; [partial sentence to fit: "Your back tickles with the feeling of movement caused by [back adornments of Player]."]
	now Back Skin Adjective entry is ""; [one word adjective (feathered/furred/scaly/...); EMPTY "" for creatures with just skin]
	now Back Color entry is ""; [single word color adjective for the dominant color of the skin/fur/feathers/scales]
	[Limbs Adjective is generated by a function and can be used in scenes too - "rail-thin, slender, sinewy, average, firm, muscular, flabby, meaty, rippling"]
	now Arms Change entry is ""; [partial sentence that fits in: "Your arms [one of]tingle[or]go flush[or]vibrate with odd pleasure[or]go cold[or]feel oily[at random] as [Arms Change entry]."]
	now Arms Description entry is ""; [partial sentence to fit: "Your [Limbs Adjective of Player] arms are [Arms Description of Player]."]
	now Arms Skin Adjective entry is ""; [one word adjective (feathered/furred/scaly/...); EMPTY "" for creatures with just skin]
	now Arms Color entry is ""; [single word color adjective for the dominant color of the skin/fur/feathers/scales]
	now Locomotion entry is ""; [one word adjective: (bipedal/quadrupedal/octapedal/serpentine/sliding)]
	now Legs Change entry is ""; [partial sentence that fits in: "Your legs [one of]tingle[or]go flush[or]vibrate with odd pleasure[or]go cold[or]feel oily[at random] as [Legs Change entry]."]
	now Legs Description entry is ""; [partial sentence to fit: "As your inspection goes even lower, you come to the two [Body Adjective of Player] legs supporting you. They are [Legs Description of Player]."]
	now Legs Skin Adjective entry is ""; [one word adjective (feathered/furred/scaly/...); EMPTY "" for creatures with just skin]
	now Legs Color entry is ""; [single word color adjective for the dominant color of the skin/fur/feathers/scales]
	now Ass Change entry is ""; [partial sentence that fits in: "Your ass [one of]tingles[or]goes flush[or]vibrates with odd pleasure[or]goes cold[or]feels oily[at random] as [Ass Change entry]."]
	now Ass Description entry is ""; [partial sentence to fit: "Using your hands you feel your behind enjoying the sensation of your [Ass Width Adjective of Player], [Ass Shape Adjective of Player] [Ass Description of Player]." (For players with skin, instead of the period: ", covered in [Ass Color of Player] skin and [Body Hair Description of Player]"]
	now Ass Skin Adjective entry is ""; [one word adjective (feathered/furred/scaly/...); EMPTY "" for creatures with just skin]
	now Ass Color entry is ""; [single word color adjective for the dominant color of the skin/fur/feathers/scales]
	now Ass Width entry is 3; [ass width from 1-5]
	[Ass Width Adjective generated by function out of ass width: dainty/small/round/huge/enormous]
	[Ass Adjective generated by function out of body definition and ass width]
	now Tail Change entry is ""; [partial sentence that fits in: "Your rear [one of]tingles[or]goes flush[or]vibrates with odd pleasure[or]goes cold[or]feels oily[at random] as [if HasTail of Player is true]your existing tail is changed into a [Tail Description entry][else][Tail Change entry][end if]."]
	now Tail Description entry is ""; [partial sentence to fit: "Just below your lower back sprouts a [Tail Description of Player], which you move back and forth with glee."]
	now Tail Skin Adjective entry is ""; [one word adjective (feathered/furred/scaly/...); EMPTY "" for creatures with just skin]
	now Tail Color entry is ""; [single word color adjective for the dominant color of the skin/fur/feathers/scales]
	now Asshole Depth entry is 7; [inches deep for anal fucking]
	[Asshole Depth Adjective is generated by a function and can be used in scenes too - "petite (< 3), shallow (< 5), average (< 9), deep (< 15), bottomless (15+)"]
	now Asshole Tightness entry is 3; [asshole tightness 1-5, "extremely tight, tight, receptive, open, gaping"]
	[Asshole Tightness Adjective is generated by a function and can be used in scenes too - "extremely tight, tight, receptive, open, gaping"]
	now Asshole Color entry is ""; [one word color descriptor]
	now Cock Count entry is 0;
	now Cock Girth entry is 0; [thickness 1-5, generates the Cock Girth Adjective]
	[Cock Girth Adjective is generated by a function and can be used in scenes too: thin/slender/average/thick/monstrous]
	now Cock Length entry is 0; [length in inches]
	now Cock Adjective entry is ""; [one word adjective: avian/canine/...]
	now Cock Change entry is ""; [partial sentence that fits in: "Your cock [one of]tingles[or]goes flush[or]vibrates with odd pleasure[or]goes cold[or]feels oily[at random] as [Cock Change entry]."]
	now Cock Description entry is ""; [partial sentence to fit: "You have a [Cock Girth Adjective of Player], [Cock Length of Player]-inch-long [Cock Adjective of Player] [one of]cock[or]penis[or]shaft[or]maleness[at random] that [cock Description of Player]."]
	now Cock Color entry is ""; [one word color descriptor]
	now Ball Count entry is 0; [allowed numbers: 1 (uniball), 2 or 4]
	now Ball Size entry is 0; [size of balls 1-7: "acorn-sized", "dove egg-sized", "chicken egg-sized" "goose-egg sized", "ostrich-egg sized", "basketball-sized", "beachball-sized"]
	[Ball Size Adjective is generated by a function and can be used in scenes too]
	now Ball Description entry is ""; [partial sentence to fit: "Underneath it hangs a pair of [Ball Size Adjective of Player] [Ball Description of Player]."]
	now Cunt Count entry is 0;
	now Cunt Depth entry is 0; [penetrable length in inches; some minor stretching allowed, or more with Twisted Capacity]
	now Cunt Tightness entry is 0; [size 1-5, generates adjectives of extremely tight/tight/receptive/open/gaping]
	[Cunt Tightness Adjective is generated by a function and can be used in scenes too: extremely tight/tight/well-used/open/gaping]
	now Cunt Adjective entry is ""; [one word adjective: avian/canine/...]
	now Cunt Change entry is ""; [partial sentence that fits in: "Your pussy [one of]tingles[or]goes flush[or]vibrates with odd pleasure[or]goes cold[or]feels oily[at random] as [Cunt change entry]."]
	now Cunt Description entry is ""; [partial sentence to fit: "You have a [Cunt Tightness Adjective of Player] [one of]cunt[or]pussy[or]vagina[or]cleft[at random] that [Cunt Description of Player]."]
	now Cunt Color entry is ""; [one word color descriptor]
	now Clit Size entry is 0; [size 1-5, see Clit Size Adjective]
	[Clit Size Adjective is generated by a function and can be used in scenes: very small/small/average/large/very large]
]


Table of Critter Combat (continued)
name	combat (rule)	preattack (rule)	postattack (rule)	altattack1 (rule)	alt1chance (number)	altattack2 (rule)	alt2chance (number)	monmiss (rule)	continuous (rule)	altstrike (rule)
"vixennurse"	vixhealboost rule	--	--	--	--	--	--	--	--	--

this is the vixhealboost rule:
	choose row MonsterID from the Table of Random Critters;
	if monsterHP <= ( HP entry / 4 ) and lootchance entry > 0 and a random chance of 1 in 4 succeeds:	[weak and not used healing booster]
		let healed be 25;
		increase monsterHP by healed;
		if monsterHP > HP entry:
			decrease healed by HP entry - monsterHP;
			now monsterHP is HP entry;
		say "     The [one of]vixen nurse[or]vulpine nurse[or]silvery vixen[at random] falls back momentarily due to her injuries. She pulls a small syringe filled with blue fluid out and injects it quickly into her [one of]leg[or]thigh[or]arm[or]side[purely at random] before [one of]throwing the empty needle aside[or]tossing the needle away[or]breaking the empty needle on the ground[at random]. As her injuries start to rapidly heal, she then rushes back into the fray to face you again. She has recovered [special-style-1][healed][roman type] HP.";
		now lootchance entry is 0; [used up potential healing booster]
		follow the monster injury rule;
		say "[Name entry] is [descr].";
		wait for any key;
	else:
		standardretaliate;


Table of Game Objects (continued)
name	desc	weight	object
"healing booster"	"A small syringe filled with a clear, blue fluid."	1	healing booster

healing booster is a grab object. It is fast. It is temporary.

the scent of the healing booster is "The healing booster smells of chemicals and medicine.".

Usedesc of healing booster is "[healing booster use]".

to say healing booster use:
	let healed be 20;
	if "Expert Medic" is listed in the feats of Player:
		now healed is 25;
	else if carried of First Aid Manual > 0:
		increase healed by 2;
	if "Rapid Healing" is listed in the feats of Player:
		increase healed by 2;
	if "Regeneration" is listed in the feats of Player:
		increase healed by 3;
	if NoHealMode is true:
		now healed is ( healed * 125 ) / 100;
	increase HP of Player by healed;
	if HP of Player > MaxHP of Player:
		decrease healed by HP of Player minus MaxHP of Player;
		now HP of Player is MaxHP of Player;
	say "Using your healing booster, you inject the mix into your body, giving a quick boost to your infected body's healing rate. You regain [special-style-1][healed][roman type] HP.";

Section 3 - Endings

Table of GameEndings (continued)
Name (text)	Type (text)	Subtype (text)	Ending (rule)	Priority (number)	Triggered (truth state)
"Vixen Nurse Infection"	"Infection"	""	Vixen Nurse Infection rule	1000	false

This is the Vixen Nurse Infection rule:
	if Player has a body of "Vixen Nurse":
		trigger ending "Vixen Nurse Infection"; [Here it states, that the ending has been played.]
		if humanity of Player < 10:
			say "     Falling to the instincts and reprogramming of the infection, you drift off into the city and eventual come to the city hospital. There you are taken in by the silvery vixen nurses of the hospital staff, feeling the urge to work alongside them. They welcome you happily, and lustfully, as do the other denizens of the large medical facility.";
			if hospquest < 2:
				if "Sterile" is not listed in feats of Player and Player is female:
					say "     After a particularly energetic romp with one of the jaguar orderlies, you become pregnant and are transferred to the maternity ward. There you tend to the hospital's cubs, adding your own litter to them and feeding the cute cubs from your bosom.";
				else if Player is male:
					say "     Being a rare vulpine in their midst with a cock, you are quite popular with the female vixens and mate with many of them, adding many more cubs to the maternity ward to grow and add to the hospital's population.";
				else:
					say "     Between the strange, medical duties you and the others perform, you enjoy many an evening with the muscled jaguars that populate the hospital, never tiring of the feel of their cocks pounding into your hyper-sexualized body.";
			else if hospquest < 13:
				say "     Drawn by your instincts as a member of the hospital staff, you report back to Dr. Mouse. While you only vaguely remember him, he greets you with a smile and happily adds you to his hospital's staff. He puts you in charge of one of his exploratory teams, letting you order around the jaguar orderlies as they capture new [']volunteers['] for his experiments.";
				if Player is female:
					say "     On a trip to the beach, you are ambushed by a crew of pirate sharks after the helicopter. Successfully boarding the craft, they disable the pilot and manage to deal with the orderlies only by sheer numbers. They are all dumped overboard into the sea while you are kept as booty. The sharks celebrate that evening with drink, song and sex, all eager to take a turn with you. Being treated by the good doctor for your duties, you resist physically transforming to become another shark, but your mind unravels again. You are remade into a vixen pirate, lover to this band of air pirates.";
				else:
					say "     During a mission to an old hotel on the outskirts of the red light district, your team is assaulted by a herd of powerful equines. The ferocious orderlies manage to hold their own, but you are dragged off. The horses spend many weeks trying to turn you into another equine slave for their brothel, but the treatment given to you by the mouse doctor holds enough to keep your body intact. But your mind does not fare as well and succumbs to the constant training they give you, turning you into a slutty, silver fox. You act as their medical staff, helping them with their conversions when needed and the rare injuries that are too much for the nanites. When not performing these infrequent duties, you are there to provide a change of pace to anyone looking for something a little different from the otherwise equine whorehouse.";
			else if hospquest is 13 and HP of doctor mouse is 1:
				say "     Driven by your new instincts as a member of the hospital staff, you report back to Dr. Mouse. While you only vaguely remember the experiences that lead you to know him, he somehow recognizes you readily and is cruelly pleased with your fate. Fully subservient to him now, he takes delight in ordering you around and using you for any twisted experiment he wants. Your body is changed over and over again in countless ways over the years and you are often used to mate with any new test subjects he captures for his amusement";
				if "Sterile" is not listed in feats of Player and Player is female:
					say ". You birth many bizarre, hybrid creatures from these matings";
				say ". You do all this for him gladly, though never understanding why he is so mean to you, his loyal follower";
				if Player is female:
					say ". It hurts you the most any time he takes you as a lover to slake his lust upon you. He is particularly cruel at these times, but you want it so badly from him and love it so much when your master fills you with his seed";
				say ".";
			else if hospquest is 13 and HP of doctor mouse is 2:
				say "     The hospital is in disarray when you arrive, more like a stirred up hornets nest than the orderly bee hive you feel it should be. The various factions strike out at each other at times, but cooperate at others. The maternity ward still runs, but the cafeteria is often host to in-fighting over mates.";
				if intelligence of Player >= 20 and charisma of Player >= 15 and "Expert Medic" is listed in feats of Player:
					say "     It is only with the coming of the military that control is restored. The united threat of military action unifies the factions, at least temporarily. And you would see that order remain and start taking charge of the groups. Feeling the need to have someone in charge, the other groups begin to respond to your commands, beginning to rely on you to fill that void. Your familiarity and experience in the city helps counter the military incursion. You use your knowledge of the safe paths through the city and its havens to hide to command the medical staff into position over the radio. Using medical and anatomical terminology for your code, the staff understand it intrinsically and can act upon it instantly while the military code-breakers labor over it. The strikes are made with surgical precision, excising key elements from the military supply and support chain within the city until the point that they're driven back from the hospital. With the hospital left alone and a new collection of test subjects, you leave the remaining military forces largely alone.";
					say "     Taking over as the head of the hospital from that point comes naturally. The groups fall into line and order is restored to you hospital. While lacking the extensive medical training and experience Dr. Mouse had, you learn quickly by studying the numerous medical books and journals throughout the hospital. You even start up some experiments of your own, enjoying converting the captured soldiers into more staff or using them for perverse, sexual cross-breeding with sample creatures. While perhaps not as ambitious as the mouse's experiments, you also have no urge to leave the hospital like he did, content with your orderly medical center and your collection of cross-breed test subjects to satisfy your myriad sexual hungers.";
					increase score by 50;
				else:
					say "     It is only with the coming of the military that control is restored. The united threat of military action unites the factions, at least temporarily. And you would see that unity remain and enact a plan that percolates in the back of your mind. Feeling the need to have someone in charge, you break from the defense and slip past the military lines. You find a small veterinarian hospital and spot some activity inside. Armed with a syringe filled with tranquilizers and a need to do what must be done for the good of the hospital, you slip in and attack the panther taur vet. Unprepared for the injection, she moved in close, letting you knock her out with it.";
					say "     You relay your success over the radio to the hospital, but it takes them some time to get a team past the military and out to you. Thankfully the veterinary clinic still has supplies and you're able to keep her under until you can get her back to the hospital. One of the female jaguars is allowed to welcome the panther herm to the hospital, bonding her into the staff as your new leader. The taur doctor fills her position well, maintaining the unity of the hospital staff after the military is repulsed. The hospital's medical work slacks off, but several of the staff are sent out to capture many animal creatures from the city. These are converted into more staff for an expanding new wing for sexual veterinary medicine.";
			else:
				say "     Drawn by your instincts as a member of the hospital staff, you report back to Dr. Mouse. While you only vaguely remember him, he greets you with a smile and happily adds you to his hospital's staff. He puts you in charge of monitoring his test subjects with a pair of jaguars to act as your muscle. Obediently, you follow the mad doctor's orders, watching his [']volunteers['] and often using them as play-toys when he's done with them before sending them downstairs to the hospital proper to be assimilated into the staff[if Susan is in hidden lab]. Susan, as his assistant, is there with him to help you and reward you with lustful sex[end if].";
				say "     When the time comes to leave the city, Dr. Mouse takes you[if Susan is in hidden lab], Susan[end if] and several other of the staff to escape through the service tunnels under the hospital. Meanwhile the main body of the staff hold the hospital against the army with the helicopter running as an added diversion. You all escape out of the city and Dr. Mouse sets up a new lab in secret. He begins selling off the fruits of his research to foreign powers and the growing factions of transformed creatures that form. He has you continue to monitor his test subjects for his ongoing experiments";
				if Player is female:
					say ". You also are honored with being the little mouse's personal sex-toy when he needs to unwind after a particularly exciting procedure";
					if "Sterile" is not listed in feats of Player:
						say ". You are very proud when your belly grows full, swelling with his young";
				say ".";
		else:
			if hospquest > 13:
				say "     When you are rescued from the infected city by the military, they take you to a base they've set up for the testing and processing of the infected. While you are being examined, you have to resist your urges to play with doctors like the naughty nurse you are. You can't afford to draw too much attention to yourself. Using your innate medical knowledge and your sensual body, you avoid receiving the treatment to render you non-infectious and fudge the results. When cleared, you travel to a new city and insinuate yourself into a small clinic, infecting the staff there and setting up a nice little den of silver foxes to be your mates.";
			else:
				say "     When you are rescued from the infected city by the military, they take you to a base they've set up for testing and processing of the infected. While you are being examined, you chat up the doctors. At first, they are clinical and unresponsive to your playful antics, but eventually begin to warm up to you as you prove clever and knowledgeable about their medical examinations. At your behest, one of them gets a nurse's outfit for you and join their staff. Receiving the treatment to render you non-infectious, they also start giving in to your playful banter and sneaking off with you for a little fun to help relieve their stress after a particularly alluring patient gets them riled up.";

Naughty Nurse ends here.
