Version 1 of Alexandra Breeding by Wahn begins here.
[Version 1 - Split off from Alexandra ]

"Adds Breeding scenes for Bad Alexandra the Doberwoman to the Flexible Survival game"

[ AlexandraBrutusInteraction                          ]
[  0: nothing yet                                     ]

[ Intelligence of Alexandra - Talking with Anthony about the farm and her ]
[  0: nothing yet                                                         ]
[  1: got his okay for leaving her on the farm for a while                ]
[  2: actually has been at the farm before                                ]

[ Energy of Alexandra - Breeding with the horseman twins                  ]
[  0: nothing yet                                                         ]
[  1: Alexandra met and fucked them before                                ]
[  2: Took her to the farm before                                         ]

[ Planned content                                                         ]
[   1: let evil Brutus pound Alexandra + female player breeding option    ]
[   2: take Alexandra to the farm (choice menu for breeders to take her)  ]


[
For Breeding Alexandra
Player
Likes/fetishes: male doms, female subs or power bottom, Impregnation/Breeding, pregnancy, threesomes/multiple partners, collars with titles on them like breeder, tattoos with titles on them like breeder, oral and dirty talk for cock and ball worship, big balls, lots of cum, dirty talk
Dislikes: vore, unbirth, death, permanent appearance tf, mind control [90% of the time], hard bondage by itself
Other comments: I like culting and peer pressure, like if someone likes getting bred they also what others to get bred too and they want to help make that happen, coerce them, and/or force them to do it. But it's nothing they wouldn't do themselves and prefer would do it with them and help them revel in the good parts
I like it when someone is so interested in something that the conviction they have drives them to find others to help or make them experience it.

Character
The gender of my player character is (usually): male or female
Feats my character often/always has: fertile, litter bearer, and other game-play feats that help me level and loot
Does the character usually use Automatic Survival?: no

Scenes
Pairings that interest me are (keep those that are fine by you): MF, FF, HF, HH
I prefer creature gender to be: female or male
When winning a fight, I like as its aftermath: sex, dom,
When losing a fight, I like as its aftermath: sex, sub, food and water taken
The following creatures I like the most (why?): most M or H/F
The following creatures I dislike the most (why?): those with content I don't like or cause tf easily
This creature or infection could use an update (multiple possible, say what you think needs work): minotaur
I'd love to see as new creature: new tentacle monster

NPCs
I always/often bring home/visit these NPCs: always most to all of the ladies, when playing female I usually pick up fang and most of the men that are sexable art bunker except the pig
Threesomes and/or extra scenes between these bunker/library NPCs would be awesome:
The following NPCs I like the most (why?): Alexandra Nadia, Fang, Amy, Sarah and other ladies that interact with others
The following NPCs I dislike the most (why?): pig and because he is a slob


i wanted do scenes listed below or something similar unless you have other suggestions

growth phase: wants more horse "meat" and is looking forward to spending time with the rest of the barracks

Solo: Spit roast or maybe another idea
Join: "69" with player on top
Alexandra gets a great view of what kind of breeding she is getting and a face full of balls and cum.
Twins walk-in:   watch,  aftermath
Barracks bang: watch,  join,  walk-in watch, walk-in aftermath

Iceassassin7712/04/2019
with these type of scenes
- Preg and non preg Non interactive Walk in: handjob/s
- Non interactive Walk in aftermath: alexandra all fucked out, tired and messy
[not walk in] Sex with npc: alexandra has found a breeder to show and share with her boss that is eager to please her; with huge balls to match
[not walk in] Sex with [same]npc: player options
[not walk in] player join barracks bang

and if there is anything left i will let do whatever with Corbin

2 Nelson alexandra Preg and non preg Walk in
	Player joins or don’t
2 Preg and non preg Non interactive Walk in
2 sex menu Alexandra, Nelson: simular to the style of Brutus
	Player joins or don’t

]

[ AlexandraBrutusInteraction                                                   ]
[  50: Fucked rough by Brutus                                                  ]
[  51: Fuck shared last time - she's eager for more                            ]
[  52: Brutus + Alexandra unchained sex                                        ]

AlexandraFarmhandEventCooldown is a number that varies. [@Tag:Notsaved]
AlexandraFarmhandEventCooldown is usually 20000.

Section 0 - Breeding Menu

to say AlexandraBreedingMenu:
	project the figure of Alexandra_clothed_icon;
	LineBreak;
	if Alexandra is in Grey Abbey Library:
		say "     Walking up to Alexandra, you run one hand over her naked chest, cupping and squeezing one of her breasts, while the other slides behind her head to draw her closer to you. Giving your dobie bitch a forceful kiss, you tongue-wrestle with her a little and suck on the tip of her floppy appendage. Drawing back after a little while to look into her eyes, you then tell the canine ex-cop that you want to breed her like the slut she is, choosing studs to mount her and fill that belly with some pups. In reply, ";
		if "Cuckold" is listed in Feats of Player: [player is too much of a chump in her view for Alexandra to accept the demand]
			say "the tough bitch lets out a derisive bark, giving your chest a light shove. 'You think I care about what ideas you think up? I sleep with whom I want! You're tough in a fight, but we both know you're a weakling when it comes to defending your territory afterwards, so don't make me laugh with demands like that.' With a haughty look on her face, she just walks away from you after that, not even waiting for what you might say next.";
			stop the action;
		else if Sterile of Alexandra is true: [sterile right now]
			say "the tough bitch's eyebrows rise and an annoyed look crosses her face. 'Really? You're a fucking kinky freak bastard! Sending me off to get my tubes tied by that lizard doctor and THEN whipping out your idea of breeding me. So you just wanna see your bad bitch pounded and filled with spunk without having to care for [if Libido of Alexandra > 0]extra [end if]puppies? Fine! But you better choose some damn good studs if we're going through this charade, asshole!' Alexandra barks at you with a scowl, taking a step back and crossing her arms in front of her chest.";
		else if "Fertility Treatments" is listed in Traits of Alexandra: [she's been bred several times already and got a taste for it]
			say "the tough bitch lets out an amused bark, smirking at you as she lowers one hand to her belly. 'Why am I not surprised? You're one fucking kinky freak, boss! Just can't get enough of your dobie puppy mill swelling up and pushing out those pups, eh? Fine! But you better choose some damn good studs, not just any dirty mongrel!' Alexandra says and leans in closer, brushing her breasts against you in clear anticipation of being taken and filled with virile seed.";
		else if Player is not male: [no dick]
			say "the tough bitch raises one eyebrow while sliding a hand down to your crotch, squeezing it suggestively. 'You know, if you're interested in breeding me you could get a dick yourself to do the deed. I could give you some suggestions of pretty fucking amazing schlongs I've seen out there on the roads.' Alexandra is grinning broadly now as she adds, 'Ever thought about having a horsecock swing between your legs? Or one of those ridged wyvern things, that's a fun option. Knotted dicks are the best of all though. Ah, but maybe this is something else, eh? Feeling kinky and wanting to own a bitch and make her put out for buddies? Fine, fine. But you better choose some damn good studs, not just any dirty mongrel!'";
		else if Player is male:
			say "Alexandra looks at you in surprise, letting her hand slide down to your crotch and squeezing it suggestively. 'What? You don't wanna knock me up yourself? A strong, powerful guy makes the best puppies, just so you know boss. Don't think you need any help with the task, eh?! Ah, but maybe this is something else, eh? Feeling kinky and wanting to own a bitch and make her put out for buddies? Fine, fine. But you better choose some damn good studs, not just any dirty mongrel!'";
	else if Alexandra is in Worker Barracks:
		say "     Walking up to Alexandra, you run one hand over her naked chest, cupping and squeezing one of her breasts, while the other slides behind her head to draw her closer to you. Giving your dobie bitch a forceful kiss, you tongue-wrestle with her a little and suck on the tip of her floppy appendage. Drawing back after a little while to look into her eyes, you then tell the canine ex-cop that you want to breed her like the slut she is, choosing studs to mount her and fill that belly with some pups. In reply, ";
		if "Cuckold" is listed in Feats of Player: [player is too much of a chump in her view for Alexandra to accept the demand]
			say "the tough bitch lets out a derisive bark, giving your chest a light shove. 'You think I care about what ideas you think up? I sleep with whom I want! You're tough in a fight, but we both know you're a weakling when it comes to defending your territory afterwards, so don't make me laugh with demands like that.' With a haughty look on her face, she just walks away from you after that, not even waiting for what you might say next.";
			stop the action;
		else if Sterile of Alexandra is true: [sterile right now]
			say "the tough bitch's eyebrows rise and an annoyed look crosses her face. 'Really? What do you think has been happening since you kinky freak bastard dropped me off here?! And it's all wasted 'breeding' as you sent me off to get my tubes tied by that lizard doctor! So you just wanna see your bad bitch pounded and filled with spunk without having to care for [if Libido of Alexandra > 0]extra [end if]puppies? Fine! But you better choose some damn good studs if we're going through this charade, asshole!' Alexandra barks at you with a scowl, taking a step back and crossing her arms in front of her chest.";
		else if "Fertility Treatments" is listed in Traits of Alexandra: [she's been bred several times already and got a taste for it]
			say "the tough bitch lets out an amused bark, smirking at you as she lowers one hand to her belly. 'Why am I not surprised? You're one fucking kinky freak, boss! Just can't get enough of your dobie puppy mill swelling up and pushing out those pups, eh? Fine! But you better choose some damn good studs, not just any dirty mongrel!' Alexandra says and leans in closer, brushing her breasts against you in clear anticipation of being taken and filled with virile seed.";
		else if Player is not male: [no dick]
			say "the tough bitch raises one eyebrow while sliding a hand down to your crotch, squeezing it suggestively. 'You know, if you're interested in breeding me you could get a dick yourself to do the deed. I could give you some suggestions of pretty fucking amazing schlongs I've seen out there on the roads.' Alexandra is grinning broadly now as she adds, 'Ever thought about having a horsecock swing between your legs? Or one of those ridged wyvern things, that's a fun option. Knotted dicks are the best of all though. Ah, but maybe this is something else, eh? Feeling kinky and wanting to own a bitch and make her put out for buddies? Fine, fine. But you better choose some damn good studs, not just any dirty mongrel!'";
		else if Player is male:
			say "Alexandra looks at you in surprise, letting her hand slide down to your crotch and squeezing it suggestively. 'What? You don't wanna knock me up yourself? A strong, powerful guy makes the best puppies, just so you know boss. Don't think you need any help with the task, eh?! Ah, but maybe this is something else, eh? Feeling kinky and wanting to own a bitch and make her put out for buddies? Fine, fine. But you better choose some damn good studs, not just any dirty mongrel!'";
	else:
		say "     ERROR - Alexandra is neither in the library nor is she in the worker barracks on the farm. Please report where she is in your game and report how she got there on the FS Discord.";
	now sextablerun is 0;
	blank out the whole of table of fucking options;
	say "     So, which partner do you want to pound Alexandra's pussy and breed her?";
	[
	if "Feral Mutt" is listed in EncounteredEnemies of Player or "Feral Mutt Pack" is listed in EncounteredEnemies of Player: [Player knows the feral dogs]
		choose a blank row in table of fucking options;
		now title entry is "A feral mutt";
		now sortorder entry is 1;
		now description entry is "Let Alexandra get mounted by a street dog";
	]
	if demon brute is tamed and DBCaptureQuestVar is 5 and DemonBruteStatus < 2: [evil Brutus]
		choose a blank row in table of fucking options;
		now title entry is "Your demon slave Brutus";
		now sortorder entry is 2;
		now description entry is "Let Brutus ravage Alexandra's pussy";
	[]
	if PlayerMet of Farmhand Horsemen is true and FriesianRelationship is 0: [saw them, no interaction]
		choose a blank row in table of fucking options;
		now title entry is "That pair of black stallion twins you saw at the McDermott Farm";
		now sortorder entry is 3;
		now description entry is "Let the Friesian farmhands double-team Alexandra";
	[]
	if PlayerMet of Farmhand Horsemen is true and FriesianRelationship is 1: [sexed them, don't know the names]
		choose a blank row in table of fucking options;
		now title entry is "That pair of black stallion twins you met at the McDermott Farm";
		now sortorder entry is 4;
		now description entry is "Let the Friesian farmhands double-team Alexandra";
	[]
	if PlayerMet of Farmhand Horsemen is true and FriesianRelationship is 2: [knows the twins]
		choose a blank row in table of fucking options;
		now title entry is "Karel and Isaac, the black stallion twins";
		now sortorder entry is 5;
		now description entry is "Let the Friesian farmhands double-team Alexandra";
	[]
	if PlayerMet of Nelson is true and Alexandra is in Worker Barracks and Nelson is in Worker Barracks:
		choose a blank row in table of fucking options;
		now title entry is "Nelson, the large zebra stud";
		now sortorder entry is 6;
		now description entry is "Let the zebra give Alexandra a pounding";
	[]
	if PlayerMet of Farmhand Horsemen is true and FriesianRelationship is 2 and Energy of Alexandra > 0 and Alexandra is not in Worker Barracks: [knows the twins, Alexandra was fucked by horsecock already]
		choose a blank row in table of fucking options;
		now title entry is "Take her to the farm for an extended stay in the worker barracks";
		now sortorder entry is 7;
		now description entry is "Bring your bitch to live with a whole bunch of horny studs for a while";
	[]
	sort the table of fucking options in sortorder order;
	repeat with y running from 1 to number of filled rows in table of fucking options:
		choose row y from the table of fucking options;
		say "[link][y] - [title entry][as][y][end link][line break]";
	say "[link]0 - Nevermind[as]0[end link][line break]";
	while sextablerun is 0:
		say "Pick the corresponding number> [run paragraph on]";
		get a number;
		if calcnumber > 0 and calcnumber <= the number of filled rows in table of fucking options:
			now current menu selection is calcnumber;
			choose row calcnumber in table of fucking options;
			say "[title entry]: [description entry]?";
			if Player consents:
				let nam be title entry;
				now sextablerun is 1;
				if (nam is "A feral mutt"):
					say "[AlexandraBreeding_Mutt]";
				else if (nam is "Your demon slave Brutus"):
					say "[AlexandraBreeding_EvilBrutus]";
				else if (nam is "That pair of black stallion twins you saw at the McDermott Farm" or nam is "That pair of black stallion twins you met at the McDermott Farm" or nam is "Karel and Isaac, the black stallion twins"):
					say "[AlexandraBreeding_Karel_Isaac]";
				else if (nam is "Take her to the farm for an extended stay in the worker barracks"):
					if Intelligence of Alexandra < 2: [first time]
						say "[AlexandraBreeding_BarracksMove]";
					else: [repeats]
						say "[AlexandraBreeding_BarracksReturn]";
				else if (nam is "Nelson, the large zebra stud"):
					say "[AlexandraBreeding_Nelson]";
				[wait for any key;]
		else if calcnumber is 0:
			now sextablerun is 1;
			say "     You step back from the doberwoman bitch and tell her that you'll have to continue your conversation at another time. She looks at you in puzzlement, then turns her attention back to [if Alexandra is in Grey Abbey Library]guarding the entrance[else if Alexandra is in Worker Barracks]ogling the farmhand workers[else]ERROR, LOCATION TASK NOT SET[end if].";
			[wait for any key;]
		else:
			say "Invalid Option. Pick between 1 and [the number of filled rows in the table of fucking options] or 0 to exit.";
	[clear the screen and hyperlink list;]

to say AlexandraBreeding_Mutt:
	say "...";

Section 1 - Brutus

after going to Grey Abbey Library while (HP of Alexandra is 2 or HP of Alexandra is 4 and AlexandraBrutusPups > 7 and AlexandraBrutusInteraction > 40 and AlexandraBrutusInteraction < 52 and Lastfuck of Alexandra - turns > 4 and a random chance of 1 in 2 succeeds):
	try looking;
	AlexandraBrutus_Unchained;

instead of navigating Grey Abbey Library while (HP of Alexandra is 2 or HP of Alexandra is 4 and AlexandraBrutusPups > 7 and AlexandraBrutusInteraction > 40 and AlexandraBrutusInteraction < 52 and Lastfuck of Alexandra - turns > 4 and a random chance of 1 in 2 succeeds):
	say "[NavCheck Grey Abbey Library]";
	if NavCheckReturn is false, stop the action;
	move player to Grey Abbey Library;
	AlexandraBrutus_Unchained;

after going to Worker Barracks while (HP of Alexandra is 2 or HP of Alexandra is 4 and AlexandraBrutusPups > 7 and AlexandraBrutusInteraction > 40 and AlexandraBrutusInteraction < 52 and Lastfuck of Alexandra - turns > 4 and a random chance of 1 in 2 succeeds):
	try looking;
	AlexandraBrutus_Unchained;

to AlexandraBrutus_Unchained:
	now AlexandraBrutusInteraction is 52; [Alexandra ready for unchained sex]
	if Alexandra is in Grey Abbey Library:
		say "     As you enter the front area of the library, Alexandra is clearly waiting for you, as she pushes herself off from the wall she was leaning against and saunters closer. Swaying her hips enticingly, the dobie bitch is quite a sight to behold, and you let your memory wander through everything you've done to and with her, which puts a grin on your lips all of its own. 'Hey boss,' the former cop says as she comes to stand before you, one hand straying to her flat and toned belly. 'You know what - I kinda learned to dig having rough sex with your purple beast. Being speared by that arm-thick prick, just a play-toy in the arms of the brute, then carrying his spawn inside me. Little demon dogs. They may look like normal puppies, but they sure got some of his temperament.'";
	else if Alexandra is in Worker Barracks:
		say "     As you enter the worker barracks, Alexandra is clearly waiting for you, as she pushes herself off from the wall she was leaning against and saunters closer. Swaying her hips enticingly, the dobie bitch is quite a sight to behold, and you let your memory wander through everything you've done to and with her, which puts a grin on your lips all of its own. 'Hey boss,' the former cop says as she comes to stand before you, one hand straying to her flat and toned belly. 'You know what - I kinda learned to dig having rough sex with your purple beast. Being speared by that arm-thick prick, just a play-toy in the arms of the brute, then carrying his spawn inside me. Little demon dogs. They may look like normal puppies, but they sure got some of his temperament.'";
	else:
		say "     ERROR - Alexandra is in an unexpected location. Please report where she is and how she got there on the FS Discord.";
	if demon brute is listed in companionList of Player: [already summoned]
		say "     Turning her head towards Brutus, who's still at his usual spot one step behind you to the side, a lusty smirk crosses Alexandra's face. 'I'm ready for another go as your puppy mill. Wanna unleash the demon on me? I can take it, no holds barred this time!' Almost as if to prove this to you, she quickly proceeds to unzip her jeans, tucking open the front and then taking your hand to guide it to her pussy. You can feel wetness between her arousal-swollen nether lips, as the bitch is leaking female juices in anticipation of a huge cock thrusting into her and breeding her once more. In response to the show, Brutus steps forward, grinning down at Alexandra with a hungry expression that shows his frightful collection of sharp teeth. His clawed hand twitches as if to just rip the remaining clothes off Alexandra's body, but apparently is held back by your standing order not to hurt anyone but your enemies. '[Master]?' he asks with an impatient growl, his erection filling out and throbbing.";
	else: [not the active companion]
		say "     Laying her hand on your chest and stroking a finger along the curve of your demontooth amulet, a lusty smirk crosses Alexandra's face. 'I'm ready for another go as your puppy mill. Wanna unleash the demon on me? I can take it, no holds barred this time!' Almost as if to prove this to you, she quickly proceeds to unzip her jeans, tucking open the front and then taking your hand to guide it to her pussy. You can feel wetness between her arousal-swollen nether lips, as the bitch is leaking female juices in anticipation of a huge cock thrusting into her and breeding her once more. 'Come on boss, you know you want to see him put another litter in there!'";
	say "     [bold type]What's your reply?[roman type][line break]";
	LineBreak;
	say "     ([link]Y[as]y[end link]) - Time for another demon breeding!";
	say "     ([link]N[as]n[end link]) - No. You decide when they can breed, not them!";
	if Player consents:
		LineBreak;
		if demon brute is not listed in companionList of Player: [not the active companion]
			say "     Thrusting in two fingers and feeling the insides your dobie's trembling pussy, you find her snug around your digits, yet at the same time easy to spread open as her dripping snatch stretches out with a little push. Seems that repeated poundings with a dick bigger around than a beer-can left their mark on the breeding bitch, with the nanites fixing her hole up with the needed elasticity to return to normal dimensions instead of gaping open wide all the time. She grinds against your hand and pants lustfully, then bends her head forward to lick your cheek and say, 'Give me what I need. Please boss!' A grin spreads across your face in response to Alexandra's needy begging and you raise your hand to close around the demontooth amulet.";
			say "     Reciting the tongue-breaker of a magical command phrase that Nermine taught you starts purple smoke to billow out of the very tip of the tooth, quickly improving in volume. Swirling away from you to a spot about ten feet ahead, the cloud becomes thicker and thicker until soon solidifying into the towering shape of your demonic slave Brutus. '[Master]?' the big, purple brute growls out in greeting, turning his horned head to look at you. Yet his usual hateful scowl slips a little as he sees Alexandra plastered against your front, panting audibly as you continue to finger-fuck her. Brutus's nostrils flare as he bends forwards and sniffs the air, followed by the aroused growl of, 'A [if Sterile of Alexandra is true]needy[else]fertile[end if] bitch to breed!' His huge cock throbs visibly, immediately starting to fill out and rising from the place where it was dangling between his muscled legs. Somewhat reluctantly, you pull your fingers out of Alexandra and turn her around to face the demon she begged you for.";
			WaitLineBreak;
		say "[AlexandraBreeding_EvilBrutus]";
	else:
		LineBreak;
		if demon brute is listed in companionList of Player: [already summoned]
			say "     Shaking your head and reminding the two of them that you're their [master], you earn a sullen huff from Alexandra, followed by her walking over to the nearest sofa and flopping down on it. Pushing her pants down over her hips, she starts to frig her pussy in full view, working at getting herself off now that you've denied the fun she wanted. Meanwhile, Brutus rages against his magical binding, the muscles of his towering physique rippling beneath his skin as he attempts to raise his clawed hands to disembowel the cock-blocker standing between him and savagely fucking the dobie bitch. Finally he balls his fists hard enough for claw-tips to dig into his palms, with some drops of dark purple blood welling up. Impotent to cause physical harm, he moves on to a tirade of vile curses that could peel paint of the walls, until you tell him to just shut up and be silent for now.";
		else: [not the active companion]
			say "     Shaking your head and reminding the former cop that you're her [master] now, you earn a sullen huff from Alexandra, followed by her walking over to the nearest sofa and flopping down on it. Pushing her pants down over her hips, she starts to frig her pussy in full view, working at getting herself off now that you've denied the fun she wanted. The dobie bitch lets out purposefully loud moans and gasps that echo through the library, even going so far as calling out, 'Breed me! Breed my pussy you brute!' as she gets close to orgasm soon after. One might think she's just fantasizing about the demon as she has her eyes mostly closed by that time, but you see her throwing you quick glances through slitted lids. Seems she's trying to make you jealous or to draw you into the fantasy and change your mind about seeing her bred.";

to say AlexandraBreeding_EvilBrutus:
	if AlexandraBrutusInteraction is 0: [first time]
		project the figure of BrutusEvil_icon;
		if demon brute is listed in companionList of Player: [already summoned]
			say "     Instead of saying anything further to the breeding bitch, you raise a hand to stroke the curve of your demontooth amulet and turn your head towards Brutus, the huge purple beast you have taken as your controlled slave. He scowls as he becomes aware of your attention, baring his sharp teeth at the indignity of having to serve. Despite this, the towering brute steps up as you command him to, then says in a growling voice, 'Yes... [master]?' ";
		else: [not the active companion]
			say "     Instead of saying anything further to the breeding bitch, you grab your demontooth amulet tightly in your fist, then murmur the magic words Nermine told you. Swirling purple mist flows out of the demon fang's sharp tip, then solidifies in the musclebound figure of your captive demon brute. The towering brute says in a growling voice, 'Yes... [master]?' ";
		say "Glancing back at Alexandra and seeing the worried expression creeping over her face, you gleefully pronounce your command for the demon to take and breed her. In an instant reaction, Brutus's hand shoots forward and he wraps his clawed fingers around the former cop's throat, lifting her off her feet as she lets out a choked gurgle. As you quickly remind him of your standing order not to seriously hurt any of your companions, the demon focuses his blazing eyes on you and replies with clenched teeth creaking against each other, 'Of course. I obey.'";
		WaitLineBreak;
		project the figure of Alexandra_naked_icon;
		say "     Getting over her momentary shock, Alexandra starts to claw at the single strong arm with which Brutus is holding her up. She shows the strength of desperation inherent to people running out of air as she leaves bloody streaks across his skin, yet the demon brute endures this without even flinching once. Drawing Alexandra closer to his face, he licks her cheek and chuckles darkly as she tries to bite his tongue. 'Gonna make you scream, bitch!' he growls in arousal, his massive shaft rapidly filling out and coming to stand at attention. Meanwhile, the former cop's struggles start to become come more sluggish and weak as she gets close to run out of oxygen, prompting Brutus to let go of her with an annoyed grunt. Falling bonelessly to the ground, the dobie coughs and gasps for air, then is instantly pounced on by Brutus, who rips her jeans to shreds in a single rend with his clawed hand.";
		say "     Despite the show of violence, his sharp talons didn't even nick Alexandra's skin, demonstrating your control over the bloodthirsty demon's impulses. Of course, that doesn't protect her from the things you actually ordered Brutus to do to your breeding bitch. He's more than eager to take the bitch too, with the tip of his thick shaft literally oozing pre-cum that drips onto the ground in sticky strings. Alexandra is still gasping for air and unable to fight back as he grabs her by the back of the neck this time, lifting her into the air and shaking her a little. 'I wanna feel you on my shaft, little bitch!' he growls hungrily, then grabs her hip with his other hand to guide her crotch towards his cock. She gets in a weak kick to his side which doesn't really faze Brutus at all, with him just chuckling in response. Then he rams her down forcefully onto his erection, a toothy grin on his face as she screams at the sudden deep penetration.";
		WaitLineBreak;
		project the figure of BrutusEvil_icon;
		say "     Alexandra writhes in your demon pet's grasp as he slams more than a foot of cock into her, creating a visible bulge in her stomach. He isn't actually all the way in yet though, as you can see several more inches visible between his crotch and her widely stretched pussy lips. ";
		if Cunt Depth of Alexandra + 2 < Cock Length of demon brute: [standard values: 10 (+2 stretching allowance) vs 18]
			say "Pushing the doberman ex-cop further down onto his erection, Brutus smile grows wide and predatory as Alexandra lets out a strained gasp. It seems he's reached the end of her pussy and is now nudging her cervix. Gleefully playing his tongue over his lips and sharp teeth, Brutus looks aside to you and growls, 'Breeding wombs is best!' With that, he rams himself home the rest of the way, [if TwistedCapacity of Alexandra is false]drawing a desperate scream from Alexandra as he violates her inner barrier[else]drawing a shocked gasp from Alexandra as he pushes past her inner barrier. The demon scowls for a second at the fact that she was able to take him without the pain he expected, then shrugs it off and concentrates on fucking her instead[end if]. Laughing out loud, the towering purple beast starts to use his captive as a human-sized fleshlight, pounding her up and down on his massive length.";
			if TwistedCapacity of Alexandra is false:
				increase Cunt Depth of Alexandra by 1; [oversized fucks stretch characters bit by bit]
		else: [he actually fits into her]
			say "Pushing the doberman ex-cop further down onto his erection, Brutus smile grows wide and predatory as Alexandra lets out a strained gasp. Reaching depths into her that few regular males would, he gleefully plays his tongue over his lips and sharp teeth, then looks aside to you and growls, 'Gonna deep-dick your slut!' With that, he rams himself home the rest of the way. The demon scowls for a second at the fact that she was able to take him without the pain he expected, then shrugs it off and concentrates on fucking her instead. Laughing out loud, the towering purple beast starts to use his captive as a human-sized fleshlight, pounding her up and down on his massive length.";
		say "     It's an entrancing sight to see Brutus make use of your dobie bitch, hammering his whole length into her again and again and bulging the stomach of the lithe woman out as if she was already pregnant with his spawn. Despite the harsh treatment, it doesn't take long before Alexandra finds herself reacting to the stimulation of being fucked and she starts to let out breathless groans and gasps, her pussy leaking female juices over the demon's shaft and at least making it easier for him to slide in. Pounding away at her with no holds barred, the demon's arousal builds rapidly and he squeezes her hip and buttock hard with his clawed fingers, stopping just short of drawing blood. Finally he roars out loud and slams into her all the way, cum erupting into her womb. Brutus's head whip forward at the same time to chomp down on the top of Alexandra's shoulder. Or he would have, if Nermine's binding and your command didn't restrain him, so all she gets is an imprint of his impressive set of teeth.";
		WaitLineBreak;
		say "     The large balls of your demon slave churn and twitch as he pumps a deluge of cum into his play-toy, making her belly swell visibly as it fills up more and more. Before long, it looks like she's already pregnant and ready to pop out a whole litter of pups, and further demon seed starts to squelch out around the purple shaft stretching open her pussy. Brutus keeps holding, pawing and almost biting Alexandra while he rides out his orgasm, but as soon as he's shot his last spurt, he unceremoniously pulls her off his erection. As his thick purple shaft slips out of the stretched hole, a gush of cum accompanies it, splattering onto the floor and starting to trickle down the insides of her legs. Looking at the canine in his hand, hanging limply as he fucked her into a semi-conscious state, Brutus chuckles and then swings her over to you, letting go so she crumples at your feet. 'More pussy! This one is used up,' the demon then demands in a challenging tone.";
		now lastdobiemess is 89; [Brutus creamed her pussy]
		impregAlexandraChance with "Brutus"; [chance to knock her up]
		NPCSexAftermath Alexandra receives "PussyFuck" from Brutus;
		if Player is female:
			say "     [bold type]What's your reply?[roman type][line break]";
			LineBreak;
			say "     ([link]Y[as]y[end link]) - Tell him to fuck you next.";
			say "     ([link]N[as]n[end link]) - Shut the demon down and put him in the amulet for now.";
			if Player consents:
				LineBreak;
				say "     You smile at the demon and tell him that you'll allow him to fuck you too, just because he did such a nice job with Alexandra. The towering creature's slick and dripping member twitches as he steps forward and reaches out, aching to just throw you down and rape you, but unable to do so thanks to the binding spell. You slip your clothes off slowly to tease the demon a bit, then lie down on your back spread your legs invitingly and command that he eat you out first. With an annoyed grumble at not being able to just fuck you, the demon obeys, leaning forward and putting two massive hands on your legs. Bringing his long forked tongue to your crotch, he licks over your sensitive pussy lips, then slips his forked tongue in between them. The wet appendage wiggles around, probing and teasing your insides passage and causing you to moan in lust.";
				WaitLineBreak;
				say "     With the musclebound creature eating you out, wiggling his tongue inside your vagina, you could almost just let him keep going like this... but no, it's time for the main event now. With an aroused gasp for him to fuck you, he is free to do he wanted right from the start. With a hungry growl, the demon is on top of you in a second, his body covering yours and hips thrusting forward - only to stop with just the tip of his thick erection touching your nether lips. You can see beads of sweat form on the demon's purple skin and the muscles below tighten and flex - but no matter how much he tries, the magic controlling him doesn't allow hurting you by just slamming inside with quite as much force as he wanted. Finally he relents, venting his frustration by digging his claws into the ground left and right of your head with a crunch, then start to slowly press forward.";
				say "     The hot member of your infernal servant spreads your pussy lips around it, then sinks deeper into your body, creating pleasant feelings as the bumps on his shaft rub your inner walls. Even as relaxed as your muscles got during the thorough eating out the demon gave you, it's still quite a lot to take and you're thankful that he can't go faster. Finally he bottoms out inside you, his shaft buried all the way and his two large cum-factories resting against your skin. Raising a hand to halt his movement by laying it on his chest, you force him to stop and try to get used to having him inside you. A few minutes later, you tell him to continue - slowly. Moving in and out, the bumps on Brutus's cock rub against your stretched insides, making you shudder with rising lust. Over time, it becomes easier to have him inside you, with your muscles being stretched out and getting used to it. This allows the creature to speed up his thrusts, going faster and faster, the slapping noises of his balls against your hips now coming in rapid succession.";
				WaitLineBreak;
				say "     You can only take so much of the hard fuck your demon pet dishes out, and all the stimulation soon drives your arousal over the edge. [if Player is male]With a loud moan, your [Cock of Player] shaft sprays cum all over your chest[else if Player is female]With a loud moan, you orgasm, femcum running down from your stretched cunt[else]With a loud moan, your body shakes in orgasm[end if]. His duty at getting you off fulfilled, the constraints on the demon's libido fall away and he starts fucking you even harder to get himself off. Soon, he reaches his climax too - and with a deep, satisfied grunt, he begins to pump your bowels full of his infernal seed. With the head of his shaft pushing open your cervix, he easily fills your womb and vagina, with the remaining cum squirting out around the brute's thick cock as he thrusts into you a few more times. As he finally removes his cock with a lout *pop*, your stomach looks distended from the sheer amount of cum he has injected into you, with more of it leaking from your stretched hole to create a white-ish pool under you.";
				LineBreak;
				if demon brute is listed in companionList of Player: [is the active pet]
					say "     Satisfied, you sink to the floor and tell your captive demon to resume guarding you.";
				else: [back into the amulet]
					say "     Satisfied, you sink to the floor and moan the magic words to banish the demon again. Your well-hung fucker turns into a cloud of purple mist and vanishes into the amulet.";
				NPCSexAftermath Player receives "PussyFuck" from Brutus;
			else: [chosen to banish him]
				say "     Giving Brutus an unimpressed look, you raise the demontooth amulet with one hand, then intone the magic words that Nermine taught you. He scowls and makes one step forward as if to attack you even as he already is turning into purple smoke that swirls towards the amulet in the air. Letting out a final aggressive roar that speaks of his desire for unrestrained rampage, the demon fully dematerializes a second or two later, then vanishes as he is drawn in by the magic.";
		else: [just banish him]
			say "     Giving Brutus an unimpressed look, you raise the demontooth amulet with one hand, then intone the magic words that Nermine taught you. He scowls and makes one step forward as if to attack you even as he already is turning into purple smoke that swirls towards the amulet in the air. Letting out a final aggressive roar that speaks of his desire for unrestrained rampage, the demon fully dematerializes a second or two later, then vanishes as he is drawn in by the magic.";
		WaitLineBreak;
		say "     A little while later, Alexandra comes to again, groaning as she half-pushes herself up from the floor and looks at you. 'You can be a downright bastard at times, you know that,' she growls, looking down over her cum-matted fur and wincing as she stands up a little while later. 'Fuck, that was one huge cock. And that beast it's attached to...' She shakes her head to clear it, then stumbles off to clean herself up. Glancing over her shoulder before she [if Alexandra is in Grey Abbey Library]turns the corner behind a bookshelf[else if Alexandra is in Worker Barracks]vanishes in a side room[else]ERROR, LOCATION NOT SET[end if], she says, 'Don't even think about fucking me for the next few hours. I need a break! And thanks to your asshole demon I need to find some new jeans too!'";
		now AlexandraBrutusInteraction is 50; [last fuck was a rough one]
	else if AlexandraBrutusInteraction is 50: [fucked roughly last time - she's not eager for a repeat]
		say "     A grin plays over your face as you lay a hand on Alexandra's stomach, then tell her that you want Brutus to breed her again. Her ears droop and fold back as she pulls back half a step, then scowls openly. 'Are you KIDDING me right now? That bastard is a fucking beast with a dick as thick as my arm and he's rough as fuck! Took ages for my insides to feel anywhere close to normal again after last time!' Looking at the dobie bitch, eyes following the curves of her well-sized breasts before returning to her face, you realize that she didn't actually walk away or say that she wouldn't follow your order, just that she's not very enthusiastic about the prospect of being a demon sex toy once more. Well, there certainly are ways to fix that...";
		if Player is female:
			say "     [bold type]How do you make the pairing more palatable for Alexandra?[roman type][line break]";
			LineBreak;
			say "     ([link]Y[as]y[end link]) - Warm your doggie up a bit first, touching and stroking her.";
			say "     ([link]N[as]n[end link]) - Join her in a threesome with Brutus breeding you both.";
			if Player consents:
				LineBreak;
				say "[AlexandraBrutusBreedingWarmup]";
			else:
				LineBreak;
				say "[AlexandraBrutusBreedingThreesome]";
		else:
			say "[AlexandraBrutusBreedingWarmup]";
	else if AlexandraBrutusInteraction is 51: [fuck shared last time - she's eager for more]
		say "     A grin plays over your face as you lay a hand on Alexandra's stomach, then tell her that you want Brutus to breed her again. Her eyebrows rise and the dobie leans forward to press herself against your side. 'Want to make it another threesome with the beast? Having you there with me last time really made all the difference, even if it took ages for my insides to feel anywhere close to normal again afterwards!' Looking at the dobie bitch and the slight curl of a smile on her muzzle as she remembers your togetherness, you wonder if you should keep being this informal with her or rather remind her that she's yours to make use of any way you want, up to and including rough fucks by your demon pet.";
		if Player is female: [females can join again]
			say "     [bold type]How do you want to have Alexandra fucked?[roman type][line break]";
			LineBreak;
			say "     ([link]Y[as]y[end link]) - Remind her of her place, then give her to Brutus for a hard fuck.";
			say "     ([link]N[as]n[end link]) - Join her in a threesome with Brutus breeding you both.";
			if Player consents:
				LineBreak;
				say "[AlexandraBrutusBreedingWarmup]";
			else:
				LineBreak;
				say "[AlexandraBrutusBreedingThreesome]";
		else: [male + neuter can only have her rough fucked or cancel]
			say "     [bold type]Given that you're not actually equipped with female parts right now, how do you want to deal with this?[roman type][line break]";
			LineBreak;
			say "     ([link]Y[as]y[end link]) - Remind her of her place, then give her to Brutus for a hard fuck.";
			say "     ([link]N[as]n[end link]) - Tell her that you changed her mind.";
			if Player consents:
				LineBreak;
				say "[AlexandraBrutusBreedingWarmup]";
			else:
				LineBreak;
				say "     Pulling the former cop against yourself, you kiss her deeply and grope her ass, then tell her that you changed your mind for now. She can get bred another time. 'Huh? Okay, you're the boss,' she says in a surprised tone, then shrugs and goes back to what she was doing before.";
	else if AlexandraBrutusInteraction is 52: [ready for no holds barred fuck]
		project the figure of Alexandra_clothed_icon;
		say "     A grin plays over your face as you lay a hand on Alexandra's stomach, then tell her that Brutus will breed her again. She lets out an eager moan hands lifting to cup her breasts and pinch their nipples. 'Yeah Boss, you really know what your bad dog bitch needs! That huge purple shaft slamming my pussy hard, then my belly swelling with his load of cum alone!' Looking at the dobie bitch and her wagging tail at the prospect of being harshly used by your demon slave, you can't help but think back to the stuffy cop you encountered out on the streets not that long ago. The nanite apocalypse certainly opened up untold opportunities for those who know how to use them. Pulling Alexandra's head to yours to give her a demanding kiss, you smile broadly and tell her she's just the sort of slutty bitch you always wanted.";
		say "     Pulling open the jeans of your breeding bitch, you rub her clit with your fingers, drawing a shuddering breath from Alexandra. Your other hand moves to her breasts, cupping and squeezing them. Even though she's already moist from arousal for the coming demon fuck, it still is quite a bit of fun to warm her up some more, touching and stroking the woman. Going back and forth to suckle on her erect nipples, you make the bitch whimper and pant in need. Then finally, you dip two fingers into the by now dripping wet snatch of the anthro dog, making her gasp in pleasure as you curl your digits and rub her insides. With your fingers inside her and your thumb on the pleasure-button of her clit, you ask the horny canine what she wants. The answer is delivered in breathless pants and ecstatic barks, especially as you keep caressing her while she speaks. 'I want the beast's cock! His huge, thick prick inside me! Breeding me!'";
		WaitLineBreak;
		if Player is female: [females can join]
			say "";
			say "     [bold type]How do you want to have Alexandra fucked?[roman type][line break]";
			LineBreak;
			say "     ([link]Y[as]y[end link]) - Just serve her up to Brutus and let him take her.";
			say "     ([link]N[as]n[end link]) - Join her in a threesome with Brutus breeding you both.";
			if Player consents:
				LineBreak;
				say "[AlexandraBrutus_UnchainedBreeding_Intro]";
				say "[AlexandraBrutus_UnchainedBreeding]";
			else:
				LineBreak;
				say "[AlexandraBrutus_UnchainedBreedingThreesome]";
		else:
			say "[AlexandraBrutus_UnchainedBreeding_Intro]";
			say "[AlexandraBrutus_UnchainedBreeding]";

to say AlexandraBrutusBreedingWarmup:
	project the figure of Alexandra_clothed_icon;
	say "     Moving closer to the former cop that you made your breeding bitch, you cup one of her breasts with your hand and lightly pinch her nipple, drawing a shuddering breath from Alexandra. Your other hand moves to her hip, stroking the short fur of her side, followed by a demanding kiss of her muzzle. Even with her panties in a twist as she is right now, Alexandra still reacts positively to your touch, obedience to her [master] cemented in her innermost self since you broke and claimed her. Making out with your canine companion, you stroke and touch her body, feeding the fires of her arousal until they're well and truly lit. Going back and forth to suckle on her erect nipples, you make the bitch whimper and pant in need. Finally snaking a hand into her jeans, you dip two fingers into the dripping wet snatch of the anthro dog, making her gasp in pleasure as you curl your digits and rub her insides.";
	say "     With your fingers inside her and your thumb on the pleasure-button of her clit, you ask the horny canine who and what she is. The answer is delivered in breathless pants and ecstatic barks, especially as you keep caressing her while she speaks, teasing the right words out of her. 'I'm Alexandra, your *Aaah, yes!* bad dog bitch! All yours boss! Your *nnnghhfffuuckkk!* breeding bitch! *Oooh, do that again!*' With Alexandra being in the aroused state that she is, you decide it's about time for a reminder too, so you quickly grab the back of her neck with your other hand, sharply pulling the loose fur there back as you look into her eyes. Gruffly reminding the woman that she couldn't resist you when she was still a goody two shoes cop, and she won't do so now, you end with the comment that she should know what you want to hear from her next. 'Nnghh! Fuck! Fine, I'll be your broodmare for that fucking demon and take his monster cock!'";
	WaitLineBreak;
	project the figure of Alexandra_naked_icon;
	say "     You give Alexandra a broad grin and tell her what a good dog she is, then pull your fingers from her pussy and hold them out for her to lick clean, slurping up her own juices. Adding a command for her to strip, the next thing you do is ";
	if demon brute is listed in companionList of Player: [already summoned]
		say "stroking the curve of your demontooth amulet and turning your head towards Brutus, the huge purple beast you have taken as your controlled slave. He's standing close by, his huge purple shaft erect and throbbing from the show of Alexandra's domination. With a growling voice, he asks, 'Yes... [master]?' ";
	else: [not the active companion]
		say "grabbing your demontooth amulet tightly in your fist and murmuring the magic words Nermine told you. Swirling purple mist flows out of the demon fang's sharp tip, then solidifies in the musclebound figure of your captive demon brute. The towering brute says in a growling voice, 'Yes... [master]?' ";
	say "Turning back at Alexandra, by now dressed in nothing more than her bare fur, you give her body an appreciative glance as she hurries over to one of the sofas and lays back on it. She spreads her legs and reaches down to open the wet folds of her sex with two fingers, presenting herself for breeding. Giving the towering purple demon next to you a sharp smack on the ass, you gleefully give him the command to your command for the demon to get into her and breed the bitch. A bestial growl rises from the depths of Brutus's broad chest and he pounces on her in a second, closing in on the sofa with just three large strides.";
	say "     The demon reaches out to pin Alexandra down by her neck, but just as he is about to lay his clawed fingers on her, you tell him to freeze and saunter over to them. After stroking a hand over the dobie's wet slit, then across her stomach and to her breasts before going further up and making her suck your fingers, you explain that you want to see a good, hard fuck that leaves her well bred. Brutus strains against his binding, annoyed by even this little of a delay, and Alexandra looks up at him in trepidation, then at you with large eyes as you go on to say that she can tell Brutus how to fuck her as long as she keeps it interesting for you. And if she doesn't, you'll let him off his leash, or most of the way at least. 'Damn! Fuck me sideways, that's twisted even f-,' Alexandra exclaims in response, quickly followed by a scream of 'Wait you fucking monster!' as Brutus started moving again at her poorly chosen words.";
	WaitLineBreak;
	project the figure of BrutusEvil_icon;
	say "     After looking at you with a slightly nervous expression on her face, Alexandra turns her attention to the huge purple demon leaning over her and the massive prick standing erect above his crotch, showing a slow but steady trickle of pre dripping down from its tip. 'Damn, that's big. And you fucker just wanted to choke me and ram it in, didn't you?' Brutus snarls at her, then growls out the words, 'Yeah, you little whore! Gonna break that cunt of yours!' 'Oh no you won't! First of all, keep your paws off me at all times. And second - you're gonna be on the bottom. Lay down, on the ground right there as you wouldn't even fit this sofa properly.' With little choice but to obey, the demon brute does just that, coming to rest on his back with his upper body propped up on both elbows as he gives the doberwoman a challenging glare. 'Afraid of my dick, eh bitch? It's gonna go into you one way or another!' 'Shut up, beast! Not one more word from you. That's an order.'";
	say "     Stepping over to Brutus on her slender paws, Alexandra swallows visibly as she looks at his dick, then moves herself into position above him. Reaching down to grasp the shaft, she mutters, 'Thing's pretty hot too. But at least lube's not gonna be a problem.' As she says the second bit, another small gush of pre wells from Brutus's cum-slit and trickles over her fingers. The former cop proceeds to jerk up and down, spreading the slick fluid over the demon's dickhead and upper shaft before lowering herself to touch it with her nether lips. Closing her eyes, Alexandra grinds against the erection with her crotch for a little while, then says to herself, 'Slow and steady.' With that, your breeding bitch starts to push herself down on his member, suppressing a gasp as the tip slips into her body. Her widely stretched folds look pretty obscene around his throbbing shaft, with the fact that you're able to make both of them do this giving you a spike of arousal.";
	WaitLineBreak;
	say "     Panting loudly as she takes in gulps of air, Alexandra slides herself deeper slowly, first one inch then another. 'I'm getting there boss, just you see!' the dobie says with a determined expression on her face, a statement that gets answered by Brutus laughing darkly, followed by him thrusting his hips up violently and impaling her on his cock with the sudden move. Demonic laughter is joined by a howl from Alexandra as ";
	if Cunt Depth of Alexandra + 2 < Cock Length of demon brute: [standard values: 10 (+2 stretching allowance) vs 18]
		say "Brutus penetrates her all the way, right past her inner barrier [if TwistedCapacity of Alexandra is false]and so sudden that the pain of her cervix being stretched doesn't even have time to register[else]which stretches readily to allow his entrance[end if]. Claws digging into the floor in frustration since he isn't allowed to grab her, Brutus makes Alexandra bounce on his crotch instead, each hammering thrust pushing her up to be coming down for the next one. He successfully penetrates her twice, then a third time before she shouts, 'FREEZE DIRTBAG! DO NOT FUCKING MOVE!'";
		if TwistedCapacity of Alexandra is false:
			increase Cunt Depth of Alexandra by 1; [oversized fucks stretch characters bit by bit]
	else: [he actually fits into her]
		say "Brutus penetrates her all the way, his whole huge cock sinking into her vagina. Claws digging into the floor in frustration since he isn't allowed to grab her, Brutus makes Alexandra bounce on his crotch instead, each hammering thrust pushing her up. He successfully penetrates her twice, then a third time before she shouts, 'FREEZE DIRTBAG! DO NOT FUCKING MOVE!'";
	say "     Even as Brutus's motion ceases, he is chuckling and grinning at Alexandra, then sticks out his tongue and wiggles it as if licking her. 'Fucking hell!' Alexandra exclaims, then looks your way with a raised eyebrow. 'The things I do for you boss. But you'll get your knocked up bitch, don't you worry.' Glancing down, she barks at Brutus, 'Cum in me, now! No? Come on, this can't be the one thing you don't do on command. Bastard!' With a sigh, she then begins rocking against his motionless body, rock steady beneath the dobie despite the fact that he's basically in the middle of a gymnastics bridge and she's got her full weight on his middle. Alexandra's hands move to her stomach, cupping the bulge the demon's cock creates there as she fucks herself on him. 'Once you get past the beginning, this thing doesn't even feel half bad inside you. Had a girlfriend who was a size queen and would have loved even the penetration. But really, fucking hell - can't you do something about his personality? Lobotomize the beast maybe?'";
	WaitLineBreak;
	project the figure of Alexandra_naked_icon;
	say "     Alexandra doesn't wait for you to reply, instead leaning forward on Brutus's chest and bracing herself with both paw-hands against the demon's rock-hard abs. Her breathing is coming more quickly now and she's grinding against him with increased vehemence, a clear sign that she's getting closer to where she wants to go. Sauntering around the two of them to look at the spot where their bodies meet, you see that she's not the only one, as Brutus's balls look even fuller than usual, brimming with cum to put into the bitch riding him. Alexandra might have forbidden him to talk, or move, but he's breathing quite heavy too and his eyes seem to burn with an inner fire. A high-pitched bark makes you look up again, seeing Alexandra throwing her head back and whining needily as she starts to gush femcum over Brutus's crotch. Her inner muscles must be trembling and flexing hard around the demon, as he joins her in orgasm just moments later, made obvious by the way her stomach swells as a cum-geyser erupts inside her.";
	say "     With throb after heavy throb, the former cop is filled up by her demonic partner, bathing her innermost chambers in his infernal seed. The large balls of your demon slave churn and twitch as he pumps a deluge of cum into the bitch riding him, making her belly swell visibly as it fills up more and more. Before long, it looks like she's already pregnant and ready to pop out a whole litter of pups, and further demon seed starts to squelch out around the purple shaft stretching open her pussy. Brutus stays silent and motionless, as ordered by Alexandra, yet by the twitches of his lips and other facial features, you can discern that he'd be bellowing in satisfaction if he could. That and possibly throwing some degrading words at Alexandra. The dobie rides out her orgasm impaled on his dick, finally sinking forward onto Brutus's chest to catch her breath, then pulls herself off his shaft. As the thick purple shaft slips out of Alexandra's stretched hole, a gush of cum accompanies it and soaks Brutus's chest.";
	WaitLineBreak;
	say "     Bracing herself against the demon's hip as she gets her legs under herself somewhat shakily, Alexandra looks at you and clears her throat. 'There, happy now? Really hope the bastard's brood takes root and you don't make me do this again! But right now, I need a break. Gonna go clean myself up!' She quickly goes to grab her discarded clothing, then pauses for a second as she seems to get an idea. 'Give me this one, alright?! Since I'm playing your puppy mill and all that,' the dobie says to you, followed by a barked command to Brutus. 'Stay just like that and do not move an inch for the next... hour or so. And don't you dare relax for one second!' After that, she strides off and quickly vanishes from sight [if Alexandra is in Grey Abbey Library]between some of the bookshelves[else if Alexandra is in Worker Barracks]in a side room[else]ERROR, LOCATION NOT SET[end if].";
	say "     This leaves you standing next to Brutus, with the demon holding a precarious gymnastics pose and his crotch and lower chest soaked in cum and female juices that are slowly drying on him. A low, growling sound is coming from the depths of his broad chest, telling you all you need to know about what he's thinking of the position he's in. Since Brutus already is filled with deadly loathing for you and anyone else who'd dare to control him, you shrug and simply allow Alexandra's complaint to play out. She's been a good little doggie, so why not let her have a bit of revenge.";
	now lastdobiemess is 89; [Brutus creamed her pussy]
	now AlexandraBrutusInteraction is 50; [last fuck for her was a rough one]
	impregAlexandraChance with "Brutus"; [chance to knock her up]
	NPCSexAftermath Alexandra receives "PussyFuck" from Brutus;

to say AlexandraBrutusBreedingThreesome:
	project the figure of Alexandra_clothed_icon;
	say "     Moving closer to the former cop that you made your breeding bitch, you cup one of her breasts with your hand and lightly pinch her nipple, drawing a shuddering breath from Alexandra. Your other hand moves to her hip, stroking the short fur of her side, followed by a demanding kiss of her muzzle. Even with her panties in a twist as she is right now, Alexandra still reacts positively to your touch, obedience to her [master] cemented in her innermost self since you broke and claimed her. Making out with your canine companion, you stroke and touch her body, feeding the fires of her arousal until they're well and truly lit. Going back and forth to suckle on her erect nipples, you make the bitch whimper and pant in need. Finally snaking a hand into her jeans, you dip two fingers into the dripping wet snatch of the anthro dog, making her gasp in pleasure as you curl your digits and rub her insides.";
	say "     With your fingers inside her and your thumb on the pleasure-button of her clit, you tell the horny canine that she doesn't have to worry about taking Brutus's girth on her own. You'll be with her all the way, temper his worst urges and take that thick cock right along your favorite dobie. Her answer is delivered in breathless pants and ecstatic barks, especially as you keep caressing her while she speaks, teasing Alexandra even as she speaks. 'God, boss! You're *nnnghhfffuuckkk!* one kinky [BodyName of Player in lower case]! Shit like this makes me glad I'm your bitch - your breeding bitch! *Oooh, do that again!*' You reward the former cop with some more stroking and touching, basically finger-fucking her for a little while before pulling out and presenting your hand for her to lick clean.";
	WaitLineBreak;
	say "     After slurping up her own juices like a good little bitch, she puts on a challenging expression and barks out, 'Sure he don't just wanna keep going, just the two of us? Hah, just kidding, I know you want to put that brute of a breeding stud into action!'";
	WaitLineBreak;
	project the figure of BrutusEvil_icon;
	say "     You give Alexandra a broad grin and tell her what a good dog she is, then add a command for her to strip and nod over to [if Alexandra is in Grey Abbey Library]one of the library sofas [else if Alexandra is in Worker Barracks]a somewhat worn sofa standing in one of the corners of the room, [else]ERROR, LOCATION NOT SET [end if]not too far away. As the doberwoman saunters towards it, drawing your eye with her wagging tail and enticingly swinging hips, you ";
	if demon brute is listed in companionList of Player: [already summoned]
		say "stroke the curve of your demontooth amulet and turn your head towards Brutus, the huge purple beast you have taken as your controlled slave. He's standing close by, his huge purple shaft erect and throbbing from the show he just witnessed. With a growling voice, he asks, 'Yes... [master]?' ";
	else: [not the active companion]
		say "grab your demontooth amulet tightly in your fist and murmur the magic words Nermine told you. Swirling purple mist flows out of the demon fang's sharp tip, then solidifies in the musclebound figure of your captive demon brute. The towering brute says in a growling voice, 'Yes... [master]?' ";
	say "Informing him that he'll get to breed both Alexandra as well as yourself puts a toothy grin on his face, which draws into a snarl as you add that he act on direct command and should keep any comments to himself. Having demoted him to basically just a walking sex toy and sperm donor with that last part, you slap the demon's ass playfully and tell him to follow.";
	say "     Flanked by the towering presence of your demon slave, you strut towards Alexandra, who is waiting for you in a half-reclined pose on the sofa, nude down to her short fur. The doberwoman is cupping one of her breasts, with the fingers of her other hand down between her legs and playing with the dripping wet folds of her sex. 'Ready when you are, boss!' she says enticingly, letting her tongue dangle out of her open muzzle and curling the tip as if she was licking something. You climb right onto the sofa as you reach it, moving on top of your canine bitch and drawing her close in a tight embrace. Meeting her in a kiss that escalates into a full making-out session, you feel her breasts pressing against your front. Before long, she's also lifting her hips to grind against you, creating some quite pleasurable sensations as her nether lips [if Player is male]rub your erection[else]brush against your own[end if].";
	WaitLineBreak;
	project the figure of Alexandra_naked_icon;
	say "     Having so much fun just kissing Alexandra and with her grinding against you, it takes a moment before you realize where the growling noise is coming from that starts a little while into your play: Brutus is still standing right next to the sofa, staring down at the two of you with hate-filled eyes and a massive, throbbing, purple cock standing proudly erect at crotch level. It is literally dripping with pre-cum, with another small spurt welling up from his cum-slit even as you watch. 'I was wondering how long I could keep you from remembering the fucker,' Alexandra says in a playful tone, raising her head to lick your neck and cheek. You give her breasts a grope in reply, then tell Brutus to kneel and pleasure both of you with his tongue. The controlled demon lets out an annoyed huff through his nose as he gets on the floor, then bends his horned head forwards.";
	say "     A moment later, you feel the touch of his warm tongue brush over your nether lips, licking a few times before he switches to Alexandra for a little while. The doberwoman enjoys his attention quite obviously, letting out a pleased bark and giving you a long french kiss right after that. Before long, the two of you are grinding your crotches against each other to share the demon's tongue and also feel each other's sex rubbing your own. Then suddenly, Alexandra stiffens in your arms and with a lewd groan, she starts getting really wet and dripping between her legs, climaxing from the stimulation. 'Fuuckkk,' she pants out between gasping breaths, a slightly embarrassed grin on her face. 'Coming without even getting a dick in me like some clueless virgin. What can I say, you feel nice boss, and our big bad down there isn't too bad with his tongue.'";
	WaitLineBreak;
	say "     With Alexandra still in the throes of her orgasm, you decide that she won't mind if you monopolize Brutus's attention for a little while and command him to get his tongue inside you, to pleasure and open up your pussy. The demon obeys with little more than a grumble, his slick appendage worming its way between your nether lips straight away. Then he's licking your inner passage, twitching the tip of his long tongue left and right to search for your most sensitive spots. Closing your eyes to concentrate on this pleasurable exploration, you feel him move inside you, then the large clawed hands of the demon on your thighs as he lifts you a little to drive his tongue even deeper. Soon you're panting and moaning from being tongue-fucked deeper than quite a few dicks would go. A pair of soft-furred paw-hands draws you back to reality, Alexandra taking your head in both hands and pulling it towards her own to kiss you.";
	say "     'That good, eh? You looked a bit out of it for a second there. Wanna share?' she asks in a playful tone, then licks your nose and wiggles her eyebrows. Weakly panting out for Brutus to switch to your canine partner for now, you are lowered again, then feel the ridges of the demon's horns pressing against your inner thighs and buttocks as he goes down on the doberwoman. She lets out a yipping bark as he starts to tongue-fuck her pussy, head lolling back from the pleasure that you felt just before. You look down at your dobie companion, naked and panting by your request, and can't help but feel quite satisfied at having claimed her as well as Brutus as your own. Squeezing Alexandra's breasts possessively and watching the play of her features through the sensations she's getting right now for a little while, you then command Brutus to take her pussy with his dick. The start of a dark chuckle reminds you to hastily add to the command to go only as hard as she wants him to, stopping the brute's more violent impulses in their tracks.";
	WaitLineBreak;
	say "     Feeling some movement behind yourself, you nevertheless keep your full attention on Alexandra herself. It doesn't seem she's realized yet what's coming next, as she's still lying back with her eyes closed, but that changes quickly before much longer. Her eyes shoot open as Brutus's dickhead touches her sex and presses in against it with its large girth, followed by an animalistic grunt as he penetrates her. Alexandra's arms whip forward reflexively and clutch onto your body in a tight embrace. 'Nngggaahhh! He's fucking big,' she pants into your ear, keeping her death-grip around your chest as more and more of that huge erection is slowly sunk into her body.' ";
	if Cunt Depth of Alexandra + 2 < Cock Length of demon brute: [standard values: 10 (+2 stretching allowance) vs 18]
		say "Even with the preparation of having Alexandra eaten out and pre-stretched by the tongue fuck, it takes a minute or so for Brutus to get much of his length into her. Then the demon pauses and you can feel a clawed finger on your shoulder, poking you impatiently. Turning your head to look back over your shoulder, you ask him what's up, rescinding your order of shutting him up for a moment.";
		if TwistedCapacity of Alexandra is false:
			say "     'Bitch's too small! Womb fuck her?' Brutus asks hopefully, his face showing a broad grin full of countless sharp teeth as he anticipates a chance to torture someone violently. You just look at him for a little while, making him wait and impatiently lick his, then shake your head and say that he may only go as deep as he is now. Leaving the demon to gnash his teeth and scowl, you turn back to your dobie bitch and stroke her hair in a gesture of affection. 'Had me worrying there for a second,' Alexandra tells you in a playful, teasing tone before adding, 'But you'd never do that to your favorite breeding bitch, would you boss? Treating me like a street bitch you just grab and fuck right in the open.' It's almost as if she's challenging you to do so and wanting to prove her status as the toughest canine around.";
		else:
			say "     'Bitch's too small! Womb fuck her?' he asks hopefully. You start to open your mouth to reply, but before you can do so Alexandra butts in with the words, 'I can take it, dick-for-brains! Just you see!' Chuckling about her defending her tough bitch status, you nod for Brutus to go ahead and he gives a sharp thrust, penetrating her the rest of the way easily. The demon growls, apparently feeling cheated since she didn't show any pained spasms and Alexandra growls at him, 'Told ya, you dumb brute!' You can hear his teeth grind against each other, followed by an outburst of, 'When I get free I'll disembowel you little bitch and make you eat -' You stop him short at that point, forbidding him from saying anything for the rest of your threesome. 'Yeah, more fucking less growling,' Alexandra adds to your commands for the demon, then kisses you eagerly.";
	else: [he actually fits into her]
		say "Even with the preparation of having Alexandra eaten out and pre-stretched by the tongue fuck, it takes a minute or three for Brutus to bottom out inside her, given that he has to pause when she calls out curse-filled commands for him to do so. You can literally feel him through her, from the cock bulging out her belly and pressing against yourself that way.";
		say "     'Damn, I still can't believe that such gigantic dicks now can fit into me,' Alexandra pants out in a somewhat strained voice, giving you a squeeze. 'Good thing that this new body seems to be so stretchy and adaptable, otherwise I wouldn't want to know how gaping and blown out my pussy would be before long. Not only from taking guys like your demon stud here but also pushing out a litter of puppies and all that.' Stroking the fur of Alexandra's back, you tell her that you agree about that and then add that she's just the bitch you always wanted to own. 'Busty, fuckable and ready to serve as your puppy mill? Damn boss, you're one kinky fucker!' the former cop replies and licks the side of your neck affectionately.";
	WaitLineBreak;
	say "     Raising your head, you call out for Brutus to start fucking Alexandra, and he begins to stroke his massive shaft in and out of her, moving at a fast pace that speaks of his own pent-up lust and frustration. You wonder for a second if you should have him slow down, but right then your sexy dobie calls out, 'Fuck yeah, take me hard you fucking beast!' She likes it rough apparently, which isn't too surprising given what she's been through with yourself. Settling in for making out with her and touching the bitch, you're right in the action, feeling every thrust by Brutus through the bump in her belly it creates. It is fun to share her experience of writhing in pleasure from the demon's fuck, and you can see that Alexandra is rapidly being pushed towards a second orgasm. Yet since you don't know if she could last for a third, you decide to give her a bit of a cool-down phase in which she can just ride her current high. With an eager flutter in your voice, you command Brutus to switch to your own pussy.";
	say "     The demon growls deeply, no doubt wanting to inflict some payback on you, but the amulet's binding mitigates what would have been a vicious thrust to nothing more but him pushing at your sex somewhat impatiently. ";
	if Cunt Depth of Player + 2 < Cock Length of demon brute and Player is not twistcapped: [player pussy depth (+2 stretching allowance) vs 18 - doesn't fit]
		say "Thanks to his expert prep-work earlier, your pussy is ready to stretch around his massive dickhead and Brutus can slide more of himself into you before eventually reaching the extent of what you can take. Given his binding's strictures on not actually being able to hurt you in any way, he stops right there and begins to fuck you just at this depth, giving you a wild ride even so. ";
	else: [he fits in the player - either naturally or through twisted capacity]
		say "Thanks to his expert prep-work earlier, your pussy is ready to stretch around his massive dickhead and Brutus can slide more of himself into you right away. It doesn't take long before the steady push makes him bottom out inside your body, with his weighty balls now pressing against your crotch too. 'Damn, I can feel his cock against my abs,' Alexandra says in a surprised tone from beneath you. 'Was it the same way with myself? Your pet really is a fucking monster in the dick department. A real fuckmonster, hah!' Brutus ignores her banter and your own moans and grunts and simply starts to fuck you in a wild ride. ";
	say "The thick purple shaft moving in and out of you is pleasantly warm, almost hot, which isn't too surprising given its owner's infernal descent. Besides this, the demon proves to be a quite good lover, with his shaft really hitting all the spots and him having the experience to use it well. As he drives your libido to new heights, you can't help but idly wonder how many victims he savaged with this dick to get so good, until you put a muzzle on his darker impulses and made him just pleasure Alexandra and you.";
	WaitLineBreak;
	say "     Enjoying the demon dicking for a little while, you eventually become aware of a hand moving between Alexandra and yourself. The dobie bitch is rubbing her clit with her fingers, showing that she's eager for some more loving. With a sigh, you command Brutus to stop and tell him to fuck your breeding bitch instead. The purple brute acts on this immediately, pulling out with a wet slurp and rams himself home into the canine underneath you, drawing a shocked gasp from her. Oops, seems like her asking for a hard fuck earlier allowed him some leeway there. Thankfully, the harsh entry doesn't stop Alexandra from enjoying the renewed fuck as they pick up right where they left it off earlier, with him deep-dicking her pussy again and again. You're so close to both of them that it almost feels like he's still fucking you too, maintaining your own state of high arousal right along theirs.";
	say "     The ecstatic three-way grinding between yourself, the doberwoman and the demon, quickly builds up towards a spectacular crescendo, with the sounds of sex echoing throughout the whole [if Alexandra is in Grey Abbey Library]library[else if Alexandra is in Worker Barracks]barracks[else]ERROR, LOCATION NOT SET[end if]. A high-pitched bark marks the beginning of the end, with Alexandra throwing her head back and whining needily as she starts to gush femcum over Brutus's and your own crotch. Her inner muscles must be trembling and flexing hard around the demon, as he joins her in orgasm just moments later, made obvious by the way her stomach swells as a cum-geyser erupts inside her, pumping a massive amount of infernal seed into her womb. With throb after heavy throb, the former cop is filled up by her demonic partner, bathing her innermost chambers in his infernal seed. The large balls of your demon slave churn and twitch as he pumps a deluge of cum into the bitch. Yet she isn't the only one you want bred right now, so you loudly call out for him to fill you too.";
	WaitLineBreak;
	say "     Reluctantly, Brutus pulls out of Alexandra, with a spurt of is seed splattering the pressed-together bellies of the bitch and yourself before he rams himself into your own stretched opening. Then you can feel the creamy whiteness of his cum bathe your insides in its warmth, with countless sperm starting the race to find an egg to impregnate. Fulfilling your plan of having the demon breed both your dobie bitch and yourself, the satisfaction you feel is enough to push you the last little step over the edge right along with the two of them, and you gasp in orgasm as your inner muscles start to twitch and tremble, milking more cum out of Brutus. Alexandra holds you in her arms as you come, making out with you happily and sharing your pleasure. The two of you caress and kiss for who knows how long, just riding out the sensations together and both feeling very nicely filled now.";
	say "     You stay entwined with Alexandra long enough for Brutus to actually recover his stamina for another go, and the demon starts to fuck into you again before you command him to stop and just go away for now. With a hostile grunt, he does just that, leaving you alone on the sofa with your dobie bitch. 'Well, that was fun. It's nicer with you being there with me, boss. But fuck am I sore down there, that dick is something else!' Alexandra remarks, then lightly pushes against your chest to make you rise a bit as she looks down. 'And look at that mess! He creamed us good, hah!' Reaching down to tough her stretched hole with a ginger touch, she jokingly adds, 'Man, it'll be a few hours till that's back to normal, even with the nanite thingies. Let's hope his brood takes, eh? Otherwise we'll have to have another go!' The kiss that follows tells you that she wouldn't be too opposed to doing so, not if you'll keep her company that time too.";
	now lastdobiemess is 89; [Brutus creamed her pussy]
	now AlexandraBrutusInteraction is 51; [last fuck for her was a shared, if rough one]
	impregAlexandraChance with "Brutus"; [chance to knock her up]
	NPCSexAftermath Alexandra receives "PussyFuck" from Brutus;
	NPCSexAftermath Player receives "PussyFuck" from Brutus;

to say AlexandraBrutus_UnchainedBreeding_Intro:
	if demon brute is listed in companionList of Player: [already summoned]
		say "     Turning your gaze to the side, you let your eyes wander over Brutus's towering form, packed with bulging muscles and a terrifying sight to behold, with his horns, spikes and the hate-filled scowl on his face. Yet despite all this, he's standing his usual spot as when you're traveling, docile thanks to the magic binding him. His loathing at the subservience is almost palpable, as is his desire to have sex, with the thick pillar of his manhood standing fully erect and dripping pre-cum on the ground. Growling as he tears his red-glowing eyes from giving you murderous looks, he focuses on Alexandra, his hand twitching as if to snatch her up and just rip the remaining clothes off her body. '[Master]?' he asks with an impatient growl, his erection throbbing and sending a spurt of pre flying to almost hit you in the leg.";
	else: [not the active companion]
		say "     A grin spreads across your face in response to Alexandra's needy begging and you raise your hand to close around the demontooth amulet. Reciting the tongue-breaker of a magical command phrase that Nermine taught you starts purple smoke to billow out of the very tip of the tooth, quickly improving in volume. Swirling away from you to a spot about ten feet ahead, the cloud becomes thicker and thicker until soon solidifying into the towering shape of your demonic slave Brutus. '[Master]?' the big, purple brute growls out in greeting, turning his horned head to look at you. Yet his usual hateful scowl slips a little as he sees Alexandra plastered against your front, panting audibly as you continue to finger-fuck her. Brutus's nostrils flare as he bends forwards and sniffs the air, followed by the aroused growl of, 'A [if Sterile of Alexandra is true]needy[else]fertile[end if] bitch to breed!' His huge cock throbs visibly, immediately starting to fill out and rising from the place where it was dangling between his muscled legs.";

to say AlexandraBrutus_UnchainedBreeding:
	say "     Somewhat reluctantly, you pull your fingers out of Alexandra and turn her around to face the demon she begged you for. Raising her head to look him in the eye, she lets out a challenging bark. 'Hey there, you big stupid brute! Time for you to do the one thing you're good for!' With an enraged bellow, Brutus snarls back, 'Fucking bitch, I'll make you bleed and suffer for eternity!' Alexandra laughs in his face and says, 'Yeah right, the boss's got you neutered in terms of killing and slicing, remember? Without that huge prick you'd just be a waste of space these days!' You can't help but raise your eyebrows at her goading him like that, especially since she knows he'll fuck her in mere moments. Seems like Alexandra really is into getting a harsh fuck, so you decide to indulge her and give the demon some specific orders for this occasion, softening his orders about not touching or hurting your companions to allow some more freedom - if they [italic type]ask[roman type] for it. He still isn't allowed any nonsexual violence, break skin or choke someone out though.";
	say "     'Let's get this party started!' Alexandra barks out in a throaty voice, swaying her hips left and right enticingly. She stretches her arms behind her back and wiggles her chest to slide off the leather jacket in a quite nice show of bouncing breasts that draws everyone's gaze. Throwing the garment aside, the dobie bitch then saunters up to Brutus, running her fingers lightly along the side of his shaft. 'Gotta give you that boss, you sure know how to choose your pets,' she adds casually, then licks over Brutus's dickhead and has a taste of his pre-cum. 'And who cares if he's dumb as a brick if he's virile enough for studding, eh?' With that insult still hanging in the air and Brutus wordless growls deepen in reply, Alexandra walks away from him about fifteen feet, then bends over forward to slide off her jeans all the way, giving both of you a prime view of the moist and dripping pussy between her legs.";
	WaitLineBreak;
	project the figure of BrutusEvil_icon;
	say "     Kicking aside her last piece of clothing, Alexandra turns her naked body towards Brutus once more, then calls out the challenge of, 'Show me what you can do with that cock of yours, beast!' Brutus bellows a furious shout that makes the [if Alexandra is in Grey Abbey Library]bookshelves[else if Alexandra is in Worker Barracks]walls[else]ERROR, LOCATION NOT SET[end if] shake and pounces on her, closing the distance in three large steps and wrapping the fingers of one clawed hand around her neck. The other hand closes around the base of his shaft, hefting it to hit the side of her muzzle with a meaty slap. Unimpressed, Alexandra glares up at him and barks out the words, 'What, you don't even know where to shove your prick, you - ghnnnggghh!' The thick purple schlong of your enraged demon slave chokes off any further insults, as Brutus forces it into her open muzzle. He simply shrugs off her response of hitting the side of his leg, barely noticing it. Moving his hand from her neck to behind the bitch's head, Brutus wrenches her deeper onto his length even as she makes choking noises, right until her nose is buried in his pubes.";
	say "     Even with the length of Alexandra's muzzle taken into account, it is clear that half his cock is down her throat, creating a visible bulge in the doberwoman's neck. 'Loudmouth bitch! This what you were asking for?!' Brutus growls darkly, then uses her as a living fleshlight for a moment, forcing her head up and down on his shaft. Cut off from life-sustaining oxygen, Alexandra's resistance to his manhandling begins to flag a little, at which point he's forced to wrench her off his erection so she can gasp for breath. While the former cop writhes in his grasp, dangling a foot off the ground, the towering demon brute gives the control amulet around your neck a hateful stare, then turns back to his canine victim. Lips peeling back from his frightening array of sharp fangs, Brutus pushes out his tongue and possessively licks over her breast, neck and cheek. 'You're mine now, slut! Gonna fuck you till you break! Your holes will be wrecked for good!'";
	WaitLineBreak;
	say "     The gasping pants of Alexandra as she takes in gulps of air lead over to somewhat breathless laughter, with her mockingly throwing at him, 'Still don't get it, dumbfuck? Those nanite thingies make us adapt and fix things, good or better than before. Your 'death fuck from hell' is just some spicy sex now that I learned to get into!' Brutus scowls at those words, followed by him thrusting her whole body down against his hips, impaling her on his cock with the sudden move. ";
	if Cunt Depth of Alexandra + 2 < Cock Length of demon brute: [standard values: 10 (+2 stretching allowance) vs 18]
		say "The enormous demonic shaft thankfully is slick with his pre and Alexandra is more than wet enough for sex too, allowing him to actually penetrate her all the way, right past her inner barrier. [if TwistedCapacity of Alexandra is false]Her body spasms hard from the sudden penetration and the shock of him popping past her cervix, his prick pressing into her womb[else]Her body spasms from the sudden penetration, even though her cervix stretches readily to allow his entrance into her womb[end if].";
		if TwistedCapacity of Alexandra is false:
			increase Cunt Depth of Alexandra by 1; [oversized fucks stretch characters bit by bit]
	else: [he actually fits into her]
		say "The enormous demonic shaft thankfully is slick with his pre and Alexandra is more than wet enough for sex too, allowing him to actually penetrate her all the way, pressing deep into her yielding pussy. Her body spasms hard from the sudden penetration, even though she's able to take all of him easily, inner walls stretching snug around his thick purple length.";
	say "     Fingers curling to rake Brutus with her claws as she is violated in this way, Alexandra leaves scratches of dark purple blood on the sides and back of the demon, not that he notices in any way. No, the demon simply howls in satisfaction, looking down at the obscene bulge his dickhead creates in her stomach. He begins to fuck into her with powerful thrusts, making her belly waver between flat and almost pregnant-looking again and again. The former cop is far beyond being able to speak at the moment, with each of his thrusts literally driving the air out of her lungs as she is flopped around by the force, but you still believe you can see a smile curling up the corners of her mouth. Brutus growls and bends his neck to attack her breasts too, catching one between his teeth and gnawing at it while licking, since he literally can't bite down due to your orders. As he does so, Alexandra lets out a definite aroused yip, proving that she's truly enjoying this treatment.";
	WaitLineBreak;
	say "     Almost as if to prove that he still has the power to destroy a mortal with nothing but sex, Brutus keeps railing Alexandra with all his power, filling the [if Alexandra is in Grey Abbey Library]library[else if Alexandra is in Worker Barracks]barracks[else]ERROR, LOCATION NOT SET[end if] with grunts, growls and the loud slap of his balls against her naked body. He's fucking the bitch like a beast in rut, doing all he can to really punish her with his monstrous erection, which soon strains even the impressive stamina of a demon brute just as him. With the volume of his bellows suddenly having a sharp spike, he slams Alexandra down on his prick and thrusts his hips forward hard, at which point you can see her belly bulge even further as the first massive gush of his seed erupts into her. Throb after throb of cum blasts into the former cop, bathing her innermost self in his infernal seed, which swarms to find her eggs and impregnate the bitch. She apparently isn't foo far behind either, as the dobie starts to gush femcum over Brutus's crotch as he begins to fill her.";
	say "     Groping her body roughly, licking and lightly biting, Brutus keeps rocking Alexandra against his crotch like a huge fleshlight, enjoying his time as he breeds her. With the deluge of cum that his grapefruit-sized, purple balls are able to put out, she already looks more than pregnant right now, her belly swollen and round. 'Fuck yeah!' Alexandra eventually exclaims as she comes down from her own high, laying a hand on her swollen belly and smiling to herself, then throwing you a broad grin. 'Just what I needed, and hopefully the beginning of your next litter of pups. Let's hope they have my smarts and not his, eh?' Brutus shows his teeth and growls, to which she rolls her eyes and barks, 'Oh, shut up and stand still for a moment, will ya?' Amused by her antics, you casually hook a finger under the leather band of your amulet and call out for Brutus to obey.";
	WaitLineBreak;
	say "     As the muscle-packed purple brute freezes in motion, Alexandra starts to writhe out of his grasp, first grabbing his broad chest as she starts to slide up on his erection, then reaching up to use his horns as handholds. Getting her legs pulled in from where they were limply dangling around his hips and bracing her paws on his thighs, she pulls herself up till just the thick head of his cock is inside her, then looks into his eyes and gives Brutus an amused grin. 'I have no idea how you can think that you'd 'break me', you idiot. Remember all the times we fucked before? I've had litters of your spawn inside me multiple times! They came out of this snatch too, ya know! Hard to teach a dumb demon brute new ticks I guess, but let's try at least.' With that said, she stands up fully in a quick move, pulling off his erection that keeps all of the cum stoppered up inside her.";
	say "     Laughing, Alexandra leans her body forward and makes sure that the first big gush of fluid splashes Brutus's chest, after which she pushes her crotch right into his face. 'Look at it!' the bitch demands from her fucker as his load starts to leak out of her sex and trickle over the tip of his nose. He crosses his eyes to do so and Alexandra uses a finger to trace the slick and goopy folds of her nether lips. 'This look destroyed to you, asshole? Told ya, good as before. Your times of gaping poor victims are over. But I guess it's not in your nature to stop trying, eh? Some stupid is just too fix.' Smirking, she dips a finger into the cum and draws the letter 'D' onto Brutus's forehead. 'I look forward to next time with ya, doofus. Your rage-fucks are a blast,' she adds in a mocking tone, then climbs down on top of him. Alexandra saunters over while swaying her hips and making sure to show off her cum-stained and sweat-matted fur to you. 'Liked the show, boss? I sure had fun giving it!'";
	now lastdobiemess is 89; [Brutus creamed her pussy]
	impregAlexandraChance with "Brutus"; [chance to knock her up]
	NPCSexAftermath Alexandra receives "PussyFuck" from Brutus;

to say AlexandraBrutus_UnchainedBreedingThreesome:
	project the figure of Alexandra_clothed_icon;
	say "     With your fingers inside her and your thumb on the pleasure-button of her clit, you tell the horny canine that she doesn't have to worry about taking Brutus's girth on her own. You'll be with her all the way and take that thick cock right along your favorite dobie. Her answer is delivered in breathless pants and ecstatic barks, especially as you keep caressing her while she speaks, teasing Alexandra even as she speaks. 'God, boss! You're *nnnghhfffuuckkk!* one kinky [BodyName of Player in lower case]! Shit like this makes me glad I'm your bitch - your breeding bitch! *Oooh, do that again!*' You reward the former cop with some more stroking and touching, basically finger-fucking her for a little while before pulling out and presenting your hand for her to lick clean. After slurping up her own juices like a good little bitch, she puts on a challenging expression and barks out, 'Sure he don't just wanna keep going, just the two of us? Hah, just kidding, I know you want to put that brute of a breeding stud into action!'";
	say "     You give Alexandra a broad grin and tell her what a good dog she is, then add a command for her to strip and nod over to [if Alexandra is in Grey Abbey Library]one of the library sofas [else if Alexandra is in Worker Barracks]a somewhat worn sofa standing in one of the corners of the room, [else]ERROR, LOCATION NOT SET [end if]. As the doberwoman saunters towards it, drawing your eye with her wagging tail and enticingly swinging hips, you ";
	if demon brute is listed in companionList of Player: [already summoned]
		say "stroke the curve of your demontooth amulet and turn your head towards Brutus, the huge purple beast you have taken as your controlled slave. He's standing close by, his huge purple shaft erect and throbbing from the show he just witnessed. With a growling voice, he asks, 'Yes... [master]?' ";
	else: [not the active companion]
		say "grab your demontooth amulet tightly in your fist and murmur the magic words Nermine told you. Swirling purple mist flows out of the demon fang's sharp tip, then solidifies in the musclebound figure of your captive demon brute. The towering brute says in a growling voice, 'Yes... [master]?' ";
	say "Informing him that he'll get to breed both Alexandra as well as yourself puts a toothy grin on his face, which draws into a snarl as you add that he still isn't allowed any nonsexual violence, break skin or choke someone out. Since like Alexandra really is into getting a harsh fuck, you decide to indulge her and add some specific orders for this occasion, softening his orders to allow some more freedom - if they [italic type]ask[roman type] for it. Brutus may be grumbling as usual, but with his thick cock in plain view and obviously hard as a rock, you have no worries at all that he'll perform.";
	WaitLineBreak;
	project the figure of Alexandra_naked_icon;
	say "     Flanked by the towering presence of your demon slave, you strut towards Alexandra, who is waiting for you in a half-reclined pose on the sofa, nude down to her short fur. The doberwoman is cupping one of her breasts, with the fingers of her other hand down between her legs and playing with the dripping wet folds of her sex. 'Ready when you are, boss!' she says enticingly, letting her tongue dangle out of her open muzzle and curling the tip as if she was licking something. You climb right onto the sofa as you reach it, moving on top of your canine bitch and drawing her close in a tight embrace. Meeting her in a kiss that escalates into a full making-out session, you feel her breasts pressing against your front. Before long, she's also lifting her hips to grind against you, creating some quite pleasurable sensations as her nether lips [if Player is male]rub your erection[else]brush against your own[end if].";
	say "     Having so much fun just kissing Alexandra and with her grinding against you, it takes a moment before you realize where the growling noise is coming from that starts a little while into your play: Brutus is still standing right next to the sofa, staring down at the two of you with hate-filled eyes and a massive, throbbing, purple cock standing proudly erect at crotch level. It is literally dripping with pre-cum, with another small spurt welling up from his cum-slit even as you watch. 'I was wondering if I'd have to remind you of our purple breeding stud. My pussy is itching to be filled by him,' Alexandra says in a playful tone, raising her head to lick your neck and cheek. You give her breasts a grope in reply, then tell Brutus to kneel and pleasure both of you with his tongue. The controlled demon lets out an annoyed huff through his nose as he gets on the floor, then bends his horned head forwards.";
	WaitLineBreak;
	say "     A moment later, you feel the touch of his warm tongue brush over your nether lips, licking a few times before he switches to Alexandra for a little while. The doberwoman enjoys his attention quite obviously, letting out a pleased bark and giving you a long French kiss right after that. Before long, the two of you are grinding your crotches against each other to share the demon's tongue and also feel each other's sex rubbing your own. Then suddenly, Alexandra stiffens in your arms and with a lewd groan, she starts getting really wet and dripping between her legs, climaxing from the stimulation. 'Fuuckkk,' she pants out between gasping breaths, a slightly embarrassed grin on her face. 'Coming without even getting a dick in me like some clueless virgin. What can I say, you feel nice boss, and our big bad down there isn't too bad with his tongue.'";
	say "     With Alexandra still in the throes of her orgasm, you decide that she won't mind if you monopolize Brutus's attention for a little while and command him to get his tongue inside you, to pleasure and open up your pussy. The demon obeys with little more than a grumble, his slick appendage worming its way between your nether lips straight away. Then he's licking your inner passage, twitching the tip of his long tongue left and right to search for your most sensitive spots. Closing your eyes to concentrate on this pleasurable exploration, you feel him move inside you, then the large clawed hands of the demon on your thighs as he lifts you a little to drive his tongue even deeper. Soon you're panting and moaning from being tongue-fucked deeper than quite a few dicks would go. A pair of soft-furred paw-hands draws you back to reality, Alexandra taking your head in both hands and pulling it towards her own to kiss you.";
	WaitLineBreak;
	say "     'That good, eh? You looked a bit out of it for a second there. Wanna share?' she asks in a playful tone, then licks your nose and wiggles her eyebrows. Weakly panting out for Brutus to switch to your canine partner for now, you are lowered again, then feel the ridges of the demon's horns pressing against your inner thighs and buttocks as he goes down on the doberwoman. She lets out a yipping bark as he starts to tongue-fuck her pussy, head lolling back from the pleasure that you felt just before. You look down at your dobie companion, naked and panting by your request, and can't help but feel quite satisfied at having claimed her as well as Brutus as your own. Squeezing Alexandra's breasts possessively and watching the play of her features through the sensations she's getting right now for a little while, you then tell her that she can command Brutus to give her what she really wants.";
	say "     'Thanks boss! I've been waiting to have that fucker stretch my pussy again. Hear that you dumb brute? Fuck my pussy with everything you got!' A dark chuckle behind you accompanies the corner of the eye impression of Brutus stretching himself up, giving a tooth-filled grin at you and Alexandra. Turning your attention back to Alexandra, you watch her lying before you on her back, cupping and pinching her breasts in anticipation. Her eyes open wide as Brutus's dickhead touches her sex and presses in against it with its large girth, followed by an animalistic grunt as he penetrates her. Alexandra's arms whip forward reflexively and clutch onto your body in a tight embrace. 'Nngggaahhh! That cock fills me really nice,' she pants into your ear, keeping her death-grip around your chest as more and more of that huge erection is shoved into her body.'";
	WaitLineBreak;
	if Cunt Depth of Alexandra + 2 < Cock Length of demon brute: [standard values: 10 (+2 stretching allowance) vs 18]
		say "     Even with the preparation of having Alexandra eaten out and pre-stretched by the tongue fuck, she thrashes under you as his length and girth force her insides to stretch around him. ";
		if TwistedCapacity of Alexandra is false:
			say "'You asked for it bitch! Gonna womb-fuck you!' Brutus growls gleefully and bucks into the dobie hard. Alexandra writhes in shock at the sudden deep penetration, her fingers tightly gripping your arms. 'Fucking brutal bastard!' she snarls, but her expression betrays some pleasure too, as the anthro's tongue is dangling out the side of her mouth in lusty pants. 'He's an asshole, but he fills me so good! And your favorite breeding bitch is tough enough to take him, boss!'";
		else:
			say "'You asked for it bitch! Gonna womb-fuck you!' Brutus growls gleefully, with Alexandra immediately shouting back, 'I can take it, dick-for-brains! Just you see!' Chuckling about her defending her tough bitch status, you watch the demon give a sharp thrust in reply, penetrating her the rest of the way easily. The demon growls, apparently feeling cheated since she didn't show any pained spasms and Alexandra growls at him, 'Told ya, you dumb brute!' You can hear his teeth grind against each other, followed by an outburst of, 'When I get free I'll disembowel you little bitch and make you eat -' You stop him short at that point, forbidding him from saying anything for the rest of your threesome. 'Yeah, more fucking less growling,' Alexandra adds to your commands for the demon, then kisses you eagerly.";
	else: [he actually fits into her]
		say "Even with the preparation of having Alexandra eaten out and pre-stretched by the tongue fuck, it seems improbable that Brutus's huge cock will fit into her - but he doesn't really care and just hammers into her harshly. You can literally feel him through her, from the cock bulging out her belly and pressing against yourself that way. 'Damn, I still can't believe that such gigantic dicks now can fit into me,' Alexandra pants out in a somewhat strained voice, giving you a squeeze. 'Good thing that this new body seems to be so stretchy and adaptable, otherwise I wouldn't want to know how gaping and blown out my pussy would be before long. Not only from taking guys like your demon stud here but also pushing out a litter of puppies and all that.' Stroking the fur of Alexandra's back, you tell her that you agree about that and then add that she's just the bitch you always wanted to own. 'Busty, fuckable and ready to serve as your puppy mill? Damn boss, you're one kinky fucker!' the former cop replies and licks the side of your neck affectionately.";
	say "     Letting out a growl that seems to reject the shared intimacy between you and your bitch, Brutus starts fucking Alexandra in earnest, stroking his massive shaft in and out of her, moving at a fast pace that speaks of his own pent-up lust and frustration. You wonder for a second if you should have him slow down, but right then your sexy dobie calls out, 'Fuck yeah, take me hard you fucking beast!' She likes it rough after all, with this being just one of a series of fucks that you've arranged between Brutus and herself. Settling in for making out with her and touching the bitch, you're right in the action, feeling every thrust by Brutus through the bump in her belly it creates. It is fun to share her experience of writhing in pleasure from the demon's fuck, and you can see that Alexandra is rapidly being pushed towards a second orgasm. Yet since you don't know if she could last for a third, you decide to give her a bit of a cool-down phase in which she can just ride her current high. With an eager flutter in your voice, you command Brutus to switch to your own pussy.";
	WaitLineBreak;
	say "     The demon growls deeply, no doubt wanting to inflict some payback on you, but the amulet's binding mitigates what would have been a vicious thrust to nothing more but him pushing at your sex somewhat impatiently. ";
	if Cunt Depth of Player + 2 < Cock Length of demon brute and Player is not twistcapped: [player pussy depth (+2 stretching allowance) vs 18 - doesn't fit]
		say "Thanks to his expert prep-work earlier, your pussy is ready to stretch around his massive dickhead and Brutus can slide more of himself into you before eventually reaching the extent of what you can take. Given his binding's strictures on not actually being able to hurt you in any way, he stops right there and begins to fuck you just at this depth, giving you a wild ride even so. ";
	else: [he fits in the player - either naturally or through twisted capacity]
		say "Thanks to his expert prep-work earlier, your pussy is ready to stretch around his massive dickhead and Brutus can slide more of himself into you right away. It doesn't take long before the steady push makes him bottom out inside your body, with his weighty balls now pressing against your crotch too. 'Damn, I can feel his cock against my abs,' Alexandra says in a surprised tone from beneath you. 'Was it the same way with myself? Your pet really is a fucking monster in the dick department. A real fuckmonster, hah!' Brutus ignores her banter and your own moans and grunts and simply starts to fuck you in a wild ride. ";
	say "The thick purple shaft moving in and out of you is pleasantly warm, almost hot, which isn't too surprising given its owner's infernal descent. Besides this, the demon proves to be a quite good lover, with his shaft really hitting all the spots and him having the experience to use it well. As he drives your libido to new heights, you can't help but idly wonder how many victims he savaged with this dick to get so good, until you put a muzzle on his darker impulses and made him just pleasure Alexandra and you.";
	WaitLineBreak;
	say "     Enjoying the demon dicking for a little while, you eventually become aware of a hand moving between Alexandra and yourself. The dobie bitch is rubbing her clit with her fingers, showing that she's eager for some more loving. With a sigh, you command Brutus to stop and tell him to fuck your breeding bitch instead. The purple brute acts on this immediately, pulling out with a wet slurp and rams himself home into the canine underneath you, drawing a shocked gasp from her. Thankfully, the harsh entry doesn't stop Alexandra from enjoying the renewed fuck as they pick up right where they left it off earlier, with him deep-dicking her pussy again and again. You're so close to both of them that it almost feels like he's still fucking you too, maintaining your own state of high arousal right along theirs.";
	say "     The ecstatic three-way grinding between yourself, the doberwoman and the demon, quickly builds up towards a spectacular crescendo, with the sounds of sex echoing throughout the whole [if Alexandra is in Grey Abbey Library]library[else if Alexandra is in Worker Barracks]barracks[else]ERROR, LOCATION NOT SET[end if]. A high-pitched bark marks the beginning of the end, with Alexandra throwing her head back and whining needily as she starts to gush femcum over Brutus's and your own crotch. Her inner muscles must be trembling and flexing hard around the demon, as he joins her in orgasm just moments later, made obvious by the way her stomach swells as a cum-geyser erupts inside her, pumping a massive amount of infernal seed into her womb. With throb after heavy throb, the former cop is filled up by her demonic partner, bathing her innermost chambers in his infernal seed. The large balls of your demon slave churn and twitch as he pumps a deluge of cum into the bitch. Yet she isn't the only one you want bred right now, so you loudly call out for him to fill you too.";
	WaitLineBreak;
	say "     Reluctantly, Brutus pulls out of Alexandra, with a spurt of is seed splattering the pressed-together bellies of the bitch and yourself before he rams himself into your own stretched opening. Then you can feel the creamy whiteness of his cum bathe your insides in its warmth, with countless sperm starting the race to find an egg to impregnate. Fulfilling your plan of having the demon breed both your dobie bitch and yourself, the satisfaction you feel is enough to push you the last little step over the edge right along with the two of them, and you gasp in orgasm as your inner muscles start to twitch and tremble, milking more cum out of Brutus. Alexandra holds you in her arms as you come, making out with you happily and sharing your pleasure. The two of you caress and kiss for who knows how long, just riding out the sensations together and both feeling very nicely filled now.";
	say "     You stay entwined with Alexandra long enough for Brutus to actually recover his stamina for another go, and the demon starts to fuck into you again before you command him to stop and just go away for now. With a hostile grunt, he does just that, leaving you alone on the sofa with your dobie bitch. 'Well, that was fun. Being right in your arms while he knocks me up. Little bit sore down below, but it's worth the pain. That dick is something else!' Alexandra remarks, then lightly pushes against your chest to make you rise a bit as she looks down. 'And look at that mess! He creamed us good, hah!' Reaching down to tough her stretched hole with a ginger touch, she jokingly adds, 'Man, it'll be a few hours till that's back to normal, even with the nanite thingies. Let's hope his brood takes, eh? Otherwise we'll have to have another go!' The kiss that follows tells you that she wouldn't be too opposed to doing so, not if you'll keep her company that time too.";
	now lastdobiemess is 89; [Brutus creamed her pussy]
	impregAlexandraChance with "Brutus"; [chance to knock her up]
	NPCSexAftermath Alexandra receives "PussyFuck" from Brutus;
	NPCSexAftermath Player receives "PussyFuck" from Brutus;

Section 2 - Farmhands

Definition: A person (called x) is BarracksSlut:
	if "Barracks Slut" is listed in Traits of x, yes;
	no;

Definition: A person (called x) is SupervisedBreeder:
	if "Supervised Breeding" is listed in Traits of x, yes;
	no;

after going to Worker Barracks while (HP of Alexandra is 2 or HP of Alexandra is 4 and "Barracks Slut" is listed in Traits of Alexandra and AlexandraFarmhandEventCooldown - turns > 3 and a random chance of 3 in 4 succeeds): [Alexandra is NOT pregnant, has been made the barracks slut, hasn't been fucked in 3 turns, 75% chance]
	try looking;
	let randomnumber be a random number from 1 to 6;
	if randomnumber is:
		-- 1:
			say "     As you enter the building, your attention is immediately drawn to the other end of the main room, where you can see the towering form of an anthro Clydesdale stud outlined against the back wall. The large horseman is completely naked, allowing you to see the muscles moving under his slightly sweat-matted coat as he pumps his hips back and forth, accompanied by moans and barks in a familiar voice. Looking a bit closer, you see Alexandra's long, slender legs wrapped around his hips, while her leather-clad arms are pinned against the wall by his strong hands. 'Harder, you bastard! Yeah, just like that!' the former cop calls out between her gasps of pleasure, making it clear that she's enjoying herself quite a bit. For a moment you just stare at the action going on right in the open, before registering the rest of your surroundings, which is filled with several further equines - sitting at the table, leaning against walls or just standing around, all of whom are watching the pair fucking in front of them.";
			say "     Barely taking his eyes off the show, one of the men nearest to yourself comments, 'Quite the fuckpuppy you dropped off with us, [sir]. This is the third guy she's taking in a row!' Chuckling, he nods to two nearby beds in which you can see naked farmhands stretched out on their backs, 'recuperating' after a round with your dobie bitch. Still half-hard, one of the guys has a small cum-puddle on his abs, apparently being too worn out to clean himself up right now. 'Everyone's waiting around to be picked next,' your neighbor states, 'Sure hope it's me. I had to promise Karel quite a thing to trade his grass-cutting shift with me.' An urgent bark draws your attention fully back to Alexandra and her equine stud, who by now is franticly thrusting into her wet snatch, grunting deeply as he gets closer and closer to orgasm.";
			say "[AlexandraFarmhandStandingFuckMenu]";
		-- 2:
			say "[AlexandraFarmhandGroupSuck_Nopreg]";
		-- 3:
			say "[AlexandraFarmhandCunni]";
		-- 4:
			say "[AlexandraFarmhandDripping]";
		-- 5:
			say "[AlexandraFarmhandJerking]";
		-- 6:
			say "[AlexandraFarmhandCumStuffed]";
	now AlexandraFarmhandEventCooldown is turns;

after going to Worker Barracks while (HP of Alexandra is 3 or HP of Alexandra is 5 and "Barracks Slut" is listed in Traits of Alexandra and AlexandraFarmhandEventCooldown - turns > 3 and a random chance of 3 in 4 succeeds): [Alexandra IS pregnant, has been made the barracks slut, hasn't been fucked in 3 turns, 75% chance]
	try looking;
	let randomnumber be a random number from 1 to 3; [so far there is only one walk-in option]
	if randomnumber is:
		-- 1:
			say "[AlexandraFarmhandGroupSuck_Preg]";
		-- 2:
			say "[AlexandraFarmhandCunni]";
		-- 3:
			say "[AlexandraFarmhandJerking]";
	now AlexandraFarmhandEventCooldown is turns;

after going to Worker Barracks while (HP of Alexandra is 2 or HP of Alexandra is 4 and "Supervised Breeding" is listed in Traits of Alexandra and AlexandraFarmhandEventCooldown - turns > 3 and a random chance of 1 in 2 succeeds): [Alexandra is NOT pregnant, has been told you'll supervise breeding, hasn't been fucked in 3 turns, 50% chance]
	try looking;
	let randomnumber be a random number from 1 to 3; [so far there is only one walk-in option]
	if randomnumber is:
		-- 1:
			say "[AlexandraFarmhandGroupSuck_Preg]";
		-- 2:
			say "[AlexandraFarmhandCunni]";
		-- 3:
			say "[AlexandraFarmhandJerking]";
	now AlexandraFarmhandEventCooldown is turns;

after going to Worker Barracks while (HP of Alexandra is 3 or HP of Alexandra is 5 and "Supervised Breeding" is listed in Traits of Alexandra and AlexandraFarmhandEventCooldown - turns > 3 and a random chance of 1 in 2 succeeds): [Alexandra IS pregnant, has been told you'll supervise breeding, hasn't been fucked in 3 turns, 50% chance]
	try looking;
	let randomnumber be a random number from 1 to 3; [so far there is only one walk-in option]
	if randomnumber is:
		-- 1:
			say "[AlexandraFarmhandGroupSuck_Nopreg]";
		-- 2:
			say "[AlexandraFarmhandCunni]";
		-- 3:
			say "[AlexandraFarmhandJerking]";
	now AlexandraFarmhandEventCooldown is turns;


to say AlexandraFarmhandCumStuffed: [player just walks in on a sleeping Alexandra, and she's a cummy mess]
	[she's been fucked by Nelson, the twins and multiple horsemen even before the scene]
	impregAlexandraChance with "Nelson";
	impregAlexandraChance with "Karel";
	impregAlexandraChance with "Isaac";
	impregAlexandraChance with "Farmhand Horseman";
	impregAlexandraChance with "Farmhand Horseman";
	say "     As you enter the building, you pass a Clydesdale Stud with a well-satisfied smile on his face, touching his hat as he gives you a respectful nod. There are more horsemen inside, hanging around with some playing cards, and others are just wandering out from the shower room in the back, towels wrapped around their hips and coats all shiny with moisture. Then one of the men notices that you came in and gives a cheer, which is quickly joined by pretty much everyone else present. The source of their good spirits becomes quickly apparent as you let your gaze sweep over the room: a familiar brown and black furred form lies stretched out on a nearby bunk bed, and she's quite a sight! Alexandra is completely naked and dozing in what appears to be content exhaustion, her fur plastered to the sexy bitch's skin from all the cum she's drenched in!";
	say "     Your breeding bitch's legs are spread, showing the still gaping opening of her pussy, with strings of cum connecting her nether lips and more of the creamy fluid leaking out slowly at the bottom. Looks like the guys really gave her a workout, and it's almost guaranteed that some of that sperm put a litter in her! You can't help but smile at this result of your plans for the woman, thinking back to the prim and proper police officer you encountered in the streets of the city not all that long ago. Now she's your bad-ass bitch... and puppy mill, putting out for the whole barracks for horny farmhands! Feasting your eyes on Alexandra and imagining her belly swelling soon with the results of the gangbang she was just in, you can year some of the guys chat about how good she felt, and what they'll do next time.";
	say "[AlexandraFarmhandCumStuffedMenu]";

to say AlexandraFarmhandCumStuffedMenu:
	LineBreak;
	now sextablerun is 0;
	blank out the whole of table of fucking options;
	say "     [bold type]Seeing that Alexandra is right there before you, naked and available, do you want to do anything yourself?[roman type][line break]";
	[]
	choose a blank row in table of fucking options;
	now title entry is "Eat her out";
	now sortorder entry is 1;
	now description entry is "Sample the potent mixture leaking from the bitch, and give her one more orgasm";
	[]
	if player is male:
		choose a blank row in table of fucking options;
		now title entry is "Get some sloppy seconds";
		now sortorder entry is 2;
		now description entry is "Churn the cum in her snatch up with your own contribution";
	[]
	choose a blank row in table of fucking options;
	now title entry is "Just let her rest";
	now sortorder entry is 3;
	now description entry is "She's had enough of a workout for now";
	[]
	sort the table of fucking options in sortorder order;
	repeat with y running from 1 to number of filled rows in table of fucking options:
		choose row y from the table of fucking options;
		say "[link][y] - [title entry][as][y][end link][line break]";
	while sextablerun is 0:
		say "Pick the corresponding number> [run paragraph on]";
		get a number;
		if calcnumber > 0 and calcnumber <= the number of filled rows in table of fucking options:
			now current menu selection is calcnumber;
			choose row calcnumber in table of fucking options;
			say "[title entry]: [description entry]?";
			if Player consents:
				let nam be title entry;
				now sextablerun is 1;
				if (nam is "Eat her out"):
					say "[AlexandraFarmhandCumStuffed_EatOut]";
				else if (nam is "Get some sloppy seconds"):
					say "[AlexandraFarmhandCumStuffed_Fuck]";
				else if (nam is "Just let her rest"):
					say "[AlexandraFarmhandCumStuffed_Rest]";
				wait for any key;
		else:
			say "Invalid Option. Pick between 1 and [the number of filled rows in the table of fucking options] or 0 to exit.";
	clear the screen and hyperlink list;

to say AlexandraFarmhandCumStuffed_EatOut:
	say "     Feeling a little kinky yourself right now, you [if player is not naked]slip out of your clothing and gear, [else]take off your gear [end if]and pile it up on the neighboring bed so it doesn't get dirty, then step up to here Alexandra is lying. You can see from the corner of your eyes that this is drawing some attention from the gathered farmhands, several of which casually move to better positions for watching you. Climbing onto the bed, you feel some wet spots from where stray shots of cum landed not too long ago, another proof if the virility of the many horny men you've sent your bitch here to serve. As you lower yourself on all fours between Alexandra's legs, the scent of sex suffuses your nostrils: lots and lots of cum, with some clean sweat to go with it. Brushing your hands along the mostly matted fur of the doberwoman's thighs, you spread them some more, making room for you to go down on her.";
	say "     Lowering your head to Alexandra's crotch, you stick out your tongue and play its tip over the nub of her clit, tasting her and the horseman cum sticking to your bitch. The anthro starts to stir a little at the touch, then more when you continue to lap at the pleasure-button, drawing her out of the depths of fucked-out stupor. Escalating to planting your lips over the dobie's clit and sucking on it hard, you can hear a groggy, 'Nnnhh? Fuuck, you guys... are... insatiable!' One of her paw-hands moves to feel around, coming to rest on your head as the bitch slurs the words, 'Yyeah, that-that's good!' You're only to happy to keep going, mixing things up a little by adding some long licks up from the base of her pussy, tongue scooping up some of the fertile sperm leaking from her and pushing it back in as you trace your tongue over her open folds, then return to the clit and service it some more.";
	WaitLineBreak;
	say "     Alexandra lets out needy moans and whines as she writhes on the mattress, acting like the sexy bitch you always wanted to call your own. Some might call this nanite plague an apocalypse, but you can't help but think that it's also a fucking good time! Eating out the freshly bred ex-cop and slurping the mixed loads of at least a dozen men that are churned up inside her, you can only imagine how much more of that potent, creamy cum is in her womb - millions of sperm hunting down eggs to burrow into. Over the sounds of yourself and Alexandra, you distantly register some of the men cheering you on, a reminder that you're giving them a show too. Only spurred on by this, you intensify your attention for the anthro's canine pussy, now going back to suckling on her clit full time and using your fingers to delve between her nether lips, wiggling them around in her slick insides.";
	say "     With your relentless stimulation, it doesn't take all that much longer before you push Alexandra into another orgasm, with her letting out a long, high-pitched whine as she bucks her hips up against your face. You can feel her insides spasm and flex around your fingers, sending a fresh gush of horseman cum to splurge over your hand and forearm. Continuing to go at it while the bitch rides out the height of her pleasure, you draw more moans and some almost animalistic sounds from her before the end, making it a fun little time for the both of you. When Alexandra eventually winds down, you then move forward into a position half beside her, coming into full view for the panting bitch for the first time since you started going down on her. 'Oh, hey boss! Y-you just did that?! T'was so good!' She smiles in exhausted satisfaction, and you can see that her energy is flagging, now that she got off. 'Gotta say, staying here with all these guys sure is... iss a workout...' are the last words she manages to say before dozing off again.";
	NPCSexAftermath Player receives "OralPussy" from Alexandra;

to say AlexandraFarmhandCumStuffed_Fuck:
	say "     Feeling a little kinky yourself right now, you [if player is not naked]slip out of your clothing and gear, [else]take off your gear [end if]and pile it up on the neighboring bed so it doesn't get dirty, then step up to here Alexandra is lying. You can see from the corner of your eyes that this is drawing some attention from the gathered farmhands, several of which casually move to better positions for watching you. Climbing onto the bed, you feel some wet spots from where stray shots of cum landed not too long ago, another proof if the virility of the many horny men you've sent your bitch here to serve. As you kneel between Alexandra's legs, the scent of sex suffuses your nostrils: lots and lots of cum, with some clean sweat to go with it. Brushing your hands along the mostly matted fur of the doberwoman's thighs, you spread them some more, making room for you to move up close and tight to her crotch and gaping pussy. Leading the way is your [cock of Player] shaft, hard and ready to get your fuck on!";
	say "     Wrapping your hand around the base of your cock, you bend it down a little and trace its head over the nub of her clit, wiping off some of the horseman cum sticking to your bitch. You stroke up and down along your length, spreading the farmhand's seed as improvised lube, then rub yourself against her pleasure-button some more. The anthro starts to stir at being touched, drawing her out of the depths of fucked-out stupor. Escalating to dipping your dickhead down from her clit, you hook it into the spread opening of her pussy and sink yourself into her warm, wet depth with a smooth push that just feels amazing! Everything around your shaft is slick and creamy, and you can't help but chuckle at the knowledge that you're churning up the loads of at least a dozen farmhands that bred her. Looking up as you hear a groggy, 'Nnnhh? Fuuck, you guys... are... insatiable!' you see Alexandra waking up fully, opening her eyes and blinking once or twice before focusing on you. Then her eyes go wide and she barks, 'Fuck! It's you boss!'";
	WaitLineBreak;
	say "     Savoring the ex-cop's realization that it isn't just another farmhand plunging into her squelching depths but actually the person who claimed her in the streets, wearing her resistance down until she became your very own bad dog bitch, you grin broadly and then hammer into her at full force. ";
	if Cunt Depth of Alexandra + 2 < Cock Length of Player: [standard values: 10 (+2 stretching allowance) vs 15]
		say "The doberwoman bucks under you wildly and [if TwistedCapacity of Alexandra is false]lets out almost feral sounds as your enormous dick batters past her cervix, right into her womb. 'Fucking hell that's big!' she shouts, holding back a whimper at the pain. Yet at the same time, she's into it too, [else]then lets out a almost gleeful laugh as her altered body somehow accommodates to let your enormous dick slip right into her womb. 'Fuck yeah, that's one big dick!' she barks, [end if]gushing more female juices in her arousal. Fully sheathed inside Alexandra, [if Sterile of Alexandra is false]right where she'll likely have a litter of pups growing soon and [end if]with her sex squeezing all around your cock, you can't help but go a little wild. Grunting lustfully, you go on to fuck her hard and deep, really pummeling the dobie's insides with your hard shaft. 'Damn, I love all of these monster dicks in me! Blast some puppies up that pussy, boss!'";
		say "     Alexandra lets out needy moans and whines as she writhes on the mattress, acting like the sexy bitch you always wanted to call your own. Some might call this nanite plague an apocalypse, but you can't help but think that it's also a fucking good time! Ravaging her canine snatch and churning up the mixed loads of at least a dozen men with your own prick, you thoroughly enjoy making use of your slut. Over the sounds of yourself and Alexandra, you distantly register some of the men cheering you on, a reminder that you're giving them a show too. Only spurred on by this, you intensify your attention for the anthro's canine pussy, now going all out in your deep penetrations, until finally ramming home one last time and starting to flood her womb with everything your balls have to give. Thus your own seed joins the throng of millions of sperm, hunting for any eggs they might burrow into and knock the bitch up!";
		if TwistedCapacity of Alexandra is false:
			increase Cunt Depth of Alexandra by 1; [oversized fucks stretch characters bit by bit]
	else: [Player actually fits into her]
		say "The doberwoman bucks under you at the sudden deep penetration, letting out a needy moan. [if Cock Length of Player > 11]You can see the vague outline of your shaft and how far it reaches inside her, which brings with it the realization that a dick this big wouldn't have fit in the bitch when you first took her as yours. Seems like continued deep fucks stretched her out, with her nanite-infused body adapting to take the cocks she has taken. [end if]'Fuck yeah, give me that dick!' she barks, gushing more female juices in her arousal. Fully sheathed inside Alexandra, pushing the cum already inside her deeper[if Sterile of Alexandra is false] and increasing the chance that she'll have a litter of pups growing soon[end if], you can feel her sex squeezing all around your cock. It feels so good that you can't help but go a little wild. Grunting lustfully, you go on to fuck her hard and deep, really pummeling the dobie's insides with your hard shaft. 'Damn, I love being bred! Blast some puppies up that pussy, boss!'";
		say "     Alexandra lets out needy moans and whines as she writhes on the mattress, acting like the sexy bitch you always wanted to call your own. Some might call this nanite plague an apocalypse, but you can't help but think that it's also a fucking good time! Ravaging her canine snatch and churning up the mixed loads of at least a dozen men with your own prick, you thoroughly enjoy making use of your slut. Over the sounds of yourself and Alexandra, you distantly register some of the men cheering you on, a reminder that you're giving them a show too. Only spurred on by this, you intensify your attention for the anthro's canine pussy, now going all out in your deep penetrations, until finally ramming home one last time and starting to flood her pussy with everything your balls have to give. The blasts of cum spurt deep into the throng of millions of sperm already there, joining the hunt for any eggs they might burrow into and knock the bitch up!";
	WaitLineBreak;
	say "     Feeling yet another cock throb against her insides as she is bred for the upteenth time today, Alexandra herself climaxes right along with you, finding fulfillment from her assigned role. When your shared orgasms eventually wind down and you sink over Alexandra with your dick resting inside her, the bitch loosely wraps her arms around you and strokes your sides. 'T'was so good! I'm totally stuffed!' she says with a chuckle, slurring her satisfied words in exhaustion. You can see that her energy is flagging fast, now that she got off. 'Gotta say, staying here with all these guys sure is... iss a workout...' are the last words she manages to say before dozing off again. Well-pleased with your breeding bitch, you wait a little while longer to catch your breath, then pull out of her, your dick white and dripping with frothy cum. Leaving Alexandra to rest on the bed, you move over into the showers to clean yourself up, then return to grab your [if player is not naked]clothes and [end if]gear again.";
	impregAlexandraChance with "Player";
	NPCSexAftermath Alexandra receives "PussyFuck" from Player;

to say AlexandraFarmhandCumStuffed_Rest:
	say "     You decide to let Alexandra get her well-deserved rest, as she's already totally stuffed with cum[if Alexandra is not sterile] and more than likely already knocked up[end if]. Instead, you make a little circuit through the room, chatting with the happy and quite thankful horsemen all around, who praise Alexandra's sexy body and receptive nature, and you for bringing her here for them to enjoy. It really feels good to bask in their adoration for a while.";
	SanBoost 5;

to say AlexandraFarmhandJerking: [farmhand being jerked by Alexandra]
	say "     As you enter the building, you immediately notice a pair of horsemen standing near the entrance, talking to one another and chuckling. 'Think he'll make it? It's one tall order with a bitch like her working him over!' one of them says, with the second replying, 'Fuck, no! Not in a million years. But who cares if the training sessions with Alexandra are so much fun anyways.' Following their gazes over to one of the beds lined up throughout the large room, you can see what they're talking about. Another farmhand is stretched out on his bed, bare-ass naked and panting with a pit of a pinched expression on his face. Alexandra is sitting next to him on the corner of the bed, both her hands wrapped around the muscular male's erect shaft. She is stroking up and down along its length, then leans in to run her tongue over his head in a slow tease before pulling back again.";
	say "     'You're already leaking, stud! That doesn't bode well for lasting through my challenge!' the doberwoman calls out in a teasing tone, tail wagging as she enjoys ribbing the guy. His reply is little but a grunt, but you can see the muscles in his arms bulging as he grips the bedframe even harder, trying to weather what your bad bitch is putting him through. 'You stallionboys need some proper training! Nothing's more disappointing than having a guy shoot too quickly in you!' Alexandra goes on to say, and you can see what she's doing now. Seems the bitch is challenging her barracks-mates to last a certain time before blowing their loads. She's really not making it easy on them though, as her regimen of jerking, licking and stroking winds the man in her clutches right now up immensely. ";
	let randomnumber be a random number from 1 to 2; [so far there is only one walk-in option]
	if randomnumber is:
		-- 1: [good contender]
			say "Still, he seems determined to last as long as he can, clenching his teeth together and his body tensed up something fierce.";
			LineBreak;
			say "     Even though she keeps up her sensual torture for several more minutes, it seems like the horseman might prevail, as Alexandra does throw a look at the clock in the wall once or twice. Yet then, she resorts to a trick, wetting a finger with spit and wiggling it against, then into the quivering pucker of her playmate. The sudden penetration might have been enough to disrupt his concentration, or maybe she found his prostate and gave it a stroke, but mere instants later, he lets out a grunt and starts to erupt in a fountain of equine seed, splattering his load all over the large male's chest and one shot even hitting him in the muzzle. 'Hey!' the man complains as soon as he is able to catch his breath, with Alexandra simply shrugging him off and saying, 'All's fair in love and war.'";
			say "     Panting in lust, the guy groans and drops his head back on the pillow while Alexandra aims his cock to cover his pecs and abs in sperm. 'Guess you'll have to pay up, boy-toy!' With that said, the bitch scoops up a bit of cum with her hand, then holds it out for the farmhand, who reluctantly raises his head and proceeds to lick the creamy goop of her fingers. Chuckling in amusement, Alexandra continues to feed him his own cum, only getting up and patting his chest when it's all gone. 'Better luck next time, eh?' she tells him with a wink, then saunters away.";
		-- 2: [quick shooter]
			say "In fact, it takes just a few more moments of her stimulation before the guy's cock erupts in a fountain of equine seed, splattering his load all over the large male's chest and one shot even hitting him in the muzzle.";
			LineBreak;
			say "     'Aw, now that was a quick finish,' Alexandra comments in a mix of amusement and playfully exaggerated disappointment. Panting in lust, the guy groans and drops his head back on the pillow while Alexandra aims his cock to cover his pecs and abs in sperm. 'Guess you'll have to pay up, boy-toy!' With that said, the bitch scoops up a bit of cum with her hand, then holds it out for the farmhand, who reluctantly raises his head and proceeds to lick the creamy goop of her fingers. Chuckling in amusement, Alexandra continues to feed him his own cum, only getting up and patting his chest when it's all gone. 'Better luck next time, eh?' she tells him with a wink, then saunters away.";

to say AlexandraFarmhandCunni: [farmhand oral on Alexandra]
	say "     As you enter the building, at first there doesn't seem to be anything out of the ordinary happening, with the various farmhands present hanging out and a group of them playing poker at the table in the front. Yet then, you hear a high-pitched moan come from over at the rows of beds. Glancing that way, you spot one of the large equine studs kneeling on the ground, his upper body bent forward and with two slender, toned legs hooked over his shoulders. The brown-furred, canine paws at the end of those legs make it clear that it's your breeding bitch Alexandra getting some action right now. A moment later, she gasps out, 'YES! Deeper! Wiggle that tongue for me, big boy! NNgghhh, yeah!' while throwing her arms out to the sides, digging her fingers into the blanket on the bed. Curiosity has you taking a few steps closer to the action, and from your soon much better angle, you can see that the horseman's muzzle is right between Alexandra's legs.";
	say "     His stretched lips cover the whole of her sex, and you can only guess if the broad tongue of the guy is currently lapping at her clit or exploring Alexandra's pussy. At the same time, the farmhand's fingers are wrapped around his very erect cock, slowly stroking its length as he pleasures his favorite bitch. You watch for a few more seconds, before [one of][if PlayerMet of Nelson is false]a zebra horseman[else]Nelson[end if][or]one of the Clydesdales[or]Karel[or]Isaac[at random] steps up next to you and reaches out to touch your arm, giving a friendly smile as you focus on him. '[Sir], I just had to say - thanks for bringing your doberwoman over! She's just been incredible to all of us!' As if to underline his words, you hear what can only be described as an orgasmic scream from over at Alexandra's bed. She's now got her legs hooked behind the neck of the horseman, hips raised as she grinds against his face while riding out her orgasm.";
	WaitLineBreak;
	say "     After a little while, the ex-cop winds down, her breathless panting smoothing out into a more normal rhythm once more as she sinks back on the bed, legs letting go of tightly clutching the farmhand to her crotch. 'That was very good, ponyboy!' the woman gasps out, and if she wasn't lying on it right now, you bet her tail would be wagging up a storm. The horseman grins broadly, happy at the praise, and now that he has done his duty, it seems that the man is ready to receive his own reward. Standing up to tower over the smaller form lying on the bed, he braces himself with one strong arm on the mattress, leaning over it to kiss Alexandra's muzzle and engage in a bit of tongue-wrestling. The free hand of the guy is busy below, gripping his long shaft and jerking up and down along its length in a quick, no nonsense rhythm made to push him over the edge as soon as possible. Mere moments later, the farmhand grunts into Alexandra's open muzzle and bucks his hips forward, starting to unload onto her naked form.";
	say "     Each individual spurt of equine seed that splatters Alexandra isn't all that small, not with the weighty cum-factories the guy is swinging around, and he certainly has stamina to spare, with there seeming to be no end to the orgasm. Alexandra's front is covered in a huge load of equine seed, the short fur on her body now plastered against her naked body. 'Yeah, you like seeing me like this, don't you?' the bad dog bitch says to her stud with a broad grin while running her hands down her front, [if HP of Alexandra is 2 or HP of Alexandra is 4]cupping the cum-slick orbs of her breasts[else]cupping her cum-slick pregnant belly[end if]. The response is little but a horny grunt, with the man planting his large hands on her to caress your breeding bitch, climbing on the bed with her to share touches and more kisses. Soon, they're both stretched out on the mattress, with Alexandra lying half on top of the guy's broad chest. She traces the grooves between his rock-hard abs with her finger for a little while before dozing off eventually, getting some much-needed rest.";
	CreatureSexAftermath "Horseman" receives "OralPussy" from "Alexandra";

to say AlexandraFarmhandDripping: [player just walks in on the end of sex with Alexandra, and she's a cummy mess]
	[she's been fucked by multiple horsemen even before the scene]
	impregAlexandraChance with "Farmhand Horseman";
	impregAlexandraChance with "Farmhand Horseman";
	say "     As you enter the building, you run into a work crew of horsemen, standing near the entrance and chatting with each other. They give you a friendly greeting, but seem distracted somehow, with several glancing over at the big clock on the wall. Then one of the muscled equines turns around and calls out, 'So, you gonna finish or what? We've got work to do, dude! Just blow your load and get going!' A chuckle goes through the group and the men joke around, but over that, you think you hear a grunt from somewhere deeper in the room. Curious, you take a few steps around the cluster of men, finally allowing you to see another farmhand standing in front of the back wall, his jeans pushed down while he hammers his cock deep into Alexandra in a frantic pace. 'FffuuckkkkKKKKK!' the man shouts in a breathless, lusty voice, thrusting his hips forwards reflexively as he unloads a massive load into your dobie breeding bitch.";
	impregAlexandraChance with "Farmhand Horseman";
	say "     The farm worker holds Alexandra close, supporting her while filling her up with his seed, but then the others call out to him again. 'Sorry, I really gotta go,' he grunts and pulls the ex-cop off his erection in a shower of cum, both from his still-throbbing shaft as well as more than a few loads leaking out of her. Setting the bitch down on the ground gently, he receives a playful glower from her as she leans back against the wall. 'You'll make it up to me next time, ponyboy! I expect some top tongue-work eating me out, do we understand each other?!' 'Yes, ma'm!' he replies, stiffening his back and coming to attention at her tone. It would look a bit more serious if he wasn's still bare-ass naked, but the show of obedience seems enough for Alexandra, who laughs and grabs his sensitive dickhead, giving it a squeeze before waving him off. Pulling his pants up and sprinting, the man catches up with his buddies, leaving the naked doberwoman behind.";
	WaitLineBreak;
	say "     Alexandra looks a bit worse for wear, much of her fur plastered against her skin either with sweat or cum, you can't quite tell in most places. Well, except at her pussy and along the insides of her legs, as more of a creamy mess of fresh equine seed is just dripping out of her sex by the moment. You can't help but wonder if she took all of those guys who just left to create that deluge of sperm, or if one or another of them is just a big shooter. The ex-cop notices your attention on herself and gives you a tired wave, with a broad grin on her face. 'Puppy mill at work, boss! Shouldn't be long before these studs have me knocked up with a new litter!' Stroking her hand over the dripping folds of her pussy, she shows the white mess on her palm off proudly, then licks it up. 'But man, these fuckers do wear you out, and I'm sticky all over! I'll go freshen up now.' With that said, the sexy woman strolls over towards the shower room, leaving a trail of white dribs and drabs as she goes along.";
	CreatureSexAftermath "Alexandra" receives "PussyFuck" from "Horseman";

to say AlexandraFarmhandGroupSuck_Preg:
	say "     As you enter the building, your attention is immediately drawn to a whole group of anthro horsemen standing in one corner of the large room. Seeing how tightly they're bunched up, the fact that they're not actually talking but rather exchanging horny grunts, and that they're all facing inwards towards the center of the little gathering, you have little doubt that you'll find Alexandra there. As you begin walking towards them, one of the towering males unzips his pants, following by pushing the jeans down and starting to jerk a humongous piece of equine cock. Soon, you're standing just behind the seven foot tall anthro Clydesdale, but with all of the men there, you still can't see Alexandra. Clearing your throat and tapping the guy on the back only raises a reaction when you're persistent, at which point the man grunts in annoyance, 'Buzz off, you can wait your turn like ev- oh! Hello, [sir]!'";
	say "     Having half-turned around to look at you, he almost smacked you with his dick by accident, and now the farmhand his holding it away from you while looking at you wide-eyed. His nostrils flare from rapid breathing as he stammers a few words along the lines of, 'I - er, didn't mean to say - of course she's yours and... I'll shut up now.' Lightly poking his neighbor with an elbow, the embarrassed horseman points you out to that guy, then steps aside a little, pushing further horsemen back to create a gap through which you can see the center of the group. As mostly expected, Alexandra's right in the middle of all these men, crouched down with one cock in each hand, long tongue slurping up along the shaft of another dangling just in front of her face. She's completely naked, ";
	if lust of Alexandra < 13: [slightly pregnant]
		say "likely in anticipation of not fitting into her clothes anyways with the litter she has on the way. It looks to be growing quickly as the bitch's tummy is a little more rounded and full than usual.";
	else: [visibly pregnant]
		say "which is only to be expected, as the bitch's clothing is just not made to stretch over a ";
		if AlexandraGrowingPups < 3: [2 pups]
			say "noticeably big ";
		else if AlexandraGrowingPups < 5: [3+4 pups]
			say "quite large ";
		else: [5+6 pups]
			say "almost monstrously large ";
		say "and round belly. The brood that [AlexandraPupDaddyName]given her seem to be growing quickly.";
	WaitLineBreak;
	say "     'Hey Boss!' the former cop that you've made to become the barracks slut of this whole crew of horny farm workers calls out, grinning at you and wagging her tail. 'Just having some fun with the boys,' she adds, before taking one of the blunt dickheads so eagerly presented into her muzzle and sucking on it. The farmhand being serviced lets out a satisfied groan, while his neighbor (who's being slowly stroked by Alexandra) smiles and reaches out to give your shoulder a friendly pat and squeeze. 'Quite the fuckpuppy you dropped off with us, [sir]! [if Alexandra is BarracksSlut]Even though deep-dicking her is out, with the foals and all, Alexandra's been taking care of all of us! [else]We know we're not supposed to fuck her without you there, and there's foals on the way right now anyways, [end if]so Alexandra's been taking care of all of us another way! ";
	say "She's insatiable, just wanting to have more and more cock! I guess what they say about pregnant women being horny as fuck is true after all!' Glancing down, you see that the naked dobie's fur is matted and wet in some places, no doubt from previous cumshots that hit her body instead of going down her throat.";
	say "     Despite this, you're certain that she isn't in any way the submissive partner in this group activity. No one's pushing or manhandling Alexandra, that's for sure, and when she pulls off her current partner's dick and starts to suckle on another, the man accepts that without complaint, simply stroking himself slowly and hoping for another round. Even though she's a single bitch in a large group of men, it's clear that Alexandra is the top dog of the scene. Meanwhile, a few of the other guys around you reach out to pat your back and murmur their thanks for bringing Alexandra here. Surrounded by all these half- or fully naked people, with the general atmosphere of arousal and lust in the air, you can't help but feel a little stimulated yourself.";
	WaitLineBreak;
	say "[AlexandraFarmhandSuckingMenu]";

to say AlexandraFarmhandGroupSuck_Nopreg:
	say "     As you enter the building, your attention is immediately drawn to a whole group of anthro horsemen standing in one corner of the large room. Seeing how tightly they're bunched up, the fact that they're not actually talking but rather exchanging horny grunts, and that they're all facing inwards towards the center of the little gathering, you have little doubt that you'll find Alexandra there. As you begin walking towards them, one of the towering males unzips his pants, following by pushing the jeans down and starting to jerk a humongous piece of equine cock. Soon, you're standing just behind the seven foot tall anthro Clydesdale, but with all of the men there, you still can't see Alexandra. Clearing your throat and tapping the guy on the back only raises a reaction when you're persistent, at which point the man grunts in annoyance, 'Buzz off, you can wait your turn like ev- oh! Hello, [sir]!'";
	say "     Having half-turned around to look at you, he almost smacked you with his dick by accident, and now the farmhand his holding it away from you while looking at you wide-eyed. His nostrils flare from rapid breathing as he stammers a few words along the lines of, 'I - er, didn't mean to say - of course she's yours and... I'll shut up now.' Lightly poking his neighbor with an elbow, the embarrassed horseman points you out to that guy, then steps aside a little, pushing further horsemen back to create a gap through which you can see the center of the group. As mostly expected, Alexandra's right in the middle of all these men, crouched down with one cock in each hand, long tongue slurping up along the shaft of another dangling just in front of her face. She's completely naked, most likely to protect her nice leather jacket from being drenched in cum, or just because the dobie wanted to feel her admirers all over herself.";
	WaitLineBreak;
	say "     'Hey Boss!' the former cop that you've placed here to [if Alexandra is BarracksSlut]become the barracks slut of this whole crew of horny farm workers [else]have bred by your chosen studs [end if]calls out, grinning at you and wagging her tail. 'Just having some fun with the boys,' she adds, before taking one of the blunt dickheads so eagerly presented into her muzzle and sucking on it. The farmhand being serviced lets out a satisfied groan, while his neighbor (who's being slowly stroked by Alexandra) smiles and reaches out to give your shoulder a friendly pat and squeeze. 'Quite the fuckpuppy you dropped off with us, [sir]! [if Alexandra is BarracksSlut]Alexandra's been taking care of all of us! [else]We know we're not supposed to fuck her without you there, so Alexandra's been taking care of all of us another way! [end if]She's insatiable, just wanting to have more and more cock!' Glancing down, you see that the naked dobie's fur is matted and wet in some places, no doubt from previous cumshots that hit her body instead of going down her throat.";
	say "     Despite this, you're certain that she isn't in any way the submissive partner in this group activity. No one's pushing or manhandling Alexandra, that's for sure, and when she pulls off her current partner's dick and starts to suckle on another, the man accepts that without complaint, simply stroking himself slowly and hoping for another round. Even though she's a single bitch in a large group of men, it's clear that Alexandra is the top dog of the scene. Meanwhile, a few of the other guys around you reach out to pat your back and murmur their thanks for bringing Alexandra here. Surrounded by all these half- or fully naked people, with the general atmosphere of arousal and lust in the air, you can't help but feel a little stimulated yourself.";
	say "[AlexandraFarmhandSuckingMenu]";

to say AlexandraFarmhandSuckingMenu:
	LineBreak;
	now sextablerun is 0;
	blank out the whole of table of fucking options;
	say "     [bold type]Do you want to do anything yourself?[roman type][line break]";
	[]
	choose a blank row in table of fucking options;
	now title entry is "Stay right where you are and keep watching";
	now sortorder entry is 1;
	now description entry is "Observe Alexandra being covered in cum";
	[]
	if player is male:
		choose a blank row in table of fucking options;
		now title entry is "Step up and have her suck you off";
		now sortorder entry is 2;
		now description entry is "Make use of your rights as Alexandra's master";
	[]
	choose a blank row in table of fucking options;
	now title entry is "Crouch down and join her in giving oral";
	now sortorder entry is 3;
	now description entry is "Join Alexandra and be a barracks slut today";
	[]
	sort the table of fucking options in sortorder order;
	repeat with y running from 1 to number of filled rows in table of fucking options:
		choose row y from the table of fucking options;
		say "[link][y] - [title entry][as][y][end link][line break]";
	say "[link]0 - Nevermind[as]0[end link][line break]";
	while sextablerun is 0:
		say "Pick the corresponding number> [run paragraph on]";
		get a number;
		if calcnumber > 0 and calcnumber <= the number of filled rows in table of fucking options:
			now current menu selection is calcnumber;
			choose row calcnumber in table of fucking options;
			say "[title entry]: [description entry]?";
			if Player consents:
				let nam be title entry;
				now sextablerun is 1;
				if (nam is "Stay right where you are and keep watching"):
					say "[AlexandraFarmhandSucking_Watch]";
				else if (nam is "Step up and have her suck you off"):
					say "[AlexandraFarmhandSucking_Suck]";
				else if (nam is "Crouch down and join her in giving oral"):
					say "[AlexandraFarmhandSucking_Join]";
				wait for any key;
		else if calcnumber is 0:
			now sextablerun is 1;
			say "[AlexandraFarmhandSucking_Leave]";
			wait for any key;
		else:
			say "Invalid Option. Pick between 1 and [the number of filled rows in the table of fucking options] or 0 to exit.";
	clear the screen and hyperlink list;

to say AlexandraFarmhandSucking_Watch: [generalized watch scene with some special sections for preg/nonpreg]
	say "     Putting a broad smile on your face, you tell the gathered horsemen to enjoy themselves with Alexandra. This is exactly what you brought her here for after all. A cheer goes through the crowd, with the men calling out thanks to you as even those who were still wearing trousers hurriedly take them off to free their rapidly hardening erections. Moments later, Alexandra is presented by many more equine shafts, with the now boisteous group of men moving in closer, their naked bodies pushed against each other as they strive to be at the front. Still, it's all in good friendship, with several guys putting arms around the shoulders of their neighbors, and even those standing a little bit back able to push their long cocks between the others. [if Player is male]You yourself of course also pull out a quickly hardening cock, stroking [else if player is female]You yourself slide a hand down to your crotch, fingering yourself [else]You yourself slide a hand down to your crotch, touching yourself [end if]while watching Alexandra service all of the men.";
	say "     From your close-up observer position, it seems like Alexandra is suddenly surrounded on all sides by a ring of cocks, and the bitch takes all the attention in stride, her tail wagging hard as she licks, sucks and fondles one cock after another, with sucking on the weighty equine balls of some guys thrown in as a special treat. It's a really hot thing to watch, and you're not the only one to think so, as the general air of lustful arousal of the group builds up more and more. Alexandra wrapping her lips around the thick cock of [one of]the one zebra in the group[or]a lucky Clydesdale[or]Karel[or]Isaac[at random] and giving him a deep-throat experience that makes the farmhand stomp his hoof on the ground in arousal pushes things to a climax soon after. Grunts and moans of lust from the man lead over to a horny shout of, 'Nnnnghhh YEAH! I'm coming!' and he plants his hand on Alexandra's head to pull her closer as he blows his load down her throat.";
	WaitLineBreak;
	say "     One prominent stallion reaching his limit and flooding Alexandra's stomach with his seed pulls the rest of the guys along past the point of no return. Within only a few seconds, groans and grunts from more than a dozen horsemen fill the room, with their equine cock's heads swelling in broad flares as they start shooting long streams of cum all over their favorite bitch. Each individual spurt of equine seed isn't all that small, not with the weighty cum-factories these guys are swinging around, and the men certainly have stamina to spare, with there seeming to be no end to their orgasms. Alexandra is drenched in a deluge of cum, her hair and short fur plastered against her naked body. ";
	if HP of Alexandra is 2 or HP of Alexandra is 4: [not pregnant]
		say "A fair number of the men in front of her seem to be specifically aiming their cocks for the currently flat and toned area of her abs, joking about her becoming pregnant from their sheer virility this way. Alexandra chuckles at their antics and calls out, 'Keep it coming boys, we'll see who knocks me up!' Then she plants her hands on her breasts, massaging in the randy equine's seed in circling movements and working down from there, with special attention to her flat stomach.";
	else if HP of Alexandra is 3 or HP of Alexandra is 5: [pregnant]
		say "A fair number of the men in front of her seem to be specifically aiming their cocks for the [if Lust of Alexandra < 13]slight [else if AlexandraGrowingPups < 3]noticeably big [else if AlexandraGrowingPups < 5]quite large [else]almost monstrously large [end if]curve of your breeding bitch's round belly. Alexandra loves this and puts her hands onto the curve of her life-giving bump, massaging in the randy equine's seed in circling movements.";
	say "     Seeing the formerly rather uptight policewoman revel in the new role in life that you've chosen for her and being carried along by the lust of everyone around you, ";
	if player is male: [male and herm]
		say "a familiar tightness heralds your impending orgasm. Breathing heavily as you struggle to contain yourself just a little longer, you give a sharp dog-whistle that has Alexandra whipping her head around - just in time for you to hit her muzzle with the first spurt of your seed. The dobie is quick to get her lips around your dickhead after that, long tongue enfolding your shaft as it throbs again and again, filling her muzzle with your cum. ";
		NPCSexAftermath Alexandra receives "OralCock" from Player;
	else if player is female: [females]
		say "a familiar tingle spreads through your nether regions, heralding your impending orgasm. Breathing heavily as you struggle to contain yourself just a little longer, you give a sharp dog-whistle that has Alexandra whipping her head around - just in time for you to pull her head against your crotch, her muzzle becoming wet with the fluids of your arousal. The dobie is quick to stick out her tongue and snake it between your pussy lips after that, teasing your sensitive insides while nosing your clit with her wet doggy nose, both inhaling your scent as well as arousing you with the touch. ";
		NPCSexAftermath Alexandra receives "OralPussy" from Player;
	else: [neuter]
		say "a familiar tingle spreads through your nether regions, heralding your impending orgasm. Breathing heavily as you struggle to contain yourself just a little longer, you give a sharp dog-whistle that has Alexandra whipping her head around - just in time for you to pull her head against your crotch, her wet doggy nose brushing your genderless but still quite sensitive nether region. She's quick to start lapping at your skin after that, both inhaling your scent as well as arousing you with the touch. ";
	say "Holding on to the head of your breeding bitch, sticky as she is with more than a dozen men, you ride out your orgasm and enjoy yourself immensely. Alexandra keeps servicing you dutifully the whole time, including switching over to just gentle lapping when you get sensitive as you wind down from your high.";
	WaitLineBreak;
	say "     'You like seeing your bitch like this, eh boss?' Alexandra asks from her position on the ground before you, giving your crotch a last slow lick before leaning back and running her hands down her front, [if HP of Alexandra is 2 or HP of Alexandra is 4]cupping the cum-slick orbs of her breasts[else]cupping her cum-slick pregnant belly[end if]. You nod to her and smile, replying that she knows you do, then raise your gaze to look at the group of horsemen still gathered quite close, commending them for giving your bitch just the treatment she needs. Standing up and looking over her slender, toned body, Alexandra adds in an amused tone, 'Speaking of what I need - I'm sticky all over, so would anyone here like to give me a nice warm scrubdown in the sh-' That's how far she gets before [one of]the one zebra in the group[or]a studly Clydesdale[or]Karel[or]Isaac[at random] swoops your breeding bitch up in his arms and plants a kiss on her muzzle, shutting her up.";
	say "     With a broad grin on his muzzle, the man proceeds to carry the dobie towards the showers, leaving a trail of dripped cum as he goes. About half of the other farmhands follow, either to wash themselves or to simply watch him take care of Alexandra, while the rest stay behind, casually naked as they start chatting about how much fun the barracks are since Alexandra came here. With the show over now, you clean yourself up a little bit, then turn your attention back to surviving in this crazy city.";
	CreatureSexAftermath "Alexandra" receives "OralCock" from "Horseman";

to say AlexandraFarmhandSucking_Suck: [player takes center stage as the one being sucked]
	say "     Putting a broad smile on your face, you tell the gathered horsemen that you'll have a turn with Alexandra's mouth now. But of course, this doesn't mean that they have to go, as your bitch can still jerk them at the same time and maybe hand out a few licks too. A murmur goes through the crowd, with the guys commenting about how lucky you are to have such a great fuckpuppy at your beck and call, and one or two moaning about them having been next. Overall, they're still cheerful enough about being allowed to stay, with those that are wearing trousers hurriedly taking them off to join a throng of horsemen jerking themselves to the coming show of Alexandra going down on you. As she turns around to find your cock held out at eye level, Alexandra's tail beats rapidly, with the bitch giving a lewd grin, followed by tracing her tongue over your sensitive dickhead.";
	say "     'I'm gonna rock your world, boss!' she pants in an eager tone, then takes your shaft into her muzzle and starts bobbing on it. Your length slides over the slick surface of her warm tongue in Alexandra's mouth, while the organ's floppy length is sufficient for her to wiggle it against your manhood and tease it, almost wrapping around it at times. 'She did that to me too, it's an amazing feeling!' one of the farmhands watching says to his neighbor, which prompts a little chat between the men of what they liked best about Alexandra's oral service, with suggestions to make her do this or that next being addressed your way. Meanwhile, the density of cock around Alexandra grows further as the group of horny men move in closer, their naked bodies pushed against each other as they strive to get a good view. Still, it's all in good friendship, with several guys putting arms around the shoulders of their neighbors, and even those standing a little bit back able to push their long cocks between the others.";
	WaitLineBreak;
	say "     From your position as being the center of Alexandra's oral efforts, it seems like Alexandra is suddenly surrounded on all sides by a ring of cocks. The bitch takes all the attention in stride, her tail wagging hard as she still mostly is going down on you, but also hands out a few licks and quite a bit of jerking and fondling to the others. It's a really hot thing to experience to have your breeding bitch's mouth on you while at the same time seeing her be the focus on so many other men, to whom you delivered her when you brought her here to stay. Yet while they might be able to take her at the moment, in the end Alexandra is yours, and you revel in seeing what you re-made a formerly straight-laced policewoman into. As the general air of lustful arousal of the group builds up more and more, Alexandra pushes her muzzle forwards and goes down all the way, giving you a deep-throat experience that has you struggling for composure, then surrender to orgasm as you simply can't take too much of such exquisite pleasure.";
	say "     Grunting deeply as you clamp your hands on the bitch's head, you grind your crotch against her muzzle and erupt down her throat, your balls twitching hard as they send thick spurts of cum down Alexandra's throat. The fact that you reach your climax almost seems to be a signal for the group of horny males all around Alexandra and yourself, who abandon all restraint and barrel past the point of no return moments later as they go to town on their own cocks. Within only a few seconds, groans and grunts from more than a dozen horsemen fill the room, with their equine prick's ends swelling in broad flares as they start shooting long streams of cum all over their favorite bitch. Each individual spurt of equine seed isn't all that small, not with the weighty cum-factories these guys are swinging around, and the men certainly have stamina to spare, with there seeming to be no end to their orgasms. Alexandra is drenched in a deluge of cum, her hair and short fur plastered against her naked body.";
	WaitLineBreak;
	if HP of Alexandra is 2 or HP of Alexandra is 4: [not pregnant]
		say "A fair number of the men in front of her seem to be specifically aiming their cocks for the currently flat and toned area of her abs, joking about her becoming pregnant from their sheer virility this way. Alexandra chuckles at their antics, the edges of her lips drawing up a little even as she still holds your cock in her mouth. She plants her hands on her breasts, massaging in the randy equine's seed in circling movements and working down from there, with special attention to her flat stomach. ";
	else if HP of Alexandra is 3 or HP of Alexandra is 5: [pregnant]
		say "A fair number of the men in front of her seem to be specifically aiming their cocks for the [if Lust of Alexandra < 13]slight [else if AlexandraGrowingPups < 3]noticeably big [else if AlexandraGrowingPups < 5]quite large [else]almost monstrously large [end if]curve of your breeding bitch's round belly. Alexandra loves this and puts her hands onto the curve of her life-giving bump, massaging in the randy equine's seed in circling movements. ";
	say "Holding on to the head of your breeding bitch, sticky as she is with more than a dozen men, you ride out your orgasm and enjoy yourself immensely. Alexandra keeps servicing you dutifully the whole time, including switching over to just gentle lapping when you get sensitive as you wind down from your high. When you're finally tapping her head and gently push against it to get her off you, Alexandra looks up from her position on the ground. 'You like seeing your bitch like this, eh boss?' Alexandra asks with a smirk, giving your crotch a last slow lick before leaning back and running her hands down her front, [if HP of Alexandra is 2 or HP of Alexandra is 4]cupping the cum-slick orbs of her breasts[else]cupping her cum-slick pregnant belly[end if].";
	say "     You nod to her and smile, replying that she knows you do, then raise your gaze to look at the group of horsemen still gathered quite close, commending them for giving your bitch just the treatment she needs. Standing up and looking over her slender, toned body, Alexandra adds in an amused tone, 'Speaking of what I need - I'm sticky all over, so would anyone here like to give me a nice warm scrubdown in the sh-' That's how far she gets before [one of]the one zebra in the group[or]a studly Clydesdale[or]Karel[or]Isaac[at random] swoops your breeding bitch up in his arms and plants a kiss on her muzzle, shutting her up. With a broad grin on his muzzle, the man proceeds to carry the dobie towards the showers, leaving a trail of dripped cum as he goes. About half of the other farmhands follow, either to wash themselves or to simply watch him take care of Alexandra, while the rest stay behind, casually naked as they start chatting about how much fun the barracks are since Alexandra came here. With the show over now, you clean yourself up a little bit, then turn your attention back to surviving in this crazy city.";
	NPCSexAftermath Alexandra receives "OralCock" from Player;

to say AlexandraFarmhandSucking_Join:
	say "     Putting a broad smile on your face, you tell the gathered horsemen that it seems to you Alexandra will need a bit of help taking care of so many handsome studs. As they gape at you, first in surprise then in rising lust as you [if player is not naked]strip down and [end if]take off your gear, handing it to one of the men to put aside. Soon, you're crouched down right next to Alexandra, with the bitch grinning at you, her tail wagging up a storm. 'Aww, want to keep me company, boss? Plenty of cock to go around for both of us!' the ex-cop tells you, leaning in to give you a doggy kiss with her long tongue licking over your face and wiggling into your mouth. The two of you have a little make-out session, during which you vaguely register the sounds of zippers being pulled down, and the clatter of hooves on the ground as the men hastily kick off their pants.";
	say "     By the time you stop kissing your dobie bitch for a second to take a breath, she and you are surrounded by a ring of equine cocks all around, with the now boisteous group of men standing fairly close, their naked bodies pushed against each other as they strive to be at the front. Still, it's all in good friendship, with several guys putting arms around the shoulders of their neighbors, and even those standing a little bit back able to push their long cocks between the others. Alexandra grins as she takes hold of one prominently erect shaft almost sticking out between the two of you, craning her neck to lick its side. You can see where she's going with it and join he canine woman in worshiping the pillar of man-meat, tongues frequently meeting and intertwining as they both slide over the shaft of [one of]the one zebra in the group[or]a lucky Clydesdale[or]Karel[or]Isaac[at random].";
	WaitLineBreak;
	say "     The paired oral service you give one man escalates very quickly, with more and more other equines starting to brush their cocks against your bodies and faces. This prompts you and Alexandra to spread out your attention, licking, sucking and fondling one cock after another, with bouts of sucking on the weighty equine balls of some guys thrown in as a special treat. It's a really hot experience to be in the middle of, and even those guys who can simply watch over their buddies shoulders and stroke off to it seem to think so, as the general air of lustful arousal of the group builds up more and more. Alexandra wrapping her lips around the thick cock of the enormous cock of the zebra-guy in the group and giving him a deep-throat experience that makes the farmhand stomp his hoof on the ground in arousal pushes things to a climax soon after.";
	say "     Grunts and moans of lust from the man lead over to a horny shout of, 'Nnnnghhh YEAH! I'm coming!' and he plants his hand on Alexandra's head to pull her closer as he blows his load down her throat. Your own current partner is only seconds behind, with the head of his equine shaft flaring proudly, filling your mouth with his swollen member as he erupts down your throat, pumping spurts of his rich seed directly into your stomach. Grunts and groans from more of a dozen other horsemen chime in shortly, and from the corner of your eye, you can see equine cock's heads swelling in broad flares as they start shooting long streams of cum all over their favorite bitch and her master. Each individual spurt of equine seed isn't all that small, not with the weighty cum-factories these guys are swinging around, and the men certainly have stamina to spare, with there seeming to be no end to their orgasms. Both of you are drenched in a deluge of cum, hair and fur plastered against your naked bodies.";
	WaitLineBreak;
	if HP of Alexandra is 2 or HP of Alexandra is 4: [not pregnant]
		say "     A fair number of the men in front of her seem to be specifically aiming their cocks for the currently flat and toned area of Alexandra's abs, joking about her becoming pregnant from their sheer virility this way. Alexandra chuckles at their antics and after pulling off her stud's cock calls out, 'Keep it coming boys, we'll see who knocks me up!' Then she plants her hands on her breasts, massaging in the randy equine's seed in circling movements and working down from there, with special attention to her flat stomach. ";
	else if HP of Alexandra is 3 or HP of Alexandra is 5: [pregnant]
		say "     A fair number of the men in front of her seem to be specifically aiming their cocks for the [if Lust of Alexandra < 13]slight [else if AlexandraGrowingPups < 3]noticeably big [else if AlexandraGrowingPups < 5]quite large [else]almost monstrously large [end if]curve of your breeding bitch's round belly. Alexandra loves this and puts her hands onto the curve of her life-giving bump, massaging in the randy equine's seed in circling movements. ";
	say "Seeing the formerly rather uptight policewoman revel in the new role in life that you've chosen for her and being carried along by the lust of everyone around you, ";
	if player is male: [male and herm]
		say "a familiar tightness heralds your impending orgasm. Breathing heavily, you jerk your cock in frantic movements to push yourself over the edge, erupting all over the lower legs of two farmhands standing close in front of you, the creamy thickness of your seed running down over their hooves and puddling on the floor.";
	else if player is female: [females]
		say "a familiar tingle spreads through your nether regions, heralding your impending orgasm. Breathing heavily, your hand flies to your clit, frigging it in frantic movements to push yourself over the edge. Panting and moaning, you hold on to a stud's strong leg with your free hand as a breathtaking orgasm overcomes you.";
	else: [neuter]
		say "a familiar tingle spreads through your nether regions, heralding your impending orgasm. Breathing heavily, your hand flies to your genderless crotch, frigging your sensitive skin there in frantic movements to push yourself over the edge. Panting and moaning, you hold on to a stud's strong leg with your free hand as a breathtaking orgasm overcomes you.";
	say "     While you're still riding out the pleasure of sex, a slender hand is placed on your hand, drawing your head to the side to look at Alexandra. 'You like seeing your bitch like this, eh boss?' she asks from her position on the ground beside you, leaning back and running her hands down her front, [if HP of Alexandra is 2 or HP of Alexandra is 4]cupping the cum-slick orbs of her breasts[else]cupping her cum-slick pregnant belly[end if]. You nod to her and smile, replying that she knows you do, then raise your gaze to look at the group of horsemen still gathered quite close, commending them for an awesome experience and giving you just what you needed. Standing up and looking over her slender, toned body, Alexandra adds in an amused tone, 'Speaking of what I need - I'm sticky all over, so would anyone here like to give me a nice warm scrubdown in the sh-' That's how far she gets before [one of]the one zebra in the group[or]a studly Clydesdale[or]Karel[or]Isaac[at random] swoops your breeding bitch up in his arms and plants a kiss on her muzzle, shutting her up.";
	WaitLineBreak;
	say "     With a broad grin on his muzzle, the man proceeds to carry the dobie towards the showers, leaving a trail of dripped cum as he goes. A second later, you're also swooped up by someone, and more or less the whole group wanders over to the shower area, either to wash themselves or to participate in giving Alexandra and yourself a very sensual washing, with lots of touching and groping thrown in. When you eventually come back into the main room of the barracks, clean and towelled try, your gear is waiting for you in a small pile, which you quickly reclaim.";
	CreatureSexAftermath "Alexandra" receives "OralCock" from "Horseman";
	CreatureSexAftermath "Player" receives "OralCock" from "Horseman";

to say AlexandraFarmhandSucking_Leave:
	say "     Putting a broad smile on your face, you tell the gathered horsemen to enjoy themselves with Alexandra. This is exactly what you brought her here for after all. A cheer goes through the crowd, with the men calling out thanks to you as even those who were still wearing trousers hurriedly take them off to free their rapidly hardening erections. Moments later, Alexandra is presented by many more equine shafts, with the now boisteous group of men moving in closer, their naked bodies pushed against each other as they strive to be at the front. Still, it's all in good friendship, with several guys putting arms around the shoulders of their neighbors, and even those standing a little bit back able to push their long cocks between the others. You yourself quietly slip out of the ring of horny equines, secure in the knowledge that even as you turn your attention to survival in this maddened city, your breeding bitch will be servicing a lot of virile males.";

to say AlexandraFarmhandStandingFuckMenu:
	project the figure of Alexandra_naked_icon;
	LineBreak;
	[farmhands went first, so their impregnation comes before anything the player does]
	impregAlexandraChance with "Farmhand Horseman";
	impregAlexandraChance with "Farmhand Horseman";
	impregAlexandraChance with "Farmhand Horseman";
	now sextablerun is 0;
	blank out the whole of table of fucking options;
	say "     [bold type]Do you want to do anything now?[roman type][line break]";
	[]
	choose a blank row in table of fucking options;
	now title entry is "Move closer and keep watching";
	now sortorder entry is 1;
	now description entry is "Observe Alexandra being bred (again)";
	[]
	if player is male:
		choose a blank row in table of fucking options;
		now title entry is "Step up and take the next spot fucking her";
		now sortorder entry is 2;
		now description entry is "Make use of your rights as Alexandra's master";
	[]
	if player is female:
		choose a blank row in table of fucking options;
		now title entry is "Offer your own pussy to be bred too";
		now sortorder entry is 3;
		now description entry is "Join Alexandra as another barracks slut today";
	[]
	choose a blank row in table of fucking options;
	now title entry is "Eat out the dobie's well-bred pussy";
	now sortorder entry is 4;
	now description entry is "Get on top of her in a 69 and lap the cum out of your bitch";
	[]
	sort the table of fucking options in sortorder order;
	repeat with y running from 1 to number of filled rows in table of fucking options:
		choose row y from the table of fucking options;
		say "[link][y] - [title entry][as][y][end link][line break]";
	say "[link]0 - Nevermind[as]0[end link][line break]";
	while sextablerun is 0:
		say "Pick the corresponding number> [run paragraph on]";
		get a number;
		if calcnumber > 0 and calcnumber <= the number of filled rows in table of fucking options:
			now current menu selection is calcnumber;
			choose row calcnumber in table of fucking options;
			say "[title entry]: [description entry]?";
			if Player consents:
				let nam be title entry;
				now sextablerun is 1;
				if (nam is "Move closer and keep watching"):
					say "[AlexandraFarmhandStanding_Watch]";
				else if (nam is "Step up and take the next spot fucking her"):
					say "[AlexandraFarmhandStanding_Fuck]";
				else if (nam is "Offer your own pussy to be bred too"):
					say "[AlexandraFarmhandStanding_Join]";
				else if (nam is "Eat out the dobie's well-bred pussy"):
					say "[AlexandraFarmhandStanding_Eat]";
				wait for any key;
		else if calcnumber is 0:
			now sextablerun is 1;
			say "     Shrugging, you pull your attention away from the doberwoman as she's railed by the massive prick of her stallion and try to focus on other things. It's not easy, given the sheer noise the two of them make as they eventually climax together, followed by a somewhat breathless Alexandra picking the man next to you as her followup partner, and they begin to grind against each other in your full view. Some time later, the action eventually dies down, with the quadruple-bred bitch requiring a bit of a rest too.";
			wait for any key;
		else:
			say "Invalid Option. Pick between 1 and [the number of filled rows in the table of fucking options] or 0 to exit.";
	clear the screen and hyperlink list;

to say AlexandraFarmhandStanding_Watch:
	say "     A grin spreads across your face as you tell the horseman next to you that he just might be next. 'Yeah, I really hope so,' he replies, planting a hand on the crotch of his pants and giving the bulge there a squeeze. Patting his arm and nodding for the guy to come along, you stroll towards the action, bypassing several others and getting a prime spot to see what's going on. From your new position, you see more of the former cop past the broad chest of the horseman: she's naked except for an open leather jacket, which has been pushed back so her well-rounded breasts are in full view. The fur between her legs looks wet and matted with cum, some of which keeps squirting out of her in a frothy mess every time the equine thrusts in deeply.";
	say "     Seeing a roughly fifteen-inch long horse cock pull out and then thrust into your bitch again, causing a visible bulge to appear in her stomach, you ";
	if Cunt Depth of Alexandra + 2 < 15: [standard values: 10 (+2 stretching allowance) vs 15]
		say "can't help but wonder at the flexibility her body shows for such massive penetrations. Despite his huge size, Alexandra takes him with eagerness and loud moans, either not feeling any discomfort or her arousal drowning it out. ";
		if TwistedCapacity of Alexandra is false:
			increase Cunt Depth of Alexandra by 1; [oversized fucks stretch characters bit by bit]
	else: [he actually fits into her]
		say "can't help but be amazed at the flexibility her body shows for such massive penetrations. By now, the bitch is well-used to being shafted by exceptional pieces of man-meat, and she takes him with eagerness that is accompanied by loud moans. ";
	say "Their shared sounds of ecstasy mount in volume and become more urgent quickly, with the stallion really hammering in and out of Alexandra now. The tough dobie bitch takes even this intense workout in stride, panting like she is in heat and with her tail wagging in the air beneath her. Then all of a sudden, an almost animalistic howl of lust wells up from the depth of her throat and she bucks against the horseman's hips in orgasm, the slender legs around his hips trembling and jerking. The equine stud isn't far behind, not with his erection being squeezed and stimulated by the spasming muscles in her pussy, and he grunts deeply as he starts to unload into her squelching depths, adding his own baby batter to the potent load already in her womb.";
	WaitLineBreak;
	say "     Closing the last few steps to the tall and muscled farm worker, you clap your hand jovially on his shoulder, asking if he's enjoying himself. 'Yeah, who wouldn't with this sexy bitch clamped around their dick?!' comes his well-pleased reply, followed by him half-turning his upper body to turn to you and stiffening as he realizes it's you. 'I - er,' he starts cautiously, only to relax as he sees you're smiling. After all, you dropped Alexandra off here to do exactly this. Clearing his throat, the man goes on to say, 'Thanks for getting us some action, [sir]! Your own hand will only do for so long, eh? And your woman here is a trooper!' Realizing that he's still holding the blissed-out Alexandra's arms pinned to the wall, he shifts his grip, instead holding her by the ass, with the other arm wrapping around her upper body to pull the bitch to his chest. 'Hey boss,' the dobie pants breathlessly as her gaze falls on you. 'Just spending some little time with the guys, you know.'";
	say "     A chuckle goes through the room, intermixed with the guys at the table knocking on the wood and a few voices calling, 'Yeah!', 'She's a top tier bitch!' and 'Pick me for the next ride and I'll show you an even better ride!' The stallion still balls-deep inside Alexandra starts to look speculatively at you, eyes wandering down to your crotch as he asks, 'So, guess you want the next ride? Her being your bitch and all...' You wave him off and reply that you're happy to watch for now, but that you know someone who's just waiting to sink into her. With a grin, you point at the stallion you brought with you to the front, who starts beaming a lusty smile. Within seconds, he's got his pants pushed down to his ankles, kicking them off an eyeblink later and stepping forward on his hooves with a thick equine shaft leading the way. 'Really appreciate this, [sir]!' he tells you happily and reaches out to grope Alexandra's breasts.";
	WaitLineBreak;
	say "     'You sure put me among many eager boys with lots of stamina, boss! Good that I'm ready to handle them,' Alexandra barks out amusedly, tail waggking as she's happy to be the center of attention. The farmhand still balls-deep inside her leans his head forward to kiss Alexandra and says, 'Let's do this again soon babe!' 'Sure thing, I'll keep you in mind, stud!' she replies after giving him a wet doggy kiss that quickly becomes a three-way as she tugs on the new guy to come closer too. The former cop spends some moments going back and forth between them in making out, until the newcomer eventually bumps his coworker with an elbow and grunts, 'Come on, hand her over!' Almost reluctantly, the farmhand draws Alexandra away from his hips, his shaft literally white with frothed cum as it emerges. Finally only the flared head of his organ is inside her, tugging a little at her opening from the inside.";
	say "     Your chosen successor for breeding Alexandra snakes his arms under her, getting a good grip and pulling her off the other farmhand in a gush of cum to splatter onto the floor and their hooves, only stopping as he rams her down on his own erection. Wet and dripping as she is, even the massive size of his shaft is no hindrance in penetrating your breeding bitch, with Alexandra giving a lusty gasp as she is filled to the brim, even showing a small bulge in her stomach from the sheer length of his shaft. 'Fuck,' she pants breathlessly as he starts to hammer her sex, turning around as if to show off his new cocksleeve to everyone in the room. You watch for a little while longer while yet another male takes Alexandra, then eventually gain some distance, secure in the knowledge that your slut's got all the cock she can take coming for her, and coming in her soon after.";

to say AlexandraFarmhandStanding_Takeover:
	say "     A grin spreads on your face as you tell the horseman next to you that he'll have to wait. It's your turn with the bitch next. His eyebrows draw together a little and the farmhand opens his mouth as if to protest, but he stops himself and just huffs out an indrawn breath. 'Fine, I guess - she's your slut after all. Still looking forward to having a go at her later myself though.' Quickly dropping your gear [if player is not naked]and clothing [end if]on a free bed nearby, in the wise anticipation of a fun but messy time with Alexandra, you saunter over to where she's being railed against the wall. Getting closer, you see more of the former cop past the broad chest of the horseman: she's naked except for an open leather jacket, which has been pushed back so her well-rounded breasts are in full view. The fur between her legs looks wet and matted with cum, some of which keeps squirting out of her in a frothy mess every time the equine thrusts in deeply.";
	say "     Seeing a roughly fifteen-inch long horse cock pull out and then thrust into your bitch again, causing a visible bulge to appear in her stomach, you ";
	if Cunt Depth of Alexandra + 2 < 15: [standard values: 10 (+2 stretching allowance) vs 15]
		say "can't help but wonder at the flexibility her body shows for such massive penetrations. Despite his huge size, Alexandra takes him with eagerness and loud moans, either not feeling any discomfort or her arousal drowning it out. ";
		if TwistedCapacity of Alexandra is false:
			increase Cunt Depth of Alexandra by 1; [oversized fucks stretch characters bit by bit]
	else: [he actually fits into her]
		say "can't help but be amazed at the flexibility her body shows for such massive penetrations. By now, the bitch is well-used to being shafted by exceptional pieces of man-meat, and she takes him with eagerness that is accompanied by loud moans. ";
	say "Their shared sounds of ecstasy mount in volume and become more urgent quickly, with the stallion really hammering in and out of Alexandra now. The tough dobie bitch takes even this intense workout in stride, panting like she is in heat and with her tail wagging in the air beneath her. Then all of a sudden, an almost animalistic howl of lust wells up from the depth of her throat and she bucks against the horseman's hips in orgasm, the slender legs around his hips trembling and jerking. The equine stud isn't far behind, not with his erection being squeezed and stimulated by the spasming muscles in her pussy, and he grunts deeply as he starts to unload into her squelching depths, adding his own baby batter to the potent load already in her womb.";
	WaitLineBreak;
	say "     Closing the last few steps to the tall and muscled farm worker, you clap your hand jovially on his shoulder, asking if he's enjoying himself. 'Yeah, who wouldn't with this sexy bitch clamped around their dick?!' comes his well-pleased reply, followed by him half-turning his upper body to turn to you and stiffening as he realizes it's you. 'I - er,' he starts cautiously, only to relax as he sees you're smiling. After all, you dropped Alexandra off here to do exactly this. Clearing his throat, the man goes on to say, 'Thanks for getting us some action, [sir]! Your own hand will only do for so long, eh? And your woman here is a trooper!' Realizing that he's still holding the blissed-out Alexandra's arms pinned to the wall, he shifts his grip, instead holding her by the ass, with the other arm wrapping around her upper body to pull the bitch to his chest. 'Hey boss,' the dobie pants breathlessly as her gaze falls on you. 'Just spending some little time with the guys, you know.'";
	say "     A chuckle goes through the room, intermixed with the guys at the table knocking on the wood and a few voices calling, 'Yeah!', 'She's a top tier bitch!' and 'Pick me for the next ride and I'll show you an even better ride!' The stallion still balls-deep inside Alexandra starts to look speculatively at you, eyes wandering down to your crotch as he asks, 'So, guess you want the next ride? Her being your bitch and all...' You nod and wave him over to the nearest bed with the stallion obediently carrying his cocksleeve over to it, bending over the frame and lowering her onto the mattress, then almost reluctantly withdrawing himself from the well-bred cavern of her sex. His flared shaft is literally white with frothed cum as he pulls out and the man tells Alexandra, 'Let's do this again soon babe!' 'How could I say no to that,' she barks back in amusement, reaching out to slide her hand over his cock before licking off his seed from her fingers. 'Fuck,' he pants lustfully under his breath before stepping aside and making room for you.";
	WaitLineBreak;

to say AlexandraFarmhandStanding_Fuck:
	say "[AlexandraFarmhandStanding_Takeover]";
	say "     Sitting on the edge of the bed for a moment, stroking your hand over her supine form and teasing Alexandra's nipples, you grin down at your bad dog bitch. She meets your eyes and pants, 'Hell, boss. Gotta say that your plan of turning me into a puppy mill really has some interesting sides. Like taking a few [italic type]yards[roman type] of equine dicks a day! It's fun to be the willing whore for so many stallions!' A cheer from your spectators makes you look up and wave to the men, followed by announcing that you're taking a turn with what's yours now. With that said, you rise halfway, then swing your leg over Alexandra and get on the bed with her. Spreading the former cop's legs, to take her in the classic missionary position, your dick twitches as you glance down at her and you revel in the fact that you took a dutiful woman this far, turning her into your fucktoy, now literally drenched in a bunch of guy's seed and loving it.";
	say "     Guiding your [cock of player] shaft in between her legs, you brush the dickhead against her folds, still open and slick from the stallions who went before you. Despite her having been railed long and hard today already, you can be sure that the bitch will be a nicely tight fuck, kinda a nice upside of a civilization-endangering nanite infection. Pushing forward into the squelching depths of your breeding slut, you grin at the canine gyrating her hips beneath you and moaning, 'Yeah boss, take your bad dog!' Her eager gasp entices you to thrust in hard, ";
	if Cunt Depth of Alexandra + 2 < Cock Length of Player:
		say "your long shaft popping right past the opening to her womb and making the woman groan and buck beneath you. It's clearly not the first time someone has pushed in there today, and with all the cum already fucked into her, Alexandra's innermost passage isn't all that hard to penetrate, with the pleasure far outweighing pain for the bitch. You can't help but feel a bit of pride at your fucktoy at being able to take such massive penetrations and lean forward to bring your head up to hers. ";
	else: [player actually fits into her]
		say "your shaft filling her receptive pussy and making the woman moan beneath you. She's warm, tight and very wet around your shaft, filled to the brim with equine cum. You can't help but feel a bit of pride at your fucktoy at being able to take such massive penetrations and lean forward to bring your head up to hers. ";
	say "Meeting the dobie's muzzle in a hungry kiss and sucking on her floppy tongue, you hammer into her again and again, fucking with deep strokes.";
	WaitLineBreak;
	say "     Chuckling and a comment of, 'Yeah, look at [ObjectPro of Player] going! No wonder she's agreed to be [PosAdj of Player] bitch!' reminds you that you have an audience. Then a second stallion snorts, 'Just you wait for my turn. She'll be smitten with this dick and drop her panties at the snap of my fingers from then on,' followed by a reply of 'Which panties?! The slut's not wearing any!' Raising your head and looking over to them, two large farmhands who're standing nearby and stroking themselves casually as they watch, you grin widely and pull yourself out of Alexandra's snatch, brushing your dickhead over her clit and drawing fresh moans from her. Then you aim a little lower and thrust in hard, all the way until your balls slap against Alexandra's skin. The bitch gasps at the sudden deep penetration and wraps her arms around your body, clinging on for the rapid-fire pounding that follows, as you prove to the audience that you're the true master of this dobie.";
	say "     Stimulating the anthro canine mercilessly, you drive her over the edge before much longer, with Alexandra letting out rapid, breathless pants and clutching you even tighter, her blunt claws leaving some light scratches on your back. She bucks against your body wildly, all the while her cum-filled pussy trembles and twitches around your manhood, almost milking your cock. Your own climax isn't far behind either, not with the sensations of her sex feeling so very good, and you bury yourself all the way into her with a deep grunt soon after. Gasping for air, you feel your balls tighten and pulse as the first heavy blast of creamy seed spurts deep into Alexandra, mingling with the earlier deposits of multiple equine studs. While you're still grinding against her, shooting more and more cum into the former cop, Alexandra licks your cheek and pants out, 'Man, with you as her boss, a bitch really gets all she can take!' And with that, she sinks back on the mattress, halfway passed out as she tries to recover from the exhaustion of constant sex.";
	WaitLineBreak;
	say "[AlexandraFarmhandStanding_TakeoverAftermath]";

to say AlexandraFarmhandStanding_Join:
	say "     A grin spreads over your face as you step up to the man next to you, reaching out to plant a hand on the bulge in his jeans and telling him that he doesn't really have to wait to get some pussy. The farmhand stares at you for a second, his eyes dancing up and down over your form before he gulps and a smile spreads over his face. 'We can do that, [sir].' Coming to stand at attention, the muscular male pops the button of his pants and pulls its zipper down, freeing a rapidly hardening equine shaft. Wrapping both hands around the length of his manhood, he slowly strokes up and down along its length, with the flared cock soon reaching its full 16 inches of erect length. With him showing his best piece off, you proceed to do the same, [if Player is not naked]pulling your clothes off in a[else]putting on a[end if] little show that has your stud entranced in no time at all, dripping pre-cum from the slit of his dickhead. And he's not the only one, as several of the other men in the room turn to watch, giving wolf-whistles and little cheers.";
	say "     Standing naked in the midst of the whole work crew, you stroke your hand over the Clydesdale's firm pecs, then reach up to hook it behind his neck and pull the guy in for a kiss. While making out, he shimmys his jeans the rest of the way down, kicking them off urgently. The next thing you know is that you're being lifted in his strong arms, with the horseman's hands underneath your ass as he holds you tight against his body. 'Hold on to my shoulders, alright?' he tells you, waiting for you to do so before removing one hand from your ass to grab his cock and lining it up with your waiting pussy.  With a little bit of squeezing, his large flared head pops past your opening and slides deep into your body, with the guy lowering you relatively gently onto his cock. 'Nnngh, nice and tight,' he grunts as he bottoms out, squeezing your ass appreciatively.";
	WaitLineBreak;
	say "     Held aloft by his strong arms and the huge cock you're now impaled on, you're carried over to where Alexandra is still being railed, every step of your own anthro making his dick shift inside you and rub sensitive spots. Soon, he steps up besides the other naked Clydesdale, calling out a proud, 'Hey bro, look what I got!' An amused snort is the only reply, thought the other male gives you a lusty once-over with his gaze. Then you hear a female voice say, 'Hey boss, guess you wanted some equine action yourself, eh? Quite a feeling to be ridden by a horse!' You can't help but to agree, half-moaning your reply to Alexandra as your stud chooses that moment to grind his cock into your sex and almost taking your breath away with the sensations it creates.";
	say "     All around your little double-feature of standing fucks, you hear more horsemen chatting, laughing and cheering on their brethren, with some things you can make out being, 'What, there's two bitches now?!' 'Yeah, guess the bossy one is as much as a nympho as the doberman. Guess [SubjectPro of Player]'d have to be if [SubjectPro of Player] usually lives with Alexandra.' 'Fuck, I wanna do both of em!' From the sounds of it, your added participation has made today an occasion that will be very well remembered indeed. The men continue to chat, but you're too distracted by your stud starting to jack-hammer is pick into your pussy to really take any notice of it after that. Your world basically shrinks to just the important parts, yourself, the towering equine holding you against his crotch and the almost one and a half foot long shaft buried in your snatch.";
	WaitLineBreak;
	say "     The strong hands of the Clydesdale stud switch between lifting you and driving you down on his giant erection, all the while keeping you held against him with almost effortless ease. He goes faster and faster, driving your libido through the roof until you finally can't contain yourself anymore and let out a half-shouted moan as you orgasm, your juices making his shaft extra slippery and matting the fur of his crotch. Balls-deep inside your spasming pussy, the horseman isn't far behind either, letting out a lust-filled whinny the second a first big blast of his seed shoots into your depths. More than a dozen heavy spurts follow, making sure your pussy and womb are well and truly drenched in equine cum. As you slowly come down from the intense orgasm afterwards, you glance over to Alexandra and see that her own stallion must have finished at the same time as yours and that another of the large males is standing close them.";
	say "     'Come on, hand her over!' the new guy demands, and the stud inside Alexandra reluctantly draws her away from his hips, his shaft literally white with frothed cum as it emerges. Finally only the flared head of his organ is inside her, tugging a little at her opening from the inside. The second horseman snakes his arms under her, getting a good grip and pulling her off the other farmhand in a gush of cum to splatter onto the floor and their hooves, only stopping as he rams her down on his own erection. Wet and dripping as she is, even the massive size of his shaft is no hindrance in penetrating your breeding bitch, with Alexandra giving a lusty gasp as she is filled to the brim, even showing a small bulge in her stomach from the sheer length of his shaft. 'Fuck,' she pants breathlessly as he starts to hammer her sex, turning around as if to show off his new cocksleeve to everyone in the room.";
	WaitLineBreak;
	say "     You watch for a little while longer while yet another male takes Alexandra, secure in the arms of your stallion, who is enjoying the time of just holding onto you and having his shaft in a warm and tight sheath freshly bred with his seed. Seems like the other men are holding off from treating you the same as Alexandra, what with you being an authority figure. He even nuzzles the side of your neck a little, licking over your sweaty skin while lightly groping your naked body. For a moment, you imagine getting the same treatment as your breeding bitch, getting all the cock one can take. Feels tempting, but you refrain from actually asking for another horseman to fuck you, as you have to tell yourself that you've got to worry about surviving in the city, and losing oneself in a big orgy isn't the best way to do.";
	say "     Upon your request, the guy who fucked you is nice enough to carry you over into the communal bathroom, followed by a hot shower and gentle scrubbing of your back. By the time you return into the main room of the worker barracks, naked, clean and towelled, Alexandra is ling on top of a farmhand in his bed, both of them dozing and with his cock still in her cum-dripping pussy. Chuckling at the sight, you collect your gear and get dressed.";
	CreatureSexAftermath "Player" receives "PussyFuck" from "Horseman";

to say AlexandraFarmhandStanding_Eat:
	say "[AlexandraFarmhandStanding_Takeover]";
	say "     Sitting on the edge of the bed for a moment, stroking your hand over her supine form and teasing Alexandra's nipples, you grin down at your bad dog bitch. She meets your eyes and pants, 'Hell, boss. Gotta say that your plan of turning me into a puppy mill really has some interesting sides. Like taking a few [italic type]yards[roman type] of equine dicks a day! It's fun to be the willing whore for so many stallions!' A cheer from your spectators makes you look up and wave to the men, followed by announcing that you're taking a turn with what's yours now. With that said, you rise halfway, then swing your leg over Alexandra and get on the bed with her, in the classical 69 position. On all fours on top of the doberwoman, you can't help but get a good whiff of the manly aroma of equine cum and revel for a second in the fact that you took a dutiful policewoman this far, turning her into your fucktoy, now literally drenched in a bunch of guy's seed and loving it.";
	say "     A lick over your [if player is male]erect cock[else if player is female]moist folds[else]sensitive crotch[end if] shakes you out of your thoughts, followed by Alexandra's sloppy tongue washing over your skin once more. 'You like the look of that, eh boss? Your doggie bitch, squelchingly full of cum[if Sterile of Alexandra is false] and most likely already knocked up again[end if]!' Choosing to show your feelings in actions, not words, you lower your head and lick her clit, tasting equine seed as you play your tongue over her pleasure-button. 'Nnghh,' comes Alexandra's reply, somewhat muffled as she's got her muzzle pressed to your crotch, giving back oral pleasure in turn. Your mutual stimulation encourages you to go deeper, tracing the outer folds of her sex with the tip of your tongue before dipping in between them and lapping up a little of the potent mixture of equine seed and female juices.";
	WaitLineBreak;
	say "     You spend the next little while with your head between Alexandra's legs, eating out her stallion-stretched pussy and teasing its sensitive pleasure-points with patient attention, all the while humping your own hips up and down as you enjoy the former cop's talented tongue. With yourself being fresh instead of already having orgasmed several times, it's little wonder that the anthro canine's ministrations drive you past the point of no return first, groaning in lust as you [if player is male]come while inside of her muzzle, spurting your seed over Alexandra's tongue[else if player is female]come, with her wet nose pressed against your clit and Alexandra's tongue wiggling inside your pussy[else]come, trembling all over as your body writhes in ecstasy[end if]. You ride out your orgasm, enjoying every moment of it, then take a deep breath and get back to work on your bitch's pussy, happy to give her a reward for being a good little fuckpet.";
	say "     Now going all out in servicing her, eager to share your pleasure with Alexandra, you not only suckle and lick on her clit but also bring in your fingers to dig in between her nether lips. Pulling them out wet with cum just gives you more to lick up, and you lick and finger your anthro doggie while her moans get louder and more urgent by the moment. Then Alexandra bucks up under you, grinding her crotch against your face and lets out a needy whimper, followed by barks of pleasure as you plant your mouth over her clit and suck on it. 'Fffuckk yeah!' the bitch pants out loud, riding the wave of her climax. You keep at it, never letting up from her clit or wiggling your fingers inside her pussy while she's still trembling and twitching, doing your best to extend her orgasm as long as you can. This culminates in your dobie bitch eventually going limp on the bed, head lolling a little with closed eyes as she finds herself in sensory overload.";
	WaitLineBreak;
	say "[AlexandraFarmhandStanding_TakeoverAftermath]";

to say AlexandraFarmhandStanding_TakeoverAftermath:
	say "     You stay in intimate closeness with Alexandra for a little while, before eventually extracting yourself from the bed and standing up. Lots of grinning faces from the farmhands tell you that they enjoyed the show quite a bit. [bold type]Some sidelong glances the guys are giving Alexandra and yourself seem to ask the question of who'll go next, to which your answer is:[roman type][line break]";
	say "     [link](1)[as]1[end link] - They'll figure it out between each other.";
	say "     [link](2)[as]2[end link] - Wave the guy you talked with at the start over.";
	say "     [link](3)[as]3[end link] - They should give it a rest for now.";
	now calcnumber is 0;
	while calcnumber < 1 or calcnumber > 3:
		say "Choice? (1-3)>[run paragraph on]";
		get a number;
		if calcnumber is 1 or calcnumber is 2 or calcnumber is 3:
			break;
		else:
			say "Invalid choice. Type [link]1[end link] to let them sort it out, [link]2[end link] to wave the hoseman you talked with over or [link]3[end link] to let her rest.";
	if calcnumber is 1:
		LineBreak;
		say "     With a chuckle, you wave them to step up and have a go with Alexandra, then stroll over to where you stashed your gear [if player is not naked]and clothing[end if]. Behind you, there's some murmuring and quiet discussion, followed by an amused bark, then the wet and squelching noises of sex. Having already gotten off, you more or less ignore the action going on around Alexandra until it eventually dies down and she is stable on her legs enough again to put her pants back on.";
	else if calcnumber is 2:
		LineBreak;
		say "     With a chuckle, you point at the guy you talked before, right after coming in here. He looks left and right, if you might be meaning someone else, then smiles broadly as he realizes that it's his lucky day. Almost instantly, the bulge in his pants grows a little and he has to adjust his manhood while walking over to you. 'Thanks, I've been looking forward to having a go!' the man says, squeezing your upper arm in a show of comraderie. Telling him to have fun, you then stroll over to where you stashed your gear [if player is not naked]and clothing[end if]. Behind you, there's some murmuring and quiet discussion, followed by an amused bark, then the wet and squelching noises of sex. Having already gotten off, you more or less ignore the action going on around Alexandra until it eventually dies down and she is stable on her legs enough again to put her pants back on.";
	else:
		say "     Clearing your throat, you announce that the guys should give Alexandra a rest for now. Some grumbling and groaning fills the room at your proclamation, but the men take your ruling obediently enough. Meanwhile, Alexandra is too out of it to even react, having dozed off on the bed. With a last look at her mostly naked, cum-covered form, you stroll over to where you stashed your gear [if player is not naked]and clothing[end if].";

Section 3 - Karel & Isaac

to say AlexandraBreeding_Karel_Isaac:
	if Energy of Alexandra is 0: [first time]
		say "     A smile plays over your lips as you ask the doberwoman if she likes horses. Alexandra lets out a snort, and she raises one eyebrow as she looks you in the eyes. 'Really? Boss, you may be one tough motherfucker, but sometimes you ask fucking stupid questions. Let me tell you this: Any woman who once was a little girl likes horses! Even the ones who only ever encountered horses in the shape of a plastic toy that their bitch of a mom stole from a yard sale!' For a moment, there is a far-away expression in Alexandra's eye, then she shakes her head and focuses on you again. 'I think what you wanted to ask is if I want to be fucked by one, ain't that right? Since this whole fucking outbreak started, I've seen quite a few different dicks, and I gotta admit, a horsecock has an interesting shape. So, do you have a breeding stallion stashed up in an alley somewhere or what?'";
		say "     Explaining to Alexandra that you know a farm out in the dry plains that is staffed by (more or less) well-behaved anthro stallions, you earn a laugh from the former cop. 'You're really invested in your little breeding program, eh? Planning a road trip through monster-infested streets to see me knocked up by just the right stud.' Studs, you correct her, explaining that there's a pair of black-furred twins you have in mind. 'Fancy that, eh? A double-pack of hunks to sink their dicks into me. Fine, boss, that does actually sound like fun. Let's get going!' Putting her clothes back in order, Alexandra saunters over to the entrance and waits there for you, her tail wagging left and right. It actually looks like she's eager to get going, so you gather your own gear in short notice and set out with the anthro bitch.";
		WaitLineBreak;
		say "     Wandering through the chaotic streets of the city, you skirt around wrecked cars, heaps of trash, and frequent shreds of often cum-soaked clothing. As the two of you move in a focused manner with a goal in mind, most creatures on the way do avoid you, preferring to hide or wait for easier targets to attack and bring down. Yet by the time that you've almost reached the edge of the dry plains, there is one guy who doesn't seem to have gotten the memo: ";
		let randomnumber be a random number from 1 to 3;
		if randomnumber is:
			-- 1:[husky encounter]
				project the Figure of HuskyAlpha_soft_icon;
				say "An Alpha Husky steps into your way from behind the crumbling wall of a ruined building, a predatory grin spreading over his muzzle. 'What do we have here? A sweet little bitch just wandering into my territory. I could smell your wet pussy when you were a block away!' He sniffs the air with a grin on his muzzle, eyes roaming up and down over Alexandra's form. Almost as an afterthought, he throws you a glance too. 'Ooh, you're taking your bitch for a walk, is that it? Tough luck! Wherever you think you are going, you can forget about that! I'll take her off of your hands, and she'll be another slut in my pack!'";
				say "     As you start to protest and say that Alexandra is yours, the doberwoman keeps an uncharacteristic passive stance, lowering her head and only looking at the husky from the corner of her eye. He apparently decides that this means that she's no threat and struts closer, puffing out his chest as he growls at you in challenge. 'If you don't want to get a beating, you should fuck off now while I introduce this slut to my d-gnnnhhhHHH!' His further words come out as nothing more than a breathless groan after Alexandra knees him in the groin hard, sending the husky falling down to his knees. 'Let's leave this stupid asshat here in the street, boss. Maybe someone will come along and make use of him somehow. He's definitely a waste of space in the pack leader department if he fell for that simple trick.' With that said, she gives the guy a kick in the side, snorting derisively as he curls up into a ball. Then she continues to stroll down the street without looking back.";
			-- 2:[minotaur encounter]
				say "The towering shape of a minotaur stomps out of an alley just ahead of you, sniffing the air with interest. He seems to hone in on Alexandra, something about her drawing intense interest in the large male. You can see his dick starting to throb and grow. Then he grunts, 'Mmmhh! Pussy!' Alexandra lets out a sigh and face-palms, then calls over to you, 'Can you believe this guy? Calling me a pussy when it's totally obvious that I'm a bitch!' The way she wiggles her eyebrows and makes a circling movement with one hand tells you that the former cop has a plan, so you join and call back to her in a loud voice, drawing the attention of the minotaur.";
				say "     Using the opportunity, your doberwoman takes a few steps to pick up something from the ground: A pair of mostly intact panties as well as a chunk of rock that she keeps hidden behind her back. Looking back and forth between the two of you, the minotaur grunts out the word 'Pussy' again a moment later, then starts to walk towards Alexandra. 'You like my scent, don't you, big guy?' she asks him teasingly, moving the hand with the panties to slide under her waistband and rubbing the fabric against her crotch. By the time the bull-man reaches her, the garment is damp with her juices, and Alexandra holds it out for the minotaur to sniff, tucking it lower and lower until he's bent forward quite significantly. That's the moment when she strikes, hitting him between the eyes with her rock and momentarily stunning the big brute. 'Let's ditch this dip-shit!' the dobie shouts to you with a mocking bark, and you follow her advice, gaining sufficient distance before the minotaur manages to gather his wits again.";
			-- 3:[hawkman]
				project the Figure of Hawkman_naked_icon;
				say "A hawkman swoops down on the two of you with a screech, claws extended to slice or grab. Thankfully Alexandra is far from just a passive slut, and the tough bitch throws herself out of the way of his attack, landing in a crouch after a roll on the asphalt. The attacker isn't ready to just call it quits that easily though, and he takes a turn to attack again, only to find himself pelted with the rocks and trash Alexandra is finding around herself on the street. You join in after a moment or two and together drive off the aerial attacker.";
		WaitLineBreak;
		follow the ngraphics_blank rule;
		say "     Having dealt with the unfriendly encounter, you and Alexandra continue on your way, soon reaching the open expanse of the dry plains. No longer having to follow the road grid now, with sometimes blocked passages, you make faster headway and manage to avoid further unpleasantness until you reach the entrance to the McDermott Farm grounds. Passing a work crew that is cutting down the creeping grass along the borderline with scythes, Alexandra lets out a wolf whistle at the muscular horsemen. 'I can see why you want me to fuck one of them, boss. Not quite the type of horsie ride younger me would have imagined, but I'm definitely interested in feeling one of those studs inside of me!' A strapping anthro Clydesdale actually pauses in his work, rubbing the crotch of his jeans as he poses enticingly for Alexandra, but one of his buddies clears his throat and reminds the hunk that he's on shift. 'Fucking lucky bastards that are in the barracks right now,' he grumbles, then goes back to cutting the grass.";
		say "     Leaving the archway marking the entrance to the farm behind, you guide Alexandra over to the worker quarters and step inside of the open barracks building. This long structure is mostly one large room, a kind of living area at the front with a table, sofas, and a TV, the back half filled with quite a few bunk beds spaced a bit apart, with tall lockers in between. Several farm-workers are always present, for the main part anthro horsemen, and you have little trouble spotting the ones you're here for. [one of]Back in front of the lockers [or]Sitting at a table and playing cards with one another [or]Just walking out from the showers out back [or] Dozing on their bunk beds [at random]are two black-coated Friesians, looking totally identical from the distance. Patting Alexandra's arm, you point the two of them out to her, which makes her tail wag even harder than before. Some of the other horsemen in here approach your dobie bitch and start to chat her up while you walk up to the twins to talk to them.";
		WaitLineBreak;
		project Figure of Karel&Isaac_clothed_icon;
		say "     Giving the two brothers a friendly greeting, you shake the strong hand of the first one then the other, then explain that you have got a proposition for them. 'Do say, pardner. Might that have something to do with your quite attractive lady-friend over there?' one of the horsemen replies with a smirk, nodding to where Alexandra is chatting with several of the workers, her shapely breasts in full view of the men. You reply that Alexandra is indeed what you wanted to talk to them about, explaining that she's your breeding bitch, and you're looking for some strapping men who could serve as studs. The second twin cranes his neck to look over at the former cop, who by now has her hand in the pants of a horseman, feeling his equine shaft. 'Well, that certainly looks like an eager one,' he says with a chuckle, and his brother throws in, ";
		if FriesianRelationship is 0: [never interacted before]
			say "'Okay then, there's two things you need to know ";
		else if FriesianRelationship is 1: [player did things with them before (orgy most likely), but never was introduced]
			say "'Okay then. We didn't have time to tell you before, but... ";
		else: [player was told the names before]
			say "'Okay then, and nice to see you again. I know that we've had some fun before, but since people never can tell us apart... ";
		say "I'm Karel and he's Isaac,' pointing at himself, then his twin brother.";
		if FriesianRelationship < 2: [variable adjustment for those who do not know their names]
			now FriesianRelationship is 2; [player was told their names]
		say "     'Now then, I think we should get over there and meet her before one of the guys gets some ideas.' Flanked by the two horsemen, you make your way back to Alexandra, finding her with two erect horsecocks in her hands. As you step up, she chuckles and presses the cocks together, stroking them between her hands. The farmhands attached to them (a Clydesdale and a zebra) look somewhat startled for a second, then shrug and just enjoy. Hearing you clearing your throat, Alexandra says, 'Sorry, boys, duty calls. I'm sure that you'll manage without me, right?' With a grin on her face, she pulls up the zebra's hand and wraps his fingers around the shafts, then saunters over to you and the twins. As she arrives, you lay your arm around Alexandra's shoulders and pull her close to you. Tucking open her leather jacket, you place a hand on the rounded swell of her breasts and give them a good grope, demonstrating your dominance over the otherwise so headstrong bitch, as she simply leans into your touch and quips, 'Changed your mind boss and want to fuck me personally after all?'";
		WaitLineBreak;
		say "     Giving her nipple a good pinch that draws a moan from the former cop, you tell her that you've got two strapping studs to breed her right here before her. After making introductions between the Friesians and your dobie, you start to say something more but are cut short by the bad bitch smirking and asking, 'So, which them is gonna fuck me first?' Karel and Isaac laugh at her unashamed question, and Isaac replies, 'You're gonna be quite popular with that outlook in here, ma'am. We don't usually get women who just waltz in here and offer themselves. Or who are volunteered to be knocked up by their partners.' Playfully pinching your dobie bitch's nipples again, you pull her muzzle to the side to give her a lust-filled kiss, then tell the two men that Alexandra is yours and will do what she's told. [if Player is female]And you do enjoy a good breeding, maybe even personally too.[end if] 'Anything for you, boss!' the former cop barks out in reply, licking your cheek and leaning against your side. 'So, you guys decided yet who gets the first dip?'";
		say "     The brothers shake their head good-naturedly at your relationship with Alexandra, then Isaac raises a fist and lightly taps it into the palm of his other hand. Karel picks up on what he means right away and they do a lightning-quick round of rock, paper, scissors that leaves the second twin as the victor. 'Oh yeah!' the lucky farmhand exclaims, stepping up to Alexandra, whom you release into his embrace, to be drawn into a kiss on the muzzle. The dobie enthusiastically leans into his caress, throwing her arms around the tall horseman's neck and pulling herself up to wrap both legs around his hips. Watching in amazement as his brother is literally jumped by a sexy bitch, with her grinding her hips against his body as their tongues wrestle back and forth, Isaac gives your arm a friendly pat and nods respectfully. 'That's quite a lady you got there. Makes me glad you picked my bro and me for your kinky play.'";
		WaitLineBreak;
		project Figure of Karel_hard_icon;
		say "     Then he clears his throat and adds, 'Hey, Karel, maybe we should take this somewhere else, or the boys are gonna get jealous as fuck!' You have a quick glance over the wide open barracks room, seeing that several horsemen are indeed stroking the bulges in their pants, watching with intent expressions. Of course, some of them are focused on Alexandra's earlier playmates, who're still stroking their dicks together, but most are clearly after your naughty bitch. Still intensely making out with the former cop, the second twin replies with only a grunt, yet slowly walks after his brother and yourself as Isaac leads the way into a side room. Finding yourself in what seems to be a miniature laundromat, complete with a row of four washing machines and the same number of driers, you watch Karel carry Alexandra over to one of them and then sit her on the machine, untangling himself from the bitch. 'Just a sec, darlin[']. Gotta take care of something that's giving me an awful pinch!'";
		say "     With a grin on his equine muzzle, Karel pops the button of his jeans and pulls down the zipper, allowing the content of his large bulge to flop out freely: a roughly 15 inch long cock, night-black as his furry coat and sporting a blunt tip with a flared crown. As he shoves down his pants, a hefty pair of goose-egg sized balls are revealed, promising that the stud will do his proper duty for impregnating your bad dog bitch. Alexandra certainly seems to think so, as she lets out a barking laugh when she sees how hung the stallion is. 'Now that's a proper man!' she comments, pulling the front of her jacket fully open and presenting him with her swaying breasts. Karel lowers his head to lick them, teasing her nipples with the strokes of his broad tongue while his hands move to her hips. For having fairly big hoof-like nails, the young man's fingers are still quite dexterous, and he has no trouble at all undoing her buttons and pulling the jeans down over her furry ass.";
		WaitLineBreak;
		project Figure of Isaac_hard_icon;
		say "     Meanwhile, you hear the quiet click of a door being closed from behind, and Isaac steps up to stand beside you, eyes on his twin and your horny bitch. Karel peels the jeans off Alexandra's legs and throws them aside, then sinks down to stick his muzzle between her legs. His large nostrils flare as he takes a long sniff of the musky aroma of her arousal, followed by tracing his tongue over the glistening folds of her sex. 'Fuuckk! You're good with your tongue, horsie!' Alexandra groans out, her tongue lolling out of her muzzle as she digs her fingers into his mane and pulls him against her crotch. A hand on your arm pulls your attention away from Alexandra being orally pleasured a moment later, over to the other Friesian farmhand. Isaac smiles at you and clears his throat, 'So, just how kinky are you personally, if you got a bitch like this? I can't help but note that you went out to get two studs...'";
		LineBreak;
		say "[AlexandraFriesianSexMenu]";
		LineBreak;
		say "     After setting down your backpack and making sure that the library is still secure, you return to where Alexandra is hanging out. Hooking a hand behind the ex-cop's head and pulling her in for a kiss on the muzzle, you ask the dobie bitch what she thought of your little trip to the farm. She laughs and replies, 'Well boss, I think that was one of the best ideas you've had since I met you. Those horsecocks really fill a woman up, that's for sure! Karel and Issac are cute too, in their country-boy way. I almost was sorry to have to go after, wouldn't have minded to keep going with em, one to fuck while the other recovers, hah!' Grinning to yourself at the tough but willing slut you've made out of the prim and proper policewoman in such a short time, you place a hand on her belly [if Sterile of Alexandra is true]and imagine it bulging out under a thrusting cock. [else]as you imagine it swelling with a litter of puppies. [end if][bold type]The idea of just keeping her at the farm for a while, for repeated breeding sticks in the back of your head. Maybe you can bring it up sometime...[roman type][line break]";
		now Energy of Alexandra is 1;
	else if Energy of Alexandra > 0: [repeat]
		if Alexandra is in Grey Abbey Library: [still got to move her there]
			say "     A smile plays over your lips as you tell Alexandra that you're taking her back to the farm for another session with Karel and Isaac. The former cop lets out an amused snort, then comments, 'Hah! Good thing you're so invested in your little breeding program, if I'm getting pounded by grade A stud-meat because of that. I won't even complain about how stupid an idea it is to do a road trip through monster-infested streets just to see me knocked up.' Grabbing her by the back of the neck, you pull the bitch closer and kiss her a little forcefully. Letting your hands wander over her breasts, you remind Alexandra that she's your bitch, and if you want to have her bred by someone specific, or just stake her out to be fucked by anyone wandering past, that's your choice. 'Hey boss, I didn't say I wasn't going to spread my legs! No need to get rough, I'm down for some breeding, so let's get going!'";
			WaitLineBreak;
			say "     Putting her clothes back in order, Alexandra saunters over to the entrance and waits there for you, her tail wagging left and right. It actually looks like she's eager to get going, so you gather your own gear in short notice and set out with the anthro bitch. Wandering through the chaotic streets of the city, you skirt around wrecked cars, heaps of trash, and frequent shreds of often cum-soaked clothing. As the two of you move in a focused manner with a goal in mind, most creatures on the way do avoid you, preferring to hide or wait for easier targets to attack and bring down. Yet by the time that you've almost reached the edge of the dry plains, there is one guy who doesn't seem to have gotten the memo: ";
			let randomnumber be a random number from 1 to 3;
			if randomnumber is:
				-- 1:[husky encounter]
					project the Figure of HuskyAlpha_soft_icon;
					say "An Alpha Husky steps into your way from behind the crumbling wall of a ruined building, a predatory grin spreading over his muzzle. 'What do we have here? A sweet little bitch just wandering into my territory. I could smell your wet pussy when you were a block away!' He sniffs the air with a grin on his muzzle, eyes roaming up and down over Alexandra's form. Almost as an afterthought, he throws you a glance too. 'Ooh, you're taking your bitch for a walk, is that it? Tough luck! Wherever you think you are going, you can forget about that! I'll take her off of your hands, and she'll be another slut in my pack!'";
					say "     As you start to protest and say that Alexandra is yours, the doberwoman keeps an uncharacteristic passive stance, lowering her head and only looking at the husky from the corner of her eye. He apparently decides that this means that she's no threat and struts closer, puffing out his chest as he growls at you in challenge. 'If you don't want to get a beating, you should fuck off now while I introduce this slut to my d-gnnnhhhHHH!' His further words come out as nothing more than a breathless groan after Alexandra knees him in the groin hard, sending the husky falling down to his knees. 'Let's leave this stupid asshat here in the street, boss. Maybe someone will come along and make use of him somehow. He's definitely a waste of space in the pack leader department if he fell for that simple trick.' With that said, she gives the guy a kick in the side, snorting derisively as he curls up into a ball. Then she continues to stroll down the street without looking back.";
				-- 2:[minotaur encounter]
					say "The towering shape of a minotaur stomps out of an alley just ahead of you, sniffing the air with interest. He seems to hone in on Alexandra, something about her drawing intense interest in the large male. You can see his dick starting to throb and grow. Then he grunts, 'Mmmhh! Pussy!' Alexandra lets out a sigh and face-palms, then calls over to you, 'Can you believe this guy? Calling me a pussy when it's totally obvious that I'm a bitch!' The way she wiggles her eyebrows and makes a circling movement with one hand tells you that the former cop has a plan, so you join and call back to her in a loud voice, drawing the attention of the minotaur.";
					say "     Using the opportunity, your doberwoman takes a few steps to pick up something from the ground: A pair of mostly intact panties as well as a chunk of rock that she keeps hidden behind her back. Looking back and forth between the two of you, the minotaur grunts out the word 'Pussy' again a moment later, then starts to walk towards Alexandra. 'You like my scent, don't you, big guy?' she asks him teasingly, moving the hand with the panties to slide under her waistband and rubbing the fabric against her crotch. By the time the bull-man reaches her, the garment is damp with her juices, and Alexandra holds it out for the minotaur to sniff, tucking it lower and lower until he's bent forward quite significantly. That's the moment when she strikes, hitting him between the eyes with her rock and momentarily stunning the big brute. 'Let's ditch this dip-shit!' the dobie shouts to you with a mocking bark, and you follow her advice, gaining sufficient distance before the minotaur manages to gather his wits again.";
				-- 3:[hawkman]
					project the Figure of Hawkman_naked_icon;
					say "A hawkman swoops down on the two of you with a screech, claws extended to slice or grab. Thankfully Alexandra is far from just a passive slut, and the tough bitch throws herself out of the way of his attack, landing in a crouch after a roll on the asphalt. The attacker isn't ready to just call it quits that easily though, and he takes a turn to attack again, only to find himself pelted with the rocks and trash Alexandra is finding around herself on the street. You join in after a moment or two and together drive off the aerial attacker.";
			WaitLineBreak;
			follow the ngraphics_blank rule;
			say "     Having dealt with the unfriendly encounter, you and Alexandra continue on your way, soon reaching the open expanse of the dry plains. No longer having to follow the road grid now, with sometimes blocked passages, you make faster headway and manage to avoid further unpleasantness until you reach the entrance to the McDermott Farm grounds. Passing a work crew that is cutting down the creeping grass along the borderline with scythes, Alexandra lets out a wolf whistle at the muscular horsemen. 'Hey boys, we're back!' Several of the strapping anthro Clydesdales pause in their work, rubbing the crotches of their jeans as they direct lewd stares at Alexandra. It takes the foreman clearing his throat to remind them that they're on shift and should get back to work. 'Fucking lucky bastards that are in the barracks right now,' one of the men grumbles, then joins his comrades in cutting the grass.";
			say "     Leaving the archway marking the entrance to the farm behind, you guide Alexandra over to the worker quarters and step inside of the open barracks building. This long structure is mostly one large room, a kind of living area at the front with a table, sofas, and a TV, the back half filled with quite a few bunk beds spaced a bit apart, with tall lockers in between. Several farm-workers are always present, for the main part anthro horsemen, and you have little trouble spotting the ones you're here for. [one of]Back in front of the lockers [or]Sitting at a table and playing cards with one another [or]Just walking out from the showers out back [or] Dozing on their bunk beds [at random]are Karel and Isaac, the two black-coated Friesians looking totally identical from the distance. Patting Alexandra's arm, you point the two of them out to her, which makes her tail wag even harder than before. Some of the other horsemen in here approach and try to chat your dobie bitch up, only to have her saunter past them and straight to the twins.";
		else: [already in the barracks]
			say "     A smile plays over your lips as you tell Alexandra that you want to see her in another session with Karel and Isaac. The former cop lets out an amused snort, then comments, 'Hah! Good thing you're so invested in your little breeding program, if I'm getting pounded by grade A stud-meat because of that. And especially from those two!' Grabbing her by the back of the neck, you pull the bitch closer and kiss her a little forcefully. Letting your hands wander over her breasts, you remind Alexandra that she's your bitch, and you'll have her bred whenever you want. 'Yeah boss, anything you say. I'm down for some breeding, so let's get going!' With that, you guide her over to where you spotted the black-furred Friesian horsemen earlier, a broad grin on your face.";
		WaitLineBreak;
		project Figure of Karel&Isaac_clothed_icon;
		project Figure of Karel_hard_icon;
		say "     'Welcome back,' the two brothers say almost in unison, with Karel stepping forward to shake your hand while Isaac focuses mainly on Alexandra, even having to adjust his trouser-snake as it throbs and seems to grow in his pants. Your dobie bitch chuckles as she sees the effect she is having on the tall stallion and saunters over to him, then opens her jacket and exposes her full breasts for him to see, even going so far as to press them against his abs when she lays her arm around him. 'Someone's eager to get in me I see!' she calls out over her shoulder, making Karel grin. 'I guess we don't have to ask why you're here again. Your woman likes horses, hm?' Replying that Alexandra does indeed like them, but that it is you who chose Karel and Isaac again, you whistle for the bitch, calling her over to stand by your side. Raising your hand and groping her breasts demonstratively, you explain that you want the two Friesians to breed her, here and now.";
		say "     As a crowd is already gathering around the four of you, the twins once again lead your little group over to the laundry room, securely closing the door to keep the others out. Karel picks Alexandra up and sits her on one of the washing machines, then says, 'Just a sec, darlin. Gotta take care of something that's giving me an awful pinch!' With a grin on his equine muzzle, the large horseman pops the button of his jeans and pulls down the zipper, allowing the content of his large bulge to flop out freely: a roughly 15 inch long cock, night-black as his furry coat and sporting a blunt tip with a flared crown. As he shoves down his pants, a hefty pair of goose-egg sized balls are revealed, promising that the stud will do his proper duty for impregnating your bad dog bitch. Alexandra certainly seems to think so, as she lets out a barking laugh when she sees how hung the stallion is.";
		WaitLineBreak;
		say "     'Now that's a proper man!' she comments, pulling the front of her jacket fully open and presenting him with her swaying breasts. Karel lowers his head to lick them, teasing her nipples with the strokes of his broad tongue while his hands move to her hips. For having fairly big hoof-like nails, the young man's fingers are still quite dexterous, and he has no trouble at all undoing her buttons and pulling the jeans down over her furry ass. Meanwhile, Isaac steps up to stand beside you, eyes on his twin and your horny bitch. Karel peels the jeans off Alexandra's legs and throws them aside, then sinks down to stick his muzzle between her legs. His large nostrils flare as he takes a long sniff of the musky aroma of her arousal, followed by tracing his tongue over the glistening folds of her sex. 'Fuuckk! You're good with your tongue, horsie!' Alexandra groans out, her tongue lolling out of her muzzle as she digs her fingers into his mane and pulls him against her crotch.";
		say "     A hand on your arm pulls your attention away from Alexandra being orally pleasured a moment later, over to the other Friesian farmhand. Isaac smiles at you and clears his throat, 'So, just how kinky are you personally, if you got a bitch like this? I can't help but note that you went out to get two studs...'";
		LineBreak;
		say "[AlexandraFriesianSexMenu]";

to say AlexandraFriesianSexMenu:
	now sextablerun is 0;
	blank out the whole of table of fucking options;
	say "     [bold type]How do you want this to go from here?[roman type][line break]";
	[]
	if Player is female:
		choose a blank row in table of fucking options;
		now title entry is "Your dobie bitch isn't the only one who needs a good filling";
		now sortorder entry is 1;
		now description entry is "Get fucked right along with Alexandra";
	[]
	choose a blank row in table of fucking options;
	now title entry is "Stroke Isaac's dick until it's his turn";
	now sortorder entry is 2;
	now description entry is "Get your hands on Isaac's dick and have him primed to go as soon as Karel fills Alexandra";
	[]
	choose a blank row in table of fucking options;
	now title entry is "Just stand back and watch the action";
	now sortorder entry is 3;
	now description entry is "Let them do what they will and have a ringside seat, but do not interact";
	[]
	choose a blank row in table of fucking options;
	now title entry is "You'll step out and leave them to it";
	now sortorder entry is 4;
	now description entry is "Wait in the barracks while the Friesian farmhands double-team Alexandra";
	[]
	sort the table of fucking options in sortorder order;
	repeat with y running from 1 to number of filled rows in table of fucking options:
		choose row y from the table of fucking options;
		say "[link][y] - [title entry][as][y][end link][line break]";
	say "[link]0 - Nevermind[as]0[end link][line break]";
	while sextablerun is 0:
		say "Pick the corresponding number> [run paragraph on]";
		get a number;
		if calcnumber > 0 and calcnumber <= the number of filled rows in table of fucking options:
			now current menu selection is calcnumber;
			choose row calcnumber in table of fucking options;
			say "[title entry]: [description entry]?";
			if Player consents:
				let nam be title entry;
				now sextablerun is 1;
				if (nam is "Your dobie bitch isn't the only one who needs a good filling"):
					say "[AlexandraFriesianBreeding1]";
				else if (nam is "Stroke Isaac's dick until it's his turn"):
					say "[AlexandraFriesianBreeding2]";
				else if (nam is "Just stand back and watch the action"):
					say "[AlexandraFriesianBreeding3]";
				else if (nam is "You'll step out and leave them to it"):
					say "[AlexandraFriesianBreeding4]";
				wait for any key;
		else if calcnumber is 0:
			now sextablerun is 1;
			say "[AlexandraFriesianBreeding4]";
			wait for any key;
		else:
			say "Invalid Option. Pick between 1 and [the number of filled rows in the table of fucking options] or 0 to exit.";
	clear the screen and hyperlink list;

to say AlexandraFriesianBreeding1: [female player gets fucked]
	say "     With a grin spreading over your face, you tell Isaac that Alexandra is your prized breeding slut, and you do want to see her pumped full of premium seed - but she isn't the only one that needs a good pounding. Between her and yourself, two virile studs should be just enough to have fun! 'We'll certainly do our best, [sir],' the farmhand replies eagerly, a broad smile on his muzzle. Reaching out to lay his arm around your midriff, he guides you over to where Karel is still licking Alexandra's pussy, tapping the washing machine one to the right for you to sit on. As Isaac starts to undo his pants, [if player is not naked]you quickly shimmy out of your own clothes, then [else]you [end if]spread your legs, baring your sex to him. The enticing view is well appreciated, a fact that is made obvious when his night-black shaft quickly pushes out of the sheath, swinging in the air in its 17 inch long, girthy majesty.";
	say "     Kicking his jeans off fully and looking back and forth between yourself and Alexandra, Isaac pats Karel's shoulder and says, 'We hit the jackpot, bro!' As the other twin's muzzle is buried between Alexandra's thighs and his tongue exploring her pussy, the reply is simply a pleased grunt and loud hum that makes your dobie bitch tremble and pant from the vibrations he's creating. 'Guess we can say the same, eh?' the former cop comments while her hand seeks out your own, clutching it tightly as Karel's continued licks build up her arousal to new heights. Clearly eager to catch up with his brother, Isaac sinks down into a crouch and bends his head over your laid-back form, his broad tongue stroking all the way across your crotch. The warm, wet appendage teasingly traces the outside of your folds and tickles the pleasure-button of your clit before being brought up right to your opening and wiggling inside of your body.";
	WaitLineBreak;
	say "     The two horsemen orally pleasure you for a nice long while, filling the small laundry room with pleasureful moans and groans. As amazing as this feels, you almost wish to continue on like this until you come, but all too soon, Alexandra barks out, 'So, how about you get to it? Show us you can use those pieces of stud-meat!' She squeezes your hand in anticipation and looks to the side, meeting your gaze with a grin on her muzzle. Meanwhile, Karel and Isaac wrap up their cunnilingus by giving one last long lick, then suckling on both of your clits for a few heartbeats before they stand up again. Long, rock-hard equine shafts get hefted in their hands, stroking them and milking glistening droplets of pre-cum from the cumslits. Karel strokes his night-black cock over Alexandra's flat tummy, brushing her soft fur with the flared head of his erection before lining himself up with her entrance.";
	say "     Slowly and gently, he presses in between her nether lips, nudging them apart with his girthy member and sliding into her slick tunnel. 'Fuuck, this is a nice and tight bitch!' he grunts as he pushes in inch after inch, ";
	if Cunt Depth of Alexandra + 2 < Cock Length of Karel: [standard values: 10 (+2 stretching allowance) vs 15]
		say "until he eventually nudges her cervix with his tip and holds back from going any further. 'Not bad at all! Don't you worry, miss. I know you've already taken more cock than most would be able to, and got raised to respect people's limits.' Interestingly, Alexandra reacts rather gruffly to his words, barking out, 'Don't you dare try to go easy on me, you hear that? I'm not some pampered lapdog but a real bitch! Not that I'm asking for you to simply force it in, but you'll damn well fuck me with proper thrusts!' The Friesian tells her, 'Yes, darlin!' as he stiffens a little and straightens his back, in the course of which he presses deeper into her, making the dobie squirm and moan. ";
		WaitLineBreak;
		say "     Karel starts to pull out most of the way, then thrusts back in, at first a little gingerly but then harder as Alexandra wraps her legs around his ass and hits his buttocks with the heels of her foot-paws. The slick, black length of his cock saws in and out of her in rhythmic motions, and you can see it when he hits her inner barrier, as Alexandra clenches her muzzle every time, yet the woman doesn't seem to want to stop, not when her 'toughness' is in question. Instead, she calls out, 'Harder! Fuck me like you mean it!' After multiple requests by your slutty breeding bitch, Karel eventually gives her what she wants. ";
		say "     Strong hands grasping her by the hips, he hammers into Alexandra with full force, [if TwistedCapacity of Alexandra is false]making her buck and thrash on the washing machine as the blunt cock forces its way into her womb. 'Fucking hell!' she groans out, holding back a whimper at the pain. The farmhand gives her a moment to compose herself, seemingly ready to pull out if she just asks for it, but Alexandra just barks in an aggressive tone, 'Go on! Fuck some puppies into me!' Eyebrows rising on both of the twins, they look at each other for a second in apparent shock at Alexandra's determination and willingness to be womb-fucked. Isaac shows plenty of interest in that, with his dick twitching visibly as he sees his brother's boner vanish all the way into your slutty bitch. Trying to play it cool nonetheless, he gives his brother's ass a light slap. 'Ya heard the lady!' [else]making her buck on the washing machine as the blunt cock pushes right into her womb. 'Told ya I can take it!' Alexandra barks out with harsh laughter, her changed body ready to accommodate even the biggest shafts somehow. The farmhand gives her a moment to compose herself, seemingly ready to pull out if she just asks for it, but Alexandra is having none of that. 'Go on! Fuck some puppies into me!' Eyebrows rise on both of the twins, followed by a shared grin at their luck of getting a horny bitch like Alexandra. Isaac shows plenty of interest in that, with his dick twitching visibly as he sees his brother's boner vanish all the way into your slutty dobie. Trying to play it cool nonetheless, he gives his brother's ass a light slap. 'Ya heard the lady!' [end if][line break]";
		WaitLineBreak;
		say "     Shaking his head in disbelief, Karel goes on to pound Alexandra deeply, thrust after deep thrust going in all the way and pushing him into her womb repeatedly. She takes everything that he can dish out, barking, moaning, and whimpering in desperate arousal as the equine cock ravages her pussy. Meanwhile, Isaac lowers his cock a little bit, pressing it up against your crotch and showing just how long it is, and would be inside you. 'You ready for taking me, lady? I'd understand if you want me to hold back, no worries about that,' he says, but the way he keeps glancing over at his twin deep-dicking Alexandra betrays his desire to go all out, bury himself in you as he breeds your pussy.";
		if TwistedCapacity of Alexandra is false:
			increase Cunt Depth of Alexandra by 1; [oversized fucks stretch characters bit by bit]
	else: [he actually fits into her]
		say "until he eventually bottoms out, his whole length buried in her. 'It never ceases to amaze me how stretchy some of the regular-sized people can be,' Isaac comments from the side and nods down to his own erection, then glances at yourself. 'Think you'll be able to take this one just like her? I'm bigger than my 'little' bro.' Anything you might have wanted to say gets drowned out by Alexandra's rising moans as Karel starts to thrust into her. 'Yeah! Fuck me like you mean it!' she calls out eagerly, and Karel gives her exactly what she wants. Strong hands grasping her by the hips, he hammers into Alexandra with full force, stretching her receptive pussy around his length.";
		WaitLineBreak;
		say "     The former cop eagerly takes all of her stud, even wrapping both legs around his hips to pull him tighter and bucking her hips a little to grind against Karel's crotch. Shaking his head in disbelief at the smaller female taking his whole dick, Karel goes on to pound Alexandra deeply, thrust after deep thrust going all the way in. Shaking his head in disbelief, Karel goes on to pound Alexandra deeply, thrust after deep thrust going in all the way and pushing him into her womb repeatedly.";
		say "     The former cop eagerly takes all of her stud, even wrapping both legs around his hips to pull him tighter and bucking her hips a little to grind against Karel's crotch. Shaking his head in disbelief at the smaller female taking his whole dick, Karel goes on to pound Alexandra deeply, thrust after deep thrust going all the way in. She takes everything that he can dish out, barking, moaning, and whimpering in desperate arousal as the equine cock ravages her pussy. Meanwhile, Isaac lowers his cock a little bit, pressing it up against your crotch and showing just how long it is, and how very far it would reach inside you. 'So, back to us, hm? You ready for taking me, lady? I'd understand if you want me to hold back, no worries about that,' he says, but the way he keeps glancing over at his twin deep-dicking Alexandra betrays his desire to go all out, bury himself in you as he breeds your pussy.";
	project Figure of Isaac_hard_icon;
	say "     [bold type]What is your reply?[roman type][line break]";
	say "     [link](1)[as]1[end link] - You want to take him, but gently and just as deep as he can easily fit.";
	say "     [link](2)[as]2[end link] - He can try to go deep, but should take it easy and not try to push things too hard.";
	say "     [link](3)[as]3[end link] - You want it all! He can ram himself home, you'll take it!";
	now calcnumber is 0;
	while calcnumber < 1 or calcnumber > 3:
		say "Choice? (1-3)>[run paragraph on]";
		get a number;
		if calcnumber is 1 or calcnumber is 2 or calcnumber is 3:
			break;
		else:
			say "Invalid choice. Type [link]1[end link] to take a regular penetration, [link]2[end link] to let him try deep dicking, or [link]3[end link] to invite forceful thrusts.";
	if calcnumber is 1:
		LineBreak;
		say "     'Of course, I'll be gentle,' he says and smiles down at you, then wraps a hand around his erection just beneath the flared head. Brushing his glans over your sex, he focuses the teasing touches on your clit, making you tremble and squirm in anticipation before aligning himself with your opening. Gently nudging the folds of your pussy apart, the equine man pushes himself into you and lets out a panted breath as his dickhead is enveloped by your vagina's tight embrace. Grinning in satisfaction, Isaac sinks further and further into you, until ";
		if Cunt Depth of Player < Cock Length of Isaac: [standard value for Isaac: 17]
			say "his enormous cock eventually nudges against your cervix. Being a perfect gentleman, he stops pushing then and there, instead leaning down over you to meet your lips in a bout of making out with each other. Well-filled by your equine hunk, you wrap your arms around his neck as you share kisses. Then you feel his fingers brush against your spread pussy as he wraps a hand around his dick, making sure that he won't go deeper than right now as he starts to fuck.";
		else: [he fits in the player]
			say "his well-filled balls eventually nudge against your crotch, signifying that you've taken the whole of his 17 inch erection. Leaning over you to share a kiss, Isaac moans, 'You're amazing. Not many can take me!' Wiggling your eyebrows and giving him a provocative grin, you wrap your arms around his neck to keep him close as you suck on his tongue. While still making out with the stallion, you can feel his hips start moving, pushing his length in and out of your stretched pussy.";
		say "     Still mindful of your wishes, the muscled horseman moves in a slow and steady rhythm, switching up the angle of his entry and trying to find those special spots inside that make your libido soar and cause you to moan out loud. It may be a more sedate pace than Karel is setting with Alexandra, pounding into her and making the washing machine rock against the back wall, but you sure have fun with your own stud as you kiss, touch and are fucked by him. The small laundry room fills with moans and groans from all four of you, and given just how loudly Alexandra keeps barking, 'Fuck me deep you bastard! God, it's so long!' there is little doubt that the whole farm know by now what's going on in here. The hot and sweaty action keeps ramping up further and further, until Karel eventually reaches the point of no return, letting out a deep grunt as he slams forward one last time and his thick shaft begins to gush a virile load into her womb.";
		WaitLineBreak;
		say "     You turn your head to watch Alexandra's muzzle open wide as she screams out a moan, driven over the edge herself as her insides are painted white with equine cum, with untold millions of sperm starting their hunt for eggs to bury themselves into. She bucks and trembles underneath him, the blunt claws of her hands digging into is back as Karel keeps grinding against her, both of them breathing hard from the exertion of sex. Panting and out of breath, Karel glances over to meet his brother's gaze. 'God, you've got to try her. That's one sweet pussy!' Isaac grins at him and replies, 'Next time maybe, got my own. Right! Here!' Using thrusts into your body to underline his last words, the studly horseman pushes you closer and closer to your own orgasm, and the two of you turn your attention away from the couple next to you and instead focus on each other. Leaning down to kiss you again, Isaac asks, 'Ready for a foal all of your own?'";
		say "     As you moan into his open mouth for the Friesian stallion to breed you, he lowers a hand to rest on your crotch and places his thumb on your clit, stroking it in circling movements. Now literally pushing all your buttons, inside and out, the horseman speeds up his thrusts to a somewhat more impatient pace that soon brings your coupling to a sweaty, pleasurable conclusion. Sharing each other's breath as he grinds deep into your pussy, you just can't hold back anymore and let out an orgasmic moan as your insides clench around his shaft[if player is male] and your own [Cock of Player] erection erupts, splattering your chest with streaks of cum[end if]. Isaac isn't far behind either, sinking himself into you as far as he can go and pumping thick bursts of equine seed into your womb. His heavy balls produce an awe-inspiring amount of cum and after the tenth spurt, you wonder if his orgasm will ever stop as you literally feel your belly swelling a little from the sheer amount of his load.";
		WaitLineBreak;
		say "     Isaac very obviously enjoys breeding you and seeing your tummy rise, looking down on it and placing a hand there to feel the bump. Then suddenly, at the sound of a hand slapping his buttocks, he stiffens and stands up straight, which makes his erection shift inside you and churn up the creamy deposit in your depths. The culprit is his twin brother Karel, having slapped Isaac on the ass to draw his attention. 'Nice job, bro! Love seeing you give it to a gal good!' Karel says in an adoring tone of voice, and in reply his twin grasps him by the back of the mane to give him a deep kiss on the muzzle. Panting noises and a chuckle draw your attention away from the two of them for a second, to Alexandra lying next to you and showing a broad grin. 'Double fuck and a little bit of a twincest show for the end, eh? You sure know how to pick em, boss! This should be plenty for a new litter, but I wouldn't mind coming back here regularly!' she says next, cradling her own swollen stomach.";
		say "     The twins['] kiss escalates a little, with the two of them making out and also stroking each other's well-muscled chests and arms, up until the point where Alexandra eventually barks out, 'Enjoying yourselves, horsies? Don't forget the bitches you're still balls-deep in!' Pulling back from their kisses, Isaac gapes a little at her and replies, 'Oh! Sorry lady, I - we ...' 'Got caught up in the heat of the moment,' Karel finishes for him, also looking a little embarrassed. 'It's fine, you're hot so you're allowed to be stupid at times!' Alexandra replies with a laugh, showing that she's only teasing. Chuckling along with her, the twins look relieved, then start to pull out. As Karel's hips move backwards, the length of his cock that emerges from Alexandra's pussy is streaked white with cum. 'Oh! Way it feels, she's ready to squirt like a geyser if I pull out!'";
		WaitLineBreak;
		say "     'Slow down a sec then,' Isaac replies, then stretches to the side and manages to reach one of the stacks of washed laundry with his fingertips. Pulling the flannel washcloths closer, he hands one to his brother, who uses it to plug Alexandra's hole as he eases his flared dickhead out of her, pushing most of the fabric in between her nether lips. 'Wanted to make sure that your cum stays in me as long as possible, eh? That's some dedication in a breeding stud!' Alexandra barks out in amusement, feeling around a little gingerly at her hard-fucked pussy. Isaac snatches up another square of fabric for his own use, [if player is male]wiping the cum off your chest first before [end if]dabbing the towel at your crotch and using it to replace his erection when he soon after pulls out carefully. As the four of you emerge from the laundry room a short while later, you're greeted by a group of grinning farmhands that cheer as they see the wide grins on the twins' faces.";
		say "     There is some good-natured ribbing from them, and Alexandra delights in telling quite raunchy details of what the twins did to the two of you, until the crowd eventually breaks up as one or another horseman has to go on shift or lie down to get some rest. The twins kiss both Alexandra and you, one after the other. 'Seems fairly sure that she's knocked up, what with all that we've put in there, but in case it doesn't take or you just want another round... we're here for the both of ya,' Isaac adds, then they head out with another work crew. You're left with your well-bred bitch in the mostly empty barracks. [if Alexandra is in Grey Abbey Library]When some other horsemen come in, chatting with each other about wanting to be the next to fuck the 'horny sluts putting out', you know that it's time to leave, and you whistle for Alexandra to come to heel. The trip back to the library afterwards is fairly uneventful, and you arrive safely in your home ground.[end if][line break]";
	else if calcnumber is 2:
		LineBreak;
		say "     'Sure thing, let's see how much you can take!' he says and smiles down at you, then wraps a hand around his erection just beneath the flared head. Brushing his glans over your sex, he focuses the teasing touches on your clit, making you tremble and squirm in anticipation before aligning himself with your opening. Gently nudging the folds of your pussy apart, the equine man pushes himself into you and lets out a panted breath as his dickhead is enveloped by your vagina's tight embrace. Grinning in satisfaction, Isaac sinks further and further into you, until ";
		if Cunt Depth of Player + 2 < Cock Length of Isaac: [standard value for Isaac: 17]
			if Player is not twistcapped: [doesn't fit, even with stretching]
				say "his enormous cock eventually nudges against your cervix. He pushes lightly to go a little further and you can feel your innards shift and flex a little, until it becomes clear that this is as deep as he'll be able to go. Being a perfect gentleman, he watches like a hawk for any sign of pain on your face and immediately stops moving when you the pressure against the opening of your womb becomes uncomfortable. Backing off a tiny bit, he instead leans down over you to meet your lips in a bout of making out with each other. Well-filled by your equine hunk, you wrap your arms around his neck as you share kisses. Then you feel his fingers brush against your spread pussy as he wraps a hand around his dick, making sure that he won't go deeper than right now as he starts to fuck.";
				increase Cunt Depth of Player by 1; [oversized fucks stretch characters bit by bit]
			else:
				say "his enormous cock eventually nudges against your cervix. He pushes lightly to go a little further and you can feel your innards shift and flex a little, before suddenly yielding to the pressure and allowing his flared head to sink right into your pussy. 'Oh? Ooooh!' Isaac says in surprise that is immediately followed by a realization as you just grin up eagerly at him. 'Now that's quite a skill!' he adds, then leans down over you to meet your lips in a bout of making out with each other. Well-filled by your equine hunk, you wrap your arms around his neck as you share kisses. While still making out with the stallion, you can feel his hips start moving, pushing his length in and out of your stretched pussy.";
		else: [he fits in the player]
			say "his well-filled balls eventually nudge against your crotch, signifying that you've taken the whole of his 17 inch erection. Leaning over you to share a kiss, Isaac moans, 'You're amazing. Not many can take me!' Wiggling your eyebrows and giving him a provocative grin, you wrap your arms around his neck to keep him close as you suck on his tongue. While still making out with the stallion, you can feel his hips start moving, pushing his length in and out of your stretched pussy.";
		say "     Eager to give you a proper pounding, the muscled horseman's slow start quickly builds up to a steady rhythm, switching up the angle of his entry and trying to find those special spots inside that make your libido soar and cause you to moan out loud. Almost as fast-paced as the hard fuck Karel is giving Alexandra, pounding into her and making the washing machine rock against the back wall, you sure have fun with your own stud's deep strokes as you kiss and touch him at the same time. The small laundry room fills with moans and groans from all four of you, and given just how loudly Alexandra keeps barking, 'Fuck me deep you bastard! God, it's so long!' there is little doubt that the whole farm know by now what's going on in here. The hot and sweaty action keeps ramping up further and further, until Karel eventually reaches the point of no return, letting out a deep grunt as he slams forward one last time and his thick shaft begins to gush a virile load into her womb.";
		WaitLineBreak;
		say "     You turn your head to watch Alexandra's muzzle open wide as she screams out a moan, driven over the edge herself as her insides are painted white with equine cum, with untold millions of sperm starting their hunt for eggs to bury themselves into. She bucks and trembles underneath him, the blunt claws of her hands digging into is back as Karel keeps grinding against her, both of them breathing hard from the exertion of sex. Panting and out of breath, Karel glances over to meet his brother's gaze. 'God, you've got to try her. That's one sweet pussy!' Isaac grins at him and replies, 'Next time maybe! Got my own! Right! Here!' Using thrusts into your body to underline his last words, the studly horseman pushes you closer and closer to your own orgasm, and the two of you turn your attention away from the couple next to you and instead focus on each other. Leaning down to kiss you again, Isaac asks, 'Ready for a foal all of your own?'";
		say "     As you moan into his open mouth for the Friesian stallion to breed you, he lowers a hand to rest on your crotch and places his thumb on your clit, stroking it in circling movements. Now literally pushing all your buttons, inside and out, the horseman takes out all the stops and thrusts into you in an even more impatient pace that soon brings your coupling to a sweaty, pleasurable conclusion. Sharing each other's breath as he grinds deep into your pussy, you just can't hold back anymore and let out an orgasmic moan as your insides clench around his shaft[if player is male] and your own [Cock of Player] erection erupts, splattering your chest with streaks of cum[end if]. Isaac isn't far behind either, sinking himself into you as far as he can go and pumping thick bursts of equine seed into your womb. His heavy balls produce an awe-inspiring amount of cum and after the tenth spurt, you wonder if his orgasm will ever stop as you literally feel your belly swelling a little from the sheer amount of his load.";
		WaitLineBreak;
		say "     Isaac very obviously enjoys breeding you and seeing your tummy rise, looking down on it and placing a hand there to feel the bump. Then suddenly, at the sound of a hand slapping his buttocks, he stiffens and stands up straight, which makes his erection shift inside you and churn up the creamy deposit in your depths. The culprit is his twin brother Karel, having slapped Isaac on the ass to draw his attention. 'Nice job, bro! Love seeing you give it to a gal good!' Karel says in an adoring tone of voice, and in reply his twin grasps him by the back of the mane to give him a deep kiss on the muzzle. Panting noises and a chuckle draw your attention away from the two of them for a second, to Alexandra lying next to you and showing a broad grin. 'Double fuck and a little bit of a twincest show for the end, eh? You sure know how to pick em, boss! This should be plenty for a new litter, but I wouldn't mind coming back here regularly!' she says next, cradling her own swollen stomach.";
		say "     The twins['] kiss escalates a little, with the two of them making out and also stroking each other's well-muscled chests and arms, up until the point where Alexandra eventually barks out, 'Enjoying yourselves, horsies? Don't forget the bitches you're still balls-deep in!' Pulling back from their kisses, Isaac gapes a little at her and replies, 'Oh! Sorry lady, I - we ...' 'Got caught up in the heat of the moment,' Karel finishes for him, also looking a little embarrassed. 'It's fine, you're hot so you're allowed to be stupid at times!' Alexandra replies with a laugh, showing that she's only teasing. Chuckling along with her, the twins look relieved, then start to pull out. As Karel's hips move backwards, the length of his cock that emerges from Alexandra's pussy is streaked white with cum. 'Oh! Way it feels, she's ready to squirt like a geyser if I pull out!'";
		WaitLineBreak;
		say "     'Slow down a sec then,' Isaac replies, then stretches to the side and manages to reach one of the stacks of washed laundry with his fingertips. Pulling the flannel washcloths closer, he hands one to his brother, who uses it to plug Alexandra's hole as he eases his flared dickhead out of her, pushing most of the fabric in between her nether lips. 'Wanted to make sure that your cum stays in me as long as possible, eh? That's some dedication in a breeding stud!' Alexandra barks out in amusement, feeling around a little gingerly at her hard-fucked pussy. Isaac snatches up another square of fabric for his own use, [if player is male]wiping the cum off your chest first before [end if]dabbing the towel at your crotch and using it to replace his erection when he soon after pulls out carefully. As the four of you emerge from the laundry room a short while later, you're greeted by a group of grinning farmhands that cheer as they see the wide grins on the twins' faces.";
		say "     There is some good-natured ribbing from them, and Alexandra delights in telling quite raunchy details of what the twins did to the two of you, until the crowd eventually breaks up as one or another horseman has to go on shift or lie down to get some rest. The twins kiss both Alexandra and you, one after the other. 'Seems fairly sure that she's knocked up, what with all that we've put in there, but in case it doesn't take or you just want another round... we're here for the both of ya,' Isaac adds, then they head out with another work crew. You're left with your well-bred bitch in the mostly empty barracks. [if Alexandra is in Grey Abbey Library]When some other horsemen come in, chatting with each other about wanting to be the next to fuck the 'horny sluts putting out', you know that it's time to leave, and you whistle for Alexandra to come to heel. The trip back to the library afterwards is fairly uneventful, and you arrive safely in your home ground.[end if][line break]";
	else if calcnumber is 3:
		LineBreak;
		say "     'Being adventurous? I like that in a gal!' he says and smiles down at you, then wraps a hand around his erection just beneath the flared head. Brushing his glans over your sex, he focuses the teasing touches on your clit, making you tremble and squirm in anticipation before aligning himself with your opening. Gently nudging the folds of your pussy apart, the equine man pushes himself into you and lets out a panted breath as his dickhead is enveloped by your vagina's tight embrace. Grinning in satisfaction, Isaac sinks a little further into you, until a wicked grin spreads over his muzzle and he asks, 'Ready for me to go deep?' You take a deep breath, preparing yourself mentally for it, then nod for the stallion to go ahead. With an aroused whinny, the black-furred male thrusts in hard and ";
		if Cunt Depth of Player + 2 < Cock Length of Isaac: [standard value for Isaac: 17]
			if Player is not twistcapped: [doesn't fit, even with stretching]
				say "you thrash wildly under him as his enormous cock slams past the opening of your womb, forcing the cervix wide around its girth.";
				say "     The sudden penetration makes you see stars before your eyes for a few seconds, with your hands in a death-grip on the edges of the washing machine. Isaac is wise enough to give you a moment to adjust, not moving an inch even though you can feel his erection throb hard inside you. Seems to you that he's very turned on, and gushing a fair bit of pre-cum into your womb. Thankfully, the pain in your loins quickly ebbs off and then vanishes entirely, no doubt due to the intervention of the ever-so-helpful nanites. 'Feeling better?', Isaac asks in a gentlemanly fashion, looking relieved as you nod and wrap your arms around his neck to kiss him. While still making out with the stallion, you can feel his hips start moving, pushing his length in and out of your stretched pussy.";
				increase Cunt Depth of Player by 1; [oversized fucks stretch characters bit by bit]
			else:
				say "you buck wildly under him as his enormous cock slams past the opening of your womb, forcing the cervix wide around its girth.";
				say "     He freezes in motion, cautiously watching your face for any signs of pain, only to be somewhat baffled at seeing nothing but an eager grin. 'Oh? Ooooh!' Isaac says in surprise that is immediately followed by a realization as you just grin up eagerly at him. 'Now that's quite a skill!' he adds, then leans down over you to meet your lips in a bout of making out with each other. Well-filled by your equine hunk, you wrap your arms around his neck as you share kisses. While still making out with the stallion, you can feel his hips start moving, pushing his length in and out of your stretched pussy.";
		else: [he fits in the player]
			say "you buck under him as his enormous cock plunges balls-deep into your pussy.";
			say "     The sudden penetration of such a gloriously large piece of equine dick draws loud moans and gasps from you, much to the amusement of Karel, who cheers his brother on with the words, 'Nice! Give it to [ObjectPro of Player] good!' Momentarily waiting for you to adjust to his girth inside you, leans down and kisses your lips, then says, 'You're amazing. Not many can take me!' Wiggling your eyebrows and giving him a provocative grin, you wrap your arms around his neck to keep him close as you suck on his tongue. While still making out with the stallion, you can feel his hips start moving, pushing his length in and out of your stretched pussy.";
		WaitLineBreak;
		say "     Eager to give you a proper pounding, the muscled horseman's quick-fire entry is continued in hard thrusts in and out, switching up the angle of his entry and trying to find those special spots inside that make your libido soar and cause you to moan out loud. It almost seems a competition between the two brothers of who can fuck their partner harder, deeper and make Alexandra and yourself scream louder in lust. The hard pounding makes your washing machines rock against the back wall as the twin power-houses of equine muscle give everything they have. The small laundry room fills with moans and groans from all four of you, and given just how loudly Alexandra keeps barking, 'Fuck me deep you bastard! God, it's so long!' there is little doubt that the whole farm know by now what's going on in here. The hot and sweaty action keeps ramping up further and further, until Karel eventually reaches the point of no return, letting out a deep grunt as he slams forward one last time and his thick shaft begins to gush a virile load into her womb.";
		WaitLineBreak;
		say "     You turn your head to watch Alexandra's muzzle open wide as she screams out a moan, driven over the edge herself as her insides are painted white with equine cum, with untold millions of sperm starting their hunt for eggs to bury themselves into. She bucks and trembles underneath him, the blunt claws of her hands digging into is back as Karel keeps grinding against her, both of them breathing hard from the exertion of sex. Panting and out of breath, Karel glances over to meet his brother's gaze. 'God, you've got to try her. That's one sweet pussy!' Isaac grins at him and replies, 'Next time maybe! Got my own! Right! Here!' Using thrusts into your body to underline his last words, the studly horseman pushes you closer and closer to your own orgasm, and the two of you turn your attention away from the couple next to you and instead focus on each other. Leaning down to kiss you again, Isaac asks, 'Ready for a foal all of your own?'";
		say "     As you moan into his open mouth for the Friesian stallion to breed you, he lowers a hand to rest on your crotch and places his thumb on your clit, stroking it in circling movements. Now literally pushing all your buttons, inside and out, the horseman takes out all the stops and thrusts into you in an even more impatient pace that soon brings your coupling to a sweaty, pleasurable conclusion. Sharing each other's breath as he grinds deep into your pussy, you just can't hold back anymore and let out an orgasmic moan as your insides clench around his shaft[if player is male] and your own [Cock of Player] erection erupts, splattering your chest with streaks of cum[end if]. Isaac isn't far behind either, sinking himself into you as far as he can go and pumping thick bursts of equine seed into your womb. His heavy balls produce an awe-inspiring amount of cum and after the tenth spurt, you wonder if his orgasm will ever stop as you literally feel your belly swelling a little from the sheer amount of his load.";
		WaitLineBreak;
		say "     Isaac very obviously enjoys breeding you and seeing your tummy rise, looking down on it and placing a hand there to feel the bump. Then suddenly, at the sound of a hand slapping his buttocks, he stiffens and stands up straight, which makes his erection shift inside you and churn up the creamy deposit in your depths. The culprit is his twin brother Karel, having slapped Isaac on the ass to draw his attention. 'Nice job, bro! Love seeing you give it to a gal good!' Karel says in an adoring tone of voice, and in reply his twin grasps him by the back of the mane to give him a deep kiss on the muzzle. Panting noises and a chuckle draw your attention away from the two of them for a second, to Alexandra lying next to you and showing a broad grin. 'Double fuck and a little bit of a twincest show for the end, eh? You sure know how to pick em, boss! This should be plenty for a new litter, but I wouldn't mind coming back here regularly!' she says next, cradling her own swollen stomach.";
		say "     The twins['] kiss escalates a little, with the two of them making out and also stroking each other's well-muscled chests and arms, up until the point where Alexandra eventually barks out, 'Enjoying yourselves, horsies? Don't forget the bitches you're still balls-deep in!' Pulling back from their kisses, Isaac gapes a little at her and replies, 'Oh! Sorry lady, I - we ...' 'Got caught up in the heat of the moment,' Karel finishes for him, also looking a little embarrassed. 'It's fine, you're hot so you're allowed to be stupid at times!' Alexandra replies with a laugh, showing that she's only teasing. Chuckling along with her, the twins look relieved, then start to pull out. As Karel's hips move backwards, the length of his cock that emerges from Alexandra's pussy is streaked white with cum. 'Oh! Way it feels, she's ready to squirt like a geyser if I pull out!'";
		WaitLineBreak;
		say "     'Slow down a sec then,' Isaac replies, then stretches to the side and manages to reach one of the stacks of washed laundry with his fingertips. Pulling the flannel washcloths closer, he hands one to his brother, who uses it to plug Alexandra's hole as he eases his flared dickhead out of her, pushing most of the fabric in between her nether lips. 'Wanted to make sure that your cum stays in me as long as possible, eh? That's some dedication in a breeding stud!' Alexandra barks out in amusement, feeling around a little gingerly at her hard-fucked pussy. Isaac snatches up another square of fabric for his own use, [if player is male]wiping the cum off your chest first before [end if]dabbing the towel at your crotch and using it to replace his erection when he soon after pulls out carefully. As the four of you emerge from the laundry room a short while later, you're greeted by a group of grinning farmhands that cheer as they see the wide grins on the twins' faces.";
		say "     There is some good-natured ribbing from them, and Alexandra delights in telling quite raunchy details of what the twins did to the two of you, until the crowd eventually breaks up as one or another horseman has to go on shift or lie down to get some rest. The twins kiss both Alexandra and you, one after the other. 'Seems fairly sure that she's knocked up, what with all that we've put in there, but in case it doesn't take or you just want another round... we're here for the both of ya,' Isaac adds, then they head out with another work crew. You're left with your well-bred bitch in the mostly empty barracks. [if Alexandra is in Grey Abbey Library]When some other horsemen come in, chatting with each other about wanting to be the next to fuck the 'horny sluts putting out', you know that it's time to leave, and you whistle for Alexandra to come to heel. The trip back to the library afterwards is fairly uneventful, and you arrive safely in your home ground.[end if][line break]";
		if Player is not twistcapped:
			increase Cunt Depth of Player by 1; [oversized fucks stretch characters bit by bit]
	now lastdobiemess is 86; [Friesians came in her]
	impregAlexandraChance with "Karel"; [chance to knock her up]
	NPCSexAftermath Alexandra receives "PussyFuck" from Karel; [Friesian Twin 1]
	NPCSexAftermath Player receives "PussyFuck" from Isaac; [Friesian Twin 2]

to say AlexandraFriesianBreeding2: [player has a hand on Isaac]
	say "     With a shrug, you tell Isaac that Alexandra is your prized breeding slut, and you simply want to see her pumped full of premium seed - literally, as you intend to watch it all and maybe have a little bit of a hand in it too. Two virile studs like him and his brother should be enough to ensure that the dobie bitch swells up with a new litter soon. 'We'll certainly do our best, [sir],' the farmhand replies with a grin on his muzzle, then turns towards where Karel is still licking Alexandra's pussy. As Isaac starts to undo his pants, you reach over and place a hand on his rapidly hardening manhood, grinning as his eyebrows rise. The horseman is quite well hung, with a night-black shaft that grows to be at least 17 inches long, and thick to boot. You lead him along with you by the hand on his cock, stepping up next to the second twin who just kicks off his jeans. Now there are two large stallions ready to fuck Alexandra, towering over her.";
	say "     Your bad doggie looks back and forth between them and comments with a smirk, 'Seems I won the lottery today, with such grade A stud-meat to pound my pussy!' She reaches out to stroke your arm as you continue to handle Isaac's erect rod, preparing him for his turn in her receptive pussy. Meanwhile, Karel wraps up his oral service to the doberwoman by giving her one last long lick, then suckling on her clit for a few heartbeats before he stands up again. His equine shaft is rock-hard and dripping precum from the tip. Taking hold of the night-black cock, the horseman strokes it over Alexandra's flat tummy, brushing her soft fur with the flared head of his erection before lining himself up with her entrance. Slowly and gently, he presses in between her nether lips, nudging them apart with his girthy member and sliding into her slick tunnel. 'Fuuck, this is a nice and tight bitch!' he grunts as he pushes in inch after inch, ";
	if Cunt Depth of Alexandra + 2 < Cock Length of Karel: [standard values: 10 (+2 stretching allowance) vs 15]
		say "until he eventually nudges her cervix with his tip and holds back from going any further. 'Not bad at all! Don't you worry, miss. I know you've already taken more cock than most would be able to, and got raised to respect people's limits.'";
		WaitLineBreak;
		say "     Interestingly, Alexandra reacts rather gruffly to his words, barking out, 'Don't you dare try to go easy on me, you hear that? I'm not some pampered lapdog but a real bitch! Not that I'm asking for you to simply force it in, but you'll damn well fuck me with proper thrusts!' 'Yes, darlin!' the Friesian tells her, stiffening a little and straightening his back, in the course of which he presses deeper into her, making the dobie squirm and moan. Karel starts to pull out most of the way, then thrusts back in, at first a little gingerly but then harder as Alexandra wraps her legs around his ass and hits his buttocks with the heels of her foot-paws. The slick, black length of his cock saws in and out of her in rhythmic motions and you can see it when he hits her inner barrier, as Alexandra clenches her muzzle every time, yet the woman doesn't seem to want to stop, not when her 'toughness' is in question. Instead, she calls out, 'Harder! Fuck me like you mean it!'";
		say "     After multiple requests by your slutty breeding bitch, Karel eventually gives her what she wants. Strong hands grasping her by the hips, he hammers into Alexandra with full force, [if TwistedCapacity of Alexandra is false]making her buck and thrash on the washing machine as the blunt cock forces its way into her womb. 'Fucking hell!' she groans out, holding back a whimper at the pain. The farmhand gives her a moment to compose herself, seemingly ready to pull out if she just asks for it, but Alexandra just barks in an aggressive tone, 'Go on! Fuck some puppies into me!' Eyebrows rising on both of the twins, they look at each other for a second in apparent shock at Alexandra's determination and willingness to be womb-fucked. Yet since you have your hand on his cock, you feel Isaac's member throb and twitch, telling you that he's very turned on right now. Seems like he's really interested in such deep penetrations, and knocking your bitch up too. Playing it fairly cool nonetheless, Isaac shrugs and gives his brother's ass a light slap. 'Ya heard the lady!' [else]making her buck on the washing machine as the blunt cock pushes right into her womb. 'Told ya I can take it!' Alexandra barks out with harsh laughter, her changed body ready to accommodate even the biggest shafts somehow. The farmhand attempts to her a moment to compose herself, seemingly ready to pull out if she just asks for it, but Alexandra is having none of that. 'Go on! Fuck some puppies into me!' Eyebrows rise on both of the twins, followed by a shared grin at their luck of getting a horny bitch like Alexandra. You feel Isaac's member throb and twitch, telling you that he's very turned on right now. Seems like he's really interested in such deep penetrations, and knocking your bitch up too. Already fantasizing about his own turn, Isaac gives his brother's ass a light slap. 'Ya heard the lady!' [end if][line break]";
		WaitLineBreak;
		say "     Shaking his head in disbelief, Karel goes on to pound Alexandra deeply, thrust after deep thrust going in all the way and pushing him into her womb repeatedly. She takes everything that he can dish out, barking, moaning, and whimpering in desperate arousal as the equine cock ravages her pussy, until her stud finally reaches the point of no return, letting out a deep grunt as he slams forward one last time, and his thick shaft begins to gush a virile load into her womb. Spurt after rich spurt paints Alexandra's insides white, with untold millions of sperm starting their hunt for eggs to bury themselves into. Panting and out of breath, Karel glances over to meet his brother's gaze. 'God, you've got to try her. That's one sweet pussy!' Isaac grins at him and replies, 'I will, just gotta make some room, bro.' With that said, the second Friesian steps up to his sibling, pressing against his side as they both stand before the smaller female.";
		say "     Reaching out to put a hand on Isaac's shaft, Karel says, 'Wait till you feel her around your cock! You ready for the switch?' As the stallion nods, Karel pulls out of Alexandra in a swift pull that makes her tremble and gasp as his flared head pops past her cervix on the way out, and immediately places his brother's dickhead at her opening to replace him. Isaac reacts right away and thrusts in hard, his length sliding into the cum-slick passage and delving into the dobie's womb like his brother before. 'God, you're one sweet lay, lady! And Karel, I can feel your load squishing all around my dick!' Grinning broadly, the second horseman leans in to lick the side of Isaac's neck, giving him a playful nip. 'You know you love it, bro.' Isaac strokes his black-furred chest in reply, but then gets interrupted by Alexandra letting out an amused, if somewhat impatient bark of, 'So, you gonna fuck me or what?! You can smooch on your own time!'";
		WaitLineBreak;
		project Figure of Isaac_hard_icon;
		say "     Focusing back on the canine impaled on his huge shaft, eyebrows drawing together a little, Isaac smacks her ass and starts to move in and out of her quivering snatch. You can hear squishy noises as he churns up the cum already inside her. At the same time, Karel moves around to the side a little, running his hands over Alexandra's upper body, stroking her heaving breasts and caressing the former cop's clit. Now having two muscled equines servicing her at the same time, your receptive bitch's arousal sizzles and rises like lava in a volcano about to erupt. She does her best to imitate the acoustics of one too, letting out full-throated moans and gasps that build up to a shouted crescendo as she reaches her climax, bucking and thrashing wildly on the washing machine. Balls deep in the trembling bitch, his erection squeezed like a vice from all sides, Isaac isn't far behind either, panting into her open mouth as he blasts his load deep into her womb, to mingle with his brother's deposit.";
		say "     Grunting deeply, the horseman trembles all over with every shot of cum into Alexandra, his balls sending forth every drop they can muster. As more and more equine seed is pumped into her, the dobie's belly starts to swell a little bit from the sheer volume of two quite large horsemen's virility. The two of them buck and grind against each other for a little while longer, until their movements eventually die down. At this moment, Karel moves in, bringing his muzzle up to theirs and starting to make out with Alexandra, as well as Isaac. Three-way kisses are shared between all of them as they ride out the ebbing high of their respective orgasms. Eventually, when the twins are just kissing each other for a moment, Alexandra lets out a chuckle and pats her filled belly. 'Now if this doesn't knock me up, we'll just have to do it again!' she says in eager anticipation, though you're not quite sure for which. Maybe both, judging from her well-satisfied look right now.";
		WaitLineBreak;
		say "     After leaning in to kiss Alexandra again, Karel stands up and looks down at his sweat-soaked body, then pats his brother's similarly damp chest. 'Quite a workout, eh?' Sharing a laugh with his brother, Isaac pulls his hips back a little, with the length of his cock that emerges from Alexandra's pussy being streaked white with cum. 'Got a small issue here, bro. Way it feels, she's ready to squirt like a geyser if I pull out!' Glancing around, the second horseman quickly steps over to snatch up a flannel washcloth and hands it to Isaac, who uses it to plug Alexandra's hole as he eases his flared dickhead out of her, pushing most of the fabric in between her nether lips. 'Wanted to make sure that your cum stays in me as long as possible, eh? That's some dedication in a breeding stud!' Alexandra barks out in amusement, feeling around a little gingerly at her twice-fucked pussy.";
		say "     As the four of you emerge from the laundry room a short while later, you're greeted by a group of grinning farmhands that cheer as they see the wide grins on the twins' faces. There is some good-natured ribbing from them, and Alexandra delights in telling quite raunchy details of what the twins did to her, until the crowd eventually breaks up as one or another horseman has to go on shift or lie down to get some rest. The twins give you friendly slaps on the back and kiss Alexandra on the muzzle one after the other. 'Seems fairly sure that she's knocked up, what with all that we've put in there, but in case it doesn't take or you just want another round... we're here for the both of ya,' Isaac adds, then they head out with another work crew. You're left with your well-bred bitch in the mostly empty barracks. [if Alexandra is in Grey Abbey Library]When some other horsemen come in, chatting with each other about wanting to be the next to fuck the 'horny sluts putting out', you know that it's time to leave, and you whistle for Alexandra to come to heel. The trip back to the library afterwards is fairly uneventful, and you arrive safely in your home ground.[end if][line break]";
		if TwistedCapacity of Alexandra is false:
			increase Cunt Depth of Alexandra by 1; [oversized fucks stretch characters bit by bit]
	else: [he actually fits into her]
		say "until he eventually bottoms out, his whole length buried in her. 'It never ceases to amaze me how stretchy some of the regular-sized people can be,' Isaac comments from the side and nods down to his own erection in Alexandra's grip. 'Think you'll be able to take this one too, gal? I'm bigger than my 'little' bro.'";
		WaitLineBreak;
		say "     Alexandra reacts with an amused bark and says, 'You're gonna have to fuck me and find out, stallion-boy!' With a grin, the Friesian replies,  'Yes, darlin! As soon as Karel's done!' , then slaps his brother's ass lightly, animating him to start thrusting rhythmically. 'Yeah! Fuck me like you mean it!' Alexandra calls out eagerly, and Karel gives her exactly what she wants. Strong hands grasping her by the hips, he hammers into Alexandra with full force, stretching her receptive pussy around his length. She eagerly takes all of him, even wrapping her legs around his hips to pull him tighter and bucking her hips a little to grind against Karel's crotch. Shaking his head in disbelief at the smaller female taking his whole dick, Karel goes on to pound Alexandra deeply, thrust after deep thrust going all the way in.";
		say "     She takes everything that he can dish out, barking and moaning in desperate arousal as the equine cock ravages her pussy, until her stud finally reaches the point of no return, letting out a deep grunt as he slams forward one last time, and his thick shaft begins to gush a virile load against her cervix. With his flared head stoppering the way out, it doesn't take long at all before the growing pressure makes his cum gush past the ring of her cervix and right into Alexandra's womb. Spurt after rich spurt paints Alexandra's insides white, with untold millions of sperm starting their hunt for eggs to bury themselves into. Panting and out of breath, Karel glances over to meet his brother's gaze. 'God, you've got to try her. That's one sweet pussy!' Isaac grins at him and replies, 'I will, just gotta make some room, bro.' With that said, the second Friesian steps up to his sibling, pressing against his side as they both stand before the smaller female.";
		WaitLineBreak;
		project Figure of Isaac_hard_icon;
		say "     Reaching out to put a hand on Isaac's shaft, Karel says, 'Wait till you feel her around your cock! You ready for the switch?' As the stallion nods, Karel pulls out of Alexandra in a swift pull that makes her tremble and gasp as his flared head pops past her cervix on the way out, and immediately places his brother's dickhead at her opening to replace him. Isaac reacts right away and thrusts in hard, his length sliding into the cum-slick passage and pistoning another gush of equine seed into the dobie's womb. 'God, you're one sweet lay, lady! And Karel, I can feel your load squishing all around my dick!' Grinning broadly, the second horseman leans in to lick the side of Isaac's neck, giving him a playful nip. 'You know you love it, bro.' Isaac strokes his black-furred chest in reply, but then gets interrupted by Alexandra letting out an amused, if somewhat impatient bark of 'So, you gonna fuck me or what?! You can smooch on your own time!'";
		say "     Focusing back on the canine impaled on his huge shaft, eyebrows drawing together a little, Isaac smacks her ass and starts to move in and out of her quivering snatch. You can hear squishy noises as he churns up the cum already inside her. At the same time, Karel moves around to the side a little, running his hands over Alexandra's upper body, stroking her heaving breasts and caressing the former cop's clit. Now having two muscled equines servicing her at the same time, your receptive bitch's arousal sizzles and rises like lava in a volcano about to erupt. She does her best to imitate the acoustics of one too, letting out full-throated moans and gasps that build up to a shouted crescendo as she reaches her climax, bucking and thrashing wildly on the washing machine. Balls deep in the trembling bitch, his erection squeezed like a vice from all sides, Isaac isn't far behind either, panting into her open mouth as he blasts his load deep into her pussy, to mingle with his brother's deposit already in her womb.";
		WaitLineBreak;
		say "     Grunting deeply, the horseman trembles all over with every shot of cum into Alexandra, his balls sending forth every drop that they can muster. As more and more equine seed is pumped into her, the dobie's belly starts to swell a little bit from the sheer volume of two quite large horsemen's virility. The two of them buck and grind against each other for a little while longer, until their movements eventually die down. At this moment, Karel moves in, bringing his muzzle up to theirs and starting to make out with Alexandra, as well as Isaac. Three-way kisses are shared between all of them as they ride out the ebbing high of their respective orgasms. Eventually, when the twins are just kissing each other for a moment, Alexandra lets out a chuckle and pats her filled belly. 'Now if this doesn't knock me up, we'll just have to do it again!' she says in eager anticipation, though you're not quite sure for which. Maybe both, judging from her well-satisfied look right now.";
		say "     After leaning in to kiss Alexandra again, Karel stands up and looks down at his sweat-soaked body, then pats his brother's similarly damp chest. 'Quite a workout, eh?' Sharing a laugh with his brother, Isaac pulls his hips back a little, with the length of his cock that emerges from Alexandra's pussy being streaked white with cum. 'Got a small issue here, bro. Way it feels, she's ready to squirt like a geyser if I pull out!' Glancing around, the second horseman quickly steps over to snatch up a flannel washcloth and hands it to Isaac, who uses it to plug Alexandra's hole as he eases his flared dickhead out of her, pushing most of the fabric in between her nether lips. 'Wanted to make sure that your cum stays in me as long as possible, eh? That's some dedication in a breeding stud!' Alexandra barks out in amusement, feeling around a little gingerly at her twice-fucked pussy.";
		WaitLineBreak;
		say "     As the four of you emerge from the laundry room a short while later, you're greeted by a group of grinning farmhands that cheer as they see the wide grins on the twins' faces. There is some good-natured ribbing from them, and Alexandra delights in telling quite raunchy details of what the twins did to her, until the crowd eventually breaks up as one or another horseman has to go on shift or lie down to get some rest. The twins give you friendly slaps on the back and kiss Alexandra on the muzzle one after the other. 'Seems fairly sure she's knocked up, what with all that we've put in there, but in case it doesn't take or you just want another round... we're here for the both of ya,' Isaac adds, then they head out with another work crew. You're left with your well-bred bitch in the mostly empty barracks. [if Alexandra is in Grey Abbey Library]When some other horsemen come in, chatting with each other about wanting to be the next to fuck the 'horny sluts putting out', you know that it's time to leave, and you whistle for Alexandra to come to heel. The trip back to the library afterwards is fairly uneventful, and you arrive safely in your home ground.[end if][line break]";
	now lastdobiemess is 86; [Friesians came in her]
	impregAlexandraChance with "Karel"; [chance to knock her up]
	impregAlexandraChance with "Isaac"; [chance to knock her up]
	NPCSexAftermath Alexandra receives "PussyFuck" from Karel; [Friesian Twin 1]
	NPCSexAftermath Alexandra receives "PussyFuck" from Isaac; [Friesian Twin 2]

to say AlexandraFriesianBreeding3: [player simply watches]
	say "     With a shrug, you tell Isaac that Alexandra is your prized breeding slut, and you simply want to see her pumped full of premium seed - literally, as you intend to watch it all. Two virile studs like him and his brother should be enough to ensure that the dobie bitch swells up with a new litter soon. 'We'll certainly do our best, [sir],' the farmhand replies with a grin on his muzzle, then turns towards where Karel is still licking Alexandra's pussy. As Isaac starts to undo his pants, you quietly walk after him, ready to follow all of the action from right up close. With the second twin kicking off his jeans in short order, there are now two quite large stallions ready to fuck Alexandra. Your bad doggie looks back and forth between them and comments with a smirk, 'Seems I won the lottery today, with such grade A stud-meat to pound my pussy!' She reaches out to lay her hand on Isaac's huge and erect rod as she says this, stroking its thick length up and down.";
	say "     Meanwhile, Karel wraps up his oral service to the doberwoman by giving her one last long lick, then suckling on her clit for a few heartbeats before he stands up again. His equine shaft is rock-hard and dripping precum from the tip. Taking hold of the night-black cock, the horseman strokes it over Alexandra's flat tummy, brushing her soft fur with the flared head of his erection before lining himself up with her entrance. Slowly and gently, he presses in between her nether lips, nudging them apart with his girthy member and sliding into her slick tunnel. 'Fuuck, this is a nice and tight bitch!' he grunts as he pushes in inch after inch, ";
	if Cunt Depth of Alexandra + 2 < Cock Length of Karel: [standard values: 10 (+2 stretching allowance) vs 15]
		say "until he eventually nudges her cervix with his tip and holds back from going any further. 'Not bad at all! Don't you worry, miss. I know that you've already taken more cock than most would be able to, and I was raised to respect people's limits.'";
		WaitLineBreak;
		say "     Interestingly, Alexandra reacts rather gruffly to his words, barking out, 'Don't you dare try to go easy on me, you hear that? I'm not some pampered lapdog but a real bitch! Not that I'm asking for you to simply force it in, but you'll damn well fuck me with proper thrusts!' The Friesian tells her, 'Yes, darlin!' as he stiffens a little and straightens his back, in the course of which he presses deeper into her, making the dobie squirm and moan. Karel starts to pull out most of the way, then thrusts back in, at first a little gingerly but then harder as Alexandra wraps her legs around his ass and hits his buttocks with the heels of her foot-paws. The slick, black length of his cock saws in and out of her in rhythmic motions, and you can see it when he hits her inner barrier, as Alexandra clenches her muzzle every time, yet the woman doesn't seem to want to stop, not when her 'toughness' is in question. Instead, she calls out, 'Harder! Fuck me like you mean it!'";
		say "     After multiple requests by your slutty breeding bitch, Karel eventually gives her what she wants. Strong hands grasping her by the hips, he hammers into Alexandra with full force, [if TwistedCapacity of Alexandra is false]making her buck and thrash on the washing machine as the blunt cock forces its way into her womb. 'Fucking hell!' she groans out, holding back a whimper at the pain. The farmhand gives her a moment to compose herself, seemingly ready to pull out if she just asks for it, but Alexandra just barks in an aggressive tone, 'Go on! Fuck some puppies into me!' Eyebrows rising on both of the twins, they look at each other for a second, then Isaac shrugs and gives his brother's ass a light slap. 'Ya heard the lady!' [else]making her buck on the washing machine as the blunt cock pushes right into her womb. 'Told ya I can take it!' Alexandra barks out with harsh laughter, her changed body ready to accommodate even the biggest shafts somehow. The farmhand gives her a moment to compose herself, seemingly ready to pull out if she just asks for it, but Alexandra is having none of that. 'Go on! Fuck some puppies into me!' Eyebrows rising on both of the twins, they look at each other for a second, then Isaac shrugs and gives his brother's ass a light slap. 'Ya heard the lady!' [end if][line break]";
		WaitLineBreak;
		say "     Shaking his head in disbelief, Karel goes on to pound Alexandra deeply, thrust after deep thrust going in all the way and pushing him into her womb repeatedly. She takes everything that he can dish out, barking, moaning, and whimpering in desperate arousal as the equine cock ravages her pussy, until her stud finally reaches the point of no return, letting out a deep grunt as he slams forward one last time, and his thick shaft begins to gush a virile load into her womb. Spurt after rich spurt paints Alexandra's insides white, with untold millions of sperm starting their hunt for eggs to bury themselves into. Panting and out of breath, Karel glances over to meet his brother's gaze. 'God, you've got to try her. That's one sweet pussy!' Isaac grins at him and replies, 'I will, just gotta make some room, bro.' With that said, the second Friesian steps up to his sibling, pressing against his side as they both stand before the smaller female.";
		say "     Reaching out to put a hand on Isaac's shaft, Karel says, 'Wait till you feel her around your cock! You ready for the switch?' As the stallion nods, Karel pulls out of Alexandra in a swift pull that makes her tremble and gasp as his flared head pops past her cervix on the way out, and immediately places his brother's dickhead at her opening to replace him. Isaac reacts right away and thrusts in hard, his length sliding into the cum-slick passage and delving into the dobie's womb like his brother before. 'God, you're one sweet lay, lady! And Karel, I can feel your load squishing all around my dick!' Grinning broadly, the second horseman leans in to lick the side of Isaac's neck, giving him a playful nip. 'You know you love it, bro.' Isaac strokes his black-furred chest in reply, but then gets interrupted by Alexandra letting out an amused, if somewhat impatient bark of 'So, you gonna fuck me or what?! You can smooch on your own time!'";
		WaitLineBreak;
		project Figure of Isaac_hard_icon;
		say "     Focusing back on the canine impaled on his huge shaft, eyebrows drawing together a little, Isaac smacks her ass and starts to move in and out of her quivering snatch. You can hear squishy noises as he churns up the cum already inside her. At the same time, Karel moves around to the side a little, running his hands over Alexandra's upper body, stroking her heaving breasts and caressing the former cop's clit. Now having two muscled equines servicing her at the same time, your receptive bitch's arousal sizzles and rises like lava in a volcano about to erupt. She does her best to imitate the acoustics of one too, letting out full-throated moans and gasps that build up to a shouted crescendo as she reaches her climax, bucking and thrashing wildly on the washing machine. Balls deep in the trembling bitch, his erection squeezed like a vice from all sides, Isaac isn't far behind either, panting into her open mouth as he blasts his load deep into her womb, to mingle with his brother's deposit.";
		say "     Grunting deeply, the horseman trembles all over with every shot of cum into Alexandra, his balls sending forth every drop they can muster. As more and more equine seed is pumped into her, the dobie's belly starts to swell a little bit from the sheer volume of two quite large horsemen's virility. The two of them buck and grind against each other for a little while longer, until their movements eventually die down. At this moment, Karel moves in, bringing his muzzle up to theirs and starting to make out with Alexandra, as well as Isaac. Three-way kisses are shared between all of them as they ride out the ebbing high of their respective orgasms. Eventually, when the twins are just kissing each other for a moment, Alexandra lets out a chuckle and pats her filled belly. 'Now if this doesn't knock me up, we'll just have to do it again!' she says in eager anticipation, though you're not quite sure for which. Maybe both, judging from her well-satisfied look right now.";
		WaitLineBreak;
		say "     After leaning in to kiss Alexandra again, Karel stands up and looks down at his sweat-soaked body, then pats his brother's similarly damp chest. 'Quite a workout, eh?' Sharing a laugh with his brother, Isaac pulls his hips back a little, with the length of his cock that emerges from Alexandra's pussy being streaked white with cum. 'Got a small issue here, bro. Way it feels, she's ready to squirt like a geyser if I pull out!' Glancing around, the second horseman quickly steps over to snatch up a flannel washcloth and hands it to Isaac, who uses it to plug Alexandra's hole as he eases his flared dickhead out of her, pushing most of the fabric in between her nether lips. 'Wanted to make sure that your cum stays in me as long as possible, eh? That's some dedication in a breeding stud!' Alexandra barks out in amusement, feeling around a little gingerly at her twice-fucked pussy.";
		say "     As the four of you emerge from the laundry room a short while later, you're greeted by a group of grinning farmhands that cheer as they see the wide grins on the twins faces. There is some good-natured ribbing from them, and Alexandra delights in telling quite raunchy details of what the twins did to her, until the crowd eventually breaks up as one or another horseman has to go on shift or lie down to get some rest. The twins give you friendly slaps on the back and kiss Alexandra on the muzzle one after the other. 'Seems fairly sure she's knocked up, what with all that we've put in there, but in case it doesn't take or you just want another round... we're here for the both of ya,' Isaac adds, then they head out with another work crew. You're left with your well-bred bitch in the mostly empty barracks. [if Alexandra is in Grey Abbey Library]When some other horsemen come in, chatting with each other about wanting to be the next to fuck the 'horny sluts putting out', you know that it's time to leave, and you whistle for Alexandra to come to heel. The trip back to the library afterwards is fairly uneventful, and you arrive safely in your home ground.[end if][line break]";
		if TwistedCapacity of Alexandra is false:
			increase Cunt Depth of Alexandra by 1; [oversized fucks stretch characters bit by bit]
	else: [he actually fits into her]
		say "until he eventually bottoms out, his whole length buried in her. 'It never ceases to amaze me how stretchy some of the regular-sized people can be,' Isaac comments from the side and nods down to his own erection in Alexandra's grip. 'Think that you'll be able to take this one too, gal? I'm bigger than my 'little' bro.'";
		WaitLineBreak;
		say "     Alexandra reacts with an amused bark and says, 'You're gonna have to fuck me and find out, stallion-boy!' With a grin, the Friesian replies,  'Yes, darlin! As soon as Karel's done!', then slaps his brother's ass lightly, animating him to start thrusting rhythmically. 'Yeah! Fuck me like you mean it!' Alexandra calls out eagerly, and Karel gives her exactly what she wants. Strong hands grasping her by the hips, he hammers into Alexandra with full force, stretching her receptive pussy around his length. She eagerly takes all of him, even wrapping her legs around his hips to pull him tighter and bucking her hips a little to grind against Karel's crotch. Shaking his head in disbelief at the smaller female taking his whole dick, Karel goes on to pound Alexandra deeply, thrust after deep thrust going all the way in.";
		say "     She takes everything that he can dish out, barking and moaning in desperate arousal as the equine cock ravages her pussy, until her stud finally reaches the point of no return, letting out a deep grunt as he slams forward one last time, and his thick shaft begins to gush a virile load against her cervix. With his flared head stoppering the way out, it doesn't take long at all before the growing pressure makes his cum gush past the ring of her cervix and right into Alexandra's womb. Spurt after rich spurt paints Alexandra's insides white, with untold millions of sperm starting their hunt for eggs to bury themselves into. Panting and out of breath, Karel glances over to meet his brother's gaze. 'God, you've got to try her. That's one sweet pussy!' Isaac grins at him and replies, 'I will, just gotta make some room, bro.' With that said, the second Friesian steps up to his sibling, pressing against his side as they both stand before the smaller female.";
		WaitLineBreak;
		project Figure of Isaac_hard_icon;
		say "     Reaching out to put a hand on Isaac's shaft, Karel says, 'Wait till you feel her around your cock! You ready for the switch?' As the stallion nods, Karel pulls out of Alexandra in a swift pull that makes her tremble and gasp as his flared head pops past her cervix on the way out, and immediately places his brother's dickhead at her opening to replace him. Isaac reacts right away and thrusts in hard, his length sliding into the cum-slick passage and pistoning another gush of equine seed into the dobie's womb. 'God, you're one sweet lay, lady! And Karel, I can feel your load squishing all around my dick!' Grinning broadly, the second horseman leans in to lick the side of Isaac's neck, giving him a playful nip. 'You know you love it, bro.' Isaac strokes his black-furred chest in reply, but then gets interrupted by Alexandra letting out an amused, if somewhat impatient bark of 'So, you gonna fuck me or what?! You can smooch on your own time!'";
		say "     Focusing back on the canine impaled on his huge shaft, eyebrows drawing together a little, Isaac smacks her ass and starts to move in and out of her quivering snatch. You can hear squishy noises as he churns up the cum already inside her. At the same time, Karel moves around to the side a little, running his hands over Alexandra's upper body, stroking her heaving breasts and caressing the former cop's clit. Now having two muscled equines servicing her at the same time, your receptive bitch's arousal sizzles and rises like lava in a volcano about to erupt. She does her best to imitate the acoustics of one too, letting out full-throated moans and gasps that build up to a shouted crescendo as she reaches her climax, bucking and thrashing wildly on the washing machine. Balls deep in the trembling bitch, his erection squeezed like a vice from all sides, Isaac isn't far behind either, panting into her open mouth as he blasts his load deep into her pussy, to mingle with his brother's deposit already in her womb.";
		WaitLineBreak;
		say "     Grunting deeply, the horseman trembles all over with every shot of cum into Alexandra, his balls sending forth every drop they can muster. As more and more equine seed is pumped into her, the dobie's bells starts to swell a little bit from the sheer volume of two quite large horsemen's virility. The two of them buck and grind against each other for a little while longer, until their movements eventually die down. At this moment, Karel moves in, bringing his muzzle up to theirs and starting to make out with Alexandra, as well as Isaac. Three-way kisses are shared between all of them as they ride out the ebbing high of their respective orgasms. Eventually, when the twins are just kissing each other for a moment, Alexandra lets out a chuckle and pats her filled belly. 'Now if this doesn't knock me up, we'll just have to do it again!' she says in eager anticipation, though you're not quite sure for which. Maybe both, judging from her well-satisfied look right now.";
		say "     After leaning in to kiss Alexandra again, Karel stands up and looks down at his sweat-soaked body, then pats his brother's similarly damp chest. 'Quite a workout, eh?' Sharing a laugh with his brother, Isaac pulls his hips back a little, with the length of his cock that emerges from Alexandra's pussy being streaked white with cum. 'Got a small issue here, bro. Way it feels, she's ready to squirt like a geyser if I pull out!' Glancing around, the second horseman quickly steps over to snatch up a flannel washcloth and hands it to Isaac, who uses it to plug Alexandra's hole as he eases his flared dickhead out of her, pushing most of the fabric in between her nether lips. 'Wanted to make sure that your cum stays in me as long as possible, eh? That's some dedication in a breeding stud!' Alexandra barks out in amusement, feeling around a little gingerly at her twice-fucked pussy.";
		WaitLineBreak;
		say "     As the four of you emerge from the laundry room a short while later, you're greeted by a group of grinning farmhands that cheer as they see the wide grins on the twins' faces. There is some good-natured ribbing from them, and Alexandra delights in telling quite raunchy details of what the twins did to her, until the crowd eventually breaks up as one or another horseman has to go on shift or lie down to get some rest. The twins give you friendly slaps on the back and kiss Alexandra on the muzzle one after the other. 'Seems fairly sure she's knocked up, what with all that we've put in there, but in case it doesn't take or you just want another round... we're here for the both of ya,' Isaac adds, then they head out with another work crew. You're left with your well-bred bitch in the mostly empty barracks. [if Alexandra is in Grey Abbey Library]When some other horsemen come in, chatting with each other about wanting to be the next to fuck the 'horny sluts putting out', you know that it's time to leave, and you whistle for Alexandra to come to heel. The trip back to the library afterwards is fairly uneventful, and you arrive safely in your home ground.[end if][line break]";
	now lastdobiemess is 86; [Friesians came in her]
	impregAlexandraChance with "Karel"; [chance to knock her up]
	impregAlexandraChance with "Isaac"; [chance to knock her up]
	NPCSexAftermath Alexandra receives "PussyFuck" from Karel; [Friesian Twin 1]
	NPCSexAftermath Alexandra receives "PussyFuck" from Isaac; [Friesian Twin 2]

to say AlexandraFriesianBreeding4: [player leaves them alone to do it]
	say "     With a shrug, you tell Isaac that Alexandra is your prized breeding slut, and you simply want to see her pumped full of premium seed. Two virile studs like him and his brother should be enough to ensure that the dobie bitch swells up with a new litter soon. 'We'll certainly do our best, [sir],' the farmhand replies with a grin on his muzzle, then turns towards where Karel is still licking Alexandra's pussy. As Isaac starts to undo his pants, you quietly slip out from the laundry room and move to one of the tables in the main barracks room to sit down while you wait. You chat a little with the other horsemen, with them mostly detailing the hard work of keeping the farm clear of the creeping grass and the various creatures that roam the nearby area. They even invite you to a friendly game of cards, and the time till the twins are done with Alexandra seems over in a flash.";
	say "     Eventually, the door to the laundry room is opened from within, and a broadly grinning Karel steps outside, his searching gaze looking for you in the barracks. Following right after him is Alexandra, helped along by Isaac's arm around her shoulders. The bitch seems well-satisfied at her time with the two of them, if a bit weak on her legs, and you can see that her belly bulges a little from all of the cum they must have pumped into her, so much so that her pants aren't even quite shut at the front, with a little bit of white flannel visible through the open zipper. Looks like most of it has been pushed in between her nether lips to plug her hole. 'We had to improvise so there wouldn't be too much of a mess. Feel free to keep the hand towel, it's gonna be totally soaked in cum anyways,' Karel says with a smirk as he steps up to the table, then presents Alexandra with a wave of his arm as she arrives right after. 'And here is your lovely lady again.'";
	WaitLineBreak;
	say "     Karel's words draw a derisive snort from Alexandra, who says in a sarcastic tone, 'Yeah right, pfft! You boys know that I'm not a lady! The boss made me [PosAdj of Player] broken-in slut and wants to run a puppy mill it seems. [SubjectProCap]'ll see me knocked up right after your pups are born, I bet! And you know what? I don't even wanna bitch about it too much, since that's what I am. Just a bad dog bitch who needs to be bred!' With that said, she hooks an arm behind Isaac's head and pulls him down to her for a forceful kiss. After playfully sucking on his tongue for a moment, Alexandra pulls back and turns to you, giving a respectful nod. 'Thanks for taking me here, boss. This farm really has some studs who know how to give it to a woman, hard and proper!' The twins appear proud and somewhat embarrassed at the same time, right up to the point where one of the Clydesdales shouts, 'Way to go, guys!' and the room gets filled with laughter and cheers.";
	say "     There is some good-natured ribbing from the other farmhands, and Alexandra delights in telling quite raunchy details of what the twins did to her, until the crowd eventually breaks up as one or another horseman has to go on shift or lie down to get some rest. The twins give you friendly slaps on the back and kiss Alexandra on the muzzle one after the other. 'Seems fairly sure she's knocked up, what with all that we've put in there, but in case it doesn't take or you just want another round... we're here for the both of ya,' Isaac adds, then they head out with another work crew. You're left with your well-bred bitch in the mostly empty barracks. [if Alexandra is in Grey Abbey Library]When some other horsemen come in, chatting with each other about wanting to be the next to fuck the 'horny sluts putting out', you know that it's time to leave, and you whistle for Alexandra to come to heel. The trip back to the library afterwards is fairly uneventful, and you arrive safely in your home ground.[end if][line break]";
	now lastdobiemess is 86; [Friesians came in her];
	impregAlexandraChance with "Karel"; [chance to knock her up]
	impregAlexandraChance with "Isaac"; [chance to knock her up]
	NPCSexAftermath Alexandra receives "PussyFuck" from Karel; [Friesian Twin 1]
	NPCSexAftermath Alexandra receives "PussyFuck" from Isaac; [Friesian Twin 2]

to say AlexandraBreeding_BarracksMove:
	if Intelligence of Alexandra is 0: [not talked to Anthony yet]
		say "     A smile plays over your lips as you tell Alexandra that you want to take her back to the farm - to stay for a while, what with there being so many studs to breed her. The former cop lets out an amused snort, then comments, 'Hah! Good thing you're so invested in your little breeding program, if I'm getting pounded by grade A stud-meat because of that. I won't even complain about how stupid an idea it is to do a road trip through monster-infested streets just to see me knocked up.' Grabbing her by the back of the neck, you pull the bitch closer and kiss her a little forcefully. Letting your hands wander over her breasts, you remind Alexandra that she's your bitch, and if you want to have her bred by someone specific, or just declare her the barracks fuckmeat, that's your choice.";
		say "     You're about ready to get going with your breeding slut, but then pause for a second to think about what you're actually planning. Taking her for a trip is one thing, but having Alexandra live at the farm is a step beyond. [bold type]You really should have a chat with Anthony about your plans first.[roman type][line break]";
	else: [already cleared things up with Anthony]
		say "     A smile plays over your lips as you tell Alexandra that you're taking her back to the farm - to stay for a while, what with there being so many studs to breed her. The former cop lets out an amused snort, then comments, 'Hah! Good thing you're so invested in your little breeding program, if I'm getting pounded by grade A stud-meat because of that. I won't even complain about how stupid an idea it is to do a road trip through monster-infested streets just to see me knocked up.' Grabbing her by the back of the neck, you pull the bitch closer and kiss her a little forcefully. Letting your hands wander over her breasts, you remind Alexandra that she's your bitch, and if you want to have her bred by someone specific, or just declare her the barracks fuckmeat, that's your choice. 'Hey boss, I didn't say I wasn't going to spread my legs! No need to get rough, I'm down for some breeding, so let's get going!'";
		WaitLineBreak;
		say "     Putting her clothes back in order, Alexandra [if Libido of Alexandra is 1]stops by her teenage kids and lets them know she'll be gone for a while, then [else if Libido Of Alexandra > 1]stops by her teenage kids and lets the group of them know she'll be gone for a while, then [end if]saunters over to the entrance and waits there for you, her tail wagging left and right. It actually looks like she's eager to get going, so you gather your own gear in short notice and set out with the anthro bitch. Wandering through the chaotic streets of the city, you skirt around wrecked cars, heaps of trash, and frequent shreds of often cum-soaked clothing. As the two of you move in a focused manner with a goal in mind, most creatures on the way do avoid you, preferring to hide or wait for easier targets to attack and bring down. Yet by the time that you've almost reached the edge of the dry plains, there is one guy who doesn't seem to have gotten the memo: ";
		let randomnumber be a random number from 1 to 3;
		if randomnumber is:
			-- 1:[husky encounter]
				project the Figure of HuskyAlpha_soft_icon;
				say "An Alpha Husky steps into your way from behind the crumbling wall of a ruined building, a predatory grin spreading over his muzzle. 'What do we have here? A sweet little bitch just wandering into my territory. I could smell your wet pussy when you were a block away!' He sniffs the air with a grin on his muzzle, eyes roaming up and down over Alexandra's form. Almost as an afterthought, he throws you a glance too. 'Ooh, you're taking your bitch for a walk, is that it? Tough luck! Wherever you think you are going, you can forget about that! I'll take her off of your hands, and she'll be another slut in my pack!'";
				say "     As you start to protest and say that Alexandra is yours, the doberwoman keeps an uncharacteristic passive stance, lowering her head and only looking at the husky from the corner of her eye. He apparently decides that this means that she's no threat and struts closer, puffing out his chest as he growls at you in challenge. 'If you don't want to get a beating, you should fuck off now while I introduce this slut to my d-gnnnhhhHHH!' His further words come out as nothing more than a breathless groan after Alexandra knees him in the groin hard, sending the husky falling down to his knees. 'Let's leave this stupid asshat here in the street, boss. Maybe someone will come along and make use of him somehow. He's definitely a waste of space in the pack leader department if he fell for that simple trick.' With that said, she gives the guy a kick in the side, snorting derisively as he curls up into a ball. Then she continues to stroll down the street without looking back.";
			-- 2:[minotaur encounter]
				say "The towering shape of a minotaur stomps out of an alley just ahead of you, sniffing the air with interest. He seems to hone in on Alexandra, something about her drawing intense interest in the large male. You can see his dick starting to throb and grow. Then he grunts, 'Mmmhh! Pussy!' Alexandra lets out a sigh and face-palms, then calls over to you, 'Can you believe this guy? Calling me a pussy when it's totally obvious that I'm a bitch!' The way she wiggles her eyebrows and makes a circling movement with one hand tells you that the former cop has a plan, so you join and call back to her in a loud voice, drawing the attention of the minotaur.";
				say "     Using the opportunity, your doberwoman takes a few steps to pick up something from the ground: A pair of mostly intact panties as well as a chunk of rock that she keeps hidden behind her back. Looking back and forth between the two of you, the minotaur grunts out the word 'Pussy' again a moment later, then starts to walk towards Alexandra. 'You like my scent, don't you, big guy?' she asks him teasingly, moving the hand with the panties to slide under her waistband and rubbing the fabric against her crotch. By the time the bull-man reaches her, the garment is damp with her juices, and Alexandra holds it out for the minotaur to sniff, tucking it lower and lower until he's bent forward quite significantly. That's the moment when she strikes, hitting him between the eyes with her rock and momentarily stunning the big brute. 'Let's ditch this dip-shit!' the dobie shouts to you with a mocking bark, and you follow her advice, gaining sufficient distance before the minotaur manages to gather his wits again.";
			-- 3:[hawkman]
				project the Figure of Hawkman_naked_icon;
				say "A hawkman swoops down on the two of you with a screech, claws extended to slice or grab. Thankfully Alexandra is far from just a passive slut, and the tough bitch throws herself out of the way of his attack, landing in a crouch after a roll on the asphalt. The attacker isn't ready to just call it quits that easily though, and he takes a turn to attack again, only to find himself pelted with the rocks and trash Alexandra is finding around herself on the street. You join in after a moment or two and together drive off the aerial attacker.";
		WaitLineBreak;
		follow the ngraphics_blank rule;
		say "     Having dealt with the unfriendly encounter, you and Alexandra continue on your way, soon reaching the open expanse of the dry plains. No longer having to follow the road grid now, with sometimes blocked passages, you make faster headway and manage to avoid further unpleasantness until you reach the entrance to the McDermott Farm grounds. Passing a work crew that is cutting down the creeping grass along the borderline with scythes, Alexandra lets out a wolf whistle at the muscular horsemen. 'Hey boys, we're back!' Several of the strapping anthro Clydesdales pause in their work, rubbing the crotches of their jeans as they direct lewd stares at Alexandra. It takes the foreman clearing his throat to remind them that they're on shift and should get back to work. 'Fucking lucky bastards that are in the barracks right now,' one of the men grumbles, then joins his comrades in cutting the grass.";
		say "     Leaving the archway marking the entrance to the farm behind, you guide Alexandra over to the worker quarters and step inside of the open barracks building. This long structure is mostly one large room, a kind of living area at the front with a table, sofas, and a TV, the back half filled with quite a few bunk beds spaced a bit apart, with tall lockers in between. Several farm-workers are always present, for the main part anthro horsemen, and you have little trouble spotting the ones you're here for. [one of]Back in front of the lockers [or]Sitting at a table and playing cards with one another [or]Just walking out from the showers out back [or] Dozing on their bunk beds [at random]are Karel and Isaac, the two black-coated Friesians looking totally identical from the distance. Patting Alexandra's arm, you point the two of them out to her, which makes her tail wag even harder than before. Some of the other horsemen in here approach and try to chat your dobie bitch up, only to have her saunter past them and straight to the twins.";
		WaitLineBreak;
		project Figure of Karel&Isaac_clothed_icon;
		say "     'Welcome back,' the two brothers say almost in unison, with Karel stepping forward to shake your hand while Isaac focuses mainly on Alexandra, even having to adjust his trouser-snake as it throbs and seems to grow in his pants. Your dobie bitch chuckles as she sees the effect she is having on the tall stallion and saunters over to him, then opens her jacket and exposes her full breasts for him to see, even going so far as to press them against his abs when she lays her arm around him. 'Someone's eager to get in me I see!' she calls out over her shoulder, making Karel grin. 'I guess we don't have to ask why you're here again. Your woman likes horses, hm?' Replying that Alexandra does indeed like them, but that it is you who chose Karel and Isaac again, you whistle for the bitch, calling her over to stand by your side. Raising your hand and groping her breasts demonstratively, you explain that you want her to actually stay for a while in the barracks and ask for the two Friesians to look out for her while she does so.";
		say "     As a crowd is already gathering around the four of you, the twins once again lead your little group over to the laundry room, securely closing the door to keep the others out. 'So, what's this about her staying here you said?' Karel asks with one raised eyebrow, then looks over to ogle Alexandra's breasts. 'Isaac and me can watch her some of the time, but you do know we've got work to do too, so she'd be alone here with the others fairly regularly.' Alexandra snorts at his words and crosses her arms, 'What? You worried I'm some weak bitch that'll get taken advantage of? I can knock heads with the best of em, made it out on the streets for a long time, you know?! Not that I particularly mind riding nice thick stud-meat now, hah!' Isaac leans closer to her and gives her ear a playful nuzzle while groping the dobie's breasts.";
		LineBreak;
		say "     [bold type]Seems like having Alexandra stay in the barracks shouldn't be too much of a problem then. But what orders do you give her for her stay?[roman type][line break]";
		say "     [link](1)[as]1[end link] - You want her bred by anyone able to fill that juicy pussy with cum!";
		say "     [link](2)[as]2[end link] - She can play with the studs, tease, jerk and blow them, but you want to be there when she's bred!";
		now calcnumber is 0;
		while calcnumber < 1 or calcnumber > 2:
			say "Choice? (1-2)>[run paragraph on]";
			get a number;
			if calcnumber is 1 or calcnumber is 2:
				break;
			else:
				say "Invalid choice. Type [link]1[end link] to be the barracks breeding bitch or [link]2[end link] to just play with the studs and be ready when you come to see her bred.";
		if calcnumber is 1: [free breeding]
			LineBreak;
			say "     A grin spreads over your face as you decide what you want to do. Since you only feel like explaining it once, you throw an arm around the sexy dobie's shoulders and guide her out of the laundry room, closely followed by the Friesians. Opening the door, you see several horsemen and a zebra stud hanging out nearby, talking with each other. Seems like the crowd didn't quite disband yet, as some of the guys wanted to listen or were hopeful for a round with Alexandra themselves after the twins were done with her. Loudly clearing your throat and announcing that you have something to say, leads to all of the horsemen from the living quarters walking up, and several even popping out of the shower area in one of the back rooms, all of them naked, wet and dripping. All in all, fifteen towering equine studs form a circle around your group, throwing Alexandra[if player is female] and yourself[end if] some lusty looks.";
			say "     You introduce your dobie bitch to them, drawing open the front of her leather jacket to expose her shapely breasts and groping them for everyone to see. Then you lay your hand on her belly and explain that she's your breeding slut, and that you want to see some pups or foals as soon as possible. The so-far almost spellbound crowd of anthro equines bursts out in a cheer, with discussions starting immediately of who gets to do her first. The growing din of voices overlaying each other is suddenly cut like a knife by Alexandra letting out a sharp whistle around two fingers between her lips. 'Yo, boys! Only the boss here may give me orders. I'm not some meek piece of ass that'll lie there and take it till she's sore! I'll fuck ya, don't doubt that - but it's gonna be on my timetable, you hear me?!'";
			WaitLineBreak;
			say "     Almost in unison, the farmhands come to attention at her no-nonsense tone of voice, stiffening their backs and looking at your tough bitch with a new respect in their eyes. 'Yes, ma'm!' the ones she's looking at directly call out, followed by the rest in quick succession as Alexandra lets her gaze sweep over the group. Isaac lightly hits his brother on the shoulder, and quips, 'Guess we needn't have worried about her, eh bro?' 'It'll still be the right thing to watch out for her, but yeah, she's one tough cookie.' Chuckling as she hears them talk, Alexandra turns a little in your grasp, which both presses her breasts against your side and also allows her to look over her shoulder to the brothers. 'You two studs are gonna be my favorites among this bunch, that's for sure. Wouldn't mind to carry a whole lot of your kids!'";
			say "     What follows afterwards takes on less of an 'impending gangbang' air, instead becoming more of a friendly get-together. Singly, or more often than not in three's and two's, the various horsemen make their way to your little group, introducing themselves. Many try to impress Alexandra, with boasts of their prowess, promises of the pleasure they'll give her, and in one case simply an enormous erect cock being presented as the owner's prime argument why she should choose him as her next partner. The dobie bitch takes this in stride, exchanging teasing words with her future breeding partners, and getting a two-handed grip on the offered erection and squeezing it before saying, 'Someone's a big boy. But if you really want to impress me, show how flexible you are - if you can suck yourself off and swallow the load, you're gonna jump up on the list quite a bit.' Funnily enough, the guy actually does it, just lowering his head and starting to suck, never pulling his eyes away from the doberwoman's curving breasts the whole time.";
			WaitLineBreak;
			say "     All in all, the introduction of Alexandra as the new resident breeding bitch of the farm is a roaring success, leaving your bad dog bitch an accepted visitor among the group of farmhands. While the air in the building is quite testosterone-laden now that there's an available and open female around, things still are stable enough that you have no worries about leaving her there for a long while. With a last grope of Alexandra's ass and drawing her into a demanding kiss, you get moving back towards the library while Karel and Isaac are explaining the living arrangements of the farm and get fresh sheets so she can claim an unoccupied bottom bunk.";
			add "Barracks Slut" to Traits of Alexandra;
		else if calcnumber is 2: [player supervised breeding]
			LineBreak;
			say "     A grin spreads over your face as you decide what you want to do. Since you only feel like explaining it once, you throw an arm around the sexy dobie's shoulders and guide her out of the laundry room, closely followed by the Friesians. Opening the door, you see several horsemen and a zebra stud hanging out nearby, talking with each other. Seems like the crowd didn't quite disband yet, as some of the guys wanted to listen or were hopeful for a round with Alexandra themselves after the twins were done with her. Loudly clearing your throat and announcing that you have something to say, leads to all of the horsemen from the living quarters walking up, and several even popping out of the shower area in one of the back rooms, all of them naked, wet and dripping. All in all, fifteen towering equine studs form a circle around your group, throwing Alexandra[if player is female] and yourself[end if] some lusty looks.";
			say "     You introduce your dobie bitch to them, drawing open the front of her leather jacket to expose her shapely breasts and groping them for everyone to see. Then you lay your hand on her belly and explain that she's your breeding slut, who'll stay at the farm for a while to get to know them all, and that they can have all the oral fun they want in your absence. The so-far almost spellbound crowd of anthro equines bursts out in a cheer, with discussions starting immediately of who gets to do her first. The growing din of voices overlaying each other is suddenly cut like a knife by Alexandra letting out a sharp whistle around two fingers between her lips. 'Yo, boys! Only the boss here may give me orders. And besides [ObjectPro of Player] just saying that it's oral only, I'm not some meek piece of ass either that'll lie there and take it till she's sore! So if ya wanna have some fun, it's gonna be on my timetable and you better know how to eat pussy, you hear me?!'";
			WaitLineBreak;
			say "     Almost in unison, the farmhands come to attention at her no-nonsense tone of voice, stiffening their backs and looking at your tough bitch with a new respect in their eyes. 'Yes, ma'm!' the ones she's looking at directly call out, followed by the rest in quick succession as Alexandra lets her gaze sweep over the group. Isaac lightly hits his brother on the shoulder, and quips, 'Guess we needn't have worried about her, eh bro?' 'It'll still be the right thing to watch out for her, but yeah, she's one tough cookie.' Chuckling as she hears them talk, Alexandra turns a little in your grasp, which both presses her breasts against your side and also allows her to look over her shoulder to the brothers. 'You two studs are gonna be my favorites among this bunch, that's for sure. Wouldn't mind to carry a whole lot of your kids!' Turning her gaze back to you, she asks, 'You're gonna let them breed me again, right boss?'";
			say "     What follows afterwards takes on less of an 'impending gangbang' air, instead becoming more of a friendly get-together. Singly, or more often than not in three's and two's, the various horsemen make their way to your little group, introducing themselves. Many try to impress Alexandra, with boasts of their powress, promises of the pleasure they'll give her, and in one case simply an enormous erect cock being presented as the owner's prime argument why she should choose him as her next partner. The dobie bitch takes this in stride, exchanging teasing words with her future breeding partners, and getting a two-handed grip on the offered erection and squeezing it before saying, 'Someone's a big boy. But if you really want to impress me, show how flexible you are - if you can suck yourself off and swallow the load, you're gonna jump up on the list quite a bit.' Funnily enough, the guy actually does it, just lowering his head and starting to suck, never pulling his eyes away from the doberwoman's curving breasts the whole time.";
			WaitLineBreak;
			say "     All in all, the introduction of Alexandra as the new resident breeding bitch of the farm is a roaring success, leaving your bad dog bitch an accepted visitor among the group of farmhands. While the air in the building is quite testosterone-laden now that there's an available female around, things still are stable enough that you have no worries about leaving her there for a long while. With a last grope of Alexandra's ass and drawing her into a demanding kiss, you let go of your bitch and stand back while Karel and Isaac are explaining the living arrangements of the farm and get fresh sheets so she can claim an unoccupied bottom bunk.";
			add "Supervised Breeding" to Traits of Alexandra;
		now Energy of Alexandra is 2; [was taken to the farm before]
		if Intelligence of Alexandra < 2:
			now Intelligence of Alexandra is 2;
		move Alexandra to Worker Barracks;
		move Player to Worker Barracks;

to say AlexandraBreeding_BarracksReturn:
	say "     A smile plays over your lips as you tell Alexandra that you're taking her back to the farm for another extended stay. The former cop lets out an amused snort, then comments, 'Hah! Good thing you're so invested in your little breeding program, if I'm getting pounded by grade A stud-meat because of that. I won't even complain about how stupid an idea it is to do a road trip through monster-infested streets just to see me knocked up.' Grabbing her by the back of the neck, you pull the bitch closer and kiss her a little forcefully. Letting your hands wander over her breasts, you remind Alexandra that she's your bitch, and if you want to have her bred by someone specific, or just declare her the barracks fuckmeat, that's your choice. 'Hey boss, I didn't say I wasn't going to spread my legs! No need to get rough, I'm down for some breeding, so let's get going!'";
	WaitLineBreak;
	say "     Putting her clothes back in order, Alexandra [if Libido of Alexandra is 1]stops by her teenage kid and lets them know she'll be gone for a while, then [else if Libido Of Alexandra > 1]stops by her teenage kids and lets the group of them know she'll be gone for a while, then [end if]saunters over to the entrance and waits there for you, her tail wagging left and right. It actually looks like she's eager to get going, so you gather your own gear in short notice and set out with the anthro bitch. Wandering through the chaotic streets of the city, you skirt around wrecked cars, heaps of trash, and frequent shreds of often cum-soaked clothing. As the two of you move in a focused manner with a goal in mind, most creatures on the way do avoid you, preferring to hide or wait for easier targets to attack and bring down. Thankfully, your trip through the outer city and the dry plains is without any hassle, and soon, the entrance to the McDermott Farm grounds is visible in the distance. Reaching it, you're welcomed by a work crew just coming out, carrying large scythes to cut down the creeping grass on the borderline of the farm.";
	say "     Several of the men let out aroused whinny's as they see your companion coming closer, and one of the large and muscled equines calls out, 'Hey boys, the bitch's back!' They share a laugh and welcome yourself and Alexandra, who makes a beeline for the man who spoke and reaches out to rub his crotch through the fabric of his jeans. The strapping anthro Clydesdale's breathing starts to come a bit heavier and for a moment he looks ready to take the canine woman right here, with a bulge in the blunt-headed shape of an equine cock starting to expand along the inside of his pants-leg. But then, Alexandra pats him on the nose as he bends down to kiss her, stopping the man cold. 'Now you got something to think about while you do your hard, sweaty work. And if you come by after your shift to see me, I might just do something about it. Oh, and no jerking off before then - I'd smell that on you.' With a lewd wink, she leaves him standing like that, sauntering past while swaying her hips.";
	WaitLineBreak;
	say "     Leaving the archway marking the entrance to the farm behind, the two of you move over to the worker quarters and step inside the front entrance. As usual, there are several farm-workers present, which includes your special friends Karel and Isaac, who are just [one of]back in front of the lockers[or]sitting at a table and playing cards with one another[or]walking out from the showers out back[or] dozing on their bunk beds[at random]. The two black-coated Friesians looking totally identical from the distance, but Alexandra seems to be able to tell them apart without problem, as she strides forward with a wagging tail and calls Isaac by his name, lustily kissing him full on the lips before doing the same to his brother Karel. While she's exchanging some light groping with the two of them, various other horsemen gather in a small crowd, mostly staring at Alexandra, but also with one or two coming up to you and asking if you'll let her stay again.";
	say "     As you announce that Alexandra is indeed going to be here for a while, a cheer goes through the group of farmhands, with your back being slapped and hand shaken by the pent-up equine studs. A low murmur starts between several of them, exchanging ideas of how they'll convince Alexandra to choose them for some fun next. Your dobie bitch chuckles as she sees the effect she is having on the tall stallions, so she opens her jacket and exposes her full breasts for all of them to see, even shaking them to draw wolf whistles. Stepping back to watch her catch up with the men she spent time with before, you see Alexandra be openly greeted into their community, and groped half a dozen times in just a few minutes.";
	move Alexandra to Worker Barracks;
	move Player to Worker Barracks;

to say AlexandraBreeding_LibraryReturn:
	say "     Clearing your throat as you step up to Alexandra, you pull her close to your body and give her a demanding kiss. With the dobie bitch in your arms, you announce that you'll be taking her back home with you now. The gathered horsemen seem less than thrilled about the idea of losing their resident barracks slut, but accept things as they are after some grumbling, not standing in your way as you lead the former cop towards the building entrance. While they are an unruly, horny bunch, these men are still mostly control of their own desires, so they shrug it off quickly. As you leave the building, Alexandra leans against your side and licks your cheek, then asks, 'Wanted me back all for yourself again? Or is there some new beast you found that you want to breed me with? Wait, you know what - don't tell me, boss. Kinda feel like being surprised what you have in store for me, hah!'";
	say "     You chuckle at Alexandra's words and say nothing, instead snaking a hand down her back and sliding it into her pants, groping the woman's furry buns while you stroll towards the entrance of the farm. Caressing and teasing your bitch is a fun past-time, making the long trip to the library fly by in what feels like just a few minutes. 'Home sweet home, eh? Did I ever tell you how much I love doing it in there? Something about screaming and barking in lust in a 'quiet place' really tickles me pink!'";
	move Alexandra to Grey Abbey Library;
	move Player to Grey Abbey Library;

Alexandra Breeding ends here.
