Version 1 of Bastet by Wahn begins here.


[ Libido of Nermine (quest progress with Bastet and the Fennec     ]
[  0: never met them                                               ]
[  1: the fennec walked off with the ritual supplies               ]
[  2: the bet was declared                                         ]

[ BastetApproval:                                                    ]
[  0: Starting State                                                 ]
[ >0: Player was nice to her, had sex after "honorable" into         ]
[ <0: Player demands/forces sex with Bastet                          ]

[ Expansion Options                                                  ]
[
Bastet: [anthro lioness; available through making Nermine the player's bitch, then a questline]
- Deepening the Player's relationship with Bastet, in the positive or negative (befriending her or being more demanding - either of which might lead to various further sexual acts)
- Impregnating Bastet with cubs
- Freeing Bastet from her obligations (depending on the relationship built till that point, this might go several ways)
Ankhtepi: [anthro fennec twink: Bastet's high priest / devoted follower - comes in a package deal with her]
- Befriending Ankhtepi by giving the fennec some attention (hanging out as buddies, aiding him in 'freeing' Bastet from her obligations, letting him actually touch/worship Bastet, ...)
- Continued cucking of Ankhtepi, lusting after his goddess while the player has her as their plaything
- Using Ankhtepi (he'd do anything for Bastet, including serving sexually to 'save' her from the indignity)
- Gender-switching Ankhtepi through Nermine's powers to give the Player three sexy ladies at their beck and call (any of the above options with Ankhtepi could come after, with a different flavor now)
]

BastetSexBattleCount is a number that varies.
BastetSexOrTalk is a truth state that varies. [true for being in her sex menu, false for talk menu]
BastetApproval is a number that varies.

Section 1 - Quest and Sex Battle

instead of going north from Mall West Wing while Libido of Nermine is 1 and NermineFennecTurn - turns > 12:
	move player to Mysterious Shop;
	if debugactive is 1:
		say "     DEBUG: NERMINE/FENNEC/BASTET QUEST STAGE 1[line break]";
	now NermineFennecTurn is turns; [re-using the old timer for Bastet's fetch-quest]
	say "     Walking into Nermine's shop in the mall, you spot the beautiful jackaless standing in front of one of the large shelves in the back, inspecting and sorting strange knickknacks before placing them in a particular order. Since becoming yours, she's taken up going around the store completely naked, her soft fur shining lustrously in the candlelight. Watching the shapely form of this powerful woman being so openly presented is incredibly erotic, and the thought that she bows to your will has your libido flaring bright in barely a moment. You follow the seductive voice of your inner urges and walk up to the black-furred shopkeeper, appreciating the little glimpses of her soft breasts you catch past her body as Nermine stretches for some item or puts another down. So intent on her task that she doesn't notice you approach, the next thing Nermine feels is your right hand gently pulling her wagging tail to one side while your left arm slides around her chest and pulls the shopkeeper against your chest.";
	say "     Nermine stiffens in surprise and prepares to pull away, but just for a second - then she recognizes the hand now cupping her left breast and melts into your touch. 'Did Nermine's [master] decide to visit her again? What a nice surprise.' Turning her head to the side, she smiles at you, adoration clear on her face and you can feel the jackaless's tail wagging against your side in excitement. With such an eager bitch at your hands, you can't help but pull her around, and plant a lusty kiss on Nermine's lips. Making out with the sexy black-furred female, you move both hands to cup her breasts, then lean down to lick over a nipple and - are pulled out of the moment by a person shyly clearing his voice behind you. Breaking your lip-lock with the aroused jackaless, you turn around to see someone standing at the store counter, looking intensely embarrassed.";
	WaitLineBreak;
	project Figure of Bastet_neutral_dress_seethrough_nojewelry_icon;
	say "     You remember the slender fennec - he walked in on your fun with Nermine before. You briefly wonder what the odds are that you would happen to meet again under the same circumstances - but realize that with you having unrestrained access to the sexy jackaless these days, you're around often enough that it's pretty likely. Still, you do wish he'd come a bit later, as Nermine's businesswoman instincts draw her towards him and she quietly slips out of your grasp. 'What can Nermine do for her dear repeat customer? Did the noble fennec's endeavor end in a success?' Dressed as she is - which means not at all, her luscious breasts and more than a bit wet pussy in open view - the Fennec's eyes are drawn to her nude form and he pants speechlessly for several seconds before catching himself and looking back up to her face.";
	say "     'I - er - we - erm. I thank you for the urn, mistress Nermine. It worked! My goddess walks this earth again,' he finally gets out, giving Nermine a deep bow, then slowly continues, 'She... We... require something else. The goddess -' His stumbling words are interrupted by the ringing of the entrance bell as it heralds the appearance of a very beautiful and quite imposing lioness dressed in a tight kalasiris, striding into the store with regal composure. Apparently the goddess became impatient. 'What is taking so long, Anktepi?' she asks the fennec, who trembles at the slight tone of displeasure in her voice. 'Goddess, I was just...' he begins, lowering his head submissively, but the lioness waves him silent with a casual flick of her hand. 'There!' she commands, pointing at a chest standing in the corner of the room. 'Ah yes,' Nermine says with a smile on her muzzle, addressing the newest visitor, 'My welcome to you, avatar of Bastet. Nermine sees you have a desire for one of her more precious possessions.'";
	WaitLineBreak;
	say "     'It is mine,' the lioness states matter-of-factly, but Nermine lets a bit of her businesswoman's steely resolve show through and doesn't back down, instead saying, 'Of course Bastet will be aware that the high priestess's regalia has had many owners since her last avatar walked this world. Now it belongs to this humble storekeeper, who acquired it at not insignificant cost. So while Nermine would of course love to see her visitor reunited with these items, there will be a need for some compensation.' A little staring contest starts between the jackaless and her godly visitor, will pushing against will - but eventually, it is Bastet who first looks aside, her long tail twitching in annoyance. In this new world and with only one worshiper to sustain her, Nermine's got the upper hand, and apparently the cat goddess knows that only too well.";
	say "     Then a smile appears on Bastet's muzzle, brushing away any hint of disagreement, and she says in a now all sweet and nice voice, 'Once I have reclaimed my position in the pantheon of these people, I will shower you in riches, storekeeper. You can be sure of that. Give me what's m- what belonged to my previous incarnation, and your rewards will be plenty.' Nermine in turn gives the lioness a gentle nod, but then spreads her hands in an apologetic gesture and replies, 'This humble jackal is sorry, dear goddess, but this store does not provide credit, even to a goddess of honor. Given the state of things as they are now, the goal you aspire is far from guaranteed. This world is in flux, with many interested factions stepping forward. Nermine cannot give her visitor what she seeks on just a promise of future rewards.'";
	WaitLineBreak;
	project Figure of Bastet_neutral_dress_seethrough_icon;
	say "     The flicking of Bastet's tail shows clearly how displeased she is to hear these words, so Nermine quickly continues, 'This jackal is very apologetic about this. However, she can offer a deal that will likely satisfy both sides. An item of equal worth will be a fitting trade for what Bastet seeks and so Nermine suggests she retrieve the sash of dreams, long-sought by Nermine and in this very city right now. The wealthy collector Kurgan McNally living in a penthouse in the inner city recently acquired it. As a gesture of goodwill, the storekeeper will even provide an advance to the avatar, one item out of the set, to be hers to keep until the complete exchange is made.' Strolling over to the chest, Nermine paints a glowing symbol on the lid with her finger, then flicks that aside in a cloud of glowing fog, opening the lid to retrieve a pair of golden bracers, clearly of Egyptian design.";
	say "     Holding the bracers in her paw-hands, Nermine walks over to Bastet and shows them to her, though not without keeping her fingers tightly locked around the priceless artifacts. It is clear how dearly the lioness wants them, as her hands twitch slightly, as if to snatch them from Nermine's grasp. Waiting a few seconds more, the jackalwoman then asks, 'So, is this deal acceptable, my dear goddess?' Almost immediately, Bastet replies, 'Yes, yes. Fine. We will get you that bauble you want. Now give me my bracers.' With a bow, Nermine hands the silver and gold bracers over, a faint smile playing over her lips. 'As you wish, dear visitor. May we see each other again soon,' the jackaless adds calling after Bastet as the lioness rushes out of the store, followed by her fennec servant.";
	WaitLineBreak;
	say "     When the two of them are out of sight, Nermine saunters over to you, pressing her shapely breasts against your chest as she leans in to kiss you and gently takes your hand to set it on her bare rump. When she comes up for air after the long kiss, the sexy jackaless half moans half whispers to you, 'Did you enjoy the looks of Bastet's avatar, my lovely [master]? The deal that Nermine offered her has the opportunity of great profit - and pleasure, with the lioness. Should Nermine's dearest wish, she could tell [if Player is purefemale]her[else]him[end if] just where the sash of dreams currently resides. Retrieving it before Bastet and Anktepi can locate the artifact would be very advantageous...'";
	say "     The eager glint in Nermine's eyes tells you that the cunning jackaless would like you to play into her plans oh so very much. She belongs to you now, but being what she is, the storekeeper just can't stop scheming away, even if that includes letting you do the work for it. [bold type]It is your decision if you want to go along, so make up your mind now...[roman type][line break]";
	LineBreak;
	say "     ([link]Y[as]y[end link]) - Tell Nermine to give you the location.";
	say "     ([link]N[as]n[end link]) - Refuse to get involved.";
	if Player consents:
		LineBreak;
		say "     Nermine smiles contently, happy to see the main actor for her plan to play along. Clearing her throat, she begins, 'Nermine told Bastet only the truth, McNally did veritably acquire the sash quite recently - before loaning it out to the city museum, to be the centerpiece of their next grand exhibition, after the dinosaur event ran its course. She doesn't doubt that Bastet will learn of this too, once she visits the penthouse and questions whoever is left there - but for now, the way is clear for Nermine's beloved to retrieve the sash. It will be in an airtight vault box in the [bold type]restaurateur's office[roman type], deep in the [bold type]museum[roman type].' Nermine kisses your cheek, then takes a little box from one of the shelf-boards, opening it to pull out a small piece of paper, covered with neatly penned numbers. 'Nermine had been hoping for an opportunity and she had traded for the combination to the vault, so retrieving the sash should be an easy task. In and out, nothing that should provide any difficulty.'";
		now Restaurateur's Office is active;
		now Libido of Nermine is 2; [stage 1 event done - the hunt for the sash has started]
	else:
		say "     [bold type]Shaking your head and saying you're not interested, you see a slight frown cross her features, only to be quickly smoothed away as she remembers that you're her [master] after all. [roman type][line break]";
		LineBreak;
		say "     ([link]Y[as]y[end link]) - Fuck Nermine to drive home that you're the boss of her.";
		say "     ([link]N[as]n[end link]) - She'll just have to deal with her disappointment.";
		if Player consents:
			LineBreak;
			if Player is male:
				say "     Nermine grins eagerly as she pulls aside the dark curtains leading into the back room. You find your own muzzle stretching in a grin as you watch how eager she is to please you now, and step forward to look into the back room of the shop. Looking around, you find yourself in a rather large back room, boxes piled high along one side, your attention however, is drawn immediately to the other side of the room, where a soft mattress lies on the floor piled high with blankets. Next to the mattress is a small writing desk with a laptop on it, and a large comfy looking chair positioned next to it.";
				say "     Your examination of the room is interrupted, by Nermine stepping in the room behind you, her soft breasts pressing up against your back as she runs the tips of her claws through your fur teasingly, 'Does Nermine's master like?' The sexy jackal whispers lustily into your ears as she rubs her body up against your back, her hands reaching around to stroke your chest, even as they slowly trail down your body to trace over your stiff canine member teasingly. 'Nermine wishes her master would make himself right at home in Nermine's house, everything Nermine owns is her masters after all - including Nermine herself.' The eager jackal pants in your ear, obviously getting even more excited as she breathes in your strong dominant scent. You find yourself panting as well, from the jackal-woman's soft experienced touches, as she strokes her hands needily over your body. Your lust rising, it is all you can do to lead your eager little pet jackal over to the large comfy chair, feeling the need to sit for a minute.";
				WaitLineBreak;
				say "     Nermine grins happily as you settle into the large surprisingly comfortable chair, and before you can comment the lusty black jackal-woman is on her knees before you, her hands stroking the soft fur of your thighs even as she leans forward to trail her canine tongue along the base of your stiff cock. Your hands grip the chair arms tightly, as she then leans forward slightly giving you a wonderful view of her cleavage. 'Mmm Nermine noticed master liked Nermine's breasts. Let Nermine show her handsome master just what she can do with them,' the jackal bitch says in a soft teasing tone as she cups her soft breasts in her hands, before leaning forward even further so your cock is nestled in between her soft pillows, making you pant in pleasure as you feel yourself thrusting upwards slightly.";
				say "     Nermine grins happily at your sign of pleasure as she presses the soft fur of her breasts around your cock, moaning as she moves herself up and down, her long tongue licking the tip of your pointed canine cock whenever it comes in reach. You find yourself yipping in pleasure as the submissive jackal-woman lavishes her attention on your rod, her hand occasionally teasing your knot as it swells with arousal, even as the feel of her silken soft fur on your sensitive cock makes you shudder with excitement. Unable to hold yourself back, your jackal-like howl of pleasure soon echoes through the back room, as your seed spills out over your pets breasts, the sticky white liquid coating her face even as she eagerly licks at your spurting cock.";
				WaitLineBreak;
				say "     Eventually you relax back in the chair, as your pet sits back on her haunches, panting happily, her lust fogged eyes staring up at you adoringly even as your seed begins to dry on her breasts. Grinning you reach forward and pet her on the head a couple times and let her know what a good little pet she is being, which makes her smile as her tail wags eagerly behind her. You stroke her head for a while, until you feel recovered enough to head back out to the store, your new pet following along behind with your seed still adorning her breasts, making you grin at how proud she seems to be to have your cum displayed so prominently on her body, as she begins to go about her tasks in the store. The jackalman was definitely right about just how much this would change the lovely shopkeepers point of view, you find yourself thinking idly as you watch her move around the area happily, a grin spreading across your muzzle as you realize just how much better she looks as a lusty little pet for you to play with.";
			else if Player is female:
				say "     Nermine grins eagerly as she pulls aside the dark curtains leading into the back room. You find your own muzzle stretching in a grin as you watch how eager she is to please you now, and step forward to look into the back room of the shop. Looking around, you find yourself in a rather large back room, boxes piled high along one side, your attention however, is drawn immediately to the other side of the room, where a soft mattress lies on the floor piled high with blankets. Next to the mattress is a small writing desk with a laptop on it, and a large comfy looking chair positioned next to it.";
				say "     Your examination of the room is interrupted, by Nermine stepping in the room behind you, her soft breasts pressing up against your back as she runs the tips of her claws through your fur teasingly, 'Does Nermine's mistress like?' The sexy jackal whispers lustily into your ears as she rubs her body up against your back, her hands reaching around to stroke and tease your own soft nipples as she does so. 'Nermine wishes her mistress to make herself right at home in Nermine's house, everything she owns is her mistress's after all, including Nermine herself...' she pants in your ear, obviously getting even more excited as she breathes in your strong dominant scent. You find yourself panting as well, from the jackal-woman's soft experienced touches, as she strokes her hands needily over your body. Your lust rising, it is all you can do to lead your eager little pet jackal over to the mattress, where you can sprawl out comfortably.";
				WaitLineBreak;
				say "     Lying down on the bed, you position yourself on your back on the cushions, so you can watch with amusement as Nermine lowers herself down to all fours like an animal, as she crawls into bed with you. Deciding to see just how much fun you can have with this, you spread your legs slightly, giving her a glimpse of your soft jackal pussy, and are amused to see how her tongue immediately begins to lick along the sides of her mouth with desire. Grinning, your own body almost as aroused as hers is by this point, you spread your legs all the way so she can crawl up between them and service you properly, which the newly submissive jackal bitch wastes no time in doing.";
				say "     The feel of her long canine tongue as it licks over your own needy pussy is a small taste of heaven, as you lean back into the silk covered cushions and groan in pleasure, soon her tongue is teasing the edges of your pussy as it licks over your crotch, making you lift your hips up in excitement with each pass of her flexible tongue. Nermine helps by shifting so you can rest your legs up on her shoulders, the feel of her head between your soft furry thighs is amazing, and you lose yourself for a minute in the pleasure of her soft fur rubbing up against your own, the silk sheets underneath you feeling amazing on your back, even as your canine hind-paws rub up against Nermine's soft back. Once she has you positioned comfortably, she wastes no time lavishing your pussy with her attentions, her hands stroking your thighs even as you gasp at the feel of tongue pushing into your body.";
				WaitLineBreak;
				say "     Her narrow canine muzzle rubs up against your lips as she works her tongue in as far as it can go, shifting and teasing it around within you as you groan and clench the cushions underneath you in pleasure, the feel of her eagerly licking and nibbling on your clit as she laps up your juices is indescribably amazing, and after what seems like no time at all, and an eternity of pleasure at the same time, your body is shaking in a mind blowing orgasm as you let out a long canine howl which echoes around the room. Nermine's body shudders as well as you rub your feet on her shoulders, as she laps at your pussy, eager to clean every bit of your juices up, before eventually sitting back on her haunches, your feet settling back down on the mattress as you relax in the afterglow. Looking at your eager pet, and how happy she seems to be with her new role makes you smile, and you pet the mattress next to you, and she eagerly takes the invitation to lie down and tuck herself up against your side. You smile as you drift pleasantly in and out of consciousness for a while, enjoying the new situation and your new pet immensely.";
			else:
				say "     Being genderless currently, you're sadly not equipped to make use of your jackal bitch, so she'll just have to remember it on her own that you're her master and decide what gets done. With a last kiss and grope of her well-rounded breasts, you step away from the female jackal.";
			jackalmanify;
		else:
			LineBreak;
			say "     You don't feel like fucking Nermine right now, so she'll just have to remember it on her own that you're her master and decide what gets done. With a last kiss and grope of her well-rounded breasts, you step away from the female jackal.";
		now Libido of Nermine is 99; [stage 1 event done - no interest in cheating Bastet]

instead of going north from Mall West Wing while Libido of Nermine is 2 and NermineFennecTurn - turns > 12:
	say "[NermineBastetQuestFail]";

instead of going north from Mall West Wing while Libido of Nermine is 99 and NermineFennecTurn - turns > 12:
	say "[NermineBastetQuestFail]";

to say NermineBastetQuestFail:
	move player to Mysterious Shop;
	if debugactive is 1:
		say "     DEBUG: NERMINE/FENNEC/BASTET QUEST FAIL[line break]";
	project Figure of Bastet_smile_dress_seethrough_icon;
	say "     On the way into Nermine's shop in the mall, you literally collide with Anktepi the fennec as he very hastily pushes the door open, wanting to hold it open for his mistress. The two of you stumble a bit but neither falls down, not with the door and doorframe to catch yourselves on. Though this puts you right in the path of Bastet, now newly garbed with a golden armband, a very large and elaborate necklace, two little anklets, a tail-band and finally a golden tiara. Wearing the precious artifacts from a time her cult was in ascendancy as clearly bolstered the goddess avatar, as raw power seems to radiate from her like the warming rays of the summer sun. Better not keep one as her waiting, so you step aside and the lioness passes you with a regal nod, then walks a short distance before calmly saying over her shoulder, 'Anktepi, come.' This breaks the slender fennec out of his shame-filled paralysis at having messed up holding the door open for his goddess, and he hastily rushes after her, taking his spot half a step behind the powerful feline.";
	now Libido of Nermine is 100; [Bastet quest failed]
	now Restaurateur's Office is resolved;

Table of GameEventIDs (continued)
Object	Name
Restaurateur's Office	"Restaurateur's Office"

Restaurateur's Office is a situation.
ResolveFunction of Restaurateur's Office is "[ResolveEvent Restaurateur's Office]". Restaurateur's Office is inactive.
Sarea of Restaurateur's Office is "Museum".
when play begins:
	add Restaurateur's Office to BadSpots of MaleList; [monkey king]
	add Restaurateur's Office to BadSpots of FurryList; [monkey king]

to say ResolveEvent Restaurateur's Office:
	say "     After walking through the labyrinthine passages of the museum for quite a while, it becomes more and more obvious that something strange and unusual happened to this place when all the craziness started. It's a bit hard to say with hallways seemingly looping around and suddenly having developed new forks when you get to a portion that you went through before, but your guess is that you're about half a mile deep in here. At least the glowing 'EXIT' signs that every room and hallway holds give you confidence that you'll find your way back out, as every time you tried, the museum foyer was just two or three rooms back - if one follows the green arrows...";
	say "     Almost ready to call of the search after stumbling into the Asian wing - again - for the third time, your eyes suddenly notice a doorway that wasn't there the last few times you came through here. On it, a sign says 'Restaurateur'. Eager to finally get what you are here for, you dig the small paper with the vault combination Nermine gave you out of your pocket, then take quick steps towards the door. Yet before you're more than halfway across the room, you realize that you're not alone in here...";
	LineBreak;
	challenge "Monkey";
	if fightoutcome >= 20 and fightoutcome <= 29: [lost]
		say "     As you pick yourself up after the monkey departs, you notice that you seem to be missing something - the paper with the combination is nowhere to be found! You must have dropped it during your confrontation with the would-be king, and even with some searching, you can't find it again. Checking out the office, you do indeed find the vault that Nermine mentioned, but there's no way you could get a ten digit electronic combination lock open without the right code. Dejected, you can't do anything but leave. Maybe Nermine has written the numbers down somewhere else, and hopefully you can get back here before Bastet and her servant find the place...";
		now Resolution of Restaurateur's Office is 2; [lost]
		now Libido of Nermine is 50; [failed]
	else if fightoutcome >= 30: [fled]
		say "     Running off through the museum, you manage to shake the monkey tailing you after a while and stop to catch your breath. But as you do so, you notice that you seem to be missing something - the paper with the combination is nowhere to be found! You must have dropped it during your confrontation with the would-be king, or while fleeing, and even carefully backtracking through one or two rooms, you can't find it again. Dejected, you can't do anything but leave. Maybe Nermine has written the numbers down somewhere else, and hopefully you can get back here before Bastet and her servant find the place...";
		now Resolution of Restaurateur's Office is 3; [fled]
		now Libido of Nermine is 50; [failed]
	else if fightoutcome >= 10 and fightoutcome <= 19: [won]
		say "     Having dealt with the monkey annoyance, you continue on to the office door and open it, stepping into the large room behind it. Just as Nermine said, there is a vault-box in one corner of the room, and when you make your way to it, the combination she wrote down for you unlocks the sturdy combination lock. With a hiss, the airtight container opens, revealing a clear case of shatterproof plastic, inside which you can see a carefully folded band of highly decorated fabric. Just what Nermine wanted. Carefully picking the case up, you decide to leave the sash inside and bring it to Nermine right away.";
		say "     The trip to the mall thankfully is an uneventful one, so not too long after, you walk into Nermine's store carrying your precious cargo. The jackaless is already eagerly awaiting your arrival, giving a satisfied yip as you hand her the case. 'Nermine started feeling the power of the sash when her beloved must have removed it from the vault. She has little doubt that it will also attract... ah. Here they come.' Following the jackaless pointing paw, you look out through the storefront window to see Bastet in her beautiful lioness form, followed by her dutiful fennec worshiper. With a ring of the door bell, the two of them enter, and Bastet's eyes widen as she sees the case in Nermine's hands. Before the lioness has a chance to speak, Nermine pre-empts her and says, 'Another good acquaintance of this humble storekeeper brought her the object not too long ago. Nermine is sorry, but the agreed-upon deal has passed, now that it is in her possession. She does not know of any other things worth trading for the goddesses regalia currently, she is sad to say.'";
		WaitLineBreak;
		project Figure of Bastet_neutral_dress_seethrough_icon;
		say "     Bastet gives an angry hiss, but manages to hold herself back from cursing at the jackaless - being very cognizant of the fact that Nermine still holds most of her artifacts. 'We'll find something else to trade you,' she growls, then whirls around to leave in a huff - but again, Nermine stops her cold with an oh so calmly added, 'All the while being sorry to disappoint, Nermine has to remind the dear visitor that the partial armor she wears was just a loan - extended as a gracious advance on the deal. Now that that won't happen, there is the small matter of her visitor's obligation to pay her back... now, as Nermine is not in the habit of letting debts go unpaid.'";
		say "     'I have nothing to give you, jackaless!' the cat goddess hisses, her tail flicking left and right. Nermine shows her a bit of a toothy smile and replies, 'Nothing is far from what you got, dear goddess. As Nermine's visitors might have noticed, her [master] -' Nermine extends a gracious paw towards you, then moves on to pointing at Bastet, '- has an interest in the physical form the dear catess deigns to inhabit.' Bastet gives a somewhat annoyed flick of her tail then really looks at you for the first time. Yet before she can say anything, Nermine continues, 'So to please her [master] and give her honored visitor an opportunity to reclaim her armor completely, Nermine wants to offer the following: The beautiful cat goddess will spend some time with her master, doing her best to please [ObjectPro of Player]. If she succeeds in making [ObjectPro of Player] come before her, that will satisfy the debt and the deal, allowing her to leave with the ancient armor. But if Nermine's [master] should be the one pleasing Bastet instead, making her reach an orgasm before [ObjectPro of Player] - this would incur further obligations.'";
		WaitLineBreak;
		say "     'Clever, for a jackal bitch,' Bastet hisses, pulling her lips back to show sharp fangs. Then she adds, 'You built your trap well, sorceress. I have little choice but to accept.' Her fennec companion Anktepi is visibly startled by seeing his mistress forced to give in to Nermine's demands, and as Bastet walks up to you, there is a look of quiet despair and... envy, in is eyes. The proud lioness comes to stand quite close, looking you up and down with slitted eyes and a somewhat annoyed expression. Though even as she does so, you see the cat goddess's nostrils flare as she smells your jackalman body for the first time - and surprised interest flares up in her eyes. ";
		if Player is submissive:
			say "It seems like there was some hint of your submissive nature in what Bastet smelled too, as the lioness subtly changes her stance, a small smile playing over her lips. Seems like she expects an easy victory.";
			LineBreak;
			project Figure of Bastet_smile_dress_seethrough_icon;
			decrease BastetSexBattleCount by 1;
		else if "Dominant" is listed in feats of Player:
			say "It seems like there was some hint of your dominant nature in what Bastet smelled too, as the lioness subtly changes her stance, a small smile playing over her lips. Seems like she is getting ready for the challenge you'll prove to be, all the while panting slightly from the first hint of arousal.";
			LineBreak;
			project Figure of Bastet_smile_dress_seethrough_icon;
			increase BastetSexBattleCount by 1;
		else:
			LineBreak;
		say "     Well, let's get the action started then:";
		LineBreak;
		say "     [link](1)[as]1[end link] - Lean in and give Bastet a gentle kiss.[line break]";
		say "     [link](2)[as]2[end link] - Pull her close and show who's the boss here right from the start.[line break]";
		now calcnumber is 0;
		while calcnumber < 1 or calcnumber > 2:
			say "Choice? (1-2)>[run paragraph on]";
			get a number;
			if calcnumber is 1 or calcnumber is 2:
				break;
			else:
				say "Invalid choice. Type [link]1[end link] to gently kiss Bastet or [link]2[end link] to pull her against you and be a bit more offensive in your attention to the lioness.";
		if calcnumber is 1: [gentle kiss]
			LineBreak;
			say "     Leaning in to the lioness, you slide a hand gently over her shoulder, touching the back of Bastet's head as you give her a kiss on the mouth. She does readily return it and slowly brushes slender, clawed fingers over your arms as you continue making out for a moment. There even is a little bit of tongue-wrestling, with your own rubbing against the slightly rough surface of her feline tongue. Then suddenly, the moment is over and Bastet pulls back from you slightly, giving a flicker of a smile for how easily she got you worked up and breathing hard.";
			project Figure of Bastet_smile_dress_seethrough_icon;
			decrease BastetSexBattleCount by 1;
		else if calcnumber is 2: [go for the grope]
			LineBreak;
			say "     Wrapping an arm around the lioness, you confidently plant your hand on her shapely rump before pulling her body close against your own with a sudden tug. There is the start of a surprised yowl from the cat goddess at you being so forward with her divine self - but that is instantly quelled as you draw her head to yours with the other hand and plant a deep kiss on her lips. Sliding your tongue into the still shocked woman's mouth, you encounter her somewhat rough tongue and playfully wrestle with it. Your confident action is enough to draw the lioness into a sexy bout of making out, melting into your touch as you grope and caress her body at the same time. Eventually, after having some amazing moments with the cat goddess in your arms, you pull back, leaving Bastet to stand before you, panting and flushed.";
			project Figure of Bastet_neutral_dress_seethrough_icon;
			increase BastetSexBattleCount by 1;
		LineBreak;
		say "     Pleasant as it may be, there is no way anyone would spend all their time with a sexy lioness like Bastet simply making out - and both of you know it. The cat goddess takes a step back and weaves her lithe body in a sinuous, very enticing way, accompanied by graceful movements of her lightly muscled arms and legs. Her little show pulls all attention to the form-fitting kalasiris she wears, with the skin-tight tube dress providing sexy glimpses of Bastet's body. Consisting of very finely woven cloth, the garment seems almost transparent in places, letting you make out that besides the perky breasts with their little nipple-bumps up on her chest, the lioness has another set of two further down, their pale skin shining out of the golden fur all around. All in all, Bastet a very pleasant sight to look at, making you more than a little eager to see her fully naked.";
		LineBreak;
		say "     [link](1)[as]1[end link] - Take matters into your own hands, undress Bastet and caress her body.[line break]";
		say "     [link](2)[as]2[end link] - Just enjoy the show, letting Bastet proceed to a sexy strip show.[line break]";
		now calcnumber is 0;
		while calcnumber < 1 or calcnumber > 2:
			say "Choice? (1-2)>[run paragraph on]";
			get a number;
			if calcnumber is 1 or calcnumber is 2:
				break;
			else:
				say "Invalid choice. Type [link]1[end link] to strip Bastet yourself or [link]2[end link] to let her perform a strip show.";
		if calcnumber is 1: [grabby hands]
			LineBreak;
			say "     Stepping up to the lioness, you bring your hands forward to touch her shapely form, stroking them up and down over her tight dress while she sways her body some more, brushing those curves against you. Bastet can't help but give a little moan as you cup her breasts and lightly stroke the hard nipples showing so clearly through the almost-transparent material of her dress. Next, you slide your hands hand along the soft fur on the curve of her neck, then behind it, feeling for where the two strands holding up her dress are tied at the back. You find what you are looking for and undo the binding with a gentle tug, then slide your hands back to the beautiful feline's front, hooking your fingers under the fabric of her dress just below the armpits.";
			say "     As you start pulling down slowly, slowly, the sexy lioness takes up her enticing gyrations once again, making it an incredible show as inch by inch of the golden-furred female's breathtaking body is revealed. First the gentle rise of her chest below the collarbones, continuing on and on to the peak of her shapely breasts and their small, hard nipples, then the sharper curves of their underside, just asking for your hands to cup them. Continuing down, the next thing coming into sight is the lightly muscled expanse of her belly, complete with two more nipples waiting to be suckled on at the upper end, a small belly button and even a hint of visible abs on the trained body of this attractive lioness.";
			say "     Finally, your hands push the bunched up cloth down over the widest part of her hips and the dress falls to the floor completely, revealing her final treasure between those long legs - the delicate flower of her female parts. Breathing a bit faster from your sheer proximity and touch, the cat goddess says the word, 'Anktepi' almost in a sigh, calling over her servant to pick up her dress as she lifts her delicate paw-feet to step out of it. With the Fennec still crouched by your feet, the bundle of light fabric in his hands, you clear your throat to make him look up, smiling as you brush a hand over his mistress's crotch and slightly pull open her outer folds. In front of the slender male's widening eyes, you dip in a finger to feel how very wet she is, then demonstratively rub it against your thumb, pulling the digits apart slowly to show off a string of Bastet's fluids stretching from one to the other. And then, you give a sharp nod to the side, relegating Anktepi back to his spot as an observer after getting this enticing a look - and smell - of his goddess's.";
			project Figure of Bastet_neutral_naked_jewelry_icon;
			increase BastetSexBattleCount by 1;
		else if calcnumber is 2: [strip show]
			LineBreak;
			say "     You simply stand back, watching as the lioness sensuously strokes her hands up and down over the tight dress while swaying her body some more, then eventually slides them up, cupping her own breasts and stroking their nipples lightly while giving a demonstrative moan. Next, she slides a hand along the soft fur of her neck and behind it, pulling open the knot of the one strand of fabric that holds her dress up. As you watch in eager anticipation, the sexy lioness takes up her enticing gyrations once again while taking hold of the fine fabric of her garment at the hips and slowly, slowly pulling down on it. Inch by inch of the golden-furred female's breathtaking body is revealed - first the gentle rise of her chest below the collarbones, continuing on and on to the peak of her shapely breasts and their small, hard nipples, then the sharper curves of their underside, just asking for your hands to cup them. Continuing down, the next thing coming into sight is the lightly muscled expanse of her belly, complete with two more nipples waiting to be suckled on at the upper end, a small belly button and even a hint of visible abs on the trained body of this attractive lioness.";
			say "     Finally, her hands push the bunched up cloth down over the widest part of her hips and the dress falls to the floor completely, revealing her final treasure between those long legs - the delicate flower of her female parts. Bastet bends over to pick up her dress slowly, making sure you get to see all of her shapely assets presented in a very enticing way. After casually throwing the light garment to Anktepi for him to hold onto, the lioness walks closer, swaying her hips and drawing your eyes to her crotch with a hand that slightly pulls open her outer folds. Arriving just before you, she gives an almost challenging mrowl and takes your hand, setting it on top of her pubic mound before pushing it down slowly. Oh yeah, you can feel it - she's already slightly wet, getting ready for fun with you. Though if you're honest with yourself - your own arousal has soared quite a bit too during Bastet's sexy strip show. You'll have to watch yourself if you actually wanna win this contest of who gets the other off first.";
			project Figure of Bastet_smile_naked_jewelry_icon;
			decrease BastetSexBattleCount by 1;
		LineBreak;
		say "     Standing this close to the naked cat goddess, the wetness of her sex already on your fingers, you're of course very eager to continue with more fun. For now, you think touching her pussy some more should be the next step - but what will you do with the panting lioness?";
		LineBreak;
		say "     [link](1)[as]1[end link] - Slide two (or more) fingers deep into her body, rubbing Bastet's inner walls and stretching her.[line break]";
		say "     [link](2)[as]2[end link] - Concentrate on the clit at the top, rubbing its small button while also stroking her folds.[line break]";
		say "     [link](3)[as]3[end link] - On second thought... why not fuck her right now instead?[line break]";
		now calcnumber is 0;
		while calcnumber < 1 or calcnumber > 3:
			say "Choice? (1-3)>[run paragraph on]";
			get a number;
			if calcnumber is 1 or calcnumber is 2 or calcnumber is 3:
				break;
			else:
				say "Invalid choice. Type [link]1[end link] to penetrate and stretch Bastet with your fingers, [link]2[end link] to concentrate on rubbing her clit or [link]3[end link] to proceed straight to fucking.";
		if calcnumber is 1: [put some fingers in her]
			LineBreak;
			say "     Sliding your hand over the sexy lioness's pussy, you feel her soft and slightly open nether lips, spread them some more with your fingers, then push two of them deep into her, making Bastet's eyes go wide at the sudden penetration. The passage you're feeling your way into is warm and wet, clenching around the invading digits as her breath comes quicker from the arousing sensations you lavish on her. In and out, you guide your fingers, replacing a cock's thrusting with an intimate, sensitive strength as you work into her pussy again and again, driving the cat goddess to lust-filled mews with your efforts. Meanwhile, your other hand comes to rest on the shapely boobs the lioness sports cupping and caressing them, as well as stroking over the nipples.";
			say "     It does take a little bit of experimentation, but you do find a very sensitive spot deep inside that makes the sexy feline's legs almost buckle under her as you brush against it. Eventually, after some fun time fingering Bastet, you do pull your hand back, leaving her oh so very much turned on - and yourself almost as much at the same time, after so much groping and touching. Doesn't seem like you've made much headway in this step of the sex battle, but it's been a fun thing to do nonetheless.";
			project Figure of Bastet_smile_naked_jewelry_icon;
			decrease BastetSexBattleCount by 1;
		else if calcnumber is 2: [stroke the clit]
			LineBreak;
			say "     Sliding your hand over the sexy lioness's pussy, you feel her soft and slightly open nether lips, spread them some more with your fingers, then dip in a single finger to gently rub her passage. Bastet's eyes go wide at the sudden touch of her inner folds, then even wider, as you abandon the 'obvious' target of a finger-fuck to concentrate on the little nub that is her clit. A single brush over the sensitive little button draws a breathless mew from the feline beauty, which makes way for even louder gasps and aroused sighs as you set your index finger on it and start a circling movement, giving the lioness an intimate massage. Holding back from the more 'active' fun of thrusting into her pussy with your digits, you simply concentrate on driving Bastet out of her mind with pleasure, rubbing and stroking - down at her clit, and the quartet of small pink nipples up on her breasts and the upper chest below those.";
			say "     The attentive work with your fingers pays off quite quickly, winding Bastet up sexually in a really big way. She pants and meows at your touch, even purring for a moment in between, and soon has to take hold of your body to even stand straight, her legs almost buckling as pleasure and sex take over as new priorities for her body. Looks like you've got the feline well and ready for the real deal by now.";
			project Figure of Bastet_neutral_naked_jewelry_icon;
			increase BastetSexBattleCount by 1;
		else if calcnumber is 3: [fucking]
			LineBreak;
			say "     With Bastet already this wet and ready, you decide that there isn't much need for further one-sided foreplay after all. Time for the real fun...";
		LineBreak;
		say "     Pulling back a little from the sexy lioness, you quickly get busy removing your gear and clothes, throwing most of it simply aside as fast as possible as you set a new record for stripping down. And then, as soon as you are as naked as your feline partner, Bastet goes into the offensive, almost pouncing on you in her eagerness to win your little contest and reclaim her artifacts from Nermine. Though given the foreplay you've been through already, there is a definite edge of bodily need to her actions as well, which makes sharing hungry kisses with her all the more delicious. Wrapping herself around you in a tight embrace, the cat goddess aggressively makes out with you, giving lusty little growls as her nipples brush against your chest.";
		if Player is male:
			say "     With your pointy jackalman shaft standing rock-hard and ready, poking Bastet in the stomach as she presses against you, the next level of escalation she chooses is to grab your shoulders to brace herself, then swing a very flexible leg up and hook it around your hips - so she can slide herself down on your erection. You moan a satisfied grunt into her mouth as the lioness's slick and warm passage envelops your member deeper and deeper, then finally all the way and your balls press against her crotch. The two of you grind against each other for several moments while standing, gasping out shared moans as you get used to feeling the other inside - or around - you, then ";
			if BastetSexBattleCount > 2 or (BastetSexBattleCount is 2 and a random chance of 1 in 2 succeeds): [player won]
				project Figure of Bastet_neutral_naked_jewelry_icon;
				say "you grab Bastet's furry butt with one hand, hooking the other under the lioness's still standing leg to pull her into your arms fully. The cat goddess gives a needy mrowl as you pick her up, grinding her crotch tightly against your own in the progress. A series of aroused little meows follow as you carry her over to the store counter, your hard shaft rubbing her insides in new and exciting ways with each step you take, then gently lay her down on top of it, giving the sexy feline a long kiss as you do.";
				say "     As you eventually break the lip-lock with the golden-furred female, you straighten yourself and look down into her slitted eyes, giving Bastet a superior grin - then pull partway out and thrust deep in a lightning-quick move. She throws her head back and roars like a lioness in heat as you take her hard, her eyes rolling up in their sockets at the intense sensations of a powerful male mating with her. Fucking the beautiful woman on Nermine's store-counter, with her tight passage trembling and flexing around your erection, you can't help but think back to when you took the jackaless in just this very spot, and just how much fun you did have taking her while she had to service a customer. The thought of just who that customer was makes you look up from Bastet's breasts as they bounce with each thrust into her, and you seek out Anktepi with your gaze - only to see that the slender fennec has his own cock in hand and is stroking off to his mistress being fucked. Seems like the small guy couldn't help but get aroused at the sight - but he's likely imagining its him giving it to the magnificent lioness.";
				WaitLineBreak;
				say "     With you clearly on the winning end of this fun little sex-battle, you take a moment to revel in having driven Bastet half out of her mind in arousal, mewling needily with each hard thrust into her pussy. Leaning over the lioness, you make out with her some more, then even catch first one, then the other breast and nibble a little on her nipples - all the while drawing louder and louder moans from the horny goddess. And then, it is time for the grand finale - as you feel the urge to cum rise quickly inside yourself, and you don't want to lose after all by accident. Stroking a hand over Bastet's lower pair of nipples, then the flat tummy and down to her crotch, you rub her clit while still keeping up the hard pounding into her, stimulating the lioness most sensitive spots at the same time, inside and out.";
				say "     Helpless against this lustful assault on her senses, Bastet's simply can't hold back anymore, and with a loud yowl, she starts to orgasm, writing under you in boundless pleasure. Her tight passage around your thrusting shaft ripples and flexes as the beautiful female barrels past the point of no return, forfeiting any right to her ancient treasures and incurring even more of a debt to Nermine. With the satisfaction of victory lifting your already very high spirits, it does take but a moment till you join her in climax, driving your shaft deep just as the knot at its base swells up and locks the two of you together. Then the first splash of your seed bursts into her body to claim her as yours. Half-collapsing on top of Bastet as the orgasm rocks through your body, you grunt with each further spurt of cum deposited in her fertile womb.";
				WaitLineBreak;
				say "     As you yourself slowly come down from the height of arousal, the sound of rapid panting and low fapping noises draw your attention to the side, where Anktepi is frantically jerking himself off, until he soon also gives a breathless little gasp and starts shooting a quite respectable load for such a little guy, the cum landing in long streaks of white splatter on the shop's smooth wooden floorboards. As his climax slowly tapers off and smaller and smaller spurts of cum splat down on the ground, Nermine clears her throat and says, 'Nermine is always happy when her customers enjoy their stay in her store as much as possible, but the dear fennec did create quite a little mess. How fortunate that Nermine has just acquired a new servant to clean up after him.' With that, she nods to Bastet, whose head lolls from side to side in a totally blissed-out state under you.";
				say "     The fennec's reaction to Nermine's little barb is almost priceless - judging from his expression, he must be white as a sheet under the fur all over his anthro form. You can almost see the wheels turning inside his head - the guilt of jerking off as his goddess lost, with the added possibility of her having to wipe up his cum... it really leaves only one option for him, and Anktepi throws himself on the ground, wiping up the white cum in frantic haste, using his hands and the fur of his forearms. As soon as he's done, the fennec gives Nermine a pleading look and gasps out, 'Please, don't... abuse her. She's my goddess! I - I love her. I will find a way to pay for her freedom!' And with that, the little guy sprints to the door, leaving the store with the ring of its little doorbell.";
				WaitLineBreak;
				project Figure of Nermine_naked_icon;
				say "     Nermine's face bears the deceptively mild smile you've come to expect from the merciless businesswoman as she saunters over to you, swaying the hips and chest of her naked body for you to enjoy. 'Nermine must thank her handsome master,' the jackaless says and leans in to give you a kiss, then she continues, 'Through his effort, this deal worked to perfection, far better than she had accounted for. Such a pleasant reward, and the promise of much more to come.' To accompany the last sentence, she indicates the semiconscious lioness still impaled on your shaft, then the door through which Anktepi fled not long ago. The black-furred jackaless presses herself against your side, drawing you into a long bout of making out. As she eventually pulls back to let you take a breath, a wicked little smile plays over Nermine's muzzle and the jackaless says, 'Watch this, master.'";
				say "     With that, the sexy canine leans forward and caresses Bastet's breasts, giving you the quite enjoyable image of seeing her black-furred hand covering a perky golden breast of Bastet's naked body. The jackaless even goes on to lap at the supine lioness's nipples, drawing some soft mews from the soon squirming Bastet, then bringing together both their canine and feline muzzles to kiss the vanquished goddess. Gripping the counter with her hands, Bastet moans and... gets a bit wetter around your shaft, clearly showing that she can't help but react to the stimulation. Though it isn't without being somewhat annoyed about her own bodily weakness in regards to sexual matters - as the next words from Bastet's throat are, 'You bitch!' Nermine just chuckles at that and plants a kiss on Bastet's lips again, which the lioness reluctantly returns. 'What astute observation. Nermine is indeed her master's loyal bitch. As will Bastet be, should he wish it.'";
				say "     Nermine gets back to making out with the not quite willing, but still really wound up Bastet, which is a truly awesome sight with the contrast between their fur colors. With the fun show to watch, it does take quite a while till eventually your knot softens far enough to be pulled out of Bastet's freshly bred pussy. 'Nermine must ask her [master] for some privacy now, she has much to talk about with Bastet, once the goddess recovers from your competition. Instructions to give, duties to lay out. She and Nermine will be ready for his pleasure once he returns.' And with that, the jackaless gently but firmly ushers you out of her store, turning the store sign to 'Sorry, We're Closed' and locking up. Seems like she really meant it, so you decide to take a stroll through the mall and end up in the food-court after a while.";
				move player to Mall Foodcourt;
				move Bastet to Mysterious Shop;
				now Libido of Nermine is 10;
				now Resolution of Restaurateur's Office is 3; [male player won sex battle]
			else: [Bastet won]
				project Figure of Bastet_smile_naked_jewelry_icon;
				say "Bastet purrs in a commanding voice, 'Lie down.' Horny as you are, you can barely think straight, so you obey, bracing yourself with your arms as you lower yourself to the ground. While you do so, Bastet demonstrates just how flexible and skilled in gymnastics she is - by keeping your canine cock buried in her tight pussy all the way, even as you stretch and move. Eventually, you're more or less lying on your own discarded clothing, with the golden-furred feline straddling your hips and rocking back and forth in the most... stimulating way.";
				say "     A satisfied little roar comes from the lioness's muzzle as she takes full control of the situation, leaning forward and pinning your arms to the ground as she grinds her crotch against yours. Satisfied, lust-filled mrowls soon follow, each time she makes your cock bottom out and brush against very sensitive parts deep inside her tight pussy. Its such a sexy and breathtaking situation that you quickly feel the urge to cum rise deep inside you and close your eyes to await the impending orgasm - only to have Bastet stop her movements from one moment to the next. The lioness looks down at your nonplussed face with a chuckle on her lips, then gives you a little flex of her internal muscles that makes you pant needily - only to stop right after. Seems like this cat wants to play a little with you before she finishes you off.";
				WaitLineBreak;
				say "     Leaning forward, Bastet flashes sharp teeth at you, then runs her somewhat rough tongue over your [Body of Player] chest. She goes up and up, arriving at your head before long, which leads to several nice moments of her making out with you, if in a somewhat demanding fashion. Then finally, the cat goddess gives you a 'love-bite', nipping the side of your neck with her teeth before going back to full on grinding against your body. It is obvious that the feline does enjoy herself more than just a little bit - so much so that she even takes short breaks to let you cool down a little - which helps push back the inevitable orgasm she's been prepping you for since this whole matter started.";
				say "     Riding your hard pole with relish, Bastet moans and purrs in lust and you can feel her become just a bit wetter with each deep penetration. As your urge to cum wells up quite strongly once more, an idea of maybe still being able to win comes into your head, making you buck up against the lioness. And it even is a partial success, as the cat goddess gives an aroused mrowl - both from the deep penetration and a male trying to breed her... but Bastet is more than ready to counter your move. With the flexible grace that is so much part of her golden-furred form, the lioness pushes her hips up, making your canine cock slip out of her body just as the knot begins to expand and long streaks of cum squirt high into the air - only to splat down on yourself, instead of filling her womb. Bastet gives a victorious chuckle and shows a challenging grin to Nermine, then gets right back to having fun with you - the male she vanquished in sexual battle to reclaim her artifacts.";
				WaitLineBreak;
				say "     And so, the quite aroused lioness starts rubbing herself against your hot and still very hard cock, brushing her slick pussy lips against the swollen bulge of your knot. Satisfied mews escape her lips and her clawed hands grip your arms tightly as she rocks back and forth on top of you - soon reaching her own climax, making the lioness pant in lust as her pussy drips and squirts femcum, adding to the mess all over your crotch and chest. Then suddenly, you hear a breathless gasp from the side. Turning your head, you spot Anktepi the fennec, frantically jerking himself off to the hot show his mistress victory provided. A twitch goes through him from muzzle to tail-tip as he follows up with a loud pant, just as quite a respectable load for such a little guy starts to spurt out of his cock, the cum landing in long streaks of white splatter on the shop's smooth wooden floorboards.";
				say "     As Bastet's grinding gets slower and slower, just as ever smaller spurts of cum from Anktepi splat down on the ground, Nermine clears her throat and says, 'Nermine is always happy when her customers enjoy their stay in her store as much as possible, and she is happy to see that their deal has been concluded with a pleasant time for all participants.' Sauntering over towards you and Bastet, the jackaless adds (with a slight tinge of regret audible in her voice - at not getting the best deal there could have been), 'My dear goddess, the high priestess regalia is yours.' The two sexy female's eyes meet for a second, then Bastet stands up from you and Nermine gives a wave to the chest with her slender hand, stopping the almost imperceptible hum of the magical protection that surrounded it.";
				WaitLineBreak;
				project Figure of Nermine_naked_icon;
				say "     As the cat goddess avatar walks away from you, Nermine on the other hand crouches before you, then crawls forward on all fours, moving into position to kiss you on your mouth. As she comes up for air afterwards, the jackaless says, 'Nermine is glad to see her [master] did enjoy himself with the visitor. Regrettable, that Bastet triumphed in the end, but Nermine is sure she can take care of him just as well herself. And should he feel a desire for another lioness nonetheless, there are... options, Nermine could arrange.' Then she proceeds to lower herself on top of you, brushing her full breasts and hard nipples over your chest and starting to lap up the cum and sheen of sweat covering your skin.";
				say "     Meanwhile, Bastet gives her naked fennec servant a somewhat stern look, freezing him in mid-motion with a commanding hiss as he shyly tries to cover up. Her eyes wander over him, the still half-hard cock in his hand and the long streak of cum on the floor - and a slight smile plays over her lips before she regally says, 'Get my dress.' His paralysis broken, the slender fennec rushes over with Bastet's finely woven garment, then helps her put it back on with trembling fingers, followed by handing her what items lie in Nermine's chest. An armband, then a very large and elaborate necklace, followed by little anklets, a tail-band and then finally a golden tiara are put on by Bastet, each precious artifact bolstering the sense of raw power emanating from the lioness. 'Ah, finally,' the goddess of cats says, then adds with a glance to you and Nermine still licking you, 'Let us leave this lewd place then. Destiny awaits to be forged.' And with that, the lioness walks out of the store, closely followed by her servant.";
				now Libido of Nermine is 100;
				now Resolution of Restaurateur's Office is 5; [Bastet won sex battle]
		else: [females]
			say "     Making out and touching each other quickly escalates to hands sliding lower and lower, then a first brush of your fingers against each other's crotch. Soft stroking against clits and increasingly wet and swollen pussy lips leads to shared moans as your lips are pressed together, with both your tongues wrestling in a slippery dance of shared arousal. Then the next level of escalation is reached as you slip a finger into Bastet's pussy, probing her tight and hot passage while giving a rub to her clit with your thumb. A lusty mrowl escapes the lioness lips and she gets to work on you in turn, showing you some very, very stimulating movements to do with her slender fingers. The mutual groping continues in unabated eagerness until eventually Bastet presses her whole front against you tightly, pushing her shapely breasts to your chest as you join a deep kiss, then ";
			if BastetSexBattleCount > 2 or (BastetSexBattleCount is 2 and a random chance of 1 in 2 succeeds): [player won]
				project Figure of Bastet_neutral_naked_jewelry_icon;
				say "finally, you take control of the situation, turning the lioness around with a quick move, embracing her from behind with one hand on a shapely breast, the other still down between her legs.";
				say "     The cat goddess gives an aroused mew as you assert your dominance, trembling as you touch her sex. As wound up as you got her since your little contest started, now she can't hold back anymore, panting and rotating her hips to grind against your hand. And just like that, you know you finally have her - all that remains is to finish her off. Even though your own pussy isn't getting any direct stimulation right now, you can still feel copious femcum leaking from your [Cock of Player] nethers, to trickle down the inside of your legs. Getting this far with Bastet turns you on so very much. Reveling in the feeling of having the breathtakingly beautiful feline in your power, you really get to work on her - so much so that she has to brace herself against a thankfully very close-by bookshelf to keep her legs from buckling.";
				WaitLineBreak;
				say "     You can't help yourself but tease the lioness a bit, whispering into her pointy ear about not being able to control herself, that she wanted to lose so she could spend time with you and Nermine, then tell her that even her companion thinks that this is the place - and role - she belongs in. With one hand between her legs, your other takes hold of Bastet's muzzle and turns it to the side, then returns to cup her rounded breast. Now the lioness can see Anktepi clearly, see that the fennec is frantically jerking himself off to the show of two females grinding against each other before his very eyes. Then suddenly, a twitch goes through him from muzzle to tail-tip as he gives a breathless pant, just as quite a quite respectable load (for such a little guy) starts to spurt out of his cock, the cum landing in long streaks of white splatter on the shop's smooth wooden floorboards.";
				say "     Whispering into Bastet's ear that it's time for servants to cum now, you proceed with an all-out attack, pushing two fingers ever deeper into her while the other hand rubs and strokes her clit and you nibble at the curve of her neck. It only takes a moment before the combined sensations push Bastet the last little step over the edge, and the lioness trembles in your grasp as she orgasms, gushing femcum over your fingers. Now that you're really and properly won, you decide it is time to get your own release - and start to grind against something quite conveniently already between your legs - the lioness's soft-furred tail. Bastet is still breathing hard as she feels the touch of your nether lips against her tail, then the wet femcum starts to mat her hair against it.";
				WaitLineBreak;
				say "     With the sexy situation being what it is - you enjoying yourself with Bastet, in front of Nermine, her devoted servant Anktepi, and anyone else who might be walking past the shop and look in the window - it doesn't take long at all before you reach a breathtaking climax yourself, gasping loudly as you squirt quite a bit of femcum over her tail. There is a lull in the sex noises filling the store as everyone simply pants for a moment, trying to catch their breaths, then eventually Nermine clears her throat and says, 'Nermine is always happy when her customers enjoy their stay in her store as much as possible, but the dear fennec did create quite a little mess. How fortunate that Nermine has just acquired a new servant to clean up after him.' With that, she nods to Bastet, still held against your front and on shaky legs.";
				say "     The fennec's reaction to Nermine's little barb is almost priceless - judging from his expression, he must be white as a sheet under the fur all over his anthro form. You can almost see the wheels turning inside his head - the guilt of jerking off as his goddess lost, with the added possibility of her having to wipe up his cum... it really leaves only one option for him, and Anktepi throws himself on the ground, wiping up the white cum in frantic haste, using his hands and the fur of his forearms. As soon as he's done, the fennec gives Nermine a pleading look and gasps out, 'Please, don't... abuse her. She's my goddess! I - I love her. I will find a way to pay for her freedom!' And with that, the little guy sprints to the door, leaving the store with the ring of its little doorbell.";
				WaitLineBreak;
				project Figure of Nermine_naked_icon;
				say "     Nermine's face bears the deceptively mild smile you've come to expect from the merciless businesswoman as she saunters over to you, swaying the hips and chest of her naked body for you to enjoy. 'Nermine must thank her handsome master,' the jackaless says and leans in to give you a kiss, then she continues, 'Through his effort, this deal worked to perfection, far better than she had accounted for. Such a pleasant reward, and the promise of much more to come.' To accompany the last sentence, she indicates the semiconscious lioness still impaled on your shaft, then the door through which Anktepi fled not long ago. The black-furred jackaless presses herself against your side, drawing you into a long bout of making out. As she eventually pulls back to let you take a breath, a wicked little smile plays over Nermine's muzzle and the jackaless says, 'Watch this, master.'";
				say "     With that, the sexy canine moves to the side a little, now standing on the other side of Bastet from yourself, where she reaches up to cup the perky gold-furred breasts of Bastet's naked body with her black hands. The jackaless even goes on to lap at the lioness's nipples, drawing some soft mews from the soon squirming Bastet, then bringing together both their canine and feline muzzles to kiss the vanquished goddess. Squirming in your gasp, Bastet moans and... noticeably gets a bit wetter against your fingers, showing that she can't help but react to the stimulation. Though it isn't without being somewhat annoyed about her own bodily weakness in regards to sexual matters - as the next words from Bastet's throat are, 'You bitch!' Nermine just chuckles at that and plants a kiss on Bastet's lips again, which the lioness reluctantly returns. 'What astute observation. Nermine is indeed her [master]'s loyal bitch. As will Bastet be, should [SubjectPro of Player] wish it.'";
				say "     Nermine gets back to making out with the not quite willing, but still really wound up Bastet, which is a truly awesome sight with the contrast between their fur colors. With the fun show to watch over Bastet's shoulder, and of course her warm body pressed against you, it takes a moment before you think of doing anything else - which is reach out for Nermine's full breasts - only to find yourself stopped short after just a quick grope. Nodding her head in a submission, but still with a bit of determination in her voice, the jackaless says, 'Nermine must ask her [master] for some privacy now, she has much to talk about with Bastet, once the goddess recovers from your competition. Instructions to give, duties to lay out. She and Nermine will be ready for [ObjectPro of Player] pleasure once [SubjectPro of Player] returns.' And with that, the jackaless gently but firmly ushers you out of her store, turning the store sign to 'Sorry, We're Closed' and locking up. Seems like she really meant it, so you decide to take a stroll through the mall and end up in the food-court after a while.";
				move player to Mall Foodcourt;
				move Bastet to Mysterious Shop;
				now Libido of Nermine is 10;
				now Resolution of Restaurateur's Office is 4; [female player won sex battle]
			else: [Bastet won]
				project Figure of Bastet_smile_naked_jewelry_icon;
				say "finally, Bastet takes control of the situation, pushing you back slowly but surely, until you bump against one of the bookshelves on the wall. Then the lioness catches hold of your wrists, pushing them up over your head and holding them there with one hand, while the other dips down to your crotch again.";
				say "     You can't help but moan loudly as the cat goddess asserts her dominance, fingers dipping into your moist cave as she holds your wrists in a tight grip. As wound up as she got you since your little contest started, your lust-addled mind just makes you react to the stimulation, panting and rotating your hips to grind against Bastet's hand. You know she's won, that she just needs to finish you off to reclaim her artifacts - but deep down, you don't really care, this just feels too good. Through Nermine's scheming, you've got the opportunity to make out and finger a god's avatar... that's something to be proud of no matter what. Reveling in her already obvious victory, the breathtakingly beautiful feline plays with having you in her power, stroking you, then slowing down, followed by more stroking. It's like a cat and mouse game with her, only here you're the mouse, helplessly held by the feline as she pushes you right up to the edge, then keeps you there for minute after minute.";
				WaitLineBreak;
				say "     As the lioness toys with you, stroking your sex as well as leaning in to brush her breasts over your chest and kissing your lips, your head lolls around a little after another wave of arousal, and you find yourself looking to the side, where Bastet's fennec servant Anktepi is frantically jerking himself off to the show of two females grinding against each other before his very eyes. Then suddenly, a twitch goes through him from muzzle to tail-tip as he gives a breathless pant, just as quite a quite respectable load (for such a little guy) starts to spurt out of his cock, the cum landing in long streaks of white splatter on the shop's smooth wooden floorboards. Your view of the fennec is interrupted just a moment later as Bastet pulls your head to hers with a hand on your chin, letting go of your arms to do so - though with her other hand working more active on your sex than ever before, you're still totally in her power, inside and out. With Bastet going all out on the stroking now, it doesn't take long before the added stimulation finally gets you the rest of the way to a mind-blowing orgasm, trembling and twitching as the lioness holds you tight against the bookcase, with your femcum splashing her hand and dripping on the floor below.";
				say "     As Bastet's grinding soon gets slower and slower, just as ever smaller spurts of cum from Anktepi splat down on the ground, Nermine clears her throat and says, 'Nermine is always happy when her customers enjoy their stay in her store as much as possible, and she is happy to see that their deal has been concluded with a pleasant time for all participants.' Sauntering over towards you and Bastet, the jackaless adds (with a slight tinge of regret audible in her voice - at not getting the best deal there could have been), 'My dear goddess, the high priestess regalia is yours.' The two sexy female's eyes meet for a second, then Bastet leaves you leaning against the shelf to brace yourself and Nermine gives a wave to the chest with her slender hand, stopping the almost imperceptible hum of the magical protection that surrounded it.";
				WaitLineBreak;
				project Figure of Nermine_naked_icon;
				say "     As the cat goddess avatar walks away from you, Nermine on the other hand steps up, gently stroking your body then kissing you on the mouth. As she comes up for air afterwards, the jackaless says, 'Nermine is glad to see her [master] did enjoy [ObjectPro of Player]self with the visitor. Regrettable, that Bastet triumphed in the end, but Nermine is sure she can take care of [ObjectPro of Player] just as well herself. And should [SubjectPro of Player] feel a desire for another lioness nonetheless, there are... options, Nermine could arrange.' Then she proceeds to crouch down in front of you, brushing her full breasts and hard nipples against your naked body as she does so, then starts to lap the femcum from between your legs.";
				say "     Meanwhile, Bastet gives her naked fennec servant a somewhat stern look, freezing him in mid-motion with a commanding hiss as he shyly tries to cover up. Her eyes wander over him, the still half-hard cock in his hand and the long streak of cum on the floor - and a slight smile plays over her lips before she regally says, 'Get my dress.' His paralysis broken, the slender fennec rushes over with Bastet's finely woven garment, then helps her put it back on with trembling fingers, followed by handing her what items lie in Nermine's chest. An armband, then a very large and elaborate necklace, followed by little anklets, a tail-band and then finally a golden tiara are put on by Bastet, each precious artifact bolstering the sense of raw power emanating from the lioness. 'Ah, finally,' the goddess of cats says, then adds with a glance to you and Nermine still licking you, 'Let us leave this lewd place then. Destiny awaits to be forged.' And with that, the lioness walks out of the store, closely followed by her servant.";
				now Libido of Nermine is 100;
				now Resolution of Restaurateur's Office is 5; [Bastet won sex battle]
	now Restaurateur's Office is resolved;

Table of WalkInEvents (continued)
Priority	Name	EventObject	EventConditions	EventRoom	LastEncounterTurn	CoolDownTurns	EncounterPercentage
2	"Bastet_Worshipers_Introduction"	Bastet_Worshipers_Introduction	"[EventConditions_Bastet_Worshipers_Introduction]"	Mysterious Shop	2500	2	100

to say EventConditions_Bastet_Worshipers_Introduction:
	if BastetApproval > 6 and Bastet is in Mysterious Shop and Nermine is in Mysterious Shop: [list of conditions here]
		now CurrentWalkinEvent_ConditionsMet is true;

Table of GameEventIDs (continued)
Object	Name
Bastet_Worshipers_Introduction	"Bastet_Worshipers_Introduction"

Bastet_Worshipers_Introduction is a situation.
ResolveFunction of Bastet_Worshipers_Introduction is "[ResolveEvent Bastet_Worshipers_Introduction]".
Sarea of Bastet_Worshipers_Introduction is "Nowhere". [standard walkins that cannot be hunted for are Nowhere, but walkin events can also be made huntable as an alternate access way]

to say ResolveEvent Bastet_Worshipers_Introduction:
	if debugactive is 1:
		say "     DEBUG: Introduction of Bastet's Worshipers[line break]";
	say "     As you make your way to Nermine's store, you pass some people standing in a tight little group near the entrance, quietly talking with one another. They're a wild mix between all sorts of species, but one thing that sticks out is that they look like they just stepped out of the 'extras' section of a horror movie about a demonic cult. Someone must have raided the storeroom of a Bath & Beyond store to find so many dark-red terrycloth bathrobes. Pulling open the store door and hearing the old-fashioned little bell above it ring, you push the passing encounter to the back of your mind and instead focus on the welcoming sight waiting for you inside: Nermine in all her naked glory, showing off her shapely breasts as well as the curve of her hips as she stands in a striking pose right in the middle of the room. A smirk plays along her muzzle as she says, 'Nermine welcomes her delightful [master], she will be with [ObjectPro of Player] in just a moment.'";
	say "     Finishing her sentence, the jackaless then turns her head and barks out, 'But what is this?! How disappointing - the new store employee placed the urn of Apollo right next to a roman spirit amphora! And there are further mixups of the items- No, no, no - this will not do at all! The jackaless sees that even this simple task was too complex for the uneducated feline. She will have to sort out the shelf herself again.' One or two steps further into the room reveal who she's talking to - Bastet is on the far side of the room, previously out of sight as Nermine shows off, blocking your view of the berated Bastet. The lioness shoots dagger-like stares at Nermine and digs her claws into the wood of a straw-stuffed crate she's holding under one arm. Clearly enjoying any opportunity to lord her status over the other woman, Nermine adds, 'The clumsy kitten should put the box down before she messes up something more. She can go grab another storage crate from the back room instead. Fetching and carrying shouldn't be too hard, no? It'll be somewhere in the far back left corner, with 'Syria, 1862' stamped on the side.'";
	WaitLineBreak;
	say "     Controlling herself to not throw her current crate, but rather setting it down slowly, Bastet bows her head in acknowledgement of the order, accompanied by a close-mouthed growl. Then she stalks off through the back door of the store, her tail whipping back and forth in clear annoyance. Watching her indentured servant go, Nermine licks the sides of her muzzle and then saunters up to you, swinging her hips enticingly. 'It certainly is hard to get good employees in this new millennium. Nermine had hopes that the withered old kitty-cat would have some working spirit in her, but apparently that was too much to hope for.' For being a canine, Nermine sure is a catty bitch herself sometimes. Sidling up to you, the woman presses herself against your arm, her full breasts brushing against your chest as she guides your hand to rest on the warm curve of her furred rump. Following the sexy invitation, you touch and grope your tamed sorceress, fulfilling her eager need to serve.";
	say "     For a little while, you lose yourself in fondling Nermine, cupping her boobs and sharing some sloppy tongue-kisses with the bitch. Yet then, the jackaless pulls back a little from her full-contact embrace, giving you an apologetic look as she glances to the side. 'The humble storekeeper must ask her [master] for a moment of patience please. Pleasures of the flesh are delightful, but there's also business to be conducted.' Following her slight nod towards the store-window, you see that one member of the red-robed group you noticed earlier is making their way towards the store right now. It's an older man of some sort of monkey infection, his wrinkled face shrouded with the wide hood's shadow. The man's arms hold tight to his chest as if in prayer, hands hidden in the wide sleeves. Seeing the serious expression on his face, you can't help but see him and the others in a different light, now giving a little less 'weirdo in bathrobe' vibe, and more 'medieval monk' or something.";
	WaitLineBreak;
	say "     Clicking her tongue, Nermine looks at you and wiggles her eyebrows. 'Cults are such good customers, although they are a hassle. They come in all sorts of flavors... would you believe some just try to strut in and make demands? Such impertinence, but at least it makes restocking cursed living dolls an easy affair.' She smirks after saying that last bit, idly tracing a fingertip over the golden snake jewelry coiling around her left arm. 'This batch clearly isn't so bold. The storekeeper has seen them watching from afar for a little while already, but they've taken until now to dare enter Nermine's presence. Ah, there he is now...' As if on command, the doorbell rings as the robed monkey steps into the small shop. Snapping into her businesswoman persona, Nermine greets him, 'Welcome, dear visitor. This humble jackaless welcomes him to her store. What is his desire? The store holds many an item of exquisite rarity and power.'";
	say "     Momentarily distracted by staring at the stiff, protruding nipples of Nermine's black-furred breasts, and the slightly matted fur around her unabashedly wet pussy, the man hastily snaps his gaze up to her face in embarrassment and stutters, 'I - I greet you, m-mistress Nermine. I... uhm, we... we humbly request to speak to the Lady of the East, the Sacred and All Seeing Eye, our Lady Bast-' With a dismissive snort, Nermine interrupts him, 'Nermine knows of whom you speak, yes. That one is [italic type]serving[roman type] the jackaless, as an employee, and she is busy failing her on-the-job training. This is a business, after all, so the lioness has no time to waste for casual visitors just dropping in to gossip with the help. She messes things up enough on her own! Things might be different for paying customers, though.' Eyes widening at the sharp drop in Nermine's tone as the topic of conversation turned to Bastet, the monkey cringes back a little from the predatory jackal, 'I'm sorry. We're all refugees and... we don't have anything.'";
	WaitLineBreak;
	say "     'Ah, what a pity, but Nermine has found that people usually find something to trade, if they just want something badly enough.' A hint of a smirk ghosts over her muzzle as the sorceress's gaze flicks for a second to a wooden rack in a locked display against the back wall, holding several ancient-looking scrolls. You can make out the handwritten label 'contract, infernal' there. The sorceress isn't as crass as flat out saying that they should sell someone to her, but she's heavily implying it nonetheless. 'The storekeeper knows that her visitor and his friends have plenty to trade in. She'll leave him to think about what that may be, and to make that decision.' Giving the monkey a toothy grin, she starts to shoo him out of the store. Desperate to complete his mission, the monkey stutters, 'I - I... please, could you tell her that we believe in her? We've built a shrine, three stores down from Brookstone books, in the east wing!'";
	say "     'The jackaless will try to remember that,' Nermine replies, her voice dripping with disdain, all but showing that she has no intention of letting Bastet out to visit, or even telling her. After closing the entrance door with a surprisingly cheery ring of the bell, Nermine tells you, 'He'll be back,' with an edge of anticipation in her voice, 'Now, where were the jackaless and her [master]?' Starting to saunter over to get back to grinding herself against your side, you're interrupted by Bastet coming in from the back room, carrying a heavy crate overflowing with priceless artifacts. Still angry, she sets it down on the ground with a thunk. This brings the jackaless to her side posthaste, to explain the proper way of handling precious goods. You're left standing alone, to decide what you want to do next. You could just get back to enjoying some time with Nermine. [bold type]It might be a nice idea to let Bastet know of her worshippers. Or you could take her to see them. Maybe you should talk to her about it. [roman type][line break]";
	TraitGain "Worshippers Introduced" for Bastet;
	now Bastet_Worshipers_Introduction is resolved;

a postimport rule:
	if "Worshippers Visited" is not listed in Traits of Bastet:
		now Sterile of Bastet is true;

Section 2 - NPC Declaration

Table of GameCharacterIDs (continued)
object	name
Bastet	"Bastet"

Bastet is a woman.
ScaleValue of Bastet is 3. [human sized]
Cock Count of Bastet is 0.
Cock Length of Bastet is 9.
Ball Size of Bastet is 2.
Ball Count of Bastet is 0.
Cunt Count of Bastet is 1.
Cunt Depth of Bastet is 9.
Cunt Tightness of Bastet is 3.
Nipple Count of Bastet is 2. [2 nipples]
Breast Size of Bastet is 3.
[Basic Interaction states as of game start]
PlayerMet of Bastet is false.
PlayerRomanced of Bastet is false.
PlayerFriended of Bastet is false.
PlayerControlled of Bastet is false.
PlayerFucked of Bastet is false.
OralVirgin of Bastet is false.
Virgin of Bastet is false.
AnalVirgin of Bastet is true.
PenileVirgin of Bastet is true.
SexuallyExperienced of Bastet is true.
Sterile of Bastet is true.
Description of Bastet is "[BastetDesc]".
Conversation of Bastet is { "Mew!" }.
ImpregFunction of Bastet is "[impregBastetChance]".

instead of sniffing Bastet:
	say "     Bastet has an interesting, spicy scent in her fur that speaks of ancient mysteries and the potential of great power.";

to say BastetDesc:
	if debugactive is 1:
		say "DEBUG -> HP: [HP of Bastet] <- DEBUG[line break]";
	if BastetApproval > 3:
		project Figure of Bastet_smile_dress_seethrough_icon;
	else:
		project Figure of Bastet_neutral_dress_seethrough_icon;
	say "     The goddess Bastet's avatar is currently a beautiful anthro lioness, young and lightly muscled. She stands tall on her digitigrade legs and slender paws, looking at her surroundings with regal composure. Currently, the attractive female is dressed in a kalasiris, a tube dress of ancient Egyptian design, starting just below her armpits and hugging every curve of Bastet's body until it stops just below her knees. In addition to being quite spectacularly tight, the dress also is woven in a striped pattern out of very fine, in places almost transparent, fabric, giving enticing glimpses at her body below.";
	say "     Since having lost to you in a quite enjoyable sexual contest, the lioness is duty-bound to repay her debt to Nermine, and the cunning storekeeper seems to have decided that means doing guard duty at the store. Now Bastet spends pretty much all of her day here, watching out for people to make trouble. With you in your position as Nermine's [master], this offers interesting opportunities to get to know the cat goddess better - or just to make use of her.";
	if ImpregTimer of Bastet > 0:
		say "     [bold type][if ImpregTimer of Bastet > 12]Her belly bulges hugely, showing the life-giving baby bump of a pregnant woman. Most likely she'll give birth in the next day or two. [else if ImpregTimer of Bastet > 0]Her belly shows a slight curve, allowing you to guess that she's gotten pregnant recently. Sometime in the next few days, there'll be one more little lion cub born. [end if][roman type][line break]";
	if OffspringCount of Bastet is 1:
		say "     From time to time, one of the red-robed followers of Bastet comes to visit the store, accompanied by a strapping young lion, Bastet's firstborn son Apedemak. They're not welcome in the store itself, but they always wave to the lioness when she sees them, before moving on. This brings a smile to the young woman's face, and also prompts hateful glares directed to Nermine, who keeps her from spending more time with her family and worshipers.";
	else if OffspringCount of Bastet > 1:
		say "     From time to time, one of the red-robed followers of Bastet comes to visit the store, accompanied by one or another of Bastet's offspring. They're not welcome in the store itself, but they always wave to the lioness when she sees them, before moving on. This brings a smile to the young woman's face, and also prompts hateful glares directed to Nermine, who keeps her from spending more time with her family and worshipers.";

To say impregBastetChance:
	if debugactive is 1:
		say "     DEBUG: Impregnation chance for Bastet, base chance 40%, ";
		if "Fertility Treatments" is listed in Traits of Bastet:
			say "'Fertility Treatment' bonus 20%, ";
		say "Father: [LastSexualPartner of Bastet]";
	let BastetPregChance be 4; [40% base chance]
	if "Fertility Treatments" is listed in Traits of Bastet:
		increase BastetPregChance by 2; [20% extra chance]
	if a random chance of BastetPregChance in 10 succeeds:
		if debugactive is 1:
			say "     DEBUG: Impregnation successful! A lion cub is growing in Bastet now!";
		now ImpregTimer of Bastet is 1; [starts the pregnancy timer]
	else:
		if debugactive is 1:
			say "     DEBUG: Impregnation fail! A chance of [BastetPregChance] in 10 didn't succeed.";

an everyturn rule:
	if ImpregTimer of Bastet > 0: [Bastet is pregnant]
		increase ImpregTimer of Bastet by 1; [counting up towards 24]
		if debugactive is 1:
			say "     DEBUG: Bastet's pregnancy advanced one turn. Current Turn: [ImpregTimer of Bastet], Target Value: 24";
		if ImpregTimer of Bastet is 20 and skipturnblocker is 0: [announcement that birthing time is coming closer]
			if Bastet is visible:
				say "     There's a little gasp from Bastet, with her bringing a hand up to her belly and resting it on the rounded curve. 'I felt a kick. Our little one doesn't seem to want to wait much longer,' she tells you with a smile, waving you closer to have a feel yourself. [bold type]If you want to be present for the birth of Bastet's child, you should most likely stay close to her in the next 12 hours or so.[roman type][line break]";
			else:
				say "     Your thoughts wander back to Bastet, and you feel a need to go check in on her. [bold type]If you want to be present for the birth of her child, you should most likely stay close to her for the next 12 hours or so.[roman type][line break]";
		else if ImpregTimer of Bastet >= 24 and skipturnblocker is 0: [birthing time]
			if Bastet is not visible: [player isn't anywhere near her]
				say "     [bold type]Your thoughts wander back to Bastet, and you feel a need to go check in on her.[roman type][line break]";
				add "Absent_Birth" to Traits of Bastet; [memory of the birth of lion offspring without the player present]
			else: [player is next to Bastet]
				say "     From one moment to the next, the expression on Bastet's face changes, and she gasps out, 'It's time! My water just broke!' The sheer fabric of her dress does little to hide the traces of wetness matting the fur of her inner thighs. Giving the lioness an unimpressed glance, Nermine waves a hand towards the door. 'The breeding bitch can have a few hours off, to take care of her business. All Nermine needs is her making a mess of the store, so she insists the lioness leave. Now!' Clearly, there's still no love at all lost between the two of them. ";
				if OffspringCount of Bastet is 0: [first time]
					say "Panting and unaccustomed to the new sensations rippling through her body, Bastet lets you guide her towards the door, then out into the thronging crowds of the inner mall corridors. ";
				else if OffspringCount of Bastet > 4:
					say "The young man looks confident and proud, ready to bring another life into this world. But even so, Bastet seems very thankful and happy as you sit on the ground right next to him, laying your arms around his body to be there for him. ";
				else if OffspringCount of Bastet > 4:
					say "Starting to get used to the process, the young man is much calmer than the first time, no doubt from knowing what to expect. But even so, But even so, Bastet seems very thankful and happy as you sit on the ground right next to him, laying your arms around his body to be there for him. ";
				say "Before you're more than a few steps outside, you find yourself suddenly escorted by a trio of Bastet's red-robed worshipers, who apparently were part of an around-the-clock watch team standing ready for just this occurrence. Two of them do their best to clear the way ahead, while the third also helps Bastet along, and your group makes excellent time for getting to the lion goddess's shrine.";
				say "     The shine shows the wild activity of an alerted anthill, with worshipers rushing this way and that, gathering what's needed, staring wide-eyed at their goddess's extreme state of pregnancy, or kneeling in fervent prayer. The store backroom that forms the inner sanctum has been hastily converted into a birthing room, with stacks of clean towels, bowls of water and all sorts of other needful things laid ready. The most qualified among Bastet's followers stand ready to give what assistance the can, while greatly respecting you and making sure you have a spot by Bastet's side to hold her hand as things progress. This might be a little perilous, given that she's got sharp claws and is being rocked by strong contractions, but you brave some light punctures to be there fore her.";
				WaitLineBreak;
				say "     While pregnancy and birth may be a lot quicker these days, it doesn't look like they are all that much easier than before. The curve of your pregnant lioness's belly heaves with another contraction, followed by a breathless groan from her, and you can see her nether lips part further and further in preparation for what is to come. You hold her hand tight while a worshiper kneels between her legs, a thick, soft towel stretching between his hands. Then the next contraction hits, this time bringing with it the small shape of a curled-up anthro lion, matted and wet with amniotic fluid. In a bustle of activity, the umbilical cord is tied and cut, with the little one carefully being dabbed with warm water and dried. Before long, they're handed over into Bastet's arms, who brings the newborn up to her breasts.";
				say "     Carefully touching the bundle of joy to take part of the moment, you gently stroke their fur as Bastet cradles her child against her chest. Bastet smiles in fulfillment as the youngling's lips clamp onto her nipple and start to suckle greedily. Even as worn out as she is, the lioness can't help but smile as she feeds her child. As the newborn gulps down what they can drink from the happy mother, they grows noticeably larger with each passing second. Tiny as they may have been, they're in a rush to catch up now, growing so fast that the size of a human baby or toddler are simply skipped, reaching the stage of a young child in the blink of an eye. Then the burst of development slows down a little, still insanely fast but at least slow enough to watch some details of.";
				WaitLineBreak;
				say "     Bones grow and lengthen, muscles fill in, and before you know, the young lion has reached their teens. In mere moments, they rush through all of puberty, ";
				if OffspringCount of Bastet is 0: [first time always male]
					say "complete with sprouting what looks to be the start of a proud mane. ";
				else: [random pick for later gender]
					if a random chance of 1 in 2 succeeds:
						say "complete with sprouting what looks to be the start of a proud mane. ";
					else:
						say "retaining the absence of a mane and growing noticable breasts before much longer. ";
				say "It doesn't take long before the growth stabilizes at a level of development that makes your child look almost as old as Bastet! If you didn't know any better, having just watched the birth from start to finish, you'd just as likely have guessed that this new lion was Bastet's sibling. Still, there are some signs that this is a still very young lion at heart, as the newcomer almost stays comfortably curled in against Bastet's breast until they had their fill of nourishing milk. Bastet indulges her child for a long while, before she starts to talk to them and you, introducing you to your offspring, then eventually including the present worshipers as well.";
				say "     The birth of the new lion is a joyful occasion in the community of Bastet's worshipers, with many being star-struck by the persence of their goddess, her consort and her child. The next few hours are filled with an enthusiastic celebration of the birth, until the lioness regretfully has to return to her term of indentured servitude under Nermine. The worshipers swear to take the very best care of Bastet's child (and promise not to spoil them rotten), before a small delegation escorts you and your lioness back to Nermine's store.";
			increase OffspringCount of Bastet by 1; [one more lion birthed]
			now ImpregTimer of Bastet is 0; [pregnancy reset]


instead of conversing the Bastet:
	now BastetSexOrTalk is false; [approval message in her talk menu]
	say "[BastetApprovalMessage]";
	say "[BastetTalkMenu]";

to say BastetLustyEyes:
	if BastetSexOrTalk is true: [the affection message was called up by the sex menu]
		say " with the now-familiar glimmer of lust in your eyes";

to say BastetApprovalMessage:
	if BastetApproval < -6:
		say "     Seeing you approach[BastetLustyEyes], Bastet's tail twitches and jerks through the air behind her. The lioness glances at you and one sleek paw-hand automatically wanders down to her crotch, rubbing her pubic mound through her dress. Then she says, 'Back for more... [master]? Want to use me as your slut and whore again?!' There still is that little pause before she acknowledges your power over her fate, but otherwise the divinely infused lioness has accepted that you have the right to take her whenever you want. Lust and arousal are clearly audible in the rumbling purr of her voice, and she arches her back a little to present those shapely breasts of hers, barely hidden by her mostly sheer dress!";
	else if BastetApproval < -3: [annoyed, but aroused]
		say "     Seeing you approach[BastetLustyEyes], Bastet's tail twitches and jerks through the air behind her and the lioness hisses out between her sharp teeth. 'What is it this time? Back to use me as a common whore? Make me a slave to your depraved lusts?!' Like before, her words are dripping with the trapped goddess's anger - but at the same time, you manage to detect something that puts a self-satisfied smile on your lips. There is an undertone of arousal in her rich lioness voice! With all that you've done to her already, she can't help but be turned on. Even as she stands before you with crossed arms and a scornful expression on her face, you're certain that Bastet's pussy is getting wet!";
	else if BastetApproval < 0: [annoyed]
		say "     Seeing you approach[BastetLustyEyes], Bastet's tail twitches and jerks through the air behind her and the lioness hisses out between her sharp teeth. 'What is it this time? Back to use me as a common whore?' Hostility drips of her words as she stands before you with crossed arms. You can see the claws on her paw-hands slide into sight a little before she forces herself to relax them again. Bastet knows she is bound by her deal and unable to escape it, despite how much this grinds against her pride. Such a delicious situation - you can't help but smile a little as you step up to her.";
	else if BastetApproval is 0: [neutral starting stance]
		say "     Seeing you approach[BastetLustyEyes], Bastet's tail does tiny twitches left and right. She watches you through slightly slitted lids, a suspicious expression on her face. 'What do you want?' Her piercing gaze spears into you as the lioness waits for you to speak. The fingers of her paw-hands twitch a little bit, as if she is unsure whether to extend her claws or not. Trapped by her deal, the bound goddess knows she can't escape and chafes against that, but she is apparently still undecided if she should direct her anger mainly at Nermine or yourself as well.";
		say "     [bold type]You should pick wisely just how you want to treat her. With a bit of work, you could surely break Bastet in to be a sex-pet like Nermine herself - or you might treat her well, and end up at a whole different outcome... your choice![roman type][line break]";
	else if BastetApproval < 4: [somewhat pleased lioness]
		say "     Seeing you approach[BastetLustyEyes], Bastet's tail-tip twitches lightly. She watches you through slightly slitted lids, but there is a tiny hint of a smile on her lips for a second before she calms her expression. 'What do you want?' she asks, the low purr underlying her voice telling you that she has a very good guess. Her arms are still crossed over her chest, but you can see the fingers of her sleek paw-hand tapping what seems a playful rhythm on her arm. Apparently, your previous treatment of the trapped goddess put you on - well, not her good side... but at least a different category than Nermine, whom she truly despises for orchestrating her entrapment.";
	else if BastetApproval < 7: [opening up to the player]
		say "     Seeing you approach[BastetLustyEyes], Bastet's tail-tip twitches lightly. She watches you with an intense gaze, a slight smile spreading over her lips for a second before she calms her expression. 'Come to keep me a bit of company in this dreary, menial task of standing guard? Or is it something else you want?' she asks, the low purr underlying her voice telling you that she has a very good guess what that might be. Currently, she has a far more open stance to your presence than in your first meetings here, no longer crossing her arms in front of that well-rounded set of breasts on her chest. This allows you a glorious view of her body, with barely anything hidden by the mostly sheer dress Bastet is wearing. You can see the fingers of her sleek paw-hand tapping what seems a playful rhythm against the side of her hip.";
	else if BastetApproval > 6: [befriended]
		say "     Seeing you approach[BastetLustyEyes], Bastet's tail-tip twitches lightly. She watches you with a smile spreading over her lips, then calms her expression and says, 'Welcome back. Come to keep me a bit of company in this dreary, menial task of standing guard? Or is it something else you want?' The deep purr underlying her voice tells you that she has a very good guess what that might be. With all that has happened between you since Nermine trapped her in the deal, Bastet sees you as a friend and companion these days. Her affection has grown despite your own role in the affair and the fact that you are the actual [master] of her despised adversary. Seeing her stand there, striking a little bit of a pose and smiling, you take in the glorious view of her body - with barely anything hidden by the mostly sheer dress the lioness is wearing. Oh yeah... treating Bastet decently has [italic type]definitely[roman type] paid off!";

to say BastetTalkMenu:
	let TalkDone be false;
	say "     [bold type]What do you want to talk about with Bastet?[roman type][line break]";
	if BastetApproval > 3:
		project Figure of Bastet_smile_dress_seethrough_icon;
	else:
		project Figure of Bastet_neutral_dress_seethrough_icon;
	now sextablerun is 0;
	blank out the whole of table of fucking options;
	[]
	choose a blank row in table of fucking options;
	now title entry is "Learn about her history";
	now sortorder entry is 1;
	now description entry is "Ask the lioness about herself";
	[]
	choose a blank row in table of fucking options;
	now title entry is "Talk about sex";
	now sortorder entry is 2;
	now description entry is "Talk to the lioness about sex";
	[]
	choose a blank row in table of fucking options;
	now title entry is "Take her out to get some food together";
	now sortorder entry is 3;
	now description entry is "Have food in the food court together";
	[]
	if "Worshippers Introduced" is listed in Traits of Bastet:
		choose a blank row in table of fucking options;
		now title entry is "Take her out to visit the shrine of her worshipers";
		now sortorder entry is 4;
		now description entry is "Have a trip with Bastet";
	[]
	sort the table of fucking options in sortorder order;
	repeat with y running from 1 to number of filled rows in table of fucking options:
		choose row y from the table of fucking options;
		say "[link][y] - [title entry][as][y][end link][line break]";
	say "[link]0 - Nevermind[as]0[end link][line break]";
	while sextablerun is 0:
		say "Pick the corresponding number> [run paragraph on]";
		get a number;
		if calcnumber > 0 and calcnumber <= the number of filled rows in table of fucking options:
			now current menu selection is calcnumber;
			choose row calcnumber in table of fucking options;
			let nam be title entry;
			now sextablerun is 1;
			if nam is "Learn about her history":
				say "[BastetTalk1]";
			else if nam is "Talk about sex":
				say "[BastetTalk2]";
			else if nam is "Take her out to get some food together":
				say "[BastetTalk3]";
			else if nam is "Take her out to visit the shrine of her worshipers":
				say "[BastetTalk4]";
				now TalkDone is true;
			if TalkDone is false:
				say "[BastetTalkMenu]";
			else:
				wait for any key;
		else if calcnumber is 0:
			now sextablerun is 1;
			say "     You step back from the lioness, shaking your head slightly as she gives a questioning look.";
			wait for any key;
		else:
			say "Invalid Option. Pick between 1 and [the number of filled rows in the table of fucking options].";
	clear the screen and hyperlink list;

[
Can you add basic conversation nodes about Anktepi, Nermine and the player. I'd like each to become quite large depending on states but just existing will be good for now.
Oh, and Bastet herself.
]

to say BastetTalk1: [talk about her background]
	say "     Asking the anthro lioness to tell you more about herself, she proudly raises her head and glances at you with a haughty expression. 'Anktepi explained that to me that the people of this time are like confused children, wasting their minds on odd daydreams and endless frivolous games, while at the same time having being ignorant to much of what was common knowledge for thousands of years.' She lets out a huff and shakes her head, not allowing for a chance to respond before she continues. 'With my faithful being few and far between in this fallen world, I shall ignore the insult of you people's ignorance and educate you about who you're really talking to! Know that it is the daughter if Isis and Ra standing before you, incarnated into this world in the shape of my first form, as befitting this vile, violent, primitive world!' Aiming to underline her point, Bastet smiles broadly, exposing the predatory teeth of her lioness form, and she raises a hand to curl her fingers demonstratively, showing off the fact that even with human-like appendages, her fingernails are sharp and dangerous.";
	say "     'In the early days of the world, I would ride through the sky with my father, watching the world pass beneath as his boat pulled the sun along its path. Then as the night came, he would rest, and I would protect him, finding and destroying what creeped in the dark, like the vile serpent Apep and his lesser spawn! I was the lioness of the Lower Kingdom, goddess of the rising sun!' As she says this, the proud woman focuses her intense gaze upon you, and you the slits of her golden eyes narrow, with them almost glowing from within. You can't help but feel some of the awe that early humans must have experienced in those days long past, living in a time when sundown reduced people to little but helpless prey to many predators that ruled the night. 'But nothing is forever, and attempts to stay unchanging lead to decay, so change I did, over time, as did the people of the two kingdoms...'";
	WaitLineBreak;
	say "     Bastet gives you a smile, without showing teeth this time, making it a far more comforting expression to be shown. 'As is proper, they worshiped us, and learned to align their goals with the divine will, serving to oppose the crawling and slithering creatures of the dark. My own intervention was less needful after that point, and I became... different.' Wanting to make a point, the proud woman lowers both hands to rest on her tummy, then strokes her fingers over the thin, semitransparent fabric of her kalasiris to reach her breasts, cupping them and lightly teasing her nipples. 'More of a mother, by that point, I watched over the future sons and daughters of Egypt, now protecting them against what men were incapable of fighting, like evil spirits and the horrors of disease.' Reaching out to stroke a fingertip along your jawline, she adds, 'In Bubastis, at its height, those like you didn't have to fear getting sick, or losing their little ones...'";
	say "     Taking a deep breath, then blowing it out as she seems momentarily lost in memory, Bastet then snaps out of it, her tail flicking unruly left and right behind her back. 'Now... I am a little of both. Mostly a lioness, given that this world needs taming, but also some of my softer aspect, as the new kingdom to come will need a strong people to grow.' One of her hands comes to rest on her tummy again, lightly stroking it as if in a daydream of what might come soon. With her tale of the past now having made an arc to the present again, the lioness focuses her intense gaze on your face and raises an eyebrow. 'So tell me, did you learn something, or was this all just wasted breath?'";
	LineBreak;
	say "     [bold type]What do you respond?[roman type][line break]";
	LineBreak;
	let Bastet_Mythology_Choices be a list of text;
	add "Thank her for the tale, and say that you're honored to be talking to a true goddess." to Bastet_Mythology_Choices;
	if Player is male:
		add "Grip your cock and say that you could sure help out to populate that new kingdom..." to Bastet_Mythology_Choices;
	add "Yawn and say that you expected more epic battles and steamy sex scenes. It was kinda boring..." to Bastet_Mythology_Choices;
	let Bastet_Mythology_Choice be what the player chooses from Bastet_Mythology_Choices;
	if Bastet_Mythology_Choice is:
		-- "Thank her for the tale, and say that you're honored to be talking to a true goddess.":
			say "     'Good to hear that you're not a totally lost cause, even though you are associated with... her, and were instrumental in entrapping me.' The cat goddess nods to you, then adds, 'Appropriate respect should be given, even if one is in unfortunate circumstances.' Her [bold type]approval[roman type] of yourself has [bold type]risen a little[roman type].";
			project Figure of Bastet_smile_dress_seethrough_icon;
			increase BastetApproval by 1;
		-- "Grip your cock and say that you could sure help out to populate that new kingdom...":
			say "     As you grip your crotch and make the offer, giving Bastet a lewd wink, she ";
			if BastetApproval < -6:
				say "lets out a derisive hiss. 'Even though I am bound to serve, for now, and cannot stop you from attempting to pollute this body with your foul seed, your desire is in vain. The machinations of the sorceress go only so far, and it is well within my power to reject any such vile offspring you might father from my womb.' Her [bold type]approval[roman type] of yourself has [bold type]further decreased[roman type].";
				project Figure of Bastet_neutral_dress_seethrough_icon;
				decrease BastetApproval	by 1;
			else if BastetApproval < -3: [annoyed, but aroused]
				say "lets out a derisive hiss. 'Even though I am bound to serve, for now, a lewd beast like yourself is just not worthy of this gift. The machinations of the sorceress go only so far, and it is well within my power to reject any inferior offspring you might father from my womb.' Her [bold type]approval[roman type] of yourself has [bold type]further decreased[roman type].";
				project Figure of Bastet_neutral_dress_seethrough_icon;
				decrease BastetApproval	by 1;
			else if BastetApproval < 2: [annoyed]
				say "lets out a derisive huff. 'Even though I am bound to serve, for now, a lewd beast like yourself is just not worthy of this gift. The machinations of the sorceress go only so far, and it is well within my power to reject any inferior offspring you might father from my womb.' Her [bold type]approval[roman type] of yourself has [bold type]further decreased[roman type].";
				project Figure of Bastet_neutral_dress_seethrough_icon;
				decrease BastetApproval	by 1;
			else if BastetApproval < 4: [somewhat pleased lioness]
				say "lets out a chuckle and puts on a challenging expression. 'And you think you're worthy of this priceless gift? The dynasty of the new kingdom must be strong and pure! While you're not... hopelessly inferior, you're still an associate of the sorceress that entrapped me! Her machinations go only so far, and it is well within my power to reject any inferior offspring you might father from my womb. Things might be different, if you proved yourself...' Her [bold type]approval[roman type] of yourself has [bold type]risen a little[roman type].";
				project Figure of Bastet_smile_dress_seethrough_icon;
				increase BastetApproval by 1;
			else if BastetApproval < 7: [opening up to the player]
				say "lets out a chuckle and puts on a challenging expression. 'And you think you're worthy of this priceless gift? The dynasty of the new kingdom must be strong and pure! While you do have some... slightly admirable qualities, you're still an associate of the sorceress that entrapped me! Her machinations go only so far, and it is well within my power to reject any inferior offspring you might father from my womb. Things might be different, if you proved your character further...' Her [bold type]approval[roman type] of yourself has [bold type]risen a little[roman type].";
				project Figure of Bastet_smile_dress_seethrough_icon;
				increase BastetApproval by 1;
			else if BastetApproval > 6: [befriended]
				say "puts on a slight smile, then throws you a challenging look. 'And you think you're worthy of this priceless gift? The dynasty of the new kingdom must be strong and pure! While you do have some... admirable qualities, you're still an associate of the sorceress that entrapped me! Her machinations go only so far, and it is well within my power to reject any offspring I choose not to harbor in my womb.' While still being a rejection, you can't help but see a gleam of possibility shine in her golden eyes. You got Bastet thinking about having a child with her, though it'd likely take some significant step for her to allow you to knock her up. But for sure, her [bold type]approval[roman type] of yourself has [bold type]risen a little[roman type].";
				project Figure of Bastet_smile_dress_seethrough_icon;
				increase BastetApproval by 1;
		-- "Yawn and say that you expected more epic battles and steamy sex scenes. It was kinda boring...":
			say "     Rolling her eyes and letting out an annoyed hiss, Bastet murmurs something to herself and stalks off to the other side of the store. You catch the words, 'Imbecile' and 'Barbarian', but not much else. Her [bold type]approval[roman type] of yourself has [bold type] decreased[roman type].";
			project Figure of Bastet_neutral_dress_seethrough_icon;
			decrease BastetApproval	by 1;

to say BastetTalk2: [talk about sex]
	say "     As you bring up the topic of sex, Bastet raises one eyebrow and puts on a somewhat haughty air. 'Anktepi told me about the... barbaric cults that came after the Two Lands were conquered by the invaders. That they raised man above all and often treated women as nothing more but chattel, to be traded off and serve at his pleasure. And more recent, how women themselves abandoned much sensuality to become more like men and gain power.' Disdain is dripping from her voice as she recounts somewhat skewed impressions she gained of modern things - like pant-suits ('masculine disguises'), the ban of breast-feeding in public, as well as the widespread prejudice against same-sex couplings. 'If this vile culture didn't already fall with the rise of these 'nanites' of the new world, I would have broken it myself. What pitiful cripples your people made of themselves, denying women the obvious power their gender embodies.'";
	say "     That said, Bastet strokes her hands down along the sides of her partially see-through dress, sensually following every curve and drawing your gaze to follow them. As she reaches her breasts and cups them with both hands, the lioness gives a purred chuckle and nods to her priest Anktepi - standing close by and giving her looks of bottomless adoration and desire. 'That is the power of women - and goddesses,' she says with a teeth-filled smile as the fennec comes up to her, has his cheek stroked and is then waved away.";
	LineBreak;
	say "     [bold type]Do you reply to this?[roman type][line break]";
	say "     [link](1)[as]1[end link] - Tell her you agree. She is right about her views.";
	say "     [link](2)[as]2[end link] - Mock her as a cock-tease and slut.";
	say "     [link](3)[as]3[end link] - Nope. You don't.";
	now calcnumber is 0;
	while calcnumber < 1 or calcnumber > 3:
		say "Choice? (1-3)>[run paragraph on]";
		get a number;
		if calcnumber is 1 or calcnumber is 2 or calcnumber is 3:
			break;
		else:
			say "Invalid choice. Type [link]1[end link] to agree, [link]2[end link] to mock her or [link]3[end link] to stay silent.";
	if calcnumber is 1:
		LineBreak;
		say "     You wholeheartedly agree with her views, telling the sexy lioness that she should own her sensual power and use it. The cat goddess purrs for a short moment at the confirmation of what she implicitly believes and thinks of herself. Her [bold type]approval[roman type] of yourself has [bold type]risen a little[roman type].";
		project Figure of Bastet_smile_dress_seethrough_icon;
		increase BastetApproval	by 1;
	else if calcnumber is 2:
		LineBreak;
		say "     You laugh about the haughty way she shows to her one and only worshiper, then tell the lioness in no uncertain terms that the only power she has right now is as a cock-tease. And stringing men along to serve her for sexual gratification just means she's a slut. The lioness gives a little growl at these words, then chokes it down and refrains from giving a nasty reply. Still, you can tell that she is furious, seeing your comment as a direct attack on her way of life.";
		say "     [bold type]Bastet's approval of yourself has decreased.[roman type][line break]";
		project Figure of Bastet_neutral_dress_seethrough_icon;
		decrease BastetApproval	by 1;
	else:
		LineBreak;
		say "     You keep silent, letting her words stand as they were said. Bastet takes this as assent, smiling a little as she continues to believe that she is right about everything. Her [bold type]approval[roman type] of yourself has [bold type]risen a little[roman type].";
		project Figure of Bastet_smile_dress_seethrough_icon;
		increase BastetApproval	by 1;

to say BastetTalk3: [take her out for food]
	say "     After spending a moment of letting your gaze wander up and down over her form, appreciating the semitransparent nature of her kalasiris, you step up to Bastet and proclaim that you want to take her out to get some food together. The lioness looks back at you, raising an eyebrow at the sudden offer, then lets out a little snort through her nose, happy enough to get out of her role as 'guard' (or rather eye-candy for the customers) of Nermine's store. Inclining her head in a shallow nod, she replies, 'Fine, I will accompany you.' Then she [if BastetApproval > 3]slips her arm under the offered crook of your elbow [else if BastetApproval < -6]slaps away your offered hand [else]resolutely ignores your offered hand [end if]and the two of you set out through the bustling hallway of the Smith Haven Mall. The large crowd of countless humans, hybrids and transformed of all shapes and sizes that flocked to the mall to seek shelter makes your progress rather slow.";
	say "     More than once, someone bumps into your feline companion and then becomes the recipient of an indignant stare from Bastet, with most of the interlopers having the good sense to apologize and hurriedly stepping out of the way. The incarnate goddess is less than amused by having to content with such mundane matters and a lack of automatic deference, putting her in a bit of a sour mood. 'In the days of the second kingdom, everyone would have stood back, bowing their heads to show they were almost unworthy to even look at my mere presence. How did this world decay so much, leaving it in this sorry state?' the lioness comments grumpily, then shrugs her shoulders. 'But then, there is an opportunity here. With your vile civilization falling, these lost refugees are ready to be shown the right way. Once I get free of the... bondage debt your sorceress has trapped me in, I will choose disciples to create a new, proper kingdom!'";
	WaitLineBreak;
	say "     Before much longer, you arrive in the food court, where things open up a bit more, reducing the squeeze around your little party. Standing in the open concourse, Bastet glances around and studies the signage of various fast food chains and local restaurants, visibly unimpressed. 'I supposed it is too much to hope for some proper sustenance? Figs and dates, meat-filled vine leaves, or the like?' Shaking your head, you steer the young woman in the direction of a chicken-focused chain, reasoning to yourself that it should hopefully appeal to the carnivore side of Bastet's tastes. There's a line in front of the ordering counter, which the attractive female is completely oblivious to until you point out that she'll have to wait. 'Are you serious?!' she huffs, her tail flicking in annoyance, but she does as you indicate and steps up to the end of the line.";
	say "     The slight commotion draws the attention of the person ahead of the two of you, [one of]a slender and quite tall twink of a giraffe, who bends his long neck [or]a fairly burly rhinoceros, who half-turns his body [or]a teal-colored goo person who fluidly turns his head [or]a somewhat scrawny-looking male husky, who turns his head [at random]around to get a quick look at Bastet. His bright green eyes widen at the sight of her noble appearance, the golden jewelry she's wearing, and of course her sexy body, with his gaze being inevitably drawn to the curves of her breasts visible through the partially transparent dress the lioness is wearing. His Adam's apple bobs as he swallows, realizing that he's staring, and Bastet directs her own attention at him...";
	LineBreak;
	say "     [bold type]This could be an opportunity...[roman type][line break]";
	LineBreak;
	let Bastet_Foodcourt_Line_Choices be a list of text;
	add "Nah, just stand back and let Bastet give the guy a tongue-lashing." to Bastet_Foodcourt_Line_Choices;
	add "Properly introduce Bastet as a goddess. He seems impressed enough of her for it to work." to Bastet_Foodcourt_Line_Choices;
	add "Pull down the top of Bastet's dress to show off those breasts." to Bastet_Foodcourt_Line_Choices;
	let Bastet_Foodcourt_Line_Choice be what the player chooses from Bastet_Foodcourt_Line_Choices;
	if Bastet_Foodcourt_Line_Choice is:
		-- "Nah, just stand back and let Bastet give the guy a tongue-lashing.":
			LineBreak;
			say "     With the proud lioness already in a bit of a mood, she bares her fangs and lets out a little bit of a growl at being gaped at, followed by angry words that you're unable to understand, with her apparently falling back into old Egyptian as she curses him out. The guy in front of you shrinks back from her, bumping the next person, who clears his throat in annoyance. At this point, the tongue-lashed man decides that he's got somewhere else to be, stepping out of line to gain some distance to the lioness. He hurries off, then joins a different line at the other end of the food court. 'Uncultured barbarian,' the lioness grumbles, switching back to English now. 'I do hope this indignity of 'standing in line' is worth what the local cooks can serve up,' she tells you with a raised eyebrow.";
			say "     Thankfully, the rest of Bastet's food court experience is pleasant enough, as the lines moves quickly, with the experienced fast food personnel of mall rats filling each order in quick succession. The appearance of a hungry lioness on the other side of the ordering station puts a little fright in the cashier as well, with him quickly passing on the order you put in, to be fulfilled on the double. Bastet lets out a little predatory chuckle as you say that the food should be charged to Nermine's store. 'At least it will be a some payback to that woman if she has to pay for our food. I do hope it will be expensive,' Bastet comments, well and truly out of the loop for how little food costs in the modern world. The two of you claim a nearby table, where the lioness starts to demolish the large box of crispy chicken wings you got for her, complete with a little cup of spicy barbecue sauce.";
			WaitLineBreak;
			say "     Somehow, Bastet manages the impossible combination of savagely tearing into the meat with fangs and predatory teeth, while at the same time keeping a pristine and noble appearance, with not a drop of sauce ending up on her fur or dress. The multi-faceted nature of this avatar, embodying a savage lioness, proud woman and neat cat all rolled into one is fascinating to watch, almost making you forget your own food and drink at first, but quickly catch up before it gets cold, having your fill of tasty fast food.";
			PlayerEat 30;
			PlayerDrink 20;
			say "     'I think,' Bastet begins, placing the last neatly gnawed chicken bone on her plate, 'that there might be [italic type]some[roman type] parts of your culture that might be worth preserving. I will have to send Anktepi into the kitchens here to tell the cooks that they'll have the honor of being part of the new kingdom. Once I am free again, of course.' The last sentence is casually added in a firm tone, as if there is no doubt at all that Bastet will be free of Nermine's entrapping debt sooner rather than later. You wisely don't comment, just inclining your head to acknowledge the lioness's words, and tell her that you're glad she liked the food. 'Some annoyances aside, it was a pleasant and filling meal. At least one positive aspect, if I have to waste my time paying off the debt your whore of a bitch entrapped me with.' Well-fed as she is right now, it seems like Bastet's heart isn't in doing more than a little bit of griping at the moment, so she's fairly pleasant to be with as you make your way back to the store afterwards. Her [bold type]approval[roman type] of yourself has [bold type]risen a little[roman type].";
			project Figure of Bastet_smile_dress_seethrough_icon;
			increase BastetApproval by 1;
		-- "Properly introduce Bastet as a goddess. He seems impressed enough of her for it to work.":
			LineBreak;
			say "     Before the proud lioness can start to unload her annoyance on the man, you quickly step in to properly introduce her, laying it on strong by harping on about her divinity and the fact that Bastet has returned to this world in its time of need. If the man was impressed before, your little presentation and Bastet's sheer presence put him in awe, as the vague knowledge of Egypt and its gods that's part of the modern multicultural society clicks into place with the divine aura of the beautiful woman right in front of him. Add to that the desperation of a person recently bodily transformed against his will, seeking shelter in a mall with little hope for the future, and it seems like you just got a convert! Hope fills the man's eyes as he looks at her, opening his mouth but not quite sure what to say.";
			say "     Bastet on the other hand is right in her element, seeming more lively than ever as she seems to soak up his adoration. Reaching out to lay a clawed hand on his arm, she says in a warm and comforting tone. 'There will be a place for you, when the new kingdom rises. It will be a little while yet, but you can trust in that. All you need to do is to believe in me, and be ready when the time comes.' He's visibly touched by the hope she offers, and starts to kneel before the lioness, only to have her stop his movement with a firm grip. 'No, not that. My followers should never crawl, nor kneel - that is the foul nature of serpents, and the new kingdom will need a proud people. Stand as one of mine, my pack of disciples! Now, tell me your name and where you lay down your head to rest. I will send my high priest Anktepi to speak with you soon.'";
			WaitLineBreak;
			say "     The guy tells Bastet who he is, and where he can be found, then quickly offers the two of you his place in line, stepping around to stand behind the lioness. She quietly talks with him until the line has melted away, and you reach the ordering station. The appearance of a hungry lioness, and a goddess on top of that, puts a little fright in the cashier, with him quickly passing on the order you put in, to be fulfilled on the double. Bastet lets out a little predatory chuckle as you say that the food should be charged to Nermine's store. 'At least it will be a some payback to that woman if she has to pay for our food. I do hope it will be expensive,' Bastet comments, well and truly out of the loop for how little food costs in the modern world. The two of you claim a nearby table, where the lioness starts to demolish the large box of crispy chicken wings you got for her, complete with a little cup of spicy barbecue sauce.";
			WaitLineBreak;
			say "     Somehow, Bastet manages the impossible combination of savagely tearing into the meat with fangs and predatory teeth, while at the same time keeping a pristine and noble appearance, with not a drop of sauce ending up on her fur or dress. The multi-faceted nature of this avatar, embodying a savage lioness, proud woman and neat cat all rolled into one is fascinating to watch, almost making you forget your own food and drink at first, but quickly catch up before it gets cold, having your fill of tasty fast food.";
			PlayerEat 30;
			PlayerDrink 20;
			say "     'I think,' Bastet begins, placing the last neatly gnawed chicken bone on her plate, 'that there might be [italic type]some[roman type] parts of your culture that might be worth preserving. I will have to send Anktepi into the kitchens here to tell the cooks that they'll have the honor of being part of the new kingdom as well. Once I am free again, of course.' The last sentence is casually added in a firm tone, with her golden eyes focusing on the new convert, sitting a little distance away at a table where he found an empty spot. You can't help but wonder how many believers she'll need to reclaim more of her powers and give Nermine the slip. Quite a few, in all likelihood, but she's clearly in a good mood right now. Inclining your head to acknowledge the lioness's words, and tell her that you're glad she liked the food. 'It was a pleasant and filling meal, with a... rewarding encounter thrown in too.'";
			say "     Well-fed as she is right now, and elated by fresh belief flowing into her, Bastet is fairly pleasant to be with as you make your way back to the store afterwards. Her [bold type]approval[roman type] of yourself has [bold type]risen a little[roman type].";
			project Figure of Bastet_smile_dress_seethrough_icon;
			increase BastetApproval by 1;
		-- "Pull down the top of Bastet's dress to show off those breasts.":
			say "     Stepping up behind the lioness, you wrap your arms around Bastet from behind, then pull down the front of her dress, hooking the fabric beneath the curves of her breasts. She wasn't exactly hiding her body from anyone, but now the perky boobs are right in everyone's view, with many eyes being drawn to stare openly as you cup the lioness's curving bosom. A yowl of annoyance escapes her lips, albeit tempered by the moan she can't help but let out when you catch her nipples between your fingers, squeezing and caressing them for everyone to see. What started as just being gaped at now has now devolved into openly being exposed to any number of onlookers, which doesn't help improve Bastet's mood in any ways, but she wisely refrains from protesting too loudly, just bearing the indignity with gritted teeth.";
			say "     You keep playing with her chest, at some point also sliding a hand down to feel over her crotch, where a certain wetness soaks right through the fine fabric of her dress, due to her slit becoming involuntarily moist from all the stimulation. With the guy ahead of you doing little but staring hungrily and rubbing his own crotch through the clothes he has on, both of you are a little surprised as you ear someone clearing their throat loudly - it's the cashier, as the line in front of your neighbor has melted away, and it's his spot next. As you start to pull Bastet's dress back up, he holds up a hand to bid you to wait, then says, 'How about you leave that down for a little while longer, and go take my spot. I just wanna... get a good look of the other side too.' Chuckling, you nod and pull Bastet past the guy, who is smart enough not to try touching her, thus avoiding being mauled by the furious lioness. All he does is just get a really good look at her perky buttocks, visible through the semitransparent dress.";
			WaitLineBreak;
			say "     Flanked by a now [bold type]very[roman type] indignant Bastet, who quickly puts her dress back into position and barely acknowledges your existence beyond that, you order food for the two of you, explaining that it should be charged to Nermine's store. A growl comes from your companion as she hears the sorceress's name, angry at the jackaless for having created this situation that leaves her exposed to your whims. Once you're handed the food and you claim a nearby table, the lioness gives you the cold shoulder, sitting down and looking to the side while starting to demolish the large box of crispy chicken wings you got for her, complete with a little cup of spicy barbecue sauce. Somehow, Bastet manages the impossible combination of savagely tearing into the meat with fangs and predatory teeth, while at the same time keeping a pristine and noble appearance, with not a drop of sauce ending up on her fur or dress.";
			say "     The multi-faceted nature of this avatar, embodying a savage lioness, proud woman and neat cat all rolled into one is fascinating to watch, almost making you forget your own food and drink at first, but quickly catch up before it gets cold, having your fill of tasty fast food. Getting a filling meal seems to calm the immediate fury of Bastet over your treatment of her, but that doesn't mean that you haven't royally annoyed her. Her [bold type]approval[roman type] of yourself has [bold type]taken a marked downturn[roman type]. She's a stormy, sulky presence by your side as you make your way back to Nermine's store.";
			project Figure of Bastet_neutral_dress_seethrough_icon;
			decrease BastetApproval	by 2;

to say BastetTalk4: [take her out to visit her worshipers]
	if BastetApproval < 7:
		say "     It kinda feels like this is something you should only do if you're on very good terms with the lioness. Try being nicer and indulging in Bastet's whims a bit first.";
	else:
		now Sterile of Bastet is false; [let the breeding begin!]
		if "Worshippers Visited" is not listed in Traits of Bastet: [first time, guaranteed pregnancy]
			say "     After spending a moment admiring her form, letting your eyes roam over the semitransparent nature of her kalasiris, you step up to Bastet and proclaim you want to take her somewhere... special. The lioness looks back at you, raising an eyebrow at the sudden offer, then snorts through her nose, happy enough to get out of her role as 'guard' (or rather eye-candy for the customers) of Nermine's store. Inclining her head in a shallow nod, she replies, 'You're enjoying an air of mystery, I see. Fine, I will accompany you.' Slipping her arm under the offered crook of your elbow, the two of you set out through the bustling hallway of the Smith Haven Mall. The crowd of countless humans, hybrids and transformed of all shapes and sizes that flocked to the mall to seek shelter makes your progress rather slow, but you don't really mind, given the pleasant company by your side.";
			say "     Strolling down the wide corridor towards the east, then around the fountain in the atrium and passing by Brookstone Books, your path draws near to the target of this little excursion. Ahead, you make out the front of a store that had its sign painted over to read 'House of the Rising Sun', as well as having the images of two regally sitting black cats left and right of the entrance door. A trio of red-robed people stand in a small group outside the door, chatting amongst themselves. One of them spots your approach, gasping audibly as she recognizes Bastet. The other two whirl and gape for a second, then all three of them rush into the shrine, babbling 'She's here! She really is here!', 'We must tell everyone!', and 'Mother Bastet is so beautiful!' The lioness by your side raises an eyebrow, her face showing a mixture of pleasure for having actually having devoted worshipers again, and puzzlement that all of them just ran off without even greeting her.";
			WaitLineBreak;
			say "     A smile plays over your lips as you continue walking with your feline companion, seeing lots of people rush around inside the former store in frantic haste to make everything as presentable as possible. 'You were not lying when you said this was going to be special,' Bastet says, coming to a stop in front of the entrance and looking up at the sign, then studying the painted cats with a satisfied purr. You realize that she's also watching the people inside the shrine from the corner of her eye, giving them time to finish their preparations. Before much longer, the avatar then straightens herself to her full height and gives you a slight nod to the side before stepping forward across the doorstep. Within, sixteen red-robed worshipers await the two of you, standing in a half-circle facing Bastet with their heads bowed. They've got their elbows close to the sides of the body and with the hands outstretched sideways, palms up, in the ancient Egyptian prayer posture.";
			say "     You hear a sigh as Bastet exhales, having held her breath. Then she inhales, almost seeming to drink in the faith these people are pouring out. Shining with something magical, her cream-colored fur and black hair take on a richer, deeper shade that glows with vitality. 'Look up, children,' her voice both the same, but also softer than you are used to. As the gathered crowd raise their heads in unison, their worshipful eyes widen as Bastet smiles at them, one by one. Then she stretches out a hand to one of the group, the shortest of the bunch, and asks, 'So, do you want to tell me what this is? Why this is how I learn of this community?' The tone of her voice is inquisitive, but also welcoming, which coupled with an almost... motherly smile takes out any sharpness that such questions might hold.";
			WaitLineBreak;
			say "     Clearly still nervous about being put on the spot and trembling a little, Ankhtepi steps forward, to find his cheek being stroked as one would calm a small child. The oversized ears of the small fennec twitch and he leans his head slightly against her touch, before explaining, 'My goddess, I - I did not want to disappoint you, again... after the outcome of my last idea. I-I should have found another way to bring you back, without dealing with the sorceress, and...' Holding up a hand, Bastet waves away the fennec's stuttering words. 'Shh, shh, it's alright,' she pats his head with a matronly, almost angelic smile. 'After you got entrapped, I felt... lost. I just let the flow of the crowd carry me along. I don't know how long I felt myself drift. I washed up here, with those that despaired in this fallen world. There are so many among the refugees in need of guidance. I felt I could do at least a little, help them find a new hope.' As Ankhtepi stands before his goddess, looking up into her golden eyes, there is a little movement in the crowd as they come closer, not daring to touch Bastet but instead reaching out to lay their hands on the fennec, in thanks and support.";
			say "     'There are only a few believers yet, so I did not think I was worthy of telling you about it. I-' Ankhtepi's words are stopped by a feline fingertip gently laid across his lips. 'Hush, no more of that. You're always worthy in my eyes. My most faithful believer. And in doing your best, even in the time of greatest doubt, you have done something beautiful.' Letting her gaze wander over the interior of the refurbished store, Bastet takes it all in: It is clearly a shrine, given all the cat paintings and hieroglyphics, but it also is... homey. There's some furniture, a small kitchen corner, and a pile of hastily rolled-up sleeping bags from when they cleaned up earlier, as well as a fenced-off corner that looks very soft and well-padded, with three small children sleeping peacefully on piles of blankets.";
			WaitLineBreak;
			say "     Her eyes linger on the crib area for a moment, before Bastet looks back to Ankhtepi, then turns to you. 'Both of you have reminded me of something... truly important. Though I may despise that... bitch, maybe it is best that the path of fate led things here. I was ready to return to my origins. Reclaim the regalia and be the fierce lion goddess that would cut through the darkness of this world with a swipe of her claw. To rectify a world that had almost... forgotten me.' The last words are said with a rumble, betraying some anger at the state of affairs, though the prideful feline's feelings are tempered now. 'It would not have done this world much good to gain yet another goddess of war,' she adds, shaking her head. 'This community is the reminder I needed, why I am so fierce, so proud. It is to protect, to be a guardian for all my children! I needed to remember what the true source of my power is.' With that said, she then reaches out to give her followers soft kisses on their foreheads, blessing each of them in turn.";
			say "     The next little while is filled with Bastet getting to know her worshippers, learning their names and backgrounds. Given what's going on all throughout the city, it's not surprising that more than half of the group is expecting, all of the women and several of the men. Ankhtepi's message of a motherly protector clearly found fertile ground among those that wish for a safe world for their future children, even those among the group that didn't exactly voluntarily end up pregnant. Bastet has some words of comfort for each of them, after which she and you are treated to a full tour of the little commune, with her blessing the children, then inspecting her follower's efforts. This includes a very comfortably appointed 'inner sanctum' in a back room, including a large black futon and red velvet blankets. As this is the end of the tour anyways, Bastet thanks her followers in a friendly tone, then bids everyone to step outside for a moment - except you, that is.";
			WaitLineBreak;
			say "     Bastet pushes the door shut with a soft click, then turns around to face you. Her muzzle opens in a somewhat toothy grin, with her tongue playing over the sharp points of her fangs as she steps forward. Bringing a clawed hand up, she strokes a finger up and down over your breastbone, pushing you backward with gentle pressure. 'You know, I was properly... irked, at first, by your part in that woman's machinations. The audacity of it all, dashing my plans for a glorious return to my full strength. Though at the same time - you did win fair and square, and it was more than a little bit of fun.' A purr accompanies the last words, and she makes you step back just a little further until you bump against the edge of the futon with your feet. 'But you proved yourself to me after that, becoming a friend. And now you even bring me here, to this place, to remember myself. That is worth a proper reward! I wonder what I could give you...'";
			say "[BastetShrineFuck]";
			TraitGain "Worshippers Visited" for Bastet;
		else: [repeat]
			say "     Stepping up to Bastet's side and sliding an arm around her back, you run your hand down along her flank before giving her firm rump a squeeze. With a pleased murr bubbling up from the depth of her throat, the lioness looks at you, muzzle opening in a smile that shows off her fangs. 'Being bold and hands-on, I like it,' she purrs to you, leaning into your embrace. As you then offer to take her on a trip to her worshipers at the shrine in the east wing of the mall, she's more than happy to go right away, abandoning the unloved tasks that Nermine is making her do. Bastet slips her arm under the offered crook of your elbow and the two of you set out through the bustling hallway of the Smith Haven Mall. The crowd of countless humans, hybrids and transformed of all shapes and sizes that flocked to the mall to seek shelter makes your progress rather slow, but you don't really mind, given the pleasant company by your side.";
			say "     A little while later, you near the 'House of the Rising Sun', as the believers have styled their commune. The familiar sight of people in red terrycloth bathrobes (with hoods and all) greets you outside the entrance to the former store, with two of the cultists standing there along with one of the regular mall inhabitants. From the looks of it, they're having a friendly conversation, with one of the robed worshipers soon reaching out to give the shoulder of the newcomer a friendly squeeze, then inviting them inside with a sweep of their arm. Pleased in seeing belief in herself being preached and spreading, Bastet bids you to pause for a moment. She watches intently through the windows as the group is welcomed inside by several members of the congregation, soon followed by high priest Ankhtepi, who joins [one of]after coming out of the back room[or]after handing oversight of the children he was watching to someone else[or]after turning down the camping stove he was cooking something on[at random].";
			WaitLineBreak;
			say "     Visibly content at seeing the scene, Bastet pats your arm and purrs, 'Let us follow them.' The two of you resume your stroll towards the shrine, which has a marked effect on your companion. Already being a proud and beautiful lioness, she seems to gain more vibrancy with every step, giving her a subtle but majestic glow by the time you cross the doorstep. The people within the shrine are star-struck by the divine visitation, with all of the cultists immediately taking on the ancient Egyptian prayer posture of having their elbows close to the sides of the body and with the hands outstretched sideways, palms up. They did their heads in supplication before glancing back up to watch Bastet's glory. The new convert is following along as best as they can, even if they're a bit overwhelmed by this sudden turn of events.";
			say "     'How have you been, my children?' Bastet asks in a tone full of motherly warmth and softness. She patiently listens to their accounts of what happened since her last visit before turning to the newcomer and indulging in a conversation with them. In the end, she oversees a small ceremony in which they're given their own red robe, and blessed with a soft kiss on the forehead. The bustle of everyone wanting to interact with their patron goddess continues for some time before it dies down again, after lots of talking, sharing of food and playing with the young children. Bastet is well-pleased with giving these people the feeling of being loved and protected that they need, and she soaks up the faith poured out for her in turn. 'Thank you again for bringing me here,' the lioness says after slipping her hand under yours and giving you a squeeze. A deep purr vibrates in her voice as she adds, 'You deserve a reward. How about we spend some time in the inner sanctum together?'";
			LineBreak;
			say "     ([link]Y[as]y[end link]) - Have sex with Bastet in the back room.";
			say "     ([link]N[as]n[end link]) - You just wanted to make her happy and weren't thirsting for sex right now.";
			if Player consents:
				say "     After stepping into the inner sanctum, Bastet pushes the door shut with a soft click, then turns around to face you. Her muzzle opens in a somewhat toothy grin, with her tongue playing over the sharp points of her fangs as she steps forward. Bringing a clawed hand up, she strokes a finger up and down over your breastbone, pushing you backward with gentle pressure. 'After the way that our acquaintance started, I would never have guessed that I'd enjoy being with you quite this much...' A purr accompanies the last words, and she makes you step back just a little further until you bump against the edge of the futon with your feet. 'But you proved yourself to me after that, becoming a friend and then lover. Now I couldn't imagine being without you too long. Funny, how the stands of fate can entwine, isn't it?'";
				say "[BastetShrineFuck]";
			else:
				say "     Carefully redirecting her offer to other matters without flat out saying that you don't want to get frisky right this instance, you spend some further time with Bastet and the worshipers in the shine, just... hanging out, taking and enjoying each other's company. Eventually, your visit draws to a natural close and the two of you set out for the return trip to Nermine's store.";
		say "     Your excursion to visit her worshipers has pleased Bastet, and she is happily leaning in towards you as you stroll back to the store afterwards. Her [bold type]approval[roman type] of yourself has [bold type]risen markedly[roman type].";
		project Figure of Bastet_smile_dress_seethrough_icon;
		increase BastetApproval	by 2;

to say BastetShrineFuck:
	say "     Smirking as she plays coy, Bastet traces her hands along the sides of her body, wandering up and to her breasts before letting one hand slip behind her neck to undo the strap holding her dress. It is tight enough to not instantly slip off her body, giving the sexy lioness the opportunity to peel the fabric down over her form, revealing herself in a very enticing show. Stepping up close beside you, she circles around with her fingers tracing over your skin before setting her slender paws on the futon and moving to its center. In swaying, almost dance-like movements, she sinks down onto to soft bedding, coming to rest with her elbows propping up her upper body, putting her breasts on prime display. 'Come join me, my love,' she teases you, while spreading her legs a little bit to draw your attention her wetly glistening nether lips.";
	WaitLineBreak;
	if Player is not naked:
		say "     Impatiently stripping down and dropping your clothes and gear where you stand, you ";
	else:
		say "     Confident in your own nakedness without the need for clothing, you set down your gear, ";
	say "then join Bastet on the futon and kneel between her legs to lean forward and meet her muzzle in a hungry kiss. Her warmth beneath you, stiff nipples pressing against the skin of your chest, and entwining tongues as you make out, all of it feels amazing and is just the start of your love-making. Soon, you move down to worship her pair of glorious breasts, cupping them with your hands before switching back and forth sucking on one nipple then the other and drawing pleased purrs from your partner. Bastet lays back to free her arms, stroking over your head and body while pushing against your touch, with sighs and pleased moans escaping from her lips.";
	say "     Feeling that it is time to escalate the lioness's arousal even further, you give her nipples one more eager suckle, flicking them with the tip of your tongue, then continue down. Kissing your way over the [if ImpregTimer of Bastet > 12]protruding curve of her baby bump, [else if ImpregTimer of Bastet > 0]slight curve of her pregnant belly, [else]flat expanse of her toned stomach, [end if]you reach her crotch before much longer. The slightly open slit of her vagina is more than just a little wet, even matting the short fur around it. 'Yyyyessss!' comes an aroused moan from the proud feline as your breath washes over her intimate parts and you start to suckle on the protruding nub of her clit, while your fingers spread her folds to delve into her warm cave. The eager woman's inner walls tremble around your questing fingers, feeling around for what will make her writhe in pleasure. Lavishing Bastet with attention, you get her more than a little hot and bothered before eventually deciding that it's time to get some fun yourself.";
	WaitLineBreak;
	if Player is male:
		say "     Pushing yourself up from between her legs, you look down upon the golden-furred feline, stretched out on the sheets for you to feast your eyes upon - and more, as she seems perfectly happy for you to take her like this. Her eyes have that inner, lusty glow that speaks of a woman in need of a good fuck, and she even slides a hand down to her crotch, spreading her folds open in a clear invitation. 'I need you inside me!' she mrowls invitingly, and your're more than happy to oblige! Your pointy jackalman shaft stands rock-hard and ready to be guided to that welcoming passage. With a satisfied grunt rising from your throat, you slide into the lioness's slick and warm passage. It envelops your member deeper and deeper, until you finally are all the way inside her and your balls press against Bastet's crotch. Leaning forward, you kiss her full on on the lips while grinding your crotch against hers, the overwhelming sensations and hungry tongue-wrestling leaving both slightly breathless.";
		say "     Keeping your gazes locked with one another evan as you pull back again, then straighten yourself, you give Bastet a well-satisfied grin and put your hands down to grasp the sides of her hips. Then you pull partway out and thrust deep in a lightning-quick move, making her throw her head back and roar like a lioness in heat, loud enough that even the passersby outside in the hallway must have heard her. And why shouldn't they - fertility and motherhood are core tenants of Bastet's divine portfolio, so a joyful mating might even be counted as a prayer. Not that you have too much time to waste on such idle thoughts, as your focus is on the slick inner walls of the feline as they welcome your shaft in a warm and tight embrace. Having conquered the affections of Bastet, you revel in fucking her with deep, strong thrusts, making her mewl needily every time you bottom out inside her.";
		WaitLineBreak;
		say "     Sweat runs down your back as you continue the wild fuck with the lioness, with her pulling you down on top of herself and wrapping her arms around your chest tightly. Your world contracts to basically just her and you, the warmth of her body, tightness of her insides and the satin sheets under your knees and arms. In the throes of passion, she's clawing your back just a bit, leaving shallow streaks as her claws don't quite stay retracted - no matter, this is just a little spice to go with the breathless mating between the two of you, and it simply motivates to hilt yourself into her even deeper! And then, it is time for the grand finale - as the urge to cum rises to almost unbearable intensity, Bastet wraps her legs around your hips and pulls you in as tight as she can, and lets out a yowl of 'Breed me!' On this divine command, you erupt deep inside her, letting out a breathless grunt as your cock throbs HARD and the first thick splash of your seed pulses into the young woman's depths!";
		say "     Bastet's tight passage around your thrusting shaft ripples and flexes as the beautiful female joins you in orgasm, her insides twitching and squeezing around your canine knot as it swells up to tie the two of you together and claim her as yourse. Half-collapsing on top of Bastet as the orgasm rocks through your body, you grunt with each further spurt of cum deposited in her fertile womb, with your balls working overtime to deliver a load of epic proportions into your divine bedmate. She must be lending you some of her own strength to prolong this unforgettable experience for the two of you, as the matring frenzy that has you both in its grip continues unabatedly for you don't know how long, with you grinding against each other and pumping more and more semen into her!";
		WaitLineBreak;
		say "     When you eventually are capable of having clear thoughts again, you find yourself still entwined with Bastet, knotted cock tied to a pussy that must be sloshing with your load. 'That was amazing,' she tells you with a loud purr that vibrates against your cheek as your head is resting against her collarbone. She's holding you in her arms, with her fingers soothingly stroking over your back, banishing any trace of discomfort from there. In fact, you see that there's no trace at all of the claw-marks when you glance over your shoulder a little while later. ";
	else: [females]
		say "     Pushing yourself up from between her legs, you look down upon the golden-furred feline, stretched out on the sheets for you to feast your eyes upon - and more, as she seems perfectly happy for you to take her like this. Her eyes have that inner, lusty glow that speaks of a woman in need of a good fuck, and she even slides a hand down to her crotch, spreading her folds open in a clear invitation. 'I need you inside me!' she mrowls invitingly, making you hesitate in confusion, as you don't have a cock currently. This little detail doesn't deter a horny goddess for more than a moment though, as she reaches out as if to grasp a firm shaft in front of your crotch - and a miraculous, semitransparent member fades into view there. You can feel it too, both her fingers enveloping your new appendage, as well as spreading your own nether lips, as the shaft continues all the way to your crotch and further inside your body.";
		say "     Accepting the extraordinary coupling, your pointy jackalman shaft stands rock-hard and ready to be guided to that welcoming passage. With a satisfied grunt rising from your throat, you slide into the lioness's slick and warm passage. It envelops your ghostly member deeper and deeper, until you finally are all the way inside her and your clit presses against Bastet's crotch. Leaning forward, you kiss her full on on the lips while grinding your sex against hers, the overwhelming sensations and hungry tongue-wrestling leaving both slightly breathless. Keeping your gazes locked with one another evan as you pull back again, then straighten yourself, you give Bastet a well-satisfied grin and put your hands down to grasp the sides of her hips. Then you pull partway out and thrust deep in a lightning-quick move, making her throw her head back and roar like a lioness in heat, loud enough that even the passersby outside in the hallway must have heard her! And why shouldn't they - fertility and motherhood are core tenants of Bastet's divine portfolio, so a joyful mating might even be counted as a prayer. Not that you have too much time to waste on such idle thoughts, as your focus is on the slick inner walls of the feline as they welcome your shaft in a warm and tight embrace.";
		WaitLineBreak;
		say "     Having conquered the affections of Bastet, you revel in fucking her with deep, strong thrusts, making her mewl needily every time you bottom out inside her. Sweat runs down your back as you continue the wild fuck with the lioness, with her pulling you down on top of herself and wrapping her arms around your chest tightly. Your world contracts to basically just her and you, the warmth of her body, tightness of her insides and the satin sheets under your knees and arms. In the throes of passion, she's clawing your back just a bit, leaving shallow streaks as her claws don't quite stay retracted - no matter, this is just a little spice to go with the breathless mating between the two of you, and it simply motivates to hilt yourself into her even deeper! And then, it is time for the grand finale - as the urge to come rises to almost unbearable intensity, Bastet wraps her legs around your hips and pulls you in as tight as she can, and lets out a yowl of 'Breed me!' On this divine command, you orgasm messily, your pussy becoming awash with slippery femcum.";
		say "     But not just that, as the spectral dick connecting your pussies glows brightly, with a pulse of light flashing along its length from your insides to her own, then another and another. Your breath synchronizes with the pulses and throbs of the ghostly dick, with italic something clearly passing from you to her. Bastet's tight passage around your thrusting shaft ripples and flexes as the beautiful female joins you in orgasm, her insides twitching and squeezing around your canine knot as it swells up to tie the two of you together and claim her as yourse. Half-collapsing on top of Bastet as the orgasm rocks through your body, you grunt with each further spurt of essence deposited in her fertile womb, to deliver a load of epic proportions into your divine bedmate. She must be lending you some of her own strength to prolong this unforgettable experience for the two of you, as the matring frenzy that has you both in its grip continues unabatedly for you don't know how long, with you grinding against each other and pumping more and more glowing energy into her!";
		WaitLineBreak;
		say "     When you eventually are capable of having clear thoughts again, you find yourself still entwined with Bastet, knotted cock tied to a pussy that warmly and snugly envelops it. 'That was amazing,' she tells you with a loud purr that vibrates against your cheek as your head is resting against her collarbone. She's holding you in her arms, with her fingers soothingly stroking over your back, banishing any trace of discomfort from there. In fact, you see that there's no trace at all of the claw-marks when you glance over your shoulder a little while later. ";
	if ImpregTimer of Bastet is 0: [not Preg]
		if Player is male:
			say "'I will treasure carrying your child,' she tells you in a voice full of contentment, smiling when you raise your head and look at her with wide eyes. As you're about to open your mouth and ask how she knows that it will take, the goddess laughs amusedly and shushes you with a finger on your lips. 'I do have enough power for minor miracles, you know. After finding someone worthy of starting a new dynasty with me, did you think I would leave it to chance? No, this child, our child, is in here.' She lays a hand on her stomach, in absolute knowledge that she's pregnant, and you're the father!";
			say "     The two of you spend a while longer just laying there, entwined and tied together, before your erection inevitably softens and slips out of the sexy lioness. Half-expecting a deluge of semen to come with it, you're slightly surprised to see your member being dry and free of even a trace of cum. Seems like Bastet isn't letting even a drop of your load go to waste. Well, that and her being too dignified and proud to let herself be reduced to a cum-dripping mess. ";
		else:
			say "'I will treasure carrying your child,' she tells you in a voice full of contentment, smiling when you raise your head and look at her with wide eyes. As you're about to open your mouth and ask how that is possible, the goddess laughs amusedly and shushes you with a finger on your lips. 'I do have enough power for minor miracles, you know. After finding someone worthy of starting a new dynasty with me, did you think I would let the opportunity go to waste, just because you're not bearing a penis? No, this is our child, you can be sure of that.' She lays a hand on her stomach, in absolute knowledge that she's pregnant, and you're the father!";
			say "     The two of you spend a while longer just laying there, entwined and tied together, before the spectral cock eventually fades out of existence, leaving a bit of an empty feeling inside you. Looking down, you see that there isn't any cum or the like leaking from Bastet, so your more spiritual mating apparently doesn't need that to knock her up. And it would be far too messy for a dignified and proud feline like her to let herself be reduced to a cum-dripping mess too. ";
		now ImpregTimer of Bastet is 1; [starts the pregnancy timer]
	say "Satisfied, but still a bit exhausted from your coupling, you get up from the bed and assist Bastet in standing up too, then offer her the dress she stripped off earlier before collecting your own stuff and putting it in order again. As you emerge from the back room a little while later, many of the cultists throw Bastet and yourself knowing glances, and a few bend their heads to you too, as they want to acknowledge the consort of their goddess. ";
	NPCSexAftermath Bastet receives "PussyFuck" from Player;
	if Player is not male:
		NPCSexAftermath Player receives "DildoPussyFuck" from Bastet;

Instead of fucking the Bastet:
	say "[BastetSexMenu]";

to say BastetSexMenu:
	if (lastfuck of Bastet - turns < 5):
		say "     Bastet puts a hand on your chest to hold you back and says, 'Have some patience please, I am not a slut that is always ready for your pleasure... like some bitches you might know.' Her last words are accompanied by a pointed stare at Nermine, who stands ready at the store counter, dressed in nothing but her fur. The sexy jackaless even gives you two a provocative smile as she notices the looks coming her way, then cups her shapely breasts and demonstratively strokes their nipples. The proud lioness next to you just gives a disapproving huff and looks away, her tail twitching in annoyance.";
	else:
		now BastetSexOrTalk is true; [approval message in her sex menu]
		say "[BastetApprovalMessage]";
		if BastetApproval > 3:
			project Figure of Bastet_smile_naked_jewelry_icon;
		else:
			project Figure of Bastet_neutral_naked_jewelry_icon;
		now sextablerun is 0;
		blank out the whole of table of fucking options;
		[]
		choose a blank row in table of fucking options;
		now title entry is "Challenge her to another round of sexual 'combat'.";
		now sortorder entry is 1;
		now description entry is "Compete with Bastet";
		[]
		choose a blank row in table of fucking options;
		now title entry is "Go down on the lioness and lick her pussy";
		now sortorder entry is 2;
		now description entry is "Please Bastet with your tongue";
		[]
		if Player is male:
			choose a blank row in table of fucking options;
			now title entry is "Let her suck your dick";
			now sortorder entry is 3;
			now description entry is "Stick your dick into the lioness's mouth";
		[]
		choose a blank row in table of fucking options;
		now title entry is "Make her stand facing the wall and finger her mercilessly";
		now sortorder entry is 4;
		now description entry is "Shove your fingers up the lioness's pussy";
		[]
		if Player is male:
			choose a blank row in table of fucking options;
			now title entry is "Fuck her pussy";
			now sortorder entry is 5;
			now description entry is "Enter the sexy lioness and come in her";
		[]
		sort the table of fucking options in sortorder order;
		repeat with y running from 1 to number of filled rows in table of fucking options:
			choose row y from the table of fucking options;
			say "[link][y] - [title entry][as][y][end link][line break]";
		say "[link]0 - Nevermind[as]0[end link][line break]";
		while sextablerun is 0:
			say "Pick the corresponding number> [run paragraph on]";
			get a number;
			if calcnumber > 0 and calcnumber <= the number of filled rows in table of fucking options:
				now current menu selection is calcnumber;
				choose row calcnumber in table of fucking options;
				say "[title entry]: [description entry]?";
				if Player consents:
					let nam be title entry;
					now sextablerun is 1;
					if nam is "Challenge her to another round of sexual 'combat'.":
						say "[BastetSexBattleRepeats]";
					if nam is "Go down on the lioness and lick her pussy":
						say "[BastetSex1]";
					if nam is "Let her suck your dick":
						say "[BastetSex2]";
					if nam is "Make her stand facing the wall and finger her mercilessly":
						say "[BastetSex3]";
					if nam is "Fuck her pussy":
						say "[BastetSex4]";
					wait for any key;
					now lastfuck of Bastet is turns;
			else if calcnumber is 0:
				now sextablerun is 1;
				say "     You step back from the lioness, shaking your head slightly as she gives a questioning look.";
				wait for any key;
			else:
				say "Invalid Option. Pick between 1 and [the number of filled rows in the table of fucking options].";
		clear the screen and hyperlink list;

to say BastetSex1: [player licks Bastet]
	say "     You let your gaze wander over her tight sheath-dress and its semitransparent sections. Then, you step up to the lioness and kneel down - an act that makes her eyebrows rise. From your new position, she looks even more divine than usual, and you can definitely see why Anktepi worships the ground she walks upon. These proud and noble features, the edges and curves of her feline head, and its large slit-pupiled eyes looking down at you... And everything put into exactly the right light in the mixture of deep shadows and warm candlelight that fills Nermine's store. All of this makes you desire her even more, and you feast your eyes on her body, whose beauty is barely hidden by the mostly sheer fabric of her dress.";
	say "     'Worship me,' comes an eager purr from the trapped cat goddess. You slide both hands up the outside of her slender legs, stroking over their soft fur. A little gasp from somewhere to the side reaches your ears when you slip your fingers under her dress, lifting and pushing it upwards, revealing the pussy of this beautiful anthro lioness. Glancing around for a second, you realize that this gasp must have come from Anktepi. Bastet's devoted priest and servant never strays far from her side, after all. He looks a bit drooped right now, since you are basically taking his place as a willing servitor to his goddess, and intent to please her. The corners of your mouth rise a little as you meet his gaze. You give him a smug wink, then turn back to your waiting partner.";
	WaitLineBreak;
	say "     Bastet's pussy is perfectly formed, as befitting to a goddess, with slightly open, curving nether lips and a little hooded button of a clit at the top. Raising your muzzle, the tip of your nose bumps against her folds, earning a chuckle from the sexy feline. You begin to lap at her sex, playing your long tongue over the curved slit, then giving her clit special attention. You lick the small bump, and circle around with the tip of your tongue. 'Very good,' Bastet adds and pats your head with her hand-paw, purring some more as she goes on to say, 'Your service pleases me.' Eager to show her that this is merely the beginning, you attack her pussy in earnest now. You nudge apart these pussy lips with your nose, and stick your muzzle right between them, allowing to huff the entrancing aroma of her arousal with every breath. Once settled, you stick out your tongue in order to explore the lioness's depths.";
	say "     'Oooh yes!' comes Bastet's exclamation of pleasure at the wiggling of your long tongue in her pussy. The cat goddess pants in pleasure and arousal, and you feel the muscles of her legs trembling as you continue to go down on her. Ha - but this is far from the end of what you plan to do with her yet! You continue to slurp at her sex for a little while longer, then pull back and set your fingers on her pussy instead, sliding them into the lioness's vagina to tease and stroke her insides. Encouraged by the little sounds of pleasure from Bastet that you manage to drive out, you quickly rise to your feet and plant a deep kiss on her open muzzle, pushing your tongue into her mouth as you do so.";
	WaitLineBreak;
	say "     Bastet readily makes out with you, and experiences the taste of her own pussy as you twirl your tongue against hers in a long French kiss. After several minutes of making out and fingering, the feline pants heavily. You grin mentally, having successfully wrapped the cat goddess around your finger, and decide to step up your efforts. You make her sit down, and crouch down in front of her again, and focus your licking on the nub of her clit. You attack her on two fronts: while you lap and suckle the lioness's magic button, you push a pair of fingers as deep as you can, and feel around for her most sensitive spots. Bastet's hands find your head and shoulders to hold on to as she is pushed to higher and higher arousal. Her voice becomes higher and higher, her legs shake more and more, as she goes through the throes of passion.";
	say "     Before much longer, she reaches the point of no return. Her feline hands clamp even tighter onto you, and you feel the sting of one of her claws accidentally scraping your shoulder, as the contractions of her orgasm has her reflexively extends her claws. The tight passage of her vagina gets even tighter, and your fingers get wetter and wetter, eventually squishing out femcum. It splashes on your hand and on her sex, bringing back the taste of her lubrication with each stroke of your broad tongue. 'Y-Yes! Just... like... that!' Bastet yowls out in a satisfied tone, drawing out the words into a long exclamation of pleasure. She keeps her solid grip on you all the way through her climax, riding it out fully and grinding her crotch softly against your face. Soon the words, 'Clean me up,' follow, and she waits while you dutifully lick her pussy until the last traces of sexual secretion are gone. When she finally deems that she is clean enough, she lets go and let can stand back up, [bold type]Bastet gives you a well-pleased nod of approval.[roman type] She smooths her dress again, and goes returns to her relaxed waiting stance.";
	project Figure of Bastet_smile_naked_jewelry_icon;
	increase BastetApproval by 1;

to say BastetSex2: [Bastet blows the player]
	if BastetApproval < 4: [grudging BJ]
		say "     You let your gaze wander over her tight sheath-dress and its semitransparent sections. Then, you step up to the lioness and slide an arm around her body, pulling the attractive woman closer and giving her a demanding kiss on the muzzle. She tenses in your grasp, but calms her emotions a second later, well aware that she cannot deny your advances. You make out with Bastet for a moment or two longer, then slide both hands up the sides of her body and give her breasts a little squeeze. Leaning close to one of her pointy ears, you whisper into it that you want a blowjob, then push down on her shoulders and make her kneel. As you start undoing your pants, a little shocked gasp comes from the side - glancing that way, you see Anktepi stand there, the devoted priest and servant of your bound goddess. A grin spreads over your face as you pull your cock out, giving him a smug wink while presenting its hard length to Bastet.";
		say "     Stroking the kneeling lioness's head and ignoring the way her tail beats in silent fury, you order the woman to suck you off. She hisses a little between her sharp teeth, then opens her muzzle and gives your cock a first slow lick. Her tongue feels slick as well as rough at the same time, giving you a very interesting sensation that is only increased by making Bastet do something she feels is beneath her dignity. Petting her head like one would do with a domestic cat, you tell her to keep going and give you a nice blowjob. Between your little touches and nudges to encourage her as well as Bastet's own desire to get this over with, she starts to go down on you in earnest now, bobbing up and down on your hard shaft while her slender paw-hands cup and caress your balls.";
		WaitLineBreak;
		say "     You savor the feel of being in the kneeling lioness's mouth and feeling her lips wrapping around your cock, especially as [one of]someone wanders past the shop window, glancing inside and seeing with a big-eyed expression what is going on[or]the little bell at the door rings and someone walks in, throwing you and Bastet wide-eyed glances while she buys something from Nermine[or]Anktepi again and again tries to look away, but can't help himself from throwing you envious looks[at random]. She is quite good at it too, so there is little surprise in that you're rapidly getting closer and closer to an orgasm. Placing both hands on the sides of Bastet's triangular head, you start pumping her mouth in a full-on face-fuck, your balls slapping against her chin with each new thrust. Your balls tighten and churn, eager to send forth their load.";
		say "     Then finally, the point of no return is reached and you hump against her face with a deep grunt, sending a first splash of cum down Bastet's throat. Yet for the rest, you have a different plan - so you pull out of her mouth and hold her steady as the next heavy throb of cum shoots out and leaves a sticky streak on her golden-brown fur. More and more cum follows in the next few moments, making the lioness quite a sight. You smile at the look of outrage in her large green eyes, then raise a finger and wiggle it in negation as she raises a hand to wipe off your load. With a smirk, you tell her that she may not use her hands - just a tongue. Crinkling her nose at that restriction, Bastet spends a few moments licking up your cum that has landed around her mouth, then suddenly freezes in mid-lick, as if she remembered something. With a call of 'Anktepi' she draws her servant closer, letting him lick and clean her instead.";
		LineBreak;
		say "     Quite a satisfying experience with the lioness, but you're fairly certain that [bold type]Bastet resents you more[roman type] now.";
		project Figure of Bastet_neutral_naked_jewelry_icon;
		decrease BastetApproval by 1;
	else: [eager BJ]
		say "     You let your gaze wander over her tight sheath-dress and its semitransparent sections. Then, you step up to the lioness and slide an arm around her body, pulling the attractive woman closer and giving her a demanding kiss on the muzzle. She melts into your grasp, leaning forward to brush her body against your front, with her arms sliding around you all of their own and embracing you. Making out with Bastet for a moment or two longer, you then slide both hands up the sides of shapely form and give her breasts a little squeeze. The bound goddess purrs loudly as you man-handle her this way, well-amicable with letting you touch her by now. Leaning close to one of her pointy ears, you whisper into it that you want a blowjob, then push down on her shoulders and make her kneel. As you start undoing your pants, a little shocked gasp comes from the side - glancing that way, you see Anktepi stand there, the devoted priest and servant of your pliable goddess. A grin spreads over your face as you pull your cock out, giving him a smug wink while presenting its hard length to Bastet.";
		say "     Stroking the kneeling lioness's head, you caress her sensitive ears with your fingers, rubbing the base of the pointy appendages and stroking their thin and flexible shape. This clearly pleases your lioness lover, making her purr and lean her head into your touch. All of her own, she brings up a hand to take your hard shaft, then stretches out her tongue to give it a first slow lick. Her tongue feels slick as well as rough at the same time, giving you a very interesting sensation that is only increased by the satisfaction at gaining Bastet as a willing partner in sex, not just a slave bound by a rigged deal. Petting her head like one would do with a domestic cat, you tell her how amazing she is - as sexy and proud as only a goddess is bound to be. Between some additional little touches and nudges, as well as shameless flattery to encourage her, Bastet soon starts to go down on you in earnest. Before long, she is bobbing up and down on your hard shaft while her slender paw-hands cup and caress your balls.";
		WaitLineBreak;
		say "     You savor the feel of being in the kneeling lioness's mouth and feeling her lips wrapping around your cock, especially as [one of]someone wanders past the shop window, glancing inside and seeing with a big-eyed expression what is going on[or]the little bell at the door rings and someone walks in, throwing you and Bastet wide-eyed glances while she buys something from Nermine[or]Anktepi again and again tries to look away, but can't help himself from throwing you envious looks[at random]. She is quite good at it too, so there is little surprise in that you're rapidly getting closer and closer to an orgasm. Placing both hands on the sides of Bastet's triangular head, you start pumping her mouth in a full-on face-fuck, your balls slapping against her chin with each new thrust. Your balls tighten and churn, eager to send forth their load.";
		say "     Then finally, the point of no return is reached and you hump against her face with a deep grunt, sending a first splash of cum down Bastet's throat. She keeps her lips tightly wrapped around your shaft, taking the next heavy throb, and the one after that right into her stomach. Then she pulls back a little, opening her muzzle and stretching out that amazing tongue to catch each new spurt of cum. At one point, the lioness has to swallow as not to lose any, and one splash goes wild to leave a sticky streak on her golden-brown cheek. Bastet simply lets out a purred chuckle, then catches your throbbing erection with her mouth again. Playing her tongue over your sensitive member, she swallows all the rest of your cum without fail and suckles a little on your dickhead when your orgasm eventually ebbs off.";
		WaitLineBreak;
		say "     Standing up again, Bastet smiles at you and says in an affectionate tone, 'Did you know that milk was one of my favorite sacrifices by the people of Egypt? Of course, those among the lower classes or even slaves who wanted to worship me didn't have any, but I quite enjoyed their substitutions too.' And with that said, the anthro lioness raises a paw-hand to her cheek, wiping off that stray splash of your cum and then licking her fingers clean with exquisite care. She gives you a pleased smile, then strolls back to her accustomed position and gets back to guarding Nermine's store.";
		LineBreak;
		say "     Quite a satisfying experience with the lioness, and you're fairly certain that you've risen in [bold type]Bastet's esteem a little bit more[roman type] through the 'sacrifice' to the sexy goddess.";
		project Figure of Bastet_smile_naked_jewelry_icon;
		increase BastetApproval by 1;

to say BastetSex3:
	if BastetApproval < 4: [grudging fingering]
		say "     You let your gaze wander over her tight sheath-dress and its semitransparent sections. Then, you step up to the lioness and slide an arm around her body, pulling the attractive woman closer and giving her a demanding kiss on the muzzle. She tenses in your grasp, but calms her emotions a second later, well aware that she cannot deny your advances. You make out with Bastet for a moment or two longer, then slide both hands up the sides of her body and give her breasts a little squeeze. Leaning close to one of her pointy ears, you whisper into it that you want her to face the wall and spread her legs for you. Her eyes flare a little at the demand, but Bastet obeys after a moment of hesitation, turning away from you and raising her arms to brace against the store wall. This causes a little gasp to come from the side - glancing that way, you see Anktepi stand there, the devoted priest and servant of your bound goddess.";
		say "     A grin spreads over your face as you hike up the lower edge of the lioness's dress, sliding it up to reveal the shapely form of her furry buns and the base of her tail. She is naked underneath the kalasiris, most likely because the ancient Egyptian goddess isn't used to panties - or just maybe because she anticipated further sexual demands from yourself. Putting one hand on Bastet's upper back and pulling her hips back with the other, you make her bend forward a little bit more, presenting her ass and the sweet pussy between her legs to the room. Stepping back from the proud lioness and watching her tail twitch and beat from side to side in obvious annoyance, you don't even try to suppress a chuckle before you taunt her a little, saying that she should try to keep her composure and not totally embarrass herself during what comes next.";
		WaitLineBreak;
		say "     Sliding a hand between Bastet's thighs, you stroke it up the inside of her leg until you reach the lioness's pussy waiting for you. Her soft-furred body feels warm to your touch, as do the slightly spread folds of her sex. Stroking over it, you hear the feline woman suck in a little breath, suppressing a moan at the touch. Seems like she took your challenge, intending to keep her control and endure your touching. We'll see about that, you think to yourself and give her another caress, from the sensitive nub of her clit over her folds all the way to the narrow valley between her furry buns. Pressing in against her pucker with the tip of a finger draws a gasp of surprise. With Bastet distracted a little, you abandon the feint at her back door to suddenly slip a finger knuckle-deep into her sex. 'Fuck,' she murmurs under her breath as you penetrate her body, the claws on both bracing hands digging a little into the wall she is standing against.";
		say "     You proceed to slide your finger in and out of the lioness, then add another one, now both of them stroking and touching her on the search for the most sensitive spots of your reluctant partner. Bastet keeps her stance stoically still, seemingly unwavering at being fingered from behind - but you know better, as you feel the tremble of her muscles where your other hand is resting on a golden-brown thigh. Continuing to finger her with increasing tempo, you a pleased to note that the anthro lioness gets more aroused by the second, with her sex soon being wet enough for her fluids to trickle over your knuckles and drip onto the ground below. You savor being able to do this to the proud lioness, especially as [one of]someone wanders past the shop window, glancing inside and seeing with a big-eyed expression what is going on.[or]the little bell at the door rings and someone walks in, throwing you and Bastet wide-eyed glances while she buys something from Nermine.[or]Anktepi again and again tries to look away, but can't help himself from throwing you envious looks.[at random]";
		WaitLineBreak;
		say "     Soon, you have pushed Bastet too far to just keep silent anymore - she is panting openly now, with her claws having fully sunk into the wooden paneling of the wall to keep her standing upright. What a delicious situation to put the sexy woman in. A broad grin spreads over your face as you move your second hand to her crotch too, putting a finger right on her clit and starting to rub it in circling movements. Now rubbing and stroking Bastet at the same time, you continue to wind her up and give a few teasing comments about 'someone' starting to appear more like a bitch in heat than a goddess. As you do so, the lioness suppresses her sounds of arousal for a little while, but she never can keep them in for long, her dregs of willpower soon breaking under the weight of her lust.";
		say "     You tease and play with Bastet for a while longer, until you can feel that she is getting really close - at which point you start a full-out attack on her pussy, inserting a third finger to really stretch her out and intensifying the rubbing and kneading of her clit. This treatment is enough to quickly push Bastet past the point of no return, letting out a half-growled moan and shuddering all over, her pussy now really dripping with femcum! You continue to stroke and touch her to prolong her orgasm, resulting in that the fur of her inner thighs gets more than a little soaked, as the sexy woman's juices start trickling down her slender legs. With a teasing whisper about how she looks quite divine right now, you step back from the bound goddess, savoring the power you have over her like a sweet wine.";
		WaitLineBreak;
		say "     Bastet keeps standing facing the wall for a long time, her head bent as she pants out loud. Then eventually, she almost rips her paw-hands away from the wall, creating a little cloud of splinters from where her claws were dug into the wood. The cat goddess looks over to you with narrowed eyes, then pulls her dress back into place and walks back to her accustomed position of guarding the store, passing you with a grudging huff. Quite a satisfying experience with the lioness, but you're fairly certain that [bold type]Bastet resents you more[roman type] now.";
		project Figure of Bastet_neutral_naked_jewelry_icon;
		decrease BastetApproval by 1;
	else:
		say "     You let your gaze wander over her tight sheath-dress and its semitransparent sections. Then, you step up to the lioness and slide an arm around her body, pulling the attractive woman closer and giving her a demanding kiss on the muzzle. She melts into your grasp, leaning forward to brush her body against your front, with her arms sliding around you all of their own and embracing you. Making out with Bastet for a moment or two longer, you then slide both hands up the sides of shapely form and give her breasts a little squeeze. The bound goddess purrs loudly as you man-handle her this way, well-amicable with letting you touch her by now. Leaning close to one of her pointy ears, you whisper into it that you want her to face the wall and spread her legs for you. Bastet obeys after only a slight moment of hesitation, turning away from you and raising her arms to brace against the store wall. This causes a little gasp to come from the side - glancing that way, you see Anktepi stand there, the devoted priest and servant of your bound goddess.";
		say "     A grin spreads over your face as you hike up the lower edge of the lioness's dress, sliding it up to reveal the shapely form of her furry buns and the base of her tail. She is naked underneath the kalasiris, most likely because the ancient Egyptian goddess isn't used to panties - or just maybe because she anticipated further sexual pleasures yet to come. Putting one hand on Bastet's upper back and pulling her hips back with the other, you make her bend forward a little bit more, presenting her ass and the sweet pussy between her legs to the room. Stepping back from the proud lioness and watching her tail raise and twitch a little in anticipation, you tell her with conviction that she is the sexiest goddess you ever met. Bastet replies with a deep purr, looking at you over her shoulder and raising her rear a little bit more, inviting you to touch it.";
		WaitLineBreak;
		say "     Sliding a hand between Bastet's thighs, you stroke it up the inside of her leg until you reach the lioness's pussy waiting for you. Her soft-furred body feels warm to your touch, as do the slightly spread folds of her sex. Stroking over it, you hear the feline woman suck in a little breath, suppressing a moan at the touch. Seems like she intends to keep her composure as long as possible - she is a proud woman, after all. You idly wonder to yourself how long she will be able to last and give her another caress, from the sensitive nub of her clit over her folds all the way to the narrow valley between her furry buns. Pressing in against her pucker with the tip of a finger draws a gasp of surprise. With Bastet distracted a little, you abandon the feint at her back door to suddenly slip a finger knuckle-deep into her sex. 'Fuck,' she murmurs under her breath as you penetrate her body, the claws on both bracing hands digging a little into the wall she is standing against.";
		say "     You proceed to slide your finger in and out of the lioness, then add another one, now both of them stroking and touching her on the search for the most sensitive spots of your feline partner. Bastet keeps her stance stoically still, seemingly unwavering at being fingered from behind - but you know better, as you feel the tremble of her muscles where your other hand is resting on a golden-brown thigh. Continuing to finger her with increasing tempo, you a pleased to note that the anthro lioness gets more aroused by the second, with her sex soon being wet enough for her fluids to trickle over your knuckles and drip onto the ground below. You savor being able to do this little game with the proud lioness, especially as [one of]someone wanders past the shop window, glancing inside and seeing with a big-eyed expression what is going on.[or]the little bell at the door rings and someone walks in, throwing you and Bastet wide-eyed glances while she buys something from Nermine.[or]Anktepi again and again tries to look away, but can't help himself from throwing you envious looks.[at random]";
		WaitLineBreak;
		say "     Soon, you have pushed Bastet too far to just keep silent anymore - she is panting openly now, with her claws having fully sunk into the wooden paneling of the wall to keep her standing upright. What a delicious situation with your eager sex-kitten of a lioness. A broad grin spreads over your face as you move your second hand to her crotch too, putting a finger right on her clit and starting to rub it in circling movements. Now rubbing and stroking Bastet at the same time, you continue to wind her up and give a few admiring comments about her attractiveness and the nice feeling of her pussy around your fingers. As you do so, the lioness lets out a pleased roar, basking in your adoration. You can't help but think that praise and worship must be like a drug - or aphrodisiac - to mystic beings like her.";
		say "     You tease and play with Bastet for a while longer, until you can feel that she is getting really close - at which point you start a full-out attack on her pussy, inserting a third finger to really stretch her out and intensifying the rubbing and kneading of her clit. This treatment is enough to quickly push Bastet past the point of no return, letting out a half-growled moan and shuddering all over, her pussy now really dripping with femcum! You continue to stroke and touch her to prolong her orgasm, resulting in that the fur of her inner thighs gets more than a little soaked, as the sexy woman's juices start trickling down her slender legs. With a teasing whisper about how she looks quite divine right now, you step back from the bound goddess, savoring the comfortable relationship your power over her has grown into.";
		WaitLineBreak;
		say "     Bastet keeps standing facing the wall for a long time, her head bent as she pants out loud. Then eventually, she carefully retracts her claws, moving slender fingers to get the stiffness of prolonged tension out of them. Whirling around, the cat goddess looks over at you and smiles in satisfaction. Then she glances past your position and says with a purr, 'Anktepi, come help clean me up.' The little fennec is quick to rush to her side, kneeling in front of his mistress to lick her inner thighs clean of femcum. He gives her fur and pussy a devoted tongue-bath, all the while beaming with a beatific smile. After giving him a good long while of lapping at her sex - a little longer than strictly needed to just clean her up - the lioness taps her priest's head lightly and tells him, 'That is enough. You too have pleased me, Anktepi.' Stroking his cheek affectionately for a second, she then shoos him away, putting on her dignified mask of divine superiority once more.";
		say "     Quite a satisfying experience with the lioness, and you're fairly certain that you've risen in [bold type]Bastet's esteem a little bit more[roman type] as she liked you getting her off.";
		project Figure of Bastet_smile_naked_jewelry_icon;
		increase BastetApproval by 1;

to say BastetSex4: [vaginal sex]
	if BastetApproval < 4: [grudging missionary]
		say "     You let your gaze wander over her tight sheath-dress and its semitransparent sections. Then, you step up to the lioness and slide an arm around her body, pulling the attractive woman closer and giving her a demanding kiss on the muzzle. She tenses in your grasp, but calms her emotions a second later, well aware that she cannot deny your advances. You make out with Bastet for a moment or two longer, then slide both hands up the sides of her body and give her breasts a little squeeze. Leaning close to one of her pointy ears, you whisper into it that you want to fuck her. The lioness's eyes flare a little at the demand, but Bastet obeys after a moment of hesitation, looking for a spot where you could do the dirty deed. With a smirk, you tell her that you'll take her right on the store counter. This causes a little gasp to come from the side - glancing that way, you see Anktepi stand there, the devoted priest and servant of your bound goddess.";
		say "     Your grin spreads all over your face as you watch the lioness stride over to the counter, then sit upon its edge. Joining her, you hike up the lower edge of the lioness's dress, sliding it up to reveal the glorious rise of her pubic mound, and the slightly wet pussy lips beneath. Bastet is naked underneath the kalasiris, most likely because the ancient Egyptian goddess isn't used to panties - or just maybe because she anticipated further sexual demands from yourself. Putting one hand between her legs and pushing up against her crotch, you encourage her to raise her hips, allowing you to slide her dress up even higher, revealing all of her hips and tummy. Stepping back from where the proud lioness is sitting and watching her tail twitch and beat from side to side in obvious annoyance, you don't even try to suppress a chuckle before you taunt her a little, saying that she should try to keep her composure and not totally embarrass herself during what comes next.";
		WaitLineBreak;
		say "     Sliding a hand between Bastet's thighs, you stroke it up the inside of her leg until you reach the lioness's pussy waiting for you. Her soft-furred body feels warm to your touch, as do the slightly spread folds of her sex. Stroking over it, you hear the feline woman suck in a little breath, suppressing a moan at the touch. Seems like she took your challenge, intending to keep her control and endure your stroking. We'll see about that, you think to yourself and give her another caress, from the sensitive nub of her clit over her folds all the way to the narrow valley between her furry buns. Pressing in against her pucker with the tip of a finger draws a gasp of surprise. With Bastet distracted a little, you abandon the feint at her back door to suddenly slip a finger knuckle-deep into her sex. 'Fuck,' she murmurs under her breath as you penetrate her body, the claws on her hands scratching over the counter-top.";
		say "     You proceed to finger Bastet for a little while, making sure she is wet and ready. Then you step back from her and strip yourself, grinning at the woman as she gives you a high-nosed glare. But even while she wears that look of disdain, you know she is aroused - and the feminine juices still wet on your fingers prove it! Soon, you're naked before her, and wipe off the femcum on your [Cock of Player] shaft, stroking it in anticipation. Then you step up to your reluctant partner and push her legs apart even farther, lining yourself up with her sex. Holding her steady with one hand resting on her golden-brown thigh, you feel the tremble of her muscles as you rub your cock-head against her folds. Up and down, you stroke your manhood over her and feel the wetness of her sex spread over your erection. You savor being able to do this to the proud lioness, especially as [one of]someone wanders past the shop window, glancing inside and seeing with a big-eyed expression what is going on.[or]the little bell at the door rings and someone walks in, throwing you and Bastet wide-eyed glances while she buys something from Nermine.[or]Anktepi again and again tries to look away, but can't help himself from throwing you envious looks.[at random]";
		WaitLineBreak;
		say "     Soon, you have pushed Bastet too far to just keep silent anymore - she is panting openly now, with her claws leaving scratches on the counter-top. What a delicious situation to put the sexy woman in. A broad grin spreads over your face as you finally press forward, nudging her nether lips apart to sink your cock into her sweltering depths. The sudden penetration breaks her resistance completely and the store is filled by a loud mrowl that you'd expect from a feline in heat. Her sex is warm, wet and oh so very welcoming for your conquering shaft, stretching tight around the intruding member. Sliding deeper and deeper into her, you continue to advance till your crotch is flush against hers and you can feel the warmth of her fur against your skin. Leaning forward to give her a full-on kiss on the open muzzle, you can't suppress a few teasing comments about 'someone' starting to appear more like a bitch in heat than a goddess. As you do so, the lioness suppresses her sounds of arousal for a little while, but then your next hard thrust, and the next, makes them burst out between her lips once more.";
		say "     You tease and play with Bastet for a while longer, sliding in and out of her squelching sex, until you can feel that she is getting really close. At that point you start a full-out attack on her pussy, really pounding your prick into her and stretching her insides. This treatment is enough to quickly push Bastet past the point of no return, letting out a half-growled moan and shuddering all over, her pussy now really dripping with femcum! You continue to thrust into her twitching and wet passage, the sensations prolonging her orgasm - and getting you yourself quite close of course. A few more deep penetrations and you reach your own climax, burying your erection as deep as it will go and sending spurts of creamy cum into her. Leaning forward against the counter since you don't trust your trembling legs in the moment, you steal another kiss from the panting lioness. Between both of your climaxes, the fur of her inner thighs is thoroughly soaked, both with the sexy woman's juices as well as your own load squelching out of her in your follow-up thrusts.";
		WaitLineBreak;
		say "     After your orgasm runs its course and the further spurts of cum ebb off, you rest a little while longer against Bastet, just enjoying the feel of being inside her and the warmth of her fur against your naked form. Then, with a teasing whisper about how she looks quite divine right now, you step back from the bound goddess, savoring the power you have over her like a sweet wine. Bastet looks after you and pants loudly, outrage and lust warring against each other in the expression on her face, then she gives in to the exhaustion of a hard fuck and sinks back to lie on the counter to catch her breath. While you get dressed, she just lays there, breathing hard and with your seed slowly dripping out of her pussy.";
		say "     Eventually, a barb from Nermine about 'offering her services to customers if she continues to present herself like that' makes Bastet sit up with a hiss, then slide from the counter and pull her dress into place again. The cat goddess hisses at Nermine and looks over to you with narrowed eyes, walks back to her accustomed position of guarding the store, passing you with a grudging huff. Quite a satisfying experience with the lioness, but you're fairly certain that [bold type]Bastet resents you more[roman type] now.";
		project Figure of Bastet_neutral_naked_jewelry_icon;
		decrease BastetApproval by 1;
	else: [joyful missionary]
		say "     You let your gaze wander over her tight sheath-dress and its semitransparent sections. Then, you step up to the lioness and slide an arm around her body, pulling the attractive woman closer and giving her a demanding kiss on the muzzle. She melts into your grasp, leaning forward to brush her body against your front, with her arms wrapping around you all of their own and embracing you. Making out with Bastet for a moment or two longer, you then slide both hands up the sides of shapely form and give her breasts a little squeeze. The bound goddess purrs loudly as you man-handle her this way, well-amicable with letting you touch her by now. Leaning close to one of her pointy ears, you whisper into it that you want her under you, stretched out and with her legs spread. Bastet chuckles at the lust audible in your voice, and after only a slight moment of hesitation, she takes your hand and starts for the doorway leading into Nermine's back room.";
		say "     This causes a little gasp to come from the side - glancing that way, you see Anktepi stand there, the devoted priest and servant of your bound goddess. You give him a grin and a wink, then step into the other room with Bastet, where the two of you gravitate towards the mattress Nermine has laid out there. As the sexy lioness starts to hike up the lower edge of her dress, sliding it up to reveal the shapely form of her furry buns and the base of her tail, you can hear her mutter under her breath, 'Gonna fuck [ObjectPro of Player] right on that bitch's bed.' Seems like the antipathy between the two females plays right into your cards right now. Bastet is naked underneath the kalasiris, most likely because the ancient Egyptian goddess isn't used to panties - or just maybe because she anticipated further sexual pleasures yet to come. With bated breath, you watch her strip slowly and enticingly, eventually dropping the sheer dress on the floor.";
		WaitLineBreak;
		say "     Running a hand up to her nipples and circling one of them with a finger, the lioness throws you a sexy look, then turns around and bends forward, presenting presenting her ass and the sweet pussy between her legs. The show arouses you more than just a little bit, and while you quickly get rid of your own clothes and gear, Bastet lays down on the comfortable blankets and pillows of Nermine's bed, stretching out luxuriously as she waits for you. Looking down at the proud lioness, naked and ready as she is, you tell her with conviction that she is the sexiest goddess you ever met. Bastet replies with a deep purr, looking at you and opening her legs a little bit more, inviting you to get between them. And that is exactly what you do, kneeling on the mattress in front of the sexy female, yearning to touch her.";
		say "     Sliding a hand between Bastet's thighs, you stroke it up the inside of her leg until you reach the lioness's pussy waiting for you. Her soft-furred body feels warm to your touch, as do the slightly spread folds of her sex. Stroking over it, you hear the feline woman suck in a little breath, suppressing a moan at the touch. Seems like she intends to keep her composure as long as possible - she is a proud woman, after all. You idly wonder to yourself how long she will be able to last and give her another caress, from the sensitive nub of her clit over her folds all the way to the narrow valley between her furry buns. Pressing in against her pucker with the tip of a finger draws a gasp of surprise. With Bastet distracted a little, you abandon the feint at her back door to suddenly slip a finger knuckle-deep into her sex. 'Fuck,' she murmurs under her breath as you penetrate her body, the claws on both hands digging a little into the sheets and mattress beneath.";
		WaitLineBreak;
		say "     You proceed to slide your finger in and out of the lioness, then add another one, now both of them stroking and touching her on the search for the most sensitive spots of your feline partner. Bastet controls herself quite well, her face seemingly unwavering even as her pussy is finger-fucked - but you know better, as you feel the tremble of her muscles where your other hand is resting on a golden-brown thigh. Continuing to finger her with increasing tempo, you a pleased to note that the anthro lioness gets more aroused by the second, with her sex soon being wet enough for her fluids to trickle over your knuckles and soak the sheets beneath. You savor being able to do this little game with the proud lioness, especially as [one of]Nermine throws a glance into the room, slightly annoyed that Bastet gets to enjoy her bed.[or]the head of Anktepi pokes through the doorway, staring wide-eyed at what is going on.[at random]";
		say "     Soon, you have pushed Bastet too far to just keep silent anymore - she is purring openly now, enjoying every touch and stroke. What a delicious situation to put the sexy woman in. A broad grin spreads over your face as you finally line your manhood up with her sex and press forward, nudging her nether lips apart to sink your cock into those sweltering depths. Sliding deep into the lioness, you grunt out admiring comments about her attractiveness and the amazing feeling of her pussy around your [Cock of Player] shaft. As you do so, Bastet lets out a pleased roar, basking in your adoration. You can't help but think that praise and worship must be like a drug - or aphrodisiac - to mystic beings like her. The lioness's sex is warm, wet and oh so very welcoming for your conquering shaft, stretching tight around the intruding member. Sliding deeper and deeper into her, you continue to advance till your crotch is flush against hers and you can feel the warmth of her fur against your skin.";
		WaitLineBreak;
		say "     Leaning forward to give her a full-on kiss on the open muzzle, you make out with the purring goddess and are embraced by her, with Bastet's arms and legs wrapping around your body to hold you close. Entwined like that, you fuck her, humping the sexy feline on the soft sheets of the bedding. Moans, grunts and roars fill the back room, and you have to grin as you think what a customer coming into the store right now must think. You tease and play with Bastet for a long while, sliding in and out of her squelching sex, until you can feel that she is getting really close. At that point you start a full-out attack on her pussy, really pounding your prick into her and stretching her insides. This treatment is enough to quickly push Bastet past the point of no return, letting out a full-on roar of lust and need, shuddering all over and her pussy now really dripping with femcum!";
		say "     You continue to thrust into her twitching and wet passage, the sensations prolonging her orgasm - and getting you yourself quite close of course. A few more deep penetrations and you reach your own climax, burying your erection as deep as it will go and sending spurts of creamy cum into her. Leaning forward to share another eager kiss with the panting lioness, you breed her good, really pumping your heavy load into Bastet. Between both of your climaxes, the fur of her inner thighs is thoroughly soaked, both with the sexy woman's juices as well as your own load squelching out of her in your follow-up thrusts. After your orgasm runs its course and the further spurts of cum ebb off, you rest a little while longer against Bastet, just enjoying the feel of being inside her and the warmth of her fur against your naked form. Then, with a teasing whisper about how she looks quite divine right now, you pull out of the bound goddess, savoring the comfortable relationship your power over her has grown into.";
		WaitLineBreak;
		say "     Bastet keeps lounging on the mattress for a long time, enjoying the comfort of the bedding at the same time as not doing anything to stop your load from leaking out of her pussy and seeping into the sheets and mattress. She is well-pleased now, sexually and by sticking it to Nermine. Stretching out on the mattress, she revels in the looks she draws from you - and not only you, as Bastet eventually purrs out, 'Anktepi, come help clean me up.' The little fennec that had been peeking into the room from behind the doorframe is quick to rush to her side, kneeling in front of his mistress. There is no hesitation at all for him as he leans down and starts to lick her inner thighs clean, slurping up femcum as well as your own load. He gives her fur and pussy a devoted tongue-bath, all the while beaming with a beatific smile.";
		say "     After giving him a good long while of lapping at her sex - a little longer than strictly needed to just clean her up - the lioness taps her priest's head lightly and tells him, 'That is enough. You too have pleased me, Anktepi.' Stroking his cheek affectionately for a second, she then shoos him off to grab her dress and help her get dressed again, putting on the dignified mask of divine superiority once more.";
		LineBreak;
		say "     Quite a satisfying experience with the lioness, and you're fairly certain that you've risen in [bold type]Bastet's esteem a little bit more[roman type] as she liked you getting her off.";
		project Figure of Bastet_smile_naked_jewelry_icon;
		increase BastetApproval by 1;

to say BastetSexBattleRepeats:
	now BastetSexBattleCount is 0;
	say "     Letting your gaze wander down over her tight sheath-dress and its semitransparent sections for a second, you then clear your throat and look up at the waiting lioness. In a calm tone, you tell her that you want to challenge her for another round of the contest you previously had with each other. 'What? N-no. My goddess! I - she... what makes you think she would agree to that?' comes an interjection from Bastet's faithful disciple Anktepi, the smallish fennec stepping up to you in obvious agitation. He may be unimposing, but there is little doubt of his devotion as he stands in front of you, trembling slightly at possibly attracting your wrath. But there is no need to do anything to him - as you smile and raise your hand, counting off the reasons Bastet will agree: 1) She a proud being and can't resist a challenge. 2) There's no doubt that she thoroughly enjoyed the last time. 3) You'll tell Nermine to cut out her little 'games' of teasing Bastet for a full day - even if you win over the lioness. 4) With the -";
	say "     Bastet interrupts, 'Enough. You're right.' Anktepi's ears droop a little as he whirls around, looking up at his mistress. The lioness pets his head and strokes a paw-hand over his cheek gently as she says, 'Your concern is appreciated, but not needed, my trusted servant.' With a sniffle of quiet despair, the fennec steps aside, allowing Bastet to looking you up and down with an evaluating expression. As she does so, you see the cat goddess's nostrils flare as she takes in the scent of your jackalman body - and interest flares up in her eyes. ";
	if Player is submissive:
		say "It seems like there was some hint of your submissive nature in what Bastet smelled too, as the lioness subtly changes her stance, a small smile playing over her lips. Seems like she expects an easy victory.";
		LineBreak;
		project Figure of Bastet_smile_dress_seethrough_icon;
		decrease BastetSexBattleCount by 1;
	else if "Dominant" is listed in feats of Player:
		say "It seems like there was some hint of your dominant nature in what Bastet smelled too, as the lioness subtly changes her stance, a small smile playing over her lips. Seems like she is getting ready for the challenge you'll prove to be, all the while panting slightly from the first hint of arousal.";
		LineBreak;
		project Figure of Bastet_smile_dress_seethrough_icon;
		increase BastetSexBattleCount by 1;
	else:
		LineBreak;
	say "     Well, let's get the action started then:";
	LineBreak;
	say "     [link](1)[as]1[end link] - Lean in and give Bastet a gentle kiss.[line break]";
	say "     [link](2)[as]2[end link] - Pull her close and show who's the boss here right from the start.[line break]";
	now calcnumber is 0;
	while calcnumber < 1 or calcnumber > 2:
		say "Choice? (1-2)>[run paragraph on]";
		get a number;
		if calcnumber is 1 or calcnumber is 2:
			break;
		else:
			say "Invalid choice. Type [link]1[end link] to gently kiss Bastet or [link]2[end link] to pull her against you and be a bit more offensive in your attention to the lioness.";
	if calcnumber is 1: [gentle kiss]
		LineBreak;
		say "     Leaning in to the lioness, you slide a hand gently over her shoulder, touching the back of Bastet's head as you give her a kiss on the mouth. She does readily return it and slowly brushes slender, clawed fingers over your arms as you continue making out for a moment. There even is a little bit of tongue-wrestling, with your own rubbing against the slightly rough surface of her feline tongue. Then suddenly, the moment is over and Bastet pulls back from you slightly, giving a flicker of a smile for how easily she got you worked up and breathing hard.";
		project Figure of Bastet_smile_dress_seethrough_icon;
		decrease BastetSexBattleCount by 1;
	else if calcnumber is 2: [go for the grope]
		LineBreak;
		say "     Wrapping an arm around the lioness, you confidently plant your hand on her shapely rump before pulling her body close against your own with a sudden tug. There is the start of a surprised yowl from the cat goddess at you being so forward with her divine self - but that is instantly quelled as you draw her head to yours with the other hand and plant a deep kiss on her lips. Sliding your tongue into the still shocked woman's mouth, you encounter her somewhat rough tongue and playfully wrestle with it. Your confident action is enough to draw the lioness into a sexy bout of making out, melting into your touch as you grope and caress her body at the same time. Eventually, after having some amazing moments with the cat goddess in your arms, you pull back, leaving Bastet to stand before you, panting and flushed.";
		project Figure of Bastet_neutral_dress_seethrough_icon;
		increase BastetSexBattleCount by 1;
	LineBreak;
	say "     Pleasant as it may be, there is no way anyone would spend all their time with a sexy lioness like Bastet simply making out - and both of you know it. The cat goddess takes a step back and weaves her lithe body in a sinuous, very enticing way, accompanied by graceful movements of her lightly muscled arms and legs. Her little show pulls all attention to the form-fitting kalasiris she wears, with the skin-tight tube dress providing sexy glimpses of Bastet's body. Consisting of very finely woven cloth, the garment seems almost transparent in places, letting you make out that beside the perky breasts with their little nipple-bumps up on her chest, the lioness has another set of two further down, their pale skin shining out of the golden fur all around. All in all, Bastet a very pleasant sight to look at, making you more than a little eager to see her fully naked.";
	LineBreak;
	say "     [link](1)[as]1[end link] - Take matters into your own hands, undress Bastet and caress her body.[line break]";
	say "     [link](2)[as]2[end link] - Just enjoy the show, letting Bastet proceed to a sexy strip show.[line break]";
	now calcnumber is 0;
	while calcnumber < 1 or calcnumber > 2:
		say "Choice? (1-2)>[run paragraph on]";
		get a number;
		if calcnumber is 1 or calcnumber is 2:
			break;
		else:
			say "Invalid choice. Type [link]1[end link] to strip Bastet yourself or [link]2[end link] to let her perform a strip show.";
	if calcnumber is 1: [grabby hands]
		LineBreak;
		say "     Stepping up to the lioness, you bring your hands forward to touch her shapely form, stroking them up and down over her tight dress while she sways her body some more, brushing those curves against you. Bastet can't help but give a little moan as you cup her breasts and lightly stroke the hard nipples showing so clearly through the almost-transparent material of her dress. Next, you slide your hands hand along the soft fur on the curve of her neck, then behind it, feeling for where the two strands holding up her dress are tied at the back. You find what you are looking for and undo the binding with a gentle tug, then slide your hands back to the beautiful feline's front, hooking your fingers under the fabric of her dress just below the armpits.";
		say "     As you start pulling down slowly, slowly, the sexy lioness takes up her enticing gyrations once again, making it an incredible show as inch by inch of the golden-furred female's breathtaking body is revealed. First the gentle rise of her chest below the collarbones, continuing on and on to the peak of her shapely breasts and their small, hard nipples, then the sharper curves of their underside, just asking for your hands to cup them. Continuing down, the next thing coming into sight is the lightly muscled expanse of her belly, complete with two more nipples waiting to be suckled on at the upper end, a small belly button and even a hint of visible abs on the trained body of this attractive lioness.";
		say "     Finally, your hands push the bunched up cloth down over the widest part of her hips and the dress falls to the floor completely, revealing her final treasure between those long legs - the delicate flower of her female parts. Breathing a bit faster from your sheer proximity and touch, the cat goddess says the word, 'Anktepi' almost in a sigh, calling over her servant to pick up her dress as she lifts her delicate paw-feet to step out of it. With the Fennec still crouched by your feet, the bundle of light fabric in his hands, you clear your throat to make him look up, smiling as you brush a hand over his mistress's crotch and slightly pull open her outer folds. In front of the slender male's widening eyes, you dip in a finger to feel how very wet she is, then demonstratively rub it against your thumb, pulling the digits apart slowly to show off a string of Bastet's fluids stretching from one to the other. And then, you give a sharp nod to the side, relegating Anktepi back to his spot as an observer after getting this enticing a look - and smell - of his goddess's.";
		project Figure of Bastet_neutral_naked_jewelry_icon;
		increase BastetSexBattleCount by 1;
	else if calcnumber is 2: [strip show]
		LineBreak;
		say "     You simply stand back, watching as the lioness sensuously strokes her hands up and down over the tight dress while swaying her body some more, then eventually slides them up, cupping her own breasts and stroking their nipples lightly while giving a demonstrative moan. Next, she slides a hand along the soft fur of her neck and behind it, pulling open the knot of the one strand of fabric that holds her dress up. As you watch in eager anticipation, the sexy lioness takes up her enticing gyrations once again while taking hold of the fine fabric of her garment at the hips and slowly, slowly pulling down on it. Inch by inch of the golden-furred female's breathtaking body is revealed - first the gentle rise of her chest below the collarbones, continuing on and on to the peak of her shapely breasts and their small, hard nipples, then the sharper curves of their underside, just asking for your hands to cup them. Continuing down, the next thing coming into sight is the lightly muscled expanse of her belly, complete with two more nipples waiting to be suckled on at the upper end, a small belly button and even a hint of visible abs on the trained body of this attractive lioness.";
		say "     Finally, her hands push the bunched up cloth down over the widest part of her hips and the dress falls to the floor completely, revealing her final treasure between those long legs - the delicate flower of her female parts. Bastet bends over to pick up her dress slowly, making sure you get to see all of her shapely assets presented in a very enticing way. After casually throwing the light garment to Anktepi for him to hold onto, the lioness walks closer, swaying her hips and drawing your eyes to her crotch with a hand that slightly pulls open her outer folds. Arriving just before you, she gives an almost challenging mrowl and takes your hand, setting it on top of her pubic mound before pushing it down slowly. Oh yeah, you can feel it - she's already slightly wet, getting ready for fun with you. Though if you're honest with yourself - your own arousal has soared quite a bit too during Bastet's sexy strip show. You'll have to watch yourself if you actually wanna win this contest of who gets the other off first.";
		project Figure of Bastet_smile_naked_jewelry_icon;
		decrease BastetSexBattleCount by 1;
	LineBreak;
	say "     Standing this close to the naked cat goddess, the wetness of her sex already on your fingers, you're of course very eager to continue with more fun. For now, you think touching her pussy some more should be the next step - but what will you do with the panting lioness?";
	LineBreak;
	say "     [link](1)[as]1[end link] - Slide two (or more) fingers deep into her body, rubbing Bastet's inner walls and stretching her.[line break]";
	say "     [link](2)[as]2[end link] - Concentrate on the clit at the top, rubbing its small button while also stroking her folds.[line break]";
	say "     [link](3)[as]3[end link] - On second thought... why not fuck her right now instead?[line break]";
	now calcnumber is 0;
	while calcnumber < 1 or calcnumber > 3:
		say "Choice? (1-3)>[run paragraph on]";
		get a number;
		if calcnumber is 1 or calcnumber is 2 or calcnumber is 3:
			break;
		else:
			say "Invalid choice. Type [link]1[end link] to penetrate and stretch Bastet with your fingers, [link]2[end link] to concentrate on rubbing her clit or [link]3[end link] to proceed straight to fucking.";
	if calcnumber is 1: [put some fingers in her]
		LineBreak;
		say "     Sliding your hand over the sexy lioness's pussy, you feel her soft and slightly open nether lips, spread them some more with your fingers, then push two of them deep into her, making Bastet's eyes go wide at the sudden penetration. The passage you're feeling your way into is warm and wet, clenching around the invading digits as her breath comes quicker from the arousing sensations you lavish on her. In and out, you guide your fingers, replacing a cock's thrusting with an intimate, sensitive strength as you work into her pussy again and again, driving the cat goddess to lust-filled mews with your efforts. Meanwhile, your other hand comes to rest on the shapely boobs the lioness sports cupping and caressing them, as well as stroking over the nipples.";
		say "     It does take a little bit of experimentation, but you do find a very sensitive spot deep inside that makes the sexy feline's legs almost buckle under her as you brush against it. Eventually, after some fun time fingering Bastet, you do pull your hand back, leaving her oh so very much turned on - and yourself almost as much at the same time, after so much groping and touching. Doesn't seem like you've made much headway in this step of the sex battle, but it's been a fun thing to do nonetheless.";
		project Figure of Bastet_smile_naked_jewelry_icon;
		decrease BastetSexBattleCount by 1;
	else if calcnumber is 2: [stroke the clit]
		LineBreak;
		say "     Sliding your hand over the sexy lioness's pussy, you feel her soft and slightly open nether lips, spread them some more with your fingers, then dip in a single finger to gently rub her passage. Bastet's eyes go wide at the sudden touch of her inner folds, then even wider, as you abandon the 'obvious' target of a finger-fuck to concentrate on the little nub that is her clit. A single brush over the sensitive little button draws a breathless mew from the feline beauty, which makes way for even louder gasps and aroused sighs as you set your index finger on it and start a circling movement, giving the lioness an intimate massage. Holding back from the more 'active' fun of thrusting into her pussy with your digits, you simply concentrate on driving Bastet out of her mind with pleasure, rubbing and stroking - down at her clit, and the quartet of small pink nipples up on her breasts and the upper chest below those.";
		say "     The attentive work with your fingers pays off quite quickly, winding Bastet up sexually in a really big way. She pants and meows at your touch, even purring for a moment in between, and soon has to take hold of your body to even stand straight, her legs almost buckling as pleasure and sex take over as new priorities for her body. Looks like you've got the feline well and ready for the real deal by now.";
		project Figure of Bastet_neutral_naked_jewelry_icon;
		increase BastetSexBattleCount by 1;
	else if calcnumber is 3: [fucking]
		LineBreak;
		say "     With Bastet already this wet and ready, you decide that there isn't much need for further one-sided foreplay after all. Time for the real fun...";
	LineBreak;
	say "     Pulling back a little from the sexy lioness, you quickly get busy removing your gear and clothes, throwing most of it simply aside as fast as possible as you set a new record for stripping down. And then, as soon as you are as naked as your feline partner, Bastet goes into the offensive, almost pouncing on you in her eagerness to win your little contest and reclaim her artifacts from Nermine. Though given the foreplay you've been through already, there is a definite edge of bodily need to her actions as well, which makes sharing hungry kisses with her all the more delicious. Wrapping herself around you in a tight embrace, the cat goddess aggressively makes out with you, giving lusty little growls as her nipples brush against your chest.";
	if Player is male:
		say "     With your pointy jackalman shaft standing rock-hard and ready, poking Bastet in the stomach as she presses against you, the next level of escalation she chooses is to grab your shoulders to brace herself, then swing a very flexible leg up and hook it around your hips - so she can slide herself down on your erection. You moan a satisfied grunt into her mouth as the lioness's slick and warm passage envelops your member deeper and deeper, then finally all the way and your balls press against her crotch. The two of you grind against each other for several moments while standing, gasping out shared moans as you get used to feeling the other inside - or around - you, then ";
		if BastetSexBattleCount > 2 or (BastetSexBattleCount is 2 and a random chance of 1 in 2 succeeds): [player won]
			say "you grab Bastet's furry butt with one hand, hooking the other under the lioness's still standing leg to pull her into your arms fully. The cat goddess gives a needy mrowl as you pick her up, grinding her crotch tightly against your own in the progress. A series of aroused little meows follow as you carry her over to the store counter, your hard shaft rubbing her insides in new and exciting ways with each step you take, then gently lay her down on top of it, giving the sexy feline a long kiss as you do.";
			say "     As you eventually break the lip-lock with the golden-furred female, you straighten yourself and look down into her slitted eyes, giving Bastet a superior grin - then pull partway out and thrust deep in a lightning-quick move. She throws her head back and roars like a lioness in heat as you take her hard, her eyes rolling up in their sockets at the intense sensations of a powerful male mating with her. Fucking the beautiful woman on Nermine's store-counter, with her tight passage trembling and flexing around your erection, you can't help but think back to when you took the jackaless in just this very spot, and just how much fun you did have taking her while she had to service a customer. The thought of just who that customer was makes you look up from Bastet's breasts as they bounce with each thrust into her, and you seek out Anktepi with your gaze - only to see that the slender fennec has his own cock in hand and is stroking off to his mistress being fucked. Seems like the small guy couldn't help but get aroused at the sight - but he's likely imagining it is him giving it to the magnificent lioness.";
			WaitLineBreak;
			say "     With you clearly on the winning end of this fun little sex-battle, you take a moment to revel in having driven Bastet half out of her mind in arousal, mewling needily with each hard thrust into her pussy. Leaning over the lioness, you make out with her some more, then even catch first one, then the other breast and nibble a little on her nipples - all the while drawing louder and louder moans from the horny goddess. And then, it is time for the grand finale - as you feel the urge to cum rise quickly inside yourself, and you don't want to lose after all by accident. Stroking a hand over Bastet's lower pair of nipples, then the flat tummy and down to her crotch, you rub her clit while still keeping up the hard pounding into her, stimulating the lioness most sensitive spots at the same time, inside and out.";
			say "     Helpless against this lustful assault on her senses, Bastet's simply can't hold back anymore, and with a loud yowl, she starts to orgasm, writing under you in boundless pleasure. Her tight passage around your thrusting shaft ripples and flexes as the beautiful female barrels past the point of no return, forfeiting this round of sexual battle to you. With the satisfaction of victory lifting your already very high spirits, it does take but a moment till you join her in climax, driving your shaft deep just as the knot at its base swells up and locks the two of you together. Then the first splash of your seed bursts into her body to claim her as yours. Half-collapsing on top of Bastet as the orgasm rocks through your body, you grunt with each further spurt of cum deposited in her fertile womb.";
			WaitLineBreak;
			say "     As you yourself slowly come down from the height of arousal, the sound of rapid panting and low fapping noises draw your attention to the side, where Anktepi is frantically jerking himself off, until he soon also gives a breathless little gasp and starts shooting a quite respectable load for such a little guy, the cum landing in long streaks of white splatter on the shop's smooth wooden floorboards. As his climax slowly tapers off and smaller and smaller spurts of cum splat down on the ground, Nermine clears her throat and says, 'Nermine is always happy when her customers enjoy their stay in her store as much as possible, but the dear fennec did create quite a little mess. Looks like Bastet will have to - *Clearing your throat, you interrupt the jackaless and tell her to cut it out. For today, at least. The indentured cat goddess fought honorably - and quite pleasurably - against you, so it is time to show her a little respect at least. A hint of a frown plays over the jackaless's features, then Nermine calms herself again and gives you a nod. 'Of course, [Master].' Meanwhile, Bastet starts purring a little, seemingly aware of her surroundings even in the half blissed-out state you put her in.";
			say "     At the same time, the fennec's reaction to Nermine's little barb is almost priceless - judging from his expression, he must be white as a sheet under the fur all over his anthro form. You can almost see the wheels turning inside his head - the guilt of jerking off as his goddess lost, with Nermine having planned to make her wipe up his cum. Even though you stopped her, Anktepi throws himself on the ground, wiping up the white cum in frantic haste, using his hands and the fur of his forearms. As soon as he's done, the fennec gives Nermine a pleading look and gasps out, 'I - I apologize for... ehm...' The storekeeper just chuckles at his embarrassment, pulling his head up with a finger under his chin. 'The gentle fennec does have no need to worry. He is a valued customer after all and should feel free to enjoy the wares and sights of this jackal's store to the fullest.' As she then reaches further down and gives his balls a little squeeze, the little guy yips in shock and sprints to the door, leaving the store with the ring of its little doorbell.";
			WaitLineBreak;
			say "     Nermine's face bears the deceptively mild smile you've come to expect from the merciless businesswoman as she saunters over to you, swaying the hips and chest of her naked body for you to enjoy. 'Nermine must congratulate her handsome master,' the jackaless says and leans in to give you a kiss, then she continues, 'Another victory through his great skill.' To accompany the sentence, she indicates the semiconscious lioness still impaled on your shaft, then the door through which Anktepi fled not long ago. The black-furred jackaless presses herself against your side, drawing you into a long bout of making out. As she eventually pulls back to let you take a breath, a wicked little smile plays over Nermine's muzzle and the jackaless says, 'Watch this, master.'";
			say "     With that, the sexy canine leans forward and caresses Bastet's breasts, giving you the quite enjoyable image of seeing her black-furred hand covering a perky golden breast of Bastet's naked body. The jackaless even goes on to lap at the supine lioness's nipples, drawing some soft mews from the soon squirming Bastet, then bringing together both their canine and feline muzzles to kiss the vanquished goddess. Gripping the counter with her hands, Bastet moans and... gets a bit wetter around your shaft, clearly showing that she can't help but react to the stimulation. Though it isn't without being somewhat annoyed about her own bodily weakness in regards to sexual matters - as the next words from Bastet's throat are, 'You bitch!' Nermine just chuckles at that and plants a kiss on Bastet's lips again, which the lioness reluctantly returns. 'What astute observation. Nermine is indeed her master's loyal bitch.'";
			WaitLineBreak;
			say "     Nermine gets back to making out with the not quite willing, but still really wound up Bastet, which is a truly awesome sight with the contrast between their fur colors. With the fun show to watch, it does take quite a while till eventually your knot softens far enough to be pulled out of Bastet's freshly bred pussy. 'Nermine will of course honor her master's commands and... leave the goddess alone for now. It is a little bit of a waste, as there are numerous uses for divine... fluids and Nermine has many tasks that Bastet could do...' It is clear that she is fishing for you to change your mind, but you shake your head with a steely gaze. As you start pulling your clothes back on, Nermine turns away from Bastet with a little sigh, wandering over to the other side of the store to rearrange the contents of a shelf.";
			say "     From where she's still lying on the counter, [bold type]Bastet gives you a tiny nod of approval.[roman type] This approach to getting to have some fun is definitely easier to accept for the indentured goddess than you just ordering her to do so.";
			increase BastetApproval	by 1;
		else: [Bastet won]
			say "Bastet purrs in a commanding voice, 'Lie down.' Horny as you are, you can barely think straight, so you obey, bracing yourself with your arms as you lower yourself to the ground. While you do so, Bastet demonstrates just how flexible and skilled in gymnastics she is - by keeping your canine cock buried in her tight pussy all the way, even as you stretch and move. Eventually, you're more or less lying on your own discarded clothing, with the golden-furred feline straddling your hips and rocking back and forth in the most... stimulating way.";
			say "     A satisfied little roar comes from the lioness's muzzle as she takes full control of the situation, leaning forward and pinning your arms to the ground as she grinds her crotch against yours. Satisfied, lust-filled mrowls soon follow, each time she makes your cock bottom out and brush against very sensitive parts deep inside her tight pussy. Its such a sexy and breathtaking situation that you quickly feel the urge to cum rise deep inside you and close your eyes to await the impending orgasm - only to have Bastet stop her movements from one moment to the next. The lioness looks down at your nonplussed face with a chuckle on her lips, then gives you a little flex of her internal muscles that makes you pant needily - only to stop right after. Seems like this cat wants to play a little with you before she finishes you off.";
			WaitLineBreak;
			say "     Leaning forward, Bastet flashes sharp teeth at you, then runs her somewhat rough tongue over your [Body of Player] chest. She goes up and up, arriving at your head before long, which leads to several nice moments of her making out with you, if in a somewhat demanding fashion. Then finally, the cat goddess gives you a 'love-bite', nipping the side of your neck with her teeth before going back to full on grinding against your body. It is obvious that the feline does enjoy herself more than just a little bit - so much so that she even takes short breaks to let you cool down a little - which helps push back the inevitable orgasm she's been prepping you for since this whole matter started.";
			say "     Riding your hard pole with relish, Bastet moans and purrs in lust and you can feel her become just a bit wetter with each deep penetration. As your urge to cum wells up quite strongly once more, an idea of maybe still being able to win comes into your head, making you buck up against the lioness. And it even is a partial success, as the cat goddess gives an aroused mrowl - both from the deep penetration and a male trying to breed her... but Bastet is more than ready to counter your move. With the flexible grace that is so much part of her golden-furred form, the lioness pushes her hips up, making your canine cock slip out of her body just as the knot begins to expand and long streaks of cum squirt high into the air - only to splat down on yourself, instead of filling her womb. Bastet gives a victorious chuckle and shows a challenging grin to Nermine, then stands up and calls out for her fennec servant. Anktepi literally stumbles in his eagerness to get to her - landing on his knees in front of the lioness and bumping right into her crotch with his muzzle. The aroused goddess takes it in stride and just spreads her legs a little more, then tells her companion to lick.";
			WaitLineBreak;
			say "     And so, the sand-colored fox eagerly services his mistress, lapping happily at her sex and brushing the insides of her thighs with his large ears. Satisfied mews escape Bastet's lips before much longer and her clawed hands hold on to the kneeling male's head as she reaches her own climax, making the lioness pant in lust as her pussy drips and squirts femcum, which Anktepi immediately licks up. Meanwhile, the small guy's hand is rapidly jerking his own manhood, and with a muffled gasp from between Bastet's thighs, he reaches orgasm. A twitch goes through him from muzzle to tail-tip as quite a respectable load for such a little guy starts to spurt out of his cock, the cum landing in long streaks of white splatter on the shop's smooth wooden floorboards.";
			say "     As Bastet slowly winds down and lets go of her devoted fennec, stroking him in satisfaction instead, his spurts of cum splatting down on the ground get smaller and smaller too. Then Nermine clears her throat and says, 'Nermine is always happy when her customers enjoy their stay in her store as much as possible, but the dear fennec did create quite a little mess. Looks like Bastet will have to - *Clearing your throat, you interrupt the jackaless and tell her to cut it out. For today, at least. The indentured cat goddess fought honorably - and quite pleasurably - against you, so it is time to show her a little respect at least. A hint of a frown plays over the jackaless's features, then Nermine calms herself again and gives you a nod. 'Of course, [Master].'";
			WaitLineBreak;
			say "     From your position on the ground, you watch Bastet allowing Anktepi to help her don her dress, then she walks over near the door of the store and takes position there, leaning against the wall relaxedly. As she passes you on the way, the lioness gives you a content look from the corner of her eyes and even adds a little nod. This approach to getting to have some fun is definitely easier to accept for the indentured goddess than you just ordering her to do so. [bold type]You have gained a tiny bit of approval in her eyes.[roman type][line break]";
			increase BastetApproval	by 1;
	else: [females]
		say "     Making out and touching each other quickly escalates to hands sliding lower and lower, then a first brush of your fingers against each other's crotch. Soft stroking against clits and increasingly wet and swollen pussy lips leads to shared moans as your lips are pressed together, with both your tongues wrestling in a slippery dance of shared arousal. Then the next level of escalation is reached as you slip a finger into Bastet's pussy, probing her tight and hot passage while giving a rub to her clit with your thumb. A lusty mrowl escapes the lioness lips and she gets to work on you in turn, showing you some very, very stimulating movements to do with her slender fingers. The mutual groping continues in unabated eagerness until eventually Bastet presses her whole front against you tightly, pushing her shapely breasts to your chest as you join a deep kiss, then ";
		if BastetSexBattleCount > 2 or (BastetSexBattleCount is 2 and a random chance of 1 in 2 succeeds): [player won]
			say "finally, you take control of the situation, turning the lioness around with a quick move, embracing her from behind with one hand on a shapely breast, the other still down between her legs.";
			say "     The cat goddess gives an aroused mew as you assert your dominance, trembling as you touch her sex. As wound up as you got her since your little contest started, now she can't hold back anymore, panting and rotating her hips to grind against your hand. And just like that, you know you finally have her - all that remains is to finish her off. Even though your own pussy isn't getting any direct stimulation right now, you can still feel copious femcum leaking from your [Cock of Player] nethers, to trickle down the inside of your legs. Getting this far with Bastet turns you on so very much. Reveling in the feeling of having the breathtakingly beautiful feline in your power, you really get to work on her - so much so that she has to brace herself against a thankfully very close-by bookshelf to keep her legs from buckling.";
			WaitLineBreak;
			say "     You can't help yourself but tease the lioness a bit, whispering into her pointy ear about not being able to control herself, that she wanted to lose so she could spend time with you and Nermine, then tell her that even her companion thinks that this is the place - and role - she belongs in. With one hand between her legs, your other takes hold of Bastet's muzzle and turns it to the side, then returns to cup her rounded breast. Now the lioness can see Anktepi clearly, see that the fennec is frantically jerking himself off to the show of two females grinding against each other before his very eyes. Then suddenly, a twitch goes through him from muzzle to tail-tip as he gives a breathless pant, just as quite a quite respectable load (for such a little guy) starts to spurt out of his cock, the cum landing in long streaks of white splatter on the shop's smooth wooden floorboards.";
			say "     Whispering into Bastet's ear that it's time for servants to cum now, you proceed with an all-out attack, pushing two fingers ever deeper into her while the other hand rubs and strokes her clit and you nibble at the curve of her neck. It only takes a moment before the combined sensations push Bastet the last little step over the edge, and the lioness trembles in your grasp as she orgasms, gushing femcum over your fingers. Now that you're really and properly won, you decide it is time to get your own release - and start to grind against something quite conveniently already between your legs - the lioness's soft-furred tail. Bastet is still breathing hard as she feels the touch of your nether lips against her tail, then the wet femcum starts to mat her hair against it.";
			WaitLineBreak;
			say "     With the sexy situation being what it is - you enjoying yourself with Bastet, in front of Nermine, her devoted servant Anktepi, and anyone else who might be walking past the shop and look in the window - it doesn't take long at all before you reach a breathtaking climax yourself, gasping loudly as you squirt quite a bit of femcum over her tail. There is a lull in the sex noises filling the store as everyone simply pants for a moment, trying to catch their breaths, then eventually Nermine clears her throat and says, 'Nermine is always happy when her customers enjoy their stay in her store as much as possible, but the dear fennec did create quite a little mess. Looks like Bastet will have to - *Clearing your throat, you interrupt the jackaless and tell her to cut it out. For today, at least. The indentured cat goddess fought honorably - and quite pleasurably - against you, so it is time to show her a little respect at least. A hint of a frown plays over the jackaless's features, then Nermine calms herself again and gives you a nod. 'Of course, [Master].' Meanwhile, Bastet starts purring a little, seemingly aware of her surroundings even in the half blissed-out state you put her in.";
			say "     At the same time, the fennec's reaction to Nermine's little barb is almost priceless - judging from his expression, he must be white as a sheet under the fur all over his anthro form. You can almost see the wheels turning inside his head - the guilt of jerking off as his goddess lost, with Nermine having planned to make her wipe up his cum. Even though you stopped her, Anktepi throws himself on the ground, wiping up the white cum in frantic haste, using his hands and the fur of his forearms. As soon as he's done, the fennec gives Nermine a pleading look and gasps out, 'I - I apologize for... ehm...' The storekeeper just chuckles at his embarrassment, pulling his head up with a finger under his chin. 'The gentle fennec does have no need to worry. He is a valued customer after all and should feel free to enjoy the wares and sights of this jackal's store to the fullest.' As she then reaches further down and gives his balls a little squeeze, the little guy yips in shock and sprints to the door, leaving the store with the ring of its little doorbell.";
			WaitLineBreak;
			say "     Nermine's face bears the deceptively mild smile you've come to expect from the merciless businesswoman as she saunters over to you, swaying the hips and chest of her naked body for you to enjoy. 'Nermine must congratulate her handsome master,' the jackaless says and leans in to give you a kiss, then she continues, 'Another victory through his great skill.' To accompany the sentence, she indicates the semiconscious lioness still leaking femcum to mat the fur of her crotch and legs, then the door through which Anktepi fled not long ago. The black-furred jackaless presses herself against your side, drawing you into a long bout of making out. As she eventually pulls back to let you take a breath, a wicked little smile plays over Nermine's muzzle and the jackaless says, 'Watch this, master.'";
			say "     With that, the sexy canine leans forward and caresses Bastet's breasts, giving you the quite enjoyable image of seeing her black-furred hand covering a perky golden breast of Bastet's naked body. The jackaless even goes on to lap at the lioness's nipples, drawing some soft mews from the soon squirming Bastet, then bringing together both their canine and feline muzzles to kiss the vanquished goddess. Gripping the shelf with her hands, Bastet moans and... gets a bit wetter yet, a little squirt of femcum clearly showing that she can't help but react to the stimulation. Though it isn't without being somewhat annoyed about her own bodily weakness in regards to sexual matters - as the next words from Bastet's throat are, 'You bitch!' Nermine just chuckles at that and plants a kiss on Bastet's lips again, which the lioness reluctantly returns. 'What astute observation. Nermine is indeed her master's loyal bitch.'";
			WaitLineBreak;
			say "     Nermine gets back to making out with the not quite willing, but still really wound up Bastet, which is a truly awesome sight with the contrast between their fur colors. 'Nermine will of course honor her master's commands and... leave the goddess alone for now. It is a little bit of a waste, as there are numerous uses for divine... fluids and Nermine has many tasks that Bastet could do...' It is clear that she is fishing for you to change your mind, but you shake your head with a steely gaze. As you start pulling your clothes back on, Nermine turns away from Bastet with a little sigh, wandering over to the other side of the store to rearrange the contents of a shelf.";
			say "     From where she's still lying on the counter, [bold type]Bastet gives you a tiny nod of approval.[roman type] This approach to getting to have some fun is definitely easier to accept for the indentured goddess than you just ordering her to do so.";
			increase BastetApproval	by 1;
		else: [Bastet won]
			say "finally, Bastet takes control of the situation, pushing you back slowly but surely, until you bump against one of the bookshelves on the wall. Then the lioness catches hold of your wrists, pushing them up over your head and holding them there with one hand, while the other dips down to your crotch again.";
			say "     You can't help but moan loudly as the cat goddess asserts her dominance, fingers dipping into your moist cave as she holds your wrists in a tight grip. As wound up as she got you since your little contest started, your lust-addled mind just makes you react to the stimulation, panting and rotating your hips to grind against Bastet's hand. You don't actually mind all that much that she's won this round, not with all the fun you had - and still have, as she keeps touching you. Reveling in her already obvious victory, the breathtakingly beautiful feline plays with having you in her power, stroking you, then slowing down, followed by more stroking. It's like a cat and mouse game with her, only here you're the mouse, helplessly held by the feline as she pushes you right up to the edge, then keeps you there for minute after minute.";
			WaitLineBreak;
			say "     As the lioness toys with you, stroking your sex as well as leaning in to brush her breasts over your chest and kissing your lips, your head lolls around a little after another wave of arousal, and you find yourself looking to the side, where Bastet's fennec servant Anktepi is frantically jerking himself off to the show of two females grinding against each other before his very eyes. Bastet gives a victorious chuckle and follows your gaze, smiling at her devoted servant. And as she does so, the lioness goes all out with her attack on your most sensitive spots, rubbing your clit with her thumb while two fingers reach deep into your pussy and stroke a spot that has you tremble in arousal with every little touch. In mere moments, this treatment pushes you over the edge, drawing a breathless moan from you as you start to orgasm, gushing femcum over her hand.";
			say "     While you slump back against the bookshelf, having to lean against something as your knees get weak from all the pleasure coursing through your being, Bastet gives a Nermine a challenging grin. With a look and a mrowl, she calls her fennec servant to her side. Anktepi literally stumbles in his eagerness to get to her - landing on his knees in front of the lioness and bumping right into her crotch with his muzzle. The aroused goddess takes it in stride and just spreads her legs a little more, then holds her hand out to the kneeling desert fox and tells her companion to lick. With a few passes of his tongue, Anktepi slurps up your female juices from Bastet's fingers, then her hands guide his muzzle to her crotch.";
			WaitLineBreak;
			say "     And so, the sand-colored fox eagerly services his mistress, lapping happily at her sex and brushing the insides of her thighs with his large ears. Satisfied mews escape Bastet's lips before much longer and her clawed hands hold on to the kneeling male's head as she reaches her own climax, making the lioness pant in lust as her pussy drips and squirts femcum, which Anktepi immediately licks up. Meanwhile, the small guy's hand is rapidly jerking his own manhood, and with a muffled gasp from between Bastet's thighs, he reaches orgasm. A twitch goes through him from muzzle to tail-tip as quite a respectable load for such a little guy starts to spurt out of his cock, the cum landing in long streaks of white splatter on the shop's smooth wooden floorboards.";
			say "     As Bastet slowly winds down and lets go of her devoted fennec, stroking him in satisfaction instead, his spurts of cum splatting down on the ground get smaller and smaller too. Then Nermine clears her throat and says, 'Nermine is always happy when her customers enjoy their stay in her store as much as possible, but the dear fennec did create quite a little mess. Looks like Bastet will have to - *Clearing your throat, you interrupt the jackaless and tell her to cut it out. For today, at least. The indentured cat goddess fought honorably - and quite pleasurably - against you, so it is time to show her a little respect at least. A hint of a frown plays over the jackaless's features, then Nermine calms herself again and gives you a nod. 'Of course, [Master].'";
			WaitLineBreak;
			say "     From your position leaning against the bookshelf, you watch Bastet allowing Anktepi to help her don her dress, then she walks over near the door of the store and takes position there, leaning against the wall relaxedly. As she passes you on the way, the lioness gives you a content look from the corner of her eyes and even adds a little nod. This approach to getting to have some fun is definitely easier to accept for the indentured goddess than you just ordering her to do so. [bold type]You have gained a tiny bit of approval in her eyes.[roman type][line break]";
			increase BastetApproval	by 1;
	project Figure of Bastet_smile_naked_jewelry_icon;

Bastet ends here.
