Version 1 of Boghrim by Wahn begins here.
[Version 1: Moved into his own file]

"Adds an NPC named Boghrim to the Flexible Survival game"

BoghrimMet is a number that varies.
BoghrimHuntingTrip is a number that varies.

Section 1 - Meeting Event

to say BoghrimSlaveDeal:
	project the figure of Boghrim_clothed_icon;
	if BoghrimMet is 0:
		say "     A really big and powerful orc walks into your line of sight, effortlessly carrying a naked human over his shoulder. The man is very well built and muscular, but compared to the larger orc, he looks almost like a twink-boy, explaining how he ended up in this position. Noticing your eyes on his prize, the orc turns to you and grunts 'A new guy, hm? I'm Boghrim, and this is...' His brows draw together as he draws a blank, then gives his captive a light slap on the ass and asks 'What's your name anyways?', getting a somewhat groggy and slurred 'Jason' as an answer. 'There you have it. My newest slave boy, Jason. A bit feisty at first - but that changed right quick when he got a proper filling of orc cum. You wouldn't believe how tight he was when I fucked him the first time after catching him.'";
		say "     Clearly in a good mood and willing to show off, Boghrim pulls apart Jason's cheeks and rubs a thick finger over the man's cum-dripping hole, then pushes it inside, provoking a lust-filled moan from the human. 'You know, being a new brother and all... I'll offer you a deal. You could be the second orc ever to pound this little slut. Ride that butt before it gets too stretched. Give me some chow and he's yours for a while. Deal?'";
		WaitLineBreak;
		if carried of food is 0:
			say "     As you don't actually have any food on you, there is little choice but declining the offered trade. 'Your loss,' Boghrim grunts, then hefts his load and starts walking. He calls over his shoulder 'I'll be in the main hall if you change your mind...'";
		else if player is not male:
			say "     As you don't currently have a cock, you have little choice but declining the offered trade. Who knows how Boghrim would react if he learned you're not a 'real' orc. Giving a shrug at your refusal, the green man grunts, 'Your loss,' then hefts his load and starts walking. He calls over his shoulder 'I'll be in the main hall if you change your mind...'";
		else:
			if graphics is true:
				project the figure of Jason_naked_icon;
			say "     Do you agree to the orc's terms and pay for sex with Jason with some food?";
			LineBreak;
			say "     ([link]Y[as]y[end link]) - Yes.";
			say "     ([link]N[as]n[end link]) - No.";
			if player consents:
				decrease carried of food by 1;
				LineBreak;
				say "     Digging a package of food out of your pack, you hold it out to Boghrim, who sets Jason down to stand on shaky feet while his orc master takes your offer and starts to munch on it. The human slave sways a bit and looks groggy, a smear of cum on the chin of his handsome face. It's clear that he has been fed at least one load of potent orc cum in addition to what's still dripping out of his hole, making him an easy to handle slave with the intoxicating and addictive effects of orc sperm.";
				say "     Having paid good food for his service, you don't waste any time and quickly strip. Then you step up to the athletic man, pulling his head to yours to share a hungry kiss and taste a trace of the nectar-like cum on his lips. Eager to sink your bone into this docile slave-boy, you bodily pick him up, holding Jason against your broad orc chest to lower him on top of your proudly standing erection. Given the amount of cum in him, it's pretty easy to just slide in, pushing past the somewhat puffy-looking pucker with your cockhead, then stretching it as you go deeper. And Boghrim is right - the human man's hole really is delightfully tight and gripping.";
				WaitLineBreak;
				say "     The young man gasps in lust as you enter him fully, rubbing sensitive spots deep inside his ass with your hard shaft. He begins to moan and pant as you start to fuck him, lifting him with both hands on those firm, round globes of his ass, then pulling him down as you thrust your hips. Whatever the guy's orientation was before all this, it's clear that he's getting off quite a bit from being taken by you now - the hard cock standing erect between the two of you and smacking against your abs doesn't lie. Raising a hand to grab the back of his head, you pull his lips to yours again and give him a deep kiss, your tongue wrestling with his while your cock is balls deep up the man's ass.";
				say "     Coming back up for air, you look into Jason's eyes and ask if he likes feeling of a powerful orc inside him. Just as he opens his mouth to reply, you grind your hips against him once more, making him throw his head back as he almost shouts an aroused moan. Grinning broadly as you watch him get control of himself again, you can see it in his eyes - the moment where the man decides to accept his fate as an orc sex pet. Not that being all but drunk on orc cum doesn't help his decision along, but there's an underlying, decisive note in his voice as he pants 'Yeah... *unngh* Harder! Fuck my ass... master!'";
				WaitLineBreak;
				say "     Hearing those words, you feel your arousal flare up even higher - as your inner orc beats his chest and gives a satisfied roar at taming a slave... and an almost perfect one too. Jason being a magnificent stud, strong and muscular, with as tight an ass as you have around your cock right now - all that wakes the need to posses him inside you, as well as the strong urge to pump your load into him and knock him up. While you push your lips against the now eagerly participating man's and hungrily make out with him, your hips move faster and faster, pounding his ass in a wild and untamed mating.";
				say "     Not much later, you feel your balls tighten and thrust all the way into Jason for the final time, then grunt deeply as the first big spurt of cum blasts deep into his ass. Holding the muscular man tight against your chest, you grope his ass and fill him up with more and more of your seed, mixing it with Boghrim's earlier deposit. Satisfying his current orcish master and getting another injection of hot cum that spreads a warm and fuzzy feeling inside him is enough to drive Jason right over the edge with you. His arms tighten around your chest and he leans his head against your pecs, moaning loudly, then you feel his spurts of cum splash against your abs, painting your green skin with white stripes.";
				WaitLineBreak;
				say "     Catching your breath after the last few spurts of cum ebb, you look down at the human in your arms, worn-out as he is, but still with the eager 'ready to please' expression on his face. Oh, how tempted you are to posses him, take him as yours from Boghrim now... but there's just no way you could, not now, exhausted as you are and given the sheer size of the other orc. To distract yourself from those thoughts, you wipe Jason's cum from your chest and feed it to him, with the sexy pet suckling on your fingers in his desire to get it all.";
				say "     As your hard cock eventually softens enough to slip out of Jason's butt on its own, accompanied by a short gush of orc cum, you give the man a last kiss and set him down. Immediately taking his property, Boghrim throws Jason back over his shoulder, then says 'Fine little slut, isn't he?' He chuckles at the clear tone of envy in your voice as you can't help but agree, then walks off while using one thick finger to play with the young man's hole.";
			else:
				LineBreak;
				say "     Declining the offered trade, you watch Boghrim give a shrug, then hear him grunting 'Your loss.' Next, he hefts his load and starts walking on, calling over his shoulder as he does so, 'I'll be in the main hall if you change your mind...'";
		now BoghrimMet is 1;
	else:
		say "     You meet Boghrim again - the monstrously powerful orc that stands out even among these muscled brutes. And walking just beside him is Jason, the young man he had freshly captured the last time. Surprisingly he's still exactly that - a muscular and ruggedly handsome human, untouched by any sign of green skin or other transformation. Like before, he's naked and draws your eye with that perfectly shaped body - oh wait, not totally naked... there's a skimpy leather harness around his chest, basically just a few straps and a black collar around his neck. Seeing you ogle his slave, Boghrim says 'Pretty little thing, hm? He's even more valuable than I thought... you're looking at a genuine transformation-immune human. Believe me, with all the cum he's had blasted into him, anyone else would be a full-breeder now and popping out babies left and right.' Drawing his slave closer, Boghrim fondles his ass and body, making Jason pant in lust as he feels his pucker being teased by a large finger.";
		say "     'The guys have been asking me to sell him - but no way I'm gonna do that! It's far too much fun to pound that tight ass,' Boghrim says, then addresses Jason, 'Isn't it, pet?' The slave answers immediately, 'Yeah! Er... yes master! It feels so good!' And from the tone of his voice, you can see that he really means it, thoroughly happy in his role as Boghrim's pussyboy. Grunting in satisfaction, the orc turns back to you. 'With everyone hungry for a piece of that ass, I've been making a boatload just renting him out. Say, wanna have a go at him too? Just one packet of food and he's yours - for a time.";
		WaitLineBreak;
		if carried of food is 0:
			say "     As you don't actually have any food on you, there is little choice but declining the offered trade. 'Your loss,' Boghrim grunts, then starts walking away, accompanied by his slave. He calls over his shoulder 'I'll be in the main hall if you change your mind...'";
		else if player is not male:
			say "     As you don't currently have a cock, you have little choice but declining the offered trade. Who knows how Boghrim would react if he learned you're not a 'real' orc. Giving a shrug at your refusal, the green man grunts, 'Your loss,' Boghrim grunts, then starts walking away, accompanied by his slave. He calls over his shoulder 'I'll be in the main hall if you change your mind...'";
		else:
			project the figure of Jason_naked_icon;
			say "     Do you agree to the orc's terms and pay for sex with Jason with some food?";
			LineBreak;
			say "     ([link]Y[as]y[end link]) - Yes.";
			say "     ([link]N[as]n[end link]) - No.";
			if player consents:
				decrease carried of food by 1;
				LineBreak;
				say "     Digging a package of food out of your pack, you hold it out to Boghrim, who accepts it with a grin and says 'Pleasure doing business with you. Jason, take care of him!' Ready and willing to serve, the muscular slave walks up to you and shows off his body for your pleasure. In no time at all, the awesome little show makes you hard as rock, and Jason starts undoing your pants to free your orcish cock. Pushing them down, he bends over to bring his head to your crotch, then wraps his lips around the tip of your shaft, suckling on it softly. The slave gives you a skillful blowjob, getting you all hot and bothered in just a short while, then suddenly he pulls off and looks up at you with an eager expression. Using a hand to wipe off the copious pre-cum that is leaking from your slit, he brings it to his own ass, then proceeds to lube his own ass with it. Standing up, he meets your eyes with an eager expression and moans 'Fuck me, please.'";
				say "     Eager to sink your bone into this docile slave-boy, you bodily pick him up, holding Jason against your broad orc chest to lower him on top of your proudly standing erection. Lubed and well-used to this by getting pounded by many an orc, it's pretty easy to just slide in, pushing past the somewhat puffy-looking pucker with your cockhead, then stretching it as you go deeper. Despite all this, the human man's hole still is delightfully tight and gripping. He's learned well how to please his masters...";
				WaitLineBreak;
				say "     The young man gasps in lust as you enter him fully, rubbing sensitive spots deep inside his ass with your hard shaft. He begins to moan and pant as you start to fuck him, lifting him with both hands on those firm, round globes of his ass, then pulling him down as you thrust your hips. Whatever the guy's orientation was before all this, it's clear that he's getting off quite a bit from being taken by you now - the hard cock standing erect between the two of you and smacking against your abs doesn't lie. Raising a hand to grab the back of his head, you pull his lips to yours and give him a deep kiss, your tongue wrestling with his while your cock is balls deep up the man's ass.";
				say "     Coming back up for air, you look into Jason's eyes and ask if he likes getting fucked like this the feeling of a powerful orc inside him. Just as he opens his mouth to reply, you grind your hips against him once more, making him throw his head back as he almost shouts an aroused moan. Grinning broadly as you watch him get control of himself again, you can see it in his eyes - the arousal and lust at being a willing slave, owned by another to serve for his pleasure. This man has really grown into the role and is a content and obedient slave, happy as he is now. The needy note in his voice speaks volumes as he pants 'Yeah... *unngh* Harder! Fuck my ass master!'";
				WaitLineBreak;
				say "     Hearing those words, you feel your arousal flare up even higher - as your inner orc beats his chest and gives a satisfied roar at fucking such a fine slave. Jason being a magnificent stud, strong and muscular, with as tight an ass as you have around your cock right now - all that wakes the need to posses him inside you, as well as the strong urge to pump your load into him and knock him up. While you push your lips against the eagerly participating man's and hungrily make out with him, your hips move faster and faster, pounding his ass in a wild and untamed mating.";
				say "     Not much later, you feel your balls tighten and thrust all the way into Jason for the final time, then grunt deeply as the first big spurt of cum blasts deep into his ass. Holding the muscular man tight against your chest, you grope his ass and fill him up with more and more of your seed, mixing it with Boghrim's earlier deposit. Satisfying his current orcish master and getting another injection of hot cum that spreads a warm and fuzzy feeling inside him is enough to drive Jason right over the edge with you. His arms tighten around your chest and he leans his head against your pecs, moaning loudly, then you feel his spurts of cum splash against your abs, painting your green skin with white stripes.";
				WaitLineBreak;
				say "     Catching your breath after the last few spurts of cum ebb, you look down at the human in your arms, worn-out as he is, but still with the eager 'ready to please' expression on his face. Oh, how tempted you are to posses him, take him as yours from Boghrim now... but there's just no way you could, not now, exhausted as you are and given the sheer size of the other orc. To distract yourself from those thoughts, you wipe Jason's cum from your chest and feed it to him, with the sexy pet suckling on your fingers in his desire to get it all.";
				say "     As your hard cock eventually softens enough to slip out of Jason's butt on its own, accompanied by a short gush of orc cum, you give the man a last kiss and set him down. Immediately taking his property, Boghrim throws Jason back over his shoulder, then says 'Fine little slut, isn't he?' He chuckles at the clear tone of envy in your voice as you can't help but agree, then walks off while using one thick finger to play with the young man's hole.";
			else:
				LineBreak;
				say "     Declining the offered trade, you watch Boghrim give a shrug, then hear him grunting 'Your loss,' Boghrim grunts, then starts walking away, accompanied by his slave. He calls over his shoulder 'I'll be in the main hall if you change your mind...'";

Section 2 - NPC

[ HP of Boghrim                                   ]
[ 0: never fucked                                 ]
[ 1: player got fucked                            ]
[ 2: hunting event successfully done              ]
[ 3: player fucked Boghrim before                 ]

Table of GameCharacterIDs (continued)
object	name
Boghrim	"Boghrim"

Boghrim is a man. Boghrim is in Main Hall.
ScaleValue of Boghrim is 3. [human sized]
Cocks of Boghrim is 1.
Cock Length of Boghrim is 16.
Cock Width of Boghrim is 8.
Testes of Boghrim is 2.
Cunts of Boghrim is 0.
Cunt Length of Boghrim is 9.
Cunt Width of Boghrim is 2.
Breasts of Boghrim is 2. [2 nipples]
Breast Size of Boghrim is 0.
[Basic Interaction states as of game start]
PlayerMet of Boghrim is false.
PlayerRomanced of Boghrim is false.
PlayerFriended of Boghrim is false.
PlayerControlled of Boghrim is false.
PlayerFucked of Boghrim is false.
OralVirgin of Boghrim is false.
Virgin of Boghrim is true.
AnalVirgin of Boghrim is false.
PenileVirgin of Boghrim is false.
SexuallyExperienced of Boghrim is true.
The description of Boghrim is "[BoghrimDesc]".
The conversation of Boghrim is { "Mew!" }.
The icon of Boghrim is Figure of Boghrim_clothed_icon.

to say BoghrimDesc:
	say "     Boghrim is flat out the biggest, toughest-looking orc warrior you've seen yet. With his towering stature and rippling muscles under his green skin, you certainly wouldn't want to fight him - as in, ever. One look at the loincloth around his hips is enough to convince anyone of that - it is made of the light brown fur of a giant wolf, as well as several black leather belts that must have belonged to police officers. The elven badges decorating the belt-line all the way round certainly make you think so. Beside those trophies, the orc chief has at least another dozen of army dog tags assembled as a wristband on his left arm. A golden chain with weighty links around Boghrim's neck completes the image of a proud and powerful orc.";
	say "     Even the strongest of the other orcs in the drinking hall have more than a little respect for him, explaining why the large and comfortable black leather couch he occupies stands on a low, but expansive platform built in one corner of the big room. It's clear that this orc is the established boss here. Beside him on the sofa, you can see a naked orc breeder, always ready to hand his master a drink from the well-laden table to the side, and kneeling on the floor between Boghrim's legs is Jason, the young man you saw the orc bring in before. The human now wears a very skimpy leather harness, consisting of just a few straps and a black leather collar, and is worshiping his owner's cock and balls, slowly licking and stroking them.";

instead of sniffing Boghrim:
	say "     He's got an attractive male scent, with slight undertones of cum and sweat that make him appear even more manly somehow.";

instead of conversing the Boghrim:
	LineBreak;
	project the figure of Boghrim_face_icon;
	say "What do you want to talk with Boghrim about?";
	now sextablerun is 0;
	blank out the whole of table of fucking options;
	[]
	choose a blank row in table of fucking options;
	now title entry is "Him";
	now sortorder entry is 1;
	now description entry is "Try to learn a bit about Boghrim's background";
	[]
	choose a blank row in table of fucking options;
	now title entry is "Jason";
	now sortorder entry is 2;
	now description entry is "Ask if you can have some fun with Jason";
	[]
	if HP of Boghrim > 0:
		choose a blank row in table of fucking options;
		now title entry is "Hunting";
		now sortorder entry is 3;
		now description entry is "Suggest that the two of you go out hunting";
	[
	choose a blank row in table of fucking options;
	now title entry is "Fighting";
	now sortorder entry is 4;
	now description entry is "Talk about fighting with Boghrim";
	sort the table of fucking options in sortorder order;
	]
	sort the table of fucking options in sortorder order;
	repeat with y running from 1 to number of filled rows in table of fucking options:
		choose row y from the table of fucking options;
		say "[link][y] - [title entry][as][y][end link][line break]";
	say "[link]0 - Nevermind[as]0[end link][line break]";
	while sextablerun is 0:
		say "Pick the corresponding number> [run paragraph on]";
		get a number;
		if calcnumber > 0 and calcnumber <= the number of filled rows in table of fucking options:
			now current menu selection is calcnumber;
			choose row calcnumber in table of fucking options;
			say "[title entry]: [description entry]?";
			if player consents:
				let nam be title entry;
				now sextablerun is 1;
				if (nam is "Him"):
					say "[BoghrimTalk1]";
				if (nam is "Jason"):
					say "[BoghrimTalk2]";
				if (nam is "Hunting"):
					say "[BoghrimTalk3]";
				if (nam is "Fighting"):
					say "[BoghrimTalk4]";
				wait for any key;
		else if calcnumber is 0:
			now sextablerun is 1;
			say "     You step back from the large orc, shaking your head slightly as he gives a questioning look.";
			wait for any key;
		else:
			say "Invalid Option. Pick between 1 and [the number of filled rows in the table of fucking options].";
	clear the screen and hyperlink list;

to say BoghrimTalk1: [talk about him]
	let randomnumber be a random number from 1 to 3;
	if randomnumber is:
		-- 1:
			say "     'So you want to hear some stories, new guy? Well, why not... plant your ass on the couch,' Boghrim says, nodding to the free spot next to him. After you sit down, he waves one of his big hands to indicate the room before you, with its drinking, fighting and fucking orcs. 'Before the change, this was a police station. You know, arrogant pigs just coming along and snatching people from their homes, then locking them up just because they try to make a bit of money on the streets. Ha - now the strong rule... and no one is stronger than us orcs!'";
		-- 2:
			say "     'So you want to hear some stories, new guy? Well, why not... plant your ass on the couch,' Boghrim says, nodding to the free spot next to him. After you sit down, he waves one of his big hands to indicate the hallway to the east and the cell block it leads to. 'I was the first, you know - after they threw me behind bars because of 'assault'. Hmph - that guy asked to have his teeth knocked out. And legs broken. Anyways, there I was in the cell and suddenly, I felt a burning in every bone, every muscle. I collapsed, screaming from all the pain, which drew Sergeant Lawrence to come running and unlock it to check on me...'";
			say "     Boghrim's eyes take on a dreamy look for a moment, clearly reveling in the memory of what came next. Suddenly, he grabs the orc breeder sitting next to him and draws him to lie over his lap. He gives the smaller orc a slap on the butt, then runs a finger up and down his crack before pushing it up his asshole. 'Ah, I think I'll let someone else explain what went down. Tell him, Lawrie,' Boghrim chuckles, addressing the moaning breeder he's fingering. 'Uuuhng... yes! AaaahhhH!' the man gasps as his owner brushes against his prostate, then he begins to haltingly talk. 'The prisoner... my master... he became green and bigger and bigger. I was afraid and tried to run, but he grabbed the door as I wanted to close it and... I couldn't move it an inch against his strength. His other hand got me by the neck and I was pulled into the cell, then... he fucked me, fucked me so good. Gave me his seed and made me his.'";
			WaitLineBreak;
			say "     The powerful orc takes over again at that point, idly playing with the former Sergeant Lawrence's ass while talking to you. Accompanied by the big and small gasps and moans from the transformed policeman, Boghrim is all too happy to tell you how he unlocked the other cell, letting out two other men 'unjustly behind bars' and they gang-banged their captive. 'We were so incredibly horny at that moment that we didn't even think about trying to escape. By the time I got the whole rush of lust from the change out of my system, Lawrie was dripping cum from all holes and already going green - just like my buddies. With many patrols having been sent out to deal with all the crazy shit starting up that day, it was easy after that to overpower the rest still here. What man can stand against three orc warriors, after all. And even better, the police piggies came back in dribs and drabs later, often frightened and hurt, making it a cakewalk to just overwhelm [']em one by one. Every one of us orcs ended up with a nice flock of breeders that day...'";
		-- 3:
			say "     'So you want to hear some stories, new guy? Well, why not... plant your ass on the couch,' Boghrim says, nodding to the free spot next to him. After you sit down, he slaps his chest lightly with a big hand, then explains, 'I was a businessman before all this, you know. I had money, people needed money, so I lent [']em some. But of course, there's always some bums who don't plan on ever paying you back, so I had to make an example or two. A black eye works wonders, and if you break some legs, the other lenders almost fall over each other to pay you.' Grinning as he lets his gaze wander sees two orcs head-butting each other, multiple times in a row, Boghrim continues, 'Too bad money is worthless these days, because with that crew of enforcers, I could just rake it in. But then, who needs money if you can just take what you want.' Finishing that sentence, the powerful orc looks down to his human slave Jason, still kneeling between his legs and lapping away at the orc's balls.";

to say BoghrimTalk2: [talk about Jason]
	say "     Boghrim chuckles as you ask about Jason and directs the human to stand up and spin around. 'So you want to bang my little slave-boy? That'll cost you a packet of food, but trust me - it's well worth it...'";
	if carried of food is 0:
		say "     As you don't actually have any food on you, there is little choice but declining the offered trade. 'Your loss,' Boghrim grunts, giving a shrug. 'You know where to find him, if you change your mind...'";
	else if player is not male:
		say "     As you don't currently have a cock, you have little choice but declining the offered trade. Who knows how Boghrim would react if he learned you're not a 'real' orc. Giving a shrug at your refusal, the green man grunts, 'Your loss,' accompanied by a shrug. 'You know where to find us, if you change your mind...'";
	else:
		project the figure of Jason_clothed_icon;
		say "     Do you agree to the orc's terms and pay for sex with Jason with some food?";
		LineBreak;
		say "     ([link]Y[as]y[end link]) - Yes.";
		say "     ([link]N[as]n[end link]) - No.";
		if player consents:
			decrease carried of food by 1;
			LineBreak;
			say "     Digging a package of food out of your pack, you hold it out to Boghrim, who accepts it with a grin and says 'Pleasure doing business with you.' Handing the food to his orc breeder attendant, Boghrim nods to the free end of the sofa. 'Plant your ass and have fun,' he continues, then pulls his human slave's head up from where he was licking the orc's balls and tells him 'Jason, take care of him!' Ready and willing to serve, the muscular slave stands up and walks to where you flop down on the couch, then gives you a nice lap-dance, showing off a very nice body and wiggling his shapely booty at you. In no time at all, the awesome little show makes you hard as rock, and Jason starts undoing your pants to free your orcish cock. Pushing them down, he bends over to bring his head to your crotch, then wraps his lips around the tip of your shaft, suckling on it softly.";
			say "     The slave gives you a skillful blowjob, getting you all hot and bothered in just a short while, then suddenly he pulls off and looks up at you with an eager expression. Using a hand to wipe off the copious pre-cum that is leaking from your slit, he brings it to his own ass and proceeds to lube his hole with it. Standing up, he meets your eyes with an eager expression and moans 'Fuck me, please.' Eager to sink your bone into this docile slave-boy, you wave him closer, then direct him to climb on your lap. Quickly moving to straddle your hips, the sexy man's cock pokes you in the abs a moment later as he leans down to meet your lips. You have some fun wrestling the eager sex-pet's tongue with yours, then embrace and lift him a bit, holding Jason against your broad orc chest to lower him on top of your proudly standing erection. Lubed and well-used to this by getting pounded by many an orc, it's pretty easy to just slide in, pushing past the somewhat puffy-looking pucker with your cockhead, then stretching it as you go deeper. Despite all this, the human man's hole still is delightfully tight and gripping. He's learned well how to please his masters...";
			WaitLineBreak;
			say "     The young man gasps in lust as you enter him fully, rubbing sensitive spots deep inside his ass with your hard shaft. He begins to moan and pant as you start to fuck him, lifting him with both hands on those firm, round globes of his ass, then pulling him down as you thrust your hips. Whatever the guy's orientation was before all this, it's clear that he's getting off quite a bit from being taken by you now - the hard cock standing erect between the two of you and smacking against your abs doesn't lie. Raising a hand to grab the back of his head, you pull his lips to yours and give him a deep kiss, your tongue wrestling with his while your cock is balls deep up the man's ass.";
			say "     Coming back up for air, you look into Jason's eyes and ask if he likes getting fucked like this the feeling of a powerful orc inside him. Just as he opens his mouth to reply, you grind your hips against him once more, making him throw his head back as he almost shouts an aroused moan. Grinning broadly as you watch him get control of himself again, you can see it in his eyes - the arousal and lust at being a willing slave, owned by another to serve for his pleasure. This man has really grown into the role and is a content and obedient slave, happy as he is now. The needy note in his voice speaks volumes as he pants 'Yeah... *unngh* Harder! Fuck my ass master!'";
			WaitLineBreak;
			say "     Hearing those words, you feel your arousal flare up even higher - as your inner orc beats his chest and gives a satisfied roar at fucking such a fine slave. Jason being a magnificent stud, strong and muscular, with as tight an ass as you have around your cock right now - all that wakes the need to posses him inside you, as well as the strong urge to pump your load into him and knock him up. While you push your lips against the eagerly participating man's and hungrily make out with him, your hips move faster and faster, pounding his ass in a wild and untamed mating.";
			say "     Not much later, you feel your balls tighten and thrust all the way into Jason for the final time, then grunt deeply as the first big spurt of cum blasts deep into his ass. Holding the muscular man tight against your chest, you grope his ass and fill him up with more and more of your seed, mixing it with Boghrim's earlier deposit. Satisfying his current orcish master and getting another injection of hot cum that spreads a warm and fuzzy feeling inside him is enough to drive Jason right over the edge with you. His arms tighten around your chest and he leans his head against your pecs, moaning loudly, then you feel his spurts of cum splash against your abs, painting your green skin with white stripes.";
			WaitLineBreak;
			say "     Catching your breath after the last few spurts of cum ebb, you look down at the human in your arms, worn-out as he is, but still with the eager 'ready to please' expression on his face. Oh, how tempted you are to posses him, take him as yours from Boghrim now... but there's just no way you could, not now, exhausted as you are and given the sheer size of the other orc. To distract yourself from those thoughts, you wipe Jason's cum from your chest and feed it to him, with the sexy pet suckling on your fingers in his desire to get it all.";
			say "     As your hard cock eventually softens enough to slip out of Jason's butt on its own, accompanied by a short gush of orc cum, you give the man a last kiss and let him get up. Calling his slave over to him, Boghrim gives Jason's balls a rewarding fondle as he says 'That's a good boy.' Then he reaches out to grab the young man by the shoulder, pressing down on it to make him kneel, and pulls his head against his crotch. As Jason starts to lap away at his owner's balls, Boghrim says to you 'Fine little slut, isn't he?' He chuckles at the clear tone of envy in your voice as you can't help but agree, then leans back and enjoys the human playing with his full, hairy orbs.";
		else:
			LineBreak;
			say "     Giving a shrug at your refusal, the green man grunts, 'Your loss,' accompanied by a shrug. 'You know where to find us, if you change your mind...'";

to say BoghrimTalk3: [go hunting]
	say "     As you bring up the possibility of going out for a hunting trip together, Boghrim gives you an evaluating look, then nods with a slight grin on his face. 'Normally I go out alone, but since you're such a good 'buddy' of mine...' *his eyes wander over to the scars his tusks left on your shoulder, marking you as his fuck-buddy* 'Sure, why not. Let's go!' Boghrim looks down at Jason, still kneeling between his legs and lapping at the orc's big balls, then sighs and grabs his favorite slave by the shoulder, pulling him up to plant a kiss on his mouth before pushing the naked man aside to land on the sofa. Standing up, the orc addresses his little harem of orc breeders and the one unchanged human, 'Listen! Lawrie, Jase, and you other bitches - I'm going out right now. You may play around, but you're not allowed to cum!'";
	say "     While Boghrim's slaves get out some toys and start going to work on themselves or each other, the orc boss himself ties his 'clothing' around his hips - if one can call a loincloth barely large enough to hide his pendulous cock that - then walks out of the drinking hall with you. Exiting the orc lair in short notice, the two of you travel through the streets of the city - the surprisingly empty streets, with almost nothing and no one in sight between the wrecked cars and piles of trash. And what creatures do come into your line of sight quickly duck into hiding or run off. It's quite evident that Boghrim has a reputation. 'Pussies,' the mighty orc says with a chuckle as two German shepherds step into sight in front of you around a corner, only to whine and run back the way they came from as they see him.";
	WaitLineBreak;
	say "     After leaving the capitol district behind you and moving into other parts of the city, Boghrim pulls you aside into a relatively narrow alleyway, flanked by windowless buildings. 'So,' the orc says as he lets his hand slide down from his grip on your arm, along your side to finally stop covering one of your buttcheeks. He gives your behind a suggestive squeeze, then asks, 'Did you really want to go hunting with me, or was that just a ploy to get me out of the lair? I could bend you over that car hood over there right now. You'd like that, wouldn't you...'";
	LineBreak;
	say "     Do you take the orc's offer and let him fuck you, right here, right now?";
	LineBreak;
	say "     ([link]Y[as]y[end link]) - Yes.";
	say "     ([link]N[as]n[end link]) - No.";
	if player consents:
		LineBreak;
		project the figure of Boghrim_naked_icon;
		say "     More than happy to forget about hunting and just get a good dicking, you tell Boghrim exactly that. He gives a satisfied, hungry grunt at the reply and quickly guides you over to the nearby car, pushing your upper body to bend over its hood. The orc's hands work at baring your ass from clothing and gear in just a few moments, then you can feel the tip of his thick index finger push against your pucker. Leaning in close as his digit slides into you, Boghrim whispers into your ear in a husky tone, 'I really like having you as a fuck-buddy. Needy bitches are great, of course, but knowing that you're thrusting into a real man who decided he wants to give his ass up - that's something else.' That said, he intensifies fingering your rear entrance, soon drawing lusty moans from you, then asks, 'Ready to take my thick cock now, buddy?'";
		say "     As horny as his foreplay made you, the reply you give is little more than a loud moan - more than enough to satisfy the big orc, who immediately steps up behind you. The feeling of his thick shaft being smacked against your butt, on first one cheek then the other, before it is slid up and down in your crack makes you tremble in arousal. You slide your hands down to your hips and spread both cheeks apart, eagerly waiting to have the big orc enter you - and you don't have to wait long. Soon, the broad, fleshy head of Boghrim's shaft brushes against your pucker, increasing in pressure until the muscle yields and your green-skinned companion's massive cock slides into you.";
		WaitLineBreak;
		say "     Holding you by the hips, Boghrim inches deeper into your body, further and further until finally, his crotch is flush against your butt and you can feel his pubic hair tickling your skin. You hear a satisfied grunt from the big orc and he pauses for a moment, his thick prick balls-deep inside your body, leaking copious amounts of pre-cum that leave you feeling pretty buzzed and even more aroused as it is absorbed by your body. The short period of getting used to this massive pole inside you ends with the growled words, 'I'm gonna pound you till you can't sit straight,' then Boghrim's manhood is withdrawn in one quick pull, leaving your opening to gape for a second before the orc's cock is hammered back in.";
		say "     Man, that thick prick sure feels amazing inside your hole, filling it very nicely with its impressive girth and bumping your prostate... every... single... hard... thrust, making you flush hotly in arousal and rock back to meet the large orc's hips again and again. Combining the sensations of that thick piece of man-meat inside you with the fact that he's taking you out in the open, where anyone might just walk by... makes your own erection get even harder, to dangle between your legs. What follows next is... just what the orc boss said he'd do - pounding your ass hard and oh so very deep, using you as his willing butt-slut and driving you deeper and deeper into a lust-filled haze.";
		say "     You don't know how long your coupling takes, two sweaty bodies moving in unison, accompanied by the squeak of a car's suspension, but one thing is sure - you wanna do it again, and soon! After a breathtaking time of taking it from the biggest and baddest orc there is, you eventually reach the point of no return and roar out loud as an orgasm crashes over you like a wave. Gripping the edge of the car's hood so tightly that you're almost sure you felt it bend a little bit, and rocking your hips to grind against the thick cock inside your ass, you blast away with a massive load of rich, thick orc cum, pulsing through your shaft and making quite a mess on the side of this car.";
		WaitLineBreak;
		say "     Reaching your own climax pushes Boghrim over the edge in short notice, as your fuckhole twitches and flexes with each spurt of your load. The mighty orc gives a lust-fueled bellow, hands tightening around your hips, then the first blast of his seed splashes into you, followed by another and another. As more and more orcish cum fills you with each moment, Boghrim slowly winds down and he starts to loosen his grip on you. After a few more half-grunted pants, he says, 'Fuck yeah! You've got a fine ass on you! Bitches like Jason are great, but this -', he grips your firm asscheeks with both hands and gives [']em a tight squeeze, '- is a real man's butt, worthy of my hard shaft!' Looking down at your shoulder and noticing the scars he left after your first coupling, the orc licks over them with a slow swipe of his broad tongue, then adds, 'Bear these marks with pride - you're the first guy I fucked that I didn't take as a slave afterwards.'";
		say "     Waiting some time longer till the last little spurt of his load is deposited deep inside your hole, the orc pulls out with a wet slurp and inspects his handiwork, dipping his index finger between your cheeks to feel the cum-slick hole he just fucked. 'Really nice. But you can't show up at the lair like this. Just a moment...' You feel the orc step away from behind you and look to the side to see him walk out of the alley. The question what he's planning to do is answered a moment later, when you hear a surprised, frightful ";
		let randomnumber be a random number from 1 to 4;
		if randomnumber is:
			-- 1:
				say "bark and the large orc appears a moment later, carrying a weakly struggling male husky by the scruff of his neck. Dropping his captive behind you, Boghrim orders in a gruff tone, 'Clean him up, puppy.'";
				WaitLineBreak;
				say "     And the frightened husky does just that, at first only with a tentative lick of your crack, then more vigorously as he gets his first taste of potent orc cum. It doesn't take long for the canine's long tongue to scoop up every last bit of Boghrim's cum that leaked out of you and all he can reach inside your ass. The big orc even has to pull the husky off you since he just won't stop lapping your crack, drunk with lust as he gets in short notice. With all the evidence of your activities now safely taken care of, Boghrim nudges you with his arm and says, 'Come on buddy, let's go home.' You quickly put your clothes back in order and follow the orc out of the alley, leaving the husky behind, now lying on the ground in his drunken buzz and furiously jerking himself off.";
			-- 2:
				say "bleek and the large orc appears a moment later, carrying a weakly struggling ram by the scruff of his neck. Dropping his captive behind you, Boghrim orders in a gruff tone, 'Clean him up, sheep.'";
				WaitLineBreak;
				say "     And the frightened ram does just that, at first only with a tentative lick of your crack, then more vigorously as he gets his first taste of potent orc cum. It doesn't take long for the ovine's long tongue to scoop up every last bit of Boghrim's cum that leaked out of you and all he can reach inside your ass. The big orc even has to pull the ram off you since he just won't stop lapping your crack, drunk with lust as he gets in short notice. With all the evidence of your activities now safely taken care of, Boghrim nudges you with his arm and says, 'Come on buddy, let's go home.' You quickly put your clothes back in order and follow the orc out of the alley, leaving the ram behind, now lying on the ground in his drunken buzz and furiously jerking himself off.";
			-- 3:
				say "gasp and the large orc appears a moment later, carrying a weakly struggling incubus by the scruff of his neck. Dropping his captive behind you, Boghrim orders in a gruff tone, 'Clean him up, slut.'";
				WaitLineBreak;
				say "     'Sure thing boss, rimming is one of my specialities,' the lust-demon replies in a husky tone, now that he's had time to get over his initial shock. A moment later, you can feel his tongue go for your hole, vigorously poking deep inside and lapping up all of the potent orc cum he can get. It doesn't take long for the demon's talented tongue to scoop up every last bit of Boghrim's cum that leaked out of you and all he can reach inside your ass. The big orc even has to pull the incubus off you since he just won't stop lapping your crack, drunk with lust as he gets in short notice. With all the evidence of your activities now safely taken care of, Boghrim nudges you with his arm and says, 'Come on buddy, let's go home.' You quickly put your clothes back in order and follow the orc out of the alley, leaving the incubus behind, now lying on the ground in his drunken buzz and furiously jerking himself off.";
			-- 4:
				say "gasp and the large orc appears a moment later, carrying a weakly struggling orang-utan by the scruff of his neck. Dropping his captive behind you, Boghrim orders in a gruff tone, 'Clean him up, monkey.'";
				WaitLineBreak;
				say "     There is a short protest of, 'I'm an ape, you stupid - umph,' ending when Boghrim pushes the primate's head between your asscheeks. The orang-utan can't help but get a taste of the of the potent orc cum leaking out of your hole, causing him to stop struggling almost instantly, then start giving tentative and later increasingly vigorous licks at your well-bred hole. It doesn't take long for the ape's questing tongue to scoop up every last bit of Boghrim's cum that leaked out of you and all he can reach inside your ass. The big orc even has to pull him off you since the orang-utan just won't stop lapping your crack, drunk with lust as he gets in short notice. With all the evidence of your activities now safely taken care of, Boghrim nudges you with his arm and says, 'Come on buddy, let's go home.' You quickly put your clothes back in order and follow the orc out of the alley, leaving the ape behind, now lying on the ground in his drunken buzz and furiously jerking himself off.";
	else: [nope, let's hunt]
		LineBreak;
		say "     You're tempted to let the orc fuck you again, but nevertheless shake your head and say that you really do want to hunt with him. There sure will be lots of fun to be had once you've brought down whatever sexy beast you'll go for, after all. 'You've got that right, buddy. Okay then - I know just what I wanna fuck today,' the big orc says, giving your ass a last appreciative squeeze before putting on a more serious expression and putting his mind on actually hunting, not just having an alleyway fuck. Boghrim guides you to a less populated area in the outskirts of the city after that, and you pass a row of long-abandoned warehouses shortly before entering a very large junkyard.";
		say "     'There's a tribe of goblins living out here - sexy little fuckers, although it's pretty hard to fit your cock in one,' Boghrim tells you in a conversational tone as you start walking along the labyrinthine passages of the junkyard, in between the tall piles of wrecked cars stacked up all over the place. 'But we want to catch us a wildcat today. Big brutes, those kitties - I've been wanting to sink my shaft in one for a while now.' He indicates a height of about eight feet with his hand, then proceeds to rub the bulge under his loincloth in eager anticipation. The two of you walk deeper and deeper into the junk labyrinth, talking about strategies to overpower a wildcat, until suddenly Boghrim says, 'Wait - did you hear that?'";
		WaitLineBreak;
		say "     You stop and listen for a second, indeed hearing a silent squeak - which rapidly escalates to the wrenching screech of tortured metal as the wall of cars on your right starts to topple. As reality seems to fall into slow-motion, you frozenly stand where you are while your mind somehow has the time to register the wall isn't just collapse on its own - something is pushing it over... something huge and green, barely seen through the gaps of the car stack. While you make interesting, but momentarily rather useless observations - as you're about to be crushed by a car or three - Boghrim instead just reacts, snatching you up and flinging you to safety with a mighty throw, before...";
		say "     Time resumes its regular pace with the deafening crash of a number of car wrecks impacting on the ground, just steps behind where you landed. You jump to your feet as quick as you can and look around - hm, where did Boghrim end up at? Thankfully, your fear that he might have been crushed under that whole pile of wreckage proves unnecessary, as you hear him growl, 'Now what the fuck did that? Give me a moment to pull myself out of here...' Seems like he's right against the wall on the other side, where a falling car only came to lean against it, not flat on the ground. Though your relief doesn't last long, as your eyes fall on the massive creature responsible for all this - it's a hydra, stepping over the twisted metal in the wall-opening it created and snapping at you with multiple heads.";
		WaitLineBreak;
		now Abandoned Lot is known;
		now BoghrimHuntingTrip is 1;
		now inasituation is true;
		challenge "Hydra Beast";
		if fightoutcome >= 20 and fightoutcome <= 29: [lost]
			say "     [if HP of player > 0]Forced to submit to[else]Unable to keep fighting against[end if] the monstrous creature and its numerous heads, you are knocked down by its many heads and pinned there. From this new position, you have a very good view of the beast's genitals - showing you that it sports as many cockheads below as it has reptilian heads up top, with all of them oozing droplets of pre-cum from the hydra's anticipation of ravaging your body. All of the big creature's attention focuses on you now. It starts to inspect and sniff you with one head while others move in to grip your gear and clothes to tear them off... until suddenly, you see a broad green-skinned foot flash through your line of sight and kick the big reptile in its massive set of balls. Ouch, that must have hurt!";
			say "     With a shrill, screamed whine that leaves your ears ringing and you slightly dazed, the massive creature rears up and throws itself on the ground to your right, writhing and twitching for a long moment before it can think of anything else than the pain. Then the hydra beast's heads whip around and focus on the source of its misery - Boghrim, standing over it with a snarl on his face. 'Think you can drop cars on me without consequences, fucker? I'm gonna kick your ass!' Bellowing, the brutish orc throws himself at the hydra, and you can only watch in shock at the explosion of violence that follows. After only barely a minute of combat, the fight is decided, with the big reptile fleeing in terror, two of its heads dangling down with broken necks. As it does so, the creature slams into another tall pile of wrecked cars, making it sway, then collapse just as the hydra is past - which cuts your orc companion off from catching it.";
			WaitLineBreak;
			say "     Grumbling under his breath at your quarry getting away, Boghrim walks back to you and gives you a hand to get up. He isn't much in the mood to talk afterwards as you make your way back to the orc lair, mostly coming back to 'Next time, that fucker is toast,' as he thinks about another hunt for the hydra.";
		else if fightoutcome >= 30: [fled]
			say "     As you run off, the hydra beast roars with its many heads and thunders after you, making the ground shake with the rapid impact of its tick legs. Thankfully, you're quite a bit more agile than the massive predator with its armored hide, so you do manage to shake it before much longer. As you leave the junkyard proper a short while later, still pretty out of breath, you can't help but think that this won't impress Boghrim much - though at least the hydra came after you, so you didn't just ditch him with it. No doubt, the orc will have freed himself by now and be on his way back to the orc lair...";
			move player to Abandoned Lot;
		else if fightoutcome >= 10 and fightoutcome <= 19:[won]
			say "     You manage to fight your way to what you perceive to be the central head and grapple it, twisting it in a painful lock. The other heads hiss angrily at you, but do not attack for fear of you harming its true head. Forcing the weakened creature to submit, you direct it to lower its forequarters to the ground, then step back to consider what you want to do with it now. Meanwhile, Boghrim managed to free himself from the narrow crawlspace between the fallen car and the other wall of wrecks, dusting himself off as he comes to stand beside you. 'Very nice work, buddy! And... you kinda saved my ass - I sure wouldn't have wanted to have that thing waiting for me when I got out from under the car. So - wanna celebrate your glorious victory by having some fun with the beastie?'";
			WaitLineBreak;
			LineBreak;
			now sextablerun is 0;
			blank out the whole of table of fucking options;
			[]
			choose a blank row in table of fucking options;
			now title entry is "Fuck the hydra, Boghrim gets sucked";
			now sortorder entry is 1;
			now description entry is "You'll enjoy its fuckhole, leaving Boghrim to enjoy the hydra's mouths";
			[]
			choose a blank row in table of fucking options;
			now title entry is "Boghrim fucks the hydra, you get sucked";
			now sortorder entry is 2;
			now description entry is "You'll enjoy the hydra's mouths, while leaving Boghrim to pound its fuckhole";
			[]
			choose a blank row in table of fucking options;
			now title entry is "Nah - just leave";
			now sortorder entry is 3;
			now description entry is "Don't have sex with the hydra";
			[]
			sort the table of fucking options in sortorder order;
			repeat with y running from 1 to number of filled rows in table of fucking options:
				choose row y from the table of fucking options;
				say "[link][y] - [title entry][as][y][end link][line break]";
			say "[link]0 - Nevermind[as]0[end link][line break]";
			while sextablerun is 0:
				say "Pick the corresponding number> [run paragraph on]";
				get a number;
				if calcnumber > 0 and calcnumber <= the number of filled rows in table of fucking options:
					now current menu selection is calcnumber;
					choose row calcnumber in table of fucking options;
					say "[title entry]: [description entry]?";
					if player consents:
						let nam be title entry;
						now sextablerun is 1;
						if (nam is "Fuck the hydra, Boghrim gets sucked"):
							say "[BoghrimHydraSex1]";
						if (nam is "Boghrim fucks the hydra, you get sucked"):
							say "[BoghrimHydraSex2]";
						if (nam is "Nah - just leave"):
							say "     Telling Boghrim that you're not in the mood for reptiles right now, you suggest going back to the lair and celebrating with a cold orc brew. The big orc looks somewhat disappointed for a moment, then shrugs and answers, 'As you wish - it's your prey, so you decide.' With that, the two of you make your way to the exit from the junkyard, leaving a somewhat knocked around and still really horny hydra behind. There's little doubt that it'll go hunting for someone else to take its sexual frustrations out on, but... that's not your problem, after all.";
							if HP of Boghrim < 3:
								say "     As you make your way back to the orc lair, and when you share a drink soon after, you realize that the orc boss gives you... interested looks, and his cock stays half-hard the whole time. It seems you've impressed him today, proved that you're a 'real man' - he now might be more open to the possibility of getting fucked by you.";
						WaitLineBreak;
				else if calcnumber is 0:
					now sextablerun is 1;
					say "     You step back from the orc boss, shaking your head slightly as he gives a questioning look.";
					WaitLineBreak;
				else:
					say "Invalid Option. Pick between 1 and [the number of filled rows in the table of fucking options] or 0 to exit.";
			clear the screen and hyperlink list;
			now HP of Boghrim is 2;
		now BoghrimHuntingTrip is 0;
		now inasituation is false;

to say BoghrimHydraSex1:
	project the figure of Boghrim_naked_icon;
	say "     Giving Boghrim a broad grin, you nod and quickly strip off your clothes, then step back up to the large reptile in front of you. You grab its primary head with both hands and pull it close to yours, then give the beast a hungry kiss. A surprised rumble goes through its throat, echoed by all the other heads as they turn into position to look at you with big eyes from all around. Faced with a clearly unexpected, pretty pleasant situation, the hydra makes no attempt to resist and even starts to reply in kind a moment later, sliding its slick tongue into your mouth. The two of you share a moment of companionable tongue-wrestling, until you eventually break the kiss - and find a number of its other heads stretched close, with somewhat hopeful expressions on their faces.";
	say "     You guess that someone should have just told Hercules that snogging the beast would have been a viable option - or at least in your case it was, as the creature seems far more at ease and compliant now. Well, now that you have the hydra calmed down, you're more than ready to have your fun with it. Ordering to keep that ass raised, you move around behind the large creature and can't help but chuckle at how eagerly it raises its tail, willingly granting access to its ass for its captor. You run your hands over its meaty backside, feeling the firm muscles under its scaly hide. And between the firm buttocks under its tail, there is the dark green ring that is your target.";
	WaitLineBreak;
	if anallevel is 3 and a random chance of libido of player in 125 succeeds:
		say "     Leaning in close, you lick your lips before pressing your slick tongue to the creature's taunt pucker. Slathering your tongue across it a few times, you hear it give a pleased hiss and take that as a sign to proceed to prodding at its clenched hole. The great beast rumbles in arousal as you knead its rear and work your slick, meaty flesh into its back passage, getting those muscles to relax and open up, preparing for what is to come. While you keep going at it - longer than strictly necessary, enjoying the reactions you can get from your captive beast - your hands feel under the hydra, groping for its huge, heavy ballsack. Each nut has what feels like clusters of testes clumped together under its thick skin, a necessity to provide enough cum for the creature's many cocks. Only after you've had your fun playing with its balls and hearing it moan and rumble as you do are you ready to get to the main event.";
	else if anallevel is 3:
		say "     You suck down on a pair of your fingers, getting them wet before pressing them to the creature's taunt pucker. You rub and tease across it a few times before starting to prod at its clenched hole. The great beast rumbles in pleasure as you knead its rear with your free hand while working your slick digits into its back passage, getting those muscles to relax and open up, preparing for what is to come. While you keep going at it - longer than strictly necessary, enjoying the reactions you can get from your captive beast - your hands feel under the hydra, groping for its huge, heavy ballsack. Each nut has what feels like clusters of testes clumped together under its thick skin, a necessity to provide enough cum for the creature's many cocks. Only after you've had your fun playing with its balls and hearing it moan and rumble as you do are you ready to get to the main event.";
	say "     [if anallevel is 3]Having gotten its back entrance ready, you[else]You[end if] move into position, lining up your cock with the hydra's [if anallevel is 3]slick [end if]hole and push your [cock size desc of player] shaft into the beast. It releases rumbling moans from its many heads and grinds itself back onto your cock. Meanwhile, you make use of its thick tail as a convenient handhold, putting an arm around its length as you start thrusting at the green beast's tailhole. As you fuck the mythical creature, its primary head twists back around, coming in to kiss you. Its long tongue dives into your mouth and down your throat, and you suck on it happily, thrusting all the harder as you do.";
	say "     As you go on pounding into the hydra and making out with its main head at the same time, you become dimly aware that something changes after a short while - the pleased sounds of its other heads do start to sound a bit muffled. Curious what's going on, you break the kiss with your reptilian partner for a moment and look past its scaled visage - only to see Boghrim, standing at the creature's other end and pumping his massive prick into an elongated muzzle. The other side heads of the hydra aren't idle either, instead being put to good use lapping at the mighty orc's green skin and even eating out the crack of his ass. 'Yeah, that's what I'm talking about,' the orc roars in satisfaction and pumps into the vanquished beast, giving you a thumbs-up as his gaze meets yours.";
	WaitLineBreak;
	say "     After giving the mythic monster a good, hard pounding, you bury your [cock size desc of player] cock into it and moan in release. You shoot your [cum load size of player] load into its clenching asshole[if player is male] and across its meaty backside[end if], blast after blast of potent orcish seed flooding the big beast. As he sees you breed the large creature, Boghrim bellows, 'Yeah, let's give this fucker a cream filling!' Then he pumps into the hydra's open mouth with new vigor, climaxing before much longer and pumping his potent orc cum directly down its throat. The sudden spike in arousal as a double load of orc cum starts to show its effects causes the creature's many heads to growl lustfully as it climaxes itself, spraying gushers of cum from each of its [hydraheadcount] penises. Much of its load is sucked up by its additional heads, but plenty ends up leaving a sticky mess on the ground. When you're done and pull out, the hydra's many heads set themselves to licking you clean before you give it another long, tongue-filled kiss. Then you send it on its away, staggering a little and still lust-drunk, while leaving a trail of white cum dripping from its well-bred rear[if hydraheadcount > 6]. As it departs, you can see its extra heads already decaying away, dropping off and melting into fleshy goop until it's down to its original half-dozen[else if hydraheadcount < 6]. As it departs, you can see the bulges of new heads starting to form at the severed stumps, the creature soon to be back up to a half-dozen[end if].";
	if HP of Boghrim < 3:
		LineBreak;
		say "     As you make your way back to the orc lair, and when you share a drink soon after, you realize that the orc boss gives you... interested looks, and his cock stays half-hard the whole time. It seems you've impressed him today, proved that you're a 'real man' - he now might be more open to the possibility of getting fucked by you.";

to say BoghrimHydraSex2:
	project the figure of Boghrim_naked_icon;
	say "     Giving Boghrim a broad grin, you nod and quickly strip off your clothes, then step back up to the large reptile in front of you. You grab its primary head with both hands and pull it close to yours, then give the beast a hungry kiss. A surprised rumble goes through its throat, echoed by all the other heads as they turn into position to look at you with big eyes from all around. Faced with a clearly unexpected, pretty pleasant situation, the hydra makes no attempt to resist and even starts to reply in kind a moment later, sliding its slick tongue into your mouth. The two of you share a moment of companionable tongue-wrestling, until you eventually break the kiss - and find a number of its other heads stretched close, with somewhat hopeful expressions on their faces.";
	say "     You guess that someone should have just told Hercules that snogging the beast would have been a viable option - or at least in your case it was, as the creature seems far more at ease and compliant now. Well, now that you have the hydra calmed down, you're more than ready to have your fun with it and guide its head down to your crotch, ordering it to start licking. [if cocks of player > 1]Faced with your multiple loins, it rumbles softly and licks across them before you slide one of your cocks into its open muzzle[else]Faced with your throbbing manhood, the big reptile rumbles softly and licks over your erect shaft before sliding its muzzle over it[end if]. Working that long, forked tongue quite adeptly, your scaly partner plays it across your sensitive flesh and increases your arousal quickly. The creature shows considerable skill while sucking your cock, likely having lots of practice on itself and others.";
	WaitLineBreak;
	say "     As the hydra works to orally pleasure you with the main head, you do grab for its other heads and pull them into the fun, one by one. After sharing surprisingly steamy kisses (for a cold-blooded reptile) with each scaly head, accompanied by pleased hissing noises when you suck on their forked tongues, you guide each head into position, letting them pleasure your [bodydesc of player] body. Moving the ply-able and eager hydra heads to new spots from time to time, you enjoy having them lick and suck on your nipples, play over your [skin of player] skin and tickle your armpits, sending shivers of delight through you[if cocks of player > 2]. Making sure that your other cocks receive attention too, you swap hydra heads onto them as well[else if cocks of player is 2]. Making sure that your other cock receives attention too, you swap a hydra head onto it as well[end if][if anallevel is 3 and hydraheadcount > 4]. One of those heads even sneaks around to your ass when you're otherwise distracted by its numerous licking tongues and laps at your asshole. After a few teasing licks, it squirms the slick, meaty flesh past your relaxing muscles and into you, causing you to moan at the pleasant intrusion[end if].";
	say "     The sensual fest of oral pleasures you enjoy with the hydra is interrupted for a second as the big beast gives a surprisingly high-pitched squeal, whipping two of its less busy heads around to focus on Boghrim, now standing behind your reptilian playmate and using its thick tail as a handhold, just having buried his cock in its asshole with a mighty thrust. 'Yeah, that's what I'm talking about,' the orc roars in satisfaction and pumps into the vanquished beast. It's kinda funny to watch one of the hydra's raised heads cross its eyes and blink in amazement when the pain of Boghrim's initial penetration is soon replaced by pleasure, both from him bumping the beast's prostate as well as the potent orc precum leaking into its ass. Eventually, you catch the two heads again and pull them close, setting one back to work and making out with the other one.";
	WaitLineBreak;
	say "     Your threesome with the eagerly participating hydra is kept up for quite a while, until you can hold back no longer and cum with a long, loud moan, pumping your hot seed down the creature's [if cocks of player > 1]throats[else]throat[end if]. It feels amazing to have its muscles flex around your shaft as it swallows everything you can give, suckling eagerly to get every last bit of your tasty orc cum. As your load slides down into the big creature's stomach, it quickly unfolds its true potential, overwhelming the hydra with a sudden spike of pure lust that makes the beast blast its own load all over the ground below. Its massive balls churn out more and more creamy cum to add to the growing puddle underneath. Meanwhile, the twitching and squirming of your hydra's fuckhole around Boghrim's cock drive the large orc past his own point of no return and he blasts away with a rich load of orc cum to fill up the big reptile's rear.";
	say "     After giving you and your hunting buddy such fulfilling orgasms, you give the hydra beast's prime head another kiss, this one having lingering traces of your semen to flavor it. Then you send it on its away, staggering a little and still lust-drunk, while leaving a trail of white cum dripping from its well-bred rear[if hydraheadcount > 6]. As it departs, you can see its extra heads already decaying away, dropping off and melting into fleshy goop until it's down to its original half-dozen[else if hydraheadcount < 6]. As it departs, you can see the bulges of new heads starting to form at the severed stumps, the creature soon to be back up to a half-dozen[end if].";
	if HP of Boghrim < 3:
		LineBreak;
		say "     As you make your way back to the orc lair, and when you share a drink soon after, you realize that the orc boss gives you... interested looks, and his cock stays half-hard the whole time. It seems you've impressed him today, proved that you're a 'real man' - he now might be more open to the possibility of getting fucked by you.";

to say BoghrimTalk4: [talk about x]
	say "     ";

instead of fucking Boghrim:
	LineBreak;
	project the figure of Boghrim_naked_icon;
	setmonster "Orc Warrior";
	if player is not male or cockname of player is not "Orc Warrior" or player is not pure:
		say "     You're currently not quite 'man enough' to have sex with Boghrim. Brazenly approaching the mighty orc right in the middle of the drinking hall and under the eyes of the gathered orcs... seems something that only a true orc warrior would do - which you're not... right now.";
	else:
		now sextablerun is 0;
		blank out the whole of table of fucking options;
		[]
		choose a blank row in table of fucking options;
		now title entry is "Get fucked - Threesome";
		now sortorder entry is 1;
		now description entry is "Ask the orc leader to fuck you and have some fun with Jason at the same time";
		[]
		if HP of Boghrim > 0:
			choose a blank row in table of fucking options;
			now title entry is "Get fucked - one on one with Boghrim";
			now sortorder entry is 2;
			now description entry is "Ask the orc leader to fuck you";
		[]
		if HP of Boghrim > 0:
			choose a blank row in table of fucking options;
			now title entry is "Fuck him";
			now sortorder entry is 3;
			now description entry is "Ask if you can fuck Boghrim";
		[]
		if HP of Boghrim > 0 and MulAnalAcceptance > 2:
			choose a blank row in table of fucking options;
			now title entry is "Take Mul to be fucked upstairs";
			now sortorder entry is 4;
			now description entry is "Have a sex party with Boghrim, Mul and Jason";
		[]
		if HP of Boghrim > 2:
			choose a blank row in table of fucking options;
			now title entry is "A threesome in which you fuck him";
			now sortorder entry is 5;
			now description entry is "Stick your dick up Bogrim's rear end as he fucks Jason";
		[]
		if HP of Boghrim > 0 and MulAnalAcceptance > 6:
			choose a blank row in table of fucking options;
			now title entry is "Double-team Mul with Boghrim";
			now sortorder entry is 6;
			now description entry is "Take a 'trip' with Mul and Boghrim and share your bottom bitch with him";
		[]
		sort the table of fucking options in sortorder order;
		repeat with y running from 1 to number of filled rows in table of fucking options:
			choose row y from the table of fucking options;
			say "[link][y] - [title entry][as][y][end link][line break]";
		say "[link]0 - Nevermind[as]0[end link][line break]";
		while sextablerun is 0:
			say "Pick the corresponding number> [run paragraph on]";
			get a number;
			if calcnumber > 0 and calcnumber <= the number of filled rows in table of fucking options:
				now current menu selection is calcnumber;
				choose row calcnumber in table of fucking options;
				say "[title entry]: [description entry]?";
				if player consents:
					let nam be title entry;
					now sextablerun is 1;
					if (nam is "Get fucked - Threesome"):
						say "[BoghrimSex1]";
					if (nam is "Get fucked - one on one with Boghrim"):
						say "[BoghrimSex2]";
					if (nam is "Fuck him"):
						say "[BoghrimSex3]";
					if (nam is "Take Mul to be fucked upstairs"):
						say "[BoghrimSex4]";
					if (nam is "A threesome in which you fuck him"):
						say "[BoghrimSex5]";
					if (nam is "Double-team Mul with Boghrim"):
						say "[BoghrimSex6]";
					wait for any key;
			else if calcnumber is 0:
				now sextablerun is 1;
				say "     You step back from the orc boss, shaking your head slightly as he gives a questioning look.";
				wait for any key;
			else:
				say "Invalid Option. Pick between 1 and [the number of filled rows in the table of fucking options] or 0 to exit.";
		clear the screen and hyperlink list;

to say BoghrimFirstFuck:
	say "     The mighty orc grunts in satisfaction, then gives Jason another quick slap on the bare butt and says, 'Get up, you little slut - we're making this a private party now.' That said, he stands up himself and, without even bothering to put on his loincloth, leads his naked slave and yourself through the drinking hall, his thick prick proudly dangling between his legs. Soon, you're walking up a set of stairs up to the second floor and into the station chief's conference room. Like the rest of the station, things have been rearranged in there quite a bit, as there is no sign of any table or even chairs... instead, the room holds a mightily big, round fuck-pad of a bed, combined with piles of loot and a top of the line stereo system. Moving over to switch it on, Boghrim gives you a bragging grin as the beat of punk music vibrates in your bones for a second, then is turned down to the level of background music.";
	say "     While his master was setting the right atmosphere for some hot and heavy sex, Jason already sunk to his knees in front of you and undid your pants. Now he's looking up at you, an eager 'use me' expression on his face - which is something you just can't resist, holding up your hard prick and guiding the submissive human to take it in his mouth. And oh does he do a good job with that. Jason just slides those sexy lips up and up your shaft, going on to deep-throat you till his nose is buried right in your pubes - damn, Boghrim trains his bitches well! As Jason starts to bob up and down on your manhood, the broad-shouldered shape of the orc boss steps up beside you and his large hand slides down your back to tightly squeeze your right buttock.";
	WaitLineBreak;
	say "     You can feel Boghrim's hot breath against your cheek as he leans in and licks your face, then speaks in a lusty murmur, 'Yeah, you like that pretty little pink-skinned slut's lips, don't you? But there's something you'll like even more...' That said, the orc takes hold of his long and impressively thick erection, slapping it against your thigh with a meaty slap. 'You wanted this and now you're gonna have it! Get on the bed, both of you!' As Jason pulls of your manhood with a little slurp and happily jumps on the bed, your eyes are drawn to the shapely butt on him and his well-sized penis (for a human, that is).";
	LineBreak;
	say "     What kind of fun do you want to have with Boghrim's favorite slave as the orc himself fucks you? Sink your shaft balls-deep into the muscular guy or share a blowjob with him in the typical 69 position?";
	LineBreak;
	say "     ([link]Y[as]y[end link]) - Fuck him.";
	say "     ([link]N[as]n[end link]) - 69.";
	if player consents:
		LineBreak;
		say "     Climbing on the bed behind Jason, you snake an arm around his chest and pull him against your chest, then stretch around to give him a deep and hungry kiss that goes on and on. After exploring the willing slave's mouth with your tongue a bit and letting your hands wander over his smooth-skinned muscular form, you give Jason a sudden shove that has him fall forwards onto the soft sheets. Pouncing the human before he can react in any way, you hold him down as he is with a hand on his broad back, face pressed into the soft sheets, while your other hand guides your prick to rub between his cheeks. Being such a well-trained butt-slut, the young man can't help raise his bubble butt for you to mount, loudly moaning, 'Yes please! Take me deep! I need it!'";
		say "     More than willing to oblige the subby human, you immediately set your cockhead at his opening and thrust deep, sinking more than half your erection into him in one go. Jason just gives an aroused gasp at being mounted like this - unsurprising, as he's used to being taken roughly by horny orcs... as evidenced by the copious amounts of cum you feel around your member, squishing around in his asshole and lubing your way. You bottom out in the young man and hold still for a second to revel in the feeling of his stretched chute around your shaft, then start fucking him with sharp little thrusts that make your hips hit his ass with satisfying slaps.";
		WaitLineBreak;
		say "     You can feel the mattress shift as Boghrim gets on the bed too, moving up behind and looming at the edge of your vision as a broad-shouldered green shape. 'Yeah, fuck that slut! Fuck him like only an orc can!' you can hear from him, followed by, 'I'm gonna enjoy taking a real man for once.' With that, he gets up close to you, wrapping his strong arms around your chest from behind, making his massive shaft poke you in the back hotly. Large fingers tease your nipples for a second, then Boghrim's hand slides between the two of you, grasping his member and pressing it against your quivering pucker. He inches his hips forward slowly, until your opening finally yields to his thick shaft, stretching wide as the orc's cockhead sinks into your body.";
		say "     Boghrim's manhood feels amazing inside your hole, filling it very nicely with its impressive girth. Combining the sensations of him bumping all the right spots with that thick piece of man-meat with feeling the mighty orc's strong arms holding you... gets your own erection get even harder inside Jason. Then the orc boss pulls back a bit before thrusting deep into you, giving a deep and lusty grunt as his hips meet your cheeks with a resounding slap that is immediately followed by an aroused gasp from both you and Jason. What follows is a wild threesome of rough orc sex, with Boghrim fucking you hard and deep, really pounding into you from behind - which at the same time pushes your own erection again and again into the ecstatically whimpering human slave's upturned ass.";
		WaitLineBreak;
		say "     You don't know how long your coupling takes, three sweaty bodies moving in unison to the beat of a fast-paced selection of punk-rock songs, but one thing is sure - you wanna do it again, and soon! After a breathtaking time of pounding the willing butt-slut under you while taking it from the biggest and baddest orc there is, you eventually reach the point of no return and roar out loud as an orgasm crashes over you like a wave. Hammering into Jason all the way and pushing him deep into the soft expanse of the round bed, you fulfill your body's imperative to breed the little slut and blast away with a massive load of rich, thick orc cum, pulsing through your shaft and deep into his insides.";
		say "     Reaching your climax pushes your two partners over the edge a moment later too - Jason, from the sensations of feeling all of your potent seed being pumped into him and a slave's delight at having pleased his masters, and Boghrim, from the tightness of your hole as it twitches and flexes with each spurt of your cum. The mighty orc gives a lust-fueled bellow, arms tightening around your body as he possessively clutches you to his chest, then as the first blast of his seed splashes into you, he sinks his canines into the curve of your neck in a shallow bite. Between the high of your own orgasm and Boghrim's cum having its effect on you, the pain of being chomped on barely registers in your mind - and he didn't really try to hurt you either, just a shallow bite in the throes of passion - though at least his long tusks will surely leave a mark.";
		WaitLineBreak;
		say "     As spurt after spurt of the big orc's cum fills you and Boghrim slowly winds down, he starts to loosen his grip on you and after a few more half-grunted pants, he says, 'Fuck yeah! You can definitively come back anytime and I'll fuck you good! Bitches like Jason are great, but this -', he grips your firm asscheeks with both hands and gives [']em a tight squeeze, '- is a real man's butt, worthy of my hard shaft!' Looking down and noticing the bite-marks he left on your shoulder, the orc licks over them with a slow swipe of his broad tongue, then adds, 'Bear these marks with pride - you're the first guy I fucked that I didn't take as a slave afterwards.'";
		say "     Waiting some time longer till the last little spurt of his load is deposited deep inside your hole, the orc pulls out with a wet slurp and moves to kneel beside you on the bed. Giving you a little poke in the side with his elbow and a wide grin, he add with a chuckle, 'Watch this.' Then Boghrim bellows, 'Clean us up, slave!', which results in Jason almost jumping off the bed... or well, at least instantly coming to stand on his feet from the sudden fright. The panting young man then kneels down immediately and goes down on his master, slurping the remnants of his load up from the orc's shaft and lapping at his pubes. After Boghrim has been cleaned of cum, Jason moves on to you, licking up your own load before getting in position to eat his master's cum out of your hole.";
		WaitLineBreak;
		say "     Eventually, as Jason finishes with you two and joins Boghrim in a post-coital nap cuddled up against his master's side, you get back up from the bed and gather up your belongings. While doing so, you notice that the sting of the teethmarks on your shoulder has already faded completely, and by craning your neck a bit, you see that the nanites have already healed them over - though not without leaving two spots of distinctive scarring. Something to remember your first time with Boghrim by, it seems. Putting on your clothes and gear, you then make your way back down into the drinking hall.";
	else:
		LineBreak;
		say "     Climbing on the bed to join Jason, you snake an arm around his back and pull him against your chest, then give him a deep and hungry kiss that goes on and on. After exploring the willing slave's mouth with your tongue a bit and letting your hands wander over his smooth-skinned muscular form, you give the young man a sudden shove that has him fall backwards onto the soft sheets. Pouncing the human before he can react in any way, you hold him down as he is with a hand on his broad chest, pressing him into the soft sheets, then move into position to kneel over him on all fours - with your crotch above his face and his in front of yours. Being such a well-trained butt-slut, the young man immediately takes hold of your shaft and starts to lap at it, loudly moaning, 'Mmmmh! Tasty!' before he takes your cockhead into his mouth and can only mumble around it anymore.";
		say "     More than willing to return the favor to the subby human, you lean forward yourself and bring your lips to his well-sized cock (for a human, that is) and go down on it. Something in Jason's murmurs around your shaft tells you how pleased he is at for once being the one getting a blowjob, not only giving them all the time, so you really put in some extra effort to reward the slave for his amazing tonguework on your own hardon.";
		WaitLineBreak;
		say "     You can feel the mattress shift as Boghrim gets on the bed too, moving up behind and looming at the edge of your vision as a broad-shouldered green shape. 'Those lips feel great on your cock, don't they? I love the little bitch - even though he's a new slave, he's definitively my favorite,' you can hear from him, followed by, 'I'm gonna enjoy taking a real man for once.' With that, he gets up close to you, wrapping his strong arms around your chest from behind, making his massive shaft poke you in the back hotly. Large fingers tease your nipples for a second, then Boghrim's hand slides between the two of you, grasping his member and pressing it against your quivering pucker. He inches his hips forward slowly, until your opening finally yields to his thick shaft, stretching wide as the orc's cockhead sinks into your body.";
		say "     Boghrim's manhood feels amazing inside your hole, filling it very nicely with its impressive girth. Combining the sensations of him bumping all the right spots with that thick piece of man-meat with feeling the mighty orc's strong arms holding you... gets your own erection get even harder inside Jason's mouth. Then the orc boss pulls back a bit before thrusting deep into you, giving a deep and lusty grunt as his hips meet your cheeks with a resounding slap that is immediately followed by an aroused gasp from both you and Jason. What follows is a wild threesome of rough orc sex, with Boghrim fucking you hard and deep, really pounding into you from behind - which at the same time pushes your own erection again and again into the ecstatically whimpering human slave's mouth and throat.";
		WaitLineBreak;
		say "     You don't know how long your coupling takes, three sweaty bodies moving in unison to the beat of a fast-paced selection of punk-rock songs, but one thing is sure - you wanna do it again, and soon! After a breathtaking time of deep-throat face-fucking the willing butt-slut under you while taking it from the biggest and baddest orc there is, you eventually reach the point of no return and roar out loud as an orgasm crashes over you like a wave. Hammering into Jason all the way and pushing him deep into the soft expanse of the round bed, you blast away with a massive load of rich, thick orc cum, pulsing through your shaft and directly into the little slut's stomach.";
		say "     Reaching your climax pushes your two partners over the edge a moment later too - Jason, spurting his seed in your mouth to be hungrily devoured, coming from the sensations of feeling all of your potent seed being pumped into him and a slave's delight at having pleased his masters, and Boghrim, from the tightness of your hole as it twitches and flexes with each spurt of your cum. The mighty orc gives a lust-fueled bellow, arms tightening around your body as he possessively clutches you to his chest, then as the first blast of his seed splashes into you, he sinks his canines into the curve of your neck in a shallow bite. Between the high of your own orgasm and Boghrim's cum having its effect on you, the pain of being chomped on barely registers in your mind - and he didn't really try to hurt you either, just a shallow bite in the throes of passion - though at least his long tusks will surely leave a mark.";
		WaitLineBreak;
		say "     As spurt after spurt of the big orc's cum fills you and Boghrim slowly winds down, he starts to loosen his grip on you and after a few more half-grunted pants, he says, 'Fuck yeah! You can definitively come back anytime and I'll fuck you good! Bitches like Jason are great, but this -', he grips your firm asscheeks with both hands and gives [']em a tight squeeze, '- is a real man's butt, worthy of my hard shaft!' Looking down and noticing the bite-marks he left on your shoulder, the orc licks over them with a slow swipe of his broad tongue, then adds, 'Bear these marks with pride - you're the first guy I fucked that I didn't take as a slave afterwards.'";
		say "     Waiting some time longer till the last little spurt of his load is deposited deep inside your hole, the orc pulls out with a wet slurp and moves to kneel beside you on the bed. Giving you a little poke in the side with his elbow and a wide grin, he add with a chuckle, 'Watch this.' Then Boghrim bellows, 'Clean us up, slave!', which results in Jason almost jumping off the bed... or well, at least instantly coming to stand on his feet from the sudden fright. The panting young man then kneels down immediately and goes down on his master, slurping the remnants of his load up from the orc's shaft and lapping at his pubes. After Boghrim has been cleaned of cum, Jason moves on to you, licking up your own load before getting in position to eat his master's cum out of your hole.";
		WaitLineBreak;
		say "     Eventually, as Jason finishes with you two and joins Boghrim in a post-coital nap cuddled up against his master's side, you get back up from the bed and gather up your belongings. While doing so, you notice that the sting of the teethmarks on your shoulder has already faded completely, and by craning your neck a bit, you see that the nanites have already healed them over - though not without leaving two spots of distinctive scarring. Something to remember your first time with Boghrim by, it seems. Putting on your clothes and gear, you then make your way back down into the drinking hall.";
	if "Boghrim's Mark" is not listed in feats of player:
		add "Boghrim's Mark" to feats of player;
	now HP of Boghrim is 1;

to say BoghrimSex1: [get fucked]
	if HP of Boghrim is 0: [never fucked]
		say "     Just openly walking up to Boghrim and offering sex might have drastic consequences. Who knows how he'd react to that. Do you really want to do it?";
		LineBreak;
		say "     ([link]Y[as]y[end link]) - Yes.";
		say "     ([link]N[as]n[end link]) - No.";
		if player consents:
			say "     As you quietly ask the mighty orc to fuck you, he eyes you with surprise on his face and... interest in his eyes. 'Never thought I'd see a strong orc warrior ask to be my bottom boy. What are you then? A weak little breeder who chugged orc brew to gain the confidence to ask the boss-man for a fuck, or a real man with some deviant tastes?' Reaching over to casually grope the orc breeder leaning against his side and make him suckle on two fingers pushed into his mouth, Boghrim continues, 'I have enough sluts really, but... if you prove you're an actual warrior, I'll take you up as a fuck-buddy. You'd be someone to enjoy as a treat... pounding a real man's ass for a change. Go on then - prove yourself! Punch out Glarbuk.' Following the orc's pointing finger, your gaze falls on a big brute of an orc - who just at that moment head-butts another orc into unconsciousness to take his beer. Not someone you'd look forward to fighting, but something tells you it is far too late to back out of this...";
			say "     Swallowing reflexively as your gaze wanders over the bulging muscles of the monstrously built orc, you steel your resolve and step down from Boghrim's platform, walking towards your designated target. On the way, you pick up an empty beer stein, nice and heavy - perfect to assist in a sucker punch. As you step up to the hulking orc and tap him on the shoulder, you smash the mug over his head as soon as he turns around - which only dents the mug and leaves the orc pretty unimpressed. Uh Oh. This won't be over as quickly as you hoped... ";
			now inasituation is true;
			now OrcSpecialFightNumber is 2;
			repeat with y running from 1 to number of filled rows in Table of Random Critters:
				choose row y in Table of Random Critters;
				if name entry is "Orc Warrior":
					now monster is y;
					break;
			choose row monster from the Table of Random Critters;
			now HP entry is 250;
			now monsterHP is 250;
			now lev entry is 16;
			now wdam entry is 25;
			challenge "Orc Warrior";
			repeat with y running from 1 to number of filled rows in Table of Random Critters:
				choose row y in Table of Random Critters;
				if name entry is "Orc Warrior":
					now monster is y;
					break;
			choose row monster from the Table of Random Critters;
			now HP entry is 125;
			now monsterHP is 125;
			now lev entry is 14;
			now wdam entry is 15;
		else:
			say "     You decide to better play it safe and put those plans on ice - for now...";
	else if HP of Boghrim is 1: [fuck buddy]
		say "     You step up on the orc boss's platform and find Boghrim with his favorite slave Jason stretched out over his lap, ass up and getting fingered by Boghrim's thick fingers. After you give the muscled green male a suggestive wink and nod towards the stairs leading up to his private rooms, Boghrim slaps Jason's ass playfully, which makes makes the young man pant in arousal. Then the orc pulls him aside, making his hard prick whip up, now that there isn't a submissive human lying on it anymore. While Jason automatically starts to worship his Master's shaft, stroking and licking it, Boghrim gives a telling look from the thick pole of man-meat to you and back, then loudly says, 'Time to... share this little slut between us again. Let's do it!'";
		say "     The mighty orc grunts in satisfaction, then gives Jason another quick slap on the bare butt and says, 'Get up, boytoy - we're making this a private party now.' That said, he stands up himself and, without even bothering to put on his loincloth, leads his naked slave and yourself through the drinking hall, his thick prick proudly dangling between his legs. Soon, you're walking up a set of stairs up to the second floor and into the station chief's conference room. Like the rest of the station, things have been rearranged in there quite a bit, as there is no sign of any table or even chairs... instead, the room holds a mightily big, round fuck-pad of a bed, combined with piles of loot and a top of the line stereo system. Moving over to switch it on, Boghrim gives you a bragging grin as the beat of punk music vibrates in your bones for a second, then is turned down to the level of background music.";
		WaitLineBreak;
		say "     While his master was setting the right atmosphere for some hot and heavy sex, Jason already sunk to his knees in front of you and undid your pants. Now he's looking up at you, an eager 'use me' expression on his face - which is something you just can't resist, holding up your hard prick and guiding the submissive human to take it in his mouth. And oh does he do a good job with that. Jason just slides those sexy lips up and up your shaft, going on to deep-throat you till his nose is buried right in your pubes - damn, Boghrim trains his bitches well! As Jason starts to bob up and down on your manhood, the broad-shouldered shape of the orc boss steps up beside you and his large hand slides down your back to tightly squeeze your right buttock.";
		say "     You can feel Boghrim's hot breath against your cheek as he leans in and licks your face, then speaks in a lusty murmur, 'Yeah, you like that pretty little pink-skinned slut's lips, don't you? But there's something you'll like even more...' That said, the orc takes hold of his long and impressively thick erection, slapping it against your thigh with a meaty slap. 'You wanted this and now you're gonna have it! Get on the bed, both of you!' As Jason pulls of your manhood with a little slurp and happily jumps on the bed, your eyes are drawn to the shapely butt on him and his well-sized penis (for a human, that is).";
		WaitLineBreak;
		say "     What kind of fun do you want to have with Boghrim's favorite slave as the orc himself fucks you? Sink your shaft balls-deep into the muscular guy or share a blowjob with him in the typical 69 position? ";
		LineBreak;
		say "     ([link]Y[as]y[end link]) - Fuck him.";
		say "     ([link]N[as]n[end link]) - 69.";
		if player consents:
			LineBreak;
			say "     Climbing on the bed behind Jason, you snake an arm around his chest and pull him against your chest, then stretch around to give him a deep and hungry kiss that goes on and on. After exploring the willing slave's mouth with your tongue a bit and letting your hands wander over his smooth-skinned muscular form, you give Jason a sudden shove that has him fall forwards onto the soft sheets. Pouncing the human before he can react in any way, you hold him down as he is with a hand on his broad back, face pressed into the soft sheets, while your other hand guides your prick to rub between his cheeks. Being such a well-trained butt-slut, the young man can't help raise his bubble butt for you to mount, loudly moaning, 'Yes please! Take me deep! I need it!'";
			say "     More than willing to oblige the subby human, you immediately set your cockhead at his opening and thrust deep, sinking more than half your erection into him in one go. Jason just gives an aroused gasp at being mounted like this - unsurprising, as he's used to being taken roughly by horny orcs... as evidenced by the copious amounts of cum you feel around your member, squishing around in his asshole and lubing your way. You bottom out in the young man and hold still for a second to revel in the feeling of his stretched chute around your shaft, then start fucking him with sharp little thrusts that make your hips hit his ass with satisfying slaps.";
			WaitLineBreak;
			say "     You can feel the mattress shift as Boghrim gets on the bed too, moving up behind and looming at the edge of your vision as a broad-shouldered green shape. 'Yeah, fuck that slut! Fuck him like only an orc can!' you can hear from him, followed by, 'I'm gonna enjoy taking a real man for once.' With that, he gets up close to you, wrapping his strong arms around your chest from behind, making his massive shaft poke you in the back hotly. Large fingers tease your nipples for a second, then Boghrim's hand slides between the two of you, grasping his member and pressing it against your quivering pucker. He inches his hips forward slowly, until your opening finally yields to his thick shaft, stretching wide as the orc's cockhead sinks into your body.";
			say "     Boghrim's manhood feels amazing inside your hole, filling it very nicely with its impressive girth. Combining the sensations of him bumping all the right spots with that thick piece of man-meat with feeling the mighty orc's strong arms holding you... gets your own erection get even harder inside Jason. Then the orc boss pulls back a bit before thrusting deep into you, giving a deep and lusty grunt as his hips meet your cheeks with a resounding slap that is immediately followed by an aroused gasp from both you and Jason. What follows is a wild threesome of rough orc sex, with Boghrim fucking you hard and deep, really pounding into you from behind - which at the same time pushes your own erection again and again into the ecstatically whimpering human slave's upturned ass.";
			WaitLineBreak;
			say "     You don't know how long your coupling takes, three sweaty bodies moving in unison to the beat of a fast-paced selection of punk-rock songs, but one thing is sure - you wanna do it again, and soon! After a breathtaking time of pounding the willing butt-slut under you while taking it from the biggest and baddest orc there is, you eventually reach the point of no return and roar out loud as an orgasm crashes over you like a wave. Hammering into Jason all the way and pushing him deep into the soft expanse of the round bed, you fulfill your body's imperative to breed the little slut and blast away with a massive load of rich, thick orc cum, pulsing through your shaft and deep into his insides.";
			say "     Reaching your climax pushes your two partners over the edge a moment later too - Jason, creaming the sheets under him from the sensations of feeling all of your potent seed being pumped into him and a slave's delight at having pleased his masters, and Boghrim, from the tightness of your hole as it twitches and flexes with each spurt of your cum. The mighty orc gives a lust-fueled bellow, arms tightening around your body as he possessively clutches you to his chest, then the first blast of his seed splashes into you, followed by another and another.";
			WaitLineBreak;
			say "     As more and more orcish cum fills you with each moment, Boghrim slowly winds down and he starts to loosen his grip on you. After a few more half-grunted pants, he says, 'Fuck yeah! You can definitively come back anytime and I'll fuck you good! Bitches like Jason are great, but this -', he grips your firm asscheeks with both hands and gives [']em a tight squeeze, '- is a real man's butt, worthy of my hard shaft!' Looking down at your shoulder and noticing the scars he left after your first coupling, the orc licks over them with a slow swipe of his broad tongue, then adds, 'Bear these marks with pride - you're the first guy I fucked that I didn't take as a slave afterwards.'";
			say "     Waiting some time longer till the last little spurt of his load is deposited deep inside your hole, the orc pulls out with a wet slurp and moves to kneel beside you on the bed. Giving you a little poke in the side with his elbow and a wide grin, he add with a chuckle, 'Watch this.' Then Boghrim bellows, 'Clean us up, slave!', which results in Jason almost jumping off the bed... or well, at least instantly coming to stand on his feet from the sudden fright. The panting young man then kneels down immediately and goes down on his master, slurping the remnants of his load up from the orc's shaft and lapping at his pubes. After Boghrim has been cleaned of cum, Jason moves on to you, licking up your own load before getting in position to eat his master's cum out of your hole.";
			WaitLineBreak;
			say "     Eventually, as Jason finishes with you two and joins Boghrim in a post-coital nap cuddled up against his master's side, you get back up from the bed and gather up your belongings. While doing so, you notice the distinct scars made by Boghrim's tusks on your shoulder again from the corner of your eye. Somehow, you can't help but feel good about having them, knowing that the mighty orc has accepted you as the only free man he has sex with. Putting on your clothes and gear, you then make your way back down into the drinking hall.";
		else:
			LineBreak;
			say "     Climbing on the bed to join Jason, you snake an arm around his back and pull him against your chest, then give him a deep and hungry kiss that goes on and on. After exploring the willing slave's mouth with your tongue a bit and letting your hands wander over his smooth-skinned muscular form, you give the young man a sudden shove that has him fall backwards onto the soft sheets. Pouncing the human before he can react in any way, you hold him down as he is with a hand on his broad chest, pressing him into the soft sheets, then move into position to kneel over him on all fours - with your crotch above his face and his in front of yours. Being such a well-trained butt-slut, the young man immediately takes hold of your shaft and starts to lap at it, loudly moaning, 'Mmmmh! Tasty!' before he takes your cockhead into his mouth and can only mumble around it anymore.";
			say "     More than willing to return the favor to the subby human, you lean forward yourself and bring your lips to his well-sized cock (for a human, that is) and go down on it. Something in Jason's murmurs around your shaft tells you how pleased he is at for once being the one getting a blowjob, not only giving them all the time, so you really put in some extra effort to reward the slave for his amazing tonguework on your own hardon.";
			WaitLineBreak;
			say "     You can feel the mattress shift as Boghrim gets on the bed too, moving up behind and looming at the edge of your vision as a broad-shouldered green shape. 'Those lips feel great on your cock, don't they? I love the little bitch - even though he's a new slave, he's definitively my favorite,' you can hear from him, followed by, 'I'm gonna enjoy taking a real man for once.' With that, he gets up close to you, wrapping his strong arms around your chest from behind, making his massive shaft poke you in the back hotly. Large fingers tease your nipples for a second, then Boghrim's hand slides between the two of you, grasping his member and pressing it against your quivering pucker. He inches his hips forward slowly, until your opening finally yields to his thick shaft, stretching wide as the orc's cockhead sinks into your body.";
			say "     Boghrim's manhood feels amazing inside your hole, filling it very nicely with its impressive girth. Combining the sensations of him bumping all the right spots with that thick piece of man-meat with feeling the mighty orc's strong arms holding you... gets your own erection get even harder inside Jason's mouth. Then the orc boss pulls back a bit before thrusting deep into you, giving a deep and lusty grunt as his hips meet your cheeks with a resounding slap that is immediately followed by an aroused gasp from both you and Jason. What follows is a wild threesome of rough orc sex, with Boghrim fucking you hard and deep, really pounding into you from behind - which at the same time pushes your own erection again and again into the ecstatically whimpering human slave's mouth and throat.";
			WaitLineBreak;
			say "     You don't know how long your coupling takes, three sweaty bodies moving in unison to the beat of a fast-paced selection of punk-rock songs, but one thing is sure - you wanna do it again, and soon! After a breathtaking time of deep-throat face-fucking the willing butt-slut under you while taking it from the biggest and baddest orc there is, you eventually reach the point of no return and roar out loud as an orgasm crashes over you like a wave. Hammering into Jason all the way and pushing him deep into the soft expanse of the round bed, you blast away with a massive load of rich, thick orc cum, pulsing through your shaft and directly into the little slut's stomach.";
			say "     Reaching your climax pushes your two partners over the edge a moment later too - Jason, spurting his seed in your mouth to be hungrily devoured, coming from the sensations of feeling all of your potent seed being pumped into him and a slave's delight at having pleased his masters, and Boghrim, from the tightness of your hole as it twitches and flexes with each spurt of your cum. The mighty orc gives a lust-fueled bellow, arms tightening around your body as he possessively clutches you to his chest, then the first blast of his seed splashes into you, followed by another and another.";
			WaitLineBreak;
			say "     As more and more orcish cum fills you with each moment, Boghrim slowly winds down and he starts to loosen his grip on you. After a few more half-grunted pants, he says, 'Fuck yeah! You can definitively come back anytime and I'll fuck you good! Bitches like Jason are great, but this -', he grips your firm asscheeks with both hands and gives [']em a tight squeeze, '- is a real man's butt, worthy of my hard shaft!' Looking down at your shoulder and noticing the scars he left after your first coupling, the orc licks over them with a slow swipe of his broad tongue, then adds, 'Bear these marks with pride - you're the first guy I fucked that I didn't take as a slave afterwards.'";
			say "     Waiting some time longer till the last little spurt of his load is deposited deep inside your hole, the orc pulls out with a wet slurp and moves to kneel beside you on the bed. Giving you a little poke in the side with his elbow and a wide grin, he add with a chuckle, 'Watch this.' Then Boghrim bellows, 'Clean us up, slave!', which results in Jason almost jumping off the bed... or well, at least instantly coming to stand on his feet from the sudden fright. The panting young man then kneels down immediately and goes down on his master, slurping the remnants of his load up from the orc's shaft and lapping at his pubes. After Boghrim has been cleaned of cum, Jason moves on to you, licking up your own load before getting in position to eat his master's cum out of your hole.";
			WaitLineBreak;
			say "     Eventually, as Jason finishes with you two and joins Boghrim in a post-coital nap cuddled up against his master's side, you get back up from the bed and gather up your belongings. While doing so, you notice the distinct scars made by Boghrim's tusks on your shoulder again from the corner of your eye. Somehow, you can't help but feel good about having them, knowing that the mighty orc has accepted you as the only free man he has sex with. Putting on your clothes and gear, you then make your way back down into the drinking hall.";

to say BoghrimSex2: [get fucked]
	say "     You step up on the orc boss's platform and find Boghrim with his favorite slave Jason stretched out over his lap, ass up and getting fingered by Boghrim's thick fingers. After you give the muscled green male a suggestive wink and nod towards the stairs leading up to his private rooms, Boghrim slaps Jason's ass playfully, which makes makes the young man pant in arousal. Then the orc pulls him aside, making his hard prick whip up, now that there isn't a submissive human lying on it anymore. While Jason automatically starts to worship his Master's shaft, stroking and licking it, Boghrim gives a telling look from the thick pole of man-meat to you and back, then loudly says, 'Time to... share this little slut between us again. Let's do it!'";
	say "     The mighty orc grunts in satisfaction, then gives Jason another quick slap on the bare butt and says, 'Get up, boytoy - we're making this a private party now.' That said, he stands up himself and, without even bothering to put on his loincloth, leads his naked slave and yourself through the drinking hall, his thick prick proudly dangling between his legs. Soon, you're walking up a set of stairs up to the second floor and into the station chief's conference room. Like the rest of the station, things have been rearranged in there quite a bit, as there is no sign of any table or even chairs... instead, the room holds a mightily big, round fuck-pad of a bed, combined with piles of loot and a top of the line stereo system. Moving over to switch it on, Boghrim gives you a bragging grin as the beat of punk music vibrates in your bones for a second, then is turned down to the level of background music.";
	WaitLineBreak;
	say "     While his master was setting the right atmosphere for some hot and heavy sex, Jason already sunk to his knees in front of you and undid your pants. Now he's looking up at you, an eager 'use me' expression on his face - which is something you just can't resist, holding up your hard prick and guiding the submissive human to take it in his mouth. And oh does he do a good job with that. Jason just slides those sexy lips up and up your shaft, going on to deep-throat you till his nose is buried right in your pubes - damn, Boghrim trains his bitches well! As Jason starts to bob up and down on your manhood, the broad-shouldered shape of the orc boss steps up beside you and his large hand slides down your back to tightly squeeze your right buttock.";
	say "     You can feel Boghrim's hot breath against your cheek as he leans in and licks your face, then speaks in a lusty murmur, 'Yeah, you like that pretty little pink-skinned slut's lips, don't you? But there's something you'll like even more...' That said, the orc takes hold of his long and impressively thick erection, slapping it against your thigh with a meaty slap. 'You wanted this and now you're gonna have it! Get on the bed, both of you!' But as Jason pulls off your manhood with a little slurp, you grab him by the shoulder and tell him to stay out of it this time. Mixed feelings flash over the young man's face as his urge to submit and follow orders clashes with a true bottom's desire to be used, pounded hard by his orc masters or sucking a heavy load from a thick cock in his mouth. Then the slave complies, moving over to sit on a nearby office chair stroking his cock as he watches Boghrim and you.";
	WaitLineBreak;
	say "     The big orc chuckles as he hears you telling Jason to sit this one out, then remarks, 'Can't get enough of my hard cock, can you? Don't wanna share with anyone - ha! Fine, you'll get what you need, buddy. I'll pound you till you can't sit straight.' Climbing on the bed, you let yourself fall on your back, presenting all your naked glory to the orc boss and his eagerly watching slave-boy. You even spread your legs in obvious invitation, bracing both feet on the soft mattress and raising your hips to show your waiting hole. 'Oh yeah, you're gonna get it - hard,' the orc grunts in a lusty tone, then steps forward, one hand on his massive prick.";
	say "     You can feel the mattress shift as Boghrim gets on the bed too, coming to loom over you as he kneels between your legs. Mutual lust almost crackles in the air for a moment, then his weighty erection bumps against your own as Boghrim adjusts his position, drawing an aroused grunt from the muscled green male. True to his orcish desires to dominate others, the mighty orc literally pounces on you, grabbing you by the shoulders and pushing you deeper into the mattress as his body comes to cover yours. Boghrim leans over you like that for a second or two, looking deep into your eyes while his hips move to grind your cocks against one another, then the orc brings his lips to yours for a pretty rough and tempestuous bit of making out. Nevertheless, it's still clear that he's the one in control, initiating each hungry kiss and pushing his broad tongue into your mouth to wrestle with yours.";
	WaitLineBreak;
	say "     In between lusty grunts and grinding his tusks against yours in the progress of snogging with you, the orc growls, 'I'm gonna enjoy taking a real man for once.' Eventually, he pulls his head back and gives your body a lewd look, then puts both his hands on your pecs and gives them an appreciative squeeze before biting down lightly on one, his tusks almost piercing your skin while his tongue plays over a nipple, leaving you with a surprisingly pleasant mix of sensations. While Boghrim is still nipping and licking at your chest, one of his hands guides the thick piece of man-meat between his legs right against your own quivering pucker. You can feel the large head of his cock rest hotly against your skin, bringing with it a wet and somewhat euphoric feeling as he leaks precum that is absorbed by your body. The large orc inches his hips forward slowly, until your opening finally yields to his thick shaft, stretching wide as his cockhead sinks into your body.";
	say "     Boghrim's manhood feels amazing inside your hole, filling it very nicely with its impressive girth. Combining the sensations of him bumping all the right spots with that thick piece of man-meat and feeling the mighty orc's strong arms holding you down... makes your own erection get even harder, to stand proudly erect over your navel. Then the orc boss pulls back almost all the way before thrusting deep into you, giving a deep and lusty grunt as his hips meet your cheeks with a resounding slap. A gasp from somewhere to the side draws your attention for a second, and before Boghrim's next thrust makes your eyes roll back and you moan loudly, you have just enough time to realize it's Jason, pumping fingers in and out of his own hole as he watches his master fuck. What follows afterwards is just what the orc boss said he'd do - pounding your ass hard and oh so very deep, using you as his willing butt-slut and driving you deeper and deeper into a lust-filled haze.";
	WaitLineBreak;
	say "     You don't know how long your coupling takes, two sweaty bodies moving in unison to the beat of a fast-paced selection of punk-rock songs, but one thing is sure - you wanna do it again, and soon! After a breathtaking time of taking it from the biggest and baddest orc there is, you eventually reach the point of no return and roar out loud as an orgasm crashes over you like a wave. Digging your hands into the sheets and rocking your hips to grind against the thick cock inside your ass, you blast away with a massive load of rich, thick orc cum, pulsing through your shaft and splattering all over your chest.";
	say "     Reaching your climax pushes your partner over the edge in short notice, as your fuckhole twitches and flexes with each spurt of your cum. The mighty orc gives a lust-fueled bellow, arms tightening on your arms as he pins you down, then the first blast of his seed splashes into you, followed by another and another. As more and more orcish cum fills you with each moment, Boghrim slowly winds down and he starts to loosen his grip on you. After a few more half-grunted pants, he says, 'Fuck yeah! You can definitively come back anytime and I'll fuck you good! Bitches like Jason are great, but this -', he reaches around to grip your firm asscheeks with both hands and gives [']em a tight squeeze, '- is a real man's butt, worthy of my hard shaft!' Looking down at your shoulder and noticing the scars he left after your first coupling, the orc licks over them with a slow swipe of his broad tongue, then adds, 'Bear these marks with pride - you're the first guy I fucked that I didn't take as a slave afterwards.'";
	WaitLineBreak;
	say "     Waiting some time longer till the last little spurt of his load is deposited deep inside your hole, the orc pulls out with a wet slurp and moves to lie beside you on the bed, with his upper body partly raised. Giving you a little poke in the side with his elbow and a wide grin, he add with a chuckle, 'Watch this.' Then Boghrim bellows, 'Clean us up, slave!', which results in Jason instantly jumping up from his chair and hurrying to the bed. The panting young man then kneels down immediately and goes down on his master, slurping the remnants of his load up from the orc's shaft and lapping at his pubes. After Boghrim has been cleaned of cum, Jason moves on to you, getting in position to eat his master's cum out of your hole.";
	say "     Eventually, as Jason finishes with you two and joins Boghrim in a post-coital nap cuddled up against his master's side, you get back up from the bed and gather up your belongings. While doing so, you notice the distinct scars made by Boghrim's tusks on your shoulder again from the corner of your eye. Somehow, you can't help but feel good about having them, knowing that the mighty orc has accepted you as the only free man he has sex with. Putting on your clothes and gear, you then make your way back down into the drinking hall.";

to say BoghrimSex3: [fuck him]
	if HP of Boghrim < 2:
		say "     Right now, the best you can expect if you ask to fuck him is a punch to the face that knocks you out. Maybe you should get to know the mighty orc a bit better before trying that... a hunting trip out into the city together could serve well for that purpose - provided you can bring down something powerful enough to impress Boghrim. Why don't you talk to him about it.";
	else:
		say "     You step up on the orc boss's platform and find Boghrim with his favorite slave Jason stretched out over his lap, ass up and getting fingered by Boghrim's thick fingers. After you give the muscled green male a suggestive wink and nod towards the stairs leading up to his private rooms, Boghrim slaps Jason's ass playfully, which makes makes the young man pant in arousal. Then the orc pulls him aside, making his hard prick whip up, now that there isn't a submissive human lying on it anymore. While Jason automatically starts to worship his Master's shaft, stroking and licking it, Boghrim gives a telling look from the thick pole of man-meat to you and back, then loudly says, 'Time to... share this little slut between us again. Let's do it!'";
		say "     The mighty orc grunts in satisfaction, then gives Jason another quick slap on the bare butt and says, 'Get up, boytoy - we're making this a private party now.' That said, he stands up himself and, without even bothering to put on his loincloth, leads his naked slave and yourself through the drinking hall, his thick prick proudly dangling between his legs. Soon, you're walking up a set of stairs up to the second floor and into the station chief's conference room. Like the rest of the station, things have been rearranged in there quite a bit, as there is no sign of any table or even chairs... instead, the room holds a mightily big, round fuck-pad of a bed, combined with piles of loot and a top of the line stereo system. Moving over to switch it on, Boghrim gives you a bragging grin as the beat of punk music vibrates in your bones for a second, then is turned down to the level of background music.";
		WaitLineBreak;
		say "     While his master was setting the right atmosphere for some hot and heavy sex, Jason already sunk to his knees in front of you and undid your pants. Now he's looking up at you, an eager 'use me' expression on his face - which is something you just can't resist, holding up your hard prick and guiding the submissive human to take it in his mouth. And oh does he do a good job with that. Jason just slides those sexy lips up and up your shaft, going on to deep-throat you till his nose is buried right in your pubes - damn, Boghrim trains his bitches well! As Jason starts to bob up and down on your manhood, the broad-shouldered shape of the orc boss steps up beside you and his large hand slides down your back to tightly squeeze your right buttock.";
		if HP of Boghrim is 2: [first time]
			say "     Before things go any further and these two distract you what your real plans are, you snake your arm around Boghrim's broad frame and get a grip on his firm and naked behind, then tell him in a lusty voice that YOU want to fuck HIM now. There is a second of shocked silence in which Boghrim's eyes start to go wide, then both your attention is drawn down to Jason choking on your cock in his mouth. The young man pulls off your shaft and pants quickly while looking up with surprise on his face, then his master murmurs, 'Get back to work, slut.' After Jason buries his nose in your pubes again, your erect cock in his throat, Boghrim gives you a long, calculating look. Finally, he nods to you and says, 'You certainly were... impressive on that hunting trip we took and kinda saved my bacon, so... I'll give you a chance. Get on the bed and we'll wrestle, then we can see who gets who fucks whom.'";
		else:
			say "     Before things go any further and these two distract you what your real plans are, you snake your arm around Boghrim's broad frame and get a grip on his firm and naked behind, then tell him in a lusty voice that YOU want to fuck HIM now. Interest flares up in Boghrim's eyes and a smile starts to spread over his face, showing off the orc's sharp tusks. Meanwhile, Jason starts to fondle your balls while slurping on your shaft with new elan, as if to prepare you to fuck his master hard. The young man pulls off your shaft and pants quickly while looking up at the two of you with a happy submissive's expression, then buries his nose in your pubes again, your erect cock sliding easily into his well-trained throat. Boghrim gives your naked body a long, lusty look, then says, 'You certainly were... impressive on that hunting trip we took and kinda saved my bacon, so... I'll give you a chance. Get on the bed and we'll wrestle, the winner gets to pound the other's fuckhole.'";
		WaitLineBreak;
		challenge "Orc Boss";
		if fightoutcome >= 20 and fightoutcome <= 29: [lost]
			say "     Finally getting a good grip on you, the mighty orc pulls you close, with your back against his chest and both arms trapped against your body as he by his arms wrapped around you. You keep struggling for a moment longer, using any way you can to break his grip - without success, until you have to admit defeat 'Not bad,' you hear Boghrim say right next to your head, then lick the side of your neck and nibble at it before continuing, 'This little bit of action has really gotten me in the mood to fuck your prime ass long and hard. We both knew this was how it was going to end, didn't we? And the great thing is - I won't have to hold back - you can take it, that much I know!' The orc chuckles loudly and you can feel the hot length of his erection sliding between your buttcheeks.";
			say "     'Assume the position, like a good bottom-boy,' Boghrim grunts with lust in his voice as he lifts you off the mattress, then suddenly lets you fall, a little push at the end ensuring that you land in a prone position on the soft mattress. A certain note of urgency in his command tells you that the fun bout of naked wrestling has gotten the big orc more than a little horny, so you instantly get ready for the impending anal assault, raising your hips for the powerful male and spreading the cheeks of your ass in open invitation. The mattress shifts under you as the orc steps up closer, then you can feel his large hands take hold of your hips. 'I'll pound your hole till you can't sit straight,' comes a lusty grunt from the orc boss, followed by feeling the tip of his massive prick nudging against your rear.";
			WaitLineBreak;
			say "     Mutual lust and anticipation almost crackles in the air for a moment, all the sexual tension that has built up between you. Then it reaches its peak, and you can't help but give a breathless gasp at the sudden thrust forward by Boghrim's hips, pushing the thick head of his meaty shaft right past your pucker. And he doesn't stop there - holding you by the hips, he slides deeper into your body, further and further until finally, his crotch is flush against your butt and you can feel his pubic hair tickling your skin. You hear a satisfied grunt from the big orc and he pauses for a moment, his thick prick balls-deep inside your body, leaking copious amounts of pre-cum that leave you feeling pretty buzzed and even more aroused as they are absorbed by your body.";
			say "     The short period of getting used to this massive pole inside you ends with the growled words, 'I'm gonna enjoy taking a real man for once,' then Boghrim's manhood is withdrawn in one quick pull, leaving your opening to gape for a second before the orc's cock hammers back into you. Man, that thick prick sure feels amazing inside your hole, filling it very nicely with its impressive girth and bumping your prostate... every... single... hard... thrust, making you flush hotly in arousal and rock back to meet the large orc's hips again and again. Combining the sensations of that thick piece of man-meat inside you with the mighty orc's weight on top of you... makes your own erection get even harder, to dangle between your legs.";
			WaitLineBreak;
			say "     A gasp from somewhere to the side draws your attention for a second, and before Boghrim's next thrust makes your eyes roll back and you moan loudly, you have just enough time to realize it's Jason, pumping fingers in and out of his own hole as he watches his master fuck. What follows afterwards is just what the orc boss said he'd do - pounding your ass hard and oh so very deep, using you as his willing butt-slut and driving you deeper and deeper into a lust-filled haze.";
			say "     You don't know how long your coupling takes, two sweaty bodies moving in unison to the beat of a fast-paced selection of punk-rock songs, but one thing is sure - you wanna do it again, and soon! After a breathtaking time of taking it from the biggest and baddest orc there is, you eventually reach the point of no return and roar out loud as an orgasm crashes over you like a wave. Digging your hands into the sheets and rocking your hips to grind against the thick cock inside your ass, you blast away with a massive load of rich, thick orc cum, pulsing through your shaft and making quite a mess off the sheets.";
			WaitLineBreak;
			say "     Reaching your climax pushes your partner over the edge in short notice, as your fuckhole twitches and flexes with each spurt of your cum. The mighty orc gives a lust-fueled bellow, hands tightening around your hips, then the first blast of his seed splashes into you, followed by another and another. As more and more orcish cum fills you with each moment, Boghrim slowly winds down and he starts to loosen his grip on you. After a few more half-grunted pants, he says, 'Fuck yeah! You can definitively come back anytime and I'll fuck you good! Bitches like Jason are great, but this -', he grips your firm asscheeks with both hands and gives [']em a tight squeeze, '- is a real man's butt, worthy of my hard shaft!' Looking down at your shoulder and noticing the scars he left after your first coupling, the orc licks over them with a slow swipe of his broad tongue, then adds, 'Bear these marks with pride - you're the first guy I fucked that I didn't take as a slave afterwards.'";
			say "     Waiting some time longer till the last little spurt of his load is deposited deep inside your hole, the orc pulls out with a wet slurp and moves to lie beside you on the bed, with his upper body partly raised. Giving you a little poke in the side with his elbow and a wide grin, he add with a chuckle, 'Watch this.' Then Boghrim bellows, 'Clean us up, slave!', which results in Jason instantly jumping up from his chair and hurrying to the bed. The panting young man then kneels down immediately and goes down on his master, slurping the remnants of his load up from the orc's shaft and lapping at his pubes. After Boghrim has been cleaned of cum, Jason moves on to you, getting in position to eat his master's cum out of your hole.";
			WaitLineBreak;
			say "     Eventually, as Jason finishes with you two and joins Boghrim in a post-coital nap cuddled up against his master's side, you get back up from the bed and gather up your belongings. While doing so, you notice the distinct scars made by Boghrim's tusks on your shoulder again from the corner of your eye. Somehow, you can't help but feel good about having them, knowing that the mighty orc has accepted you as the only free man he has sex with. Putting on your clothes and gear, you then make your way back down into the drinking hall.";
		else if fightoutcome >= 30:[fled]
			say "     As you rush out of the room, clutching your hastily snatched up gear, you hear Boghrim say, 'Bah - he gets me in the mood and then just runs off. Guess another little slut is gonna get fucked hard then.' The immediate answer of, 'Yes master,' by Jason shows in its eager tone how completely the young man has become Boghrim's obedient slave. Soon after, the breathless gasps and pants, as well as satisfied grunts and slapping noises of a tight butt being pounded echo out of Boghrim's lair.";
		else if fightoutcome >= 10 and fightoutcome <= 19: [won]
			say "     As you land another blow, Boghrim rocks back into a defensive wrestling position for a moment, giving you the time to have another good look at the mighty orc's naked form. Your green-skinned buddy really is in awe-inspiring shape - broad-shouldered and with bulging muscles, he's only breathing somewhat harder than usual from your whole scuffle and there is a slight sheen of sweat glistening on his body. Clearly, the orc is far from beaten - or would be, if this was a purely physical challenge. But with the two of you rubbing and brushing against each other naked, Boghrim's arousal has been rising steadily, turned on from someone giving him a real challenge. Therefore... the next thing you do is only a feint at a punch, distracting the big brute so you can get your other hand on the thick piece of man-meat standing erect at his crotch.";
			say "     Grabbing the weighty shaft, you slide your fingers over its warm skin, distracting him from any thoughts of winning the wrestling match against you. You give him a few moments to completely succumb to the sensations of having an eager partner jerking his cock, then when the big orc gives a lusty groan, you end the fight by hooking a foot behind his lower leg and pushing hard against Boghrim's broad chest. Toppling like a tree in a storm, your orc friend's eyes go wide as he falls, falls and then hits the mattress on his back. There is a second in which he almost starts to get back up, rising on his elbows, but looking up at you - and your own rock-hard [cock of player] cock, the orc stops himself. Instead, a grin spreads over his face and he chuckles, 'You win, you horny fucker. Now show me what a sexy beast you can be with that prick!'";
			WaitLineBreak;
			say "     Better not let the big orc wait, now that you've got him all warmed up and ready to take a cock, so you quickly drop to your knees in front of him. As you spit into your hand and smear that over the orc's back door, then push the improvised lube into him with a probing finger, you become aware of your audience again - Jason is still here too of course, having one hand on his cock to jerk off at the sexy show he gets. You give the young man a wink, then turn all of your attention back to Boghrim and line up your shaft with his quivering pucker. Knowing that a real orc likes his sex hard and rough, you don't waste any more time with taking things slow after that. Thrusting in with some force, your hard shaft slides deep into the tight embrace of Boghrim's asshole, making the big brute gasp in a mixture of lust and pain.";
			say "     Barely an eye-blink later, you bottom out in him fully, bumping against the orc's prostate in the process. And... your big friend is quite sensitive there as it turns out - that first touch is enough to drive the already pretty wound-up brute over the edge, bellowing loudly as his prick twitches with spurt after spurt of cum to splatter all over his chest. Mmmh - what a delicious sight... the leader of this whole orc tribe, lying before you covered in his own load - and that just from you entering him. After taking a moment to enjoy the warm and tight feeling of Boghrim's hole around your shaft, twitching and flexing with each further shot of his seed, you proceed to pull out almost all the way, then hammer back into him, now fucking the large guy in earnest.";
			WaitLineBreak;
			say "     'Yeah! *grunt* Just like *grunt* that!' Boghrim pants loudly between your thrusts, clearly enjoying the deep shafting he's getting. He digs both his hands into the bedsheets under him and rears up a bit with his hips when you give especially hard thrusts - which makes the creamy load splattered on his chest ooze down into the cum gutters of his abs, giving you another naughty idea what you can do with the big brute. Still thrusting hard, but slowing down a bit, you bring a hand to the mighty orc's chest, rubbing his pecs and pinching a nipple - then scoop up a bit of his cum with your fingers and push them into Boghrim's open mouth as he gives another loud moan. Before he realizes what you're doing, the big orc tastes his own cum - which has its usual effects and puts his already roaring libido into overdrive.";
			say "     Showing how quickly the effects of a strong orc's potent load can go to someone's head, Boghrim hungrily sucks and swallows everything you have on your fingers, then whimpers for more. After that, he eagerly licks off and eats more and more of his own cum as you feed it to him. When there finally isn't anything left, the big brute starts to pant for you to fuck him harder, babbling in drunk arousal that he wants to feel your load deep in his hole. He almost sounds like... well, Jason - begging like a properly submissive bitch while on his cum-high - but you doubt this'll last long, as the green brute's dominant character is too strong to be suppressed for any length of time. But for now... you gladly give this subby version of the mighty orc what he's panting and pleading for.";
			WaitLineBreak;
			say "     Pounding hard against the big orc's ass, you feel the tingling urge to cum rise from your balls and bury your whole cock inside his ass as deep as it will go, then groan in lust as it starts to blast your heavy load into him. Spurt after spurt fill your green-skinned partner's insides, and between the sensations of your shaft pulsing against his inner walls and the effects of even more orc cum on his system, Boghrim joins you in orgasm just a moment later. Long strings of cum arc high into the air from his erect cock, then splash down on his muscled chest, one or two even hitting the orc in the face. Worn out from the hot sex and two orgasms in a row, the orc lets his head fall back on the bed and takes a moment to rest. You can almost hear the effects of the orc cum in him start to wear off, as moment by moment his breathing becomes calmer and less like the frantic panting of a needy bottom.";
			say "     Waiting some time longer till the last little spurt of your load is deposited deep inside Boghrim's hole, you eventually pull out of the orc with a wet slurp. A small amount of your cum leaks out as your cockhead pops past the muscled brute's pucker, giving a very nice contrast as it starts to slowly run down between his legs. Seeing it fills you with pride, as it is the visible proof that you bested the orc, in a playful and sexualized wrestling match at least. There is even a little string of cum stretching from your slit to the upper edge of his winking pucker - glistening enticingly in the light and drawing the attention of Jason, who's moved up right next to you on the mattress. He licks his lips and asks in a pleading tone, 'May I -' And that is as far as he gets before you grip his neck softly, pulling him down towards your crotch. The eager human catches your dangling little string of cum with his tongue, slurping it up, then gently pushes against your hip so you make room for him to go down on Boghrim and eat your load out of his ass.";
			WaitLineBreak;
			say "     'Oooh yeah, stick your tongue in there deep,' the orc boss groans to his favorite slave, raising his own hips a little bit more to allow Jason easier access. As the human is busy lapping your seed from Boghrim's well-bred hole, you wipe the small amount of cum that stuck to your cock off against his naked side, then move towards the edge of the bed and start looking for your clothes. Giving the two of them one last look and seeing Jason busy pleasing his master -as well as licking up and swallowing the 'evidence' of your activities you left behind, you then close the door properly behind you and make your way back down into the drinking hall.";
			if HP of Boghrim < 3:
				now HP of Boghrim is 3;

to say BoghrimSex4: [sex party with Boghrim, Mul and Jason]
	if libido of Mul is 0: [first time]
		say "     Deciding that you want to introduce your sex pet to Boghrim, your eyes search out Mul across the room and a wide grin spreads over your face. You're more than a little curious how the orc chief will react to the fact that one of his brutes has become a secret bottom-boy, hungry for your shaft. Images of some quite sexy scenarios how things may go dance in front of your mind's eye as you make your way through the crowd of partying orcs. Soon, you're very close to your target - but before you walk up to him, you stop for a second to inspect his muscled physique. The broad shoulders, tall stature and corded muscles speak for themselves - he's a grade A hunk, almost an ideal orc. And yet... you broke him in to getting fucked. There's something just so delicious about secretly being the one who can make him bend over and take it - hard. And now, you're right in the middle of the lair and approach your boy for a fuck. Ah, isn't life great?";
	else:
		say "     Deciding that you want to share your sex pet with Boghrim again, your eyes search out Mul across the room and a wide grin spreads over your face. Images of some quite sexy scenarios how things may go dance in front of your mind's eye as you make your way through the crowd of partying orcs. Soon, you're very close to your target - but before you walk up to him, you stop for a second to inspect his muscled physique. The broad shoulders, tall stature and corded muscles speak for themselves - he's a grade A hunk, almost an ideal orc. And yet... you broke him in to getting fucked. There's something just so delicious about secretly being the one who can make him bend over and take it - hard. And now, you're right in the middle of the lair and approach your boy for a fuck. Ah, isn't life great?";
	LineBreak;
	say "     Silently walking up behind the strong orc, you whisper in his ear that you want to fuck him again - while at the same time casually sliding a hand under his loincloth and squeezing one of his firm and muscular buttcheeks. A snarl starts to form in Mul's throat, only to be quickly quenched as he looks at all the other orcs around you and decides that making a scene might not be the best idea[if lastfuck of Mul - turns < 8], given that you can still feel the wetness of cum in his crack - a remainder from your last fun-time[else] right now[end if]. Still, he gives a deep growl, then says just loud enough for only you to hear, 'I'll get you for this, bastard. Eventually you'll be mine and there'll be - *gasp*' You can't help yourself, interrupting his little rant with a finger that you slip into his hole.";
	say "     As well-trained as you have the orc by now, his pucker readily yields to your probing digit, allowing you to rub Mul's inner walls, which totally breaks his concentration. Fighting down all further moans and gasps after the first one, the orc gives in to you a moment later and says, 'Fine, let's go.' Mul leads the way, passing others whom he grunts to, gives a slap on the back, and one orc brute whom he decks hard enough to knock him out - then as he starts to move towards the corridor leading west, you instead grab him by the upper arm and nod in the direction of Boghrim's raised platform. A curious, then concerned, look crosses Mul's face as he realizes that you want him to go that way. He doesn't resist though, following you as you step up and walk over to the orc chief, throwing yourself onto the sofa right next to him.";
	WaitLineBreak;
	if libido of Mul is 0: [first time]
		say "     While Mul just stands nearby and distractedly watches Jason as he kneels between Boghrim's legs and laps at the mighty orc's thick shaft, you lean in to the orc boss and ask if he's game for some more fun. A chuckle escapes Boghrim lips and he grabs hold of his hard cock, then swats it against Jason's forehead with a meaty thud, 'What do you think? 'Course I'm ready to fuck! But what's with your buddy there? If he wants a go at Jason, he'll have to pay like anyone else...' A broad grin spreads over your face as you reach out to Jason and stroke his naked shoulder, then hook a finger under the collar around the human's neck. Calmly and casually - just loud enough for only Boghrim, Jason and Mul to hear - you tell the orc beside you that you wanted to add a bit to the fun by bringing your own tamed bitch along. Boghrim's eyes widen at that and he gapes at the interesting shade of emerald green Mul's face takes up in embarrassment, then the orc boss throws his head back and laughs heartily. His shaft throbs with a little spurt of clear pre-cum which is instantly licked up by Jason.";
	else:
		say "     While Mul just stands nearby and distractedly watches Jason as he kneels between Boghrim's legs and laps at the mighty orc's thick shaft, you lean in to the orc boss and ask if he's game for some more fun. A chuckle escapes Boghrim lips and he grabs hold of his hard cock, then swats it against Jason's forehead with a meaty thud, 'What do you think? 'Course I'm ready to fuck! And you've even brought a buddy to have fun with. Now how could I say no to that?' A broad grin spreads over your face as you reach out to Jason and stroke his naked shoulder, then hook a finger under the collar around the human's neck. Calmly and casually - just loud enough for only Boghrim, Jason and Mul to hear - you tell the orc beside you that your own tamed bitch is just as hungry for cock as Jason. Boghrim's eyes widen at that and he gapes at the interesting shade of emerald green Mul's face takes up in embarrassment, then the orc boss throws his head back and laughs heartily. His shaft throbs with a little spurt of clear pre-cum which is instantly licked up by Jason. 'Sounds like a challenge - let's get to it then!'";
	say "     Boghrim gives Mul a close look - and you can tell it's not him looking at another orc, but rather a piece of man-meat to be taken - then the big orc loudly says, 'Time to... share this little slut between us.' He hooks his hands under Jason's shoulders and pulls him up to slap the human's bare butt as he says that, but both of you know he meant another male altogether. Grunting in satisfaction, the mighty orc gives Jason a quick grope and says, 'Come on, boytoy - we're making this a private party now.' That said, he stands up himself and, without even bothering to put on his loincloth, leads his naked slave, yourself and a glumly looking Mul through the drinking hall, all with his thick prick proudly dangling between his legs. Soon, you're walking up a set of stairs up to the second floor and into the station chief's conference room. Like the rest of the station, things have been rearranged in there quite a bit, as there is no sign of any table or even chairs... instead, the room holds a mightily big, round fuck-pad of a bed, combined with piles of loot and a top of the line stereo system. Moving over to switch it on, Boghrim gives you a bragging grin as the beat of punk music vibrates in your bones for a second, then is turned down to the level of background music.";
	WaitLineBreak;
	say "     Standing next to the bed with Jason and Mul, it's your decision on how to proceed from here. Do you want to throw Mul a bone and let him sink his cock into Jason's hungry hole, or would you rather see the orc take Boghrim's pet human up the ass?";
	LineBreak;
	say "     ([link]Y[as]y[end link]) - Let Mul fuck Jason.";
	say "     ([link]N[as]n[end link]) - Fuck Mul yourself.";
	if player consents: [Mul gets to fuck]
		LineBreak;
		say "     Hooking a finger under the collar around Jason's neck, you pull the otherwise naked young man close and give him a deep kiss. It's quite easy to see why this human is Boghrim's favorite, with his soft lips and eager temperament, not to say a firm and shapely body - but you control your urge to fuck him right then and there, instead pulling back and leaving Jason to stretch his neck a bit, wanting to keep making out. But then you tell him to get on all fours on the bed and that your buddy Mul will fuck him, at which point Jason's eyes get very round and an eager moan escapes his lips. The muscled guy gives Mul a look of undisguised admiration and licks his lips as he watches the orc's bulge, then quickly moves to get into fucking position on the large fuck-pad that is Boghrim's bed.";
		say "     'That's more like it,' Mul grunts in satisfaction, a bit of relief audible in his voice as he seems to thing this could just be a gang-bang on the human after all. He pulls his loincloth off and throws it aside, then steps up onto the bed and gets into position behind Jason. The mighty orc grasps both the young man's firm buns with his hands, squeezing them appreciatively, then pulls apart Jason's cheeks and gives a lusty grunt as he sees the pink pucker between wink open and shut. Mul's right hand takes hold of his thick cock and smacks it against Jason's crack, then he lines himself up with the human slave's waiting hole. As well-trained as Jason is these days, not to say pre-lubed with Boghrim's last deposits into his rectum, Mul's prick slides right in. The orc gives a guttural grunt and proceeds to hammer his hips forward, creating a loud slapping noise as his balls hit Jason's ass. Though far from being dismayed by such harsh treatment, the young man just whimpers in lust and raises his ass a little bit more, waiting for the next thrust, and the next...";
		LineBreak;
		say "     With Mul and Jason now busy with each other, it's time for their masters to join the fun. How to proceed from here? Do you want to give Boghrim the honor of sinking his thick shaft into Mul, or would you rather personally enjoy your orcish butt-slut's tight passage?";
		LineBreak;
		say "     ([link]Y[as]y[end link]) - Boghrim takes Mul.";
		say "     ([link]N[as]n[end link]) - You take Mul.";
		if player consents: [Boghrim takes Mul]
			LineBreak;
			say "     Meeting Boghrim's eyes, you grin widely and give him an inviting gesture as you nod towards Mul. The big orc gives a lusty chuckle, his massive prick twitching in anticipation. He gets on the bed, walking on it to stand behind the fucking couple of man and orc, then he crouches down far enough for his member to come to rest between Mul's firm asscheeks. Your orcish boy-toy's grunting and humping into Jason comes to a shrieking halt as he feels the touch of a hard cock. Mul lifts his head from where he was just giving Jason a love-bite on the back, and his eyes go wide as he sees you standing at the side of the bed - which of course makes him realize that the person who's on top of him is Boghrim. The orc opens his mouth as if to say... something, you don't know what, as his tribe's chief chooses just that moment to pull back a little and then thrust forward hard, ramming the whole length of his erection down Mul's chute in one go.";
			say "     'OoooaarrRRRRGHHHH!' comes the guttural howl from Mul at this sudden and merciless penetration, though even before he's done with the exclamation, you can hear the tone of his voice shift, betraying an undertone of arousal and lust. Oh well - orcs are tough, so you guess he can take it... and Mul's enough of a butt-slut right now that he really gets off a lot on having such a heavy piece of man-meat shoved up his rear end. Not giving his orcish subordinate even a second to rest, Boghrim just keeps fucking him roughly, laughing as that makes Mul grunt and moan in lust. 'Always thought you were the toughest of your family Mul. And now I learn you're just a needy bitch inside, hungry for cock! Very tight and gripping too! Gonna ride your ass till you can't sit straight, you slut!'";
			WaitLineBreak;
			if HP of Boghrim < 2: [not arranged to fuck Boghrim yet]
				say "[PlayerJasonMulBoghrimFuck]";
			else:
				say "     Hearing Boghrim talk about fucking another orc's hungry hole, you do get reminded of the time you sank your own erection into his tight end. Do you want to take a go at him for another round and make this a fuck-chain, or would you rather line up to get blown by Jason?";
				LineBreak;
				say "     ([link]Y[as]y[end link]) - Fuck-Chain.";
				say "     ([link]N[as]n[end link]) - Blowjob.";
				if player consents:
					LineBreak;
					say "     While Boghrim pounds into Mul with unabated intensity, you quickly take off your clothes and gear, then get on the round fuck-pad of a bed, eager to join the fun. Moving into position behind the mighty orc, you look down at the green-skinned male and watch corded muscles ripple and flex as he thrusts his hips forward in a rapid pace, pounding his cock into Mul's asshole, which of course hammers the other orc's erection deeper into a needily whimpering Jason. It's so very delicious to see the human slave taking a hard cock like the bitch he is - and on top of him, the former alpha male that's balls deep inside him is also getting fucked - hard, and fast - and he likes it. Breaking in this would-be 'owner' of yours to taking thick cocks is one of the best ideas you ever had - at least that's what your libido is telling you, with the throbbing and hard erection between your legs supporting its argument. As your gaze inevitably gets drawn down to the still almost virginal pucker between Boghrim's firm buns, you smile in anticipation of what you will do next.";
					say "     Reaching between the big orc's legs, you cup his balls and roll the full orbs between your fingers for a moment, then playfully tease Mul about all the cum Boghrim's got waiting for him. Your fuck-buddy gladly joins in on mocking the orcish bottom a bit, slapping his buttcheeks hard and telling him, 'Yeah, that's right. Your master brought you to me to be filled like a little breeder slut.' Then as you move your hand a bit further up and grab the shaft of his cock, the orc chief pulls out and pauses for a second to let you stroke his full erection, by now dripping with pre-cum spread along its length. After a moment of enjoying your touch, he adds, 'Hah, time to get back to fucking. I'm gonna *thrust* breed *thrust* this bitch *thrust* SO HARD!' And with that, he lays into Mul with full force again, filling the room with loud slaps as his crotch hits the other orc's butt. Meanwhile, you do straighten yourself again - and use the slick pre coating of your hand to lube your own manhood.";
					WaitLineBreak;
					say "     You run your hands down the back of the big orc in front of you, feeling the firm muscles and the slight sheen of sweat on them, then grab both his firm buns and pull them apart. Your rock-hard dick is lined up with his pucker in an eye-blink, nudging its round shape as the orc moves his hips in preparation of another thrust into Mul. And in just that moment, you commit to taking his ass - knowing that a real orc likes his sex hard and rough, you don't waste any more time with taking things slow. Thrusting in with some force, your hard shaft slides deep into the tight embrace of Boghrim's asshole, making the big brute gasp in a mixture of lust and pain.";
					say "     Barely an eye-blink later, you bottom out in him fully, bumping against the orc's prostate in the process. 'Ngh! YEAH! More!' He roars, thrown deep into the grip of his own arousal as his own potent pre is absorbed by his inner walls. You're more than happy to comply, adding the rhythmic thrusts of your own hips to the fuck-chain and soon leaking further pre-cum into the lust-maddened green brute. Well, that shows once again that even the mightiest orc isn't immune to the thrill of getting fucked - and dosed with orc cum - but you knew that, of course. The thought of saying something to tease Boghrim about it pops up in your head as you proceed to fuck your big buddy, but... naaah, this is to nice a setup to mess up by offending the orc chief. After all, he's not someone you could just beat up and dominate like you did Mul.";
					WaitLineBreak;
					say "     Your sexy foursome of three orcs and one human humps and thrusts into each other in a wild rhythm for quite a bit, hands touching and squeezing each other's fit bodies as you fuck. Eventually, it is Mul who is the first to reach the point of no return - no wonder, really... with a born bottom like Jason squeezing his love-hole around his shaft, and the thick prod of Boghrim hammering him from behind. The wound-up brute bellows loudly as his prick twitches with spurt after spurt of cum to fill Jason's hungry hole. Mmmh - that must have been a delicious sight... a powerful orc warrior breeding a muscled human, while at the same time impaling himself on a hard pole with every pull back. The special properties of the big orc's cum only take a second to affect Jason in turn - making the young man's stretched pucker tremble and twitch around Mul's cock as the human moans in arousal. His breathless grunts, together with the soft sound of little splats barely audible over the moaning and gasping make it clear that the young man just nutted all over the sheets of Boghrim's bed.";
					say "     'Yeah! *grunt* Just like *grunt* that! Work your slutty hole on my cock,' Boghrim pants loudly between thrusts that meet Mul's rear, clearly getting quite close himself. Then suddenly, he throws himself forward with full force, forcing both Mul and Jason down on the bed. With both hands digging into the bedsheets as he grinds his crotch against Mul's ass hard, the orc roars in lust and starts to pump his load into his subordinate orc's hungry depths. Still thrusting hard yourself, you feel Boghrim's anal muscles tremble and flex around you, making you almost feel like he's jerking you off inside his ass. With such a nice sensation around your manhood, it is no wonder that you soon reach a breathtaking climax yourself. Grunting deeply, you impale the orc chief on your spear one last time, driving in all the way till your balls rub against his skin - then the first thick spurt of your cum blasts into the orc and paints his insides white.";
					WaitLineBreak;
					say "     For several long moments, only loud panting and the breathless grunts accompanying further spurts of cum can be heard above the music Boghrim put on, then Boghrim slowly shakes off the effects of his newest orc-cum infusion and reaches back to slap your ass. 'Man, that was something else. Very nice slut you got here in Mul! You're welcome to bring him up here anytime.' With that said, the orc pulls his erection out of Mul, leaving a quite impressive load to leak out of the green brute's gaping hole. He slides himself off your shaft too, then turns to give you a long snog, rubbing his tusks against yours as you make out with each other. Eventually, when Boghrim comes back up for air from another lusty kiss, the orc looks down upon Jason and Mul, who now lie on the mattress with Jason held against Mul's front, still impaled on his cock. 'Hah, wimps. They're still out of it,' Boghrim chuckles then gropes Mul's ass and sticks a finger deep in his well-bred hole, pulling it out with a creamy coating of his cum. Just holding out his hand in front of Jason's face has the young man's eyes wrench open after a flare of his nostrils, and the human has his lips wrapped around the cum-dripping finger an eye-blink later.";
					say "     Soon, Jason's got it all licked off, prompting him to smack his lips hungrily and asks in a pleading tone, 'May I -' And that is as far as he gets before Boghrim presents him with his half-hard cock, letting him slurp up the sperm still clinging to it. 'You can get the rest right from the source. Be a good slut and clean me up,' Boghrim grunts to his slave, then chuckles loudly as Jason laps at his balls and shaft. As you raise off the stained mattress with a sigh, you start putting your clothes back on, then stop as you remember that there is something important to be done yet - unless you want to expose your green slut to the full orc mob downstairs and possibly lose him to them. Meeting Boghrim's gaze, you nod towards Jason, then Mul and get a knowing grin in reply. With his permission given, you tell Jason in a commanding tone that just rolls down your orcish tongue that he should get to work between Mul's buns - and take care of all the evidence.";
					WaitLineBreak;
					say "     Boghrim meanwhile quietly catches your own cum leaking out of his hole and lubes himself up with it, making no attempts to hide that the show of Mul's ass getting eaten turns him on quite a bit. So by the time Jason raises his head from Mul's butt again and smacks his lips satedly, Boghrim is sporting another full-on erection - and he sinks it into the human without warning, making him gasp at the sudden penetration. But then, that's what the slave's been used to by now, as he quickly overcomes his discomfort and moans loudly as his master pounds him into the mattress. While you wish you could have another round, it seems clear that this time, the big orc wants to spend some private time with his favorite slut, so you hit Mul in the arm to get his attention and tell him that you're going. After collecting your gear and clothes, you and your orc companion leave the upper floor, casually wandering down into the main drinking hall of the orc lair. Mul peels off your side without another word and quickly goes to pick up a drink, then starts chugging away orc brew and sits down to challenge another at arm wrestling.";
				else:
					LineBreak;
					say "[PlayerJasonMulBoghrimFuck]";
		else: [player takes Mul]
			LineBreak;
			say "     Quickly getting rid of your clothes and gear, you get on the bed yourself and kneel down behind Mul, your [cock of player] shaft hard and ready for some action. And then - just as Mul is right in the middle of chuckling what a nice bitch Jason is - you thrust deep into the strong male's tight hole, making him roar at the sudden anal invasion. It's not so much that he isn't well-used to getting fucked by now, but rather the sudden role-reversal from dominant alpha male to your butt-slut that sends Mul reeling for a moment, frozen in shock. Meanwhile, his body does what you've trained him for - Mul's pucker readily expands to allow more and more of your shaft in, while at the same time still being nice and snug around your member. The big male's hole feels fantastic to be in, and the fact that you're dominating the very orc that wanted to take you as a slave makes fucking him all the sweeter.";
			say "     The sensation of your cock hitting his prostate is enough to wrench your hunk of an orc out of his paralysis - and the first thing coming out of his mouth afterwards is a needy moan. Being used to getting fucked by now - and getting off on it quite a bit, Mul's anal muscles flex and twitch as you pound into him hard. Part of it is just him reacting to you hitting the prostate, but there are also some moments in which the orc's hole almost seems to jerk you off inside him. Apparently, your muscled green playmate has accepted this role so much now that he is experimenting with new techniques to make wild anal sex feel even better for you both. You can't help but give a very satisfied laugh at the situation - you, balls deep inside a mighty orc warrior and pounding into him so hard that even Jason moans and whimpers from the force transmitted through to him with each thrust.";
			WaitLineBreak;
			say "     You feel movement on the bed behind you, then two strong arms slide around you and hug you tight against a broad, muscled chest. Not that that's the only thing you feel press against you, as Boghrim's mighty pole hotly touches the small of your back. 'Mmmh, our two sluts are both getting fucked deep. Their butts are just meant to be bred,' Boghrim tells you in a satisfied tone and you can feel the warm breath of the orc boss on your skin as takes a deep huff of your own masculine musk, then follows up with a tender love-bite in the bend of your neck. 'They're sexy bitches, but right now - I wanna have something more. Feel the insides of a real man wrapped around my cock! And with you so nicely demonstrating that you can dominate even a guy like Mul... I know just where to find one.'";
			say "     Giving a lusty grunt, Boghrim licks the side of your neck, then lightly nips your earlobe - at the same time as he grabs the thick shaft resting against your back and bends it down to brush over your butt-crack. You feel the wetness of pre-cum on your skin that his touch leaves - seems like you've got a very horny orc behind you. And now he's aligning his shaft with your back door, then pressing in against it, and... his thick cockhead pops into you as he makes a sudden thrust. You can't help but give a breathless gasp at the sudden penetration, but the momentary pain is quickly outweighed by the pleasant feeling of fullness his cock brings - as well as Boghrim's potent pre-cum being absorbed by your own inner walls, resulting in a pleasant buzz. But he doesn't stop there - holding you by the hips, he slides deeper into your body, further and further until finally, his crotch is flush against your butt and you can feel his pubic hair tickling your skin. You hear a satisfied grunt from the big orc and he pauses for a moment, his thick prick balls-deep inside your body, leaking copious amounts of pre-cum that push you to even greater arousal.";
			WaitLineBreak;
			say "     Boghrim gives you a short period to get used to his massive pole inside your ass, kissing and nipping your neck and the bend of your shoulder, then soon you hear the growled words, 'I'm gonna fuck you so hard!' The mighty orc's manhood is withdrawn in one quick pull, leaving your opening to gape for a second before the green brute's cock hammers back into you. Man, that thick prick sure feels amazing inside your hole, filling it very nicely with its impressive girth and bumping your prostate... every... single... hard... thrust, making you flush hotly in arousal and rock back to meet the large orc's hips again and again. And all that while your own manhood is still snugly tight in Mul's well-trained passage, passing on the force of Boghrim's hips into the muscled orc, and through him further into the young human slave who's taking Mul's cock.";
			say "     Oh hell, what a scene - you almost wish you could be standing to the side and watch it all... Jason, a human hunk of a guy - yet dwarfed by his orcish masters - in the center of the bed, with his ass raised and face pressed into the mattress, eagerly moaning as the green-skinned Mul hammers into his sloppy hole. Then behind your orc yourself, balls-deep inside the butt-slut you've trained and pushing him deeper into Jason with each thrust - with the end of the fuck chain being formed by the big man - the big orc - of this tribe himself, pounding your ass hard and oh so very deep. If you weren't already getting the fuck of your life, you'd be jerking yourself raw at the hot sight of the orc boss using you as his willing bottom-boy, driving you deeper and deeper into a lust-filled haze with each new pounding thrust. You don't know how long your coupling takes, four sweaty bodies moving in unison to the beat of a fast-paced selection of punk-rock songs, but one thing is sure - you wanna do it again, and soon! After a breathtaking time of taking it from the biggest and baddest orc there is, you eventually reach the point of no return and roar out loud as an orgasm crashes over you like a wave. Your hands grip the sides of Mul's hips very tightly as you bury all of your manhood inside the big brute, then shoot many a spurt of rich, thick orc seed deep into his rectum.";
			WaitLineBreak;
			say "     Reaching your climax pushes Boghrim over the edge in short notice, as your fuckhole twitches and flexes with each spurt of your cum. The mighty orc gives a lust-fueled bellow, arms tightening around your chest, then the first blast of his seed splashes into you, followed by another and another. As more and more orcish cum fills you with each moment, Boghrim grunts lustfully into your ear, then says, 'Fuck yeah! Your hole feels great!' Meanwhile, on your other end, Mul is trembling and panting as your seed paints his insides white, giving the orcish slaver just the fix he needed. With you injecting all that potent cum into him, it's only moments before he orgasms himself, breathlessly growling, 'Fuck my ass, you bastard! Fill me up. GrrawwwwrrrRRRR!' Mul's own orc cum rockets through his thick, pulsing member and gets deposited deep inside Jason's hungry hole, making Boghrim's favorite slave quite a sloppy mess.";
			say "     Being used (and more than a little addicted) to aphrodisiac-laden orcish seed, Jason gives a satisfied howl as Mul pumps his massive load deep into him. The human slut whimpers in need, a mantra of, 'Breed me! Fill me up master!' repeated on his lips while his own cock starts spurting cum, splattering Boghrim's bed with a creamy load. There is a long moment in which cum pulses through hard members before everyone's orgasms run their course, then the exhaustion of a breathtaking bout of fucking catches up with all of you, making three orcs and a human sink down on the bed in a tangle of limbs and sticky bodies.";
			WaitLineBreak;
			say "     After resting a bit with Boghrim's arms still wrapped around you, you eventually slip out of his embrace, pulling off the orc's still half-hard cock in the progress too. Yet without the strong male's shaft inside your passage, you start feeling kind of empty... thankfully, you have just the right thing to take your mind off such matters. With a barked command, you rouse Mul from his slumber too, then demonstratively turn your rear towards him and tell him to eat you out. For a second, conflicting emotions flicker over the orc warrior's face, then his hunger for cum - and especially something as potent as Boghrim's seed - wins out and Mul goes down on you. Pulling apart your asscheeks with strong hands and starting to lap over your crack, the orc warrior slurps out what cum is sticking to your skin, then sticks his tongue into your freshly bred hole.";
			WaitLineBreak;
			say "     Having Mul eating your ass is quite pleasant... and distracting, but you nevertheless remember that there is something else to be done - unless you want to expose your green slut to the full orc mob downstairs and possibly lose him to them. In a commanding tone that just rolls down your orcish tongue, you tell Jason to get to work between Mul's buns in turn - and take care of all the evidence. Boghrim meanwhile watches your little ass-eating chain, making no attempts to hide that the show turns him on quite a bit. So by the time Mul raises his head from your butt again and smacks his lips satedly, Boghrim is sporting another full-on erection - and he calls on Jason to take care of it. Soon, the submissive human is again kneeling between his master's legs, lapping away at his shaft in adoration.";
			say "     While you wish you could have another round, it seems clear that this time, the big orc wants to spend some private time with his favorite slut, so you hit Mul in the arm to get his attention and tell him that you're going. After collecting your gear and clothes, you and your orc companion leave the upper floor, casually wandering down into the main drinking hall of the orc lair. Mul peels off your side without another word and quickly goes to pick up a drink, then starts chugging away orc brew and sits down to challenge another at arm wrestling.";
	else: [Mul's shafted by Jason]
		say "     Stepping up to Mul, you grab him by the back of his neck and pull the orc into a bout of making out with you. Initially reluctant, the muscled green brute's resistance soon falters as your tongues wrestle with each other, and not much later, he does little more than grunt once as you tear off his loincloth and casually fling it aside. Pulling back from a deep kiss that had your tusks rub against each other, you look down at his by now fully erect shaft, standing proudly erect to prod you in the abs. With a dominant growl, you command your orc butt-slut to get on the bed - on all fours and ready to be mounted. Clearly, your 'training sessions' with Mul paid off quite nicely, as the orc obeys without much complaint, pulling his loincloth off in clear eagerness to feel your manhood inside him again. Not that he'll be getting it - at least not right now, with you having other plans...";
		say "     Mul moves his mighty form on the round fuck-pad that is Boghrim's bed, taking a quite lewd position. With the orc resting on his knees, your muscled bottom's rear is raised very invitingly - even more so since he has both hands on his own firm buttcheeks, holding them apart for your pleasure. And of course, with nothing left to brace his upper body, the orc's head and shoulders are pressed into the mattress below, muffling his moans and grunts as well as stopping him from seeing what's going on around him. The perfect situation, for what you've got planned. A wide smile on your face, you wave Jason closer and slip an arm around his shoulders as the hunky human obeys, your other hand sliding down over his ripped abs to take hold of the quite respectful cock Boghrim's slave has between his legs.";
		WaitLineBreak;
		say "     Jerking your hand up and down the hard shaft a few times, you lean in to Jason and whisper in his ear that he may fuck Mul, just this once. The young man's eyes go wide and you can feel his heartbeat grow faster in the throbs of his cock, then an eager nod goes your way. It's clear that - no matter how satisfied he is as Boghrim's bottom slut - Jason is still a quite masculine man... and he really wants to be the one doing the fucking right now. Letting go of his shoulder, you give the human slave's shapely butt an appreciative slap, then watch as he moves into position behind your orc. Bending his legs a little, Jason brings his crotch to the same level as Mul's rear and he swats his manhood into the crack between Mul's cheeks before playfully nudging against the orc's back door.";
		say "     But Jason's restraint doesn't last all that long - the horny man soon grips the orc by his hips and thrusts his hips forward with some force, sinking the hard cock deep into the green bottom boy. Judging from the relish and intensity with which he pounds into Mul, it is hard to believe that Jason was straight as an arrow before Boghrim took him as his - but then, the school of being an orc's slave boy is filled with little else but fucking... especially butt fucking, at that, so maybe it's not such a wondrous change after all. No matter what, Jason goes for Mul's gripping butthole with full force, hammering into the orc hard enough to fill the room with loud slapping noises. And your butt slut... loves it, groaning loudly into the mattress and even getting out a muffled but understandable, 'FUCK ME!'";
		LineBreak;
		say "     Hmmm... how to proceed from here? Do you want to move around to Mul's front and get a blowjob, at the same time letting him know that a human is fucking his ass? Or would you rather step up behind Jason and make it a chain fuck, with the hunky man sandwiched between you and your orc butt-slut?";
		LineBreak;
		say "     ([link]Y[as]y[end link]) - Get a blowjob.";
		say "     ([link]N[as]n[end link]) - Fuck-Chain.";
		if player consents: [fuck his face]
			LineBreak;
			say "     Walking around the large expanse of Boghrim's round fuck-pad of a bed and quickly getting rid of all your clothing and gear, you get on it yourself, eager to join the fun. Moving into position at Mul's front end, you look down at the strong orc as he moans into the mattress, thinking that it's you pounding his ass hard and not Jason letting his pent up dominant side have a very enthusiastic outing. It's so very delicious to see the alpha male you've broken in to needing your cock up his rear now putting out to other males - and liking it. Stroking your own [cock of player] shaft, you watch the show a little bit longer, then lean forward and ask Mul if he likes being pounded by a human slave-boy. The drawn-out groan your orc butt-slut was making after a deep thrust of Jason's is interrupted by a deep rumble, then him pushing his upper body up from the mattress with both muscle-packed arms.";
			say "     'What?!' Mul growls and starts to turn his head, but you're ready for him, just grabbing his head between your hands and pulling it against your crotch, plugging the orc's mouth with your cock. Holding on to him tight, you start face-fucking Mul and after a second or three, he stops struggling and gets more into slurping on your prick. Ah, orc precum - the ultimate tool to resolve little spats about who gets to fuck whom. As the buzz your fluids create mellows Mul's rage, you run a hand through his short hair and stroke his shoulder. Then you tell the green brute that he shouldn't make such a fuzz. He moaned and whimpered from taking Jason's cock after all - knowing that it's not yours shouldn't make any difference. The only reply you get is another loud slurp as Mul eagerly suckles on your shaft, trying to drain your balls in hungry anticipation";
			WaitLineBreak;
			say "     You feel movement on the bed behind you, then two strong arms slide around you and hug you tight against a broad, muscled chest. Not that that's the only thing you feel press against you, as Boghrim's mighty pole hotly touches the small of your back. 'Mmmh, look at those two sluts go. Their butts are just meant to be bred,' Boghrim tells you in a satisfied tone and you can feel the warm breath of the orc boss on your skin as takes a deep huff of your own masculine musk, then follows up with a tender love-bite in the bend of your neck. 'But right now - I wanna have something more. Feel the insides of a real man wrapped around my cock! And with you so nicely demonstrating that you can dominate even a guy like Mul... I know just where to find one.'";
			say "     Giving a lusty grunt, Boghrim licks the side of your neck, then lightly nips your earlobe - at the same time as he grabs the thick shaft resting against your back and bends it down to brush over your butt-crack. You feel the wetness of pre-cum on your skin that his touch leaves - seems like you've got a very horny orc behind you. And now he's aligning his shaft with your back door, then pressing in against it, and... his thick cockhead pops into you as he makes a sudden thrust. You can't help but give a breathless gasp at the sudden penetration, but the momentary pain is quickly outweighed by the pleasant feeling of fullness his cock brings - as well as Boghrim's potent pre-cum being absorbed by your own inner walls, resulting in a pleasant buzz. But he doesn't stop there - holding you by the hips, he slides deeper into your body, further and further until finally, his crotch is flush against your butt and you can feel his pubic hair tickling your skin. You hear a satisfied grunt from the big orc and he pauses for a moment, his thick prick balls-deep inside your body, leaking copious amounts of pre-cum that push you to even greater arousal.";
			WaitLineBreak;
			say "     Boghrim gives you a short period to get used to his massive pole inside your ass, kissing and nipping your neck and the bend of your shoulder, then soon you hear the growled words, 'I'm gonna fuck you so hard!' The mighty orc's manhood is withdrawn in one quick pull, leaving your opening to gape for a second before the green brute's cock hammers back into you. Man, that thick prick sure feels amazing inside your hole, filling it very nicely with its impressive girth and bumping your prostate... every... single... hard... thrust, making you flush hotly in arousal and rock back to meet the large orc's hips again and again. And all that while Mul's still holding your own prick between his sucking lips, bobbing up and down on the shaft and even giving moments of impromptu deep-throating when Jason slams him forward with an especially hard thrust.";
			say "     Oh hell, what a scene - you almost wish you could be standing to the side and watch it all... in the center of the bed you and Mul, face-fucking your orc butt-slut's sexy mouth, then behind him Boghrim's slave-boy Jason, and behind yourself the big man himself, pounding your ass hard and oh so very deep. If you weren't already getting the fuck of your life, you'd be jerking yourself raw at the hot sight of the orc boss using you as his willing bottom-boy, driving you deeper and deeper into a lust-filled haze with each new pounding thrust. You don't know how long your coupling takes, four sweaty bodies moving in unison to the beat of a fast-paced selection of punk-rock songs, but one thing is sure - you wanna do it again, and soon! After a breathtaking time of taking it from the biggest and baddest orc there is, you eventually reach the point of no return and roar out loud as an orgasm crashes over you like a wave. Your hands shoot out to grip Mul's head tightly as you push all of your cock into his throat, pumping many a spurt of rich, thick orc cum straight into his stomach.";
			WaitLineBreak;
			say "     With you injecting all that potent cum into him, it's only seconds before Mul orgasms himself, slurping and slobbering on your cock as his thick prick lets loose a deluge of orcish seed to splatter all over the sheets of Boghrim's bed. Trembling and twitching in ecstasy the big orc's orgasm then finally brings the last sexual domino in the room to fall, as his flexing anal muscles almost milk Jason's cock... and the young man gives a breathless grunt, followed by his own load painting Mul's insides white. A moment later, the exhaustion of a breathtaking bout of fucking catches up with all of you, making three orcs and a human sink down on the bed in a tangle of limbs and sticky bodies.";
			say "     After resting a bit with Boghrim's arms still wrapped around you, you eventually slip out of his embrace, pulling off the orc's still half-hard cock in the progress too. Yet without the strong male's shaft inside your passage, you start feeling kind of empty... thankfully, you have just the right thing to take your mind off such matters. With a barked command, you rouse Mul from his slumber too, then demonstratively turn your rear towards him and tell him to eat you out. For a second, conflicting emotions flicker over the orc warrior's face, then his hunger for more cum - and especially something as potent as Boghrim's seed - wins out and Mul goes down on you. Pulling apart your asscheeks with strong hands and starting to lap over your crack, the orc warrior slurps out what cum is sticking to your skin, then sticks his tongue into your freshly bred hole.";
			WaitLineBreak;
			say "     Having Mul eating your ass is quite pleasant... and distracting, but you nevertheless remember that there is something else to be done - unless you want to expose your green slut to the full orc mob downstairs and possibly lose him to them. In a commanding tone that just rolls down your orcish tongue, you tell Jason to get to work between Mul's buns in turn - and take care of all the evidence. Boghrim meanwhile watches your little ass-eating chain, making no attempts to hide that the show turns him on quite a bit. So by the time Mul raises his head from your butt again and smacks his lips satedly, Boghrim is sporting another full-on erection - and he calls on Jason to take care of it. Soon, the submissive human is again kneeling between his master's legs, lapping away at his shaft in adoration.";
			say "     While you wish you could have another round, it seems clear that this time, the big orc wants to spend some private time with his favorite slut, so you hit Mul in the arm to get his attention and tell him that you're going. After collecting your gear and clothes, you and your orc companion leave the upper floor, casually wandering down into the main drinking hall of the orc lair. Mul peels off your side without another word and quickly goes to pick up a drink, then starts chugging away orc brew and sits down to challenge another at arm wrestling.";
		else: [fuck chain]
			LineBreak;
			say "     Quickly getting rid of all your clothing and gear, you get on the round fuck-pad of Boghrim's bed yourself, eager to join the fun. Moving into position behind Jason, you run your hands down the young man's muscled sides and let them come to rest on the firm buns of his ass, feeling them flex and bounce as he pounds into Mul. You look down at the strong orc as he moans into the mattress, thinking that it's you pounding his ass hard and not Jason letting his pent up dominant side have a very enthusiastic outing. It's so very delicious to see the alpha male you've broken in to needing your cock up his rear now putting out to other males - and liking it. Stroking your own [cock of player] shaft, you watch the show a little bit longer, then move forward on your knees, aiming your hard cock right at Jason's well-used pucker. On his next pull back, the human basically impales himself on your erect rod and gives a true bottom-boy's delighted gasp at being penetrated. Jason even slides himself further down on you in his eagerness to be completely filled, uncaring that it means he slips out of Mul's ass fully.";
			say "     'Mmmhhh! Fuck me, master!' Jason groans in bottomless need at the same time that Mul growls at the interruption of his own ass-fuck. The muscled green brute pushes himself up on strong arms and turns his head, going wide-eyed as he realizes who it was that just had him whimper and drool into the sheets. His brows draw together in outrage and Mul opens his mouth to say... something, you don't know what, as you use just that moment to hump against Jason with some force, driving the young man's cock balls deep back into the green butt-slut. Mul's eyes turn back in their sockets and he groans lustily at the hard penetration, then clenches the sheets tightly as you put an arm around Jason's hips, holding him tight against yourself and making the human move to fuck your orc's needy hole. Looking around Jason at the green brute eagerly taking a cock up his ass, tell Mul that he shouldn't make such a fuzz. He moans and whimpers for more cock after all - knowing that it's not yours shouldn't make any difference. The only reply you get is a half-moaned grunt, then the orc lowers his head and shoulders back to the mattress, fully giving in to the fuck.";
			WaitLineBreak;
			say "     You feel movement on the bed behind you, then two strong arms slide around you and hug you tight against a broad, muscled chest. Not that that's the only thing you feel press against you, as Boghrim's mighty pole hotly touches the small of your back. 'Mmmh, our two sluts are both getting fucked deep. Their butts are just meant to be bred,' Boghrim tells you in a satisfied tone and you can feel the warm breath of the orc boss on your skin as takes a deep huff of your own masculine musk, then follows up with a tender love-bite in the bend of your neck. 'They're sexy bitches, but right now - I wanna have something more. Feel the insides of a real man wrapped around my cock! And with you so nicely demonstrating that you can dominate even a guy like Mul... I know just where to find one.'";
			say "     Giving a lusty grunt, Boghrim licks the side of your neck, then lightly nips your earlobe - at the same time as he grabs the thick shaft resting against your back and bends it down to brush over your butt-crack. You feel the wetness of pre-cum on your skin that his touch leaves - seems like you've got a very horny orc behind you. And now he's aligning his shaft with your back door, then pressing in against it, and... his thick cockhead pops into you as he makes a sudden thrust. You can't help but give a breathless gasp at the sudden penetration, but the momentary pain is quickly outweighed by the pleasant feeling of fullness his cock brings - as well as Boghrim's potent pre-cum being absorbed by your own inner walls, resulting in a pleasant buzz. But he doesn't stop there - holding you by the hips, he slides deeper into your body, further and further until finally, his crotch is flush against your butt and you can feel his pubic hair tickling your skin. You hear a satisfied grunt from the big orc and he pauses for a moment, his thick prick balls-deep inside your body, leaking copious amounts of pre-cum that push you to even greater arousal.";
			WaitLineBreak;
			say "     Boghrim gives you a short period to get used to his massive pole inside your ass, kissing and nipping your neck and the bend of your shoulder, then soon you hear the growled words, 'I'm gonna fuck you so hard!' The mighty orc's manhood is withdrawn in one quick pull, leaving your opening to gape for a second before the green brute's cock hammers back into you. Man, that thick prick sure feels amazing inside your hole, filling it very nicely with its impressive girth and bumping your prostate... every... single... hard... thrust, making you flush hotly in arousal and rock back to meet the large orc's hips again and again. And all that while your own manhood is still snugly tight in Jason's well-trained passage, passing on the force of Boghrim's hips into the young man, and through him further into your own orcish butt-slut Mul.";
			say "     Oh hell, what a scene - you almost wish you could be standing to the side and watch it all... Mul, the big and muscled orc slaver in the center of the bed, with his ass raised and face pressed into the mattress, eagerly moaning as a human slave hammers into his sloppy hole. Then behind Jason yourself, balls-deep inside the young man and pushing him deeper into Mul with each thrust - with the end of the fuck chain being formed by the big man - the big orc - of this tribe himself, pounding your ass hard and oh so very deep. If you weren't already getting the fuck of your life, you'd be jerking yourself raw at the hot sight of the orc boss using you as his willing bottom-boy, driving you deeper and deeper into a lust-filled haze with each new pounding thrust. You don't know how long your coupling takes, four sweaty bodies moving in unison to the beat of a fast-paced selection of punk-rock songs, but one thing is sure - you wanna do it again, and soon! After a breathtaking time of taking it from the biggest and baddest orc there is, you eventually reach the point of no return and roar out loud as an orgasm crashes over you like a wave. Your hands grip the sides of Jason's hips very tightly as you bury all of your manhood inside the human, then shoot many a spurt of rich, thick orc seed deep into his rectum.";
			WaitLineBreak;
			say "     Reaching your climax pushes Boghrim over the edge in short notice, as your fuckhole twitches and flexes with each spurt of your cum. The mighty orc gives a lust-fueled bellow, arms tightening around your chest, then the first blast of his seed splashes into you, followed by another and another. As more and more orcish cum fills you with each moment, Boghrim grunts lustfully into your ear, then says, 'Fuck yeah! Your hole feels great!' Meanwhile, on your other end, Jason is trembling and panting as your seed paints his insides white, giving the young man just the fix he needed. With you injecting all that potent cum into him, it's only moments before Jason orgasms himself, breathlessly whimpering, 'Breed me master. Fill me up. Oh my goooddddDDDD!' Human cum rockets through Jason's pulsing member and gets deposited deep inside Mul's hungry hole, making your green butt-slut quite a sloppy mess.";
			say "     Being used to aphrodisiac-laden orcish seed being fucked into him, your orc slut on the other hand isn't quite ready to orgasm yet... until Jason starts giving him a reacharound, that is. Talented human hands grope for and find your orc's prick, then start jerking and squeezing it, placing special attention to caressing the thick and sensitive cockhead at the very end. More than used to bringing pleasure to his orcish masters, Jason's attention quickly pushes Mul's arousal through the roof, and before much longer the orc gives a bellow and his thick prick lets loose a deluge of orcish seed to splatter all over the sheets of Boghrim's bed. A moment later, the exhaustion of a breathtaking bout of fucking catches up with all of you, making three orcs and a human sink down on the bed in a tangle of limbs and sticky bodies.";
			WaitLineBreak;
			say "     After resting a bit with Boghrim's arms still wrapped around you, you eventually slip out of his embrace, pulling off the orc's still half-hard cock in the progress too. Yet without the strong male's shaft inside your passage, you start feeling kind of empty... thankfully, you have just the right thing to take your mind off such matters. With a barked command, you rouse Mul from his slumber too, then demonstratively turn your rear towards him and tell him to eat you out. For a second, conflicting emotions flicker over the orc warrior's face, then his hunger for cum - and especially something as potent as Boghrim's seed - wins out and Mul goes down on you. Pulling apart your asscheeks with strong hands and starting to lap over your crack, the orc warrior slurps out what cum is sticking to your skin, then sticks his tongue into your freshly bred hole.";
			WaitLineBreak;
			say "     Having Mul eating your ass is quite pleasant... and distracting, but you nevertheless remember that there is something else to be done - unless you want to expose your green slut to the full orc mob downstairs and possibly lose him to them. In a commanding tone that just rolls down your orcish tongue, you tell Jason to get to work between Mul's buns in turn - and take care of all the evidence. Boghrim meanwhile watches your little ass-eating chain, making no attempts to hide that the show turns him on quite a bit. So by the time Mul raises his head from your butt again and smacks his lips satedly, Boghrim is sporting another full-on erection - and he calls on Jason to take care of it. Soon, the submissive human is again kneeling between his master's legs, lapping away at his shaft in adoration.";
			say "     While you wish you could have another round, it seems clear that this time, the big orc wants to spend some private time with his favorite slut, so you hit Mul in the arm to get his attention and tell him that you're going. After collecting your gear and clothes, you and your orc companion leave the upper floor, casually wandering down into the main drinking hall of the orc lair. Mul peels off your side without another word and quickly goes to pick up a drink, then starts chugging away orc brew and sits down to challenge another at arm wrestling.";

to say PlayerJasonMulBoghrimFuck:
	say "     While Boghrim pounds into Mul with unabated intensity, you quickly take off your clothes and gear, then get on the round fuck-pad of a bed, eager to join the fun. Moving into position at Jason's front end, you look down at the muscular man as he moans into the mattress, his ass raised high to serve as a fuck-hole for Mul, and therefore also feeling every deep thrust of his true master, Boghrim. It's so very delicious to see the human slave taking a hard cock like the bitch he is - and on top of him, the alpha male that's balls deep inside him, is also getting fucked - hard, and fast - and he likes it. Breaking in this would-be 'owner' of yours to taking thick cocks is one of the best ideas you ever had - at least that's what your libido is telling you, with the throbbing and hard erection between your legs supporting its argument. A sudden, gasped-out groan Jason howls into the mattress draws your attention back to the young man, and you instantly know what to do next.";
	say "     Drawing Jason up by the shoulders, you present the human with your hard cock and grunt in satisfaction as he instantly slips his lips over the head and starts suckling on your manhood. Setting both hands on Jason's head you guide him up and down on your erection, which he services in eager anticipation of swallowing your load. Oh yeah, Boghrim really trained him well. Meanwhile, the orc boss still takes his lust out hard on Mul, hammering into the other orc with such hard thrusts that you almost think he's giving him a spanking - but no, that's just his crotch slamming against Mul's rear. And Boghrim isn't done talking dirty to his current butt-slut either... leaning over the orc as he slams forward again, Boghrim asks him loudly, 'You like that, you needy slut, don't you? Just like a breeder...' Mul grunts a somewhat slurred, 'Yes. Soooo good. Take me. Breed me. I wanna feel your cum,' in assent. Clearly, Boghrim's been leaking more than a little precum into him, pushing the orc into a sex-drunk state of bliss.";
	WaitLineBreak;
	say "     Oh hell, what a scene - you almost wish you could be standing to the side and watch it all... in the center of the bed Mul and Jason, with the orc humping the human slave's upturned butt relentlessly - all the while Boghrim crouches over him, his hips pumping back and forth as he takes the former alpha male orc's hungry asshole. And then of course yourself, balls-deep in Jason's mouth and getting quite a show from your ringside seat. You don't know how long your coupling takes, four sweaty bodies moving in unison to the beat of a fast-paced selection of punk-rock songs, but one thing is sure - you wanna do it again, and soon! After a breathtaking time of getting an exceptionally good blowjob, you eventually reach the point of no return and roar out loud as an orgasm crashes over you like a wave. Forcing Jason's head down on your pole as you feel the orgasm coming, you hold him tight and pump many a spurt of rich, thick orc cum straight into his stomach.";
	WaitLineBreak;
	say "     With you injecting all that potent cum into him, it's only seconds before Jason orgasms himself, slurping and slobbering on your cock as his respectable manhood lets loose several long spurts of cum to splatter all over the sheets of Boghrim's bed. As the human's hole trembles and twitches in ecstasy, his orcish fucker is pushed past the point of no return in short order. With a deep grunt, Mul pushes all of his thick cock into Jason one last time, then gives the young man a whole lot of creamy filling, contributing the slave's cum-drunk state even more. Meanwhile Boghrim's growls and grunts are getting louder and louder as he grinds his hips against Mul's rear very tightly - then the big orc howls, 'Time to get bred! Gonna knock you up with triplets, you sexy slut!'";
	say "     And with that, he pulls completely out of Mul with a wet slurp, creating a shocked gasp from the orc - followed by a deep grunt as Boghrim goes for another one-thrust-penetration that only ends as his balls smack Mul's buttcheeks. Boghrim grunts gutturally, lips drawing back in a satisfied smile that shows his tusks... and his hands dig into Mul's shoulders as he grips him very tightly while unloading a deluge of cum into the orc's ass. Knowing the virility of the mighty orc, you can only imagine how your orcish butt-slut must feel now, having Boghrim's cock pulse with burst after burst of creamy orc cum that splashes into him. After a long moment during which everyone's orgasms slowly abate and the last spurts of cum are shot, the exhaustion of a breathtaking bout of fucking catches up with all of you, making three orcs and a human sink down on the bed in a tangle of limbs and sticky bodies.";
	WaitLineBreak;
	say "     After resting a bit with Jason's arms around you, and the satisfied slave nuzzling your abs with his face, you eventually slip out of his embrace, and raise off the stained mattress. With a sigh, you get off the bed and start putting your clothes back on, then stop as you remember that there is something important to be done yet - unless you want to expose your green slut to the full orc mob downstairs and possibly lose him to them. In a commanding tone that just rolls down your orcish tongue, you tell Jason to get to work between Mul's buns - and take care of all the evidence. Boghrim meanwhile just raises himself on an elbow and watches the bout of ass-eating going on, making no attempts to hide that the show turns him on quite a bit. So by the time Jason raises his head from Mul's butt again and smacks his lips satedly, Boghrim is sporting another full-on erection - and he calls on Jason to take care of it too. Soon, the submissive human is again kneeling between his master's legs, lapping away at his shaft in adoration.";
	say "     While you wish you could have another round, it seems clear that this time, the big orc wants to spend some private time with his favorite slut, so you hit Mul in the arm to get his attention and tell him that you're going. After collecting your gear and clothes, you and your orc companion leave the upper floor, casually wandering down into the main drinking hall of the orc lair. Mul peels off your side without another word and quickly goes to pick up a drink, then starts chugging away orc brew and sits down to challenge another at arm wrestling.";


to say BoghrimSex5: [Threesome + fuck him]
	if HP of Boghrim < 2:
		say "     Right now, the best you can expect if you ask to fuck him is a punch to the face that knocks you out. Maybe you should get to know the mighty orc a bit better before trying that... a hunting trip out into the city together could serve well for that purpose - provided you can bring down something powerful enough to impress Boghrim. Why don't you talk to him about it.";
	else:
		say "     You step up on the orc boss's platform and find Boghrim with his favorite slave Jason stretched out over his lap, ass up and getting fingered by Boghrim's thick fingers. After you give the muscled green male a suggestive wink and nod towards the stairs leading up to his private rooms, Boghrim slaps Jason's ass playfully, which makes makes the young man pant in arousal. Then the orc pulls him aside, making his hard prick whip up, now that there isn't a submissive human lying on it anymore. While Jason automatically starts to worship his Master's shaft, stroking and licking it, Boghrim gives a telling look from the thick pole of man-meat to you and back, then loudly says, 'Time to... share this little slut between us again. Let's do it!'";
		say "     The mighty orc grunts in satisfaction, then gives Jason another quick slap on the bare butt and says, 'Get up, boytoy - we're making this a private party now.' That said, he stands up himself and, without even bothering to put on his loincloth, leads his naked slave and yourself through the drinking hall, his thick prick proudly dangling between his legs. Soon, you're walking up a set of stairs up to the second floor and into the station chief's conference room. Like the rest of the station, things have been rearranged in there quite a bit, as there is no sign of any table or even chairs... instead, the room holds a mightily big, round fuck-pad of a bed, combined with piles of loot and a top of the line stereo system. Moving over to switch it on, Boghrim gives you a bragging grin as the beat of punk music vibrates in your bones for a second, then is turned down to the level of background music.";
		WaitLineBreak;
		say "     While his master was setting the right atmosphere for some hot and heavy sex, Jason already sunk to his knees in front of you and undid your pants. Now he's looking up at you, an eager 'use me' expression on his face - which is something you just can't resist, holding up your hard prick and guiding the submissive human to take it in his mouth. And oh does he do a good job with that. Jason just slides those sexy lips up and up your shaft, going on to deep-throat you till his nose is buried right in your pubes - damn, Boghrim trains his bitches well! As Jason starts to bob up and down on your manhood, the broad-shouldered shape of the orc boss steps up beside you and his large hand slides down your back to tightly squeeze your right buttock.";
		say "     Before things go any further and these two distract you what your real plans are, you snake your arm around Boghrim's broad frame and give his shoulder a friendly squeeze, then suggest that you wanna see Jason impaled from both ends. Praising the muscled slut's charms, you tell Boghrim to imagine the human bouncing up and down on his cock while at the same time deep-throating your own mighty shaft. Interest flares up in Boghrim's eyes and a smile starts to spread over his face, showing off the orc's sharp tusks. Meanwhile, Jason starts to fondle your balls while slurping on your shaft with new elan, his hunger for orc cum increased even more as he gets aroused by hearing your plans. The young man pulls off your shaft and pants quickly while looking up at the two of you with a happy submissive's expression, then buries his nose in your pubes again, your erect cock sliding easily into his well-trained throat. Boghrim gives the human slave's naked body a long, lusty look, then tugs at Jason's collar and says, 'On the bed, Jase. We'll see how you like taking two orcs at the same time.'";
		WaitLineBreak;
		say "     The young bodybuilder kneeling at your feet gets in a few more bobs down to the base of your shaft, eagerly swallowing the small pulses of pre-cum this draws from your balls, then pulls back with a slurp, panting loudly and looking up to you. He runs his tongue over your cockhead again right away as your dick keeps oozing more of the clear, intoxicating pre. His lips are back around the cockhead to suckle on you, right until Boghrim gruffly calls out, 'Jason! Heel, my little bitch!' Commanded by his master, the human slave almost jumps to his feet, quickly following Boghrim to the orc's large fuck-pad. Boghrim smacks the bottom-boy's bare ass with a loud smack as Jason catches up, a little punishment mixed together with foreplay, as he then pulls the human into his arms, holding him by his hair and giving him a domineering kiss.";
		say "     'Never forget who your boss is, even if someone's dick is tickling your tonsils,' Boghrim tells his slave in light admonishment, only to continue making out with him in a very affectionate manner, showing that Jason is still his favorite. A moment later, the orc's large hands hook under Jason's thighs, pulling them up and spreading them before pushing the human's ass down on his hard shaft. 'Unnngghh, yeah - squeeze my cock with your muscles, Jase. Gonna give you what you need', Boghrim grunts as he penetrates the young man deeply, accompanied by Jason's lusty moans. Holding the human in his arms, the orc chief then steps up on the bed and simply lets himself drop back on its middle, the impact on the mattress driving his erection even deeper into Jason.";
		WaitLineBreak;
		say "     Eager to join the two sexy males, you slop off the rest of your clothes and drop your gear, then step up on the bed yourself. Soon you're standing with your feet on both sides of Boghrim's chest and your erect cock right in the face of Jason as he bounces on his master's hard pole. Reaching out to grab the tame jock's head, you pull him against your crotch, leaving a wet line of pre on his cheek before pushing your cockhead against his lips. Just like a good cum-slut should, Jason readily opens up and envelops your erection with his tightly stretched lips, trailing his tongue over your shaft as you start face-fucking him. 'Yeah, shove it deep in his throat! He can take it!' you hear from below and turn your head to look at Boghrim as he lies there and thrusts upward into Jason's ass.";
		say "     Fucking the muscled human from both ends, the hot threesome turns everyone involved on quite a bit - so much so that you're almost ready to just keep going and feed the slave your load. But no, a horny grunt from Boghrim draws your mental view back to thoughts of how sexy the strong and powerful orc is, and memories of how amazing it was to fuck him. And so it is with a sigh that you put both your hands on the human cock-sucker's head and pull him off your dick, then look over your shoulder again and see that Boghrim's got his eyes closed, grunting deeply as he bucks up into Jason's tight hole with his hips. Perfect timing, you think and turn back around - only to see Jason's disappointed expression at being held back from sucking you off some more. With a big grin on your face, you lean down to him and whisper that you'll fuck his master now.";
		WaitLineBreak;
		say "     Letting go of the slave, you step around the orc humping into him, then kneel between Boghrim's legs and slide your hand up and down the hard pole between your legs. Nice and slick, just like it should be to fuck a muscle-packed alpha male's ass. You can't help but give Jason's bare ass a squeeze as you line up your shaft with Boghrim's pucker, your green hand almost inevitably attracted by the well-rounded bum. And then, it's time to go in - knowing that a real orc likes his sex hard and rough, you don't waste any more time with taking things slow. Thrusting in with some force, your hard shaft slides deep into the tight embrace of Boghrim's asshole, making the big brute gasp in a mixture of lust and pain.";
		say "     Barely an eye-blink later, you bottom out in him fully, bumping against the orc's prostate in the process. And... your big friend is quite sensitive there as it turns out - that first touch is enough to drive the already pretty wound-up brute over the edge, bellowing loudly as his prick twitches with spurt after spurt of cum to fill Jason's hungry hole. Mmmh - what a delicious sight... the leader of this whole orc tribe, lying before you impaled on your cock, his cock and balls twitching as he seeds his favorite slave. The special properties of the big orc's cum only take a second to affect Jason in turn - providing you with the sexy sight of the young man's stretched pucker trembling and twitching around Boghrim's cock as the human moans in arousal. His breathless grunts, together with the soft sound of little splats barely audible over the moaning and gasping, make it clear that the young man just nutted on Boghrim's chest.";
		WaitLineBreak;
		say "     'Yeah! *grunt* Just like *grunt* that!' Boghrim pants loudly between your thrusts, clearly enjoying the deep shafting he's getting. He digs both his hands into the bedsheets under him and rears up a bit with his hips when you give especially hard thrusts - which lifts the Jason up into the air, still impaled on Boghrim's rod. The movement draws your attention back down to the human's shapely butt - and incidentally to the potent cum leaking out around Boghrim's shaft, giving you another naughty idea what you can do with the big brute and his slave. Still thrusting hard, but slowing down a bit, you bring a hand to the human's well-bred ass and scoop up a bit of cum, then reach around and push your fingers into Jason's mouth. He greedily sucks the tasty bounty off your fingers, twisting his chest and sticking his tongue out for more - which you gladly feed him, before pushing on his back and telling him to show his master how thankful he is. In his cum-drunk state, Jason readily follows your instructions and proceeds to press his lips to Boghrim's, giving the big orc a deep kiss. Before he quite realizes what's going on, the big orc tastes his own cum - which has its usual effects and puts his already roaring libido into overdrive.";
		say "     Showing how quickly the effects of a strong orc's potent load can go to someone's head, Boghrim hungrily sucks on Jason's tongue, swallowing everything he can get and making out with his slave in pure lust. The two of them almost whimper in lust as you stretch forward with another dose of orc chief cum on your fingers, drawing them to include your hand in their frantic kissing before they return to a tongue duel for the last little drops. In between them kissing, and licking and moaning into each other's mouths, the big brute gets out some pants for you to fuck him harder, babbling in drunk arousal that he wants to feel your load deep in his hole. He almost sounds like... well, Jason - begging like a properly submissive bitch while on his cum-high - but you doubt this'll last long, as the green brute's dominant character is too strong to be suppressed for any length of time. But for now... you gladly give this subby version of the mighty orc what he's panting and pleading for.";
		WaitLineBreak;
		say "     Pounding hard against the big orc's ass, you feel the tingling urge to cum rise from your balls and bury your whole cock inside his ass as deep as it will go, then groan in lust as it starts to blast your heavy load into him. Spurt after spurt fill your green-skinned partner's insides, and between the sensations of your shaft pulsing against his inner walls and the effects of even more orc cum on his system, Boghrim joins you in a second orgasm just a moment later. Bucking against Jason's ass hard, his mighty balls send forth another deluge of cum, overfilling the already well-bred young man - more and more creamy orc seed squishes out around the thrusting shaft, and you don't doubt that Jason's belly must be starting to bulge from all that still is inside. Worn out from the hot sex and two orgasms in a row, the orc lets his head fall back on the bed and takes a moment to rest - while Jason proceeds to nibble at his nipples and licks his own seed up from Boghrim's chest. It doesn't take long until you can almost hear the effects of the orc cum in him start to wear off, as moment by moment his breathing becomes calmer and less like the frantic panting of a needy bottom.";
		say "     Waiting some time longer till the last little spurt of your load is deposited deep inside Boghrim's hole, you eventually pull out of the orc with a wet slurp. A small amount of your cum leaks out as your cockhead pops past the muscled brute's pucker, giving a very nice contrast as it starts to slowly run down between his legs. Seeing it fills you with pride, as it is the visible proof that you bred the orc, getting to be the top over the mightiest of the green brutes. There is even a little string of cum stretching from your slit to the upper edge of his winking pucker - glistening enticingly in the light before eventually pulling apart as you move further away. As you get off the bed and start to look for your dropped clothing, Boghrim eventually sits up a little to look at you, then reaches between his legs and pulls his hand back, fingers sticky with your cum. Rubbing the white goo between his big fingers, the orc gives an acknowledging nod to you, then grunts, 'You fucked me good - but don't think I'm your bitch now. I'm still the boss of this tribe. Still, nice job buddy.'";
		WaitLineBreak;
		say "     Boghrim rubbing your cum between his fingers quickly draws the attention of Jason, who raises his head and stares at the orc's hand in undisguised lust. He licks his lips and asks in a pleading tone, 'May I -' And that is as far as he gets before Boghrim pushes his fingers into his mouth, letting him slurp up your sperm. 'You can get the rest right from the source. Be a good slut and clean me up,' Boghrim grunts to his slave, then chuckles loudly as Jason shimmies down over him and brings his head to the orc's crotch, licking up what cum sticks to his cock and pubes, hands working on fingering his master's ass and pulling out more tasty seed from its depth.";
		say "     By the time you put the last piece of your clothes and gear on, the noise from the bed has moved on to, 'Oooh yeah, stick your tongue in there deep,' with the orc boss on all fours while his favorite slave eats him out. He even raises his hips in an obvious 'fuck me' pose, all to allow little bit more access to Jason. As the human is busy lapping your seed from Boghrim's well-bred hole, you slowly walk towards the door. Giving the two of them one last look and seeing Jason busy pleasing his master - as well as licking up and swallowing the 'evidence' of your activities you left behind, you then close the door properly behind you and make your way back down into the drinking hall.";

to say BoghrimSex6: [Hunting trip with Mul]
	if libido of Mul is 0: [first time]
		say "     Deciding that you want to introduce your sex pet to Boghrim, your eyes search out Mul across the room and a wide grin spreads over your face. You're more than a little curious how the orc chief will react to the fact that one of his brutes has become a secret bottom-boy, hungry for your shaft. Images of some quite sexy scenarios how things may go dance in front of your mind's eye as you make your way through the crowd of partying orcs. Soon, you're very close to your target - but before you walk up to him, you stop for a second to inspect his muscled physique. The broad shoulders, tall stature and corded muscles speak for themselves - he's a grade A hunk, almost an ideal orc. And yet... you broke him in to getting fucked. There's something just so delicious about secretly being the one who can make him bend over and take it - hard. And now, you're right in the middle of the lair and approach your boy for a fuck. Ah, isn't life great?";
	else:
		say "     Deciding that you want to share your sex pet with Boghrim again, your eyes search out Mul across the room and a wide grin spreads over your face. Images of some quite sexy scenarios how things may go dance in front of your mind's eye as you make your way through the crowd of partying orcs. Soon, you're very close to your target - but before you walk up to him, you stop for a second to inspect his muscled physique. The broad shoulders, tall stature and corded muscles speak for themselves - he's a grade A hunk, almost an ideal orc. And yet... you broke him in to getting fucked. There's something just so delicious about secretly being the one who can make him bend over and take it - hard. And now, you're right in the middle of the lair and approach your boy for a fuck. Ah, isn't life great?";
	LineBreak;
	say "     Silently walking up behind the strong orc, you whisper in his ear that you want to fuck him again - while at the same time casually sliding a hand under his loincloth and squeezing one of his firm and muscular buttcheeks. A snarl starts to form in Mul's throat, only to be quickly quenched as he looks at all the other orcs around you and decides that making a scene might not be the best idea[if lastfuck of Mul - turns < 8], given that you can still feel the wetness of cum in his crack - a remainder from your last fun-time[else] right now[end if]. Still, he gives a deep growl, then says just loud enough for only you to hear, 'I'll get you for this, bastard. Eventually you'll be mine and there'll be - *gasp*' You can't help yourself, interrupting his little rant with a finger that you slip into his hole.";
	say "     As well-trained as you have the orc by now, his pucker readily yields to your probing digit, allowing you to rub Mul's inner walls, which totally breaks his concentration. Fighting down all further moans and gasps after the first one, the orc gives in to you a moment later and says, 'Fine, let's go.' Mul leads the way, passing others whom he grunts to, gives a slap on the back, and one orc brute whom he decks hard enough to knock him out - then as he starts to move towards the corridor leading west, you instead grab him by the upper arm and nod in the direction of Boghrim's raised platform. A curious, then concerned, look crosses Mul's face as he realizes that you want him to go that way. He doesn't resist though, following you as you step up and walk over to the orc chief, throwing yourself onto the sofa right next to him.";
	WaitLineBreak;
	if libido of Mul is 0: [first time]
		say "     While Mul just stands nearby and distractedly watches Jason as he kneels between Boghrim's legs and laps at the mighty orc's thick shaft, you lean in to the orc boss and ask if he's game for some more fun. A chuckle escapes Boghrim lips and he grabs hold of his hard cock, then swats it against Jason's forehead with a meaty thud, 'What do you think? 'Course I'm ready! What did you have in mind? If it's a gangbang, your buddy there will have to pay for Jason, like anyone else...' A broad grin spreads over your face as you reach out to Jason and stroke his naked shoulder, then hook a finger under the collar around the human's neck. Pulling aside your own loincloth, you pull the muscular young man close and allow him to suckle on your manhood. Grunting as the sweet lips of Boghrim's favorite slave slide over your cockhead, you tell him that while Jason is amazing, he'll like the fresh meat you have in mind if he accompanies you on a hunting trip. Calmly and casually - just loud enough for only Boghrim, Jason and Mul to hear - you tell the orc beside you that it's a rare treat, a sweet ass that only the strongest of warriors can call their own. Winking at his interested expression, you give a little nod towards Mul. Boghrim's eyes widen at that and he gapes at the shade of emerald green Mul's face takes up in embarrassment, then the orc boss throws his head back and laughs heartily. His shaft throbs with a little spurt of clear pre-cum which is quickly licked up by Jason as you let go of him.";
	else:
		say "     While Mul just stands nearby and distractedly watches Jason as he kneels between Boghrim's legs and laps at the mighty orc's thick shaft, you lean in to the orc boss and ask if he's game for some more fun. A chuckle escapes Boghrim lips and he grabs hold of his hard cock, then swats it against Jason's forehead with a meaty thud, 'What do you think? 'Course I'm ready! What did you have in mind? If it's a gangbang, your buddy there will have to pay for Jason, like anyone else...' A broad grin spreads over your face as you reach out to Jason and stroke his naked shoulder, then hook a finger under the collar around the human's neck. Pulling aside your own loincloth, you pull the muscular young man close and allow him to suckle on your manhood. Grunting as the sweet lips of Boghrim's favorite slave slide over your cockhead, you tell him that while Jason is amazing, he'll like the fresh meat you have in mind if he accompanies you on a hunting trip. Calmly and casually - just loud enough for only Boghrim, Jason and Mul to hear - you tell the orc that Mul's ass just itches for a hard cock. Boghrim's eyes widen at that and he gapes at the shade of emerald green Mul's face takes up in embarrassment, then the orc boss throws his head back and laughs heartily. His shaft throbs with a little spurt of clear pre-cum which is quickly licked up by Jason as you let go of him.";
	say "     Boghrim gives Mul a close look - and you can tell it's not him looking at another orc, but rather a piece of man-meat to be taken - then the big orc loudly says, 'Time to go out and catch ourselves some fresh bitch... hah, the slut will have trouble walking by the time we're done with him!' Boghrim looks down at Jason, still kneeling between his legs and lapping at the orc's big balls, then sighs and grabs his favorite slave by the shoulder, pulling him up to plant a kiss on his mouth before pushing the naked man aside to land on the sofa. Standing up, the orc addresses his little harem of orc breeders and the one unchanged human, 'Listen! Lawrie, Jase, and you other bitches - I'm going out right now. You may play around, but you're not allowed to cum!'";
	WaitLineBreak;
	say "     Led by the big orc chief, Mul and yourself stroll out of the drinking hall and walk down the eastern corridor, passing multiple orcs in the process - several of which give Boghrim grunts in greeting, and one who even offers the orc a go at the naked soldier he's carrying over his shoulder. Boghrim checks out the completely cum-drunk man with clear lust and even slides a finger into his slightly gaping asshole to stroke his prostate. 'Oh yeah, I'll definitively be along to get some of this later. He'll be a nice dessert after our hunting trip. Hah, gonna catch and fuck a big brute with these two!' The other orc chuckles and gives a tusk-baring grin, then fist-bumps Boghrim and walks on into the lair. The two orcs you are with look at the naked human dangling over his shoulder all the way until he turns the corner into the main hall, the throbbing bulges under their loincloths making it obvious that they both would have liked to fuck the soldier right then and there. With a hand on his crotch, Boghrim grunts, 'Let's go - I wanna fuck something!'";
	say "     Giving a friendly punch to Mul's arm, you lean close to the orc and tell him a taunting tone that his ass better be ready for a pounding. A half-angry, half-embarrassed flush spreads over his features and he starts a growled reply, only to catch himself as he gives a sidelong glance at the other orcs still nearby. 'You damne- Er, you're damn right! This will be a great hunting trip.' Holding a hand close to your chest so that only Mul, but not the other orcs, can see it, you grin at him and make a 'do go on' gesture combined with a little nod to his crotch. The orc clears his throat and adds, 'Just thinking of a dick sliding into our prey's ass makes me hard.' He had to force himself to admit it in front of the oblivious onlookers, bringing the words out through clenched teeth, but one look at Mul's loincloth tells you that he really is quite aroused. And that by the prospect of his own ass being rammed by Boghrim and yourself.";
	WaitLineBreak;
	say "     After sharing a fist-bump with Boghrim as the big orc laughs at the things you do with Mul, the three of you eventually set out into the empty streets. There's definitively something to be said about the ability of the orcs to calm the usually so crazy roads of the city - anyone not fled or dragged off to be a slave is thoroughly intimidated, so you make your way along several blocks without anyone or anything coming into sight. Eventually, Boghrim stops at what looks like a mechanic's shop, filled with a motor-less car and tools scattered over the somewhat cum-streaked floor. With a lusty grunt, the massive orc grabs Mul by the shoulder and pushes him inside, stumbling a few steps before he catches himself on the car chassis. 'Always thought you were the toughest of your family Mul. And now I learn you're just a needy bitch inside, hungry for cock!' Boghrim jeers at your former captor. With the words, 'Let's give this butt-slut what he craves,' the orc chief rips off his loincloth and throws it aside, then walks after Mul into the garage.";
	say "     It is pretty comical - and arousing - to see Mul on the receiving end of an even bigger orc's attention. The way his eyes flick left and right, futilely searching an escape like his captives usually do - and not finding any, with two horny orcs between him and freedom. But then - part of him doesn't want to get away, not with the need for hard cocks you've trained into him posing an itch that begs to be sated. And then Boghrim is upon Mul, groping and man-handling the big brute. 'Yeah, now that's a hunk worthy to get fucked!' the orc chief says with a hand on Mul's pec and gives it a hard squeeze, then slides his other hand to grip the back of Mul's head. Pulling the orc slaver close, Boghrim gives him a demanding kiss, then forcefully pushes Mul down on his knees. Grunts and slapping noises fill the garage as Mul is swatted in the face by the bigger orc's hard cock.";
	WaitLineBreak;
	say "     Quickly having gotten rid of your gear and clothes, you join in on the fun and step up next to Boghrim, flanking your tamed orc left and right. And so Mul finds himself presented with hard pricks being rubbed against his face - which soon escalates into sucking as the scent of orcish pre-cum causes him to lap at leaking cockheads. 'He's got talented lips, your bottom-boy!' Boghrim praises Mul's oral skills, then goes on to congratulate you for breaking the orc into the role of servicing others. This prompts a sullen grumble from Mul - rather hard to understand if he wanted to say anything with it, as the kneeling brute's lips encircle Boghrim's thick manhood halfway down his shaft. The orc boss chuckles, 'So you want more cock, Mul? Hah, such a cum-hungry slut!' And with that, Boghrim grabs Mul by the head and holds him tight while bucking his hips forward, only stopping when he's balls-deep in your tamed orc's throat.";
	say "     With Boghrim now making good use of Mul's mouth and tongue, you step back a little and watch for a moment - one strong orc being made to service an even stronger one. Quite a hot show, causing your erection to throb in growing arousal. About time to feel something warm and tight wrapped around it too, so you...";
	LineBreak;
	say "     ([link]Y[as]y[end link]) Line it up with Mul's rear end and fuck the orc.";
	say "     ([link]N[as]n[end link]) Invite Boghrim to have a go at Mul's tight ass and fuck the kneeling orc's throat in his place.";
	if player consents:
		LineBreak;
		say "     Stepping up next to the kneeling orc, you reach between Mul's legs and cup his balls, rolling the full orbs between your fingers for a moment. Stroking his ego as you stroke his cum-factories, you tell the orc how strong and virile he is - then suddenly move your hand up a bit and shove three fingers into his asshole. As Mul bucks into (not away from) the sudden anal invasion, eager to feel your digits deeper inside, his throat muscles twitch around Boghrim's manhood, almost milking him as the orc boss face-fucks his subordinate. The orc boss says with a laugh, 'Such a mighty orc you are - and yet a needy bottom bitch!' He grins at you and nods in recognition, then smiles even broader as you stroke your cock in anticipation. Your powerful fuck-buddy mocks the orcish bottom a bit, pulling out his dick and slapping it into Mul's face as he tells him, 'Yeah, that's right. You're *swat* a little *swat* green-skinned slut! *swat* And now your master is gonna take your, treating you like the breeder you are!'";
		say "     You quickly get into position behind Mul, your [cock of player] shaft hard and ready for some action. And then - just as Mul is getting another cock-smack against his forehead - you thrust deep into the strong male's tight hole, making him roar at the sudden anal invasion. It's not so much that he isn't well-used to getting fucked by now, but rather the relentless teasing and mocking that sends Mul reeling for a moment. Meanwhile, his body does what you've trained him for - Mul's pucker readily expands to allow more and more of your shaft in, while at the same time still being nice and snug around your member. The big male's hole feels fantastic to be in, and the fact that you're dominating the very orc that wanted to take you as a slave makes fucking him all the sweeter.";
		WaitLineBreak;
		say "     The sensation of your cock hitting his prostate is enough to wrench your hunk of an orc out of his paralysis - and the first thing coming out of his mouth afterwards is a needy moan. Being used to getting fucked by now - and getting off on it quite a bit, Mul's anal muscles flex and twitch as you pound into him hard. Part of it is just him reacting to you hitting the prostate, but there are also some moments in which the orc's hole almost seems to jerk you off inside him. Apparently, your muscled green playmate has accepted this role so much now that he is experimenting with new techniques to make wild anal sex feel even better for you both. You can't help but give a very satisfied laugh at the situation - you, balls deep inside a mighty orc warrior and pounding into him hard, while Boghrim is at his other end, just thrusting his dick in between Mul's lips again.";
		say "     Your sexy orc threesome humps and thrusts into each other in a wild rhythm for quite a bit, with both Boghrim and you touching and squeezing Mul's fit body as you fuck him. Eventually, it is the kneeling orc who is the first to reach the point of no return - no wonder, really... with one orc cock in his rear and another in his throat, hammering away and filling him with lots of stimulating pre-cum. The wound-up brute bellows loudly as his prick twitches with spurt after spurt of cum to splatter all over the ground, adding white splotches on top of old oil-stains. Mmmh - you can't help but grin at that, a powerful orc warrior coming without even touching his dick - while at the same time impaling himself on a hard pole he bounces back against. His deep grunts fill the garage and echo out into the streets, joined by a shout of, 'FUUUUCKKK YEAH!' the second he catches his breath again.";
		WaitLineBreak;
		say "     'Yeah! *grunt* Just like *grunt* that! Work your slutty lips over my cock,' Boghrim pants loudly between thrusts that make his balls smack Mul's chin, clearly getting quite close himself. Then suddenly, he throws himself forward with full force, forcing Mul backwards a bit and driving his ass against your pubes, impaling the orc all the way on your cock. With both hands gripping the head of the kneeling orc, he grinds his crotch against Mul's face forcefully and roars in lust as his loads starts to pump into the bottom orc's stomach. Mul's Adam's apple bounces as he swallows every spurt of aphrodisiac-laden orc cum, his anal muscles going wild from the sensations of his own orgasm and the massive infusion of orc cum rocking through his body. This quickly brings you to the point of no return yourself, and you roar out-loud as an orgasm crashes over you like a wave. Gripping the orc's hips, you grind your crotch against his ass with a vengeance, pumping many a spurt of rich, thick orc cum into his hungry hole.";
		say "     With both topping orcs (Boghrim and you) deep in the grip of their orgasms, the two of you lean over Mul from either end - and Boghrim puts his arm over your shoulder so you can brace against one another. 'Quite a fun 'hunting trip' my friend,' the orc boss pants a moment later, giving you a broad grin showing his tusks. Then he addresses Mul, 'Wouldn't you say so too, bitch?' and gives him a slap on his ass. A mumble and slurp is the only answer, as your tame orc still suckles on Boghrim's prick, eager to get even the last drops of cum. 'What a cum-slut! Hey breeder, there's something else for you to clean up,' comes the reaction from Boghrim, followed by the orc motioning you to pull your slick and still half-hard shaft out of Mul's well-bred hole. As you do so and hold it out, the orc boss pulls his dick out of the totally cum-drunk Mul's mouth, freeing the orc to twist around and inhale your erection with a loud slurp. Accompanied by your laughter at his antics, Mul hungrily suckles your own shaft clean, then pushes his hands between his legs to wipe up what cum ran out of his ass, eating that too. Finally, the orc goes on to fingering his own ass, sucking your creamy deposit from his thick fingers, then going back for more. Between the exhaustion his own orgasm and two loads of orc cum in his system, eventually Mul winds down in his drunken state, slumping down in the sticky puddle of his own cum and dozing off.";
		WaitLineBreak;
		say "     'Hah, guess we wore him out,' Boghrim tells you with a chuckle, then proceeds to dress in his loincloth and walks out of the garage. You quickly follow, still adjusting your own clothes and gear as you catch up with the orc boss. He throws a casual glance back at Mul lying on the floor, then shrugs, 'Leave him, he can sleep off his buzz on his own. And if someone finds him like this... well, lucky them. That bitch won't complain about anyone adding a load or two in his state.' And with that, the two of you make your way back to the orc lair, chatting as you go along. You're drinking your third orc brew with Boghrim in the main hall by the time Mul Mul quietly slips into the room again some while later.";
	else:
		LineBreak;
		say "     Stepping up next to the kneeling orc, you reach between Mul's legs and cup his balls, rolling the full orbs between your fingers for a moment. Stroking his ego as you stroke his cum-factories, you tell the orc how strong and virile he is - then suddenly move your hand up a bit and shove three fingers into his asshole. As Mul bucks into (not away from) the sudden anal invasion, eager to feel your digits deeper inside, his throat muscles twitch around Boghrim's manhood, almost milking him as the orc boss face-fucks his subordinate. The orc boss says with a laugh, 'Such a mighty orc you are - and yet a needy bottom bitch!' He grins at you and nods in recognition, then smiles even broader as you mime for him to have a go at Mul's ass. Your powerful fuck-buddy mocks the orcish bottom a bit, pulling out his dick and slapping it into Mul's face as he tells him, 'Yeah, that's right. You're *swat* a little *swat* green-skinned slut! *swat* And now your master is offering me your ass, to treat you like the breeder you are!'";
		say "     Quickly stepping around Mul and crouching behind the kneeling orc, Boghrim gets into position - and you grab the massive pole swinging between his legs, stroking its full length, from the bush of his pubes to the wet and pre-cum dripping cockhead. After a moment of enjoying your touch, the orc boss adds, 'Hah, time to get fucking. I'm gonna *thrust* breed *thrust* this bitch *thrust* SO HARD!' And with that, he lays into Mul with full force, filling the open garage with loud slaps as his crotch hits the other orc's butt. Meanwhile, you stand up and smear the slick pre coating of your hand all over your own manhood - a little treat for Mul. Walking around with a few steps, you have to do little but move in front of Mul and bring your erect shaft into his line of sight... then the moaning and panting orc already reaches out to you and slips his lips over your cock. It's so very delicious to see the alpha male you've broken in to needing your cock go down on you of his own volition. Holding on to him tight, you start face-fucking Mul while he does his best to slurp on your prick. Ah, orc precum - the ultimate tool to resolve little spats about who gets to fuck whom.";
		WaitLineBreak;
		say "     Your sexy orc threesome humps and thrusts into each other in a wild rhythm for quite a bit, with both Boghrim and you touching and squeezing Mul's fit body as you fuck him. Eventually, it is the kneeling orc who is the first to reach the point of no return - no wonder, really... with one orc cock in his rear and another in his throat, hammering away and filling him with lots of stimulating pre-cum. The wound-up brute bellows loudly as his prick twitches with spurt after spurt of cum to splatter all over the ground, adding white splotches on top of old oil-stains. Mmmh - you can't help but grin at that, a powerful orc warrior coming without even touching his dick - while at the same time impaling himself on a hard pole he bounces back against. His deep grunts fill the garage and echo out into the streets, joined by a shout of, 'FUUUUCKKK YEAH!' the second he catches his breath again.";
		say "     'Yeah! *grunt* Just like *grunt* that! Work your slutty hole on my cock,' Boghrim pants loudly between thrusts that meet Mul's rear, clearly getting quite close himself. Then suddenly, he throws himself forward with full force, forcing Mul forward and driving his nose into your pubes. With both hands digging into the shoulders of the kneeling orc, he grinds his crotch against Mul's ass forcefully and roars in lust as his loads starts to pump into the bottom orc's hungry depths. Mul's Adam's apple bounces as he swallows with your cock in his throat, going wild in sucking you as the sensations of his own orgasm and a massive infusion of orc cum rock through his body. This quickly brings you to the point of no return yourself, and you roar out-loud as an orgasm crashes over you like a wave. Hands shooting forward to grip Mul's head tightly, you push all of your cock into his throat, pumping many a spurt of rich, thick orc cum straight into his stomach.";
		WaitLineBreak;
		say "     With both topping orcs (Boghrim and you) deep in the grip of their orgasms, the two of you lean over Mul from either end - and Boghrim puts his arm over your shoulder so you can brace against one another. 'Quite a fun 'hunting trip' my friend,' the orc boss pants a moment later, giving you a broad grin showing his tusks. Then he addresses Mul, 'Wouldn't you say so too, bitch?' and gives him a slap on his ass. A mumble and slurp is the only answer, as your tame orc still suckles on your prick, eager to get even the last drops of cum. 'What a cum-slut! Hey breeder, I got something else for you to clean up,' comes the reaction from Boghrim, followed by the orc pulling his slick and still half-hard shaft out of Mul's well-bred hole, then holding it out demonstratively.";
		say "     Happy to join in the fun with your totally cum-drunk Mul, you let go of his head and pull your dick out, freeing the orc to twist around and inhale Boghrim's erection with a loud slurp. Accompanied by your laughter at his antics, Mul hungrily suckles Boghrim's shaft clean, then pushes his hands between his legs to wipe up what cum ran out of his ass, eating that too. Finally, the orc goes on to fingering his own ass, sucking Boghrim's creamy deposit from his thick fingers, then going back for more. Between the exhaustion his own orgasm and two loads of orc cum in his system, eventually Mul winds down in his drunken state, slumping down in the sticky puddle of his own cum and dozing off.";
		WaitLineBreak;
		say "     'Hah, guess we wore him out,' Boghrim tells you with a chuckle, then proceeds to dress in his loincloth and walks out of the garage. You quickly follow, still adjusting your own clothes and gear as you catch up with the orc boss. He throws a casual glance back at Mul lying on the floor, then shrugs, 'Leave him, he can sleep off his buzz on his own. And if someone finds him like this... well, lucky them. That bitch won't complain about anyone adding a load or two in his state.' And with that, the two of you make your way back to the orc lair, chatting as you go along. You're drinking your third orc brew with Boghrim in the main hall by the time Mul Mul quietly slips into the room again some while later.";
	if MulAnalAcceptance < 10:
		increase MulAnalAcceptance by 2;

Section 3 - Boghrim's favorite slave, Jason

Table of GameCharacterIDs (continued)
object	name
Jason	"Jason"

Jason is a man. Jason is in Main Hall.
The description of Jason is "[JasonDesc]".
The icon of Jason is Figure of Jason_clothed_icon.
The conversation of Jason is { "Having his nose pressed against Boghrim's crotch as he licks and fondles his master makes it just a bit difficult to talk to Jason. Combined with the fact that he's also a bit buzzed from swallowing the big orc's precum, you don't think there's much use talking to him right now..." }.

to say JasonDesc:
	say "     Jason is an athletic human male, somewhere in his twenties. He has short brown hair and dashingly handsome looks. By now, the young man has fully accepted his new role in life, proudly wearing a very skimpy leather harness that basically just consists of a few straps and a black leather collar around his neck. His legs are covered with a literally skin-tight pair of pants made from some sort of stretchy material - which clearly outlines his constantly half-hard cock. He's currently kneeling at his owner Boghrim's feet, worshiping his master by slowly lapping away at the big orc's balls. The fact that Jason still is a human, completely unchanged by his constant contact with the orcs all around, shows that he must be immune to the nanites - a rarity that would surely make him attractive to the researchers outside of the city and aid the search for a counter-agent...";

instead of fucking Jason:
	say "     The human slave is currently occupied worshiping his master's balls and Boghrim would surely object if you just grabbed Jason from where he's kneeling. Maybe you should talk to the orc and see if you can... rent him.";

instead of sniffing Jason:
	say "     Jason has got an attractive male scent, with a definite undertone of orc cum - no wonder, with how often he gets fucked.";

Section 4 - Infection for combat purposes

Table of Random Critters (continued)
name	enemy title	enemy name	enemy type	attack	defeated	victory	desc	face	body	skin	tail	cock	face change	body change	skin change	ass change	cock change	str	dex	sta	per	int	cha	sex	HP	lev	wdam	area	cocks	cock length	cock width	breasts	breast size	male breast size	cunts	cunt length	cunt width	libido	loot	lootchance	scale (number)	body descriptor (text)	type (text)	magic (truth state)	resbypass (truth state)	non-infectious (truth state)	DayCycle	altcombat (text)	BannedStatus (truth state)
--	--	--	--	--	--	--	--	--	--	--	--	--	--	--	--	--	--	--	--	--	--	--	--	--	--	--	--	--	--	--	--	--	--	--	--	--	--	--	--	--	--	--	--	--	--	--	--	--	--;

When Play begins:
	Choose a blank row from Table of Random Critters;
	now name entry is "Orc Boss"; [ Infection/Creature name. Capitalized. ]
	now enemy title entry is "";
	now enemy name entry is "Boghrim";
	now enemy type entry is 1; [unique enemy]
	now attack entry is "[one of]Boghrim[or]The powerful orc[or]The green-skinned brute[or]The muscular orc[or]The brutish orc[or]The muscled brute[at random] [one of]throws himself on you, pushing you down on the mattress. You can feel his erect cock rub against your side hotly before you manage to wind your way out of his grasp.[or]gets a grip on your shoulder and pushes you down, putting you on all fours with your ass raised. When you feel one of this thick fingers brush over your asshole an eye-blink later, you barely manage to crawl away before he starts to finger-fuck you.[or]grabs you by the neck, pulling your head down against his crotch. His cock rests hotly against your cheek for a moment, leaving a string of precum when you manage to pull away.[or]gives you a light slap that dazes you for a second, then lets his large hands roam over your body, feeling and groping you.[or]grabs you by the neck and aggressively kisses you, with his tongue exploring your mouth.[at random]";
	now defeated entry is "[line break]";
	now victory entry is "[line break]";
	now desc entry is "Stepping up on the large bed, the mighty orc leader stands waiting for you in all his naked glory, flexing bulging muscles under his green skin to show off a bit. Meanwhile, Jason stands beside you and watches his master with an eager expression, sporting a rock-hard cock as he can barely contain the urge to climb after the orc and worship him. 'Patience. Gonna enjoy your fine ass a bit later sweet-cheeks,' Boghrim tells his human bitch with a chuckle and wags his massive prick towards the young man, then he turns his gaze on you and says, 'Bring it on! I'm waiting...'[line break][line break]Time to get what you wanted. It only takes seconds for you to hurriedly throw off your remaining clothes and gear, then you step up on the round bed and join the other orc.";
	now face entry is "brutish in appearance, having gained an exaggerated brow, square jaw and yellow eyes. Two sharp tusks protrude from your lower mandible, giving all your expressions a terrifying undertone and distorting your speech somewhat. The short hair on top of your head is black and bristly, sticking up on its own";
	now body entry is "overall human-like, but grown to a good seven feet tall and heavily muscled. The proportions of your body are clearly a bit off the human norm, giving you a pretty bulky build, large hands and feet at the end of thick and powerful limbs, as well as a relatively short neck[if player is OrcCocked]. Around your waist, an improvised loincloth of ragged fabric loosely covers your crotch[end if]";
	now skin entry is "[one of]green[or]pale green[at random]";
	now tail entry is "";
	now cock entry is "[one of]meaty[or]veined[or]green[at random]";
	now face change entry is "a splitting headache has you hold your skull with both hands. Then the changes overtake you, jaw broadening into a square shape as two sharp tusks push up out of your mouth. Your nose flattens and becomes wider, then the rest of your features change into a pretty brutish visage with protruding brows above your eyes. As your face stabilizes in its new form, short bristles of black hair sprout on top of your head";
	now body change entry is "your body shifts and changes, becoming larger than normal. You gain bulging muscles on a broad and powerful frame. As the transformation works its way down your limbs, making them ticker and stronger, it leaves you with somewhat larger than normal hand and feet";
	now skin change entry is "a wash of green spreads across it, at first pretty dark, then lightening to an even, light green tone all over";
	now ass change entry is "your glutes become firm and meaty";
	now cock change entry is "it becomes a light green in color, with a bush of black, slightly bristly hair at its base. A moment later, a cloud of dust-like nanites whirls around your waist, fading away as a ragged loincloth forms to cover your new manhood";
	now str entry is 20;
	now dex entry is 14;
	now sta entry is 18;
	now per entry is 10;
	now int entry is 6;
	now cha entry is 6;
	now sex entry is "Male";           [ Infection will move the player towards this gender. Current: 'Male' 'Female' 'Both' ]
	now HP entry is 300;               [ The monster's starting HP. ]
	now lev entry is 18;               [ Monster level. (Level x 2) XP for victory. (Level / 2) XP for losing. ]
	now wdam entry is 30;              [ Monster's average damage when attacking. ]
	now area entry is "Nowhere";       [ "Outside" "Mall" "Park" "Beach" etc... Check an existing creature in the area. ]
	now cocks entry is 1;              [ Number of cocks the infection will try to cause if sex entry is 'Male' or 'Both'. ]
	now cock length entry is 16;       [ Length in inches infection will make cock grow to if cocks. ]
	now cock width entry is 9;         [ Cock width, more commonly used for ball size. ]
	now breasts entry is 2;            [ Number of nipples the infection will give a player. ]
	now breast size entry is 0;        [ Size of breasts the infection will try to attain (corresponds to letter cup size). ]
	now male breast size entry is 0;       [ Breast size for if Sex="Male", usually zero. ]
	now cunts entry is 0;              [ The number of cunts the infection will try to cause if sex entry is 'Female' or 'Both'. ]
	now cunt length entry is 0;        [ Depth in inches of female sex the infection will attempt to give a player. ]
	now cunt width entry is 0;         [ Width in inches of female sex the infection will try to give a player. ]
	now libido entry is 70;            [ Target libido the infection will rise towards. ]
	now loot entry is "orc brew";                     [ Dropped item, blank for none. Case sensitive. ]
	now lootchance entry is 0;                   [ Percentage chance of dropping loot, from 0-100. ]
	now scale entry is 4;                             [ Number 1-5, approx size/height of infected PC body: 1=tiny, 3=avg, 5=huge ]
	now body descriptor entry is "[one of]muscled[or]meaty[or]powerful[or]broad[or]bulky[at random]";
	now type entry is "[one of]orc[at random]";
	now magic entry is false;                     [ Is this a magic creature? true/false (normally false) ]
	now resbypass entry is false;             [ Bypasses Researcher bonus? true/false (almost invariably false) ]
	now non-infectious entry is true;    [ Is this a non-infectious, non-shiftable creature? True/False (usually false) ]
	now DayCycle entry is 0;           [ 0 = Up at all times; 1 = Diurnal (day encounters only); 2 = Nocturnal (night encounters only);]
	now altcombat entry is "default";
	now BannedStatus entry is false;     [ Row used to designate any special combat features, "default" for standard combat. ]


Section 5 - Endings

[ to be written]

Boghrim ends here.
