Version 1 of Chris by Wahn begins here.
[Version 1.1 - Character relocation - Luneth]

[ HP of Chris - location                           ]
[   0: not born yet                                ]
[   1: in the library                              ]
[ 100: lost in the orc lair                        ]

[ libido of Chris - infection status               ]
[   0: half-orc                                    ]
[   1: orc breeder                                 ]
[   2: orc warrior                                 ]

[ Dexterity of Chris - interaction with his Zebra  ]
[   0: nothing yet                                 ]
[   1: fucked the guy                              ]

Chris is a man. The HP of Chris is normally 0.
The description of Chris is "[ChrisDesc]".
The conversation of Chris is { "Mew!" }.
The icon of Chris is Figure of Chris_clothed_icon.
WarriorChrisPlayerFucked is a number that varies. [number of times the player has been fucked by warrior Chris]
WarriorChrisDominance is a number that varies.
ChrisPlayerOffspring is a number that varies.

instead of sniffing Chris:
	say "     Chris has got an attractive male scent.";

to say ChrisDesc:
	if debugactive is 1:
		say "DEBUG -> HP: [HP of Chris] <- DEBUG[line break]";
	if libido of Chris is 0: [half-orc Chris]
		say "     Chris is a young orc, with a lithe and muscled physique that lacks the sheer bulk and mass of an orc warrior. Still, the sleeveless shirt he found to wear is stretched tight over his hard pecs and abs, providing quite a nice sight. His other articles of clothing are a pair of shorts and some designer undies (known to be 'roomy' at the front), both of which ride pretty low, letting you glimpse the trimmed bush of his pubes. Something tells you that he'd be ready to push them off completely in a heartbeat, letting free the cock showing in a respectively sized bulge at the front. Chris's features are almost pretty but still masculine, with somewhat pronounced brow, a square jaw and yellow eyes. Two sharp tusks protrude from his lower mandible, giving him a dashing, somewhat wild look. Mid-length dark brown hair completes the picture of a very handsome man.";
		say "     As Chris notices your intense gaze upon him, he smiles back at you, giving a little wave with his hand.";
	else if libido of Chris is 1: [breeder Chris]
		say "     Chris is a young orc, with a lithe and muscled physique that lacks the sheer bulk and mass of an orc warrior. As he's wearing nothing but a rather tight pair of shorts, you can clearly see the outline of an average sized cock in them. His features are almost pretty but still masculine, with somewhat pronounced brow, a square jaw and yellow eyes. Two small tusks protrude from his lower mandible, looking rather cute, compared to a real orc's. Long, silky black hair hanging down over his shoulders completes the picture of a very handsome man.";
		say "     As Chris notices your intense gaze upon him, he presents himself for your viewing pleasure, turning to show off his well-rounded ass. He really takes after his father, now that he's become an orc breeder.";
	else if libido of Chris is 2: [warrior Chris]
		say "     Chris is a young orc, but he already has the tall and powerful stature of an orc warrior, with rippling muscles on his big arms, strong pecs and washboard abs. As he's wearing nothing but a rather tight pair of shorts, you can clearly see the outline of a very respectable cock in them. His features are almost a bit brutish, in a 'handsome caveman' kind of way, with a strongly pronounced brow, a square jaw and yellow eyes. Two sharp tusks protrude from his lower mandible, giving him a dashing, somewhat wild look. Short, bristly black hair on his head completes the picture of an untamed orcish warrior.";
		say "     As Chris notices your intense gaze upon him, he gives you a leering smile, as if to say 'I can take you when I want to'.";

instead of conversing the Chris:
	say "[ChrisTalkMenu]";

instead of trading the orc brew when the current action involves the Chris:
	if libido of Chris is 0:
		say "     You hand Chris the mug of orc brew, which the young man accepts and looks at with interest. Opening the lid, he sniffs at it, and watches the liquid slosh around in the mug as he shakes it slightly. The look in his face tells you that he's tempted to try it, partly because of the thrill of doing something forbidden, but his father's command to stay away from the drink holds him back. Biting his lip as he looks at you, Chris says 'Thanks. I - a nip at it wouldn't be so bad, would it? Just a little...'";
		say "     [bold type]Do you convince Chris to drink the orc brew, knowing that it'll most likely transform him into a brutish orc warrior?[roman type][line break]";
		LineBreak;
		say "     ([link]Y[as]y[end link]) - Yes.";
		say "     ([link]N[as]n[end link]) - No.";
		if player consents:
			LineBreak;
			say "     It doesn't take all that much effort to lay his concerns to rest, talking the young orc into taking 'just a sip' - and then another, and another. Before long, he's chugging away the alcoholic beverage like a true orc warrior - which is just what he's becoming right before your eyes. A bit tipsy from his first contact with alcohol, the young man grunts the words, 'Hmm... I want more!', while at the same time his body changes, getting bigger, wider and more muscular. The previously pretty, if masculine, features of his face take on a harder, gruff look, with a square jaw, protruding tusks and thickly pronounced brow. Meanwhile, the flowing black hair that gave Chris much of his handsome aura just disintegrates into a small shower of dust, leaving behind bristly short hair on his head. As all those bodily changes stabilize and set into place, you can almost see the shift of his thought processes in the depth of his eyes, the need and desire to dominate others and turn them into breeders he can pound hard and knock up.";
			now libido of Chris is 2;
			now the icon of Chris is Figure of OrcWarrior_random_icon;
			LineBreak;
			say "[bold type]You lose 1 orc brew![roman type][line break]";
			decrease carried of orc brew by 1;
		else:
			LineBreak;
			say "     Acknowledging that his father didn't want this for Chris, you let him give the mug back to you and pack it away.";
	else if libido of Chris is 1:
		say "     You hand Chris the mug of orc brew, which the young man accepts and looks at with interest. Opening the lid, he sniffs at it, and watches the liquid slosh around in the mug as he shakes it slightly. 'No thanks, I don't think I'd like to drink that. Do you have any delicious orc cum instead?'";
	else if libido of Chris is 2:
		say "     Accepting the mug of orc brew from you, Chris hefts the heavy container and carelessly rips the lid off, then quaffs its contents greedily. Spilling at least a third of it, the orc warrior drains the whole tankard, then gives a resounding belch and throws the mug aside. 'Just what I needed. A drink for real men!'";
		LineBreak;
		say "[bold type]You lose 1 orc brew![roman type][line break]";
		decrease carried of orc brew by 1;

instead of trading the orc cum when the current action involves the Chris:
	if libido of Chris is 0:
		say "     You hand Chris the bottle of orc cum, which the young man accepts and looks at with interest. Taking off the cap of the plastic water bottle he sniffs at it, then licks his lips, obviously tempted to drink the light green, thick and creamy liquid. His hand starts to rise a bit with the bottle, then he stops himself. Biting his lip as he looks at you, Chris says 'Thanks, but... Dad warned me about doing this. I shouldn't - or should I? It smells really nice...'";
		say "     [bold type]Do you convince Chris to drink the orc cum, knowing that it'll most likely transform him into a submissive orc breeder?[roman type][line break]";
		LineBreak;
		say "     ([link]Y[as]y[end link]) - Yes.";
		say "     ([link]N[as]n[end link]) - No.";
		if player consents:
			LineBreak;
			say "     It doesn't take all that much effort to lay his concerns to rest, talking the young orc into setting the bottle to his lips. A moment later, he's busy drinking down the flavorful orc cum, hungrily swallowing it all. His first taste of orc cum does make him rather tipsy, causing him to slur the words 'Hmm... tasty. I wanna more.' At the same time, a subtle but noticeable change goes through his body - features becoming a bit more rounded and slightly feminine, his body still lithe and muscled, but with wider hips fitting to the child-bearing role of orc breeders. The bulge at the front of his pants gets a bit smaller too, as he won't need that massive a cock in his new fate as a submissive bottom. Further up, the sharp tusks in Chris's mouth shrink in size, becoming rather cute little ones instead. As all those bodily changes stabilize and set into place, you can almost see the shift of his thought processes in the depth of his eyes, the need and desire to get mounted and bred rising to the forefront.";
			now libido of Chris is 1;
			now the icon of Chris is Figure of OrcBreeder_random_icon;
			LineBreak;
			say "[bold type]You lose 1 orc cum![roman type][line break]";
			decrease carried of orc cum by 1;
		else:
			LineBreak;
			say "     Acknowledging that his father didn't want this for Chris, you let him give the bottle back to you and pack it away.";
	else if libido of Chris is 1:
		say "     You hand Chris the bottle of orc cum, which the young man accepts and with eager hands, already licking his lips. Immediately taking the cap off, he puts the bottle to his lips and chugs down the light green, thick and creamy liquid, only stopping when it's all gone. 'Hmmm... tasty!' he hums, lightly shaking the bottle to get the last drops out of it. Chris then asks, in the typical manner of an insatiable orc breeder, 'Do you have more?'";
		LineBreak;
		say "[bold type]You lose 1 orc cum![roman type][line break]";
		decrease carried of Orc Cum by 1;
	else if libido of Chris is 2:
		say "     Accepting the plastic bottle of orc cum from you, Chris weighs it in his big hand, looking at the light green, thick and creamy liquid within. He screws the cap off and sniffs it, then hands it back to you. 'No thanks, I'd rather have something with some booze in it. A drink for real men!'";

to say ChrisTalkMenu:
	LineBreak;
	if libido of Chris is 0:
		project the figure of Chris_face_icon;
	else if libido of Chris is 1:
		project the figure of Orcbreeder_random_icon;
	else if libido of Chris is 2:
		project the figure of Orcwarrior_random_icon;
	say "What do you want to talk with Chris about?";
	now sextablerun is 0;
	blank out the whole of table of fucking options;
	[]
	if player is male:
		choose a blank row in table of fucking options;
		now title entry is "Himself";
		now sortorder entry is 1;
		now description entry is "Ask the orc about himself";
	[]
	if player is male:
		choose a blank row in table of fucking options;
		now title entry is "Sex";
		now sortorder entry is 2;
		now description entry is "Ask the orc about sex";
	[]
	sort the table of fucking options in sortorder order;
	repeat with y running from 1 to number of filled rows in table of fucking options:
		choose row y from the table of fucking options;
		say "[link][y] - [title entry][as][y][end link][line break]";
	say "[link]100 - Nevermind[as]100[end link][line break]";
	while sextablerun is 0:
		say "Pick the corresponding number> [run paragraph on]";
		get a number;
		if calcnumber > 0 and calcnumber <= the number of filled rows in table of fucking options:
			now current menu selection is calcnumber;
			choose row calcnumber in table of fucking options;
			say "[title entry]: [description entry]?";
			if player consents:
				let nam be title entry;
				clear the screen and hyperlink list;
				now sextablerun is 1;
				if nam is "Himself":
					say "[ChrisTalk1]";
				if nam is "Sex":
					say "[ChrisTalk2]";
				WaitLineBreak;
		else if calcnumber is 100:
			say "Break off?";
			if player consents:
				now sextablerun is 1;
				say "     You step back from the orc, shaking your head slightly as he gives a questioning look.";
				WaitLineBreak;
			else:
				say "Pick between 1 and [the number of filled rows in the table of fucking options] or 100 to exit.";
		else:
			say "Invalid Option. Pick between 1 and [the number of filled rows in the table of fucking options].";
	clear the screen and hyperlink list;

to say ChrisTalk1:
	if libido of Chris is 0: [basic Chris]
		say "     Chris gives a little shrug, then says 'Not much to tell when you haven't been around that long. I mean - you were there when I was born, then brought me here.' Nodding towards the row of large windows, he continues 'Been scavenging out in the nearer buildings a bit - carefully, you know, so nothing jumps me or follows back here. There's quite a bit of useful stuff to find.' After letting his eyes wander over his little camp, with its mattress, sleeping bag and numerous items piled up beside them, he the looks at the bookshelves. 'As for the future - I remember from dad that people used to have jobs, doing something instead of just scrambling to survive. I guess this whole chaos won't last forever and at some point a new society will establish itself, so I've been reading up a bit. Planning and building houses seems to be a good skill to have... what with whole city blocks burning down because no one even tries to stop a fire that breaks out.'";
	else if libido of Chris is 1: [orc breeder]
		say "     With an adoring look on his face, Chris gushes at you 'I'm so happy to be your slave, master. Please make use of me, I need someone to fuck me, make me feel good and feed me their cum. You, your friends, your pets - I live to serve!'";
	else if libido of Chris is 2: [orc warrior]
		say "     Chris rubs the bulge at the front of his pants and says 'I feel great! Strong and powerful - and pretty much horny all the time... but that isn't a problem. There's lots of ass to be had, you can just grab em off the street.' Giving you a lusty grin and a 'light' (for an orc) bump with his elbow, he continues, [one of]'Did you know there's a German Shepherd living just a block over to the west? Thought he was a tough guy and barked at me, hah - one little swat on the nose and that little bitch was out of the fight. It felt really good to have his hole wrapped around my shaft and to pump him full of cum. Now he begs me for more when I come his way, like a proper little slut...'[or]'A gryphon tried to jump me when I went out not too long ago - her feathers tickled quite a bit when I fucked her hard...'[or]'Isn't it funny how those little latex foxes bulge and expand when one blasts em full of cum? Almost thought the last one was gonna burst - haha!'[or]'I ran into this husky out on the streets with his flock of sluts. Said he was their alpha and offered me one of them to fuck since he didn't want to fight. Pfft - as if I wanted to take those weakling bitches... so I had some fun with the guy himself. Even struggled a bit, but he was no match for a real orc. You should have heard him whimper and howl when I pounded his hole...'[at random]";

to say ChrisTalk2:
	if libido of Chris is 0: [basic Chris]
		say "     A smile shows on Chris mouth as you chat him up and he says 'What about it? Sex is fun - you offering?' Giving you a playful wink that brazenly promises a good time, the orc then continues with, 'Or do you want to talk about sex in the old world? Those strange customs I remember from dad... why would anyone refuse to share comfort and pleasure with others if they're interested in each other? Or even two people just deciding to only fuck among themselves until they're all bored and annoyed with each other...'";
	else if libido of Chris is 1: [orc breeder]
		say "     With an adoring look on his face, Chris gushes at you 'Does my master wish me to do something right now? I'm always ready to please you. Or do you want me to learn some new way to please you? I think I saw some instructive books in the shelves...'";
	else if libido of Chris is 2: [orc warrior]
		say "     Chris gives a deep chuckle and rubs the bulge in his pants. 'Ha! Of course you're gonna ask me about it. I'm just a sex machine! Okay then... first you got to grab yourself a nice little bitch to have fun with, maybe give him a few light pats till he stops struggling.' To illustrate his point, Chris lets his balled up fist meet his other hand in a meaty slap. 'After that, you let him suck your cock, get it nice and wet - that's important for later! You can also use lube, but it's more fun with someone licking your balls and shaft, you know. And then it's go-time, bend over your bottom boy and start pushing it in...' In a pretty lewd demonstration Chris mimes holding on to someone by the hips and pulling them against his crotch, then thrusting against them. 'At that point you'll have to show some self control... you'll want to just pound the little bitch immediately, but you can't - wouldn't want to break your pet. So you take it slow, get him used to your thick shaft - and THEN you fuck him as wild as you want. And be sure to fill him up good and maybe feed him some more cum later - then you'll have a much more willing slave the next time you wanna fuck...'";

to say ChrisTalk3:
	say "     C";

Instead of fucking the Chris:
	if (lastfuck of Chris - turns < 5):
		say "     Chris puts a hand on your chest to hold you back and says 'Please, I need a break for a moment, okay?";
	else:
		now sextablerun is 0;
		if libido of Chris is 0:
			project the figure of Chris_naked_icon;
		else if libido of Chris is 1:
			project the figure of Orcbreeder_random_icon;
		else if libido of Chris is 2:
			project the figure of Orcwarrior_random_icon;
		blank out the whole of table of fucking options;
		[]
		if player is male:
			choose a blank row in table of fucking options;
			now title entry is "Get a blowjob from Chris";
			now sortorder entry is 1;
			now description entry is "Let the orc suck you off";
		[]
		choose a blank row in table of fucking options;
		now title entry is "Give Chris a blowjob";
		now sortorder entry is 2;
		now description entry is "Suck the orc off";
		[]
		if player is male:
			choose a blank row in table of fucking options;
			now title entry is "Fuck the orc's ass";
			now sortorder entry is 3;
			now description entry is "Pound your dick into Chris";
		[]
		if libido of Chris is 2:
			choose a blank row in table of fucking options;
			now title entry is "Let the orc take your ass";
			now sortorder entry is 4;
			now description entry is "Bend over for Chris";
		[]
		choose a blank row in table of fucking options;
		now title entry is "Milk him for some orc cum";
		now sortorder entry is 5;
		now description entry is "Collect a bottle of cum from Chris";
		[]
		sort the table of fucking options in sortorder order;
		repeat with y running from 1 to number of filled rows in table of fucking options:
			choose row y from the table of fucking options;
			say "[link][y] - [title entry][as][y][end link][line break]";
		say "[link]100 - Nevermind[as]100[end link][line break]";
		while sextablerun is 0:
			say "Pick the corresponding number> [run paragraph on]";
			get a number;
			if calcnumber > 0 and calcnumber <= the number of filled rows in table of fucking options:
				now current menu selection is calcnumber;
				choose row calcnumber in table of fucking options;
				say "[title entry]: [description entry]?";
				if player consents:
					let nam be title entry;
					clear the screen and hyperlink list;
					now sextablerun is 1;
					if nam is "Get a blowjob from Chris":
						say "[ChrisSex1]";
					else if nam is "Give Chris a blowjob":
						say "[ChrisSex2]";
					else if nam is "Fuck the orc's ass":
						say "[ChrisSex3]";
					else if nam is "Let the orc take your ass":
						say "[ChrisSex4]";
					else if nam is "Milk him for some orc cum":
						say "[ChrisSex5]";
					WaitLineBreak;
					now lastfuck of Chris is turns;
			else if calcnumber is 100:
				say "Break off?";
				if player consents:
					now sextablerun is 1;
					say "     You step back from the orc, shaking your head slightly as he gives a questioning look.";
					WaitLineBreak;
				else:
					say "Pick between 1 and [the number of filled rows in the table of fucking options] or 100 to exit.";
			else:
				say "Invalid Option. Pick between 1 and [the number of filled rows in the table of fucking options].";
		clear the screen and hyperlink list;

to say ChrisSex1: [Chris sucks the player]
	if libido of Chris is 0: [base state]
		say "     Walking up to Chris, you tell him that you'd love to have some fun with him, giving a little nod to your crotch as you do. The young orc grins as he looks down and sees the bulge in your pants, saying 'Sure, I'm down for anything,' then gets on his knees and starts to undo your pants. His eager fingers quickly have you naked below the belly-button, then they move to cup your balls and give your quickly hardening cock a few slow jerks. Lifting your manhood, he proceeds to lick up its underside, from your balls to the tip, then slides his soft lips over the cock-head.";
		if cockname of player is "Orc Warrior" or cockname of player is "Orc Breeder": [transformation danger]
			say "     Throwing your head back and moaning loudly, you enjoy the amazing blowjob Chris is giving you. He really is a natural at pleasing men, licking and teasing with your balls and cock a talented tongue in between having those sexy lips wrapped around your shaft. You feel yourself getting closer and closer to your building orgasm and gasp that you're about to cum - making Chris quickly pull off your cock. He pants 'Sorry, but I shouldn't swallow your cum...' and starts to raise his hand to jerk you off instead. A sudden urge to just grab him and face-fuck the young man until you cum wells up inside you. That must be your orc instincts, wishing to push him into the transformation to be your private orc breeder, to fill and knock up as you wish.";
			LineBreak;
			say "     ";
			say "     [bold type]Do you do the 'right' thing and suppress those urges, or would you like to feed Chris his first of many load of orc cum?[roman type][line break]";
			LineBreak;
			say "     ([link]Y[as]y[end link]) - Suppress the urges.";
			say "     ([link]N[as]n[end link]) - Feed Chris a load of cum.";
			if player consents:
				LineBreak;
				say "     Squashing your inner orc's wishes with an iron will, you keep your arms at your side and take a deep breath - which leads over to a lusty groan as Chris gets to work jerking you off. As horny and close as you already are, it doesn't take more than a few moments before you start blasting away with spurts of orc cum, which Chris aims to hit him in the chest. He keeps slowly milking your cock until you're well and truly done coming and it starts to go down, then stands up and puts his arms around you for a long kiss.";
			else:
				LineBreak;
				say "     Grunting in lust and aggression as your inner orc asserts its will, you grab Chris's head with both hands and just thrust into his still open mouth. Not stopping until you can feel his nose push against your crotch, pull back and pound into him again, roughly face-fucking the young man and quickly reaching your climax. Your shaft is pulses as a big load of thick and creamy orc cum blasts into his mouth and down his throat, leaving Chris the options of drowning or swallowing it all. At first, he still presses weakly against your hips to pull off, though that resistance soon abates and you can feel him suckle on your shaft with growing eagerness.";
				say "     His first taste of orc cum does make Chris rather tipsy, making him slur the words 'Hmm... tasty. I wanna more.' when you finally let him pull off and take a breath. At the same time, a subtle but noticeable change goes through his body - features becoming a bit more rounded and slightly feminine, his body still lithe and muscled, but with wider hips fitting to the child-bearing role of orc breeders. The bulge at the front of his pants gets a bit smaller too, as he won't need that massive a cock in his new fate as a submissive bottom. Further up, the sharp tusks in Chris's mouth shrink in size, becoming rather cute little ones instead. As all those bodily changes stabilize and set into place, you can almost see the shift of his thought processes in the depth of his eyes, the need and desire to get mounted and bred rising to the forefront.";
				now libido of Chris is 1;
		else: [regular BJ]
			say "     Throwing your head back and moaning loudly, you enjoy the amazing blowjob Chris is giving you. He really is a natural at pleasing men, licking and teasing with your balls and cock a talented tongue in between having those sexy lips wrapped around your shaft. You feel yourself getting closer and closer to your building orgasm and gasp that you're about to cum - making Chris increase his efforts, going down on you with a vengeance. Unsurprisingly, this pushes you over the edge within moments, making you pant loudly as you start blasting away into his mouth and down his throat. The handsome orc hungrily swallows everything you can give him and doesn't stop until he's milked you for even the last little drop. Finally pulling off your shaft, he smacks his lips contently, then stands up and puts his arms around you for a long kiss.";
	else if libido of Chris is 1:
		say "     Walking up to Chris, you tell him that you'd love to have some fun with him, giving a little nod to your crotch as you do. The young orc grins as he looks down and sees the bulge in your pants, saying 'Of course, master. I love serving you,' then gets on his knees and starts to undo your pants. His eager fingers quickly have you naked below the belly-button, then they move to cup your balls and give your quickly hardening cock a few slow jerks. Lifting your manhood, he proceeds to lick up its underside, from your balls to the tip, then slides his soft lips over the cock-head.";
		say "     Throwing your head back and moaning loudly, you enjoy the amazing blowjob Chris is giving you. He really is a natural at pleasing men, licking and teasing with your balls and cock a talented tongue in between having those sexy lips wrapped around your shaft. You feel yourself getting closer and closer to your building orgasm and gasp that you're about to cum - making Chris increase his efforts, going down on you with a vengeance. Unsurprisingly, this pushes you over the edge within moments, making you pant loudly as you start blasting away into his mouth and down his throat. The handsome orc hungrily swallows everything you can give him and doesn't stop until he's milked you for even the last little drop. Finally pulling off your shaft, he smacks his lips contently, then stands up and puts his arms around you for a long kiss.";
	else if libido of Chris is 2:
		say "     Walking up to Chris, you tell him that you'd love to have some fun with him, giving a little nod to your crotch as you do. The young orc grins as he looks down and sees the bulge in your pants, saying 'So? If you wanna have fun, why don't YOU suck MY cock. You can jerk off while you deep-throat me.' Changing your approach, you playfully insinuate that it's okay and you won't hold it against him that he's not man enough to take your whole shaft. 'Hah - there's nothing a real orc can't do,' he grunts, then falls to his knees before you. 'Bring it on - I'll show you what's what!' Hooking two fingers under your waistband, he pulls your pants down with a powerful wrench, then leans forward to lick your soon hardening shaft, sliding his soft lips over the cock-head in short notice.";
		say "     Throwing your head back and moaning loudly, you enjoy the amazing blowjob Chris is giving you. He really is a natural at pleasing men, licking and teasing with your balls and cock a talented tongue in between having those sexy lips wrapped around your shaft. You feel yourself getting closer and closer to your building orgasm and gasp that you're about to cum - making Chris increase his efforts, going down on you with a vengeance. Unsurprisingly, this pushes you over the edge within moments, making you pant loudly as you start blasting away into his mouth and down his throat. The handsome orc hungrily swallows everything you can give him and doesn't stop until he's milked you for even the last little drop. Finally pulling off your shaft, he smacks his lips contently, then stands up and wipes a bit of cum off the corner of his mouth. 'See - told ya. Orc warriors are the best at everything!'";

to say ChrisSex2: [player gives Chris a BJ]
	if libido of Chris is 0: [base state]
		say "     Walking up to Chris, you tell him that you'd love to have some fun with him, giving a little nod to his crotch as you do. The young orc grins as he follows your gaze, putting a large hand on the bulge in his shorts and rubbing his cock through the fabric. 'Sure, I'm down for anything,' he says with an enticing wink, then shoves his shorts halfway down his muscular legs and kicks them off a moment later. As his thick green shaft is freed from being trapped in the tight garment, it swings up and slaps against his abs with a meaty thud. This orc teen really takes after his dad, with a weighty shaft to match! Eager to get your lips around that pole of hard flesh, you crouch down in front of him and reach out to touch it.";
		say "     'Yeah!' Chris cheers as you wrap your fingers around his cock and pump it, reveling at the girth and length of the green-skinned half-orc. A glistening drop of pre that soon forms at the cum-slit draws you in closer to his crotch, leaning forward and sticking out your tongue so that you can lap it up and swallow this first drop of the orc's ambrosia. The taste of it on your tongue is almost indescribable, making you want more - much more. With a breathless pant, you pounce on Chris's dick, wrapping your lips around his cock-head and suckling on it. 'Nnngh - fuck that's good,' the orc teen grunts and puts a hand on your head, softly nudging you to go deeper.";
		WaitLineBreak;
		say "     Starting to bob up and down on the young orc's erection, you trace the veins on his shaft with your tongue and hungrily gobble up every drop of pre he leaks into your mouth. 'Damn, you're good at this. Yeah, go faster!' the orc teen calls out, his loud voice carrying throughout the library. You're only to happy to follow the request, accelerating your movements to service his erection even as he himself starts to hump his hips forward to meet you. This frequently buries your nose deep in the bush of his pubes, huffing the aroma of a young orc in his prime - and of course, his heavy balls slap against your chin every time you take all of his dick. Guided by strong hands that soon take hold of your head, you find yourself face-fucked hard by Chris. Already half drunk on the orc's pre-cum alone, you hunger for the chance to be his cum-dump... and your wish is fulfilled not long after.";
		say "     'Fuuuckkkk! I'm gonna come!' Chris suddenly bellows and forces his whole cock down your throat, then lets out a deep grunt as the first spurt of cum is pumped directly into your stomach. Heavy throbs of his cock deliver the orc's rich, creamy cum into your body, which eagerly absorbs the potent mixture. You can't help but gurgle giddily as its effects make you drunk almost out of your mind, your body twitching with suddenly spiking lust and arousal. [if player is male]Your own cock immediately starts to spew forth its own load, creaming the inside of your pants[else if player is female]Your pussy immediately starts to tingle, leaking sticky femcum and soaking the inside of your pants[else]Your sexless crotch tingles as the sensation becomes too much to bear and you orgasm[end if]. And that is pretty much the last thing you consciously sense for a while, as the overload of fresh orc cum puts you into a sexual haze. Dimly, you remember afterwards that he picked you up and brought you over to a sofa to sleep off the buzz.";
	else if libido of Chris is 1:
		say "     Walking up to Chris, you tell him that you'd love to have some fun with him, giving a little nod to his crotch as you do. The young orc smiles at you worshipfully for a moment, then shakes that off and follows your gaze, giving a happy little sigh as he realizes you want his cock. 'I - oh wow, of course master!' he says eagerly, then shoves his shorts halfway down his muscular legs in his eagerness to please you any way he can. Kicking off the garment, your orc breeder stands naked in front of you an eye-blink later. Despite having become more slender and 'pretty' as an orc slut, his cock still takes after his dead quite obviously, the weighty shaft standing proudly erect. Eager to get your lips around that pole of hard flesh, you crouch down in front of him and reach out to touch it.";
		say "     'Oooh yes!' Chris cheers as you wrap your fingers around his cock and pump it, reveling at the girth and length of the green-skinned muscular pretty-boy. A glistening drop of pre that soon forms at the cum-slit draws you in closer to his crotch, leaning forward and sticking out your tongue so that you can lap it up and swallow this first drop of the orc's ambrosia. The taste of it on your tongue is almost indescribable, making you want more - much more. With a breathless pant, you pounce on Chris's dick, wrapping your lips around his cock-head and suckling on it. 'Nnngh - fuck that's good,' the orc teen grunts and puts a hand on your head, softly nudging you to go deeper.";
		WaitLineBreak;
		say "     Starting to bob up and down on the young orc's erection, you trace the veins on his shaft with your tongue and hungrily gobble up every drop of pre he leaks into your mouth. 'Damn, this feels amazing master. Can... can you go faster?' the orc warrior calls out, his loud voice carrying throughout the library. You're only to happy to follow the request, accelerating your movements to service his erection even as he himself starts to hump his hips forward to meet you. This frequently buries your nose deep in the bush of his pubes, huffing the aroma of a young orc in his prime - and of course, his heavy balls slap against your chin every time you take all of his dick. Guided by suggestive nudges of his hands you find yourself slurping in Chris's cock in an ever increasing tempo. Already half drunk on the orc's pre-cum alone, you hunger for the chance to taste his load... and your wish is fulfilled not long after.";
		say "     'Fuuuckkkk! I'm coming master!' Chris suddenly bellows and forces his whole cock down your throat, then lets out a deep grunt as the first spurt of cum is pumped directly into your stomach. A heart-beat later, he remembers that he is your breeder - not the other way around - and lets go of you again, allowing you to pull back until just his dickhead is in your mouth. Of course, that doesn't mean he isn't still coming, and heavy throbs of his cock deliver the orc's rich, creamy cum into your body, covering your tongue with spurt after spurt. You can't help but gurgle giddily as its effects make you drunk almost out of your mind, your body twitching with suddenly spiking lust and arousal.";
		WaitLineBreak;
		say "     [if player is male]Your own cock immediately starts to spew forth its own load, creaming the inside of your pants[else if player is female]Your pussy immediately starts to tingle, leaking sticky femcum and soaking the inside of your pants[else]Your sexless crotch tingles as the sensation becomes too much to bear and you orgasm[end if]. Then suddenly, the green shaft you were sucking on is pulled away, soon to be replaced by Chris leaning in to kiss you on the mouth, his tongue pushing in between your lips to search for cum. Holding on to each other, the two of you make out with one another, sharing the aphrodisiac-laden bounty of his cock-milk between the two of you. Soon, you're both soon so giddy and lustful that things escalate to both of you lying down, touching and kissing as you ride out the high.";
	else if libido of Chris is 2:
		say "     Walking up to Chris, you tell him that you'd love to have some fun with him, giving a little nod to his crotch as you do. The young orc grins as he follows your gaze, putting a large hand on the bulge in his shorts and rubbing his cock through the fabric. 'Can't resist a true orc's cock, can you?' he says with an amused chuckle, then shoves his shorts halfway down his muscular legs and kicks them off a moment later. As his thick green shaft is freed from being trapped in the tight garment, it swings up and slaps against his abs with a meaty thud. This orc teen really takes after his dad, with a weighty shaft to match! Eager to get your lips around that pole of hard flesh, you crouch down in front of him and reach out to touch it.";
		say "     'Yeah!' Chris cheers as you wrap your fingers around his cock and pump it, reveling at the girth and length of the green-skinned brute. A glistening drop of pre that soon forms at the cum-slit draws you in closer to his crotch, leaning forward and sticking out your tongue so that you can lap it up and swallow this first drop of the orc's ambrosia. The taste of it on your tongue is almost indescribable, making you want more - much more. With a breathless pant, you pounce on Chris's dick, wrapping your lips around his cock-head and suckling on it. 'Nnngh - fuck that's good,' the orc teen grunts and puts a hand on your head, softly nudging you to go deeper.";
		WaitLineBreak;
		say "     Starting to bob up and down on the young orc's erection, you trace the veins on his shaft with your tongue and hungrily gobble up every drop of pre he leaks into your mouth. 'Damn, I love having a needy little breeder servicing my cock! Faster, slut!' the orc warrior calls out, his loud voice carrying throughout the library. You're only to happy to follow the request, accelerating your movements to service his erection even as he himself starts to hump his hips forward to meet you. This frequently buries your nose deep in the bush of his pubes, huffing the aroma of a young orc in his prime - and of course, his heavy balls slap against your chin every time you take all of his dick. Guided by strong hands that soon take hold of your head, you find yourself face-fucked hard by Chris. Already half drunk on the orc's pre-cum alone, you hunger for the chance to be his cum-dump... and your wish is fulfilled not long after.";
		say "     'Fuuuckkkk! Take it, cum-slut!' Chris suddenly bellows and forces his whole cock down your throat, then lets out a deep grunt as the first spurt of cum is pumped directly into your stomach. Heavy throbs of his cock deliver the orc's rich, creamy cum into your body, which eagerly absorbs the potent mixture. You can't help but gurgle giddily as its effects make you drunk almost out of your mind, your body twitching with suddenly spiking lust and arousal. [if player is male]Your own cock immediately starts to spew forth its own load, creaming the inside of your pants[else if player is female]Your pussy immediately starts to tingle, leaking sticky femcum and soaking the inside of your pants[else]Your sexless crotch tingles as the sensation becomes too much to bear and you orgasm[end if]. And that is pretty much the last thing you consciously sense for a while, as the overload of fresh orc cum puts you into a sexual haze, feeling nothing but pleasure and knowing you are exactly where you belong - on your knees, serving an orc master.";

to say ChrisSex3: [the player fucks Chris]
	if libido of Chris is 0: [base state]
		say "     Walking up to Chris, you tell him that you'd love to have some fun with him, giving a little nod to your crotch as you do. The young orc grins as he looks down and sees the bulge in your pants, saying 'Sure, I'm down for anything,' then reaches for your pants. His eager fingers quickly have you naked below the belly-button, then they move to cup your balls and give your quickly hardening cock a few slow jerks. Drawing your head towards his to meet your lips for a kiss, the young man pants 'Can't wait to feel you inside me.' After that, he sashays over towards his mattress, casually undoing his shorts and letting them drop on the way, then lies down. The handsome and shapely orc gives you a very inviting smile as he proceeds to pull up his legs, holding them spread open for you to present his asshole.";
		say "     Eager to join Chris between (or rather on top of) the sheets, you hurriedly throw off your gear and clothing and get down on the mattress yourself. Leaning forward, you grab the young man's already fully hard cock, licking the hot and hard pole slowly before moving lower as you jerk him with your hands. The orc gives an aroused gasp as you lap over his balls, then encircle one of them with your lips and suck on it, before finally arriving at his invitingly quivering hole. You bury your nose between his firm cheeks, breathing in Chris's own masculine scent, and lap along his crack, then seek out the pucker with the tip of your tongue and stick it in. There is something very gratifying about the way you can make this strong man quiver and pant by just wiggling your tongue a little bit as you eat out his ass.";
		WaitLineBreak;
		say "     After spending some time going down on Chris, you hear him moan 'You're amazing - but I need more. Please, stick it in and fuck me hard!' Who could resist such an enticing request? You don't even try, instead moving closer to him on your knees, until your own hard cock is just in the right position to take the green hunk's ass. Reaching down to take hold of your manhood, you gently brush it over Chris's hole, making him pant in arousal. Then you press in and sink your hard shaft into the orc's rear end, stretching his inner muscles around you. With you taking the time to prepare and relax him with oral sex, as well as some inherited traits from his orc breeder parent, you find Chris to be able to take your erection easily, while at the same time still being nice and snugly tight.";
		say "     The young man really is a natural at bottoming, squeezing and flexing his inner muscles around your invading member to add to your pleasure. Leaning over Chris, you give him a hungry kiss on the mouth, then pull back your hips and thrust into him again. Guided by rising moans in lust, you speed up bit by bit and before too much longer, the two of you are enthusiastically coupling with each other on the bunk. In between satisfied gasps and hot kisses, Chris calls out for you to go ever harder and faster, growling 'I'm an orc, we like it rough!' in the throes of passion. You're only too eager to comply, and soon you're really pounding into him, your hips meeting with a loud slap every time you thrust.";
		WaitLineBreak;
		if cockname of player is "Orc Warrior" or cockname of player is "Orc Breeder": [transformation danger]
			say "     A.";
			LineBreak;
			say "     Given the wild ride you're giving Chris, it's no big wonder that he soon moans 'Getting kind of close... you too?' Then there's a short pause and a groan 'Oh, wait - damn. Can't have your cum in me. You're an orc. Pull out, okay? Please.' Every orcish urge in your body tells you to just keep going, fill this slut up and make a breeder out of him...";
			say "     [bold type]Do you do the 'right' thing and suppress that feeling, or would you like to fill Chris with his first of many loads of orc cum?[roman type][line break]";
			LineBreak;
			say "     ([link]Y[as]y[end link]) - Yes.";
			say "     ([link]N[as]n[end link]) - No.";
			if player consents:
				LineBreak;
				say "     Slightly disappointed, but willing to respect his wishes, you pull your cock out of Chris, then bring it up to rub right against his own shaft. Taking both of them in your hands together, you start jerking them off. It feels nice to have your manhood rubbing against his, and just a short while later, you feel the urge to cum rise inside you. With a grin on your face, you aim right at the orc's head and moments later start to blast away, sending many an arc of cum to splat down on him. Chris himself is just a moment after you, gasping loudly as he comes - and creams his face even more.";
				say "     After your shaft shoots its last sting of cum onto Chris, you lean forward to start making out with him, playfully lapping up both your mixed contributions to the cum-facial and sharing them with him. Then you flop down to lie beside him for a moment, moving close to cuddle up against is muscled back and putting an arm around him. 'That was fun! We should to it more often...' the orc moans, content to just lie with you like that for a while.";
			else:
				LineBreak;
				say "     Grunting in lust and aggression as your inner orc asserts its will, you grab Chris's hips with both hands and just keep pounding him hard and deep. It takes a moment till he realizes you're not pulling out and tries to wiggle out from under you - unsuccessfully, as you're holding on to tight and your cock bumping against is prostate makes him shudder in lust and think other things. And then... it's too late. With a roar, you bury your cock in his ass all the way, grunting with each shot of your seed pumping into his ass. Feeling the life-giving, fertile seed splash against his insides drives the young orc over the edge right with you, gasping and moaning as he blows a load all over his chest.";
				say "     As more and more cum fills up his ass, a subtle but noticeable change goes through Chris's body - with features becoming a bit more rounded and slightly feminine, and hips widening to slightly to fit the child-bearing role of orc breeders. Even as his cock sprays its load all over the young man's chest, it gets somewhat smaller too. Further up, the sharp tusks in Chris's mouth shrink in size, becoming rather cute little ones instead. As all those bodily changes stabilize and set into place, you can almost see the shift of his thought processes in the depth of his eyes, the need and desire to get mounted and bred rising to the forefront.";
				now libido of Chris is 1;
		else: [regular finish with cum]
			say "     Given the wild ride you're giving Chris, it's no big wonder that he soon moans 'Almost ready *pant* to cum'. Reaching between his legs to grab his hard cock, you stroke it a few times, aiming it at Chris's head with a grin. Just a second later, the orc gives a satisfied grunt and starts to tremble and twitch with each shot of his cum that blasts from his cock... to splatter his face. The orc's anal muscles flex around your cock at the same time, which gives you the rest too in short order. As you feel the orgasm rapidly approaching, you drive into your partner's deliciously tight asshole one last time, grinding your hips against his as you fill him with your seed.";
			say "     After your shaft shoots its last sting of cum into Chris, you slowly pull out of him and flop down to lie beside him for a moment. Turning on your side, you move closer to the orc, cuddling up against his muscled back and put an arm around him. 'That was fun! We should to it more often...' the orc moans, content to just lie with you like that for a while.";
	else if libido of Chris is 1:
		say "     Walking up to Chris, you tell him that you'd love to have some fun with him, giving a little nod to your crotch as you do. The young orc grins as he looks down and sees the bulge in your pants, saying 'Of course, master,' then reaches for your pants. His eager fingers quickly have you naked below the belly-button, then they move to cup your balls and give your quickly hardening cock a few slow jerks. Drawing your head towards his to meet your lips for a kiss, the young man pants 'Can't wait to feel you inside me.' After that, he sashays over towards his mattress, casually undoing his shorts and letting them drop on the way, then lies down. The handsome and shapely orc gives you a very inviting smile as he proceeds to pull up his legs, holding them spread open for you to present his asshole.";
		say "     Eager to join Chris between (or rather on top of) the sheets, you hurriedly throw off your gear and clothing and get down on the mattress yourself. Leaning forward, you grab the young man's already fully hard cock, licking the hot and hard pole slowly before moving lower as you jerk him with your hands. The orc gives an aroused gasp as you lap over his balls, then encircle one of them with your lips and suck on it, before finally arriving at his invitingly quivering hole. You bury your nose between his firm cheeks, breathing in Chris's own masculine scent, and lap along his crack, then seek out the pucker with the tip of your tongue and stick it in. There is something very gratifying about the way you can make this strong man quiver and pant by just wiggling your tongue a little bit as you eat out his ass.";
		WaitLineBreak;
		say "     After spending some time going down on Chris, you hear him moan 'You're amazing - but I need more. Please, stick it in and fuck me hard!' Who could resist such an enticing request? You don't even try, instead moving closer to him on your knees, until your own hard cock is just in the right position to take the green hunk's ass. Reaching down to take hold of your manhood, you gently brush it over Chris's hole, making him pant in arousal. Then you press in and sink your hard shaft into the orc's rear end, stretching his inner muscles around you. With you taking the time to prepare and relax him with oral sex, as well as some inherited traits from his orc breeder parent, you find Chris to be able to take your erection easily, while at the same time still being nice and snugly tight.";
		say "     The young man really is a natural at bottoming, squeezing and flexing his inner muscles around your invading member to add to your pleasure. Leaning over Chris, you give him a hungry kiss on the mouth, then pull back your hips and thrust into him again. Guided by rising moans in lust, you speed up bit by bit and before too much longer, the two of you are enthusiastically coupling with each other on the bunk. In between satisfied gasps and hot kisses, Chris calls out for you to go ever harder and faster, growling 'I'm an orc, we like it rough!' in the throes of passion. You're only too eager to comply, and soon you're really pounding into him, your hips meeting with a loud slap every time you thrust.";
		WaitLineBreak;
		say "     Given the wild ride you're giving Chris, it's no big wonder that he soon moans 'Almost ready *pant* to cum'. Reaching between his legs to grab his hard cock, you stroke it a few times, aiming it at Chris's head with a grin. Just a second later, the orc gives a satisfied grunt and starts to tremble and twitch with each shot of his cum that blasts from his cock... to splatter his face. The orc's anal muscles flex around your cock at the same time, which gives you the rest too in short order. As you feel the orgasm rapidly approaching, you drive into your partner's deliciously tight asshole one last time, grinding your hips against his as you fill him with your seed.";
		say "     After your shaft shoots its last sting of cum into Chris, you slowly pull out of him and flop down to lie beside him for a moment. Turning on your side, you move closer to the orc, cuddling up against his muscled back and put an arm around him. 'Thank you! And please fuck me more often like this, master...' the orc moans, content to just lie with you like that for a while.";
	else if libido of Chris is 2:
		say "     Walking up to Chris, you tell him that you'd love to have some fun with him, giving a little nod to your crotch and staring at his ass as you do. The young orc grins as he looks down and sees the bulge in your pants, saying 'So? If you wanna have fun, just let ME fuck YOU. I'll show you a good time alright!' Changing your approach, you playfully insinuate that it's okay and you won't hold it against him that he's afraid of taking your whole shaft. 'What? No! I'm not afraid of anything. I'll show you!' he grunts, then undoes his shorts and lets them drop before stomping over towards his mattress. The muscular orc gives you a determined look, then lies down and proceeds to pull up his legs, holding them spread open for you to present his asshole. 'Well then - get going! I'm waiting!' he growls.";
		say "     Eager to join Chris between (or rather on top of) the sheets, you hurriedly throw off your gear and clothing and get down on the mattress yourself. Leaning forward, you grab the young man's already fully hard cock, licking the hot and hard pole slowly before moving lower as you jerk him with your hands. The orc gives an aroused gasp as you lap over his balls, then encircle one of them with your lips and suck on it, before finally arriving at his invitingly quivering hole. You bury your nose between his firm cheeks, breathing in Chris's own masculine scent, and lap along his crack, then seek out the pucker with the tip of your tongue and stick it in. There is something very gratifying about the way you can make this gruff man quiver and pant by just wiggling your tongue a little bit as you eat out his ass.";
		WaitLineBreak;
		say "     After spending some time going down on Chris, you hear him grunt 'Still not feeling any dick. Changed your mind and gonna pussy out?' It's clear that he liked his ass getting eaten quite a bit, but now he's back to his tough-guy attitude, as if to prove to himself that he's no breeder. Well, orc warrior or orc breeder - you don't care and just wanna fuck him. Moving closer to him on your knees, you bring your hard cock to just the right position to take the green hunk's ass. Reaching down to take hold of your manhood, you gently brush it over Chris's hole, making him pant in arousal. Then you press in and sink your hard shaft into the orc's rear end, stretching his inner muscles around you. With you taking the time to prepare and relax him with oral sex, as well as some inherited traits from his orc breeder parent, you find Chris to be able to take your erection easily, while at the same time still being nice and snugly tight.";
		say "     The young man really is a natural at bottoming, almost reflexively squeezing and flexing his inner muscles around your invading member to add to your pleasure. Leaning over Chris, you give him a hungry kiss on the mouth, then pull back your hips and thrust into him again. Guided by rising moans in lust, you speed up bit by bit and before too much longer, the two of you are enthusiastically coupling with each other on the bunk. In between satisfied gasps and hot kisses, Chris calls out for you to go ever harder and faster, growling 'I'm an orc, we like it rough!' in the throes of passion. You're only too eager to comply, and soon you're really pounding into him, your hips meeting with a loud slap every time you thrust.";
		WaitLineBreak;
		say "     Given the wild ride you're giving Chris, it's no big wonder that he soon moans 'Almost ready *pant* to cum'. Reaching between his legs to grab his hard cock, you stroke it a few times, aiming it at Chris's head with a grin. Just a second later, the orc gives a satisfied grunt and starts to tremble and twitch with each shot of his cum that blasts from his cock... to splatter his face. The orc's anal muscles flex around your cock at the same time, which gives you the rest too in short order. As you feel the orgasm rapidly approaching, you drive into your partner's deliciously tight asshole one last time, grinding your hips against his as you fill him with your seed.";
		say "     After your shaft shoots its last sting of cum into Chris, you slowly pull out of him and flop down to lie beside him for a moment. He raises himself up on his elbows in the meantime, then gives you a 'light' bump on the shoulder with his hand. 'See - I totally had no problem with taking you on. It'll take larger dicks to make this orc afraid!'";

to say ChrisSex4: [Chris fucks the player]
	if libido of Chris is 0: [base state]
		if a random chance of 1 in 2 succeeds:
			setmonster "Orc Warrior";
		else:
			setmonster "Orc Breeder";
		say "     Walking up to Chris, you tell him that you want his cum. The young orc grins as he follows your gaze, putting a large hand on the bulge in his shorts and rubbing his cock through the fabric. 'Sure, I'm down for anything,' he says with an enticing wink, then shoves his shorts halfway down his muscular legs and kicks them off a moment later. As his thick green shaft is freed from being trapped in the tight garment, it swings up and slaps against his abs with a meaty thud. This orc teen really takes after his dad, with a weighty shaft to match! Chris's manhood twitches and grows harder by the second, filling out as he postures for a short while, showing off his toned body and reaching down to cup his full and heavy balls suggestively, his thumb resting on the rising pole of his erection.";
		say "     'So, how do you wanna do this?' the young man asks in a lusty tone and swings his shaft up and down a little. Smiling at his eagerness, you nod over to the nearest sofa and suggest he take you on it. As you look back towards the young orc, he's already almost upon you, sliding his arm around you in a one-armed hug and bringing his mouth towards yours. The sides of his tusks press against your face tightly as Chris tongue explores your mouth and a large hand gropes your ass. 'Can't wait to fuck you,' he grunts out between kisses as the two of you make out, followed by a quick dash over towards your soon to be fuck-pad. In mere moments, you're stripped naked with his help, then find yourself stretched out on the sofa, your ass pulled right to the edge of the seat.";
		WaitLineBreak;
		say "     Eager to plunge his cock into you, Chris bends his legs to get to the right height and jerks his manhood a few times, lubing it up with the pre he has started leaking. 'Get ready. I'm gonna put it in,' the orc says in a lusty voice as he lines his erection up with your pucker. 'You want it as bad as I do, don't you?' Chris asks and teases your pucker with his cock-head, then takes hold of the base of his cock, smacking it between your buttocks a few times. Your moan at feeling him - almost - penetrate, then pull back, is all the answer he needs. A heartbeat later, Chris plunges his thick shaft into you for real, driving more than half its length inside with a guttural grunt, then pushing further until his balls soon press against your ass.";
		say "     His impatient entry technique makes you really glad that the green-skinned hunk's cock is slicked up with his pre - the natural lube allowing you to weather the relentless thrust, though you still can't help but groan at the sensation he puts you through. 'Sorry. Couldn't resist,' the young man says in an apologetic tone of voice, pausing for you to get used to the girthy invader stretching your back passage. A little while later, he pulls his hips back, leaving a rather empty feeling inside you as the hot, soft but yet rock-hard piece of man-meat slides out of you more and more. Finally nothing more than the cock-head is inside of you and he lightly pulls against your pucker from the inside with its flared rim - followed by a sudden yank that leaves your back door gaping with a wet slurp.";
		WaitLineBreak;
		say "     Under his breath, Chris says, 'Fuck that's hot,' staring down at the ring muscle staying stretched wide for a few seconds, then clenching together before it reflexively opens again in a 'wink' and a few more another after that. You still haven't got yourself fully under control again when Chris's restraint wanes and he slides his cock back into you, starting to fuck your ass hard and with untamed intensity. As the big orc cock plunges in and out of you in a rapid tempo, your own own shaft gets fully erect in short notice, and just like Chris is leaking precum into your insides, stimulating you even more, you see a string of fluid oozing out of your own cock-head, drawing a sticky string between your abs and the tip of your shaft. Man, being plowed by an orcish hunk sure got you going!";
		say "     Meanwhile, Chris winds himself up more and more, reveling in the sensations of a tight hole around his oversized shaft. His grunts and bellows get more and more intense, and before much longer he grips your thighs with both hands, holding on tight so you don't slide back as he pounds your ass. 'Nnngh - I'm gonna breed you good,' you can hear from him, and feel thrust after thrust as his crotch hits your ass. Then he goes wild - pounding your butt with his crotch back and forth, the slapping noises of flesh on flesh echoing through the library. It doesn't take much longer before your orcish partner reaches the point of no return and bellows in lust, grinding his hips down as gush after gush of potent orc cum splashes into your depths. You can feel a pleasant warm buzz filling you as the orc warrior's seed gets absorbed by your body, prompting you to loudly moan and push your rear against him hard.";
		WaitLineBreak;
		say "     'Yeah, that's it baby,' Chris groans to you, leaning forward as his cock keeps spurting, seeking your lips for him to kiss. He grunts in rhythm with further cumshots as he makes out with you. Feeling his dick pulsing inside you, his arms wrapped around your body in a nice and comfortable way, it takes but a moment longer before your own orgasm hits hard [if player is male]and a heavy load sprays all over your front, splattering you with cum[else if player is female]and your pussy starts to squirt femcum, soaking his crotch and running down to soak the sofa underneath you[end if].[mimpregchance]";
		say "     Your mutual climaxes rock though the two of you, only slowly ebbing off as Chris still humps against you in a determined pace, but even though both of you wish to just keep going, eventually things run out of steam and you quiet down, only panting hanging in the air for a moment. 'Damn, that was amazing,' Chris says with obvious affection in his voice, then adds, 'I wanna fuck you again - and soon.' He gives another little thrust of his hips against your rear, then licks the side of your neck and nibbles on you, his tusks lightly nipping your skin. Between the orc's amorous advances, a big load of his potent cum inside your ass and his hands stroking and groping your body, you barley have time to really think - your mind lost in a lustful haze. But then, why not just enjoy the moment and let your problems melt away for now...";
		if bodyname of player is "Orc Breeder" and player is pure and player is not mpreg_ok:
			LineBreak;
			say "     You feel something change deep inside you, as all the cum Chris blasted into you with completes your transformation to a real orc breeder. You'll now be able to be impregnated through anal sex. The [']MPreg['] feat has been added to your list.";
			add "MPreg" to feats of player;
	else if libido of Chris is 1:
		setmonster "Orc Breeder";
		say "     <placeholder for sub Chris on player anal>";
	else if libido of Chris is 2:
		setmonster "Orc Warrior";
		say "     Walking up to Chris, you tell him that you'd love to have some fun with him and give the young orc's crotch a pretty obvious stare. 'All right! Now we're talking,' the green-skinned hunk grunts and gives you a lewd grin around his sharp tusks, then undoes the button of his shorts and shoves them down, then pulling his shirt off. Now proudly standing before you in the buff, the young orc chuckles as you can't help but let your gaze wander over his broad-shouldered chest, firm muscles and the thick, green prick dangling between his legs. Chris's manhood twitches and grows harder by the second, filling out as he postures for a short while, showing off his muscled bulk and reaching down to cup his full and heavy balls suggestively, his thumb resting on the rising pole of his erection.";
		say "     'Hah, you sure you can even take all this?!' he grunts in youthful bravado - supported by his powerful physique and the quite thick shaft he wags in your direction. As you nod, the orc draws you against his chest in a one-armed hug and brings his mouth against yours in a forceful kiss. The sides of his tusks press against your face tightly as Chris tongue explores your mouth and a large hand gropes your ass. With little patience to wait before plunging his prick into you, the green-skinned teen pulls your gear and clothes off with strong, urgent moves, then hefts you up over his shoulder and carries you to his mattress. You're lowered, then dropped on Chris's bedding, doing a face-plant into crumpled sheets that smell enticingly of the young orc's manly musk, then your hips are pulled up by his strong hands and you can feel the hot shaft of his cock press against your ass-crack.";
		WaitLineBreak;
		say "     'I'm gonna fuck you till you can't sit straight,' the orc chuckles, giving your ass a stinging slap, then lines up his erection with your pucker. 'You want it bad, don't you?' Chris teases and nudges your pucker with his cock-head, then takes hold of the base of his cock, smacking it between your buttocks a few times. Your moan at feeling him - almost - penetrate, then pull back, is all the answer he needs. A heartbeat later, Chris plunges his thick shaft into you for real, driving more than half its length inside with a guttural grunt, then pushing further until his balls soon press against your ass. His rough entry technique makes you really glad that the green-skinned brute's cock-head leaked quite a bit of pre-cum when he toyed with you earlier - the natural lube allowing you to weather the relentless thrust, though you still can't help but shout and whimper at the sensations he puts you through, face pressed into the mattress.";
		say "     Grunting in satisfaction, the young orc grinds his cock into you some more, both his hands gripping your butt-cheeks and groping them harshly. Then he pulls his hips back, leaving an... empty... feeling inside you as the hot, soft but yet rock-hard piece of man-meat slides out of you more and more. Finally nothing more than the cock-head is inside of you and he lightly pulls against your pucker from the inside with its flared rim - followed by a hard yank that leaves your back door gaping with a wet slurp. Chris chuckles deeply as he looks down at the ring muscle stay stretched wide for a few seconds, then clench together and reflexively open again. You still haven't got yourself fully under control again when Chris's patience wanes and he hammers his cock back into you, starting to fuck your ass hard and with untamed intensity.";
		WaitLineBreak;
		say "     As the big orc cock plunges in and out of you in a rapid tempo, your own own shaft gets fully erect in short notice, and just like Chris is leaking precum into your insides, stimulating you even more, you see a string of fluid oozing out of your own cock-head, creating a wet spot on the mattress. Man, being plowed by an orcish hunk sure got you going. Meanwhile, Chris winds himself up more and more, reveling in the sensations of a tight hole around his oversized shaft. His grunts and bellows get more and more intense, and before much longer he grips your hip with one hand, the other one pushing on your back to keep you down. 'I'm gonna breed you like a good little slut,' you can hear from him, and feel the warmth of Chris breath against your back as he leans forward and pushes his crotch against your ass.";
		say "     Then he goes wild - pounding your butt with his crotch going up and down, the slapping noises of flesh on flesh echoing through the library. It doesn't take much longer before your orcish partner reaches the point of no return and bellows in lust, grinding his hips down as gush after gush of potent orc cum splashes into your depths. You can feel a pleasant warm buzz filling you as the orc warrior's seed gets absorbed by your body, prompting you to loudly moan and push your rear against him hard. 'Yeah, that's it baby,' Chris groans to you, his hot breath against your neck as he shudders and grunts with each new blast into you. Feeling him pulsing inside and on top of you, his arms gripping your body in a very possessive way, it takes but a moment longer before your own orgasm hits hard [if player is male]and a heavy load sprays all over the mattress below, adding another cum-stain to Chris's bedding[else if player is female]and your pussy starts to squirt femcum all over the mattress below, adding another stain to Chris's bedding[else]and you shudder and tremble in pleasure, digging your hands into the blanket below[end if].[mimpregchance]";
		WaitLineBreak;
		say "     Your mutual climaxes rock though the two of you, only slowly ebbing off as Chris still humps against you in a determined pace, but even though both of you wish to just keep going, eventually things run out of steam and you quiet down, only panting hanging in the air for a moment. 'Oh yeah,' Chris says with a chuckle in his voice, then adds, 'I knew you'd want to be my little breeder. So eager to take a real orc's dick. I'll keep fucking you until you're knocked up. You'd want that, isn't that right?' He gives a little thrust of his hips against your rear as you open your mouth to answer, then licks the side of your neck and nibbles on you, his tusks lightly nipping your skin.";
		say "     Between the orc's somewhat rough amorous advances, a big load of his potent cum inside your ass and his hands stroking and groping your body, you barley have time to really think - about the offer of being his breeder, giving yourself to the strong, young orc -or anything really. The only thing you manage to get out is a vaguely assenting groan, which Chris answers with a satisfied grunt, then proceeds to pinch your nipples and gives you a love-bite on the bend of your neck. The two of you spend some more time in intimate closeness on the mattress, then the orc warrior eventually pushes himself up, giving your ass a last grope before standing up and looking around for his clothes. 'All the fun made me hungry. I'll go out and grab a bite,' he says in the effortless confidence that nothing he could meet would be dangerous for an orc. Then Chris walks down the stairs after giving your still naked form a very satisfied once-over.";
		infect "Orc Breeder";
		if bodyname of player is "Orc Breeder" and player is pure and player is not mpreg_ok:
			LineBreak;
			say "     You feel something change deep inside you, as all the cum Chris blasted into you with completes your transformation to a real orc breeder. You'll now be able to be impregnated through anal sex. The [']MPreg['] feat has been added to your list.";
			add "MPreg" to feats of player;
		increase WarriorChrisPlayerFucked by 1;

to say ChrisSex5: [milk cum out of Chris]
	if libido of Chris is 0: [half-orc base state]
		say "     Walking up to Chris, you tell him that you want his cum. The young orc grins as he follows your gaze, putting a large hand on the bulge in his shorts and rubbing his cock through the fabric. 'Sure, I'm down for anything,' he says with an enticing wink, then shoves his shorts halfway down his muscular legs and kicks them off a moment later. As his thick green shaft is freed from being trapped in the tight garment, it swings up and slaps against his abs with a meaty thud. This orc teen really takes after his dad, with a weighty shaft to match! Chris's manhood twitches and grows harder by the second, filling out as he postures for a short while, showing off his toned body and reaching down to cup his full and heavy balls suggestively, his thumb resting on the rising pole of his erection.";
		say "     'So, how do you wanna do this?' the young man asks in a lusty tone and swings his shaft up and down a little. The enticing sight tempts you to just kneel and suck him, but no... you have other plans. As you pull out the small plastic bottle you prepared for this, Chris draws one of his eyebrows up and gives a little chuckle. 'Oho, so that's how it is. What are you gonna do with that? Start a business making orc milkshakes? That'd be awesome, actually...' The green-skinned teenager grins broadly as he steps up to you and puts a hand on your shoulder, giving it a friendly squeeze. Then he goes on to say, 'I'm game, you can count on me as your private nut-milk supplier!' And with that, the young man puts his hand on the shaft of his cock and starts to stroke up and down along its length.";
		WaitLineBreak;
		say "     You feast your eyes on the teenage orc as he jerks himself off - slowly, with some posing and suggestive glances being thrown your way. Soon, you can't resist stepping forward and touching him, running your hands along the muscled sides of the green-skinned young man. 'I could definitively get used to getting employee benefits like this,' Chris adds with a chuckle, playing on the story he's laid out for what you're doing. 'You know, there is a way you can... boost production a bit,' he says next, then takes your free hand and guides it to his crotch, brushing his balls against it. Taking the hint, you start to fondle the half-orc's balls, gently rolling the weighty orbs between your fingers and increasing his pleasure quite a bit.";
		say "     Chris keeps moaning and grunting in lust, his arousal soaring from his own jerking and your talented stimulation, murmuring things like 'Fuck yeah that feels good', 'Gonna fill that whole bottle' and 'So eager for some nut-milk, hah'. Soon, the randy orc goes on to slide a hand behind your head and pulls you in for a hungry kiss, tongue-wrestling you while he still strokes his cock. When he eventually pulls back from making out, Chris grunts in some urgency, 'Getting kinda close.' Eager to capture the essence of his virile manhood, you position your bottle at the head of his dick. Thankfully, you chose a container with a quite wide opening at the top, so it isn't too hard to keep it cupping his cum-slit, even as his dick jostles a bit from the jerking and his movements.";
		WaitLineBreak;
		say "     'Fuuuckkkk! Gonna cum!' Chris suddenly bellows and you can feel his big balls throb in your grasp. With a deep grunt from the young orc, the first spurt of cum erupts into the bottle, hitting the end with a little thud. Then another and another blast of his rich, creamy cum gushes forth and you can see before your very eyes how he fills the bottle, cum-shot by cum-shot. The green-skinned hunk's output is actually too much to be contained by the bottle, eventually gushing out of its open top as the next heavy spurt churns the seed already inside to a froth. Hastily, you let go of his balls and pull the lid from your pocket, then pull the bottle away after another splurge and cap it. Somehow the milky white content of the bottle look incredibly tasty to you right now. Must be the aroma of orc cum that wafts heavy into your nose...";
		say "     Meanwhile, Chris covers the tip of his shaft with his other hand, catching spurt after spurt of the surplus on his palm. His orgasm is ebbing off, but it still is a respectable amount of the rich white cream and creates an interesting contrast to his green skin. 'Guess you'll need to get a bigger bottle next time,' he says with a chuckle and raises his hand to look at the cum, then runs two fingers through it, playfully trying out how it stretches into goopy lines between his digits. 'Smells pretty nice,' he remarks and you can see him hesitate, apparently thinking about licking it off. Then he shakes his head and murmurs, 'Nah, I promised daddy Val.'";
		say "     [bold type]Seems like Chris is following his father's request not to taste orc cum - not even his own. Though what should he do with his sticky fingers now?[roman type][line break]";
		LineBreak;
		say "     ([link]Y[as]y[end link]) - Hand him a tissue. You should have some somewhere...";
		say "     ([link]N[as]n[end link]) - Pull his hand to your mouth and lick it clean.";
		if player consents:
			LineBreak;
			say "     Digging around in your pocket, you manage to find a tissue and hand it to the young orc, who gladly accepts it and wipes off his cum. 'Thanks,' he says with a grin, 'That was fun. You can count that as my application for the milkshake-bar job.' Tapping the side of your plastic bottle full of cum, the green-skinned teen gives you a wink, then walks a few steps to where he kicked his shorts earlier and bends over to pick them up - intentionally posing to show off his ass as he does so.";
		else:
			LineBreak;
			say "     Stroking your fingers up the young orc's arm, you gently pull it over towards you, then open your mouth to lick at his fingers. Chris gives a pleased grunt as you soon go on to take his fingers into your mouth, suckling on them to get every last drop of his cum. Then you go on to slurp the rest off his palm, licking it clean as well. The stuff is really tasty, after all. As you let him have back his hand, Chris grins and says, 'Thanks, that was fun. You can count that as my application for the milkshake-bar job.' Tapping the side of your plastic bottle full of cum, the green-skinned teen gives you a wink, then walks a few steps to where he kicked his shorts earlier and bends over to pick them up - intentionally posing to show off his ass as he does so.";
	else if libido of Chris is 1: [breeder Chris]
		say "     Walking up to Chris, you tell him that you'd love to have some fun with him, giving a little nod to his crotch as you do. The young orc smiles at you worshipfully for a moment, then shakes that off and follows your gaze, giving a happy little sigh as he realizes you want his cock. 'I - oh wow, of course master!' he says eagerly, then shoves his shorts halfway down his muscular legs in his eagerness to please you any way he can. Kicking off the garment, your orc breeder stands naked in front of you an eye-blink later. Despite having become more slender and 'pretty' as an orc slut, his cock still takes after his dead quite obviously, the weighty shaft standing proudly erect. Running a hand down his muscular front, you stroke over his cock and draw a pleased sigh from the orc, then order him to jerk off for you.";
		say "     'Oooh yes!' Chris sighs in pleasure and wraps his fingers around his dick. You feast your eyes on the teenage orc as he jerks himself off - slowly, with some posing and enticing glances being thrown your way. Soon, you can't resist stepping forward and touching him some more, running your hands along the muscled sides of the green-skinned young man. 'Mmmmhh,' the submissive orc breeder moans out loud and leans into your touch, enjoying being caressed by his master. Moving on to cupping his balls, you gently roll the weighty orbs between your fingers and increase his pleasure quite a bit. Chris keeps moaning and grunting in lust, his arousal soaring from his own jerking and your talented stimulation, murmuring things like 'Oh yes. Thank you', 'This feels amazing' and 'I'm going to cum so much for you'.";
		WaitLineBreak;
		say "     The horny orc is downright cute in his eagerness to serve, enticing you to pull his head over to yours and giving him a hungry kiss. Tongue-wrestling Chris, you enjoy his company while he still strokes his own cock. You're still making out when he eventually taps your shoulder lightly to get your attention, then moans in some urgency, 'Getting kinda close now.' Eager to capture the essence of his virile manhood, you position your bottle at the head of his dick. Thankfully, you chose a container with a quite wide opening at the top, so it isn't too hard to keep it cupping his cum-slit, even as his dick jostles a bit from the jerking and his movements. 'Nnnghhh! Gonna cum!' Chris suddenly calls out and you can feel his balls throb in your grasp.";
		say "     With a deep grunt from the young orc, the first spurt of cum erupts into the bottle, hitting the end with a little thud. Then another and another blast of his rich, creamy cum gushes forth and you can see before your very eyes how he fills the bottle, cum-shot by cum-shot. The green-skinned hunk's output is actually too much to be contained by the bottle, eventually gushing out of its open top as the next heavy spurt churns the seed already inside to a froth. Hastily, you let go of his balls and pull the lid from your pocket, then pull the bottle away after another splurge and cap it. Somehow the milky white content of the bottle look incredibly tasty to you right now. Must be the aroma of orc cum that wafts heavy into your nose...";
		WaitLineBreak;
		say "     Meanwhile, Chris covers the tip of his shaft with his other hand, catching spurt after spurt of the surplus on his palm. His orgasm is ebbing off, but it still is a respectable amount of the rich white cream and creates an interesting contrast to his green skin. 'Guess we need a bigger bottle next time,' he says a little apologetic, then raises his hand to look at the cum before licking it off his palm hungrily. By the time he is done cat-washing every last drop of cum from his hand, you've packed away the bottle, not wanting to tempt him with it. 'Thank you master. That was fun,' the orc breeder tells you in a pleasant tone, then waits to be dismissed before he walks a few steps to where he kicked his shorts earlier. With a seductive glance over his shoulder, he bends over to pick them up - intentionally posing to show off his ass as he does so.";
	else if libido of Chris is 2:
		say "     Walking up to Chris, you tell him that you want his cum and nod down to the young orc's crotch. 'All right! Now we're talking,' the green-skinned hunk grunts and gives you a lewd grin around his sharp tusks, then undoes the button of his shorts and shoves them down, then pulling his shirt off. Now proudly standing before you in the buff, the young orc chuckles as you can't help but let your gaze wander over his broad-shouldered chest, firm muscles and the thick, green prick dangling between his legs. Chris's manhood twitches and grows harder by the second, filling out as he postures for a short while, showing off his muscled bulk and reaching down to cup his full and heavy balls suggestively, his thumb resting on the rising pole of his erection.";
		say "     'Go on then, get sucking!' the young brute tells you in a firm tone and swings his shaft up and down a little, eager for you to slide your lips over it. It is tempting to do just that, but... you have other plans. As you pull out the small plastic bottle you prepared for this, Chris's eyebrows draw together in puzzlement. 'Huh? What's that for? It's empty and... oooh! Now I get it!' His surprise swings over into amusement and the green-skinned teenager grins broadly as he steps up to you and puts a hand on your shoulder. Giving it a squeeze, Chris goes on to say, 'Can't resist a true orc's cock, eh? You need some of the good stuff even when you're out and about to tide you over. Yeah, I just know it!'";
		WaitLineBreak;
		say "     Reaching down to take your hand, Chris pulls it to his crotch and places it on his thick and meaty shaft. 'Show me how much you want it,' comes a gruff command to follow up with and he grunts in arousal as you begin to stroke his cock. 'Yeah, jerk that dick! Faster!' he adds with a moan, thrusting his hips forward a little and bumping your gripping hand with his crotch. Chris readily allows you to jerk him off, enjoying the service a great deal. He keeps moaning and grunting in lust, murmuring things like 'Take care of your master', 'I knew you were a breeder at heart' and 'So eager for some nut-milk, hah'. Soon, the randy orc goes on to slide a hand behind your head and pulls you in for a demanding kiss, man-handling you while you still caress his cock.";
		say "     'Getting kinda close,' Chris eventually grunts out loud and starts humping against your hand again. Eager to capture the essence of his virile manhood, you position your bottle at the head of his dick. Thankfully, you chose a container with a quite wide opening at the top, so it isn't too hard to keep it cupping his cum-slit, even as his dick jostles a bit from the jerking and his movements. 'Fuuuckkkk! Take it, cum-slut!' Chris suddenly bellows and you can feel his big cock throb hard in your grasp. With a deep grunt from the young orc, the first spurt of cum erupts into the bottle, hitting the end with a little thud. Then another and another blast of his rich, creamy cum gushes forth and you can see before your very eyes how he fills the bottle, cum-shot by cum-shot.";
		WaitLineBreak;
		say "     The green-skinned brute's output is actually too much to be contained by the bottle, eventually gushing out of its open top as the next heavy spurt churns the seed already inside to a froth. Hastily, you let go of his cock and pull the lid from your pocket, then pull the bottle away after another splurge and cap it. Somehow the milky white content of the bottle look incredibly tasty to you right now. Must be the aroma of orc cum that wafts heavy into your nose. Then suddenly, the almost time-stopped moment of you staring down at the bottle in your hand is broken - by a fresh cum-shot hitting you in the face. Looking up, you realize that Chris is holding his prick, aiming it right at you as he chuckles and grunts with every further spurt.";
		say "     'Get a bigger bottle next time,' the orc teen says in an amused tone as he cums on your face, creaming you good with the ebbing-off orgasm. 'Or better yet - don't. I like that look on you,' he adds after a second or two, placing a large hand on your face to rub in the cum. Swiping up some, he playfully lets it stretch goopy lines between his fingers, then pushes the sticky digits into your mouth to be licked clean. 'Yeah, be the cum-slut that you deserve to be,' he grunts in satisfaction, amused about how eagerly you suck on his fingers. Then the teenage orc adds, 'Think of me when you drink this,' patting the bottle in your hands, then walking off to throw himself onto his sofa to rest. You're left behind, somewhat sticky and hungry for more. For a moment, you want to just chug the bottle right now, but manage to push down the instinct and pack it away instead.";
	increase carried of orc cum by 1;

instead of navigating Grey Abbey Library while (libido of Chris is 2 and Chris is in Sitting Area and Dexterity of Chris is 0):
	say "[NavCheck Grey Abbey Library]";
	if NavCheckReturn is false, stop the action;
	move player to Grey Abbey Library;
	if debugactive is 1:
		say "     DEBUG: CHRIS ZEBRA BUTTFUCK WALKIN - DEXTERITY OF CHRIS: [Dexterity of Eric][line break]";
	say "     Coming back into the library, you hear a commotion somewhere upstairs, on the second floor of the library. Then a panicky sounding male voice shouts, 'No, please! Don't... I - I'll blow you again. Just not... that.' The only reply is a deep-voiced chuckle, followed by a noise that makes you think of a thick, hard cock being slapped against an open palm. Running footsteps are next, the stomp of hooves on the upstairs floor, then the person responsible comes into sight - a panting anthro zebra who half-falls against, half-catches himself on the upper floor railing. He must have stumbled in his rush for the stairs, missing the curve after running out between the bookshelves up there.";
	say "     Bent forward over the railing, hands clutching it tightly as not to go over - and also in the reflexive intensity of his desperation, the zebra stares down right at you, panting hard. You can see that the fur on his face and his mane is matted in sweat - and another fluid, sticky and white, showing in long splashes. A second or two stretch and stretch as he blinks away the terror in his eyes, then really focuses, giving you a pleading look as he shouts, 'Help me! He's...' Right behind the zebra, as it turns out. The muscled green shape of Chris steps into view, and one strong arm of the young orc warrior wraps around the striped equine's chest from behind. Drawing the struggling male against his broad chest, Chris holds him firmly and says with a chuckle, 'Don't run from me, pony. We've got so much fun to have yet!'";
	LineBreak;
	say "     Do you want to go upstairs and... deal with the matter (in one way or another) ([link]Y[as]y[end link]), or do you just turn your attention to other things, leaving Chris and his captive alone ([link]N[as]n[end link]).";
	if player consents:
		LineBreak;
		say "     Taking the steps two at a time, you hurry upstairs and soon come to stand near Chris and his captive. They're both completely naked, with the orc teen looking very buff and big next to the still muscled but somewhat more lithe form of the equine in his arms. The zebra glances over to you and whimpers as Chris grinds his hard shaft between his butt-cheeks, grunting lustily at the feeling of soft fur against his member. The striped captive's shaft is hard too, firmly erect and leaving little smears of precum against the panels of the railing he stands against - no doubt a result of the aphrodisiac-laden orc cum he's obviously been fed before. 'Hey there,' Chris grunts in greeting and nods to you, then adds, 'Wanna watch me break in this pony? Caught him near the zoo and just had some fun with that sweet mouth of his. Long muzzles are soo good for blowjobs, hah.'";
		say "     With a grin on his face, the orc strokes a big hand over his captive's muzzle, wiping off some of the cum still sticking in the zebra's fur. Then he holds his hand in front of the equine's mouth and grunts, 'Lick it off, breeder.' The zebra frowns a little, but you can see his nostrils flare wide as he takes in the scent of the offered orc cum, then can't control himself and goes for it, hungrily lapping up Chris's seed and the salt off his skin. 'Good pony,' Chris chuckles, then adds, 'Hm - what's your name anyway?' Swallowing orcish cum, the zebra whinnys a little, then shakes his head as if he can't believe he just did that. 'I - I'm called Kai,' comes a halting reply, followed by, 'Look, please - I did what you wanted, gave you a blowjob. Even though I'm not... gay. You can't fuck me! That thing is massive, it'll rip me apart!'";
		WaitLineBreak;
		say "     Looking at their comparative sizes, with Chris about half a foot taller and much more muscled, you have to admit that you did see a lot bigger size difference turn out okay in your time since this all started. After all, there's a lot of sex going on out on the streets. Still, Kai will likely be sore if Chris isn't careful about wedging that prick into him. No matter what, the horny orc isn't deterred one bit by Kai's protests, and you can see him brush off another creamy glob of pre out of the zebra's mane, then bring his fingers down to the anthro equine's butt, rubbing them over his pucker.";
		LineBreak;
		say "     ([link]N[as]n[end link])?";
		say "     [bold type]Do you watch Chris fuck Kai, or will you pull the zebra out of Chris's grip and set him free[roman type][line break]";
		LineBreak;
		say "     ([link]Y[as]y[end link]) - Watch.";
		say "     ([link]N[as]n[end link]) - Set the zebra free.";
		if player consents:
			LineBreak;
			say "     As you lean against the railing in a comfortable position to watch the show, you try to calm Kai a bit saying that he shouldn't worry and Chris sill be gentle. The young orc gives you a cheeky grin and adds with a slight snort, 'Sure I will. Totally.' And with that, he leans over the zebra and licks the side of his neck, then tells him in a husky tone, 'You'll love it, no doubt about it. Remember how you didn't wanna blow me at first either. That didn't turn out as bad as you thought, eh?' Kai hesitates a moment, subconsciously licking his lips, and then the time to speak is over for good, as Chris pushes his cum-slick fingers against his pucker, slipping the tip of a thick digit in. A loud gasp echoes through the library as Kai's rear entrance is penetrated for the first time - the novel sensation made even more intense by Chris's orc cum being used as lube and now being absorbed into the zebra's body.";
			say "     'Unnnggghh!' Kai shouted in surprised arousal as Chris soon found what he was looking for - the equine male's prostate, sending out waves of pleasure at being rubbed. The orc fingers his captive for a while, driving the anthro male to levels of arousal he'd never thought possible from having something up his butt. Soon, he's even sliding his ass backwards to meet Chris thrusting digits and take him deeper, which makes the orc's grin grow wider and wider. 'So then, pony-boy - what do you say now?' he says in a half-mocking tone, giving Kai's cheeks a light slap and pulling his fingers out with a single quick movement. 'Gah!' the zebra gasps and rocks his body backwards, his pucker clenching and un-clenching as if wanting to grip Chris at any opportunity. 'I feel so... empty. Put em back in! Please, oooohhh, I need it!'";
			WaitLineBreak;
			say "     Chris gives you a cocky smile, one hand on his thick shaft and whacking it against the palm of his other. 'If you insist, breeder-boy...' And with that, he aims his erection right at Kai's rear entrance, then thrusts forward with a guttural grunt. The shout of two voices that fills the library as Chris penetrates combines satisfaction and a bit of pain - but above all lust, as Kai's hole was prepared for the orc's cock, even though he himself wasn't, and grips this new intruder with an eager energy. It is good that Chris did spend the time to finger Kai earlier and used some orc cum on him, as the natural lube now allows the zebra to weather such a rough entrance - but he can't help but shout and whimper nonetheless.";
			say "     Grunting in satisfaction, the young orc grinds his cock into his captive some more, both his hands gripping the zebra's furred butt-cheeks and groping them harshly. Then he pulls his hips back further and further, leaving his playmate feeling empty again as the hot, soft but yet rock-hard piece of man-meat slides out of his ass. Finally nothing more than the cock-head is inside of Kai and Chris lightly pulls against his pucker from the inside with its flared rim - followed by a hard yank that leaves Kai's back door gaping with a wet slurp. Chris chuckles deeply as he looks down at the ring muscle stay stretched wide for a few seconds, then clench together and reflexively open again. Kai has barely started whimpering and moaning at the sudden retraction of the hard cock that has been giving him such pleasure, when Chris hammers his cock back into him, starting to fuck the striped ass hard and with untamed intensity.";
			WaitLineBreak;
			say "     As the big orc cock plunges in and out of Kai in a rapid tempo, the zebra's equine hard shaft flops around, bumping against the railing panels and sometimes wagging back and forth at it dangles between his legs - and all that while Kai's overstimulated body sends a steady stream of pre oozing out of his cock-head, meaning that his cock rubs a growing wet splotch on the panels, and splashes of the zebra's pre get flung left and right too. Man, being plowed by this orcish hunk sure got Kai going. Meanwhile, Chris winds himself up more and more, reveling in the sensations of a tight hole around his oversized shaft. His grunts and bellows get more and more intense, and before much longer he grips around Kai's hips with one arm, holding him tight, the other one pulling the zebra's head to the side so Chris can give him a hungry kiss. As their lips part again, you can hear him pant out, 'I'm gonna breed you like a good little slut!'";
			say "     Then he goes wild - pounding Kai's butt so hard the zebra is pushed against the railing and the slapping noises of flesh on flesh echo through the library. It doesn't take much longer before the young orc reaches the point of no return and bellows in lust, grinding his hips forward as gush after gush of potent orc cum splashes into Kai's depths. A blissful look spreads on the zebra's face as an orc warrior's seed gets absorbed by his body, prompting him to loudly moan and push his rear against Chris. 'Yeah, that's it baby,' Chris groans to him, his hot breath against his captive's neck as he shudders and grunts with each new blast into him. Feeling his new master pulsing inside the innermost depths of his body and having the big orc's arms around him in a very possessive way, it takes but a moment longer before Kai's own orgasm hits hard, and a heavy load sprays out of his equine shaft, still pressed tight against the railing panel in front of him. The white deluge of cum the zebra's balls produce splatters down over the panel like a waterfall and ends up as a large white-puddle on the floor, where it starts to leak over the edge and drip into the library below.";
			WaitLineBreak;
			say "     Their mutual climaxes rock though the two of them, only slowly ebbing off as Chris still humps against Kai in a determined pace. But even though they're now both quite into having sex with each other, eventually things run out of steam and they quiet down, only panting hanging in the air for a moment. 'Oh yeah,' Chris says with a chuckle in his voice, then adds, 'I knew you'd want to be my little breeder pony. Now you're eager to take a real orc's dick, right Kai?' He gives a little thrust of his hips against Kai's rear as the zebra opens his mouth to answer, then licks the side of his play-mate's neck and nibbles on him, his tusks lightly nipping Kai's skin.";
			say "     Between the orc's somewhat rough amorous advances, a big load of his potent cum inside his ass and Chris's hands stroking and groping Kai's body, the zebra is pretty blissed out and overwhelmed by it all. And then, things go even further and change his life forever, as the transformative effects of his creamy filling kick in. Throwing his head back, Kai gasps loudly as his muzzle shifts a little, and with his open mouth you see four tusks form, two long and two shorter fangs showing clearly that this zebra no longer is a herbivore. The rest of his long muzzle his transformed just a blink later, and quite a few more sharp teeth present themselves. As he snaps his mouth shut and starts running his tongue over the new teeth, Kai goes a little green in the face, then a lot, as a wave of emerald color starts to replace all the white parts of his striped pattern. With that, the external changes come to a halt.";
			WaitLineBreak;
			say "     'Hah, now you're a proper orc pony. To be ridden hard by my cock!' Chris grunts as he inspects Kai's new form, then pulls his cock out of the transformed zebra with a slurp. The young orc turns his new breeder with a pull on his arm, then pulls Kai into an eager kiss, during which they playfully rub tusks. 'Wow... that was... wow,' Kai gasps out as their lips part again, then he looks down over his black and green stripes and raises a hand to feel his sharp fangs. 'Er... what exactly am I now?' he asks and looks up into Chris eyes. The only answer he gets from Chris is 'Mine', then the young orc claps his zebra breeder on the shoulder and says, 'Come on, fucking you made me hungry - let's go grab a bite to eat.' With a sly grin to you, Chris guides his companion down the stairs and the two of them walk outside.";
		else:
			LineBreak;
			say "     Telling Chris he had his fun, you step up and start prying on his muscle-packed arm off the zebra. There is a short moment of resistance, then the young orc gives an annoyed grunt and lets go. 'Fine, but only because it's your place I'm staying at right now. If I you again out in the city Kai, your ass is mine!' And with that, the green-skinned brute turns away, stalking down a path between two bookshelves, no doubt on the way to his bedding.";
			say "     With a relieved sigh, Kai babbles to you, 'THANKYOU! Thankyou! Thank you. I don't think I could have taken... you know, his thing. Could barely get my mouth around it and he wants to stick that monster up my ass?!' Sounds like he's rather buzzed by his orc cum drink earlier, but one thing is for sure - you got a very thankful and relieved zebra on your hands. He gladly lets himself be led downstairs, then out of the library, and after walking with him for a block or two, he thanks you again, then sprints off in the direction of the zoo.";
	else:
		LineBreak;
		say "     Answering the zebra's pleading look with a shrug, you look away and walk over to the librarian's desk, from where there isn't a line of sight to that section of the upper floor railing. About time you sorted out your backpack a bit anyways, the better to find your stuff if you need it in a hurry. The gasps and sounds of rough fucking from above you just tune out, as you're used to by now from out on the streets.";
	now Dexterity of Chris is 1;

instead of going up from Grey Abbey Library while (Chris is in Sitting Area and libido of Chris is 2 and WarriorChrisPlayerFucked > 2 and WarriorChrisDominance is 0 and (lastfuck of Chris - turns) > 12):
	move player to Sitting Area;
	if debugactive is 1:
		say "     DEBUG: Chris dominance scene; libido of Chris: [libido of Chris], WarriorChrisDominance: [WarriorChrisDominance], WarriorChrisPlayerFucked: [WarriorChrisPlayerFucked][line break]";
	say "     Coming up the library stairs, you find your gaze almost inevitably drawn over to the sofa Chris likes to hang out on - and before you know it, your feet follow suit and you're halfway over him already. With each step forward, the rippling muscles and masculine frame of the orc draw more and more of your attention. He really is quite a sight, with the typical and powerful body of an orc warrior now that has you biting your lip as you feast your eyes on him. Dimly, you remember the heartfelt request of Chris's orc breeder parent Val who told you to keep his kid away from the orc lifestyle. Somehow you're glad that you didn't - he looks so awe-inspiringly masculine now that you almost feel ready to just fall to your knees and muscle-worship him.";
	say "     The broad-shouldered young orc notices you coming towards him and gives you a lustful glare, one hand lowering to his hips to rub a growing bulge in his pants. Something about his demeanor makes you begin second-guessing coming to him like this. He seems to have grown more dominant since when you first met him, though that's likely from transforming him into an orc warrior. His lustful gaze continues to follow you and the orc licks his lips hungrily as you come to a stop before him. 'Back for some more?' he says, finally snapping out of it and looking at your face and not just your body. The look before reminded you of how a predator looks at his prey before devouring it. You ask him what he means. 'You know what,' he replies, apparently quite annoyed by the question. Chris's normally cheery expression turns serious as he stares at you, waiting for an answer. A few moments pass by with him getting more and more impatient at, then he finally says, 'Did you come up here to take my cock or not? I wanna get off in someone nice and tight.'";
	say "     [bold type]The sudden spike in aggression catches you off guard and you hesitate before you reply...[roman type][line break]";
	LineBreak;
	say "     ([link]Y[as]y[end link]) - That you want to have sex with him.";
	say "     ([link]N[as]n[end link]) - That you only came over to chat.";
	if player consents: [submit]
		LineBreak;
		say "     You stutter a little before finally telling him that you really did come to have sex with him. Your compliance quickly improves the orc's mood, drawing his mouth into a smile that shows off his sharp tusks. The frustrated expression becomes a lustful one, though you aren't sure that it's any better. Before you have time to start removing your gear he pulls you towards him and strips you down with little care of leaving your clothing intact. After losing a few buttons and a tear or two in the fabric, you're soon naked - and are then grabbed by the arm and pulled along as Chris goes outside. Before you know it you are standing on the open street in front of the library, in the nude next to the large orc.";
		say "     The slight breeze does you no favors as each small gust of wind sends a shiver up your spine. 'Follow,' Chris gives a barked command, beginning to stroll along the sidewalk. You follow closely not wanting to anger the suddenly sexually aggressive orc. It isn't long until you are led to an open street littered with trash and abandoned cars. You see several creatures scatter as they see your orc master, running away to not become the horny orc's next plaything. Others hide behind buildings and cars - wanting to keep their distance yet curious enough to watch what is about to happen next. Chris grabs a hold of your arm and guides you towards a small car that was left in the middle of the abandoned road. He then pushes you over the hood of the car with surprising gentleness - or maybe not so surprising, as you're letting him put you in the role of being 'his' breeder. Orcs aren't usually cruel masters, just demanding ones in sexual matters.";
		WaitLineBreak;
		say "     As your rear is exposed and Chris kneads your buttocks in obvious arousal, you some murmurs from the various kinds of creatures watching what's going on between the two of you. Soon, Chris removes his loincloth and begins stroking his thick cock - being sure to spit on it and rub any precum onto it. 'This should be enough lube for you,' he says in a horny grunt, then lines up his thick piece of meat with your waiting hole. 'I hope you like it rough.' That's the last thing he says before thrusting into you with little regard for your pleasure. You cry out in pain from his sudden penetration. Thankfully, the orc isn't too far gone in his lust that he ignores the complaint, instead pausing a little while to let you get accustomed to his thickness before pushing his way further into you.";
		say "     Soon, his balls rub against your ass as the large orc bottoms out and you can't help but let out a whorish moan at being filled as completely as you are. The murmurs from all the creatures watching have ebbed off by this point - but you think you can make out some fapping noises instead. Seems like they're enjoying the show! Meanwhile, Chris rests his thick dick in your ass for a little while. You can feel the beat of his heart in the throb of that massive dick against your inner walls. Then the orc runs his hands down your back before putting them on your hips to hold on tight. 'You won't be able to walk straight after this,' he says with a chuckle, 'Maybe one of these pathetic creatures watching might get to have my sloppy seconds.'";
		WaitLineBreak;
		say "     After winding you up with his rough teasing (Or is it? You're not sure anymore), Chris begins pulling his cock out to the tip and slams it back in again. His thrusts start out slow and steady as you moan beneath him. The young orc savors your moans for a short while before giving you a hard smack on the ass. 'I like it when my sluts are a bit more vocal. Moan for me breeder!' he growls, keeping up his slow paced fucking. Giving in to what your large partner wants, you let out loud sounds of your pleasure - which isn't hard at all, given how much you enjoy being taken like this. The orc's mighty cock starts leaking precum into your innermost depths before much longer, making you giddy and just a little cum-drunk on the effects of his orcish body fluids.";
		say "     Turned on even more than before, you moans grow ever louder and your imagination starts to bring up images of Chris breeding you again and again till you're swollen and pregnant-looking. Or maybe even actually carrying his son, given how orc reproduction works. Noticing very receptive state, Chris slams his cock deep inside of you and begins fucking you without holding back at all now. The slaps of his hefty sack against your ass begin to resound up and down the street, joined by grunts and barks and gasps as the watching crowd pleasure themselves - or possibly each other. Your orcish master's thick shaft rubs against your inner walls and nails your prostate again and again, fucking in and out of your sloppy hole. The car beneath you is rocking with each of his powerful thrusts.";
		WaitLineBreak;
		say "     Before much longer, Chris bellows, 'You ready for my load?' All you can do to reply his let out a loud moan. 'Good,' he says with a chuckle, then intensifies hammering into you even more. Each thrust inches him closer to orgasm you think to yourself, readying for the onslaught of cum that will surely come soon. The more you think about being bred by this powerful orc the more eager and needy you become. Soon, you are begging for him to fill you with his seed. This causes a few of the creatures watching to snicker - they clearly enjoy watching become the orcs needy slut. With one last powerful thrust Chris then buries his cock all the way inside of you and releases the first shot of his seed deep into your waiting bowels.";
		say "     With your insides being flooded by aphrodisiac-laden orcish seed that gets quickly absorbed, you lose control of yourself - twitching and shivering under the large male as your body rocks with an almost mind-breaking orgasm. [if player is male]Your own cock starts blasting out spurt after spurt of cum, painting the hood of the car in white streaks[else if player is female]Your pussy starts to gush with femcum, splashing on the side of the car and running down the inside of your legs[else]Your body tingles all over as you ride out the climax and pant without pause[end if]. The orc continues to pump you with his seed long after your orgasm ends. Once his countless spurts of cum subside eventually, he remains inside of you.[mimpregchance]";
		WaitLineBreak;
		say "     'A belly full of my seed just for you,' Chris pants, 'You better savor every second of it. Otherwise you won't get another.' After that he pulls his cock out of you. With a wet plop his tip escapes from your abused hole along with a small river of his cum. The orc pauses to take a look at the mess he made of you, then stands up straight and pulls you against his chest possessively. 'This is my breeder slut now! Hear that you fuckers and weaklings?! I bet not even half of you could even take my dick!' the young orc warrior bellows as he looks to the various creatures that have been masturbating to the show. Several of them start to look worried about maybe being next - which greatly amuses Chris. 'Yeah, you better be afraid - when I'm done training this one and knocking [if player is male]him[else if player is female]her[else]him[end if] up, I'll come looking for more sluts to add to my harem!";
		say "     After a bit more boasting and intimidation, the orc eventually puts his loincloth back on. He gives your as a hard smack telling you that you should follow him back to the bunker. You slowly push yourself off the car and gingerly walk with him back to the bunker and putting your gear back on once you return.";
		infect "Orc Breeder";
		if bodyname of player is "Orc Breeder" and player is pure and player is not mpreg_ok:
			LineBreak;
			say "     You feel something change deep inside you, as all the cum Chris blasted into you with completes your transformation to a real orc breeder. You'll now be able to be impregnated through anal sex. The [']MPreg['] feat has been added to your list.";
			add "MPreg" to feats of player;
		increase WarriorChrisPlayerFucked by 1;
		now WarriorChrisDominance is 1; [player got pushed to be Chris's breeder slut]
		now lastfuck of Chris is turns;
	else: [refuse]
		say "     Shaking your head, you push aside the thoughts of submitting to him and try to start a conversation with the young orc warrior - but Chris isn't having any of that. Not falling into line to do as he wanted leads to him putting on a brooding expression and then standing up from the sofa. 'I'll find someone else to fuck then - and he'll beg for more when I'm done with him!' the green-skinned brute tells you as he starts to walk towards the stairs, grudgingly shouldering you aside as he passes by. Seems like your reaction disappointed his urge for dominating as an orc warrior, and now Chris will find someone else to satisfy his desires on.";
		now WarriorChrisDominance is 50; [player refused Chris]
		now lastfuck of Chris is turns;

instead of going up from Grey Abbey Library while (Chris is in Sitting Area and libido of Chris is 2 and WarriorChrisPlayerFucked > 2 and WarriorChrisDominance is 1 and (lastfuck of Chris - turns) > 12):
	move player to Sitting Area;
	if debugactive is 1:
		say "     DEBUG: Chris dominance scene; libido of Chris: [libido of Chris], WarriorChrisDominance: [WarriorChrisDominance], WarriorChrisPlayerFucked: [WarriorChrisPlayerFucked][line break]";
	say "     Coming up the library stairs, you find your gaze almost inevitably drawn over to the sofa Chris likes to hang out on - and before you know it, your feet follow suit and you're halfway over him already. With each step forward, the rippling muscles and masculine frame of the orc draw more and more of your attention. He really is quite a sight, with the typical and powerful body of an orc warrior now that has you biting your lip as you feast your eyes on him. Memories well up in your mind of the time he took you out into the streets - naked, to fuck and publicly establish that you're his breeder slut. Fuck, that was a good time. Just thinking back to it has you almost ready to just fall to your knees and muscle-worship him.";
	say "     Getting closer to the large orc, you eventually manage to tear your gaze away from his body and crotch and notice that the orc is a bit flushed in the face and pants in and out between his sharp tusks. Seems like he's pretty hot and bothered right now, eager to drain his balls by breeding someone. You consider turning back for a second, but then decide against that idea. Being pumped full by the young orc felt so good last time, and... fuck it, you need to feel him inside you again! Stepping being a bookshelf and out of line of sight from the green-skinned hunk, you quickly put down your gear and strip naked, then stroll towards your orc master confidently.";
	WaitLineBreak;
	say "     Noticing you as you walk up to him, the fact that you're naked puts a broad smile on the orc's face. Chris chuckles and says, 'Back for more I see. You're a good breeder slut!' You simply nod in response and move forward the last few steps. Stopping right in front of the sexy orc, you can't help but idly wonder if your desire - your need - to be fucked by him signifies the start of an orc cum addiction... but any further thoughts on such matters are wiped away as the orc lately starring in a lot of your dreams slides his muscular arm around your body. He gropes your buttocks possessively, then gives you a push to fall on the sofa. You land face first on its cushioned backrest, ass up in the air - and to Chris almost immediately steps up to stand behind you. The sofa shifts a little as he braces his hands to either side of your head, leaning over it - and you. His already rock hard cock pokes at your ass, leaving a trail of pre-cum that is dripping from the swollen cock-head.";
	say "     In the quite direct way Chris likes to fuck in, he skips foreplay entirely and just lines himself up with your waiting hole. Then the orc begins to push the tip of his cock against your anus. With him prodding your hole eagerly and yourself pushing back against his cock, your pucker allows the thick invader inside just a few seconds later. The sensation of having the hard shaft of your orcish lover push its way into you forces a lewd moan to escape your lips. He doesn't stop with just the tip either - instead going on to get more and more of his cock inside of you in a slow, smooth push. Each inch of his cock fills you more and feels better than the last. The pleasure of him sinking his cock inside of you is enough for [if player is male]your cock to dribble a decent amount of precum onto the bed[else if player is female]your pussy to drip with female juices[else]pleasant tingly sensations to start running up and down your spine[end if].";
	WaitLineBreak;
	say "     You soon feel a tickle from his pubic hair and the weight of his hefty sack against your ass. Chris gives your ass a triumphant slap before he begins pulling his cock slowly out of you again. His manhood is half outside before he starts to push it back in, slowly sawing his enormous prick in and out of your hole. The pre-cum that he leaks into you somehow seems to help your insides to stretch, becoming accommodated to the orc's thick shaft. 'That's a good slut. You're a nicely tight, yet accommodating cock-sleeve!' Chris says while still slowly thrusting in and out of your ass. With each time, he pulls out a little more of his cock. Eventually only just the tip of the young orc's shaft remains inside you, the mushroom-shaped head tugging at your pucker from the inside before he pushes back inside fully.";
	say "     Chris's hand eventually finds its way between your shoulder-blades, pushing you down more firmly on the cushions. The sofas smells of his musk - and cum - which excites you even more. Once he has you fully pinned down the young orc's thrusts become much faster, his cock easily gliding in and out of your stretched out hole. You can't help but let out frequent moans as the orc pounds away at your ass. 'There you go slut, take my cock!' he growls after the next big push into you. You can only moan in response as the orc picks up the pace after that. Thankfully, he has leaked enough precum to leave your hole well-lubed, and in fact making wet slurps with each thrust. That sound is accompanied by your lewd moans and the loud slap of his balls against your ass.";
	WaitLineBreak;
	say "     This corner of the library kinda starts to reek of sex as he continues to hump you on the sofa, and the sounds of the rough pounding echo throughout the whole library. His cock slides along your insides rubbing more of his precum against your walls. 'I'm going to cummmmm,' Chris bellows in arousal, then pulls out his cock and splatters your ass and back with blast after blast of creamy cum. By the time Chris's orgasm subsides, you're literally drenched in his seed. This leaves you rather sticky and wet, but it still somehow feels good. Something about being marked by your orc master and smelling of his cum just seems to click in your brain, giving you a nice boost in pleasure at this treatment.";
	say "     Yet even though Chris got off, you still haven't. And after taking his thick rod, your back passage feels seems empty without him inside. Moving a hand to finger yourself back there to get off, you suddenly find your wrist grabbed by a strong hand. 'You don't get to cum slut,' Chris tells you, 'Only your master can cum. You can only cum if it's because of my cock, got it?' Slightly disappointed that you aren't allowed to get off unless he makes you, you look at him and nod. 'Now clean this mess up and leave,' he demands, 'I'll grab you the next time I want to get off.' Wiping yourself down as good as you can - after hungrily slurping the cum you scoop up from your fingers, you eventually go to grab your gear again and get dressed.";
	infect "Orc Breeder";
	if bodyname of player is "Orc Breeder" and player is pure and player is not mpreg_ok:
		LineBreak;
		say "     You feel something change deep inside you, as all the cum Chris blasted over your body soaks into your skin and completes your transformation to a real orc breeder. You'll now be able to be impregnated through anal sex. The [']MPreg['] feat has been added to your list.";
		add "MPreg" to feats of player;
	increase WarriorChrisPlayerFucked by 1;
	now WarriorChrisDominance is 2; [player got pushed to be Chris's breeder slut - twice]
	now lastfuck of Chris is turns;

instead of going up from Grey Abbey Library while (Chris is in Sitting Area and libido of Chris is 2 and WarriorChrisPlayerFucked > 2 and WarriorChrisDominance is 2 and (lastfuck of Chris - turns) > 12):
	move player to Sitting Area;
	if debugactive is 1:
		say "     DEBUG: Chris dominance scene; libido of Chris: [libido of Chris], WarriorChrisDominance: [WarriorChrisDominance], WarriorChrisPlayerFucked: [WarriorChrisPlayerFucked][line break]";
	say "     Coming up the library stairs, you find Chris there waiting for you, casually leaning against one of the long bookshelves. He really is quite a sight, with the typical and powerful body of an orc warrior that has you biting your lip as you feast your eyes on him. Memories well up in your mind of the time he took you out into the streets - naked, to fuck and publicly establish that you're his breeder slut. Fuck, that was a good time! Just thinking back to it has you almost ready to just fall to your knees and muscle-worship him. Your gaze automatically wanders down to his crotch, drawn to the tight pair of shorts he is wearing, and the elongated bulge in its fabric. One of the orc's big hands is stroking the outline of his cock, and there is a wet spot where his pre-cum has soaked into the cloth.";
	say "     'Ey, slut! Eyes up here!' you hear the orc call out you in a gruff tone, then snapping his fingers once or twice for good measure. Still blinking away the reverie of being his fuck-toy, you glance up to the grinning face of your strong orc warrior and hear him laugh at your entranced expression. 'Yeah, you're internalized being a breeder alright. I've been waiting for you - time to satisfy your master! Almost thought I'd have to go out and find another slut to drain my balls.' You notice that he is pretty flushed in the face, panting in and out between his sharp tusks. Clearly, Chris is pretty hot and bothered right now, eager to fill a needy fuck-toy with his cum! Being pumped full by the young orc felt so good last time, and... fuck yeah, you want it! Want to be his breeder! With hurried steps, you close the distance to your green-skinned brute, touching his bulging chest in deep worshipful adoration.";
	WaitLineBreak;
	say "     One muscular arm closes around you, drawing you against Chris's chest as he gives you a demanding kiss and lightly nips you with his tusks. The other hand slides down to grope at your ass, giving it a firm squeeze as he checks you out possessively. 'Fuck, I should order you to stay naked at all times. I don't wanna wait for you to strip!' the orc warrior grunts out, only half joking as he looks into your eyes with a lust-filled gaze, then sets you back down on your own feet. 'Get sucking, breeder!' he adds and shoves the shorts down his firmly muscled thighs, freeing the thick orc cock suddenly enough that it whips up and smacks against your chest in a meaty thud. The enticing aroma of orc cum that wafts of it literally has your mouth watering and you just can't wait to get your hands on the long shaft.";
	say "     Your orcish master chuckles as you wrap both of your hands around his member and bend your head over it, licking at the mushroom head and slurping up the pre-cum that makes it wet and shiny. A pleasant tingle runs down the back of your spine as the taste spreads over your tongue and you sigh in pleasure, almost drooling on Chris's dickhead. Fuck! And that's just his pre! You can't really deny it anymore - do you have an orc cum addiction. But then... you don't care! Giving in to the public fucking out there on that street really did change you, making you want to be his happy breeder, content with your big, strong man's dick between your lips! Further thoughts on such matters are wiped away as the orc's prick throbs in your hands and a new little gush of pre leaks from his cum slit, to be immediately slurped up by your waiting tongue.";
	WaitLineBreak;
	say "     Worshiping Chris's erection, you stroke the rim of his cock-head with your tongue, then lick over its tip again and again as he leaks more of your tasty treat. Soon, you move one hand from holding and stroking his shaft to the orc's balls, feeling the weight and fullness of the slightly hairy orbs and massaging them in eager anticipation of swallowing their bounty. With your whole world seemingly being just you and his magnificent cock at the moment, you're actually surprised to feel something touch the back of your head, only remembering after a second or two what it is. Chris put his strong hand on you and is slowly pushing you down on his cock. The massive shaft your eyes are glued to will be a challenge to take - but then... it's not like you have a choice by now!";
	say "     'Oh yeah!' your orc master groans as you open wide and take his cock-head into your mouth. His steady pressure on the back of your head makes you take more and more after that, stretched lips sliding down the green prick while your tongue feels over every detail of his erection it can reach. 'You know what?! You're one sweet cocksucker!' Chris says in a lust-filled tone as another slides past your lips. Man, this feels strange - like you're trying to swallow an apple whole - but also amazing, as he leaks a steady stream of ambrosia-like pre into your mouth and down your throat. Just how can it be that you have taken most of his cock already?! Maybe orc cum and pre has a side effect that makes breeders just a bit... stretchy?";
	WaitLineBreak;
	say "     Chris interrupts your musings about cock-sucking by patting your head and grunting, 'Almost there. Just need a little... ummmphh!' And with that, he rams your head down on his cock, sinking the remaining third down your gullet and forcing you to deep-throat him! Damn that thing is big! Nose buried in the orc's pubes, you huff his scent of cum and a little sweat, but of course you can't breathe with his cock down your throat. Heartbeat by heartbeat, you are pressed firmly to your master's crotch, feeling his erection pulse with the beat of his heart and the throb of more pre-cum while the air in your lungs depletes more and more. For a second or two, things start to blur in front of your eyes, then he pulls you off suddenly, holding you up so that you don't collapse as you gasp for breath.";
	say "     'That's a good breeder! Taking my whole cock!' the orc warrior looks down at you in pride and lust, then lowers you a little bit more, allowing your weak legs to fold until you're kneeling before him. Chris spreads his legs a little bit more as he takes on a slightly hunched posture above you. It is clear what will come next. Having regained your reasoning as air flooded your lungs once more, you raise your arms and grasp his thighs, both to hold on and also to signal the big brute when you really need to breathe. Then Chris starts to face-fuck you, holding your head in both hands as he hammers his hips forward, sliding that massive orc cock down your throat until his balls smack your chin.";
	WaitLineBreak;
	say "     For you don't know how long, you sway back and forth between the pleasure of serving as your master's cock-sleeve and tasting his pre, then clutching his legs weakly as you desperately gasp for breath in one of the few breaks of the demanding fucking. This might have been concerning before, but now... it's no big matter. You're doing what you're here for - serving his pleasure, devoted to the strong green-skinned man that calls you his breeder, his slut and eager cum-dump! The orc's rapid face-fucking quickly becomes even harsher and more urgent, until eventually building up to a glorious climax in which he hammers his prick down your throat with full force, then bellows loudly as he fills your stomach with his massive load.";
	say "     Heavy throbs of Chris's cock deliver the orc's rich, creamy cum into your body, which eagerly absorbs the potent mixture. You can't help but gurgle giddily as its effects make you drunk almost out of your mind, your body twitching with suddenly spiking lust and arousal. [if player is male]Your own cock immediately starts to spew forth its own load, creaming the inside of your pants[else if player is female]Your pussy immediately starts to tingle, leaking sticky femcum and soaking the inside of your pants[else]Your sexless crotch tingles as the sensation becomes too much to bear and you orgasm[end if]. And that is pretty much the last thing you feel for a while, as this time, you actually do pass out because Chris is too busy coming to remember giving you time to take a breath.";
	WaitLineBreak;
	say "     When you eventually come to again, you find yourself in an interesting and fairly pleasant position - lying against Chris's broad chest as he lounges on the couch he claimed has his own. Looking down, you see the orc's half hard cock between your legs - your naked legs, like the rest of your body. The orc is slowly stroking you, taking pleasure in feeling up his devoted breeder slut. 'Back awake, eh? Sorry, I guess - let things get a bit out of hand there. Take it as a compliment for you being such an amazing cum-slut!' The orc chuckles at his not-really apology, then fondles you some more before sending you off with a playful slap to the butt. You do find your clothes in an untidy heap not too far away, smelling of orc cum. Apparently he used them wipe his dick - and you - clean of his load.";
	infect "Orc Breeder";
	if bodyname of player is "Orc Breeder" and player is pure and player is not mpreg_ok:
		LineBreak;
		say "     You feel something change deep inside you, as all the cum Chris blasted into your stomach completes your transformation to a real orc breeder. You'll now be able to be impregnated through anal sex. The [']MPreg['] feat has been added to your list.";
		add "MPreg" to feats of player;
	increase WarriorChrisPlayerFucked by 1;
	now WarriorChrisDominance is 3; [player got pushed to be Chris's breeder slut - three times]
	now lastfuck of Chris is turns;

instead of going up from Grey Abbey Library while (Chris is in Sitting Area and libido of Chris is 2 and WarriorChrisPlayerFucked > 2 and WarriorChrisDominance is 3 and (lastfuck of Chris - turns) > 8 and a random chance of 1 in 3 succeeds):
	move player to Sitting Area;
	if debugactive is 1:
		say "     DEBUG: Chris dominance scene; libido of Chris: [libido of Chris], WarriorChrisDominance: [WarriorChrisDominance], WarriorChrisPlayerFucked: [WarriorChrisPlayerFucked][line break]";
	say "     Coming up the library stairs, you see that Chris has been waiting for you on his sofa, leaned back and slowly stroking his cock. The young orc gives an amused grunt as he stands up, then walks towards you with his hard shaft swinging freely. 'About time you come along, slut!' he tells you gruffly, sliding an arm around your body to pull you close. Grabbing your head and tilting it back, the orc warrior gives you a demanding kiss while his other hand gropes your body. Leaning into your master's touch, you feel a little bit giddy about how much you want him - how much you need him - and make out with him in eager bliss. Eventually, the green-skinned hunk pulls back from you a little, then goes on to lower his face to the crook of your neck and takes a deep breath.";
	if player is mpreg_able: [mpreg-able and not pregnant]
		say "     Breathing in your scent, the orc gives a satisfied growl and licks the side of your neck, then pulls you back a little from himself to look you up and down. Excitement and lust is audible in his voice as he grunts, 'Oh yeah, you're one fine slut - ripe for breeding, I can tell. Let's put an orcling in you!' With that said, Chris immediately starts to strip you down, impatiently tugging off gear and clothes. Thankfully, he doesn't tear anything - a real danger, given how aroused about breeding you the brutish orc teen really is. Soon, you're buck-naked amidst strewn-about articles of discarded clothing, with your master guiding you over to the edge of the extended balcony overlooking the lower floor. 'Get ready breeder,' he growls out and pushes against your upper back, making you bend forward and grab the polished wooden railing.";
		WaitLineBreak;
		say "     Chris slaps your buttocks with his hard cock, making the sound of his erect rod smacking against your ass several times echo through the library. 'Fuck yeah, you like that don't you?!' the orc teen grunts and leans over you, his broad-shouldered chest touching your back. Feeling his breath against your neck, you turn your head to look back and are rewarded with a grin from the warrior, followed by him nibbling at your earlobe. 'Say that you want my orcling. Shout it out for the whole world to hear!' he says to you in a lusty tone, his lips just an inch from the side of your head while he hot-dogs his cock between the buns of your ass. A shiver of arousal runs down your spine at the situation you find yourself in - naked, in this public library, with the young man who has taken you as his ready to fuck you hard...";
		say "     You don't even think of doing anything else but to readily comply, leaning forward over the railing a bit and calling out that you belong to Chris, that you want to bear his kids and be the best breeder he ever could wish for. Sure, he fucked you before... publicly and out on the street, but somehow this feels even more real - shouting these words out loud, in the place that has been your refuge in all of this chaos. The young orc is more than pleased by your commitment to your role as breeder, giving a grunt that is a sound of pure lust. He grabs his cock and lines it up with your back door right away, then pushes into your depths you with a hard thrust.";
		WaitLineBreak;
		say "     'Fuck yeah, this feels good!' Chris calls out loudly, his thick shaft throbbing against your stretched insides as it slides a little deeper, and deeper. Each inch of his cock fills you more and feels better than the last. The pleasure of him sinking his cock inside of you is enough for [if player is male]your cock to dribble a decent amount of precum[else if player is female]your pussy to drip with female juices[else]pleasant tingly sensations to start running up and down your spine[end if]. You soon feel a tickle from his pubic hair and the weight of his hefty sack against your ass. Chris gives your ass a triumphant slap before he begins pulling his cock slowly out of you again.";
		say "     The orc's manhood is half outside before he starts to push it back in, slowly sawing his enormous prick in and out of your hole. The pre-cum that he leaks into you somehow seems to help your insides to stretch, becoming accommodated to the green-skinned brute's thick shaft. 'That's a good slut. Such a nicely tight, yet accommodating cock-sleeve. And now, you're gonna be bred properly!' Chris says while still slowly thrusting in and out of your ass. With each time, he pulls out a little more of his cock. Eventually only just the tip of the young orc's shaft remains inside you, the mushroom-shaped head tugging at your pucker from the inside before he pushes back inside fully.";
		WaitLineBreak;
		say "     Chris's hands eventually find their way to your shoulders, taking hold of them as he gets ready to really pound you. Hands clutching the wooden railing you're bent over and with his big hands resting on your shoulders, you have little fear of falling down into the library below, even as your orc master pulls back in a sudden move, then hammers against your rear with full force. His cock easily glides in and out of your stretched hole, which is by now well-used to an invasion with his girth. You can't help but let out frequent moans as the orc pounds away at your ass. 'There you go slut, take my cock!' he growls after the next big push into you that generates a loud slap of his balls against your ass. You can only moan in response, [if player is male]your own cock hard as a rock and standing straight out between the carved struts of the railing.[else if player is female]your pussy starting to drip with female juices[else]a pleasant tingly sensations starting to run up and down your spine[end if]. Fuck! The two of you must be a sight... an orc and his breeder slut, fucking away right in the open and visible to everyone below!";
		say "     Grunting in satisfaction, the orc soon picks up the pace. Thankfully, he has leaked enough precum to leave your hole well-lubed, and in fact making wet slurps with each thrust. That sound is accompanied by your lewd moans and the loud slap of his balls against your ass, the sounds of the rough coupling echoing throughout the whole library. His cock slides along your insides rubbing more of his precum against your walls. 'You're gonna get it now, slut!' Chris bellows in arousal, grinding his hips against your ass as his cock starts to throb - hard - and the first gush of his seed splashes against your inner walls. You can feel a wave of pleasure break over your mind as his cum starts to soak into your innermost depths, its potent effects instantly making your arousal soar.";
		WaitLineBreak;
		say "     As blast after blast throbs into you, your own lust is pushed past any hope of holding back and you join Chris in orgasm. Your inner muscles twitch and flex around your master's cock [if player is male]in rhythm with each spurt of your cock that showers the library below in your cum[else if player is female]while your pussy starts dripping femcum, with it trickling down the inside of your legs[else]while you grasp the railing even tighter and shiver from all the pleasure[end if]. By the time Chris's orgasm subsides, you're literally filled to overflowing, some of his seed squelching out around the shaft as he pumps it in and out of your ass. The creamy load starts to run down the back and inside of your legs too, leaving you rather sticky and wet... but it still somehow feels good. Something about being marked by your orc master and smelling of his cum just seems to click in your brain, giving you a nice boost in pleasure at this treatment. Things become a little blurry after that, as you are in an orc-cum-induced lusty haze for quite a while.";
		infect "Orc Breeder";
		say "[mimpregchance]";
		if player is impreg_now: [has become pregnant]
			say "[bold type]'Chris's Breeder Slut' has been added to your feats![roman type][line break]";
			add "Chris's Breeder Slut" to feats of player; [orc baby, no matter what]
		say "     You remember being carried and held, and when you eventually come to again fully, you find yourself in an interesting and fairly pleasant position - lying against Chris's broad chest as he lounges on the couch he claimed has his own. Looking down, you see the orc's half hard cock between your legs. Chris is slowly stroking you with one hand between your legs, the other one resting on your belly. He keeps brushing his finger over your pucker again and again, taking pleasure in feeling up his devoted breeder slut. 'Back awake, eh? You did good, breeder! Can't wait to see your belly bulge with my orcling.' The orc chuckles and leans his head forward to lick your cheek, then keeps you against his chest for a while longer, arms wrapped around your midriff. Eventually, he dozes off, giving you the opportunity of extracting yourself from his grasp and starting to collect the strewn about pieces of your gear.";
	else if player is mpreg_now: [already mpregnant]
		say "     Breathing in your scent, the orc gives a satisfied growl and licks the side of your neck, then pulls you back a little from himself to look you up and down. Placing one large green hand on your belly, he gives it an almost gentle caress as he says, 'Oh yeah, you're one fine slut. Can't wait till you bear the little tyke in there. I wanna put an orcling in you soon after!' Shifting his hands to your buttocks, the young orc squeezes and kneads them under his fingers, clearly enjoying himself quite a bit. His cocks seems to get even harder than before and pokes you a little as he leans in against you. Then Chris says, 'You know what - I really can't wait. Gonna fuck you now! And it'll be good for the kid too - orc cum makes em grow extra fast, and strong!'";
		say "     With that said, Chris immediately starts to strip you down, impatiently tugging off gear and clothes. Thankfully, he doesn't tear anything - a real danger, given how aroused about breeding you the brutish orc teen really is. Soon, you're buck-naked amidst strewn-about articles of discarded clothing, with your master guiding you over to the edge of the extended balcony overlooking the lower floor. 'Get ready breeder,' he growls out and pushes against your upper back, making you bend forward and grab the polished wooden railing.";
		WaitLineBreak;
		say "     Chris slaps your buttocks with his hard cock, making the sound of his erect rod smacking against your ass several times echo through the library. 'Fuck yeah, you like that don't you. Hell, I know you do - gonna fuck that pregnant ass of yours!' the orc teen grunts and leans over you, his broad-shouldered chest touching your back. Feeling his breath against your neck, you turn your head to look back and are rewarded with a grin from the warrior, followed by him nibbling at your earlobe. 'Say that you want my cum. Shout it out for the whole world to hear!' he says to you in a lusty tone, his lips just an inch from the side of your head while he hot-dogs his cock between the buns of your ass. A shiver of arousal runs down your spine at the situation you find yourself in - naked, in this public library, with the young man who has taken you as his ready to fuck you hard...";
		say "     You don't even think of doing anything else but to readily comply, leaning forward over the railing a bit and calling out that you belong to Chris, that you want to him to fuck hard even though you're already pregnant. Sure, he took you before... publicly and out on the street, but somehow this feels even more real - shouting these words out loud, in the place that has been your refuge in all of this chaos. The young orc is more than pleased by your commitment to your role as breeder, giving a grunt that is a sound of pure lust. He grabs his cock and lines it up with your back door right away, then pushes into your depths you with a hard thrust.";
		WaitLineBreak;
		say "     'Fuck yeah, this feels good! *ngh* Hot! *ngggh* Pregnant! *nnnghhh* Boypussy!' Chris calls out loudly, his thick shaft throbbing against your stretched insides as he gives sharp little thrusts with each shouted word. Each inch or two of his cock that slides in fills you more and feels better than the last. The pleasure of him sinking his cock inside of you is enough for [if player is male]your cock to dribble a decent amount of precum[else if player is female]your pussy to drip with female juices[else]pleasant tingly sensations to start running up and down your spine[end if]. You soon feel a tickle from his pubic hair and the weight of his hefty sack against your ass. Chris gives your ass a triumphant slap before he begins pulling his cock slowly out of you again.";
		say "     The orc's manhood is half outside before he starts to push it back in, slowly sawing his enormous prick in and out of your hole. The pre-cum that he leaks into you somehow seems to help your insides to stretch, becoming accommodated to the green-skinned brute's thick shaft. 'That's a good slut. Such a nicely tight, yet accommodating cock-sleeve. And now, you're gonna be bred properly!' Chris says while still slowly thrusting in and out of your ass. With each time, he pulls out a little more of his cock. Eventually only just the tip of the young orc's shaft remains inside you, the mushroom-shaped head tugging at your pucker from the inside before he pushes back inside fully.";
		WaitLineBreak;
		say "     Chris's hands eventually find their way to your shoulders, taking hold of them as he gets ready to really pound you. Hands clutching the wooden railing you're bent over and with his big hands resting on your shoulders, you have little fear of falling down into the library below, even as your orc master pulls back in a sudden move, then hammers against your rear with full force. His cock easily glides in and out of your stretched hole, which is by now well-used to an invasion with his girth. You can't help but let out frequent moans as the orc pounds away at your ass. 'There you go slut, take my cock!' he growls after the next big push into you that generates a loud slap of his balls against your ass. You can only moan in response, [if player is male]your own cock hard as a rock and standing straight out between the carved struts of the railing.[else if player is female]your pussy starting to drip with female juices[else]a pleasant tingly sensations starting to run up and down your spine[end if]. Fuck! The two of you must be a sight... an orc and his breeder slut, fucking away right in the open and visible to everyone below!";
		say "     Grunting in satisfaction, the orc soon picks up the pace. Thankfully, he has leaked enough precum to leave your hole well-lubed, and in fact making wet slurps with each thrust. That sound is accompanied by your lewd moans and the loud slap of his balls against your ass, the sounds of the rough coupling echoing throughout the whole library. His cock slides along your insides rubbing more of his precum against your walls. 'You're gonna get it now, slut!' Chris bellows in arousal, grinding his hips against your ass as his cock starts to throb - hard - and the first gush of his seed splashes against your inner walls. You can feel a wave of pleasure break over your mind as his cum starts to soak into your innermost depths, its potent effects instantly making your arousal soar.";
		WaitLineBreak;
		say "     As blast after blast throbs into you, your own lust is pushed past any hope of holding back and you join Chris in orgasm. Your inner muscles twitch and flex around your master's cock [if player is male]in rhythm with each spurt of your cock that showers the library below in your cum[else if player is female]while your pussy starts dripping femcum, with it trickling down the inside of your legs[else]while you grasp the railing even tighter and shiver from all the pleasure[end if]. By the time Chris's orgasm subsides, you're literally filled to overflowing, some of his seed squelching out around the shaft as he pumps it in and out of your ass. The creamy load starts to run down the back and inside of your legs too, leaving you rather sticky and wet... but it still somehow feels good. Something about being marked by your orc master and smelling of his cum just seems to click in your brain, giving you a nice boost in pleasure at this treatment. Things become a little blurry after that, as you are in an orc-cum-induced lusty haze for quite a while.";
		infect "Orc Breeder";
		say "     You remember being carried and held, and when you eventually come to again fully, you find yourself in an interesting and fairly pleasant position - lying against Chris's broad chest as he lounges on the couch he claimed has his own. Looking down, you see the orc's half hard cock between your legs. Chris is slowly stroking you with one hand between your legs, the other one resting on your belly. He keeps brushing his finger over your pucker again and again, taking pleasure in feeling up his devoted breeder slut. 'Back awake, eh? You did good, breeder!' The orc chuckles and leans his head forward to lick your cheek, then keeps you against his chest for a while longer, arms wrapped around your midriff. Eventually, he dozes off, giving you the opportunity of extracting yourself from his grasp and starting to collect the strewn about pieces of your gear.";
	else: [no mpreg ability]
		say "     Breathing in your scent, the orc gives a slightly dissatisfied growl and licks the side of your neck, nipping at it lightly with his tusks. Then he pulls you back a little from himself to look you up and down. 'You're a good slut, but I want you to be a real breeder and to knock you up! Guess you need another load to guzzle, or three!' With that said, the brutish young man pushes you down to your knees and hefts his erect cock, smacking it lightly against your cheek. 'Get sucking, breeder!' he adds a second later and bends his shaft to rub it over your lips. The enticing aroma of orc cum that wafts of it literally has your mouth watering and you just can't wait to get your hands on the long shaft.";
		say "     Your orcish master chuckles as you wrap both of your hands around his member and bend your head over it, licking at the mushroom head and slurping up the pre-cum that makes it wet and shiny. A pleasant tingle runs down the back of your spine as the taste spreads over your tongue and you sigh in pleasure, almost drooling on Chris's dickhead. Fuck! And that's just his pre! You can't really deny it anymore - do you have an orc cum addiction. But then... you don't care! Giving in to the public fucking out there on that street really did change you, making you want to be his happy breeder, content with your big, strong man's dick between your lips! Further thoughts on such matters are wiped away as the orc's prick throbs in your hands and a new little gush of pre leaks from his cum slit, to be immediately slurped up by your waiting tongue.";
		WaitLineBreak;
		say "     Worshiping Chris's erection, you stroke the rim of his cock-head with your tongue, then lick over its tip again and again as he leaks more of your tasty treat. Soon, you move one hand from holding and stroking his shaft to the orc's balls, feeling the weight and fullness of the slightly hairy orbs and massaging them in eager anticipation of swallowing their bounty. With your whole world seemingly being just you and his magnificent cock at the moment, you're actually surprised to feel something touch the back of your head, only remembering after a second or two what it is. Chris put his strong hand on you and is slowly pushing you down on his cock. The massive shaft your eyes are glued to will be a challenge to take - but then... it's not like you have a choice by now!";
		say "     'Oh yeah!' your orc master groans as you open wide and take his cock-head into your mouth. His steady pressure on the back of your head makes you take more and more after that, stretched lips sliding down the green prick while your tongue feels over every detail of his erection it can reach. 'You know what?! You're one sweet cocksucker!' Chris says in a lust-filled tone as another slides past your lips. Man, this feels strange - like you're trying to swallow an apple whole - but also amazing, as he leaks a steady stream of ambrosia-like pre into your mouth and down your throat. Just how can it be that you have taken most of his cock already?! Maybe orc cum and pre has a side effect that makes breeders just a bit... stretchy?";
		WaitLineBreak;
		say "     Chris interrupts your musings about cock-sucking by patting your head and grunting, 'Almost there. Just need a little... ummmphh!' And with that, he rams your head down on his cock, sinking the remaining third down your gullet and forcing you to deep-throat him! Damn that thing is big! Nose buried in the orc's pubes, you huff his scent of cum and a little sweat, but of course you can't breathe with his cock down your throat. Heartbeat by heartbeat, you are pressed firmly to your master's crotch, feeling his erection pulse with the beat of his heart and the throb of more pre-cum while the air in your lungs depletes more and more. For a second or two, things start to blur in front of your eyes, then he pulls you off suddenly, holding you up so that you don't collapse as you gasp for breath.";
		say "     'That's a good breeder! Taking my whole cock!' the orc warrior looks down at you in pride and lust, then lowers you a little bit more, allowing your weak legs to fold until you're kneeling before him. Chris spreads his legs a little bit more as he takes on a slightly hunched posture above you. It is clear what will come next. Having regained your reasoning as air flooded your lungs once more, you raise your arms and grasp his thighs, both to hold on and also to signal the big brute when you really need to breathe. Then Chris starts to face-fuck you, holding your head in both hands as he hammers his hips forward, sliding that massive orc cock down your throat until his balls smack your chin.";
		WaitLineBreak;
		say "     For you don't know how long, you sway back and forth between the pleasure of serving as your master's cock-sleeve and tasting his pre, then clutching his legs weakly as you desperately gasp for breath in one of the few breaks of the demanding fucking. This might have been concerning before, but now... it's no big matter. You're doing what you're here for - serving his pleasure, devoted to the strong green-skinned man that calls you his breeder, his slut and eager cum-dump! The orc's rapid face-fucking quickly becomes even harsher and more urgent, until eventually building up to a glorious climax in which he hammers his prick down your throat with full force, then bellows loudly as he fills your stomach with his massive load.";
		say "     Heavy throbs of Chris's cock deliver the orc's rich, creamy cum into your body, which eagerly absorbs the potent mixture. You can't help but gurgle giddily as its effects make you drunk almost out of your mind, your body twitching with suddenly spiking lust and arousal. [if player is male]Your own cock immediately starts to spew forth its own load, creaming the inside of your pants[else if player is female]Your pussy immediately starts to tingle, leaking sticky femcum and soaking the inside of your pants[else]Your sexless crotch tingles as the sensation becomes too much to bear and you orgasm[end if]. And that is pretty much the last thing you feel for a while, as this time, you actually do pass out because Chris is too busy coming to remember giving you time to take a breath.";
		WaitLineBreak;
		say "     When you eventually come to again, you find yourself in an interesting and fairly pleasant position - lying against Chris's broad chest as he lounges on the couch he claimed has his own. Looking down, you see the orc's half hard cock between your legs - your naked legs, like the rest of your body. The orc is slowly stroking you with one hand between your legs, brushing his finger over your pucker again and again, taking pleasure in feeling up his devoted breeder slut. 'Back awake, eh? Sorry, I guess - let things get a bit out of hand there. Take it as a compliment for you being such an amazing cum-slut!' The orc chuckles at his not-really apology, then fondles you some more before sending you off with a playful slap to the butt. You do find your clothes in an untidy heap not too far away, smelling of orc cum. Apparently he used them wipe his dick - and you - clean of his load.";
		infect "Orc Breeder";
		if bodyname of player is "Orc Breeder" and player is pure and player is not mpreg_ok:
			LineBreak;
			say "     You feel something change deep inside you, as all the cum Chris blasted into your stomach completes your transformation to a real orc breeder. You'll now be able to be impregnated through anal sex. The [']MPreg['] feat has been added to your list.";
			add "MPreg" to feats of player;
		increase WarriorChrisPlayerFucked by 1;
		now lastfuck of Chris is turns;


Chris ends here.
