Version 1 of Coura by Wahn begins here.
[Version 1 - Put into its own file]

[ libido of Danny (Mall Rat involvement with Nermine)                ]
[   0: not had any public scene with them yet                        ]
[   1: fucked Nermine in front of Danny and watching rats            ]
[   2: offer for bukkake rat involvement accepted                    ]
[   3: bukkake scene completed                                       ]
[   4: player got offered a revenge plan by Nermine (and accepted)   ]
[   5: bukkake rejected + mtf rat ritual accepted                    ]
[   6: Cole was transformed once                                     ]
[   7: Coura had sex once                                            ]
[   8: Coura had sex twice                                           ]
[   9: Coura had sex three times (getting used to it)                ]
[  12: Cole wants control to be a girl freely                        ]
[  13: rejected Cole's request for the doll, continue status quo     ]
[  14: doll destroyed, Cole stuck as a guy                           ]
[  15: doll destroyed, Cole stuck as a girl                          ]
[  16: player let Cole have the doll, he must work at the store      ]
[  17: player let Cole have the doll, etc                            ]
[  99: refused the revenge offer                                     ]
[ 100: refused the harness offer                                     ]

[ CouraFriendDevelopments                                            ]
[   0: nothing yet                                                   ]
[   1: heard Cole's friends wondering about him                      ]
[   2: other rats know about his transformations and confronted him  ]
[   3: placeholder for possible developments with switching Cole     ]
[  10: his friends talked to Cole (stuck as a guy)                   ]
[  20: his friends tried to make a move on free Cole, got rejected   ]

[ CouraVirginity                                                     ]
[   0: virgin                                                        ]
[   1: taken by the player                                           ]


an everyturn rule:
	if libido of Danny > 15 and libido of Danny < 99:
		[if TimekeepingVar is 1 or TimekeepingVar is -7:] [midnight - unused, Cold sleeps]
		[else if TimekeepingVar is 0 or TimekeepingVar is -8:] [pre dawn - unused, Cole sleeps]
		if TimekeepingVar is 7 or TimekeepingVar is -1: [early morning]
			if player is in Mall Foodcourt:
				let randomnumber be a random number from 1 to 2;
				if randomnumber is:
					-- 1:
						say "     A whole group of mall rats emerges from one of the storerooms in the back corner of the foodcourt. Looks like most of them are the crew who man the fast food joints in the early shift, but there is also one rat that you recognize. It is Cole, the victim of Nermine's gender-switch spell. He goes to grab a bite to eat from one store, never noticing your presence or attention as he chats a bit with a female friend from the night shift. Before long, the young man wishes her goodnight and then becomes part of the crowd of people populating this section of the mall at any time of day, where you lose sight of him.";
					-- 2:
						say "     A whole group of mall rats emerges from one of the storerooms in the back corner of the foodcourt. Looks like most of them are the crew who man the fast food joints in the early shift, but there is also one rat that you recognize. It is Coura, the victim of Nermine's gender-switch spell. She goes to grab a bite to eat from one store, never noticing your presence or attention as she chats a bit with a female friend from the night shift. Before long, the young woman wishes her goodnight and then becomes part of the crowd of people populating this section of the mall at any time of day, where you lose sight of her.";
		else if TimekeepingVar is 6 or TimekeepingVar is -2: [mid-morning]
			if player is in Mysterious Shop:
				say "     With the ringing of its little bells, the store door opens and Coura enters Nermine's business. The young woman is dressed in her usual tank top and short skirt, wearing a somewhat apprehensive expression on her face as she approaches the store counter. But then the mall rat spots you and her worries seem blown away as she smiles and gives you a happy little wave. ";
				let randomnumber be a random number from 1 to 3;
				if randomnumber is:
					-- 1:
						say "'About time that the slutty rat finally showed up,' Nermine suddenly barks at Coura, making her flinch. The black jackaless holds an antique pocket-watch in her hands, glancing down at it with a frown. 'Almost [one of]eleven[or]twenty[or]thirty-five[or]forty[or]forty-one[or]fifty[at random] seconds late. As the rodent will soon learn, that is unacceptable. Nermine runs a business, not a charity!' Glowering at the mall rat, Nermine raises one eyebrow expectantly and Coura stammers out, 'O-of course mistress! I will do my best to be more punctual.' With a dismissive huff, the jackal sorceress expresses that she openly doubts this, then goes to grab Coura by the arm.";
					-- 2:
						say "'So the slutty rat is early today,' Nermine suddenly barks at Coura, making her flinch. The black jackaless holds an antique pocket-watch in her hands, glancing down at it with a frown. 'And what did she want to do with the [one of]eleven[or]twenty[or]thirty-five[or]forty[or]forty-one[or]fifty[at random] seconds before the start of her shift? Try to throw herself at some customer like a little whore and bother them? As the rodent will soon learn, that is unacceptable. Nermine runs a business, not a brothel!' Glowering at the mall rat, Nermine raises one eyebrow expectantly and Coura stammers out, 'O-of course not mistress! I will do my best to be more punctual.' With a dismissive huff, the jackal sorceress expresses that she openly doubts this, then goes to grab Coura by the arm.";
					-- 3:
						say "'Right on time today,' Nermine suddenly barks at Coura, making her flinch. The black jackaless holds an antique pocket-watch in her hands, glancing down at it with a frown. 'How unusual. Maybe this watch is off somehow. I should have it checked out by a mechanic.' Glowering at the mall rat, Nermine raises one eyebrow expectantly and Coura looks back somewhat frightened, then stammers out, 'Uhm. Ready for duty mistress?' With a dismissive huff, the jackal sorceress goes to grab Coura by the arm.";
				say "     'Nermine has a proper task for the lazy rodent, just right to teach her some humility.' Pulling Coura along, she reaches the door to the back room in short notice and makes a little gesture with her paw-hand. As she then pulls the door open, this reveals an exceptionally large room beyond. It is filled with shelves and boxes, all of them overstuffed with all sorts of items. You think you even see some cages further back, with living things inside them. Pointing at a cleaning rag and a duster on a little table near the door, the black-furred bitch barks, 'The storage room is in the need of a little cleaning. Surely even a stupid girl as Coura can do that right.' Not allowing any moment for a reply, Nermine pushes her servant through the door, then shuts it.";
			else if player is in Mall West Wing:
				let randomnumber be a random number from 1 to 2;
				if randomnumber is:
					-- 1:
						say "     Standing where you are, you see a shape step out of the crowd that you know. It is Coura the mall rat, dressed in her usual tank top and short skirt. She glances at the entrance of Nermine's shop with apprehension as she walks towards it. Then her eyes fall upon you and the mall rat immediately shows a friendly little smile on her face, making a beeline towards you. 'Good morning [master],' she says happily, then leans in to give you a kiss on the cheek. '[one of]I just, just needed to thank you again. It feels good to be me more than just once in a while. The freedom to shift is amazing[or]It is so great to see you here[or]It makes me happy to see a friendly face here, before I go in[at random].' The young woman's gaze rests on your face for a few seconds longer, full of worshipfulness and adoration, then she looks down at her wristwatch and flinches. 'Damn, I'm gonna be late!' With that shout, she hurriedly waves and rushes into the store.";
					-- 2:
						say "     Standing where you are, you see a shape step out of the crowd that you know. It is Coura the mall rat, dressed in her usual tank top and short skirt. She glances at the entrance of Nermine's shop with apprehension as she walks towards it, pausing for a second at the door to steel her nerves. Then the young woman enters and you can see her approach Nermine through the window of the store, who shoos her into the back room in short notice.";
[
		else if TimekeepingVar is 5 or TimekeepingVar is -3: [noon]
			if player is in Nowhere:
				say "     X";
]
		else if TimekeepingVar is 4 or TimekeepingVar is -4: [mid afternoon]
			if player is in Mysterious Shop:
				say "     Suddenly, the door to the back room swings open and Coura comes out of it, dressed in her usual tank top and short skirt. The mall rat looks fairly exhausted after a long day working for Nermine and seems eager to get out of here. Yet before she can take another step towards the exit, the black jackaless stops Coura by clearing her throat, looking at the young woman with a raised eyebrow. 'Did the rodent finish all of her tasks for the day? Truly?' she asks in a sharp tone, spearing her employee with her gaze. 'Yes mistress! Of course,' Coura replies defensively, after which Nermine pulls a scroll of what seems to be papyrus from beneath her counter. Unrolling a section of it, she glances down at a list of entries, behind which one by one checkmarks appear.";
				say "     Giving the mall rat an unimpressed nod, Nermine simply says, 'The rat can go,' then starts adding new tasks to the list for Coura to do tomorrow. Not wasting any time, Coura is out of the door within moments, and it swings shut behind her with the ringing of tiny bells.";
			else if player is in Mall West Wing:
				let randomnumber be a random number from 1 to 2;
				if randomnumber is:
					-- 1:
						say "     Standing where you are, you see someone step out of the entrance door to Nermine's store. It is Coura the mall rat, dressed in her usual tank top and short skirt. She looks genuinely relieved to be done with her shift for the day and starts out into the crowd, only to stop and make a beeline towards you as she spots you. 'Good afternoon [master],' she says happily, then leans in to give you a kiss on the cheek. '[one of]I'm done working for today[or]It is great to see you here[or]It makes me happy to see a friendly face after a hard day working for her[at random].' The young woman's gaze rests on your face for a few seconds longer, full of worshipfulness and adoration, then she looks down at her wristwatch and adds, 'I gotta go now though, as I'm due to meet some friends of mine. 'See ya, alright?' After you wish her a good afternoon, she goes off towards the Atrium with a skip in her step.";
					-- 2:
						say "     Standing where you are, you see someone step out of the entrance door to Nermine's store. It is Coura the mall rat, dressed in her usual tank top and short skirt. She looks genuinely relieved to be done with her shift for the day and starts out into the crowd, soon vanishing in the direction of the Atrium.";
[
		else if TimekeepingVar is 3 or TimekeepingVar is -5: [evening]
			if player is in Nowhere:
				say "     X";
]
		else if TimekeepingVar is 2 or TimekeepingVar is -6: [early night - Cole/Coura goes to bed]
			if player is in Mall Foodcourt:
				let randomnumber be a random number from 1 to 4;
				if randomnumber is:
					-- 1: [Cole, notices the player]
						say "     As you hang out in the food court and evening turns into night, you suddenly spot a mall rat approaching that you know. It is Cole, the victim of Nermine's gender-switch spell. He makes a beeline for you as he notices your presence, giving a friendly little wave. 'Hey there,' the young man says with a friendly smile and stops to chat a little bit with you before eventually excusing himself. 'Gotta get my rest, you know. The boss at my new job is a total bitch, especially if I come in late.' With a wink, he then walks off towards one of the storerooms in the back corner of the foodcourt. Seems like it is being used as sleeping quarters these days.";
					-- 2: [Coura, notices the player]
						say "     As you hang out in the food court and evening turns into night, you suddenly spot a mall rat approaching that you know. It is Coura, the victim of Nermine's gender-switch spell. She makes a beeline for you as she notices your presence, giving a friendly little wave. 'Hey there,' the young woman says with a friendly smile and stops to chat a little bit with you before eventually excusing himself. 'Gotta get my rest, you know. The boss at my new job is a total bitch, especially if I come in late.' With a wink, she then walks off towards one of the storerooms in the back corner of the foodcourt. Seems like it is being used as sleeping quarters these days.";
					-- 3: [Cole, doesn't notice the player]
						say "     As you hang out in the food court and evening turns into night, you suddenly spot a mall rat approaching that you know. It is Cole, the victim of Nermine's gender-switch spell. He doesn't notice you as he stops by one of the food lines and grabs a bite to eat, chatting with another mall rat for a little while. Then he walks off towards one of the storerooms in the back corner of the foodcourt. Seems like it is being used as sleeping quarters these days.";
					-- 4: [Coura, doesn't notice the player]
						say "     As you hang out in the food court and evening turns into night, you suddenly spot a mall rat approaching that you know. It is Coura, the victim of Nermine's gender-switch spell. She doesn't notice you as she stops by one of the food lines and grabs a bite to eat, chatting with another mall rat for a little while. Then she walks off towards one of the storerooms in the back corner of the foodcourt. Seems like it is being used as sleeping quarters these days.";

CouraVirginity is a number that varies.
CouraFriendDevelopments is a number that varies.

Section 1 - NPC

Cole is a man.
The description of Cole is "[ColeDesc]".
The conversation of Cole is { "<This is nothing but a placeholder!>" }.
The scent of Cole is "     ....".

to say ColeDesc:
	say "     ...";

Coura is a woman.
The description of Coura is "[CouraDesc]".
The conversation of Coura is { "<This is nothing but a placeholder!>" }.
The scent of Coura is "     ....".

to say CouraDesc:
	say "     ...";


Section 2 - Scenes

to say NermineRatRitual: [this is called from Nermine's talk menu]
	say "     As you approach the naked jackaless and ask her about the ritual, the sorceress gives an eager smile. She saunters over towards you and strokes her hands over the curves of her breasts, lightly pinching their already hard nipples - seems like someone is definitively looking forward to what will come next. She licks the sides of her muzzle in sensual slowness, then presses herself against your side. 'Everything has been prepared, [master]. All [PosAdj of player] joyful bitch now needs is for [ObjectPro of player] to say the word. The impudent rodent should immediately feel the effects once the spell is cast, and Nermine expects him - or rather her - to come here soon after.' With a smile on your face, you grab Nermine by her long hair and bend her head back to give her a demanding kiss, then command the black jackaless to do it.";
	say "     Letting out a lustful little sigh at your dominant tone, Nermine strokes her hand down your front and pulls it away after resting on your crotch for a second, then moves around the counter and lifts the broad metal bowl you saw earlier from somewhere behind it. Placing the object on the counter, you can see that its floor is covered in what seems to be a mixture of various crushed herbs and other substances that lightly sparkle in the light. The next thing that gets pulled from beneath the counter is the target's orange briefs, as well as a pair of shears. They're made of a silvery metal and ancient in design, without even any moving parts; instead consisting of a single piece of metal that twists upon itself like an infinity symbol open at one end, which is extended into blades. Lastly, Nermine places an articulated plastic doll on the counter that looks like a spitting image of a typical mall rat, down to the ears, tail and all.";
	WaitLineBreak;
	say "     'Nermine does enjoy having her store be part of places like this mall. Modern consumerism does create such very convenient opportunities,' the jackaless tells you with a smirk, tapping the head of the little doll. Thinking about it for a second, you remember seeing these things in advertisements - some sort of toy line, or was it movie merchandise? A well-stocked mall truly has something for every occasion and customer, even if it is a sorceress out for revenge. Proudly waving you closer to watch her perform her magics, Nermine leans over the bowl and whispers a tongue-twisting word, making the mixture in the bowl start to singe and then burn slowly. Aromatic scents fill the air as the metal container is filled with fire and a little smoke starts to curl up into the air from it. Smiling, the jackaless picks up the briefs and her shears next.";
	say "     Swift yet thoughtfully placed snips make a band of fabric fall from the area that would have rested above the crotch of the mall rat owner, then the remains of the garment are thrown into the bowl to be consumed by the flames. Muttering strange words under her breath, Nermine picks up the doll, now turning it around and showing it off a little, stroking over the little bumps on its chest - it is a female rat doll, apparently. Picking the piece of orange fabric up that she cut out earlier, the sorceress wraps it around the doll's hips with a flourish, fixating it with a golden safety pin. Then she holds the doll above the bowl and waves it closely over the fire, creating swirls in the smoke. Chanting faster and faster, her words build up to an intense climax, during which Nermine drops the doll into the bowl - to land on a bed of ashes, as the flames instantly are snuffed out.";
	WaitLineBreak;
	say "     Gleefully grinning and showing her teeth as she does so, Nermine pulls the doll out of the bowl and dusts it off a little, then holds it out for you to inspect. It has changed from before, now looking much more realistic and life-like, with hair and fur markings. The female rat shows a fairly shocked expression, and the fabric pinned to it actually looks like a mini-skirt now, with the golden safety pin somehow having become a press-button that holds the tiny garment around the doll's hips. With a wink, Nermine flips up the skirt and shows you that her little totem is anatomically correct too. She strokes over the tiny pussy with the tip of her finger, actually creating a shocked squeak that seems to come from the doll itself. 'It should be only a matter of time,' Nermine says eagerly, then opens a display cabinet and places the doll inside, closing the glass front and then locking it with a delicate key.";
	say "     Moving back around the counter, Nermine presses herself up against your side once more, nuzzling and caressing her beloved [master] so you don't get too bored with waiting. This is quite enjoyable in its own right, meaning that you're actually fairly aroused and focused on her, almost missing the ringing of the bell as the store entrance opens and closes in quick succession. Nermine kisses your mouth one last time, then turns her gaze towards the new arrival: A mall rat who is panting from running here and who looks at the two of you with frightened eyes. Dressed in baggy shorts and an over-sized t-shirt, you're not sure about the gender of your visitor for a second, but as you study the anthro rodent more closely, you spot the tiny bumps of breasts under the fabric of her shirt. 'Nermine is happy to welcome a new visitor to her store. Does the breathless rattess have a wish she wants fulfilled?' your jackaless bitch says in a pointedly friendly tone.";
	WaitLineBreak;
	say "     Catching her breath after a few more seconds, the female mall rat looks wide-eyed at the sorceress, then wails, 'Y-you did this, didn't you? Cast a spell on me! I-I'm sorry, mistress Nermine. Please turn me back. You can do that, right?!' Nermine smirks and strokes the side of her long black muzzle, then replies, 'Perhaps, perhaps. Nermine might know a little thing about what happened to this impudent little rodent that just burst into her store, as well as how to reverse it. The important question is, at which price should she part with this very precious information? But before that - what is the sudden visitor's name?' Gulping, the mall rat replies, 'C-Cole.' Nermine frowns a little, shaking her head. 'The humble storekeeper doesn't think that that actually fits. It is, after all, the name of a male rat. She believes 'Coura' would fit much better.' Frightened, the anthro rat just nods and sobs, 'Yes, mistress. But what about l-lifting the spell?'";
	say "     Nermine strokes a finger along the jawline of her visitor, then takes her by the hand and guides the gender-switched rodent to stand before you. Lifting the small anthro's head to look at you, the jackaless adds, 'There obviously isn't anything of material worth in the rodent's possession, that Nermine is certain of. So maybe the humble storekeeper's beloved [master] should decide about what would be a fitting service in [PosAdj of player] opinion instead.' A toothy smile is sown on her face as she looks at you expectantly.";
	say "[MTFRatSexMenu]";

to say NermineCouraSpell: [this is called from Nermine's talk menu]
	if libido of Danny > 5 and libido of Danny < 8: [still new to it]
		say "     A smile spreads over the black jackaless's muzzle as Nermine listens to your command, then saunters over to the display case where she keeps the mall rat doll. Unlocking it with a small silver key, she reaches in and fastens the tiny orange skirt back around the little rat's hips, which changes it from a male rat to a female rat in the blink of an eye. Moving back around the counter, Nermine presses herself up against your side once more, nuzzling and caressing her beloved [master] so you don't get too bored with waiting. This is quite enjoyable in its own right, meaning that you're actually fairly aroused and focused on her, almost missing the ringing of the bell as the store entrance opens and closes in quick succession. Nermine kisses your mouth one last time, then turns her gaze towards the new arrival: Coura is back, panting from running here and looking at the two of you with frightened eyes.";
		say "     Dressed in baggy shorts and an over-sized t-shirt, you have to look closely to spot the tiny bumps of breasts under the fabric of her shirt. 'Nermine welcomes the little mall rat back to her store. Does the breathless rattess have a wish she wants fulfilled?' your jackaless bitch says in a pointedly friendly tone. Speechlessly gaping at the sorceress for a few seconds, Coura eventually bursts out with the words, 'I-I thought you had... ended your spell. After I did what you wanted. And now I'm back like this!' The sorceress just stands there and smiles at him, letting the trembling mall rat sputter on a little until she runs out of steam. 'Magic can be unpredictable sometimes, the rodent visitor should know. There may exist a way to permanently shake off this spell. Though the humble storekeeper fears that such a precious secret is far too pricey for her visitor right now. But what she can afford is being turned back by rendering a little service. Who knows, maybe it will stick this time.'";
		WaitLineBreak;
		say "     Nermine strokes a finger along the jawline of her visitor, who trembles at the knowledge that she completely is in the jackaless's power. 'Oh. I see. Um... fine, I'll do what you ask. But please turn me back,' Coura says haltingly, and finds herself taken by the hand and guided to stand before you. Lifting the small anthro's head as if to show her off, the jackaless says, 'The humble storekeeper's beloved [master] should decide about what would be a fitting service in [PosAdj of player] opinion.' A toothy smile is sown on her face as she looks at you expectantly.";
	else if libido of Danny > 8 and libido of Danny < 14: [getting used to the transformations]
		say "     A smile spreads over the black jackaless's muzzle as Nermine listens to your command, then saunters over to the display case where she keeps the mall rat doll. Unlocking it with a small silver key, she reaches in and fastens the tiny orange skirt back around the little rat's hips, which changes it from a male rat to a female rat in the blink of an eye. Moving back around the counter, Nermine presses herself up against your side once more, nuzzling and caressing her beloved [master] so you don't get too bored with waiting. This is quite enjoyable in its own right, meaning that you're actually fairly aroused and focused on her, almost missing the ringing of the bell as the store entrance opens and closes in quick succession. Nermine kisses your mouth one last time, then turns her gaze towards the new arrival: Coura is back, panting from running here and looking at the two of you with a cautious expression on her face.";
		say "     Dressed in a tank top and a cute miniskirt, the anthro rat shows off her feminine side quite openly these days. You can see the enticing little bumps of her B-cup breasts under the fabric of her top, and all in all, Coura has also adapted to a different way of holding herself. Walking closer, she sways her hips just a little bit, giving you an enticing glimpse of the fact that all the transformations are leaving a lasting impact on what originally was a regular male rat. 'Nermine welcomes the little mall rat back to her store. Does she -' your jackaless bitch starts to say in a pointedly friendly tone, only to be interrupted by Coura clearing her throat. 'I - um, know what the deal is. No need to go through the motions again. So, what do I need to do for you to turn me back this time?' Raising her eyebrows, Nermine looks at the former male rat for a few seconds, then shrugs off the fact that Coura wants to skip her banter.";
		WaitLineBreak;
		say "     Reaching out to take her visitor by the hand, the black jackaless guides her to stand before you. Lifting the small anthro's head as if to show her off, the jackaless says, 'The humble storekeeper's beloved [master] should decide about what would be a fitting service in [PosAdj of player] opinion.' A toothy smile is sown on her face as she looks at you expectantly.";
	else if libido of Danny > 15: [Cole/Coura can freely shift now]
		if TimekeepingVar is 6 or TimekeepingVar is 5 or TimekeepingVar is 4 or TimekeepingVar is 3 or TimekeepingVar is -2 or TimekeepingVar is -3 or TimekeepingVar is -4 or TimekeepingVar is -5: [Coura at work]
			say "     A smile spreads over the black jackaless's muzzle as Nermine listens to your command, then saunters over to the single door in the back wall. She makes a little gesture with her paw-hand, then pulls the door open to reveal an exceptionally large room beyond. It is filled with shelves and boxes, all of them overstuffed with all sorts of items. You think you even see some cages further back, with living things inside them. Tapping one fingernail against a little bell that is the lowest point of an expansive mobile, the sorceress causes a cascade of ringing sounds that brings Coura hurrying to her from somewhere between the shelves. She has got a bandanna tied around her head right now and is wearing a baggy shirt and shorts. A sensible choice of clothing, given that she has been set to work cleaning through Nermine's mystical storage.";
			say "     'The [master] has need of the rat slut. She shall make herself presentable and join [ObjectPro of player] in the store,' Nermine barks at Coura, a superior smile on her muzzle. Immediately, the rat bows her head in a suitably respectful manner and replies, 'Of course mistress.' Huffing out a breath through her nose, Nermine looks down at her servant girl and throws the words, 'She should best be quick,' at her before turning around. Interestingly, when Nermine's gaze isn't on the young adult mall rat anymore, you see Coura's eyes search you out and a start of a smile crosses her cute little muzzle. She gives a little wave, then steps off to the side, where she seems to have stashed her clothes. A minute or so later, the young woman emerges from the back room, now wearing a tank top and a cute miniskirt. You can see the enticing little bumps of her B-cup breasts under the fabric of her top, and all in all, Coura has also adapted to a different way of holding herself.";
			WaitLineBreak;
			say "     Walking closer, Coura sways her hips just a little bit, giving you an enticing glimpse of the fact that all the transformations are leaving a lasting impact on what originally was a regular male rat. 'Hello [master],' she says to you in a friendly (or maybe even eager?) tone, running her slender fingers from over her breasts all the way down to the lower edge of her skirt and even giving it a little tug upwards before smoothing the fabric again. 'What can I do for you?' Raising her eyebrows, Nermine looks at the former male rat for a few seconds, then shrugs off her disappointment at the fact that Coura is taking the lead these days, freely offering herself instead of having to be pushed to do so.";
		else: [Coura isn't in right now]
			say "     A frown spreads over the muzzle of the black jackaless as Nermine listens to your command, then shakes her head. 'The humble storekeeper is sorry to tell her [master], but Coura is not at work right now. After someone thought it a good idea to free the little slut, she can't be called here at all times anymore.' Looking at you with one raised eyebrow, the bitchy sorceress then turns her attention to sorting through some items on one of the shelves.";
			stop the action; [no sex right now]
	say "[MTFRatSexMenu]";

to say MTFRatSexMenu:
	setmonster "Mall Rat";
	say "     What kind of fun do you want to have with the young adult mall rat?";
	choose row monster from the table of random critters;
	now sextablerun is 0;
	blank out the whole of table of fucking options;
	[]
	choose a blank row in table of fucking options;
	now title entry is "She shall please Nermine orally";
	now sortorder entry is 1;
	now description entry is "Let Coura lick your bitch";
	[]
	if (cunts of player > 0):
		choose a blank row in table of fucking options;
		now title entry is "She will eat your pussy out";
		now sortorder entry is 2;
		now description entry is "Be serviced by Coura's mouth";
	[]
	[
	if (cocks of player > 0):
		choose a blank row in table of fucking options;
		now title entry is "She'll give you a blowjob";
		now sortorder entry is 3;
		now description entry is "Be serviced by Coura's mouth";
	]
	if (cocks of player > 0):
		choose a blank row in table of fucking options;
		now title entry is "You'll fuck her pussy yourself";
		now sortorder entry is 4;
		now description entry is "Pound Coura's pussy";
	[
	if (cocks of player > 0):
		choose a blank row in table of fucking options;
		now title entry is "You'll fuck her ass yourself";
		now sortorder entry is 5;
		now description entry is "Pound Coura's asshole";
	[]
	choose a blank row in table of fucking options;
	now title entry is "Let her service the next customer who comes in";
	now sortorder entry is 6;
	now description entry is "Make Coura orally please some random person";
	[]
	choose a blank row in table of fucking options;
	now title entry is "Offer Coura's pussy to the next customer who comes in";
	now sortorder entry is 7;
	now description entry is "Let some random person fuck Coura";
	[]
	]
	sort the table of fucking options in sortorder order;
	repeat with y running from 1 to number of filled rows in table of fucking options:
		choose row y from the table of fucking options;
		say "[link][y] - [title entry][as][y][end link][line break]";
	say "[link]100 - Nevermind[as]100[end link][line break]";
	while sextablerun is 0:
		say "Pick the corresponding number> [run paragraph on]";
		get a number;
		if calcnumber > 0 and calcnumber <= the number of filled rows in table of fucking options:
			now current menu selection is calcnumber;
			choose row calcnumber in table of fucking options;
			say "[title entry]: [description entry]?";
			if player consents:
				let nam be title entry;
				now sextablerun is 1;
				if nam is "She shall please Nermine orally":
					say "[CouraSex1]";
				else if (nam is "She will eat your pussy out"):
					say "[CouraSex2]";
				else if (nam is "She'll give you a blowjob"):
					say "[CouraSex3]";
				else if (nam is "You'll fuck her pussy yourself"):
					say "[CouraSex4]";
				else if (nam is "You'll fuck her ass yourself"):
					say "[CouraSex5]";
				else if (nam is "Let her service the next customer who comes in"):
					say "[CouraSex6]";
				else if (nam is "Offer Coura's pussy to the next customer who comes in"):
					say "[CouraSex7]";
				if libido of Danny < 6:
					now libido of Danny is 6; [first transformation done]
				else if libido of Danny < 12:
					increase libido of Danny by 1; [counting up on the transformations]
				WaitLineBreak;
		else if calcnumber is 100: [cancel sex menu]
			say "Just let Cole/Coura off scot free for now?";
			if the player consents:
				now sextablerun is 1;
				if libido of Danny < 16: [regular Cole is transformed back and let go]
					say "     As you proclaim that you're not in the mood for anything right now after all, Nermine looks quite disappointed, yet she suppresses her frown after a few seconds and forces herself to say, 'Of course, [master].' Intoning a few tongue-breaking words, she waves her hand over the mall rat, instantly making her features become somewhat more masculine and the small bumps of Coura's breasts disappear from where they were bulging out the t-shirt a tiny bit. 'T-Thank you!' Cole calls out and tries to run outside, only to be stopped short by Nermine's hand tight around his arm. 'The rodent should not think that this matter is over,' she hisses into his large ear, then lets go and glares after him as he flees the store. Nermine whirls around as soon as he is gone, vanishing into the back room to compose herself, clearly pissed off that the anticipation was for naught.";
					if libido of Danny < 6:
						now libido of Danny is 6; [first transformation done]
				else: [freed Coura is sent back to work]
					say "     As you proclaim that you're not in the mood for anything right now after all, Nermine looks quite disappointed, yet she suppresses her frown after a few seconds and forces herself to say, 'Of course, [master].' Turning her attention back to the mall rat standing ready before you, she barks out, 'The slut should get back to work now. Nermine wants [one of]to see the great gong polished to a mirror's shine[or]all of her canopic jars dusted[or]the third shelf sorted alphabetically[or]her living inventory fed[at random] before the mall rat leaves today.' As the jackaless goes to pull the door open once more and shoo Coura through, the mall rat rolls her eyes as soon as Nermine's back is turned, then gives you a little wave as she says goodbye and hurries after Nermine.";
			else:
				say "Pick between 1 and [the number of filled rows in the table of fucking options] or 100 to exit.";
		else:
			say "Invalid Option. Pick between 1 and [the number of filled rows in the table of fucking options].";
	clear the screen and hyperlink list;

to say CouraSex1: [oral for Nermine]
	if libido of Danny > 3 and libido of Danny < 9: [still new to it]
		say "     Smiling at Coura, you pat her head and look into the frightened eyes of the gender-switched mall rat, then proclaim that she shall service Nermine. The young woman blinks in shock and surprise, opening her mouth as if to say something, but you simply wave for her to be quiet and tuck up her baggy t-shirt. A quick pull sees the garment in your hands, then dropped to the floor. This leaves Coura half-naked in front of you, revealing her slender body and the small B-cup breasts that Nermine's spell gave her. As you reach out to cup them and give her a little grope, the mall-rat lets out a sigh of pleasure, the expression on her face showing surprise at how good it feels to be touched like this. Yet you decided that Nermine should be the one to make use of the young woman right now, so before much longer, you spin Coura around and give her a gentle push towards your jackaless bitch.";
		say "     Nermine gives the victim of her spell a toothy smile and lays a hand on the mall rat's shoulder. 'The humble jackaless not only is a storekeeper but also delights in training servants sometime. Her apologetic visitor should remember well the lessons she will receive. Now start licking, little rodent.' Pushing down against Coura, she makes the young woman kneel and draws her head to her crotch, pressing her nose right against her furry mound. Watching with interest, you grin as the former male finds himself so very close to something he and his buddies lusted after - yet in a very different situation than they would ever have expected. Now as a sexy little mall rat girl, Coura starts lapping at Nermine's sex, controlled by the jackaless resting a hand on her head and telling her how to best please a woman.";
		WaitLineBreak;
		say "     Lick for lick, Coura services Nermine to the best of her ability, constantly huffing the aroused scent of the jackal sorceress's pussy. This quite obviously has an effect on the young woman, as she squirms a little in her kneeling position, rubbing her thighs against each other and letting out muffled moans while eating out the black jackal. 'Does the little rodent enjoy servicing her betters?' Nermine asks in a sharp tone, digging her fingers into Coura's hair and pulling her head back to look into the mall rat's eyes. The enspelled rat hesitates for a second, then gives an eager nod in reply. 'Good. She should rise and follow her mistress now,' Nermine adds and turns around to walk over to the store counter, not even having to look back to make sure that Coura follows her close by.";
		say "     Your sexy bitch lifts herself to sit on the edge of the counter, then spreads her legs and gives the mall rat an expectant glance with one raised eyebrow. Coura immediately steps up and starts to lean forward to get back to licking, but Nermine freezes her in motion with a raised hand. 'The trainee rodent really does have much to learn. She may be obedient enough when told, but did she even think about the [master]'s pleasure too?' Glancing your way as she follows Nermine's pointing finger, the anthro rat looks slightly puzzled until Nermine lets out a sigh and adds sharply, 'Strip, girl!' Gulping and nodding hurriedly, Coura turns your way and inexpertly shakes her chest and hips a little while opening the button and zipper of her shorts, letting them fall to the ground a moment later and revealing her slim legs and the matted fur around her pussy. She's wet from the treatment Nermine is putting her through!";
		WaitLineBreak;
		say "     'Better. The girl may resume licking now,' Nermine comments expectantly, letting out a pleased laugh as Coura gets her head between her legs and starts to service her. This leaves you with a nice little view of the young woman, bent over to please Nermine, with her [if CouraVirginity is 0]virgin[else]wet[end if] pussy visible between her legs. Wandering closer, you enjoy the show of having two sexy women naked and at your command. With a grin that you share with Nermine, the next thing you do is reach between the mall rat's legs, stroking over her sex and pulling away your fingers with the wetness of her juices clinging to them. The unexpected touching makes Coura pause again, though not for long, as Nermine simply pushes her head against her crotch and commands her to continue licking. ";
		if cocks of player > 0:
			say "Watching the slender rat service your jackal bitch while presenting her pussy so openly wakes the desire to sink your [cock of player] cock into the enspelled sex toy.";
			LineBreak;
			say "     [bold type]Do you follow those urges?[roman type][line break]";
			LineBreak;
			say "     ([link]Y[as]y[end link]) - Fuck yeah, you want to feel that sweet pussy!";
			say "     ([link]N[as]n[end link]) - Nah, just continue fingering her.";
			if player consents:
				LineBreak;
				say "     Quickly baring your crotch, you stroke the length of your [cock of player] shaft, moving your fingers up and down over its hard length. Coura's own juices work quite nicely to lube yourself up, and you're ready to take the sweet little rodent within moments. Guiding the glistening and slick dickhead to her drippingly wet opening, you step behind the young woman and rub up against her slightly spread nether lips, making her tremble in arousal from the sensations. Coura doesn't expect that this is anything other than just you rubbing her with your hand at first, and she even goes down on Nermine's pussy with a bit more enthusiasm than before, due to the extra stimulation. Only when you nudge apart those enticing folds with your erection and begin to enter her, the realization of what is going to happen strikes the young woman.";
				say "     In a moment of shock, Coura jolts upwards, lifting her head from between Nermine's legs and twisting her upper body to glance back at you as she lets out a surprised squeal. But of course, the most likely reason for that is because the movement actually pushed her hips back against you, meaning that she just impaled herself on another inch or two of you of your manhood all of her own! ";
				if CouraVirginity is 0: [virgin]
					say "The sexy little rodent's pussy is tight as a vice around your erection, which might have something to do with the fact that you feel a hymen inside her! The newly transformed girl is a virgin! Coura apparently only just realized this herself from the stretching sensation in her pussy, and she pants out the words, 'Be gentle, please!' You're not quite sure if you indulge the request because you don't want to be too hard on her, or just to savor to occasion. No matter which, you slow down for a moment and simply rest your shaft inside her, giving the young rodent some time to get used to it.";
					WaitLineBreak;
					say "     Reaching around to out a finger on the clit of Coura's pussy, you rub the pleasure-button of the mall rat with circling movements, all the while gently sliding your hard cock back and forth a little in her pussy. The combined sensations of being stimulated as well as having a hard shaft inside her do quickly push the transformed rodent to letting out soft moans, clearly enjoying the experience. She is panting openly before much longer, which is when you decide that the time has come to make your move and start to press deeper into her. Coura's hymen stretches a little when you push against it, then pull back again, slowly working up the intensity of your shallow thrusts until finally, the thin membrane can't withstand any longer and parts before your invading member. A breathless moan comes from the young woman when she suddenly finds herself fully impaled on your [cock of player] shaft, followed by the gasp of, 'Oh god, that feels amazing! I - I like it!'";
					say "     You wrap your arms around the chest of your mall rat partner, holding onto her slender frame as you grind your cock into the depth of her snatch, savoring the tight confines of Coura's virgin pussy. Then a comment from Nermine makes both of you look up at the black jackaless: 'The little rodent should be very thankful to Nermine's [master] to have claimed her as gently as [SubjectPro of player] chose to do. There were other options, which the storekeeper could have brought in to do the deed. But then, she still could, as an encore. Maybe a certain untamed horseman with a very fat member might teach the rat slut not to neglect her other tasks in the future.' After this pointed reminder of the fact that Coura was supposed to eat her pussy, the mall rat hastily lowers her head once more, pushing it against Nermine's crotch to start licking.";
					WaitLineBreak;
					now CouraVirginity is 1; [no longer virgin]
				else:
					say "The sexy little rodent's pussy is tight as a vice around your erection, which isn't surprising given that she was a virgin only recently. The newly transformed girl pants as she feels the stretching sensation in her pussy, then says, 'Be gentle, please!' You're not quite sure if you indulge the request because you don't want to be too hard on her, or just to savor to occasion. No matter which, you slow down for a moment and simply rest your shaft inside her, giving the young rodent some time to get used to it.";
					WaitLineBreak;
					say "     Reaching around to out a finger on the clit of Coura's pussy, you rub the pleasure-button of the mall rat with circling movements, all the while gently sliding your hard cock back and forth a little in her pussy. The combined sensations of being stimulated as well as having a hard shaft inside her do quickly push the transformed rodent to letting out soft moans, clearly enjoying the experience. She is panting openly before much longer, which is when you decide that the time has come to make your move and start to press deeper into her, sinking yourself fully into her tight snatch. A breathless moan comes from the young woman when she suddenly finds herself impaled on your [cock of player] shaft, followed by the gasp of, 'Oh god, that feels amazing! I - I like it!'";
					say "     You wrap your arms around the chest of your mall rat partner, holding onto her slender frame as you grind your cock into the depth of her pussy, savoring the tight confines inside. Then a comment from Nermine makes both of you look up at the black jackaless: 'The little rodent should be very thankful to Nermine's [master] to have claimed her as gently as [SubjectPro of player] chose to do. There were other options, which the storekeeper could have brought in to do the deed. But then, she still could, as an encore. Maybe a certain untamed horseman with a very fat member might teach the rat slut not to neglect her other tasks in the future.' After this pointed reminder of the fact that Coura was supposed to eat her pussy, the mall rat hastily lowers her head once more, pushing it against Nermine's crotch to start licking.";
				WaitLineBreak;
				say "     While Coura laps at the jackal sorceress's pussy, you fuck her from behind, speeding up your thrusts into her tight confines with each new penetration. Nermine grins in satisfaction at you as the two of you share the victim of her magics between you, making her your sex toy. While you keep fucking the young mall rat with hard and fast movements, Nermine enjoys her tongue, letting out loud moans and pleased yips. 'The rodent girl's mistress is getting quite close now,' the sorceress soon groans, 'She should keep teasing the jackaless's clit throughout her orgasm, and be sure to lick up all the juices that her mistress shares with her for the service she provides.' Reacting to Nermine's command, the slender mall rat goes all out with tonguing her, quickly pushing her closer and closer to the edge, then over it. Now with both hands holding Coura's head down and grinding it against her crotch, Nermine lets out a pleased howl and throws her head back to ride out the sensations that course through her body.";
				say "     Watching the two women who serve at your pleasure with satisfied eyes, you feel yourself getting close to an orgasm too and decide that you want the mall rat to share that moment of pleasure with you. Moving your hand back to her clit, you begin to frig the young woman's clit in a rapid pace, getting her even more hot and bothered than just your shaft made her. Soon, the young adult is moaning into the muff of Nermine's pussy that she is still licking, and her inner muscles twitch and squeeze around your manhood. This is the last little push that you needed to get off, and with a loud grunt, you hammer yourself balls-deep into her, then pump a heavy load of cum right into her depths. As the first splash of seed paints the entrance to her womb white, the mall rat starts to tremble and buck under you, the wave of a powerful orgasm breaking over her just at that moment. Femcum squirts out of her pussy, with some of it trickling down your length to drip down from your balls.";
				WaitLineBreak;
				say "     After some long moments of pleasantly riding out the high of climax, Coura eventually raises her upper body from between Nermine's legs and looks over her shoulder. The movement makes her insides flex around your shaft a little, drawing a grunt of pleasure from you. Seeing the hopeful expression of the young woman as she meets your gaze, you smile and nod in satisfaction. Nermine takes this with great amusement, and says with a smirk, 'Very well. She has pleased Nermine and her [master] sufficiently. Now the rodent slut should pull herself off the [master]'s glorious shaft, if she wants to be turned back.' As Coura does so with a hasty movement that gets your load dripping from her spread folds, the sorceress snaps her fingers audibly, creating an immediate effect on the mall rat.";
				say "     With the bumps of Coura's breasts smoothing out into a more masculine flat chest and her pubic mound being replaced by a soft cock, Cole is back and bursts out with an almost overly enthusiastic thanks to Nermine and yourself. As he moves to collect his clothes and get dressed again, you glance over to where you know the little doll of him is standing. It still is there, just with the little orange skirt now lying at its feet, the push-button that had held it up open. The smirk on Nermine's face as she nods towards it tells you that she can just put the garment back on to restore the spell to full effect. Thinking to what fun you might yet have with Coura/Cole, you barely notice as the mall rat flees from the store, leaving you and Nermine behind.";
			else:
				LineBreak;
				say "[CouraNermineFingering_Novice]";
		else:
			LineBreak;
			say "[CouraNermineFingering_Novice]";
	else if libido of Danny > 8 and libido of Danny < 14: [getting used to the transformations]
		say "     Smiling at Coura, you pat her head and look into the eyes of the gender-switched mall rat, then proclaim that she shall service Nermine. The young woman accepts your order readily and tucks up her tank top, pulling it over her head to reveal her naked breasts to you. As you reach out to cup them and give her a little grope, the mall-rat lets out a sigh of pleasure, the expression on her face showing enjoyment at being touched like this. You're almost tempted to keep her for your own enjoyment, but that'd leave Nermine high and dry, so you eventually spin Coura around and give her a gentle push towards your jackaless bitch. Nermine gives the victim of her spell a toothy smile and lays a hand on the mall rat's shoulder. 'The jackaless is curious on how well her visitor has learned her place by now. Start licking, little rodent.' Pushing down against Coura, she makes the young woman kneel and draws her head to her crotch, pressing her nose right against her furry mound.";
		say "     Watching with interest, you grin as the former male finds himself so very close to something he and his buddies lusted after - yet in a very different situation than they would ever have expected. Now being a sexy little mall rat girl and getting used to the new body too, Coura starts lapping at Nermine's sex, demonstrating enough skill at pleasing the woman that Nermine only gently rests a hand on her head. Lick for lick, Coura services Nermine to the best of her ability, constantly huffing the aroused scent of the jackaless sorceress's pussy. This quite obviously has an effect on the young woman, as she squirms a little in her kneeling position, rubbing her thighs against each other and letting out muffled moans while eating out the black jackal. 'Does the little rodent enjoy servicing her betters?' Nermine asks in a sharp tone, digging her fingers into Coura's hair and pulling her head back to look into the mall rat's eyes.";
		WaitLineBreak;
		say "     The enspelled rat hesitates for a second, then gives an eager nod in reply. 'Good. She should rise and follow her mistress now,' Nermine adds and turns around to walk over to the store counter, not even having to look back to make sure that Coura follows her close by. Your sexy bitch lifts herself to sit on the edge of the counter, then spreads her legs and gives the mall rat an expectant glance with one raised eyebrow. Coura glances from Nermine to yourself and gives you a little wave that is clearly meant to be enticing. Then she starts to sway her hips and chest, making the little bumps of her breasts shake in an interesting way. Her hands wander over her own body, drawing your eyes to sexy curves and erect nipples, then down to her hips where she slowly undoes the fastening of her skirt. A moment later, the garment falls to the ground, revealing her slim legs and the matted fur around her pussy. She's wet in anticipation for what will happen next!";
		say "     'So the girl can learn her place. Very well. She may resume licking now,' Nermine comments expectantly, letting out a pleased laugh as Coura gets her head between her legs and starts to service her. This leaves you with a nice little view of the young woman, bent over to please Nermine, with her [if CouraVirginity is 0]virgin[else]wet[end if] pussy visible between her legs. Wandering closer, you enjoy the show of having two sexy women naked and at your command. With a grin that you share with Nermine, the next thing you do is reach between the mall rat's legs, stroking over her sex and pulling away your fingers with the wetness of her juices clinging to your fingers. The teasing touch makes Coura tremble in lust, raising her ass a little as if begging for more.";
		say "     You play with the young mall rat a little while Nermine enjoys her tongue, letting out loud moans and pleased yips. 'The rodent girl's mistress is getting quite close now,' Nermine soon groans, 'She should keep teasing the jackaless's clit throughout her orgasm, and be sure to lick up all the juices that her mistress shares with her for the service she provides.' Reacting to Nermine's command, the slender mall rat goes all out with tonguing the jackaless, quickly pushing her closer and closer to the edge, then over it. Now with both hands holding Coura's head down and grinding it against her crotch, Nermine lets out a pleased howl and throws her head back to ride out the sensations that course through her body.";
		WaitLineBreak;
		say "     Watching in satisfaction, you observe that while Coura is still being held tight against Nermine's pussy by the jackaless, her own hands quickly move between her legs, frigging the young woman in a rapid pace. It doesn't take long before her masturbation pushes the mall rat over the edge too, legs trembling and hips bucking a little as she squirts out femcum over her stroking hands. After a few long moments in which the two of them slowly wind down from their orgasms, Coura stands up straight again and starts to rub the wet and matted fur on her body. She looks back and forth between Nermine and yourself expectantly, confident in that she did a good enough job so that she'll be transformed back soon. The jackal sorceress seems a bit disappointed that Coura isn't as frightened as she was originally, nodding as she says, 'Very well. She has pleased Nermine and her [master] sufficiently.' Raising her hand, Nermine snaps her fingers audibly, creating an immediate effect on the mall rat.";
		say "     With the bumps of Coura's breasts smoothing out into a more masculine flat chest and her pubic mound being replaced by a soft cock, Cole is back and thanks Nermine. As he moves to collect his clothes and get dressed again, you glance over to where you know the little doll of him is standing. It still is there, just with the little orange skirt now lying at its feet, the push-button that had held it up open. The smirk on Nermine's face as she nods towards it tells you that she can just put the garment back on to restore the spell to full effect. Then your attention is drawn back to Cole, who clears his throat as he stands at the door and is about to leave. Being a male again, he looks somewhat uncomfortable and almost sad in the feminine outfit. 'So, I guess that's it for now? I'll see you guys next time,' he says and leaves the store. You can't quite tell if the undertone in his voice was anticipation or trepidation - maybe a bit of both.";
	else if libido of Danny > 15: [Cole/Coura can freely shift now]
		say "     Smiling at Coura, you pat her head and look into the eyes of the currently female mall rat, then proclaim that she shall service Nermine. The young woman nods to show that she heard your order, then leans forward and whispers, 'Sure you don't want me to take care of someone else?' Her hand moves to gently pat your crotch before the mall rat steps back again and tucks up her tank top. Sliding off the garment, Coura reveals her naked breasts to you, giving them a little shake. As you reach out to cup the small mounds and grope them a bit, she lets out a sigh of pleasure, the expression on her face showing genuine enjoyment at being touched by you. You're almost tempted to accept her suggestion, but that'd leave Nermine high and dry, so you eventually spin Coura around and give her a gentle push towards your jackaless bitch.";
		say "     Nermine gives the victim of her spell a toothy smile and lays a hand on the mall rat's shoulder. 'The rat slut should take care to do her best work, both in servicing her employer as well as showing off to the [master]. Otherwise there will be a need for much more [']employee training['].' Her tone of voice makes those last words sound quite ominous, and you can't help but wonder just what Nermine is doing to Coura when you're not here with them. Whatever it is, the young woman is very quick to obey, falling to her knees and bringing her head to Nermine's crotch. Watching with interest, you grin as the former male finds himself so very close to something he and his buddies lusted after - yet in a very different situation than they would ever have expected. Now being a sexy little mall rat girl, Coura starts lapping at Nermine's sex, skillfully demonstrating how to please a woman. Maybe that was part of the whole [']training['] that Nermine mentioned.";
		WaitLineBreak;
		say "     Lick for lick, Coura services Nermine to the best of her ability, constantly huffing the aroused scent of the jackaless sorceress's pussy. This quite obviously has an effect on the young woman, as she squirms a little in her kneeling position, rubbing her thighs against each other and letting out muffled moans while eating out the black jackal. 'Does the little rodent enjoy servicing her betters?' Nermine asks in a sharp tone, digging her fingers into Coura's hair and pulling her head back to look into the mall rat's eyes. The gaze in the enspelled rat's eyes hardens a little at the rough treatment, but she forces herself to mime a submissive nod in reply. 'Good. Finally Coura is true to her name. Now she shall follow,' Nermine adds and turns around to walk over to the store counter. Your sexy bitch lifts herself to sit on the edge of the counter, then spreads her legs and gives the mall rat an expectant glance with one raised eyebrow.";
		say "     Coura's attention switches from Nermine to yourself for a second, showing a small smile and giving a wave that is clearly meant to be enticing. Then she starts to sway her hips and chest, making the little bumps of her breasts shake in an interesting way. Her hands wander over her own body, drawing your eyes to sexy curves and erect nipples, then down to her hips where she slowly undoes the fastening of her skirt. A moment later, the garment falls to the ground, revealing her slim legs and the matted fur around her pussy. She's wet and aroused from showing off for you! 'Come here slut. Resume licking me,' Nermine throws at the young adult mall rat, apparently getting a little impatient. Or is that a sliver of anger you register in her voice, at the fact that Coura seems to enjoy these acts as long as they concern you and not her?";
		WaitLineBreak;
		say "     Hurrying to obey the sorceress, Coura steps up to Nermine and pushes her head between the black-furred legs of the jackaless, then starts to service her. This leaves you with a nice little view of the young woman, bent over to please Nermine, with her [if CouraVirginity is 0]virgin[else]wet[end if] pussy visible between her legs. Wandering closer, you enjoy the show of having two sexy women naked and at your command. With a grin that you share with Nermine, the next thing you do is reach between the mall rat's legs, stroking over her sex and pulling away your fingers with the wetness of her juices clinging to your fingers. The teasing touch makes Coura tremble in lust, raising her ass a little as if begging for more.";
		say "     You play with the young mall rat a little while Nermine enjoys her tongue, letting out loud moans and pleased yips. 'The rodent girl's mistress is getting quite close now,' Nermine soon groans, 'She should remember to keep teasing the jackaless's clit throughout her orgasm and be sure to lick up all the juices that her mistress shares with her for the service she provides.' Reacting to Nermine's command, the slender mall rat goes all out with tonguing the jackaless, quickly pushing her closer and closer to the edge, then over it. Now with both hands holding Coura's head down and grinding it against her crotch, Nermine lets out a pleased howl and throws her head back to ride out the sensations that course through her body.";
		WaitLineBreak;
		say "     As you are still watching Nermine's full breasts swing back and forth as she rocks a little, trembling in orgasm, you suddenly feel the touch of slender fingers on your hand, down between Coura's thighs. The young woman takes hold of your hand and guides it to rub against her sex further, which you are only too happy to allow. In this way, she masturbates her wet and needy slit together with you, which seems to really push the young woman to a new level. It doesn't take long before she is pushed over the edge, with your fingers buried between her swollen nether lips, stroking Coura's sensitive insides. Her legs tremble and you can feel her hips buck against your hand a little as she squirts out femcum, drenching your fingers in fluid.";
		say "     After a few long moments in which the two of them slowly wind down from their orgasms, Coura pushes herself up from where she was, leaning back against your chest. Looking over her shoulder with a blissful smile on her lips, she coos, 'Thank you [master]. I love it when you touch me.' Then she takes hold of your other hand and guides it to brush over her slender body, caressing the sweat-matted fur of the eager young woman. She relaxes totally into your embrace, happy to just be held. Then suddenly, a low growl makes Coura stiffen in your arms. Nermine is looking at the two of you, brows drawn together as she tries to impale Coura with pointed looks. 'The slut has been sufficient. And now, she should get back to work. Nermine wants [one of]to see the great gong polished to a mirror's shine[or]all of her canopic jars dusted[or]the third shelf sorted alphabetically[or]her living inventory fed[at random] before Coura leaves today.' As the jackaless goes to pull the door to the back room open once more and shoo Coura through, the mall rat rolls her eyes as soon as Nermine's back is turned, then gives you a peck on the lips before hurrying after Nermine.";

to say CouraNermineFingering_Novice:
	say "     You play and tease with the young mall rat a little while Nermine enjoys her tongue, letting out loud moans and pleased yips. 'The rodent girl's mistress is getting quite close now,' Nermine soon groans, 'She should keep teasing the jackaless's clit throughout her orgasm, and be sure to lick up all the juices that her mistress shares with her for the service she provides.' Reacting to Nermine's command, the slender mall rat goes all out with tonguing the jackaless, quickly pushing her closer and closer to the edge, then over it. Now with both hands holding Coura's head down and grinding it against her crotch, Nermine lets out a pleased howl and throws her head back to ride out the sensations that course through her body.";
	WaitLineBreak;
	say "     Watching in satisfaction, you observe that while Coura is still being held tight against Nermine's pussy by the jackaless, her own hands quickly move between her legs, frigging the young woman in a rapid pace. It doesn't take long before her masturbation pushes the mall rat over the edge, legs trembling and hips bucking a little as she squirts out femcum over her stroking hands. After a few long moments in which the two of them slowly wind down from their orgasms, Coura stands up straight again and starts to rub the wet and matted fur on her body self-consciously. She looks pleadingly back and forth between Nermine and yourself, much to the amusement of the jackaless, who keeps her in suspense for a while before she eventually smirks and says, 'Very well. You have pleased us sufficiently.' Raising her hand, the sorceress snaps her fingers audibly, creating an immediate effect on the mall rat.";
	say "     With the bumps of Coura's breasts smoothing out into a more masculine flat chest and her pubic mound being replaced by a soft cock, Cole is back and bursts out with an almost overly enthusiastic thanks to Nermine. As he moves to collect his clothes and get dressed again, you glance over to where you know the little doll of him is standing. It still is there, just with the little orange skirt now lying at its feet, the push-button that had held it up open. The smirk on Nermine's face as she nods towards it tells you that she can just put the garment back on to restore the spell to full effect. Thinking to what fun you might yet have with Coura/Cole, you barely notice as the mall rat flees from the store, leaving you and Nermine behind.";

to say CouraSex2: [oral for player pussy]
	if libido of Danny > 3 and libido of Danny < 9: [still new to it]
		say "     Smiling at Coura, you pat her head and look into the frightened eyes of the gender-switched mall rat, then proclaim that she shall service you orally. The young woman blinks in shock and surprise, opening her mouth as if to say something, but you simply wave for her to be quiet and tuck up her baggy t-shirt. A quick pull sees the garment in your hands, then dropped to the floor. This leaves Coura half-naked in front of you, revealing her slender body and the small B-cup breasts that Nermine's spell gave her. As you reach out to cup them and give her a little grope, the mall-rat lets out a sigh of pleasure, the expression on her face showing surprise at how good it feels to be touched like this. You go on to explore the young woman's body a little while longer, then place both your hands on her shoulders, pressing down gently but firmly.";
		say "     Nermine gives the victim of her spell a toothy smile as she watches you push Coura to her knees and draw the mall rat's head towards your crotch. 'The impudent rodent should be thankful that she is allowed to service Nermine's beloved [master]. Better not disappoint [ObjectPro of player], girl!' With that said, she saunters up to you, pressing her naked form against your side and looking down at the young woman at your feet. Watching with interest, the two of you grin as the former male finds himself so very close to a receptive pussy - yet in a very different situation than they would ever have expected. Now as a sexy little mall rat girl, Coura starts lapping at your sex, controlled by your a hand on her head and Nermine giving directions on how to best please a woman.";
		WaitLineBreak;
		say "     Lick for lick, Coura services you to the best of her ability, constantly huffing the aroused scent of your dripping sex. This quite obviously has an effect on the young woman, as she squirms a little in her kneeling position, rubbing her thighs against each other and letting out muffled moans while eating out your pussy. 'Does the little rodent enjoy servicing her betters?' Nermine asks in a sharp tone, sliding her hand under yours to grab a handful of Coura's hair. She pulls the anthro rat's head back to look into her eyes. The enspelled former male hesitates for a second, then gives an eager nod in reply. 'Good. And now, Nermine thinks that her [master] might enjoy a change in positions?' The jackaless looks at you with an eager gleam in her eyes and you give her the nod to go ahead, curious about where she'll take this.";
		say "     'Follow,' the sorceress commands the mall rat and walks deeper into the store, to the large bean-bag chair in the midst of all the clutter. Coura eyes it curiously, then moves as if to sit on the unconventional chair, only to be stopped by Nermine's outstretched hand. 'The trainee rodent really does have much to learn. She may be obedient enough when told, but she should start to anticipate ways to give the [master] pleasure better. Strip, girl!' Gulping and nodding hurriedly, Coura turns your way and inexpertly shakes her chest and hips a little while opening the button and zipper of her shorts, letting them fall to the ground a moment later and revealing her slim legs and the matted fur around her pussy. She's wet from the treatment Nermine is putting her through!";
		WaitLineBreak;
		say "     'Better. Now the girl shall lay down,' Nermine comments expectantly, indicating where Coura should place herself: lying on her back, stretched out over the bean-bag and with her head fairly low on its sloping shape. 'She is ready [master],' the jackaless adds to you a moment later, inviting you to mount the rat. Beads from the chair make a rustling noise under your knees as you get on the large bag, placing your pussy right above her head. Knowing what is expected from her, Coura is quick enough to start licking, sending tingles of pleasure through your body. Standing right by your side, Nermine leans over to kiss your cheek, then suggests in an eager tone, 'This worshipful bitch would like to suggest playing with the submissive rat a bit. She is sure to be sensitive and receptive to even the littlest touch right now. This could provide much fun.'";
		say "     To demonstrate, the jackaless reaches out to stroke a fingertip over Coura's clit, making the young woman buck under you and moan with her tongue trembling against your pussy. Taking over from Nermine, you lean forward to check out Coura's slender hips and dripping pussy on your own, moving one hand to rest on it. Over the next little while, your experimentation with teasing strokes, gentle pinches and even a lick or two yields quite pleasurable results, as the mall rat reacts quite actively to every touch, moaning helplessly while she eats you out. Eventually escalating things to pumping two fingers in and out of her pussy[if CouraVirginity is 0], feeling the stretchy barrier of her intact hymen inside, [else] [end if]you animate your partner to frantic licks of your own sex, driving both of you closer and closer to orgasm. Then suddenly, you hear a breathless moan from between your legs and she bucks under you, femcum starting to trickle over your thrusting fingers.";
		WaitLineBreak;
		say "     The satisfaction of pushing your little rodent slut over the edge is the last straw you yourself needed to reach the point of no return, and with a groan, you come hard, squirting your juices straight onto the licking tongue pressed against your sex. Under the watching eyes of a grinning Nermine, both Coura and yourself ride out your mutual orgasms, with copious amounts of femcum [if cocks of player > 0]and the streaks of regular cum from your erection [end if]matting the short fur of your mall rat partner. When you are eventually back in control of your full faculties, with your body goes through a few more trembles as the pleasure ebbs off, your black jackal bitch offers you a hand to help you stand back up. She embraces you and gives you a long kiss, then pulls back and says, 'Did Nermine's [master] enjoy using the rodent toy?' Your broad grin is the only answer she needs.";
		say "     While you and your jackaless continue to make out a bit, Coura gets up from the bean-bag and collects her clothes, then eventually comes to stand next to you and shyly clears her throat. She looks pleadingly back and forth between Nermine and yourself, much to the amusement of the jackaless, who keeps her in suspense for a while before she eventually smirks and says, 'Very well. She has pleased Nermine and her [master] sufficiently.' Raising her hand, the sorceress snaps her fingers audibly, creating an immediate effect on the mall rat. The small bumps visible under the loose shirt Coura wears smooth out, marking the return of Cole. He bursts out with an almost overly enthusiastic thanks to Nermine, then quickly makes his way to the entrance and flees from the store before anything else happens to him. As he flees, you glance over to where you know the little doll of him is standing. It still is there, just with the little orange skirt now lying at its feet, the push-button that had held it up open. The smirk on Nermine's face as she nods towards it tells you that she can just put the garment back on to restore the spell to full effect.";
	else if libido of Danny > 8 and libido of Danny < 14: [getting used to the transformations]
		say "     Smiling at Coura, you pat her head and look into the frightened eyes of the gender-switched mall rat, then proclaim that she shall service you orally. The young woman accepts your order readily and tucks up her tank top, pulling it over her head to reveal her naked breasts to you. As you reach out to cup them and give her a little grope, the mall-rat lets out a sigh of pleasure, the expression on her face showing enjoyment at being touched like this. You go on to explore the young woman's body a little while longer, then place both your hands on her shoulders, pressing down gently but firmly. Nermine gives the victim of her spell a toothy smile as she watches you push Coura to her knees and draw the mall rat's head towards your crotch. 'The impudent rodent should be thankful that she is allowed to service Nermine's beloved [master]. Better not disappoint [ObjectPro of player], girl!'";
		say "     With that said, she saunters up to you, pressing her naked form against your side and looking down at the young woman at your feet. Watching with interest, the two of you grin as the former male finds himself so very close to a receptive pussy - yet in a very different situation than they would ever have expected. Now as a sexy little mall rat girl, Coura starts lapping at your sex with some skill, controlled by your a hand on her head, and with Nermine commenting that she might be worth something at giving oral pleasure after all. Lick for lick, Coura services you to the best of her ability, constantly huffing the aroused scent of your dripping sex. This quite obviously has an effect on the young woman, as she squirms a little in her kneeling position, rubbing her thighs against each other and letting out muffled moans while eating out your pussy.";
		WaitLineBreak;
		say "     'Does the little rodent enjoy servicing her betters?' Nermine asks in a sharp tone, sliding her hand under yours to grab a handful of Coura's hair. She pulls the anthro rat's head back to look into her eyes. The enspelled former male hesitates for a second, then gives an eager nod in reply. 'Good. And now, Nermine thinks that her [master] might enjoy a change in positions?' The jackaless looks at you with an eager gleam in her eyes and you give her the nod to go ahead, curious about where she'll take this. 'Follow,' the sorceress commands the mall rat and walks deeper into the store, to the large bean-bag chair in the midst of all the clutter. Coura eyes the unconventional chair, then nods to Nermine and turns her attention to you, giving a little wave that is clearly meant to be enticing.";
		say "     Coura starts to sway her hips and chest, making the little bumps of her breasts shake in an interesting way. Her hands wander over her own body, drawing your eyes to sexy curves and erect nipples, then down to her hips where she slowly undoes the fastening of her skirt. A moment later, the garment falls to the ground, revealing her slim legs and the matted fur around her pussy. She's wet in anticipation for what will happen next! 'So the girl can learn her place. Very well. She may lay down now,' Nermine comments expectantly, letting out a pleased laugh as Coura gets onto the bean-bag and stretches herself out on it on her back. With its sloping shape, her head is fairly low and in a position that gives some nice options. 'She is ready [master],' the jackaless tells you, inviting you to mount the rat.";
		WaitLineBreak;
		say "     Beads from the chair make a rustling noise under your knees as you get on the large bag, placing your pussy right above Coura's head. Knowing quite well what is expected from her by now, Coura immediately starts licking, sending tingles of pleasure through your body. Standing right by your side, Nermine leans over to kiss your cheek, then suggests in an eager tone, 'This worshipful bitch would like to suggest playing with the submissive rat a bit. She is sure to be sensitive and receptive to even the littlest touch right now. This could provide much fun.' To demonstrate, the jackaless reaches out to stroke a fingertip over Coura's clit, making the young woman buck under you and moan with her tongue trembling against your pussy.";
		say "     Taking over from Nermine, you lean forward to check out Coura's slender hips and dripping pussy on your own, moving one hand to rest on it. Over the next little while, your experimentation with teasing strokes, gentle pinches and even a lick or two yields quite pleasurable results, as the mall rat reacts quite actively to every touch, moaning helplessly while she eats you out. Eventually escalating things to pumping two fingers in and out of her pussy[if CouraVirginity is 0], feeling the stretchy barrier of her intact hymen inside, [else] [end if]you animate your partner to frantic licks of your own sex, driving both of you closer and closer to orgasm. Then suddenly, you hear a breathless moan from between your legs and she bucks under you, femcum starting to trickle over your thrusting fingers.";
		WaitLineBreak;
		say "     The satisfaction of pushing your little rodent slut over the edge is the last straw you yourself needed to reach the point of no return, and with a groan, you come hard, squirting your juices straight onto the licking tongue pressed against your sex. Under the watching eyes of a grinning Nermine, both Coura and yourself ride out your mutual orgasms, with copious amounts of femcum [if cocks of player > 0]and the streaks of regular cum from your erection [end if]matting the short fur of your mall rat partner. When you are eventually back in control of your full faculties, with your body goes through a few more trembles as the pleasure ebbs off, your black jackal bitch offers you a hand to help you stand back up. She embraces you and gives you a long kiss, then pulls back and says, 'Did Nermine's [master] enjoy using the rodent toy?' Your broad grin is the only answer she needs.";
		say "     While you and your jackaless continue to make out a bit, Coura gets up from the bean-bag and collects her clothes, then eventually comes to stand next to you and shyly clears her throat. She looks back and forth between Nermine and yourself expectantly, confident in that she did a good enough job so that she'll be transformed back soon. The jackal sorceress seems a bit disappointed that Coura isn't as frightened as she was originally, nodding as she says, 'Very well. She has pleased Nermine and her [master] sufficiently.' Raising her hand, the sorceress snaps her fingers audibly, creating an immediate effect on the mall rat. Her tank top flattens out as the small bumps of Coura's B-cup breasts vanish and you think you can see a little bulge grow under her skirt. Being a male again, Coura - or Cole now - looks somewhat uncomfortable and almost sad in the feminine outfit. 'So, I guess that's it for now? I'll see you guys next time,' he says and leaves the store. You can't quite tell if the undertone in his voice was anticipation or trepidation - maybe a bit of both.";
	else if libido of Danny > 15: [Cole/Coura can freely shift now]
		say "     Brushing a hand through the hair of your rodent sex toy, you pull her closer to your crotch until that petite nose of hers is buried in your pubes and you can feel Coura's whiskers tickle your skin. She's clearly quite motivated for giving you a nice time, immediately starting to lap at your sex with some skill, controlled by your a hand on her head, and with even Nermine commenting that she might be worth something at giving oral pleasure after all. Lick for lick, Coura services you to the best of her ability, constantly huffing the aroused scent of your dripping sex. This quite obviously has an effect on the young woman, as she squirms a little in her kneeling position, rubbing her thighs against each other and letting out muffled moans while eating out your pussy.";
		say "     Smiling at Coura, you pat her head and look into the eager eyes of the female mall rat, then proclaim that she shall service you orally. The young woman smiles happily and leans forward to plant a peck on your lips, then tucks up her tank top. With a quick movement, the garment is up over her head and gets thrown to the side, revealing her naked breasts to you. As you reach out to cup them and give her a little grope, the mall-rat lets out a sigh of pleasure, the expression on her face showing genuine enjoyment at being touched like this. You go on to explore the young woman's body a little while longer, touching and caressing her. Then eventually, Coura sinks down to her knees of her own accord, bringing her head to the height of your crotch. From there, she looks up in a worshipful way and moans, 'I'm ready for you [master].' With that said, she opens her mouth and flicks the tip of her tongue over your clit in a teasing touch, then waits for you to make the next move.";
		WaitLineBreak;
		say "     'Does the little rodent enjoy servicing her betters?' Nermine asks in a sharp tone, sliding her hand under yours to grab a handful of Coura's hair. She pulls the anthro rat's head back sharply to look into her eyes. The mall rat hesitates for a heartbeat, her eyes searching you out instead of Nermine as she gives an eager nod in reply. 'Good. And now, Nermine thinks that her [master] might enjoy a change in positions?' The jackaless looks at you with an eager gleam in her eyes and you give her the nod to go ahead, curious about where she'll take this. 'Follow,' the sorceress commands the mall rat and walks deeper into the store, to the large bean-bag chair in the midst of all the clutter. Coura eyes the unconventional chair, then nods to Nermine and turns her attention to you, giving a little wave that is clearly meant to be enticing.";
		say "     Coura starts to sway her hips and chest, making the little bumps of her breasts shake in an interesting way. Her hands wander over her own body, drawing your eyes to sexy curves and erect nipples, then down to her hips where she slowly undoes the fastening of her skirt. A moment later, the garment falls to the ground, revealing her slim legs and the matted fur around her pussy. She's wet in anticipation of going down on you! 'About time that girl learned her place. Very well. She may lay down now,' Nermine comments expectantly, letting out a chuckle as Coura gets onto the bean-bag and stretches herself out on it on her back. With its sloping shape, her head is fairly low and in a position that gives some nice options. 'She is ready [master],' the jackaless tells you, inviting you to mount the rat.";
		WaitLineBreak;
		say "     Beads from the chair make a rustling noise under your knees as you get on the large bag, placing your pussy right above Coura's head. Ready and willing to please the person who gave her at least part of her freedom back, Coura immediately starts licking, sending tingles of pleasure through your body. Standing right by your side, Nermine leans over to kiss your cheek, then suggests in an eager tone, 'This worshipful bitch would like to suggest playing with the submissive rat a bit. She is sure to be sensitive and receptive to even the littlest touch right now. This could provide much fun.' To demonstrate, the jackaless reaches out to stroke a fingertip over Coura's clit, making the young woman buck under you and moan with her tongue trembling against your pussy.";
		say "     Taking over from Nermine, you lean forward to check out Coura's slender hips and dripping pussy on your own, moving one hand to rest on it. Over the next little while, your experimentation with teasing strokes, gentle pinches and even a lick or two yields quite pleasurable results, as the mall rat reacts quite actively to every touch, moaning helplessly while she eats you out. Eventually escalating things to pumping two fingers in and out of her pussy[if CouraVirginity is 0], feeling the stretchy barrier of her intact hymen inside, [else] [end if]you animate your partner to frantic licks of your own sex, driving both of you closer and closer to orgasm. Then suddenly, you hear a breathless moan from between your legs and she bucks under you, femcum starting to trickle over your thrusting fingers.";
		WaitLineBreak;
		say "     The satisfaction of pushing your little rodent slut over the edge is the last straw you yourself needed to reach the point of no return, and with a groan, you come hard, squirting your juices straight onto the licking tongue pressed against your sex. Under the watching eyes of a grinning Nermine, both Coura and yourself ride out your mutual orgasms, with copious amounts of femcum [if cocks of player > 0]and the streaks of regular cum from your erection [end if]matting the short fur of your mall rat partner. When you are eventually back in control of your full faculties, with your body goes through a few more trembles as the pleasure ebbs off, your black jackal bitch offers you a hand to help you stand back up. She embraces you and gives you a long kiss, then pulls back and says, 'Did Nermine's [master] enjoy using the rodent toy?' Your broad grin is the only answer she needs.";
		say "     While you and your jackaless continue to make out a bit, Coura gets up from the bean-bag and collects her clothes. She doesn't put them on yet though, instead standing next to Nermine and yourself and strikes a pose that you can see past the bitch in your arms, eager to get some attention from you herself. The mall rat girl plays up her sexy cuteness to perfection, enticing you to let go of Nermine after another deep kiss, then drawing Coura into your arms to make out with her in turn. After a pleasant little while of kissing and touching the young woman, Coura coos, 'Thank you [master]. I love being with you.' Then suddenly, a low growl from right besides you makes Coura stiffen in your arms. It comes from Nermine, looking at the two of you, brows drawn together as she tries to impale Coura with pointed looks.";
		WaitLineBreak;
		say "     Less than pleased with the sudden turn that your attention has taken, the jackaless sorceress hisses to Coura, 'The slut has been sufficient. And now, she should get back to work. Nermine wants [one of]to see the great gong polished to a mirror's shine[or]all of her canopic jars dusted[or]the third shelf sorted alphabetically[or]her living inventory fed[at random] before her employee leaves today.' As the jackaless goes to pull the door to the back room open once more and shoo Coura through, the mall rat rolls her eyes as soon as Nermine's back is turned, then gives you a peck on the lips before hurrying after Nermine.";

to say CouraSex3: [BJ for player cock]
	if libido of Danny > 3 and libido of Danny < 9: [still new to it]
		say "     ...";
	else if libido of Danny > 8 and libido of Danny < 14: [getting used to the transformations]
		say "     ...";
	else if libido of Danny > 15: [Cole/Coura can freely shift now]
		say "     <WIP>";
		say "     Smiling at Coura, you pat her head and look into the eager eyes of the female mall rat, then proclaim that she shall service you orally. The young woman smiles happily and leans forward to plant a peck on your lips, then tucks up her tank top. With a quick movement, the garment is up over her head and gets thrown to the side, revealing her naked breasts to you. As you reach out to cup them and give her a little grope, the mall-rat lets out a sigh of pleasure, the expression on her face showing genuine enjoyment at being touched like this. You go on to explore the young woman's body a little while longer, touching and caressing her. Then eventually, Coura sinks down to her knees of her own accord, bringing her head to the height of your crotch. From there, she looks up in a worshipful way and moans, 'I'm ready for you [master].' With that said, she opens her mouth and flicks the tip of her tongue over your dickhead, then sits ready for you to make the next move.";
		say "     Brushing a hand through the hair of your rodent sex toy, you pull her closer to your crotch and slide those lips down on the length of your [cock of player] erection. Taking in your cock with a surprising amount of skill for someone who was a straight male not too long ago, she doesn't bat an eyelash at deep-throating your length. Soon, her petite nose is buried in your pubes and you can feel Coura's whiskers tickle your skin. She's clearly quite motivated for giving you a nice time, so you ...";

to say CouraSex4: [player fucks her pussy]
	if libido of Danny > 3 and libido of Danny < 9: [still new to it]
		say "     Smiling at Coura, you pat her head and look into the frightened eyes of the gender-switched mall rat, then proclaim that she shall service Nermine. The young woman blinks in shock and surprise, opening her mouth as if to say something, but you simply wave for her to be quiet and tuck up her baggy t-shirt. A quick pull sees the garment in your hands, then dropped to the floor. This leaves Coura half-naked in front of you, revealing her slender body and the small B-cup breasts that Nermine's spell gave her. As you reach out to cup them and give her a little grope, the mall-rat lets out a sigh of pleasure, the expression on her face showing surprise at how good it feels to be touched like this. While you play with Coura's breasts, Nermine watches for a few moments with a gleeful expression, then steps up to the mall rat's side.";
		say "     Leaning in to put her muzzle right next to the mall rat's ear, she tells the young adult in an exaggeratedly sweet voice, 'The apologetic visitor is about to receive a great honor.' Placing a hand on Coura's side, she lets it slide down and over her flat belly, to come to rest right over the mall rat's pubic mound. After undoing the button of her shorts and letting them drop to the floor, Nermine adds, 'The jackaless can tell that her [master] wants to enjoy this slutty rat's pussy next.' With that said, the black jackaless spreads Coura's outer folds with her fingers, rubbing their sensitive outlines and dipping in the tip of one digit. Your enspelled sex toy sighs and moans as two people are now touching her, reacting with pleasure to the stimulation, yet also unsure about the situation and biting her lip as she is unsure if she should say anything.";
		WaitLineBreak;
		say "     Nermine rubs Coura's pussy and gets her wet and dripping, then soon raises her hand and holds it out to the young woman, right in front of her face. It only takes a single pointed look with a raised eyebrow for the mall rat to understand what she is being asked to do, and Coura sucks her juices off Nermine's fingers right away. 'Good. And now, Nermine thinks that her [master] might enjoy a change in positions?' The jackaless looks at you with an eager gleam in her eyes and you give her the nod to go ahead, curious about where she'll take this. 'Follow,' the sorceress commands the mall rat and walks deeper into the store, to the large bean-bag chair in the midst of all the clutter. Coura eyes it curiously, then moves to sit in the unconventional chair, with Nermine pushing her backwards so she is more lying than sitting on it. 'Spread your legs to receive the [master], girl!' comes a fresh command right after that.";
		say "     Gulping and nodding hurriedly, Coura lifts her slender legs and parts them wide, her gaze on you. This puts her crotch on full display, including the matted fur around her pussy. She's wet from the treatment Nermine put her through! Eager to enjoy the young woman that Nermine is so artfully presenting for your pleasure, you walk over to the bean bag yourself and then [SelfStripCrotch]. Wrapping a hand around your [cock of player] shaft, you get into position on top of Coura, brushing it against the slightly open lips of her sex and feeling the wetness of her arousal on your skin. At this point, the young adult rodent finally breaks her silence, letting out a helpless little moan, followed by the words, 'Be gentle, please!' ";
		if CouraVirginity is 0: [virgin]
			say "It isn't too surprising that she is a little anxious about getting fucked - she is a virgin after all. You're not quite sure if you indulge the request because you don't want to be too hard on her, or just to savor to occasion. No matter which, you push your shaft into her slowly, stopping right away as you feel the flexible barrier of her hymen against your head. For a moment, you simply rest your [cock of player] erection inside her, giving the young rodent some time to get used to it.";
			WaitLineBreak;
			say "     Nermine embraces you from behind as you wait, licking your cheek in affection. You can feel her breasts press against your back as the naked jackaless plasters herself against you and says, 'The [master] of Nermine is very generous with [PosAdj of player] sex toys today. It cannot be easy to resist thrusting hard into the slut of a rat. To fuck her deep and mercilessly.' Ignoring the tempting whispers of your bitchy sorceress for now, you only put your finger on the clit of Coura's pussy, rubbing her pleasure-button with circling movements, all the while gently sliding your hard cock back and forth a little in her pussy. The combined sensations of being stimulated as well as having a hard shaft inside her do quickly push the transformed rodent to letting out soft moans, clearly enjoying the experience. She is panting openly before much longer, which is when you decide that the time has come to make your move and start to press deeper into her.";
			say "     Coura's hymen stretches a little when you push against it, then pull back again, slowly working up the intensity of your shallow thrusts until finally, the thin membrane can't withstand any longer and parts before your invading member. A breathless moan comes from the young woman when she suddenly finds herself fully impaled on your [cock of player] shaft, followed by the gasp of, 'Oh god, that feels amazing! I - I like it!'";
			say "     You wrap your arms around the chest of your mall rat partner, pulling her slender frame against your body as you grind your cock into the depth of her snatch, savoring the tight confines of Coura's virgin pussy. A barbed little comment from the jackaless makes you look aside for a second: 'The little rodent should be very thankful to Nermine's [master] to have claimed her virginity as gently as [SubjectPro of player] chose to do. There were other options, which the storekeeper could have brought in to do the deed. A certain untamed horseman with a very fat member comes to mind. No matter now, as long as the rat slut accepts that this is what she was made to be.' After this short distraction from your rather vengeful jackal bitch, you turn your attention back to Coura, savoring the young woman's pussy to the fullest.";
			now CouraVirginity is 1; [no longer virgin]
		else:
			say "It isn't too surprising that she is a little anxious about getting fucked - she only recently became a woman after all. You're not quite sure if you indulge the request because you don't want to be too hard on her, or just to savor to occasion. No matter which, you push your shaft into her slowly and stop in motion once you feel your balls against her crotch fur. For a moment, you simply rest your [cock of player] erection inside her, giving the young rodent some time to get used to it.";
			WaitLineBreak;
			say "     Nermine embraces you from behind as you wait, licking your cheek in affection. You can feel her breasts press against your back as the naked jackaless plasters herself against you and says, 'The [master] of Nermine is very generous with [PosAdj of player] sex toys today. It cannot be easy to resist thrusting hard into the slut of a rat. To fuck her deep and mercilessly.' Ignoring the tempting whispers of your bitchy sorceress for now, you only put your finger on the clit of Coura's pussy, rubbing her pleasure-button with circling movements, all the while gently sliding your hard cock back and forth a little in her pussy. The combined sensations of being stimulated as well as having a hard shaft inside her do quickly push the transformed rodent to letting out soft moans, clearly enjoying the experience. She is panting openly before much longer, which is when you decide that the time has come to make your move.";
			say "     A breathless moan comes from the young woman when you pull out almost all of the way and thrust all the way back inside, impaling her on your [cock of player] shaft. Coura lets out a gasp of, 'Oh god, that feels amazing! I - I like it!' You wrap your arms around the chest of your mall rat partner, pulling her slender frame against your body as you grind your cock into the depth of her snatch, savoring the tight confines of Coura's pussy. A barbed little comment from the jackaless makes you look aside for a second: 'The little rodent should be very thankful to Nermine's [master] to have claimed her as gently as [SubjectPro of player] chose to do. There were other options, which the storekeeper could have brought in to do the deed. A certain untamed horseman with a very fat member comes to mind. No matter now, as long as the rat slut accepts that this is what she was made to be.' After this short distraction from your rather vengeful jackal bitch, you turn your attention back to Coura, savoring the young woman's pussy to the fullest.";
		WaitLineBreak;
		say "     While Coura clutches onto you with both arms and legs, you fuck her pussy with fast and deep strokes, speeding up your thrusts into her tight confines with each new penetration. Nermine grins in satisfaction as you plow the victim of her magics, cementing Coura's status as your sex toy. The moans of the transformed mall rat are music to your ears, telling you that even though she didn't really have a choice, the young woman nevertheless enjoys being taken by you. Between her tight pussy around your shaft, her warm body against your naked skin and the scent of a very horny anthro rat in your nose, you feel yourself getting close to an orgasm before much longer. Deciding that you want the mall rat to share that moment of pleasure with you, you move your hand down to her clit and begin to frig the young woman's clit in a rapid pace, getting her even more hot and bothered.";
		say "     Soon, the young adult is panting out pleas to take her deeper, harder and more forcefully, and she trembles in the embrace of your arms as she is about to come. With the moment you waited for finally arrived, you abandon any restraint that you put on yourself and hammer balls-deep into her, grunting loudly as you pump a heavy load of cum right into her depths. As the first splash of seed paints the entrance to Coura's womb white, the mall rat bucks uncontrollably under you, the wave of a powerful orgasm breaking over her just at that moment. Femcum squirts out of her pussy, with some of it trickling down your length to drip down from your balls.";
		WaitLineBreak;
		say "     After some long moments of riding out the high of climax, the death-grip of Coura's arms around your chest eventually slackens and she lets herself fall back onto the beanbag chair, panting and exhausted. The movement makes her insides flex around your shaft a little, drawing a grunt of pleasure from you. Seeing the satisfied and hopeful expression of the young woman as she meets your gaze, you smile and nod, then lean forward to plant a kiss on her lips. Nermine takes this with great amusement, and says with a smirk, 'Very well. The rat has pleased Nermine and her [master] sufficiently.' As you pull out of Coura and stand up, leaving the mall rat with your load dripping from her spread folds, the sorceress snaps her fingers audibly, creating an immediate effect.";
		say "     With the bumps of Coura's breasts smoothing out into a more masculine flat chest and her pubic mound being replaced by a soft cock, Cole is back and bursts out with an almost overly enthusiastic thanks to Nermine and yourself. As he moves to collect his clothes and get dressed again, you glance over to where you know the little doll of him is standing. It still is there, just with the little orange skirt now lying at its feet, the push-button that had held it up open. The smirk on Nermine's face as she nods towards it tells you that she can just put the garment back on to restore the spell to full effect. Thinking to what fun you might yet have with Coura/Cole, you barely notice as the mall rat flees from the store, leaving you and Nermine behind.";
	else if libido of Danny > 8 and libido of Danny < 14: [getting used to the transformations]
		say "     Smiling at Coura, you pat her head and look into the frightened eyes of the gender-switched mall rat, then proclaim that you want to fuck her. The young woman accepts your order readily and tucks up her tank top, pulling it over her head to reveal her naked breasts to you. As you reach out to cup them and give her a little grope, the mall-rat lets out a sigh of pleasure, the expression on her face showing enjoyment at being touched like this. While you play with Coura's breasts, Nermine watches for a few moments with a gleeful expression, then steps up to the mall rat's side. Leaning in to put her muzzle right next to the mall rat's ear, she tells the young adult in an exaggeratedly sweet voice, 'The apologetic visitor is about to receive a great honor.' Placing a hand on Coura's side, she lets it slide down and over her flat belly, to come to rest right over the mall rat's pubic mound.";
		say "     After undoing the buttons of her skirt and letting it drop to the floor, Nermine adds, 'The jackaless will get the slutty rat's pussy ready for her [master].' With that said, she spreads Coura's outer folds with her fingers, rubbing their sensitive outlines and dipping in the tip of one digit. Your enspelled sex toy sighs and moans as two people are now touching her, reacting with pleasure to the stimulation, well-used to being here to service you by now. Nermine rubs Coura's pussy and gets her wet and dripping, then soon raises her hand and holds it out to the young woman, right in front of her face. Coura immediately sucks her own juices off Nermine's fingers, reacting to the unspoken command. Swallowing and then looking you right in the eye, the mall rat then clears her throat and asks, 'Shall I - uhm, get into position for you?' Smiling at her readiness to serve, you slide one hand up to her neck and pull her in for a quick kiss on the lips, then tell the young adult rodent to go ahead.";
		WaitLineBreak;
		say "     As the naked mall rat walks off towards the big bean-bag chair in the back of the store, Nermine watches her go with a predatory smile on her muzzle. 'Is it not beautiful when pets do know their place and anticipate the [master]'s wishes?' she says in a satisfied tone, revelling in the ability to lord over Coura, even as she herself has become your obedient bitch. Meanwhile, Coura has arrived at the unconventional chair and has laindown upon it, spreading her legs wide as she does so. This puts her crotch on full display, including the matted fur around her pussy. She's already wet! Eager to enjoy the young woman, you walk over to the bean bag yourself and then [SelfStripCrotch]. Wrapping a hand around your [cock of player] shaft, you get into position on top of Coura, brushing it against the slightly open lips of her sex and feeling the wetness of her arousal on your skin. At this point, the young adult rodent lets out an aroused moan, followed by the words, 'Could you please be gentle, at least at the start?'";
		if CouraVirginity is 0: [virgin]
			say "     It isn't too surprising that she is a little anxious about getting fucked - she is a virgin after all. You're not quite sure if you indulge the request because you don't want to be too hard on her, or just to savor to occasion. No matter which, you push your shaft into her slowly, stopping right away as you feel the flexible barrier of her hymen against your head. For a moment, you simply rest your [cock of player] erection inside her, giving the young rodent some time to get used to it. Nermine embraces you from behind as you wait, licking your cheek in affection. You can feel her breasts press against your back as the naked jackaless plasters herself against you and says, 'The [master] of Nermine is very generous with [PosAdj of player] sex toys today. It cannot be easy to resist thrusting hard into the slut of a rat. To fuck her deep and mercilessly.'";
			WaitLineBreak;
			say "     Ignoring the tempting whispers of your bitchy sorceress for now, you only put your finger on the clit of Coura's pussy, rubbing her pleasure-button with circling movements, all the while gently sliding your hard cock back and forth a little in her pussy. The combined sensations of being stimulated as well as having a hard shaft inside her do quickly push the transformed rodent to letting out eager moans, clearly enjoying the experience. She is panting openly before much longer, which is when you decide that the time has come to make your move and start to press deeper into her. Coura's hymen stretches a little when you push against it, then pull back again, slowly working up the intensity of your shallow thrusts until finally, the thin membrane can't withstand any longer and parts before your invading member. A breathless moan comes from the young woman when she suddenly finds herself fully impaled on your [cock of player] shaft, followed by the gasp of, 'Oh god, that feels amazing! I - I like it!'";
			say "     You wrap your arms around the chest of your mall rat partner, pulling her slender frame against your body as you grind your cock into the depth of her snatch, savoring the tight confines of Coura's virgin pussy. A barbed little comment from the jackaless makes you look aside for a second: 'The little rodent should be very thankful to Nermine's [master] to have claimed her virginity as gently as [SubjectPro of player] chose to do. There were other options, which the storekeeper could have brought in to do the deed. A certain untamed horseman with a very fat member comes to mind. No matter now, as long as the rat slut accepts that this is what she was made to be.' After this short distraction from your rather vengeful jackal bitch, you turn your attention back to Coura, savoring the young woman's pussy to the fullest.";
			now CouraVirginity is 1; [no longer virgin]
		else:
			say "     With the young woman readily offering herself to you like this, you have little reason not to indulge her request and decide to savor your fuck, pushing your shaft into her slowly and stopping in motion once you feel your balls against her crotch fur. For a moment, you simply rest your [cock of player] erection inside her, giving the young rodent some time to get used to it. Nermine embraces you from behind as you wait, licking your cheek in affection. You can feel her breasts press against your back as the naked jackaless plasters herself against you and says, 'The [master] of Nermine is very generous with [PosAdj of player] sex toys today. It cannot be easy to resist thrusting hard into the slut of a rat. To fuck her deep and mercilessly.'";
			WaitLineBreak;
			say "     Ignoring the tempting whispers of your bitchy sorceress for now, you only put your finger on the clit of Coura's pussy, rubbing her pleasure-button with circling movements, all the while gently sliding your hard cock back and forth a little in her pussy. The combined sensations of being stimulated as well as having a hard shaft inside her do quickly push the transformed rodent to letting out soft moans, clearly enjoying the experience. She is panting openly before much longer, which is when you decide that the time has come to make your move. A breathless moan comes from the young woman when you pull out almost all of the way and thrust all the way back inside, impaling her on your [cock of player] shaft. Coura lets out a gasp of  'Yeah, fuck me! I love your cock inside me!'";
			say "     You wrap your arms around the chest of your mall rat partner, pulling her slender frame against your body as you grind your cock into the depth of her snatch, savoring the tight confines of Coura's pussy. A barbed little comment from the jackaless makes you look aside for a second: 'The little rodent should be very thankful to Nermine's [master] to have claimed her as gently as [SubjectPro of player] chose to do. There were other options, which the storekeeper could have brought in to do the deed. A certain untamed horseman with a very fat member comes to mind. No matter now, as long as the rat slut accepts that this is what she was made to be.' After this short distraction from your rather vengeful jackal bitch, you turn your attention back to Coura, savoring the young woman's pussy to the fullest.";
		WaitLineBreak;
		say "     While Coura clutches onto you with both arms and legs, you fuck her pussy with fast and deep strokes, speeding up your thrusts into her tight confines with each new penetration. Nermine grins in satisfaction as you plow the victim of her magics, cementing Coura's status as your sex toy. The moans of the transformed mall rat are music to your ears, telling you that even though she didn't really have a choice, the young woman nevertheless enjoys being taken by you. Between her tight pussy around your shaft, her warm body against your naked skin and the scent of a very horny anthro rat in your nose, you feel yourself getting close to an orgasm before much longer. Deciding that you want the mall rat to share that moment of pleasure with you, you move your hand down to her clit and begin to frig the young woman's clit in a rapid pace, getting her even more hot and bothered.";
		say "     Soon, the young adult is panting out pleas to take her deeper, harder and more forcefully, and she trembles in the embrace of your arms as she is about to come. With the moment you waited for finally arrived, you abandon any restraint that you put on yourself and hammer balls-deep into her, grunting loudly as you pump a heavy load of cum right into her depths. As the first splash of seed paints the entrance to Coura's womb white, the mall rat bucks uncontrollably under you, the wave of a powerful orgasm breaking over her just at that moment. Femcum squirts out of her pussy, with some of it trickling down your length to drip down from your balls.";
		WaitLineBreak;
		say "     After some long moments of riding out the high of climax, the death-grip of Coura's arms around your chest eventually slackens and she lets herself fall back onto the beanbag chair, panting and exhausted. The movement makes her insides flex around your shaft a little, drawing a grunt of pleasure from you. 'That was nice, wasn't it?' she sighs and looks up at you, full of confidence that she did a good enough job to be transformed back soon. The jackal sorceress seems a bit disappointed that Coura isn't as frightened as she was originally, nodding as she says, 'Very well. She has pleased Nermine and her [master] sufficiently.' As you pull out of Coura and stand up, leaving the mall rat with your load dripping from her spread folds, the sorceress snaps her fingers audibly, creating an immediate effect.";
		say "     With the bumps of Coura's breasts smoothing out into a more masculine flat chest and her pubic mound being replaced by a soft cock, Cole is back an eye-blink later. He gives you a thankful smile and looks down over himself, raising one hand to touch his chest as if unsure which shape he is more comfortable with. With a little shrug to himself, he quickly goes to collect his clothes and gets dressed. But being a male again, Cole looks somewhat uncomfortable and almost sad in the feminine outfit. 'So, I guess that's it for now? I'll see you guys next time,' he says and leaves the store. You can't quite tell if the undertone in his voice was anticipation or trepidation - maybe a bit of both.";
	else if libido of Danny > 15: [Cole/Coura can freely shift now]
		say "     Smiling at Coura, you pat her head and look into the eager eyes of the female mall rat, then proclaim that she shall service you orally. The young woman smiles happily and leans forward to plant a peck on your lips, then tucks up her tank top. With a quick movement, the garment is up over her head and gets thrown to the side, revealing her naked breasts to you. As you reach out to cup them and give her a little grope, the mall-rat lets out a sigh of pleasure, the expression on her face showing genuine enjoyment at being touched like this. You go on to explore the young woman's body a little while longer, touching and caressing her. Then eventually, Coura takes your hand in hers and pulls it under her short skirt, where your fingers brush against something warm and wet. She isn't wearing panties, and if very obviously aroused at what you will soon do to her. Exchanging a worshipful look with you, she moans, 'I'm ready for you [master].'";
		say "     You can't help but grin as you run your fingers over the swollen nether lips of the female rat, then dip in the tip of your index finger and feel her body envelop it. With a blissful expression on her face, Coura moans lustfully and leans in towards you, eager fur further touching. Drawing her chin up a little, you give the slender mall rat a deep kiss, revelling in what she has become. Nermine's spells are one thing, but as Coura shows, actually being nice to your sex toys when they beg for it has a magic all of its own. Now the little sex kitten eagerly offers herself to you, rather than just obeying out of fear like before. The two of you make out for a little while longer until you eventually slide your arms around her in a bear-hug, lifting the young woman off her feet and making her give a happy squeal. With the eager bundle of rat in your arms, you walk over to the large bean bag chair standing a little bit further into the store.";
		WaitLineBreak;
		say "     After being carried for a little while, her arms wrapped around your chest, Coura beams at you when you put her down on her own slender paws again. The young woman strokes both her hands down her front in a little bit of a show for you, circling her nipples before she continues on over the flat of her stomach. Soon arriving at the skirt, she undoes its buttons and lets it drop to the floor, baring all of her sexy body. Even though you had felt her earlier, seeing this young woman hot and ready for you with the fur around her pussy wet and matted is something else. Letting out an eager grunt at her sexy showing off, you reach out and touch the mall rat's curves. Coura leans into your caresses for a little while, then takes your hand into hers and guides it to her lips, kissing it before she says full of fervor, '[Master], I need you inside me!' Smiling at her readiness to serve, you slide one hand up to her neck and pull her in for a quick kiss on the lips, then tell the young adult rodent to go ahead.";
		say "     As the naked mall rat pushes the beads in the beanbag chair into position a little, then lays herself down on it, Nermine comments from where she is standing at your shoulder. 'Is it not beautiful when pets do know their place and anticipate the [master]'s wishes?' she says in a satisfied tone, revelling in her revenge on Cole having brought the submissive Coura into play. It doesn't seem to occur to the naked jackaless that her own fate is quite similar, a powerful sorceress becoming your obedient bitch. Meanwhile, Coura has lain down on the unconventional chair, stretched out on her back and with both legs spread wide. This puts her crotch on full display, including the matted fur around her pussy. Eager to enjoy the young woman, you step up to the bean bag yourself and then [SelfStripCrotch]. Wrapping a hand around your [cock of player] shaft, you get into position on top of Coura, brushing it against the slightly open lips of her sex and feeling the wetness of her arousal on your skin. At this point, the young adult rodent lets out an aroused moan, followed by the words, 'Could you please be gentle, at least at the start?'";
		WaitLineBreak;
		if CouraVirginity is 0: [virgin]
			say "     It isn't too surprising that she is a little anxious about getting fucked - she is a virgin after all. You're not quite sure if you indulge the request because you don't want to be too hard on her, or just to savor to occasion. No matter which, you push your shaft into her slowly, stopping right away as you feel the flexible barrier of her hymen against your head. For a moment, you simply rest your [cock of player] erection inside her, giving the young rodent some time to get used to it. Nermine embraces you from behind as you wait, licking your cheek in affection. You can feel her breasts press against your back as the naked jackaless plasters herself against you and says, 'The [master] of Nermine is very generous with [PosAdj of player] sex toys today. It cannot be easy to resist thrusting hard into the slut of a rat. To fuck her deep and mercilessly.'";
			say "     Ignoring the tempting whispers of your bitchy sorceress for now, you only put your finger on the clit of Coura's pussy, rubbing her pleasure-button with circling movements, all the while gently sliding your hard cock back and forth a little in her pussy. The combined sensations of being stimulated as well as having a hard shaft inside her do quickly push the female rodent to letting out eager moans, clearly enjoying the experience. She is panting openly before much longer, which is when you decide that the time has come to make your move and start to press deeper into her. Coura's hymen stretches a little when you push against it, then pull back again, slowly working up the intensity of your shallow thrusts. Finally, the thin membrane can't withstand the pressure any longer and parts before your invading member. A breathless moan comes from the young woman when she suddenly finds herself fully impaled on your [cock of player] shaft, followed by the gasp of, 'Oh god, that feels amazing! I love it!'";
			WaitLineBreak;
			say "     You wrap your arms around the chest of your mall rat partner, pulling her slender frame against your body as you grind your cock into the depth of her snatch, savoring the tight confines of Coura's virgin pussy. A barbed little comment from the jackaless makes you look aside for a second: 'The little rodent should be very thankful to Nermine's [master] to have claimed her virginity as gently as [SubjectPro of player] chose to do. There were other options, which the storekeeper could have brought in to do the deed. A certain untamed horseman with a very fat member comes to mind. No matter now, as long as the rat slut accepts that this is what she was made to be.' After this short distraction from your rather vengeful jackal bitch, you turn your attention back to Coura, savoring the young woman's pussy to the fullest.";
			now CouraVirginity is 1; [no longer virgin]
		else:
			say "     With the young woman readily offering herself to you like this, you have little reason not to indulge her request and decide to savor your fuck, pushing your shaft into her slowly and stopping in motion once you feel your balls against her crotch fur. For a moment, you simply rest your [cock of player] erection inside her, giving the young rodent some time to get used to it. Nermine embraces you from behind as you wait, licking your cheek in affection. You can feel her breasts press against your back as the naked jackaless plasters herself against you and says, 'The [master] of Nermine is very generous with [PosAdj of player] sex toys today. It cannot be easy to resist thrusting hard into the slut of a rat. To fuck her deep and mercilessly.'";
			say "     Ignoring the tempting whispers of your bitchy sorceress for now, you only put your finger on the clit of Coura's pussy, rubbing her pleasure-button with circling movements, all the while gently sliding your hard cock back and forth a little in her pussy. The combined sensations of being stimulated as well as having a hard shaft inside her do quickly push the transformed rodent to letting out soft moans, clearly enjoying the experience. She is panting openly before much longer, which is when you decide that the time has come to make your move. A breathless moan comes from the young woman when you pull out almost all of the way and thrust all the way back inside, impaling her on your [cock of player] shaft. Coura lets out a gasp of  'Yeah, fuck me! I love your cock inside me!'";
			WaitLineBreak;
			say "     You wrap your arms around the chest of your mall rat partner, pulling her slender frame against your body as you grind your cock into the depth of her snatch, savoring the tight confines of Coura's pussy. A barbed little comment from the jackaless makes you look aside for a second: 'The little rodent should be very thankful to Nermine's [master] to have claimed her as gently as [SubjectPro of player] chose to do. There were other options, which the storekeeper could have brought in to do the deed. A certain untamed horseman with a very fat member comes to mind. No matter now, as long as the rat slut accepts that this is what she was made to be.' After this short distraction from your rather vengeful jackal bitch, you turn your attention back to Coura, savoring the young woman's pussy to the fullest.";
		say "     While Coura clutches onto you with both arms and legs, you fuck her pussy with fast and deep strokes, speeding up your thrusts into her tight confines with each new penetration. Nermine grins in satisfaction as you plow the victim of her magics, but there is a certain level of annoyance in her expression too, most likely from the fact that Coura is enjoying the fuck quite a bit. Meanwhile, the moans of the transformed mall rat are music to your ears, especially as she lets out little gasps about how much she likes you inside her. Between her tight pussy around your shaft, her warm body against your naked skin and the scent of a very horny anthro rat in your nose, you feel yourself getting close to the ecstasy of orgasm before much longer. Deciding that you want the mall rat to share that moment of pleasure with you, you move your hand down to her clit and begin to frig the young woman's clit in a rapid pace, getting her even more hot and bothered.";
		WaitLineBreak;
		say "     Soon, the young adult is literally shouting her pleas to be taken deeper, harder and more forcefully, and she trembles in the embrace of your arms as she is about to come. With the moment you waited for finally arrived, you abandon any restraint that you put on yourself and hammer balls-deep into her, grunting loudly as you pump a heavy load of cum right into her depths. As the first splash of seed paints the entrance to Coura's womb white, the mall rat bucks uncontrollably under you, the wave of a powerful orgasm breaking over her just at that moment. Femcum squirts out of her pussy, with some of it trickling down your length to drip down from your balls.";
		say "     After some long moments of riding out the high of climax, the death-grip of Coura's arms around your chest eventually slackens and she lets herself fall back onto the beanbag chair, panting and exhausted. The movement makes her insides flex around your shaft a little, drawing a grunt of pleasure from you. 'That was amazing. You're amazing, [master],' she sighs happily and looks up at you worshipfully, content in the knowledge that you're the one in control and not Nermine. Stretched out naked as she is, smiling and with your cum slowly trickling from her pussy, you can't help but feel a surge of affection for the young woman, and you lean down over her to kiss her once again. Making out with the rat and sharing caresses with one another, the two of you stay together for a little while, until eventually, a low growl from next to you makes Coura stiffen in your arms. It comes from Nermine, looking at you embracing the rat, brows drawn together as she tries to impale Coura with pointed looks.";
		WaitLineBreak;
		say "     Less than pleased with the sudden turn that your attention has taken, the jackaless sorceress hisses to Coura, 'The slut has been sufficient. And now, she should get back to work. Nermine wants [one of]to see the great gong polished to a mirror's shine[or]all of her canopic jars dusted[or]the third shelf sorted alphabetically[or]her living inventory fed[at random] before her employee leaves today.' As the jackaless goes to pull the door to the back room open once more and shoo Coura through, the mall rat rolls her eyes as soon as Nermine's back is turned, then gives you a peck on the lips before hurrying to stand up. Collecting her clothes, she rushes after Nermine and is out of sight on short notice.";

to say CouraSex5: [player fucks her ass]
	if libido of Danny > 3 and libido of Danny < 9: [still new to it]
		say "     ...";
	else if libido of Danny > 8 and libido of Danny < 14: [getting used to the transformations]
		say "     ...";
	else if libido of Danny > 15: [Cole/Coura can freely shift now]
		say "     ...";

to say CouraSex6: [random oral/bj]
	if libido of Danny > 3 and libido of Danny < 9: [still new to it]
		say "     ...";
	else if libido of Danny > 8 and libido of Danny < 14: [getting used to the transformations]
		say "     ...";
	else if libido of Danny > 15: [Cole/Coura can freely shift now]
		say "     ...";

to say CouraSex7: [random pussy fuck]
	if libido of Danny > 3 and libido of Danny < 9: [still new to it]
		say "     ...";
	else if libido of Danny > 8 and libido of Danny < 14: [getting used to the transformations]
		say "     ...";
	else if libido of Danny > 15: [Cole/Coura can freely shift now]
		say "     ...";

Section 3 - Events


instead of going North from Mall West Wing while (libido of Danny is 12):
	say "     As you are about to enter Nermine's magic shop, a voice calls out to you, making you pause just short of the entrance door. It is Cole the mall rat, who appears to have waited for you in a little niche between Nermine's store and the next neighboring one. The young adult rodent looks at you with apprehension, yet makes himself come up to you, then gives a respectful nod. 'Uhm, hello[if player is not defaultnamed] [name of player][else]there[end if]. I wanted to talk to you about... you know, being Coura. What you've had me do and also in general.' Your eyebrows rise at this open approach by Cole, but before you can do or say anything, he raises his trembling hands and gestures for you to hold up. 'Please, just... just listen for now. When things started out with the transformations and me having to come here and beg for a return to my normal self, I was in shock about what was happening, and resented the two of you. But... I don't know, things changed when I kinda got used to it.'";
	say "     Swallowing visibly, Cole looks you in the eye and adds, 'When I'm Coura, it doesn't feel strange any longer. It is just as normal as right now, in my regular body. Becoming her isn't the same shock anymore, with me having to steer an unfamiliar form and deal with it. It feels more like there is... more of myself now, and one or the other side gets to act. And that's the rub of it - Coura is really half of myself now, but she is missing out on actually living.' Letting out a sigh, his shoulders drooping a little, Cole goes on to ask, 'What does she get right now, hm? A sudden transformation out of the blue, then having to hurry to mistress Nermine so there isn't a punishment for disobeying her. There is so much more she could and should experience. So I wanted to ask if there is maybe, somehow, a way that you could allow me the power to shift forms on my own. I'd still serve you two, whenever you want. Just please, allow me to be complete, to live out both sides of myself.'";
	LineBreak;
	say "     [bold type]Well, that's a new development. How do you want to deal with this?[roman type][line break]";
	say "     [link](1)[as]1[end link] - Reject his request. You like how things are right now.";
	say "     [link](2)[as]2[end link] - Make Nermine give Cole the doll.";
	say "     [link](3)[as]3[end link] - Let Nermine destroy the doll, trapping Cole in male form.";
	say "     [link](4)[as]4[end link] - Let Nermine destroy the doll, making Coura permanently his only form.";
	now calcnumber is 0;
	while calcnumber < 1 or calcnumber > 3:
		say "Choice? (1-4)>[run paragraph on]";
		get a number;
		if calcnumber is 1 or calcnumber is 2 or calcnumber is 3:
			break;
		else:
			say "Invalid choice. Type [link]1[end link] to refuse, [link]2[end link] to give the mall rat the ability to transform on his own, [link]3[end link] to make Cole permanently male again or [link]4[end link] to make Coura permanent.";
	if calcnumber is 1:
		LineBreak;
		say "     A slightly cruel smile spreads over your face as you look at the slender mall rat, then ask what gave him the idea that his opinion is relevant in this matter. You for one like having a sexy rodent servant, and the degree of power that you hold over him just makes it even sweeter. Cole is crushed by the rejection of his plea, stepping back from you, speechless for a few seconds before he sobs out the words, 'I - I'll be off then [master]. Until you have need of me.' With that said, the mall rat runs off, leaving you standing in front of Nermine's store.";
		now libido of Danny is 13; [status quo confirmed]
	else if calcnumber is 2:
		LineBreak;
		say "     Looking thoughtfully at the young man/woman that was created by your indulgence of Nermine's veangence, you come to the decision that he really should have at least this amount of freedom. With a reassuring smile, you place a hand on his shoulder and give it a light squeeze, then tell the mall rat that you'll agree to his deal. Entering the magic shop with a wave for Cole to follow, you guide him to the counter, where Nermine is waiting and showing a smirk on her muzzle. 'Did Nermine's beloved [master] pick up their rat slut so [SubjectPro of player] can play with her right away after transformation? The jackaless has also some more fun ideas what to do with Coura.'";
		say "     Walking up to the black-furred bitch, you slide an arm around her and give her a deep kiss, grabbing a handful of hair behind her head to show your dominance and look directly into her eyes. Then you tell the sorceress about the deal that Cole suggested and that you accepted. The fact that she has to give her ratty toy some autonomy creates an immediate reaction. Nermine stiffens in your grasp and the jackal's teeth show for a second before she manages to get herself under control. When she opens her muzzle to protest, you simply shush her, at which point the bitch instead throws a hostile glare over at Cole, then huffs, 'As Nermine's love wishes.' Letting her go, you watch the jackaless unlock and open her display case, retrieving the mall rat doll and placing it on the counter before Cole.";
		WaitLineBreak;
		say "     'Is that me?' the young adult rodent asks in wonder as he sees the focus of Nermine's spell. He reaches out somewhat hesitantly to touch it and adds, 'Man, this feels weird.' Clearing her throat and looking down her long muzzle at Cole, Nermine lays out the little skirt that goes with the doll too, then explains, 'As Nermine is sure even the unworthy rodent will understand, this garment will lead to the transformation once put on the doll.' She watches the mall rat carefully pack away the doll and skirt into his shoulder bag, then says in a civil, yet sharp-edged voice, 'Nermine will be expecting the rat, every morning in the ninth hour. She will be very... disappointed ...if he or she does not show up punctually.'";
		say "     Cole replies in surprise, 'Err - what?' Letting out a huff, your jackaless bitch tells him, 'Since the rodent is taking with him that item that was telling Coura her services are required, a different way of ensuring her availability is required. As such, the undeserving rat will work for Nermine from now on. Nermine has a back room that does need a great deal of cleaning and sorting, and this way the rat slut will be available too when the [master] wishes to enjoy her. This is not negotiable.' Looking somewhat worriedly at the jackaless and what she may have planned, Cole gulps and replies, 'Yes mistress. I'll be here starting tomorrow.'";
		now libido of Danny is 16; [Cole has the doll, must work at the store]
	else if calcnumber is 3:
		LineBreak;
		say "     A slightly cruel smile spreads over your face as you look at the slender mall rat, then enter the magic shop with a wave for Cole to follow. As you approach the counter, where Nermine is waiting with a smirk on her muzzle, the jackaless says, 'Did Nermine's beloved [master] pick up their rat slut so [SubjectPro of player] can play with her right away after transformation? The jackaless has also some more fun ideas what to do with Coura.' Shaking your head, you instead tell her a short version of what he laid out for you just a minute ago. Nermine listens to you with a somewhat surprised expression and seems to wonder why she should care about the mall rat's feelings - right until the moment when you tell her that he doesn't deserve being bumped back and forth between his different selves, now that he has gotten used to it.'";
		say "     'Ah, of course,' Nermine tells you with a devious smile, then retrieves the key to her showcase and opens it, picking up the mall rat doll and setting it down on the store counter. 'Wow, that felt weird. Is - is that me?' the young adult rodent asks in wonder as he sees the focus of Nermine's spell. 'Indeed it is, as the curious rodent will be pleased to learn. And this is what causes the transformations,' Nermine tells him, pulling the orange strip of fabric that is the doll's skirt out of her other hand and wrapping it around her fingers. The jackaless looks over to you, a predatory smile on her muzzle, and you nod for her to go ahead. 'Now something like this is always special, hard to create or replace,' the black-furred bitch tells Cole and holds out the piece of fabric to him - yet as he tries to take it, she lets go of it and snaps her finger. The little skirt bursts into flame before even reaching the counter-top. 'Ooops,' the sorceress comments with a smirk.";
		WaitLineBreak;
		say "     Cole looks in shock at the piece of fabric as it quickly burns to ash, then is blown off the glass counter by Nermine. 'What?! You... I-' the mall rat stutters in shock, and Nermine smirks at him. 'Looks like Nermine's visitor won't have to worry about suddenly transforming ever again. She is very certain he will permanently stay male from now on. But the rat can feel free to take the doll. The jackaless doesn't have much need for it from now on.' With that said, she pokes the Cole doll in the chest, causing him to gasp, 'Ouch, that hurt, you bitch!' Snatching up the little doll, the mall rat runs off right after, sobbing about how things turned out.";
		now libido of Danny is 14; [doll destroyed, Cole stuck as a guy]
	else:
		LineBreak;
		say "     A slightly cruel smile spreads over your face as you look at the slender mall rat, then enter the magic shop with a wave for Cole to follow. As you approach the counter, where Nermine is waiting with a smirk on her muzzle, the jackaless says, 'Did Nermine's beloved [master] pick up their rat slut so [SubjectPro of player] can play with her right away after transformation? The jackaless has also some more fun ideas what to do with Coura.' Shaking your head, you instead tell her a short version of what he laid out for you just a minute ago. Nermine listens to you with a somewhat surprised expression and seems to wonder why she should care about the mall rat's feelings - right until the moment when you tell her that he doesn't deserve being bumped back and forth between his different selves, now that he has gotten used to it.'";
		say "     'Ah, of course,' Nermine tells you with a devious smile, then retrieves the key to her showcase and opens it, picking up the mall rat doll and setting it down on the store counter. 'Wow, that felt weird. Is - is that me?' the young adult rodent asks in wonder as he sees the focus of Nermine's spell. 'Indeed it is, as the curious rodent will be pleased to learn. And this is what causes the transformations,' Nermine tells him, pulling the orange strip of fabric that is the doll's skirt out of her other hand and wrapping it around her fingers. The jackaless looks over to you, a predatory smile on her muzzle, and you nod for her to go ahead and put it on the doll. 'Now something like this is always special, hard to create or replace,' the black-furred bitch tells Cole and quickly wraps the skirt around the doll's hips, closing its push-button fastener. This causes visible changes in Cole, who finishes his transformation into Coura within a few seconds.";
		WaitLineBreak;
		say "     'Nermine wouldn't want her rodent visitor to have any possible mishap with such a precious item, so she'll throw in a little spell that makes it unbreakable,' the sorceress says in an overly sweet tone, followed by some mystic hand gestures and her murmuring under her breath. 'The jackaless will demonstrate this, look closely...' Nermine adds, then touches the push-button holding Coura's skirt closed. It flares up, suddenly glowing red-hot, yet the fabric or the rest of the doll is not at all impacted by heat literally melting the small piece of metal into one single clump. 'There, that'll do. It won't be coming off again,' Nermine tells the mall rat with a smile. 'What?! You... I-' Coura stutters in shock, and Nermine smirks at her.";
		say "     'Looks like Nermine's visitor won't have to worry about suddenly transforming ever again. She is very certain the rodent slut will permanently stay female from now on. But the rat can feel free to take the doll. The jackaless doesn't have much need for it from now on.' With that said, she pokes the Coura doll in the chest, causing her to gasp, 'Ouch, that hurt, you bitch!' Snatching up the little doll, the mall rat runs off right after, sobbing about how things turned out.";
		now libido of Danny is 15; [doll destroyed, Cole stuck as a girl]

after going to Mall Foodcourt while (libido of Danny > 6 and libido of Danny < 9 and CouraFriendDevelopments is 0): [2 or 3 times transformed]
	say "     Walking into the Food Court, you pass Danny and a buddy of his, hanging out together at one of the freestanding tables. They are chatting with one another and sit with their backs to you, allowing you to overhear the current topic of their conversation: 'So, any idea what's up with Cole these days? He keeps running off suddenly and avoided my questions about it afterwards.' Danny shrugs in response, then adds in a joking tone, 'Maybe he got a girlfriend or something. A hot little number that he wants all to himself. Or hey - could be a sexy MILF that he suckles milk from while fucking her.' The other mall rat laughs out, 'Hah - as if he could land himself steady access to a pussy. I'll believe that when I see it.'";
	say "     Not wanting to be too obvious in hovering near the two guys and listening in, you continue on your way. If those two just knew what Cole - or Coura - has been up to... But no, for now it's your little secret that you can have fun-time with Coura whenever you tell Nermine to transform Cole again. With a grin on your face, you think about doing that right now. It really wouldn't be that far out of your way to visit your jackaless bitch again.";
	now CouraFriendDevelopments is 1; [heard Cole's friends wondering about him]

after going to Mall Foodcourt while (libido of Danny > 8 and libido of Danny < 14 and CouraFriendDevelopments < 2): [4-6 or 3 times transformed, no decision on Coura's transformation status or permanently stuck in switching by Nermine]
	say "     As you walk into the Food Court, you see Cole the mall rat a little bit ahead of you, moving up to a table where a group of young mall rats are sitting together. 'Hey guys!' he calls out cheerfully and takes a seat, only to pause in confusion as the others don't say anything, instead just looking at him expectantly. 'What's up?' Cole asks and checks himself over, in case he's got anything in his hair or so. His buddies mumble a bit and look at each other indecisively, until one of them speaks up and says, 'So, when were you gonna tell us? Vince saw you in the Atrium with a skirt and tank top on. Been hiding some sweet boobies in your loose shirts all this time?' Before Cole can react, the other rat has reached out to grope his chest, finding himself surprised quite obviously as all he feels is the flat pecs of his rodent friend.";
	say "     'Hey!' Cole calls out, batting the hand away and explaining, 'It's not like that! I'm a guy, alright?! Just, just the sorceress put a spell on me!' Shocked expressions ring the table and there is a murmur of the name Bridget being brought up here or there. 'I've been going to her store to plead that she'll turn me back, and she did so several times already, after I... do some things for her. And the reprieve is not permanent apparently. I keep turning into a girl from time to time, with almost no warning.' Clearly, he doesn't want to talk about this topic in any further detail, and the next thing that Cole says is that he'll go get some drinks for them. Before anyone can say a word, he rushes off to the food lines.";
	WaitLineBreak;
	say "     Silence hangs in the air for a few seconds, with the remaining rats looking at each other and digesting the new information, until the first guy starts to say, 'So...' A second rat bursts in, 'Yeah. Totally! Cole's so putting out for that jackal bitch! Some hot lesbo action in her weird shop, I'm sure!' A chuckle goes through the group and one or two of them get rather dreamy expressions on their faces. 'Hey Danny, can you get us some footage? It's sure to be streamin['] hot!' a grinning mall rat soon says, with Danny replying, 'I'm not sure. Don't wanna be the next guy who gets the magic whammy, you know. But maybe we cou- oh fuck, quiet, he's coming back!' The topic of conversation being instantly squashed, there is a bit of an awkward silence between the rats as Cole returns to the table, carrying a tablet with soft drink cups.";
	say "     As he hands out the drinks, one of the other rats eventually starts a discussion about arcade games, and the whole group joins in fairly quickly. Since their fan-boy antics for this or that game are not all that interesting, you finish the 'in-depth study' of the mall overview plan that you have been standing in front of the whole time and quietly walk away.";
	now CouraFriendDevelopments is 2; [Cole's friends know about his transformations and confronted him]

after going to Mall Foodcourt  while (libido of Danny is 14 and CouraFriendDevelopments < 10): [Cole stuck as a guy]
	say "     ...";
	now CouraFriendDevelopments is 10; [his friends talked to Cole (stuck as a guy)]

after going to Mall Foodcourt while (libido of Danny > 15 and libido of Danny < 20 and CouraFriendDevelopments < 10): [Cole has the doll and can shift at will, no confrontation yet]
	say "     Coming into the Food Court, you see the group of Cole's buddies hanging out at one of the larger freestanding tables, a definitive air of anticipation hanging in the air around them. Curious of what may be going on, you find a seat at a nearby table yourself and quietly observe them. It doesn't take very long before Danny appears, bringing along Cole, who finds himself a little surprised at the gathering of rats. 'Hey guys, what's up?' he asks as he takes a seat. With barely any hesitation, one of the waiting rats clears his throat and says, 'Listen, we've talked a bit about it, and... everyone agrees that we should be getting some tail from Coura. You can make her appear anytime now, and -' The young man is interrupted as Cole jumps to his feet, his chair falling over backwards and clattering noisily to the ground as he wheels to face Danny, an angry expression on his face.";
	say "     'I told you that in confidence! You weren't supposed to just blurt it out to everyone!' Danny raises his hands defensively and replies, 'Hey, relax. It's not like she's really you! Even got a different name and only appears through magic. You can be a bud and let us have a go with her.' Cole growls and looks away from him, his gaze meeting the eyes of several other rats, and finding only horny males staring back at him, seeing a pussy to fuck and not their (former) friend. One guy who reaches out to touch Cole's arm finds his hand being slapped away violently, followed by Cole shouting, 'Stay away from me, you assholes!' As the rat turns tail and runs off, his 'buddies' are left behind, staring somewhat sullenly after him, now that it is clear that they'll not get to fuck Coura.";
	WaitLineBreak;
	say "     Looking after his friend till he vanishes into the crowd, Danny has a frown on his face, apparently unsure if he did the right thing about sharing Cole's secrets. Then the guy who initially spoke up pats him on the shoulder and says, 'Don't worry about it. She'll come around eventually. Bitches being all emotional at times. It's not like she didn't know that it's 'Bro's before ho's'.' Danny thinks about it for a second, then shrugs and replies, 'I guess she will, Vince.' After that little revelation of what this group of rats actually think of Cole and Coura, the gathering slowly disintegrates. As you watch them go, you can't help but ponder on the aftermath of everything that Nermine and you have done to your ratty sex toy.";
	now CouraFriendDevelopments is 20; [his friends tried to make a move on free Cole, got rejected]

after going to Mall Foodcourt while (libido of Danny > 15 and libido of Danny < 20 and XP of Jay > 0 and CouraFriendDevelopments is 20 and a random chance of 1 in 3 succeeds): [Cole broke with his former friends]
	say "     Walking into the Food Court, you spot your friend Jay coming from one of the food counters, carrying two steaming mugs of hot chocolate. He walks straight to a table at which Cole the mall rat is waiting for him, gently patting the young man's back as he gives him one of the drinks. After Cole gives Jay his thanks and takes a first nip from the cup, the elf moves to sit on the chair next to him, then pauses as his gaze falls upon you. Changing his plans instantly, Jay instead sets out towards you, eyebrows scrunched together in an expression of disdain. 'We gotta have some words, [mister]! How could you leave this poor boy in such a state! He's all -' Jay begins to berate you, winding himself up more and more with each word, until he is brought to a sudden halt by Cole calling out, 'Stop! Please stop!' Jay turns around in surprise, looking at the mall rat who followed him from the table.";
	say "     'I - um, I don't actually blame [ObjectPro of player] too much for it all. Yeah, Nermine and her [master] used me, but... but it was actually kind of nice to experience sex as a woman. And [SubjectPro of player] made Nermine give me control over the transformations when I asked for it. I know it may sound weird, but I know what [italic type]they[roman type] want from me, and I can deal with that. What really [italic type]hurt[roman type] on the other hand was my so-called friends telling me to put out, as if I wasn't anything but a hole to fuck for them.' That last sentence came out mostly in sobs, with Cole's shoulders and his whole demeanor drooping visibly. 'There, there,' Jay tells the rat as he lays an arm around him, then guides Cole back to the table. It is a peculiar sight with the elf being all of four feet tall, yet mothering a much bigger young man.";
	now CouraFriendDevelopments is 21; [Cole + Jay are hanging out together now]

[
Could have Coura approaching the player sometime, somewhat fearful as she says, "I swear I would never just take anything from the store, but earlier, I found this in my pocket.' With that said, she pulls a disc-shaped amulet out of her pocket, covered in a ring of what looks like nordic runes around a topaz set in the middle. Clearly the young woman is worried about it, and the possible punishment by Nermine for having something from the store on her. 'And what is even weirder - I put this thing into the bag with my stuff for safekeeping until I can return it tomorrow, and now it is here in my pocket again!'
How do you want to deal with this?
Tell her that you'll take the piece of jewelry to Nermine yourself and make sure that she won't be punished.
Explain that clearly, something wants her to have it. She shouldn't worry too much about it. Surely Nermine already knows.


Wahn - Today at 6:31 PM
if I put up an npc
that npc can be placed in the midmorning turn
be gone in the noon turn (at work)
also gone in the mid-afternoon turn (at work)
and as the mid-afternoon turn is ended, I can show messages about her emerging, then place her somewhere for the evening turn
as the evening turn ends, she can have some messages about hanging out
Savriss - Today at 6:33 PM
Cool, go with that.
Wahn - Today at 6:33 PM
and as the early night turn is ended, she moves to sleep
Savriss - Today at 6:33 PM
There'll be expansions on her in future
Can one access the place where CC sleeps
]
Coura ends here.
