Dalmatian by Wahn begins here.
[ Version 1.0 - Male Dalmatian by Kaleem Mcintyre          ]
[ Version 2.0 - Multi Gender Dalmatians plus Items by Wahn ]

Section 1 - Creature Responses

[see NonCombatError Function from Core Mechanics/Basic Functions: ]
[to say NonCombatError:
	say "ERROR! This is a noncombat creature that you should never see in a fight. Please report how you saw this on the FS Discord or Forum.";]

Section 2 - Creature Insertion

Table of Random Critters (continued)
NewTypeInfection (truth state)	Species Name	Name	Enemy Title	Enemy Name	Enemy Type	Attack	Defeated	Victory	Desc	Face	Body	Skin	Tail	Cock	Face Change	Body Change	Skin Change	Ass Change	Cock Change	str	dex	sta	per	int	cha	sex	HP	lev	wdam	area	Cock Count	Cock Length	Ball Size	Nipple Count	Breast Size	Male Breast Size	Cunt Count	Cunt Depth	Cunt Tightness	Libido	Loot	Lootchance	Scale (number)	Body Descriptor (text)	Type (text)	Magic (truth state)	Resbypass (truth state)	non-infectious (truth state)	Cross-Infection (text)	DayCycle	Altcombat (text)	BannedStatus (truth state)
--	--	--	--	--	--	--	--	--	--	--	--	--	--	--	--	--	--	--	--	--	--	--	--	--	--	--	--	--	--	--	--	--	--	--	--	--	--	--	--	--	--	--	--	--	--	--	--	--	--	--;

When Play begins:
	Choose a blank row from Table of Random Critters;
	now NewTypeInfection entry is false;
	now Species Name entry is "Dalmatian";
	add "Dalmatian Male" to infections of CanineList;
	add "Dalmatian Male" to infections of NatureList;
	add "Dalmatian Male" to infections of FurryList;
	add "Dalmatian Male" to infections of MaleList;
	add "Dalmatian Male" to infections of TaperedCockList;
	add "Dalmatian Male" to infections of KnottedCockList;
	add "Dalmatian Male" to infections of SheathedCockList;
	add "Dalmatian Male" to infections of BipedalList;
	add "Dalmatian Male" to infections of TailList;
	now Name entry is "Dalmatian Male"; [ Infection/Creature name. Capitalized. ]
	now enemy title entry is ""; [name of the encountered creature at combat start - Example: "You run into a giant collie." instead of using "Smooth Collie Shemale" infection name]
	now enemy Name entry is ""; [specific name of unique enemy]
	now enemy type entry is 0; [0 = non unique enemy; 1 = unique (unknown name); 2 = unique (known name) | Used to disqualify unique enemies from Vore/UB and showing the enemy name in encounters]
	now attack entry is "[NonCombatError]";
	now defeated entry is "[NonCombatError]";
	now victory entry is "[NonCombatError]";
	now desc entry is "[NonCombatError]";
	now face entry is "covered with black spots while long floppy ears hang down the side of your regal-looking head. A black button-nose at the end of a long[if Player is female], delicate[end if] muzzle completes the image of an anthro Dalmatian's head";
	now body entry is "lean and limber, its form fitting an anthro canine built for both strength and speed. [if Player is female]Besides that, there is also a bit of a feminine curve to your hips, making them somewhat wider as a preparation for bearing cubs. [end if]Your legs end in digitigrade dog's paws, while your arms sport paw-hands as dexterous as a human's";
	now skin entry is "short but thick fur, covered with black rosettes dotted all across your";
	now tail entry is "A thin, almost wiry white tail sways from out of the end of your bubble-shaped rump.";
	now cock entry is "[one of]canine[or]knotted[or]doggy[at random]";
	now face change entry is "your nose begins to push out from your face while your senses dull ever so slightly. Reaching up with a hand you have the strangest urge to scratch at your ears, which just so happen to be growing longer and floppier onside of your head, at the exact same moment your teeth are elongating into sharpened points. Feeling a strange sensation in your mouth, you open it while your muzzle is still taking shape, reflexively sticking out the long floppy tongue you have also gained";
	now body change entry is "strong muscle-spasms go through your form, soon followed by the crunching noise of re-forming bone. Feeling like you want to curl into a ball, you can't even manage that much in coordinated movements, instead just swaying rather drunkenly as your body reshapes itself. After long moments of painful transformation you'd rather forget, your body now resembles an anthro dalmatian, complete with digitigrade paws to stand on";
	now skin change entry is "white fur pushes free from out of your pores. The new growth quickly works to cover your entire body, bringing with it a random pattern of black dots on it";
	now ass change entry is "your buttcheeks tighten into a firm pair of buttocks and a thin and wiry tail sprouts from your lower back";
	now cock change entry is "it takes on a canine shape, complete with a furred sheath as well as a pair of weighty balls. Lust bubbles up inside you and the dog's cock that you now call your own hardens within seconds, showing off the thick knot swelling up at its base. Then you cum, spraying out what seems like a celebratory load from the newly formed cock.";
	now str entry is 15; [ These are now the creature's stats... ]
	now dex entry is 22; [ ...and are only altered onto the player via Shifting or the Mighty Mutation feat ]
	now sta entry is 20; [ These values may be used as part of alternate combat.]
	now per entry is 22;
	now int entry is 16;
	now cha entry is 20;
	now sex entry is "Male"; [ Infection will move the player towards this gender. Current: 'Male' 'Female' 'Both' ]
	now HP entry is 66; [ The monster's starting HP. ]
	now lev entry is 1; [ Monster level. (Level x 2) XP for victory. (Level / 2) XP for losing. ]
	now wdam entry is 15; [ Monster's average damage when attacking. ]
	now area entry is "Nowhere"; [ "Outside" "Mall" "Park" "Beach" etc... Check an existing creature in the area. ]
	now Cock Count entry is 1; [ Number of cocks the infection will try to cause if sex entry is 'Male' or 'Both'. ]
	now Cock Length entry is 12; [ Length infection will make cock grow to if cocks. ]
	now Ball Size entry is 3; [ Cock width, more commonly used for ball size. ]
	now Nipple Count entry is 2; [ Number of nipples the infection will give a player. ]
	now Breast Size entry is 5; [ Size of breasts the infection will try to attain. ]
	now Male Breast Size entry is 0; [ Breast size for if Sex="Male", usually zero. ]
	now Cunt Count entry is 0; [ The number of cunts the infection will try to cause if sex entry is 'Female' or 'Both'. ]
	now Cunt Depth entry is 9; [ Depth of female sex the infection will attempt to give a player. ]
	now Cunt Tightness entry is 6; [ Width of female sex the infection will try to give a player. ]
	now libido entry is 55; [ Target libido the infection will rise towards. ]
	now loot entry is ""; [ Dropped item, blank for none. Case sensitive. ]
	now lootchance entry is 0; [ Percentage chance of dropping loot, from 0-100. ]
	now scale entry is 3; [ Number 1-5, approx size/height of infected PC body: 1=tiny, 3=avg, 5=huge ]
	now body descriptor entry is "[one of]lean[or]wiry[or]dexterous[or]limber[at random]"; [ Ex: "plump" "fat" "muscled" "strong" "slimy" "gelatinous" "slender". Use [one of] to vary ]
	now type entry is "canine"; [ one-word creature type. Ex: feline, canine, lupine, robotic, human... Use [one of] to vary ]
	now magic entry is false;
	now resbypass entry is false;
	now non-infectious entry is false;
	now Cross-Infection entry is ""; [infection that this infection will give the player when they lose; can be left empty if they infect with the monster's own]
	now DayCycle entry is 0; [ 0 = Up at all times; 1 = Diurnal (day encounters only); 2 = Nocturnal (night encounters only);]
	now altcombat entry is "default";
	now BannedStatus entry is false;

[
Table of New Infection Parts (continued)
Species Name	Name	Body Weight	Body Definition	Androginity	Head Change	Head Description	Head Adjective	Head Skin Adjective	Head Color	Head Adornments	Hair Length	Hair Shape	Hair Color	Hair Style	Beard Style	Body Hair Length	Eye Color	Eye Adjective	Mouth Length	Mouth Circumference	Tongue Adjective	Tongue Color	Tongue Length	Torso Change	Torso Description	Torso Adjective	Torso Skin Adjective	Torso Adornments	Torso Color	Torso Pattern	Breast Adjective	Breast Size	Male Breast Size	Nipple Count	Nipple Color	Nipple Shape	Back Change	Back Adornments	Back Skin Adjective	Back Color	Arms Change	Arms Description	Arms Skin Adjective	Arms Color	Locomotion	Legs Change	Legs Description	Legs Skin Adjective	Legs Color	Ass Change	Ass Description	Ass Skin Adjective	Ass Color	Ass Width	Tail Change	Tail Description	tail skin adjective	Tail Color	Asshole Depth	Asshole Tightness	Asshole Color	Cock Change	Cock Description	Cock Adjective	Cock Color	Cock Count	Cock Girth	Cock Length	Ball Description	Ball Count	Ball Size	Cunt Change	Cunt Description	Cunt Adjective	Cunt Color	Cunt Count	Cunt Depth	Cunt Tightness	Clit Size
--	--	--	--	--	--	--	--	--	--	--	--	--	--	--	--	--	--	--	--	--	--	--	--	--	--	--	--	--	--	--	--	--	--	--	--	--	--	--	--	--	--	--	--	--	--	--	--	--	--	--	--	--	--	--	--	--	--	--	--	--	--	--	--	--	--	--	--	--	--	--	--	--	--	--	--	--	--	--;

When Play begins:
	Choose a blank row from Table of New Infection Parts;
	now Species Name entry is ""; [name of the overall species of the infection, used for children, ...]
	now Name entry is ""; [matching infection name to Table of Random Critters]
	now Body Weight entry is 5; [scale of 1-9 for body weight, grouped into low weight (1-3), mid weight (4-6) and high weight (7-9)]
	now Body Definition entry is 5; [scale of 1-9 for body definition, grouped into low muscle (1-3), mid muscle (4-6), high muscle (7-9)]
	[Body Adjective is generated out of the body weight and body definition and can be used in scenes - one word descriptive adjective depending on weight and definition groups: low weight group: skinny/slender/lithe; mid weight group: average/fit/muscled; high weight group: pudgy/husky/jacked]
	now Androginity entry is 5; [1-9 scale of hypermasculine to hyperfeminine]
	[Gender Adjective is generated out of androginity 1-9: hypermasculine/masculine/effeminate/somewhat effeminate/androgynous/feminine butch/tomboyish/feminine/hyperfeminine]
	now Head Change entry is ""; [partial sentence that fits in: "Your head and face [one of]tingle[or]go flush[or]vibrate with odd pleasure[or]go cold[or]feel oily[at random] as [head change entry]."]
	now Head Description entry is ""; [partial sentence that fits in "Your face and head resemble that of [Head Description of Player]. You have [Eye Adjective of Player], [Eye Color of Player] eyes and an overall [Gender Adjective of Player] appearance."]
	now Head Adjective entry is ""; [one word descriptive adjective (avian/canine/...)]
	now Head Skin Adjective entry is ""; [one word descriptive adjective]
	now Head Color entry is ""; [single word color adjective for the dominant color of the skin/fur/feathers/scales]
	now Head Adornments entry is "";[partial sentence that fits in "Before moving on from your head, you give your [head adornments of Player] a proud glance followed by a light caress."]
	now Hair Length entry is 2; [hair length in inches]
	now Hair Shape entry is ""; [one word shape descriptor (curly/straight/...)]
	now Hair Color entry is ""; [one word color descriptor]
	now Hair Style entry is ""; [one word style descriptor (ponytail/mohawk/buzzcut/...) to fit "On top of your head you have [Hair Length of Player] inch long, [Hair Shape of Player] [Hair Color of Player] hair in the [Hair Style of Player] style."]
	now Beard Style entry is ""; [short beard style (goatee/3-day stubble beard/porn stache/mutton chops beard/...) to go into "You have a [Hair Color of Player] [Beard Style of Player]."]
	now Body Hair Length entry is 0; [numerical value, 0-4 (no body hair/light/moderate/heavy/furry) - only set to > 0 if the infection does not have fur/scales/etc. !]
	now Eye Color entry is ""; [one word color descriptor]
	now Eye Adjective entry is ""; [one word descriptive adjective (slitted/round/...)]
	now Mouth Length entry is 3; [inches deep for face fucking; maximum possible will be double this number (when deep throating)]
	[Mouth Length Adjective  is generated by a function and can be used in scenes too - "petite, shallow, average, deep, bottomless"]
	now Mouth Circumference entry is 3; [mouth circumference 1-5, see Mouth Circumference Adjective]
	[Mouth Circumference Adjective is generated by a function and can be used in scenes too - "tiny, small, normal, wide, gaping"]
	now Tongue Adjective entry is ""; [one word descriptive adjective (wide/slobbery/...)]
	now Tongue Color entry is ""; [one word color descriptor]
	now Tongue Length entry is 3; [length in inches]
	now Torso Change entry is ""; [partial sentence that fits in: "Your torso [one of]tingles[or]goes flush[or]vibrates with odd pleasure[or]goes cold[or]feels oily[at random] as [Torso Change entry]."]
	now Torso Description entry is ""; [partial sentence, fitting in "Looking down at yourself, you appear [Gender Adjective of Player] with a [Body Adjective of Player] build. Your torso is [Torso Description of Player][if Body Hair Length of Player > 1], covered in [Torso Color of Player] skin and [Body Hair Description of Player][else if Body Hair Length of Player is 1], covered in smooth, [Torso Color of Player] skin[end if]."]
	now Torso Adjective entry is ""; [one word descriptive adjective (avian/canine/...)]
	now Torso Adornments entry is ""; [(pouch/udders/...); partial sentence to fit: "You take a moment to feel your [torso adornments of Player]."]
	now Torso Skin Adjective entry is ""; [one word adjective (feathered/furred/scaly/...); EMPTY "" for creatures with just skin]
	now Torso Color entry is ""; [single word color adjective for the dominant color of the skin/fur/feathers/scales]
	now Torso Pattern entry is ""; [single word color adjective for the dominant pattern of the skin/fur/feathers/scales]
	now Breast Adjective entry is ""; [adjective(s) example: round, pointy, perky, saggy, bouncy. This would serve as either a general appearance of a infections breasts or possibly something that may be effected by a item or NPC.]
	now Breast Size entry is 0; [cup size as number, counting Flat Pecs = 0, A = 1, B = 2, ...]
	now Male Breast Size entry is 0; [cup size as number, counting Flat Pecs = 0, A = 1, B = 2, ...]
	now Nipple Count entry is 2; [count of nipples]
	now Nipple Color entry is ""; [one word color descriptor]
	now Nipple Shape entry is ""; [shape example: any shape will do as long as it has a baseline with a current infection or item]
	now Back Change entry is ""; [partial sentence that fits in: "Your back [one of]tingles[or]goes flush[or]vibrates with odd pleasure[or]goes cold[or]feels oily[at random] as [Back Change entry]."]
	now Back Adornments entry is ""; [partial sentence to fit: "Your back tickles with the feeling of movement caused by [back adornments of Player]."]
	now Back Skin Adjective entry is ""; [one word adjective (feathered/furred/scaly/...); EMPTY "" for creatures with just skin]
	now Back Color entry is ""; [single word color adjective for the dominant color of the skin/fur/feathers/scales]
	[Limbs Adjective is generated by a function and can be used in scenes too - "rail-thin, slender, sinewy, average, firm, muscular, flabby, meaty, rippling"]
	now Arms Change entry is ""; [partial sentence that fits in: "Your arms [one of]tingle[or]go flush[or]vibrate with odd pleasure[or]go cold[or]feel oily[at random] as [Arms Change entry]."]
	now Arms Description entry is ""; [partial sentence to fit: "Your [Limbs Adjective of Player] arms are [Arms Description of Player]."]
	now Arms Skin Adjective entry is ""; [one word adjective (feathered/furred/scaly/...); EMPTY "" for creatures with just skin]
	now Arms Color entry is ""; [single word color adjective for the dominant color of the skin/fur/feathers/scales]
	now Locomotion entry is ""; [one word adjective: (bipedal/quadrupedal/octapedal/serpentine/sliding)]
	now Legs Change entry is ""; [partial sentence that fits in: "Your legs [one of]tingle[or]go flush[or]vibrate with odd pleasure[or]go cold[or]feel oily[at random] as [Legs Change entry]."]
	now Legs Description entry is ""; [partial sentence to fit: "As your inspection goes even lower, you come to the two [Body Adjective of Player] legs supporting you. They are [legs description of Player]."]
	now Legs Skin Adjective entry is ""; [one word adjective (feathered/furred/scaly/...); EMPTY "" for creatures with just skin]
	now Legs Color entry is ""; [single word color adjective for the dominant color of the skin/fur/feathers/scales]
	now Ass Change entry is ""; [partial sentence that fits in: "Your ass [one of]tingles[or]goes flush[or]vibrates with odd pleasure[or]goes cold[or]feels oily[at random] as [Ass Change entry]."]
	now Ass Description entry is ""; [partial sentence to fit: "Using your hands you feel your behind enjoying the sensation of your [Ass Width Adjective of Player], [Ass Shape Adjective of Player] [Ass Description of Player]." (For players with skin, instead of the period: ", covered in [Ass Color of Player] skin and [Body Hair Description of Player]"]
	now Ass Skin Adjective entry is "";  [one word adjective (feathered/furred/scaly/...); EMPTY "" for creatures with just skin]
	now Ass Color entry is ""; [single word color adjective for the dominant color of the skin/fur/feathers/scales]
	now Ass Width entry is 3; [ass width from 1-5]
	[Ass Width Adjective generated by function out of ass width: dainty/small/round/huge/enormous]
	[Ass Adjective generated by function out of body definition and ass width]
	now Tail Change entry is ""; [partial sentence that fits in: "Your rear [one of]tingles[or]goes flush[or]vibrates with odd pleasure[or]goes cold[or]feels oily[at random] as [if HasTail of Player is true]your existing tail is changed into a [Tail Description entry][else][Tail Change entry][end if]."]
	now Tail Description entry is ""; [partial sentence to fit: "Just below your lower back sprouts a [tail description of Player], which you move back and forth with glee."]
	now Tail Skin Adjective entry is ""; [one word adjective (feathered/furred/scaly/...); EMPTY "" for creatures with just skin]
	now Tail Color entry is ""; [single word color adjective for the dominant color of the skin/fur/feathers/scales]
	now Asshole Depth entry is 7; [inches deep for anal fucking]
	[Asshole Depth Adjective is generated by a function and can be used in scenes too - "petite (< 3), shallow (< 5), average (< 9), deep (< 15), bottomless (15+)"]
	now Asshole Tightness entry is 3; [asshole tightness 1-5, "extremely tight, tight, receptive, open, gaping"]
	[Asshole Tightness Adjective is generated by a function and can be used in scenes too - "extremely tight, tight, receptive, open, gaping"]
	now Asshole Color entry is ""; [one word color descriptor]
	now Cock Count entry is 0;
	now Cock Girth entry is 0; [thickness 1-5, generates the Cock Girth Adjective]
	[Cock Girth Adjective is generated by a function and can be used in scenes too: thin/slender/average/thick/monstrous]
	now Cock Length entry is 0; [length in inches]
	now Cock Adjective entry is ""; [one word adjective: avian/canine/...]
	now Cock Change entry is ""; [partial sentence that fits in: "Your cock [one of]tingles[or]goes flush[or]vibrates with odd pleasure[or]goes cold[or]feels oily[at random] as [Cock Change entry]."]
	now Cock Description entry is ""; [partial sentence to fit: "You have a [Cock Girth Adjective of Player], [Cock Length of Player]-inch-long [cock adjective of Player] [one of]cock[or]penis[or]shaft[or]maleness[at random] that [cock description of Player]."]
	now Cock Color entry is ""; [one word color descriptor]
	now Ball Count entry is 0; [allowed numbers: 1 (uniball), 2 or 4]
	now Ball Size entry is 0; [size of balls 1-7: "acorn-sized", "dove egg-sized", "chicken egg-sized" "goose-egg sized", "ostrich-egg sized", "basketball-sized", "beachball-sized"]
	[Ball Size Adjective is generated by a function and can be used in scenes too]
	now Ball Description entry is ""; [partial sentence to fit: "Underneath it hangs a pair of [Ball Size Adjective of Player] [ball description of Player]."]
	now Cunt Count entry is 0;
	now Cunt Depth entry is 0; [penetratable length in inches; some minor stretching allowed, or more with Twisted Capacity]
	now Cunt Tightness entry is 0; [size 1-5, generates adjectives of extremely tight/tight/receptive/open/gaping]
	[Cunt Tightness Adjective is generated by a function and can be used in scenes too: extremely tight/tight/well-used/open/gaping]
	now Cunt Adjective entry is ""; [one word adjective: avian/canine/...]
	now Cunt Change entry is ""; [partial sentence that fits in: "Your pussy [one of]tingles[or]goes flush[or]vibrates with odd pleasure[or]goes cold[or]feels oily[at random] as [Cunt change entry]."]
	now Cunt Description entry is ""; [partial sentence to fit: "You have a [Cunt Tightness Adjective of Player] [one of]cunt[or]pussy[or]vagina[or]cleft[at random] that [cunt description of Player]."]
	now Cunt Color entry is ""; [one word color descriptor]
	now Clit Size entry is 0; [size 1-5, see Clit Size Adjective]
	[Clit Size Adjective is generated by a function and can be used in scenes: very small/small/average/large/very large]
]



Table of Random Critters (continued)
NewTypeInfection (truth state)	Species Name	Name	Enemy Title	Enemy Name	Enemy Type	Attack	Defeated	Victory	Desc	Face	Body	Skin	Tail	Cock	Face Change	Body Change	Skin Change	Ass Change	Cock Change	str	dex	sta	per	int	cha	sex	HP	lev	wdam	area	Cock Count	Cock Length	Ball Size	Nipple Count	Breast Size	Male Breast Size	Cunt Count	Cunt Depth	Cunt Tightness	Libido	Loot	Lootchance	Scale (number)	Body Descriptor (text)	Type (text)	Magic (truth state)	Resbypass (truth state)	non-infectious (truth state)	Cross-Infection (text)	DayCycle	Altcombat (text)	BannedStatus (truth state)
--	--	--	--	--	--	--	--	--	--	--	--	--	--	--	--	--	--	--	--	--	--	--	--	--	--	--	--	--	--	--	--	--	--	--	--	--	--	--	--	--	--	--	--	--	--	--	--	--	--	--;

When Play begins:
	Choose a blank row from Table of Random Critters;
	now NewTypeInfection entry is false;
	now Species Name entry is "Dalmatian";
	add "Dalmatian Bitch" to infections of CanineList;
	add "Dalmatian Bitch" to infections of NatureList;
	add "Dalmatian Bitch" to infections of FurryList;
	add "Dalmatian Bitch" to infections of FemaleList;
	add "Dalmatian Bitch" to infections of TaperedCockList;
	add "Dalmatian Bitch" to infections of KnottedCockList;
	add "Dalmatian Bitch" to infections of SheathedCockList;
	add "Dalmatian Bitch" to infections of BipedalList;
	add "Dalmatian Bitch" to infections of TailList;
	now Name entry is "Dalmatian Bitch"; [ Infection/Creature name. Capitalized. ]
	now enemy title entry is ""; [name of the encountered creature at combat start - Example: "You run into a giant collie." instead of using "Smooth Collie Shemale" infection name]
	now enemy Name entry is ""; [specific name of unique enemy]
	now enemy type entry is 0; [0 = non unique enemy; 1 = unique (unknown name); 2 = unique (known name) | Used to disqualify unique enemies from Vore/UB and showing the enemy name in encounters]
	now attack entry is "[NonCombatError]";
	now defeated entry is "[NonCombatError]";
	now victory entry is "[NonCombatError]";
	now desc entry is "[NonCombatError]";
	now face entry is "covered with black spots while long floppy ears hang down the side of your regal-looking head. A black button-nose at the end of a long[if Player is female], delicate[end if] muzzle completes the image of an anthro Dalmatian's head";
	now body entry is "lean and limber, its form fitting an anthro canine built for both strength and speed. [if Player is female]Besides that, there is also a bit of a feminine curve to your hips, making them somewhat wider as a preparation for bearing cubs. [end if]Your legs end in digitigrade dog's paws, while your arms sport paw-hands as dexterous as a human's";
	now skin entry is "short but thick fur, covered with black rosettes dotted all across your";
	now tail entry is "A thin, almost wiry white tail sways from out of the end of your bubble-shaped rump.";
	now cock entry is "[one of]canine[or]knotted[or]doggy[at random]";
	now face change entry is "your nose begins to push out from your face while your senses dull ever so slightly. Reaching up with a hand you have the strangest urge to scratch at your ears, which just so happen to be growing longer and floppier onside of your head, at the exact same moment your teeth are elongating into sharpened points. Feeling a strange sensation in your mouth, you open it while your muzzle is still taking shape, reflexively sticking out the long floppy tongue you have also gained";
	now body change entry is "strong muscle-spasms go through your form, soon followed by the crunching noise of re-forming bone. Feeling like you want to curl into a ball, you can't even manage that much in coordinated movements, instead just swaying rather drunkenly as your body reshapes itself. After long moments of painful transformation you'd rather forget, your body now resembles an anthro dalmatian, complete with digitigrade paws to stand on";
	now skin change entry is "white fur pushes free from out of your pores. The new growth quickly works to cover your entire body, bringing with it a random pattern of black dots on it";
	now ass change entry is "your buttcheeks tighten into a firm pair of buttocks and a thin and wiry tail sprouts from your lower back";
	now cock change entry is "it takes on a canine shape, complete with a furred sheath as well as a pair of weighty balls. Lust bubbles up inside you and the dog's cock that you now call your own hardens within seconds, showing off the thick knot swelling up at its base. Then you cum, spraying out what seems like a celebratory load from the newly formed cock.";
	now str entry is 15; [ These are now the creature's stats... ]
	now dex entry is 22; [ ...and are only altered onto the player via Shifting or the Mighty Mutation feat ]
	now sta entry is 20; [ These values may be used as part of alternate combat.]
	now per entry is 22;
	now int entry is 16;
	now cha entry is 20;
	now sex entry is "Female"; [ Infection will move the player towards this gender. Current: 'Male' 'Female' 'Both' ]
	now HP entry is 66; [ The monster's starting HP. ]
	now lev entry is 1; [ Monster level. (Level x 2) XP for victory. (Level / 2) XP for losing. ]
	now wdam entry is 15; [ Monster's average damage when attacking. ]
	now area entry is "Nowhere"; [ "Outside" "Mall" "Park" "Beach" etc... Check an existing creature in the area. ]
	now Cock Count entry is 0; [ Number of cocks the infection will try to cause if sex entry is 'Male' or 'Both'. ]
	now Cock Length entry is 1; [ Length infection will make cock grow to if cocks. ]
	now Ball Size entry is 1; [ Cock width, more commonly used for ball size. ]
	now Nipple Count entry is 2; [ Number of nipples the infection will give a player. ]
	now Breast Size entry is 5; [ Size of breasts the infection will try to attain. ]
	now Male Breast Size entry is 0; [ Breast size for if Sex="Male", usually zero. ]
	now Cunt Count entry is 1; [ The number of cunts the infection will try to cause if sex entry is 'Female' or 'Both'. ]
	now Cunt Depth entry is 9; [ Depth of female sex the infection will attempt to give a player. ]
	now Cunt Tightness entry is 6; [ Width of female sex the infection will try to give a player. ]
	now libido entry is 55; [ Target libido the infection will rise towards. ]
	now loot entry is ""; [ Dropped item, blank for none. Case sensitive. ]
	now lootchance entry is 0; [ Percentage chance of dropping loot, from 0-100. ]
	now scale entry is 3; [ Number 1-5, approx size/height of infected PC body: 1=tiny, 3=avg, 5=huge ]
	now body descriptor entry is "[one of]lean[or]wiry[or]dexterous[or]limber[at random]"; [ Ex: "plump" "fat" "muscled" "strong" "slimy" "gelatinous" "slender". Use [one of] to vary ]
	now type entry is "canine"; [ one-word creature type. Ex: feline, canine, lupine, robotic, human... Use [one of] to vary ]
	now magic entry is false;
	now resbypass entry is false;
	now non-infectious entry is false;
	now Cross-Infection entry is ""; [infection that this infection will give the player when they lose; can be left empty if they infect with the monster's own]
	now DayCycle entry is 0; [ 0 = Up at all times; 1 = Diurnal (day encounters only); 2 = Nocturnal (night encounters only);]
	now altcombat entry is "default";
	now BannedStatus entry is false;

[
Table of New Infection Parts (continued)
Species Name	Name	Body Weight	Body Definition	Androginity	Head Change	Head Description	Head Adjective	Head Skin Adjective	Head Color	Head Adornments	Hair Length	Hair Shape	Hair Color	Hair Style	Beard Style	Body Hair Length	Eye Color	Eye Adjective	Mouth Length	Mouth Circumference	Tongue Adjective	Tongue Color	Tongue Length	Torso Change	Torso Description	Torso Adjective	Torso Skin Adjective	Torso Adornments	Torso Color	Torso Pattern	Breast Adjective	Breast Size	Male Breast Size	Nipple Count	Nipple Color	Nipple Shape	Back Change	Back Adornments	Back Skin Adjective	Back Color	Arms Change	Arms Description	Arms Skin Adjective	Arms Color	Locomotion	Legs Change	Legs Description	Legs Skin Adjective	Legs Color	Ass Change	Ass Description	Ass Skin Adjective	Ass Color	Ass Width	Tail Change	Tail Description	tail skin adjective	Tail Color	Asshole Depth	Asshole Tightness	Asshole Color	Cock Change	Cock Description	Cock Adjective	Cock Color	Cock Count	Cock Girth	Cock Length	Ball Description	Ball Count	Ball Size	Cunt Change	Cunt Description	Cunt Adjective	Cunt Color	Cunt Count	Cunt Depth	Cunt Tightness	Clit Size
--	--	--	--	--	--	--	--	--	--	--	--	--	--	--	--	--	--	--	--	--	--	--	--	--	--	--	--	--	--	--	--	--	--	--	--	--	--	--	--	--	--	--	--	--	--	--	--	--	--	--	--	--	--	--	--	--	--	--	--	--	--	--	--	--	--	--	--	--	--	--	--	--	--	--	--	--	--	--;

When Play begins:
	Choose a blank row from Table of New Infection Parts;
	now Species Name entry is ""; [name of the overall species of the infection, used for children, ...]
	now Name entry is ""; [matching infection name to Table of Random Critters]
	now Body Weight entry is 5; [scale of 1-9 for body weight, grouped into low weight (1-3), mid weight (4-6) and high weight (7-9)]
	now Body Definition entry is 5; [scale of 1-9 for body definition, grouped into low muscle (1-3), mid muscle (4-6), high muscle (7-9)]
	[Body Adjective is generated out of the body weight and body definition and can be used in scenes - one word descriptive adjective depending on weight and definition groups: low weight group: skinny/slender/lithe; mid weight group: average/fit/muscled; high weight group: pudgy/husky/jacked]
	now Androginity entry is 5; [1-9 scale of hypermasculine to hyperfeminine]
	[Gender Adjective is generated out of androginity 1-9: hypermasculine/masculine/effeminate/somewhat effeminate/androgynous/feminine butch/tomboyish/feminine/hyperfeminine]
	now Head Change entry is ""; [partial sentence that fits in: "Your head and face [one of]tingle[or]go flush[or]vibrate with odd pleasure[or]go cold[or]feel oily[at random] as [head change entry]."]
	now Head Description entry is ""; [partial sentence that fits in "Your face and head resemble that of [Head Description of Player]. You have [Eye Adjective of Player], [Eye Color of Player] eyes and an overall [Gender Adjective of Player] appearance."]
	now Head Adjective entry is ""; [one word descriptive adjective (avian/canine/...)]
	now Head Skin Adjective entry is ""; [one word descriptive adjective]
	now Head Color entry is ""; [single word color adjective for the dominant color of the skin/fur/feathers/scales]
	now Head Adornments entry is "";[partial sentence that fits in "Before moving on from your head, you give your [head adornments of Player] a proud glance followed by a light caress."]
	now Hair Length entry is 2; [hair length in inches]
	now Hair Shape entry is ""; [one word shape descriptor (curly/straight/...)]
	now Hair Color entry is ""; [one word color descriptor]
	now Hair Style entry is ""; [one word style descriptor (ponytail/mohawk/buzzcut/...) to fit "On top of your head you have [Hair Length of Player] inch long, [Hair Shape of Player] [Hair Color of Player] hair in the [Hair Style of Player] style."]
	now Beard Style entry is ""; [short beard style (goatee/3-day stubble beard/porn stache/mutton chops beard/...) to go into "You have a [Hair Color of Player] [Beard Style of Player]."]
	now Body Hair Length entry is 0; [numerical value, 0-4 (no body hair/light/moderate/heavy/furry) - only set to > 0 if the infection does not have fur/scales/etc. !]
	now Eye Color entry is ""; [one word color descriptor]
	now Eye Adjective entry is ""; [one word descriptive adjective (slitted/round/...)]
	now Mouth Length entry is 3; [inches deep for face fucking; maximum possible will be double this number (when deep throating)]
	[Mouth Length Adjective  is generated by a function and can be used in scenes too - "petite, shallow, average, deep, bottomless"]
	now Mouth Circumference entry is 3; [mouth circumference 1-5, see Mouth Circumference Adjective]
	[Mouth Circumference Adjective is generated by a function and can be used in scenes too - "tiny, small, normal, wide, gaping"]
	now Tongue Adjective entry is ""; [one word descriptive adjective (wide/slobbery/...)]
	now Tongue Color entry is ""; [one word color descriptor]
	now Tongue Length entry is 3; [length in inches]
	now Torso Change entry is ""; [partial sentence that fits in: "Your torso [one of]tingles[or]goes flush[or]vibrates with odd pleasure[or]goes cold[or]feels oily[at random] as [Torso Change entry]."]
	now Torso Description entry is ""; [partial sentence, fitting in "Looking down at yourself, you appear [Gender Adjective of Player] with a [Body Adjective of Player] build. Your torso is [Torso Description of Player][if Body Hair Length of Player > 1], covered in [Torso Color of Player] skin and [Body Hair Description of Player][else if Body Hair Length of Player is 1], covered in smooth, [Torso Color of Player] skin[end if]."]
	now Torso Adjective entry is ""; [one word descriptive adjective (avian/canine/...)]
	now Torso Adornments entry is ""; [(pouch/udders/...); partial sentence to fit: "You take a moment to feel your [torso adornments of Player]."]
	now Torso Skin Adjective entry is ""; [one word adjective (feathered/furred/scaly/...); EMPTY "" for creatures with just skin]
	now Torso Color entry is ""; [single word color adjective for the dominant color of the skin/fur/feathers/scales]
	now Torso Pattern entry is ""; [single word color adjective for the dominant pattern of the skin/fur/feathers/scales]
	now Breast Adjective entry is ""; [adjective(s) example: round, pointy, perky, saggy, bouncy. This would serve as either a general appearance of a infections breasts or possibly something that may be effected by a item or NPC.]
	now Breast Size entry is 0; [cup size as number, counting Flat Pecs = 0, A = 1, B = 2, ...]
	now Male Breast Size entry is 0; [cup size as number, counting Flat Pecs = 0, A = 1, B = 2, ...]
	now Nipple Count entry is 2; [count of nipples]
	now Nipple Color entry is ""; [one word color descriptor]
	now Nipple Shape entry is ""; [shape example: any shape will do as long as it has a baseline with a current infection or item]
	now Back Change entry is ""; [partial sentence that fits in: "Your back [one of]tingles[or]goes flush[or]vibrates with odd pleasure[or]goes cold[or]feels oily[at random] as [Back Change entry]."]
	now Back Adornments entry is ""; [partial sentence to fit: "Your back tickles with the feeling of movement caused by [back adornments of Player]."]
	now Back Skin Adjective entry is ""; [one word adjective (feathered/furred/scaly/...); EMPTY "" for creatures with just skin]
	now Back Color entry is ""; [single word color adjective for the dominant color of the skin/fur/feathers/scales]
	[Limbs Adjective is generated by a function and can be used in scenes too - "rail-thin, slender, sinewy, average, firm, muscular, flabby, meaty, rippling"]
	now Arms Change entry is ""; [partial sentence that fits in: "Your arms [one of]tingle[or]go flush[or]vibrate with odd pleasure[or]go cold[or]feel oily[at random] as [Arms Change entry]."]
	now Arms Description entry is ""; [partial sentence to fit: "Your [Limbs Adjective of Player] arms are [Arms Description of Player]."]
	now Arms Skin Adjective entry is ""; [one word adjective (feathered/furred/scaly/...); EMPTY "" for creatures with just skin]
	now Arms Color entry is ""; [single word color adjective for the dominant color of the skin/fur/feathers/scales]
	now Locomotion entry is ""; [one word adjective: (bipedal/quadrupedal/octapedal/serpentine/sliding)]
	now Legs Change entry is ""; [partial sentence that fits in: "Your legs [one of]tingle[or]go flush[or]vibrate with odd pleasure[or]go cold[or]feel oily[at random] as [Legs Change entry]."]
	now Legs Description entry is ""; [partial sentence to fit: "As your inspection goes even lower, you come to the two [Body Adjective of Player] legs supporting you. They are [legs description of Player]."]
	now Legs Skin Adjective entry is ""; [one word adjective (feathered/furred/scaly/...); EMPTY "" for creatures with just skin]
	now Legs Color entry is ""; [single word color adjective for the dominant color of the skin/fur/feathers/scales]
	now Ass Change entry is ""; [partial sentence that fits in: "Your ass [one of]tingles[or]goes flush[or]vibrates with odd pleasure[or]goes cold[or]feels oily[at random] as [Ass Change entry]."]
	now Ass Description entry is ""; [partial sentence to fit: "Using your hands you feel your behind enjoying the sensation of your [Ass Width Adjective of Player], [Ass Shape Adjective of Player] [Ass Description of Player]." (For players with skin, instead of the period: ", covered in [Ass Color of Player] skin and [Body Hair Description of Player]"]
	now Ass Skin Adjective entry is "";  [one word adjective (feathered/furred/scaly/...); EMPTY "" for creatures with just skin]
	now Ass Color entry is ""; [single word color adjective for the dominant color of the skin/fur/feathers/scales]
	now Ass Width entry is 3; [ass width from 1-5]
	[Ass Width Adjective generated by function out of ass width: dainty/small/round/huge/enormous]
	[Ass Adjective generated by function out of body definition and ass width]
	now Tail Change entry is ""; [partial sentence that fits in: "Your rear [one of]tingles[or]goes flush[or]vibrates with odd pleasure[or]goes cold[or]feels oily[at random] as [if HasTail of Player is true]your existing tail is changed into a [Tail Description entry][else][Tail Change entry][end if]."]
	now Tail Description entry is ""; [partial sentence to fit: "Just below your lower back sprouts a [tail description of Player], which you move back and forth with glee."]
	now Tail Skin Adjective entry is ""; [one word adjective (feathered/furred/scaly/...); EMPTY "" for creatures with just skin]
	now Tail Color entry is ""; [single word color adjective for the dominant color of the skin/fur/feathers/scales]
	now Asshole Depth entry is 7; [inches deep for anal fucking]
	[Asshole Depth Adjective is generated by a function and can be used in scenes too - "petite (< 3), shallow (< 5), average (< 9), deep (< 15), bottomless (15+)"]
	now Asshole Tightness entry is 3; [asshole tightness 1-5, "extremely tight, tight, receptive, open, gaping"]
	[Asshole Tightness Adjective is generated by a function and can be used in scenes too - "extremely tight, tight, receptive, open, gaping"]
	now Asshole Color entry is ""; [one word color descriptor]
	now Cock Count entry is 0;
	now Cock Girth entry is 0; [thickness 1-5, generates the Cock Girth Adjective]
	[Cock Girth Adjective is generated by a function and can be used in scenes too: thin/slender/average/thick/monstrous]
	now Cock Length entry is 0; [length in inches]
	now Cock Adjective entry is ""; [one word adjective: avian/canine/...]
	now Cock Change entry is ""; [partial sentence that fits in: "Your cock [one of]tingles[or]goes flush[or]vibrates with odd pleasure[or]goes cold[or]feels oily[at random] as [Cock Change entry]."]
	now Cock Description entry is ""; [partial sentence to fit: "You have a [Cock Girth Adjective of Player], [Cock Length of Player]-inch-long [cock adjective of Player] [one of]cock[or]penis[or]shaft[or]maleness[at random] that [cock description of Player]."]
	now Cock Color entry is ""; [one word color descriptor]
	now Ball Count entry is 0; [allowed numbers: 1 (uniball), 2 or 4]
	now Ball Size entry is 0; [size of balls 1-7: "acorn-sized", "dove egg-sized", "chicken egg-sized" "goose-egg sized", "ostrich-egg sized", "basketball-sized", "beachball-sized"]
	[Ball Size Adjective is generated by a function and can be used in scenes too]
	now Ball Description entry is ""; [partial sentence to fit: "Underneath it hangs a pair of [Ball Size Adjective of Player] [ball description of Player]."]
	now Cunt Count entry is 0;
	now Cunt Depth entry is 0; [penetratable length in inches; some minor stretching allowed, or more with Twisted Capacity]
	now Cunt Tightness entry is 0; [size 1-5, generates adjectives of extremely tight/tight/receptive/open/gaping]
	[Cunt Tightness Adjective is generated by a function and can be used in scenes too: extremely tight/tight/well-used/open/gaping]
	now Cunt Adjective entry is ""; [one word adjective: avian/canine/...]
	now Cunt Change entry is ""; [partial sentence that fits in: "Your pussy [one of]tingles[or]goes flush[or]vibrates with odd pleasure[or]goes cold[or]feels oily[at random] as [Cunt change entry]."]
	now Cunt Description entry is ""; [partial sentence to fit: "You have a [Cunt Tightness Adjective of Player] [one of]cunt[or]pussy[or]vagina[or]cleft[at random] that [cunt description of Player]."]
	now Cunt Color entry is ""; [one word color descriptor]
	now Clit Size entry is 0; [size 1-5 (very small/small/average/large/very large)] [Size of Clit (1-5); very small/small/average/large/very large]
]

Table of Random Critters (continued)
NewTypeInfection (truth state)	Species Name	Name	Enemy Title	Enemy Name	Enemy Type	Attack	Defeated	Victory	Desc	Face	Body	Skin	Tail	Cock	Face Change	Body Change	Skin Change	Ass Change	Cock Change	str	dex	sta	per	int	cha	sex	HP	lev	wdam	area	Cock Count	Cock Length	Ball Size	Nipple Count	Breast Size	Male Breast Size	Cunt Count	Cunt Depth	Cunt Tightness	Libido	Loot	Lootchance	Scale (number)	Body Descriptor (text)	Type (text)	Magic (truth state)	Resbypass (truth state)	non-infectious (truth state)	Cross-Infection (text)	DayCycle	Altcombat (text)	BannedStatus (truth state)
--	--	--	--	--	--	--	--	--	--	--	--	--	--	--	--	--	--	--	--	--	--	--	--	--	--	--	--	--	--	--	--	--	--	--	--	--	--	--	--	--	--	--	--	--	--	--	--	--	--	--;

When Play begins:
	Choose a blank row from Table of Random Critters;
	now NewTypeInfection entry is false;
	now Species Name entry is "Dalmatian";
	add "Dalmatian Herm" to infections of CanineList;
	add "Dalmatian Herm" to infections of NatureList;
	add "Dalmatian Herm" to infections of FurryList;
	add "Dalmatian Herm" to infections of HermList;
	add "Dalmatian Herm" to infections of TaperedCockList;
	add "Dalmatian Herm" to infections of KnottedCockList;
	add "Dalmatian Herm" to infections of SheathedCockList;
	add "Dalmatian Herm" to infections of BipedalList;
	add "Dalmatian Herm" to infections of TailList;
	now Name entry is "Dalmatian Herm"; [ Infection/Creature name. Capitalized. ]
	now enemy title entry is ""; [name of the encountered creature at combat start - Example: "You run into a giant collie." instead of using "Smooth Collie Shemale" infection name]
	now enemy Name entry is ""; [specific name of unique enemy]
	now enemy type entry is 0; [0 = non unique enemy; 1 = unique (unknown name); 2 = unique (known name) | Used to disqualify unique enemies from Vore/UB and showing the enemy name in encounters]
	now attack entry is "[NonCombatError]";
	now defeated entry is "[NonCombatError]";
	now victory entry is "[NonCombatError]";
	now desc entry is "[NonCombatError]";
	now face entry is "covered with black spots while long floppy ears hang down the side of your regal-looking head. A black button-nose at the end of a long[if Player is female], delicate[end if] muzzle completes the image of an anthro Dalmatian's head";
	now body entry is "lean and limber, its form fitting an anthro canine built for both strength and speed. [if Player is female]Besides that, there is also a bit of a feminine curve to your hips, making them somewhat wider as a preparation for bearing cubs. [end if]Your legs end in digitigrade dog's paws, while your arms sport paw-hands as dexterous as a human's";
	now skin entry is "short but thick fur, covered with black rosettes dotted all across your";
	now tail entry is "A thin, almost wiry white tail sways from out of the end of your bubble-shaped rump.";
	now cock entry is "[one of]canine[or]knotted[or]doggy[at random]";
	now face change entry is "your nose begins to push out from your face while your senses dull ever so slightly. Reaching up with a hand you have the strangest urge to scratch at your ears, which just so happen to be growing longer and floppier onside of your head, at the exact same moment your teeth are elongating into sharpened points. Feeling a strange sensation in your mouth, you open it while your muzzle is still taking shape, reflexively sticking out the long floppy tongue you have also gained";
	now body change entry is "strong muscle-spasms go through your form, soon followed by the crunching noise of re-forming bone. Feeling like you want to curl into a ball, you can't even manage that much in coordinated movements, instead just swaying rather drunkenly as your body reshapes itself. After long moments of painful transformation you'd rather forget, your body now resembles an anthro dalmatian, complete with digitigrade paws to stand on";
	now skin change entry is "white fur pushes free from out of your pores. The new growth quickly works to cover your entire body, bringing with it a random pattern of black dots on it";
	now ass change entry is "your buttcheeks tighten into a firm pair of buttocks and a thin and wiry tail sprouts from your lower back";
	now cock change entry is "it takes on a canine shape, complete with a furred sheath as well as a pair of weighty balls. Lust bubbles up inside you and the dog's cock that you now call your own hardens within seconds, showing off the thick knot swelling up at its base. Then you cum, spraying out what seems like a celebratory load from the newly formed cock.";
	now str entry is 15; [ These are now the creature's stats... ]
	now dex entry is 22; [ ...and are only altered onto the player via Shifting or the Mighty Mutation feat ]
	now sta entry is 20; [ These values may be used as part of alternate combat.]
	now per entry is 22;
	now int entry is 16;
	now cha entry is 20;
	now sex entry is "Both"; [ Infection will move the player towards this gender. Current: 'Male' 'Female' 'Both' ]
	now HP entry is 66; [ The monster's starting HP. ]
	now lev entry is 1; [ Monster level. (Level x 2) XP for victory. (Level / 2) XP for losing. ]
	now wdam entry is 15; [ Monster's average damage when attacking. ]
	now area entry is "Nowhere"; [ "Outside" "Mall" "Park" "Beach" etc... Check an existing creature in the area. ]
	now Cock Count entry is 1; [ Number of cocks the infection will try to cause if sex entry is 'Male' or 'Both'. ]
	now Cock Length entry is 12; [ Length infection will make cock grow to if cocks. ]
	now Ball Size entry is 3; [ Cock width, more commonly used for ball size. ]
	now Nipple Count entry is 2; [ Number of nipples the infection will give a player. ]
	now Breast Size entry is 5; [ Size of breasts the infection will try to attain. ]
	now Male Breast Size entry is 0; [ Breast size for if Sex="Male", usually zero. ]
	now Cunt Count entry is 1; [ The number of cunts the infection will try to cause if sex entry is 'Female' or 'Both'. ]
	now Cunt Depth entry is 9; [ Depth of female sex the infection will attempt to give a player. ]
	now Cunt Tightness entry is 6; [ Width of female sex the infection will try to give a player. ]
	now libido entry is 55; [ Target libido the infection will rise towards. ]
	now loot entry is ""; [ Dropped item, blank for none. Case sensitive. ]
	now lootchance entry is 0; [ Percentage chance of dropping loot, from 0-100. ]
	now scale entry is 3; [ Number 1-5, approx size/height of infected PC body: 1=tiny, 3=avg, 5=huge ]
	now body descriptor entry is "[one of]lean[or]wiry[or]dexterous[or]limber[at random]"; [ Ex: "plump" "fat" "muscled" "strong" "slimy" "gelatinous" "slender". Use [one of] to vary ]
	now type entry is "canine"; [ one-word creature type. Ex: feline, canine, lupine, robotic, human... Use [one of] to vary ]
	now magic entry is false;
	now resbypass entry is false;
	now non-infectious entry is false;
	now DayCycle entry is 0; [ 0 = Up at all times; 1 = Diurnal (day encounters only); 2 = Nocturnal (night encounters only);]
	now altcombat entry is "default";
	now BannedStatus entry is false;

[
Table of New Infection Parts (continued)
Species Name	Name	Body Weight	Body Definition	Androginity	Head Change	Head Description	Head Adjective	Head Skin Adjective	Head Color	Head Adornments	Hair Length	Hair Shape	Hair Color	Hair Style	Beard Style	Body Hair Length	Eye Color	Eye Adjective	Mouth Length	Mouth Circumference	Tongue Adjective	Tongue Color	Tongue Length	Torso Change	Torso Description	Torso Adjective	Torso Skin Adjective	Torso Adornments	Torso Color	Torso Pattern	Breast Adjective	Breast Size	Male Breast Size	Nipple Count	Nipple Color	Nipple Shape	Back Change	Back Adornments	Back Skin Adjective	Back Color	Arms Change	Arms Description	Arms Skin Adjective	Arms Color	Locomotion	Legs Change	Legs Description	Legs Skin Adjective	Legs Color	Ass Change	Ass Description	Ass Skin Adjective	Ass Color	Ass Width	Tail Change	Tail Description	tail skin adjective	Tail Color	Asshole Depth	Asshole Tightness	Asshole Color	Cock Change	Cock Description	Cock Adjective	Cock Color	Cock Count	Cock Girth	Cock Length	Ball Description	Ball Count	Ball Size	Cunt Change	Cunt Description	Cunt Adjective	Cunt Color	Cunt Count	Cunt Depth	Cunt Tightness	Clit Size
--	--	--	--	--	--	--	--	--	--	--	--	--	--	--	--	--	--	--	--	--	--	--	--	--	--	--	--	--	--	--	--	--	--	--	--	--	--	--	--	--	--	--	--	--	--	--	--	--	--	--	--	--	--	--	--	--	--	--	--	--	--	--	--	--	--	--	--	--	--	--	--	--	--	--	--	--	--	--;

When Play begins:
	Choose a blank row from Table of New Infection Parts;
	now Species Name entry is ""; [name of the overall species of the infection, used for children, ...]
	now Name entry is ""; [matching infection name to Table of Random Critters]
	now Body Weight entry is 5; [scale of 1-9 for body weight, grouped into low weight (1-3), mid weight (4-6) and high weight (7-9)]
	now Body Definition entry is 5; [scale of 1-9 for body definition, grouped into low muscle (1-3), mid muscle (4-6), high muscle (7-9)]
	[Body Adjective is generated out of the body weight and body definition and can be used in scenes - one word descriptive adjective depending on weight and definition groups: low weight group: skinny/slender/lithe; mid weight group: average/fit/muscled; high weight group: pudgy/husky/jacked]
	now Androginity entry is 5; [1-9 scale of hypermasculine to hyperfeminine]
	[Gender Adjective is generated out of androginity 1-9: hypermasculine/masculine/effeminate/somewhat effeminate/androgynous/feminine butch/tomboyish/feminine/hyperfeminine]
	now Head Change entry is ""; [partial sentence that fits in: "Your head and face [one of]tingle[or]go flush[or]vibrate with odd pleasure[or]go cold[or]feel oily[at random] as [head change entry]."]
	now Head Description entry is ""; [partial sentence that fits in "Your face and head resemble that of [Head Description of Player]. You have [Eye Adjective of Player], [Eye Color of Player] eyes and an overall [Gender Adjective of Player] appearance."]
	now Head Adjective entry is ""; [one word descriptive adjective (avian/canine/...)]
	now Head Skin Adjective entry is ""; [one word descriptive adjective]
	now Head Color entry is ""; [single word color adjective for the dominant color of the skin/fur/feathers/scales]
	now Head Adornments entry is "";[partial sentence that fits in "Before moving on from your head, you give your [head adornments of Player] a proud glance followed by a light caress."]
	now Hair Length entry is 2; [hair length in inches]
	now Hair Shape entry is ""; [one word shape descriptor (curly/straight/...)]
	now Hair Color entry is ""; [one word color descriptor]
	now Hair Style entry is ""; [one word style descriptor (ponytail/mohawk/buzzcut/...) to fit "On top of your head you have [Hair Length of Player] inch long, [Hair Shape of Player] [Hair Color of Player] hair in the [Hair Style of Player] style."]
	now Beard Style entry is ""; [short beard style (goatee/3-day stubble beard/porn stache/mutton chops beard/...) to go into "You have a [Hair Color of Player] [Beard Style of Player]."]
	now Body Hair Length entry is 0; [numerical value, 0-4 (no body hair/light/moderate/heavy/furry) - only set to > 0 if the infection does not have fur/scales/etc. !]
	now Eye Color entry is ""; [one word color descriptor]
	now Eye Adjective entry is ""; [one word descriptive adjective (slitted/round/...)]
	now Mouth Length entry is 3; [inches deep for face fucking; maximum possible will be double this number (when deep throating)]
	[Mouth Length Adjective  is generated by a function and can be used in scenes too - "petite, shallow, average, deep, bottomless"]
	now Mouth Circumference entry is 3; [mouth circumference 1-5, see Mouth Circumference Adjective]
	[Mouth Circumference Adjective is generated by a function and can be used in scenes too - "tiny, small, normal, wide, gaping"]
	now Tongue Adjective entry is ""; [one word descriptive adjective (wide/slobbery/...)]
	now Tongue Color entry is ""; [one word color descriptor]
	now Tongue Length entry is 3; [length in inches]
	now Torso Change entry is ""; [partial sentence that fits in: "Your torso [one of]tingles[or]goes flush[or]vibrates with odd pleasure[or]goes cold[or]feels oily[at random] as [Torso Change entry]."]
	now Torso Description entry is ""; [partial sentence, fitting in "Looking down at yourself, you appear [Gender Adjective of Player] with a [Body Adjective of Player] build. Your torso is [Torso Description of Player][if Body Hair Length of Player > 1], covered in [Torso Color of Player] skin and [Body Hair Description of Player][else if Body Hair Length of Player is 1], covered in smooth, [Torso Color of Player] skin[end if]."]
	now Torso Adjective entry is ""; [one word descriptive adjective (avian/canine/...)]
	now Torso Adornments entry is ""; [(pouch/udders/...); partial sentence to fit: "You take a moment to feel your [torso adornments of Player]."]
	now Torso Skin Adjective entry is ""; [one word adjective (feathered/furred/scaly/...); EMPTY "" for creatures with just skin]
	now Torso Color entry is ""; [single word color adjective for the dominant color of the skin/fur/feathers/scales]
	now Torso Pattern entry is ""; [single word color adjective for the dominant pattern of the skin/fur/feathers/scales]
	now Breast Adjective entry is ""; [adjective(s) example: round, pointy, perky, saggy, bouncy. This would serve as either a general appearance of a infections breasts or possibly something that may be effected by a item or NPC.]
	now Breast Size entry is 0; [cup size as number, counting Flat Pecs = 0, A = 1, B = 2, ...]
	now Male Breast Size entry is 0; [cup size as number, counting Flat Pecs = 0, A = 1, B = 2, ...]
	now Nipple Count entry is 2; [count of nipples]
	now Nipple Color entry is ""; [one word color descriptor]
	now Nipple Shape entry is ""; [shape example: any shape will do as long as it has a baseline with a current infection or item]
	now Back Change entry is ""; [partial sentence that fits in: "Your back [one of]tingles[or]goes flush[or]vibrates with odd pleasure[or]goes cold[or]feels oily[at random] as [Back Change entry]."]
	now Back Adornments entry is ""; [partial sentence to fit: "Your back tickles with the feeling of movement caused by [back adornments of Player]."]
	now Back Skin Adjective entry is ""; [one word adjective (feathered/furred/scaly/...); EMPTY "" for creatures with just skin]
	now Back Color entry is ""; [single word color adjective for the dominant color of the skin/fur/feathers/scales]
	[Limbs Adjective is generated by a function and can be used in scenes too - "rail-thin, slender, sinewy, average, firm, muscular, flabby, meaty, rippling"]
	now Arms Change entry is ""; [partial sentence that fits in: "Your arms [one of]tingle[or]go flush[or]vibrate with odd pleasure[or]go cold[or]feel oily[at random] as [Arms Change entry]."]
	now Arms Description entry is ""; [partial sentence to fit: "Your [Limbs Adjective of Player] arms are [Arms Description of Player]."]
	now Arms Skin Adjective entry is ""; [one word adjective (feathered/furred/scaly/...); EMPTY "" for creatures with just skin]
	now Arms Color entry is ""; [single word color adjective for the dominant color of the skin/fur/feathers/scales]
	now Locomotion entry is ""; [one word adjective: (bipedal/quadrupedal/octapedal/serpentine/sliding)]
	now Legs Change entry is ""; [partial sentence that fits in: "Your legs [one of]tingle[or]go flush[or]vibrate with odd pleasure[or]go cold[or]feel oily[at random] as [Legs Change entry]."]
	now Legs Description entry is ""; [partial sentence to fit: "As your inspection goes even lower, you come to the two [Body Adjective of Player] legs supporting you. They are [legs description of Player]."]
	now Legs Skin Adjective entry is ""; [one word adjective (feathered/furred/scaly/...); EMPTY "" for creatures with just skin]
	now Legs Color entry is ""; [single word color adjective for the dominant color of the skin/fur/feathers/scales]
	now Ass Change entry is ""; [partial sentence that fits in: "Your ass [one of]tingles[or]goes flush[or]vibrates with odd pleasure[or]goes cold[or]feels oily[at random] as [Ass Change entry]."]
	now Ass Description entry is ""; [partial sentence to fit: "Using your hands you feel your behind enjoying the sensation of your [Ass Width Adjective of Player], [Ass Shape Adjective of Player] [Ass Description of Player]." (For players with skin, instead of the period: ", covered in [Ass Color of Player] skin and [Body Hair Description of Player]"]
	now Ass Skin Adjective entry is "";  [one word adjective (feathered/furred/scaly/...); EMPTY "" for creatures with just skin]
	now Ass Color entry is ""; [single word color adjective for the dominant color of the skin/fur/feathers/scales]
	now Ass Width entry is 3; [ass width from 1-5]
	[Ass Width Adjective generated by function out of ass width: dainty/small/round/huge/enormous]
	[Ass Adjective generated by function out of body definition and ass width]
	now Tail Change entry is ""; [partial sentence that fits in: "Your rear [one of]tingles[or]goes flush[or]vibrates with odd pleasure[or]goes cold[or]feels oily[at random] as [if HasTail of Player is true]your existing tail is changed into a [Tail Description entry][else][Tail Change entry][end if]."]
	now Tail Description entry is ""; [partial sentence to fit: "Just below your lower back sprouts a [tail description of Player], which you move back and forth with glee."]
	now Tail Skin Adjective entry is ""; [one word adjective (feathered/furred/scaly/...); EMPTY "" for creatures with just skin]
	now Tail Color entry is ""; [single word color adjective for the dominant color of the skin/fur/feathers/scales]
	now Asshole Depth entry is 7; [inches deep for anal fucking]
	[Asshole Depth Adjective is generated by a function and can be used in scenes too - "petite (< 3), shallow (< 5), average (< 9), deep (< 15), bottomless (15+)"]
	now Asshole Tightness entry is 3; [asshole tightness 1-5, "extremely tight, tight, receptive, open, gaping"]
	[Asshole Tightness Adjective is generated by a function and can be used in scenes too - "extremely tight, tight, receptive, open, gaping"]
	now Asshole Color entry is ""; [one word color descriptor]
	now Cock Count entry is 0; [number of cocks]
	now Cock Girth entry is 0; [thickness 1-5, generates the Cock Girth Adjective]
	[Cock Girth Adjective is generated by a function and can be used in scenes too: thin/slender/average/thick/monstrous]
	now Cock Length entry is 0; [length in inches]
	now Cock Adjective entry is ""; [one word adjective: avian/canine/...]
	now Cock Change entry is ""; [partial sentence that fits in: "Your cock [one of]tingles[or]goes flush[or]vibrates with odd pleasure[or]goes cold[or]feels oily[at random] as [Cock Change entry]."]
	now Cock Description entry is ""; [partial sentence to fit: "You have a [Cock Girth Adjective of Player], [Cock Length of Player]-inch-long [cock adjective of Player] [one of]cock[or]penis[or]shaft[or]maleness[at random] that [cock description of Player]."]
	now Cock Color entry is ""; [one word color descriptor]
	now Ball Count entry is 0; [allowed numbers: 1 (uniball), 2 or 4]
	now Ball Size entry is 0; [size of balls 1-7: "acorn-sized", "dove egg-sized", "chicken egg-sized" "goose-egg sized", "ostrich-egg sized", "basketball-sized", "beachball-sized"]
	[Ball Size Adjective is generated by a function and can be used in scenes too]
	now Ball Description entry is ""; [partial sentence to fit: "Underneath it hangs a pair of [Ball Size Adjective of Player] [ball description of Player]."]
	now Cunt Count entry is 0; [number of pussies]
	now Cunt Depth entry is 0; [penetratable length in inches; some minor stretching allowed, or more with Twisted Capacity]
	now Cunt Tightness entry is 0; [size 1-5, generates adjectives of extremely tight/tight/receptive/open/gaping]
	[Cunt Tightness Adjective is generated by a function and can be used in scenes too: extremely tight/tight/well-used/open/gaping]
	now Cunt Adjective entry is ""; [one word adjective: avian/canine/...]
	now Cunt Change entry is ""; [partial sentence that fits in: "Your pussy [one of]tingles[or]goes flush[or]vibrates with odd pleasure[or]goes cold[or]feels oily[at random] as [Cunt change entry]."]
	now Cunt Description entry is ""; [partial sentence to fit: "You have a [Cunt Tightness Adjective of Player] [one of]cunt[or]pussy[or]vagina[or]cleft[at random] that [cunt description of Player]."]
	now Cunt Color entry is ""; [one word color descriptor]
	now Clit Size entry is 0; [size 1-5 (very small/small/average/large/very large)] [Size of Clit (1-5); very small/small/average/large/very large]
]


Table of Random Critters (continued)
NewTypeInfection (truth state)	Species Name	Name	Enemy Title	Enemy Name	Enemy Type	Attack	Defeated	Victory	Desc	Face	Body	Skin	Tail	Cock	Face Change	Body Change	Skin Change	Ass Change	Cock Change	str	dex	sta	per	int	cha	sex	HP	lev	wdam	area	Cock Count	Cock Length	Ball Size	Nipple Count	Breast Size	Male Breast Size	Cunt Count	Cunt Depth	Cunt Tightness	Libido	Loot	Lootchance	Scale (number)	Body Descriptor (text)	Type (text)	Magic (truth state)	Resbypass (truth state)	non-infectious (truth state)	Cross-Infection (text)	DayCycle	Altcombat (text)	BannedStatus (truth state)
--	--	--	--	--	--	--	--	--	--	--	--	--	--	--	--	--	--	--	--	--	--	--	--	--	--	--	--	--	--	--	--	--	--	--	--	--	--	--	--	--	--	--	--	--	--	--	--	--	--	--;

When Play begins:
	Choose a blank row from Table of Random Critters;
	now NewTypeInfection entry is false;
	now Species Name entry is "Dalmatian";
	add "Dalmatian Transman" to infections of CanineList;
	add "Dalmatian Transman" to infections of NatureList;
	add "Dalmatian Transman" to infections of FurryList;
	add "Dalmatian Transman" to infections of TransList;
	add "Dalmatian Transman" to infections of TaperedCockList;
	add "Dalmatian Transman" to infections of KnottedCockList;
	add "Dalmatian Transman" to infections of SheathedCockList;
	add "Dalmatian Transman" to infections of BipedalList;
	add "Dalmatian Transman" to infections of TailList;
	now Name entry is "Dalmatian Transman"; [ Infection/Creature name. Capitalized. ]
	now enemy title entry is ""; [name of the encountered creature at combat start - Example: "You run into a giant collie." instead of using "Smooth Collie Shemale" infection name]
	now enemy Name entry is ""; [specific name of unique enemy]
	now enemy type entry is 0; [0 = non unique enemy; 1 = unique (unknown name); 2 = unique (known name) | Used to disqualify unique enemies from Vore/UB and showing the enemy name in encounters]
	now attack entry is "[NonCombatError]";
	now defeated entry is "[NonCombatError]";
	now victory entry is "[NonCombatError]";
	now desc entry is "[NonCombatError]";
	now face entry is "covered with black spots while long floppy ears hang down the side of your regal-looking head. A black button-nose at the end of a long muzzle completes the image of an anthro Dalmatian's head";
	now body entry is "lean and limber, its form fitting an anthro canine built for both strength and speed. Your legs end in digitigrade dog's paws, while your arms sport paw-hands as dexterous as a human's";
	now skin entry is "short but thick fur, covered with black rosettes dotted all across your";
	now tail entry is "A thin, almost wiry white tail sways from out of the end of your bubble-shaped rump.";
	now cock entry is "[one of]canine[or]knotted[or]doggy[at random]";
	now face change entry is "your nose begins to push out from your face while your senses dull ever so slightly. Reaching up with a hand you have the strangest urge to scratch at your ears, which just so happen to be growing longer and floppier onside of your head, at the exact same moment your teeth are elongating into sharpened points. Feeling a strange sensation in your mouth, you open it while your muzzle is still taking shape, reflexively sticking out the long floppy tongue you have also gained";
	now body change entry is "strong muscle-spasms go through your form, soon followed by the crunching noise of re-forming bone. Feeling like you want to curl into a ball, you can't even manage that much in coordinated movements, instead just swaying rather drunkenly as your body reshapes itself. After long moments of painful transformation you'd rather forget, your body now resembles an anthro dalmatian, complete with digitigrade paws to stand on";
	now skin change entry is "white fur pushes free from out of your pores. The new growth quickly works to cover your entire body, bringing with it a random pattern of black dots on it";
	now ass change entry is "your buttcheeks tighten into a firm pair of buttocks and a thin and wiry tail sprouts from your lower back";
	now cock change entry is "it takes on a canine shape, complete with a furred sheath as well as a pair of weighty balls. Lust bubbles up inside you and the dog's cock that you now call your own hardens within seconds, showing off the thick knot swelling up at its base. Then you cum, spraying out what seems like a celebratory load from the newly formed cock.";
	now str entry is 15; [ These are now the creature's stats... ]
	now dex entry is 22; [ ...and are only altered onto the player via Shifting or the Mighty Mutation feat ]
	now sta entry is 20; [ These values may be used as part of alternate combat.]
	now per entry is 22;
	now int entry is 16;
	now cha entry is 20;
	now sex entry is "Female"; [ Infection will move the player towards this gender. Current: 'Male' 'Female' 'Both' ]
	now HP entry is 66; [ The monster's starting HP. ]
	now lev entry is 1; [ Monster level. (Level x 2) XP for victory. (Level / 2) XP for losing. ]
	now wdam entry is 15; [ Monster's average damage when attacking. ]
	now area entry is "Nowhere"; [ "Outside" "Mall" "Park" "Beach" etc... Check an existing creature in the area. ]
	now Cock Count entry is 0; [ Number of cocks the infection will try to cause if sex entry is 'Male' or 'Both'. ]
	now Cock Length entry is 12; [ Length infection will make cock grow to if cocks. ]
	now Ball Size entry is 3; [ Cock width, more commonly used for ball size. ]
	now Nipple Count entry is 2; [ Number of nipples the infection will give a player. ]
	now Breast Size entry is 0; [ Size of breasts the infection will try to attain. ]
	now Male Breast Size entry is 0; [ Breast size for if Sex="Male", usually zero. ]
	now Cunt Count entry is 1; [ The number of cunts the infection will try to cause if sex entry is 'Female' or 'Both'. ]
	now Cunt Depth entry is 9; [ Depth of female sex the infection will attempt to give a player. ]
	now Cunt Tightness entry is 6; [ Width of female sex the infection will try to give a player. ]
	now libido entry is 55; [ Target libido the infection will rise towards. ]
	now loot entry is ""; [ Dropped item, blank for none. Case sensitive. ]
	now lootchance entry is 0; [ Percentage chance of dropping loot, from 0-100. ]
	now scale entry is 3; [ Number 1-5, approx size/height of infected PC body: 1=tiny, 3=avg, 5=huge ]
	now body descriptor entry is "[one of]lean[or]wiry[or]dexterous[or]limber[at random]"; [ Ex: "plump" "fat" "muscled" "strong" "slimy" "gelatinous" "slender". Use [one of] to vary ]
	now type entry is "canine"; [ one-word creature type. Ex: feline, canine, lupine, robotic, human... Use [one of] to vary ]
	now magic entry is false;
	now resbypass entry is false;
	now non-infectious entry is false;
	now DayCycle entry is 0; [ 0 = Up at all times; 1 = Diurnal (day encounters only); 2 = Nocturnal (night encounters only);]
	now altcombat entry is "default";
	now BannedStatus entry is false;

[
Table of New Infection Parts (continued)
Species Name	Name	Body Weight	Body Definition	Androginity	Head Change	Head Description	Head Adjective	Head Skin Adjective	Head Color	Head Adornments	Hair Length	Hair Shape	Hair Color	Hair Style	Beard Style	Body Hair Length	Eye Color	Eye Adjective	Mouth Length	Mouth Circumference	Tongue Adjective	Tongue Color	Tongue Length	Torso Change	Torso Description	Torso Adjective	Torso Skin Adjective	Torso Adornments	Torso Color	Torso Pattern	Breast Adjective	Breast Size	Male Breast Size	Nipple Count	Nipple Color	Nipple Shape	Back Change	Back Adornments	Back Skin Adjective	Back Color	Arms Change	Arms Description	Arms Skin Adjective	Arms Color	Locomotion	Legs Change	Legs Description	Legs Skin Adjective	Legs Color	Ass Change	Ass Description	Ass Skin Adjective	Ass Color	Ass Width	Tail Change	Tail Description	tail skin adjective	Tail Color	Asshole Depth	Asshole Tightness	Asshole Color	Cock Change	Cock Description	Cock Adjective	Cock Color	Cock Count	Cock Girth	Cock Length	Ball Description	Ball Count	Ball Size	Cunt Change	Cunt Description	Cunt Adjective	Cunt Color	Cunt Count	Cunt Depth	Cunt Tightness	Clit Size
--	--	--	--	--	--	--	--	--	--	--	--	--	--	--	--	--	--	--	--	--	--	--	--	--	--	--	--	--	--	--	--	--	--	--	--	--	--	--	--	--	--	--	--	--	--	--	--	--	--	--	--	--	--	--	--	--	--	--	--	--	--	--	--	--	--	--	--	--	--	--	--	--	--	--	--	--	--	--;

When Play begins:
	Choose a blank row from Table of New Infection Parts;
	now Species Name entry is ""; [name of the overall species of the infection, used for children, ...]
	now Name entry is ""; [matching infection name to Table of Random Critters]
	now Body Weight entry is 5; [scale of 1-9 for body weight, grouped into low weight (1-3), mid weight (4-6) and high weight (7-9)]
	now Body Definition entry is 5; [scale of 1-9 for body definition, grouped into low muscle (1-3), mid muscle (4-6), high muscle (7-9)]
	[Body Adjective is generated out of the body weight and body definition and can be used in scenes - one word descriptive adjective depending on weight and definition groups: low weight group: skinny/slender/lithe; mid weight group: average/fit/muscled; high weight group: pudgy/husky/jacked]
	now Androginity entry is 5; [1-9 scale of hypermasculine to hyperfeminine]
	[Gender Adjective is generated out of androginity 1-9: hypermasculine/masculine/effeminate/somewhat effeminate/androgynous/feminine butch/tomboyish/feminine/hyperfeminine]
	now Head Change entry is ""; [partial sentence that fits in: "Your head and face [one of]tingle[or]go flush[or]vibrate with odd pleasure[or]go cold[or]feel oily[at random] as [head change entry]."]
	now Head Description entry is ""; [partial sentence that fits in "Your face and head resemble that of [Head Description of Player]. You have [Eye Adjective of Player], [Eye Color of Player] eyes and an overall [Gender Adjective of Player] appearance."]
	now Head Adjective entry is ""; [one word descriptive adjective (avian/canine/...)]
	now Head Skin Adjective entry is ""; [one word descriptive adjective]
	now Head Color entry is ""; [single word color adjective for the dominant color of the skin/fur/feathers/scales]
	now Head Adornments entry is "";[partial sentence that fits in "Before moving on from your head, you give your [head adornments of Player] a proud glance followed by a light caress."]
	now Hair Length entry is 2; [hair length in inches]
	now Hair Shape entry is ""; [one word shape descriptor (curly/straight/...)]
	now Hair Color entry is ""; [one word color descriptor]
	now Hair Style entry is ""; [one word style descriptor (ponytail/mohawk/buzzcut/...) to fit "On top of your head you have [Hair Length of Player] inch long, [Hair Shape of Player] [Hair Color of Player] hair in the [Hair Style of Player] style."]
	now Beard Style entry is ""; [short beard style (goatee/3-day stubble beard/porn stache/mutton chops beard/...) to go into "You have a [Hair Color of Player] [Beard Style of Player]."]
	now Body Hair Length entry is 0; [numerical value, 0-4 (no body hair/light/moderate/heavy/furry) - only set to > 0 if the infection does not have fur/scales/etc. !]
	now Eye Color entry is ""; [one word color descriptor]
	now Eye Adjective entry is ""; [one word descriptive adjective (slitted/round/...)]
	now Mouth Length entry is 3; [inches deep for face fucking; maximum possible will be double this number (when deep throating)]
	[Mouth Length Adjective  is generated by a function and can be used in scenes too - "petite, shallow, average, deep, bottomless"]
	now Mouth Circumference entry is 3; [mouth circumference 1-5, see Mouth Circumference Adjective]
	[Mouth Circumference Adjective is generated by a function and can be used in scenes too - "tiny, small, normal, wide, gaping"]
	now Tongue Adjective entry is ""; [one word descriptive adjective (wide/slobbery/...)]
	now Tongue Color entry is ""; [one word color descriptor]
	now Tongue Length entry is 3; [length in inches]
	now Torso Change entry is ""; [partial sentence that fits in: "Your torso [one of]tingles[or]goes flush[or]vibrates with odd pleasure[or]goes cold[or]feels oily[at random] as [Torso Change entry]."]
	now Torso Description entry is ""; [partial sentence, fitting in "Looking down at yourself, you appear [Gender Adjective of Player] with a [Body Adjective of Player] build. Your torso is [Torso Description of Player][if Body Hair Length of Player > 1], covered in [Torso Color of Player] skin and [Body Hair Description of Player][else if Body Hair Length of Player is 1], covered in smooth, [Torso Color of Player] skin[end if]."]
	now Torso Adjective entry is ""; [one word descriptive adjective (avian/canine/...)]
	now Torso Adornments entry is ""; [(pouch/udders/...); partial sentence to fit: "You take a moment to feel your [torso adornments of Player]."]
	now Torso Skin Adjective entry is ""; [one word adjective (feathered/furred/scaly/...); EMPTY "" for creatures with just skin]
	now Torso Color entry is ""; [single word color adjective for the dominant color of the skin/fur/feathers/scales]
	now Torso Pattern entry is ""; [single word color adjective for the dominant pattern of the skin/fur/feathers/scales]
	now Breast Adjective entry is ""; [adjective(s) example: round, pointy, perky, saggy, bouncy. This would serve as either a general appearance of a infections breasts or possibly something that may be effected by a item or NPC.]
	now Breast Size entry is 0; [cup size as number, counting Flat Pecs = 0, A = 1, B = 2, ...]
	now Male Breast Size entry is 0; [cup size as number, counting Flat Pecs = 0, A = 1, B = 2, ...]
	now Nipple Count entry is 2; [count of nipples]
	now Nipple Color entry is ""; [one word color descriptor]
	now Nipple Shape entry is ""; [shape example: any shape will do as long as it has a baseline with a current infection or item]
	now Back Change entry is ""; [partial sentence that fits in: "Your back [one of]tingles[or]goes flush[or]vibrates with odd pleasure[or]goes cold[or]feels oily[at random] as [Back Change entry]."]
	now Back Adornments entry is ""; [partial sentence to fit: "Your back tickles with the feeling of movement caused by [back adornments of Player]."]
	now Back Skin Adjective entry is ""; [one word adjective (feathered/furred/scaly/...); EMPTY "" for creatures with just skin]
	now Back Color entry is ""; [single word color adjective for the dominant color of the skin/fur/feathers/scales]
	[Limbs Adjective is generated by a function and can be used in scenes too - "rail-thin, slender, sinewy, average, firm, muscular, flabby, meaty, rippling"]
	now Arms Change entry is ""; [partial sentence that fits in: "Your arms [one of]tingle[or]go flush[or]vibrate with odd pleasure[or]go cold[or]feel oily[at random] as [Arms Change entry]."]
	now Arms Description entry is ""; [partial sentence to fit: "Your [Limbs Adjective of Player] arms are [Arms Description of Player]."]
	now Arms Skin Adjective entry is ""; [one word adjective (feathered/furred/scaly/...); EMPTY "" for creatures with just skin]
	now Arms Color entry is ""; [single word color adjective for the dominant color of the skin/fur/feathers/scales]
	now Locomotion entry is ""; [one word adjective: (bipedal/quadrupedal/octapedal/serpentine/sliding)]
	now Legs Change entry is ""; [partial sentence that fits in: "Your legs [one of]tingle[or]go flush[or]vibrate with odd pleasure[or]go cold[or]feel oily[at random] as [Legs Change entry]."]
	now Legs Description entry is ""; [partial sentence to fit: "As your inspection goes even lower, you come to the two [Body Adjective of Player] legs supporting you. They are [legs description of Player]."]
	now Legs Skin Adjective entry is ""; [one word adjective (feathered/furred/scaly/...); EMPTY "" for creatures with just skin]
	now Legs Color entry is ""; [single word color adjective for the dominant color of the skin/fur/feathers/scales]
	now Ass Change entry is ""; [partial sentence that fits in: "Your ass [one of]tingles[or]goes flush[or]vibrates with odd pleasure[or]goes cold[or]feels oily[at random] as [Ass Change entry]."]
	now Ass Description entry is ""; [partial sentence to fit: "Using your hands you feel your behind enjoying the sensation of your [Ass Width Adjective of Player], [Ass Shape Adjective of Player] [Ass Description of Player]." (For players with skin, instead of the period: ", covered in [Ass Color of Player] skin and [Body Hair Description of Player]"]
	now Ass Skin Adjective entry is "";  [one word adjective (feathered/furred/scaly/...); EMPTY "" for creatures with just skin]
	now Ass Color entry is ""; [single word color adjective for the dominant color of the skin/fur/feathers/scales]
	now Ass Width entry is 3; [ass width from 1-5]
	[Ass Width Adjective generated by function out of ass width: dainty/small/round/huge/enormous]
	[Ass Adjective generated by function out of body definition and ass width]
	now Tail Change entry is ""; [partial sentence that fits in: "Your rear [one of]tingles[or]goes flush[or]vibrates with odd pleasure[or]goes cold[or]feels oily[at random] as [if HasTail of Player is true]your existing tail is changed into a [Tail Description entry][else][Tail Change entry][end if]."]
	now Tail Description entry is ""; [partial sentence to fit: "Just below your lower back sprouts a [tail description of Player], which you move back and forth with glee."]
	now Tail Skin Adjective entry is ""; [one word adjective (feathered/furred/scaly/...); EMPTY "" for creatures with just skin]
	now Tail Color entry is ""; [single word color adjective for the dominant color of the skin/fur/feathers/scales]
	now Asshole Depth entry is 7; [inches deep for anal fucking]
	[Asshole Depth Adjective is generated by a function and can be used in scenes too - "petite (< 3), shallow (< 5), average (< 9), deep (< 15), bottomless (15+)"]
	now Asshole Tightness entry is 3; [asshole tightness 1-5, "extremely tight, tight, receptive, open, gaping"]
	[Asshole Tightness Adjective is generated by a function and can be used in scenes too - "extremely tight, tight, receptive, open, gaping"]
	now Asshole Color entry is ""; [one word color descriptor]
	now Cock Count entry is 0;
	now Cock Girth entry is 0; [thickness 1-5, generates the Cock Girth Adjective]
	[Cock Girth Adjective is generated by a function and can be used in scenes too: thin/slender/average/thick/monstrous]
	now Cock Length entry is 0; [length in inches]
	now Cock Adjective entry is ""; [one word adjective: avian/canine/...]
	now Cock Change entry is ""; [partial sentence that fits in: "Your cock [one of]tingles[or]goes flush[or]vibrates with odd pleasure[or]goes cold[or]feels oily[at random] as [Cock Change entry]."]
	now Cock Description entry is ""; [partial sentence to fit: "You have a [Cock Girth Adjective of Player], [Cock Length of Player]-inch-long [cock adjective of Player] [one of]cock[or]penis[or]shaft[or]maleness[at random] that [cock description of Player]."]
	now Cock Color entry is ""; [one word color descriptor]
	now Ball Count entry is 0; [allowed numbers: 1 (uniball), 2 or 4]
	now Ball Size entry is 0; [size of balls 1-7: "acorn-sized", "dove egg-sized", "chicken egg-sized" "goose-egg sized", "ostrich-egg sized", "basketball-sized", "beachball-sized"]
	[Ball Size Adjective is generated by a function and can be used in scenes too]
	now Ball Description entry is ""; [partial sentence to fit: "Underneath it hangs a pair of [Ball Size Adjective of Player] [ball description of Player]."]
	now Cunt Count entry is 0;
	now Cunt Depth entry is 0; [penetratable length in inches; some minor stretching allowed, or more with Twisted Capacity]
	now Cunt Tightness entry is 0; [size 1-5, generates adjectives of extremely tight/tight/receptive/open/gaping]
	[Cunt Tightness Adjective is generated by a function and can be used in scenes too: extremely tight/tight/well-used/open/gaping]
	now Cunt Adjective entry is ""; [one word adjective: avian/canine/...]
	now Cunt Change entry is ""; [partial sentence that fits in: "Your pussy [one of]tingles[or]goes flush[or]vibrates with odd pleasure[or]goes cold[or]feels oily[at random] as [Cunt change entry]."]
	now Cunt Description entry is ""; [partial sentence to fit: "You have a [Cunt Tightness Adjective of Player] [one of]cunt[or]pussy[or]vagina[or]cleft[at random] that [cunt description of Player]."]
	now Cunt Color entry is ""; [one word color descriptor]
	now Clit Size entry is 0; [size 1-5 (very small/small/average/large/very large)] [Size of Clit (1-5); very small/small/average/large/very large]
]


Table of Random Critters (continued)
NewTypeInfection (truth state)	Species Name	Name	Enemy Title	Enemy Name	Enemy Type	Attack	Defeated	Victory	Desc	Face	Body	Skin	Tail	Cock	Face Change	Body Change	Skin Change	Ass Change	Cock Change	str	dex	sta	per	int	cha	sex	HP	lev	wdam	area	Cock Count	Cock Length	Ball Size	Nipple Count	Breast Size	Male Breast Size	Cunt Count	Cunt Depth	Cunt Tightness	Libido	Loot	Lootchance	Scale (number)	Body Descriptor (text)	Type (text)	Magic (truth state)	Resbypass (truth state)	non-infectious (truth state)	Cross-Infection (text)	DayCycle	Altcombat (text)	BannedStatus (truth state)
--	--	--	--	--	--	--	--	--	--	--	--	--	--	--	--	--	--	--	--	--	--	--	--	--	--	--	--	--	--	--	--	--	--	--	--	--	--	--	--	--	--	--	--	--	--	--	--	--	--	--;

When Play begins:
	Choose a blank row from Table of Random Critters;
	now NewTypeInfection entry is false;
	now Species Name entry is "Dalmatian";
	add "Dalmatian Transbitch" to infections of CanineList;
	add "Dalmatian Transbitch" to infections of NatureList;
	add "Dalmatian Transbitch" to infections of FurryList;
	add "Dalmatian Transbitch" to infections of TransList;
	add "Dalmatian Transbitch" to infections of TaperedCockList;
	add "Dalmatian Transbitch" to infections of KnottedCockList;
	add "Dalmatian Transbitch" to infections of SheathedCockList;
	add "Dalmatian Transbitch" to infections of BipedalList;
	add "Dalmatian Transbitch" to infections of TailList;
	now Name entry is "Dalmatian Transbitch"; [ Infection/Creature name. Capitalized. ]
	now enemy title entry is ""; [name of the encountered creature at combat start - Example: "You run into a giant collie." instead of using "Smooth Collie Shemale" infection name]
	now enemy Name entry is ""; [specific name of unique enemy]
	now enemy type entry is 0; [0 = non unique enemy; 1 = unique (unknown name); 2 = unique (known name) | Used to disqualify unique enemies from Vore/UB and showing the enemy name in encounters]
	now attack entry is "[NonCombatError]";
	now defeated entry is "[NonCombatError]";
	now victory entry is "[NonCombatError]";
	now desc entry is "[NonCombatError]";
	now face entry is "covered with black spots while long floppy ears hang down the side of your regal-looking head. A black button-nose at the end of a long, delicate muzzle completes the image of an anthro Dalmatian's head";
	now body entry is "lean and limber, its form fitting an anthro canine built for both strength and speed. Besides that, there is also a bit of a feminine curve to your hips, making them somewhat wider as a preparation for bearing cubs. Your legs end in digitigrade dog's paws, while your arms sport paw-hands as dexterous as a human's";
	now skin entry is "short but thick fur, covered with black rosettes dotted all across your";
	now tail entry is "A thin, almost wiry white tail sways from out of the end of your bubble-shaped rump.";
	now cock entry is "[one of]canine[or]knotted[or]doggy[at random]";
	now face change entry is "your nose begins to push out from your face while your senses dull ever so slightly. Reaching up with a hand you have the strangest urge to scratch at your ears, which just so happen to be growing longer and floppier onside of your head, at the exact same moment your teeth are elongating into sharpened points. Feeling a strange sensation in your mouth, you open it while your muzzle is still taking shape, reflexively sticking out the long floppy tongue you have also gained";
	now body change entry is "strong muscle-spasms go through your form, soon followed by the crunching noise of re-forming bone. Feeling like you want to curl into a ball, you can't even manage that much in coordinated movements, instead just swaying rather drunkenly as your body reshapes itself. After long moments of painful transformation you'd rather forget, your body now resembles an anthro dalmatian, complete with digitigrade paws to stand on";
	now skin change entry is "white fur pushes free from out of your pores. The new growth quickly works to cover your entire body, bringing with it a random pattern of black dots on it";
	now ass change entry is "your buttcheeks tighten into a firm pair of buttocks and a thin and wiry tail sprouts from your lower back";
	now cock change entry is "it takes on a canine shape, complete with a furred sheath as well as a pair of weighty balls. Lust bubbles up inside you and the dog's cock that you now call your own hardens within seconds, showing off the thick knot swelling up at its base. Then you cum, spraying out what seems like a celebratory load from the newly formed cock.";
	now str entry is 15; [ These are now the creature's stats... ]
	now dex entry is 22; [ ...and are only altered onto the player via Shifting or the Mighty Mutation feat ]
	now sta entry is 20; [ These values may be used as part of alternate combat.]
	now per entry is 22;
	now int entry is 16;
	now cha entry is 20;
	now sex entry is "Male"; [ Infection will move the player towards this gender. Current: 'Male' 'Female' 'Both' ]
	now HP entry is 66; [ The monster's starting HP. ]
	now lev entry is 1; [ Monster level. (Level x 2) XP for victory. (Level / 2) XP for losing. ]
	now wdam entry is 15; [ Monster's average damage when attacking. ]
	now area entry is "Nowhere"; [ "Outside" "Mall" "Park" "Beach" etc... Check an existing creature in the area. ]
	now Cock Count entry is 1; [ Number of cocks the infection will try to cause if sex entry is 'Male' or 'Both'. ]
	now Cock Length entry is 12; [ Length infection will make cock grow to if cocks. ]
	now Ball Size entry is 3; [ Cock width, more commonly used for ball size. ]
	now Nipple Count entry is 2; [ Number of nipples the infection will give a player. ]
	now Breast Size entry is 5; [ Size of breasts the infection will try to attain. ]
	now Male Breast Size entry is 5; [ Breast size for if Sex="Male", usually zero. ]
	now Cunt Count entry is 0; [ The number of cunts the infection will try to cause if sex entry is 'Female' or 'Both'. ]
	now Cunt Depth entry is 9; [ Depth of female sex the infection will attempt to give a player. ]
	now Cunt Tightness entry is 6; [ Width of female sex the infection will try to give a player. ]
	now libido entry is 55; [ Target libido the infection will rise towards. ]
	now loot entry is ""; [ Dropped item, blank for none. Case sensitive. ]
	now lootchance entry is 0; [ Percentage chance of dropping loot, from 0-100. ]
	now scale entry is 3; [ Number 1-5, approx size/height of infected PC body: 1=tiny, 3=avg, 5=huge ]
	now body descriptor entry is "[one of]lean[or]wiry[or]dexterous[or]limber[at random]"; [ Ex: "plump" "fat" "muscled" "strong" "slimy" "gelatinous" "slender". Use [one of] to vary ]
	now type entry is "canine"; [ one-word creature type. Ex: feline, canine, lupine, robotic, human... Use [one of] to vary ]
	now magic entry is false;
	now resbypass entry is false;
	now non-infectious entry is false;
	now DayCycle entry is 0; [ 0 = Up at all times; 1 = Diurnal (day encounters only); 2 = Nocturnal (night encounters only);]
	now altcombat entry is "default";
	now BannedStatus entry is false;

[
Table of New Infection Parts (continued)
Species Name	Name	Body Weight	Body Definition	Androginity	Head Change	Head Description	Head Adjective	Head Skin Adjective	Head Color	Head Adornments	Hair Length	Hair Shape	Hair Color	Hair Style	Beard Style	Body Hair Length	Eye Color	Eye Adjective	Mouth Length	Mouth Circumference	Tongue Adjective	Tongue Color	Tongue Length	Torso Change	Torso Description	Torso Adjective	Torso Skin Adjective	Torso Adornments	Torso Color	Torso Pattern	Breast Adjective	Breast Size	Male Breast Size	Nipple Count	Nipple Color	Nipple Shape	Back Change	Back Adornments	Back Skin Adjective	Back Color	Arms Change	Arms Description	Arms Skin Adjective	Arms Color	Locomotion	Legs Change	Legs Description	Legs Skin Adjective	Legs Color	Ass Change	Ass Description	Ass Skin Adjective	Ass Color	Ass Width	Tail Change	Tail Description	tail skin adjective	Tail Color	Asshole Depth	Asshole Tightness	Asshole Color	Cock Change	Cock Description	Cock Adjective	Cock Color	Cock Count	Cock Girth	Cock Length	Ball Description	Ball Count	Ball Size	Cunt Change	Cunt Description	Cunt Adjective	Cunt Color	Cunt Count	Cunt Depth	Cunt Tightness	Clit Size
--	--	--	--	--	--	--	--	--	--	--	--	--	--	--	--	--	--	--	--	--	--	--	--	--	--	--	--	--	--	--	--	--	--	--	--	--	--	--	--	--	--	--	--	--	--	--	--	--	--	--	--	--	--	--	--	--	--	--	--	--	--	--	--	--	--	--	--	--	--	--	--	--	--	--	--	--	--	--;

When Play begins:
	Choose a blank row from Table of New Infection Parts;
	now Species Name entry is ""; [name of the overall species of the infection, used for children, ...]
	now Name entry is ""; [matching infection name to Table of Random Critters]
	now Body Weight entry is 5; [scale of 1-9 for body weight, grouped into low weight (1-3), mid weight (4-6) and high weight (7-9)]
	now Body Definition entry is 5; [scale of 1-9 for body definition, grouped into low muscle (1-3), mid muscle (4-6), high muscle (7-9)]
	[Body Adjective is generated out of the body weight and body definition and can be used in scenes - one word descriptive adjective depending on weight and definition groups: low weight group: skinny/slender/lithe; mid weight group: average/fit/muscled; high weight group: pudgy/husky/jacked]
	now Androginity entry is 5; [1-9 scale of hypermasculine to hyperfeminine]
	[Gender Adjective is generated out of androginity 1-9: hypermasculine/masculine/effeminate/somewhat effeminate/androgynous/feminine butch/tomboyish/feminine/hyperfeminine]
	now Head Change entry is ""; [partial sentence that fits in: "Your head and face [one of]tingle[or]go flush[or]vibrate with odd pleasure[or]go cold[or]feel oily[at random] as [head change entry]."]
	now Head Description entry is ""; [partial sentence that fits in "Your face and head resemble that of [Head Description of Player]. You have [Eye Adjective of Player], [Eye Color of Player] eyes and an overall [Gender Adjective of Player] appearance."]
	now Head Adjective entry is ""; [one word descriptive adjective (avian/canine/...)]
	now Head Skin Adjective entry is ""; [one word descriptive adjective]
	now Head Color entry is ""; [single word color adjective for the dominant color of the skin/fur/feathers/scales]
	now Head Adornments entry is "";[partial sentence that fits in "Before moving on from your head, you give your [head adornments of Player] a proud glance followed by a light caress."]
	now Hair Length entry is 2; [hair length in inches]
	now Hair Shape entry is ""; [one word shape descriptor (curly/straight/...)]
	now Hair Color entry is ""; [one word color descriptor]
	now Hair Style entry is ""; [one word style descriptor (ponytail/mohawk/buzzcut/...) to fit "On top of your head you have [Hair Length of Player] inch long, [Hair Shape of Player] [Hair Color of Player] hair in the [Hair Style of Player] style."]
	now Beard Style entry is ""; [short beard style (goatee/3-day stubble beard/porn stache/mutton chops beard/...) to go into "You have a [Hair Color of Player] [Beard Style of Player]."]
	now Body Hair Length entry is 0; [numerical value, 0-4 (no body hair/light/moderate/heavy/furry) - only set to > 0 if the infection does not have fur/scales/etc. !]
	now Eye Color entry is ""; [one word color descriptor]
	now Eye Adjective entry is ""; [one word descriptive adjective (slitted/round/...)]
	now Mouth Length entry is 3; [inches deep for face fucking; maximum possible will be double this number (when deep throating)]
	[Mouth Length Adjective  is generated by a function and can be used in scenes too - "petite, shallow, average, deep, bottomless"]
	now Mouth Circumference entry is 3; [mouth circumference 1-5, see Mouth Circumference Adjective]
	[Mouth Circumference Adjective is generated by a function and can be used in scenes too - "tiny, small, normal, wide, gaping"]
	now Tongue Adjective entry is ""; [one word descriptive adjective (wide/slobbery/...)]
	now Tongue Color entry is ""; [one word color descriptor]
	now Tongue Length entry is 3; [length in inches]
	now Torso Change entry is ""; [partial sentence that fits in: "Your torso [one of]tingles[or]goes flush[or]vibrates with odd pleasure[or]goes cold[or]feels oily[at random] as [Torso Change entry]."]
	now Torso Description entry is ""; [partial sentence, fitting in "Looking down at yourself, you appear [Gender Adjective of Player] with a [Body Adjective of Player] build. Your torso is [Torso Description of Player][if Body Hair Length of Player > 1], covered in [Torso Color of Player] skin and [Body Hair Description of Player][else if Body Hair Length of Player is 1], covered in smooth, [Torso Color of Player] skin[end if]."]
	now Torso Adjective entry is ""; [one word descriptive adjective (avian/canine/...)]
	now Torso Adornments entry is ""; [(pouch/udders/...); partial sentence to fit: "You take a moment to feel your [torso adornments of Player]."]
	now Torso Skin Adjective entry is ""; [one word adjective (feathered/furred/scaly/...); EMPTY "" for creatures with just skin]
	now Torso Color entry is ""; [single word color adjective for the dominant color of the skin/fur/feathers/scales]
	now Torso Pattern entry is ""; [single word color adjective for the dominant pattern of the skin/fur/feathers/scales]
	now Breast Adjective entry is ""; [adjective(s) example: round, pointy, perky, saggy, bouncy. This would serve as either a general appearance of a infections breasts or possibly something that may be effected by a item or NPC.]
	now Breast Size entry is 0; [cup size as number, counting Flat Pecs = 0, A = 1, B = 2, ...]
	now Male Breast Size entry is 0; [cup size as number, counting Flat Pecs = 0, A = 1, B = 2, ...]
	now Nipple Count entry is 2; [count of nipples]
	now Nipple Color entry is ""; [one word color descriptor]
	now Nipple Shape entry is ""; [shape example: any shape will do as long as it has a baseline with a current infection or item]
	now Back Change entry is ""; [partial sentence that fits in: "Your back [one of]tingles[or]goes flush[or]vibrates with odd pleasure[or]goes cold[or]feels oily[at random] as [Back Change entry]."]
	now Back Adornments entry is ""; [partial sentence to fit: "Your back tickles with the feeling of movement caused by [back adornments of Player]."]
	now Back Skin Adjective entry is ""; [one word adjective (feathered/furred/scaly/...); EMPTY "" for creatures with just skin]
	now Back Color entry is ""; [single word color adjective for the dominant color of the skin/fur/feathers/scales]
	[Limbs Adjective is generated by a function and can be used in scenes too - "rail-thin, slender, sinewy, average, firm, muscular, flabby, meaty, rippling"]
	now Arms Change entry is ""; [partial sentence that fits in: "Your arms [one of]tingle[or]go flush[or]vibrate with odd pleasure[or]go cold[or]feel oily[at random] as [Arms Change entry]."]
	now Arms Description entry is ""; [partial sentence to fit: "Your [Limbs Adjective of Player] arms are [Arms Description of Player]."]
	now Arms Skin Adjective entry is ""; [one word adjective (feathered/furred/scaly/...); EMPTY "" for creatures with just skin]
	now Arms Color entry is ""; [single word color adjective for the dominant color of the skin/fur/feathers/scales]
	now Locomotion entry is ""; [one word adjective: (bipedal/quadrupedal/octapedal/serpentine/sliding)]
	now Legs Change entry is ""; [partial sentence that fits in: "Your legs [one of]tingle[or]go flush[or]vibrate with odd pleasure[or]go cold[or]feel oily[at random] as [Legs Change entry]."]
	now Legs Description entry is ""; [partial sentence to fit: "As your inspection goes even lower, you come to the two [Body Adjective of Player] legs supporting you. They are [legs description of Player]."]
	now Legs Skin Adjective entry is ""; [one word adjective (feathered/furred/scaly/...); EMPTY "" for creatures with just skin]
	now Legs Color entry is ""; [single word color adjective for the dominant color of the skin/fur/feathers/scales]
	now Ass Change entry is ""; [partial sentence that fits in: "Your ass [one of]tingles[or]goes flush[or]vibrates with odd pleasure[or]goes cold[or]feels oily[at random] as [Ass Change entry]."]
	now Ass Description entry is ""; [partial sentence to fit: "Using your hands you feel your behind enjoying the sensation of your [Ass Width Adjective of Player], [Ass Shape Adjective of Player] [Ass Description of Player]." (For players with skin, instead of the period: ", covered in [Ass Color of Player] skin and [Body Hair Description of Player]"]
	now Ass Skin Adjective entry is "";  [one word adjective (feathered/furred/scaly/...); EMPTY "" for creatures with just skin]
	now Ass Color entry is ""; [single word color adjective for the dominant color of the skin/fur/feathers/scales]
	now Ass Width entry is 3; [ass width from 1-5]
	[Ass Width Adjective generated by function out of ass width: dainty/small/round/huge/enormous]
	[Ass Adjective generated by function out of body definition and ass width]
	now Tail Change entry is ""; [partial sentence that fits in: "Your rear [one of]tingles[or]goes flush[or]vibrates with odd pleasure[or]goes cold[or]feels oily[at random] as [if HasTail of Player is true]your existing tail is changed into a [Tail Description entry][else][Tail Change entry][end if]."]
	now Tail Description entry is ""; [partial sentence to fit: "Just below your lower back sprouts a [tail description of Player], which you move back and forth with glee."]
	now Tail Skin Adjective entry is ""; [one word adjective (feathered/furred/scaly/...); EMPTY "" for creatures with just skin]
	now Tail Color entry is ""; [single word color adjective for the dominant color of the skin/fur/feathers/scales]
	now Asshole Depth entry is 7; [inches deep for anal fucking]
	[Asshole Depth Adjective is generated by a function and can be used in scenes too - "petite (< 3), shallow (< 5), average (< 9), deep (< 15), bottomless (15+)"]
	now Asshole Tightness entry is 3; [asshole tightness 1-5, "extremely tight, tight, receptive, open, gaping"]
	[Asshole Tightness Adjective is generated by a function and can be used in scenes too - "extremely tight, tight, receptive, open, gaping"]
	now Asshole Color entry is ""; [one word color descriptor]
	now Cock Count entry is 0;
	now Cock Girth entry is 0; [thickness 1-5, generates the Cock Girth Adjective]
	[Cock Girth Adjective is generated by a function and can be used in scenes too: thin/slender/average/thick/monstrous]
	now Cock Length entry is 0; [length in inches]
	now Cock Adjective entry is ""; [one word adjective: avian/canine/...]
	now Cock Change entry is ""; [partial sentence that fits in: "Your cock [one of]tingles[or]goes flush[or]vibrates with odd pleasure[or]goes cold[or]feels oily[at random] as [Cock Change entry]."]
	now Cock Description entry is ""; [partial sentence to fit: "You have a [Cock Girth Adjective of Player], [Cock Length of Player]-inch-long [cock adjective of Player] [one of]cock[or]penis[or]shaft[or]maleness[at random] that [cock description of Player]."]
	now Cock Color entry is ""; [one word color descriptor]
	now Ball Count entry is 0; [allowed numbers: 1 (uniball), 2 or 4]
	now Ball Size entry is 0; [size of balls 1-7: "acorn-sized", "dove egg-sized", "chicken egg-sized" "goose-egg sized", "ostrich-egg sized", "basketball-sized", "beachball-sized"]
	[Ball Size Adjective is generated by a function and can be used in scenes too]
	now Ball Description entry is ""; [partial sentence to fit: "Underneath it hangs a pair of [Ball Size Adjective of Player] [ball description of Player]."]
	now Cunt Count entry is 0;
	now Cunt Depth entry is 0; [penetratable length in inches; some minor stretching allowed, or more with Twisted Capacity]
	now Cunt Tightness entry is 0; [size 1-5, generates adjectives of extremely tight/tight/receptive/open/gaping]
	[Cunt Tightness Adjective is generated by a function and can be used in scenes too: extremely tight/tight/well-used/open/gaping]
	now Cunt Adjective entry is ""; [one word adjective: avian/canine/...]
	now Cunt Change entry is ""; [partial sentence that fits in: "Your pussy [one of]tingles[or]goes flush[or]vibrates with odd pleasure[or]goes cold[or]feels oily[at random] as [Cunt change entry]."]
	now Cunt Description entry is ""; [partial sentence to fit: "You have a [Cunt Tightness Adjective of Player] [one of]cunt[or]pussy[or]vagina[or]cleft[at random] that [cunt description of Player]."]
	now Cunt Color entry is ""; [one word color descriptor]
	now Clit Size entry is 0; [size 1-5 (very small/small/average/large/very large)] [Size of Clit (1-5); very small/small/average/large/very large]
]

Definition: a person is DalSkinned:
	if SkinName of Player is "Dalmatian Male" or SkinName of Player is "Dalmatian Bitch" or SkinName of Player is "Dalmatian Herm" or SkinName of Player is "Dalmatian Transman" or SkinName of Player is "Dalmatian Transbitch", yes;
	no;

to SetMonsterRandomDalOffspring:
	let randomnumber be a random number from 1 to 5;
	if randomnumber is:
		-- 1:
			setmonster "Dalmatian Male";
		-- 2:
			setmonster "Dalmatian Bitch";
		-- 3:
			setmonster "Dalmatian Herm";
		-- 4:
			setmonster "Dalmatian Transman";
		-- 5:
			setmonster "Dalmatian Transbitch";

Section 3 - Items

Table of Game Objects (continued)
name	desc	weight	object
"dalmatian cum"	"A tiny plastic shampoo bottle as you might find in a motel, filled with something milky white, thick and creamy. If you didn't know where it's from, you'd almost think it to be liquid soap rather than Darius's cum. You could drink it to quench your thirst, but who knows what else it might do to you..."	1	dalmatian cum

instead of sniffing dalmatian cum:
	say "You open the lid for a moment and take a sniff. Smells rather tasty actually, kinda nutty. You can't help but be tempted to take a swallow of it.";

dalmatian cum is a grab object. dalmatian cum is cum.
the usedesc of dalmatian cum is "[dalmatian cum use]";

to say dalmatian cum use:
	say "     Lifting the tiny plastic bottle to your mouth, you let Darius's creamy cum run over your tongue and down your throat. Mmmmh, this stuff actually tastes fairly nice and your body calls for more. You can't help yourself and keep pouring cum into your mouth, right until you're hungrily sucking at the mouth of the bottle with it turned upside down.";
	if Darius is visible:
		say "     Glancing over at you slurping down his cum, Darius lets out a hearty laugh. ";
		if Player is female:
			say "'Yeah babe, just swallow it all! If you like that one, I've got a whole lot more here for you...' Grabbing his crotch, the anthro canine gives it a demonstrative squeeze.";
		else:
			say "'Let's hope the stuff makes something nice out of you. Wouldn't mind giving you more, if you want it that badly - as soon as you grow a juicy pussy!' Grabbing his crotch, the anthro canine gives it a demonstrative squeeze.";
	PlayerDrink 6;
	SanLoss 5;
	infect "Dalmatian Bitch";

Table of Game Objects (continued)
name	desc	weight	object
"dalmatian fur"	"A small tuft of white and black fur, held together by a rubber band. You bought it from Darius."	1	dalmatian fur

instead of sniffing dalmatian fur:
	say "     You sniff at the tuft of fur. It has a definitive smell of dog to it.";

dalmatian fur is a grab object.
dalmatian fur is temporary.
the usedesc of dalmatian fur is "[dalmatian fur use]";

to say dalmatian fur use:
	say "     Lifting the small tuft of fur with your fingers holding on to the rubber band around it, you brush the hairs over the inside of your other arm. It feels soft and tickles a little, then a lot, as the strands seem to slowly crumble away, leaving minute traces of silvery dust that vanishes into your skin.";
	if Darius is visible:
		say "     Glancing over at you playing around with the fur you bought, Darius lets out a hearty laugh. ";
		if Player is female:
			say "'Damn babe, are you trying to become a dude? How about you rather come here and let me show you a good time? Then you'll have a nice spotted coat too and be much more fun all around.' Grabbing his crotch, the anthro canine gives it a demonstrative squeeze.";
		else:
			say "'Let's hope the stuff mans you up a bit. I could use some reliable help later on, when I expand this operation.' The anthro canine steps up to give you a fist bump.";
	SanLoss 2;
	infect "Dalmatian Male";


Section 4 - Endings

when play ends:
	if BodyName of Player is "Dalmatian Male":
		if humanity of Player < 10:
			say "     Giving yourself over to the Dalmatian infection taking over your body and mind you wander aimlessly about the city until you find yourself stumbling over a slightly familiar looking white and black spotted four legged canine. When the other gets a hold of your scent the Dalmatian immediately senses something wrong as it turns to look you over. Slowly padding its way over to try and administer comfort onto you, you find yourself whimpering back at the other as the need to rut as well as play overtakes your sensibilities. At the touch of the Dalmatian's cold nose touches your legs you kneel down next to the other Dal and then nuzzle the other four legged canine in turn before whining at it in confusion. Quickly as can be the feral creature barks into your face and then grabs you by your arm with its sharpened teeth to drag you off somewhere.";
			say "     Not having a reason to fight you simply let the other take you to wherever it's trying to get to. When you ultimately find yourself coming to a red brick edifice, which [italic type]really[roman type] looks familiar to you, you bark happily as you think that you've finally found the place where you belong. This fact is made even more certain when your new friend releases your arm and then goes over to bark and scratch at the front door to the building. Upon getting a response from someone from the inside you find yourself panting in joy as your bright eyes look over the form of a tall white and black spotted canine, this one standing on two legs instead of all fours, whom your confused canine mind screams at you that you should know intimately. Hurriedly you go over to tackle the other and then proceed to show them in rampant licks across the face.";
			say "     You definitely know now that this is where you belong now.";
		else:
			say "     When the military rolls around to try and finally clean up the place you find yourself somewhat displeased to be taken by them and then led to one of their campsites along with several other mutants at gun point. However, before you can go to grip about the indignity of your situation a scream coming out of one of the soldier's walkie-talkies about [italic type]fire[roman type] and [italic type]casualties[roman type] has you snatching the handheld device off of said soldier's hips and then barking into it about location. The soldier you just stole the walkie-talkie from doesn't try to retrieve his communication device as you are swiftly hauling tail out of the sheltered area to go see what you can do to help.";
			say "     What you see when you arrive is a somewhat high-class hotel on glistening with crimson flames from out of its windows along with several mutants all trying to run out at the same time with various items in their hands. Finding the person who had been squawking to you over the radio, quite literally in fact, you find yourself walking over to a large Pelican wearing a two-piece suit looking over the burning building with a quiet glare in his beady eyes. Asking the other about how many people are left in the complex you get your answer from a chimpanzee mutant instead of the bird. The simian creature nervously informs you that most of the people on the upper floors are outside now, but there might still be others on the lower floors. Not wasting a second to go over options you simply charge into the building and then begin sniffing around for any civilians who might have been left behind.";
			if firefighter coat is owned:
				say "     A faint ringing in your mind has you pulling out the firefighting coat Kenaz had given you and then tossing the heavy jacket over your furry white form.";
				say "     Ten minutes of searching leads you to finding several older people in the basement, two teenagers hiding in the back rooms of suite 108, and a single shy cougar female almost scared to death from the flames licking at the area surrounding her inside of room 309. Using your dexterity and strength to herd the others out of the building, your sense of smell being invaluable to help you to find the safest routes back out after some of the building's roof collapses in on your previous pathway, as well as your basic knowledge of fire safety, you manage to get everyone out of the building just as the local firefighting department is speeding its way down the side of the street.";
				LineBreak;
				say "     Working with the other Dalmatians of fire station 86 you and the rest of the team hook up hoses and then spray down the burning building with as much water as you can in order to make the laughing flames receded back into the edifice. All of you are silently thankful that the water to the city is now working again, though no one makes a comment on this as you are all busy working to get the thrashing flames battling against you under some kind of control[if waterworks is 1]. You don't spend time gloating about how you were the one who fought to get the water to the city back on as you literally have bigger fish to fry at the moment[end if].";
				say "     [if kto is 2]Humorously you find yourself chuckling into the back of your heads as you watch how Kenaz literally takes command of the situation as he barks out orders. You do the other Dalmatian proud by standing your ground and helping them finish up spraying down the building until at last, some thirty minutes later, the fire has finally died out[else]Watching as Othala and Kenaz work together to try and control this situation you chuckle mirthfully as you notice how all of the other Dalmatians follow the leadership of the former female without question. Othala wastes no time as she barks out orders amongst the pack while having Kenaz stand beside you to help shoulder some of the burden of having you hold onto the gushing hose in between your padded hands. The other male says nothing to you as you and he work together to put out the fire, however, you don't fail to notice the twinkle of pride shining in Kenaz's green orbs as he glances at you when he thinks you're not looking[end if]. Once the hungry flames of the fire have been completely drowned out the Dalmatians quickly turn to those around you, asking everyone the standard questions that go along with having survived an ordeal like this and giving medical aid to those that they can while waiting for the ambulance to get there.";
				LineBreak;
				if kto is 2:
					say "     When several white trucks pull up you find yourself sighing in relief... that is, right before you turn to notice a very angry Dalmatian looking down at you. Kenaz seems both pissed and elated that you've survived this trail, even more so at the fact that you actually managed to help out with your unrefined skills and instinctual talents. The herm makes no bones about telling you off though, and you actually pull back some as you try to whether the storm of the other's wrath. However, once the eight foot Dalmatian has calmed down he tiredly reaches around you to take you into his arms before hugging you tight. No words need be spoken between either of you as you both understand what the other is thinking. Ironically the military shows up to help, late as usual, some minutes later to lead you and everyone else back to one of their campsites.";
					say "     When you return with the armed forces back to their military camp to get checked over properly this time, you managing to drag the other Dals with you through some smooth jive talk, there's a lot of noise about you becoming a firefighter professionally after everything is said and done. However, you barely pay this any mind as you simply want to just be with Kenaz right now. The larger Dal is all too happy to comply with your desires, especially once the both of you get some alone time together at the behest of one of the scientist involved with checking you and Kenaz over. The howls you and your lover make are still talked about amongst the soldiers in the military to this day as many of them found themselves remembering the way a certain rickety cot inside of the tent you and Kenaz had been housed in literally squeaked and rocked a full night long.";
				else:
					say "     Othala seems more pissed at you than Kenaz as the former female Dal barks into your face as he tells you about how stupid you were. Of course just as soon as his anger has calmed down Othala is quick to congratulate you on doing such a fine job, what with your unrefined skills and all. You're not sure whether to be proud of yourself or ashamed as the growls from the former female Dalmatian have actually made the hairs on your body stand up on end. However, when Kenaz comes over to take you into his arms you find yourself melting as the other Dal kisses and licks you across the slightly burnt fur of your muzzle you find yourself blushing and then smiling tiredly up at the other as he goes about showering you in affection.";
					say "     When the military comes along to check over you, you find yourself, along with the rest of the pack, being taken in for inspection, much to everyone's annoyance. Being the [']hero['] of the hour does net you some perks though as when you and Kenaz finish being tested over by some of the weird procedures the doctors here have dreamed up for mutates of your species, the anal probing with thermometer is something you're still wondering about to this day, you find yourself being allowed some private time alone with Kenaz. No one present needed to guess what would happen next once the single flap to the tent you and your companion had been left in flipped to a close. And yet, the sounds of your [italic type]enjoyment[roman type] at being reunited with the Dalmatian makes for some interesting gossip amongst the both military and the pack of firefighting Dals days later. However, by that time your biggest concern has shifted from whether or not you and Kenaz were an item to whether or not you should become a full-fledged firefighter and stay with the others or not.";
					say "The offer is very tempting, considering that Kenaz and the others have decided to all buy a large condo together to make into their new den. However, you have a lot to think over first...";
			else:
				say "     Ten minutes of searching leads you to finding several older people in the basement, two teenagers hiding in the back rooms of suite 108, and a single shy cougar female almost scared to death from the flames licking at the area surrounding her inside of room 309. Using your dexterity and strength to herd the others out of the building, your sense of smell being invaluable to help you to find the safest routes back out after some of the building's roof collapses in on your previous pathway, as well as your basic knowledge of fire safety, you manage to get everyone out of the building just as the local firefighting department is speeding its way down the side of the street.";
				say "     Working with the other Dalmatians of fire station 86 you and the rest of the team hook up hoses and then spray down the burning building with as much water as you can in order to make the laughing flames receded back into the edifice. All of you are silently thankful that the water to the city is now working again, though no one makes a comment on this as you are all busy working to get the thrashing flames battling against you under some kind of control[if waterworks is 1]. You don't spend time gloating about how you were the one who fought to get the water to the city back on as you literally have bigger fish to fry at the moment[end if].";
				say "     [if kto is 2]Humorously you find yourself chuckling into the back of your heads as you watch how Kenaz literally takes command of the situation as he barks out orders. You do the other Dalmatian proud by standing your ground and helping them finish up spraying down the building until at last, some thirty minutes later, the fire has finally died out[else]Watching as Othala and Kenaz work together to try and control this situation you chuckle mirthfully as you notice how all of the other Dalmatians follow the leadership of the former female without question. Othala wastes no time as she barks out orders amongst the pack while having Kenaz stand beside you to help shoulder some of the burden of having you hold onto the gushing hose in between your padded hands. The other male says nothing to you as you and he work together to put out the fire, however, you don't fail to notice the twinkle of pride shining in Kenaz's green orbs as he glances at you when he thinks you're not looking[end if]. Once the hungry flames of the fire have been completely drowned out the Dalmatians quickly turn to those around you, asking everyone the standard questions that go along with having survived an ordeal like this and giving medical aid to those that they can while waiting for the ambulance to get there.";
				LineBreak;
				if kto is 2:
					say "     When several white trucks pull up you find yourself sighing in relief... that is, right before you turn to notice a very angry Dalmatian looking down at you. Kenaz seems both pissed and elated that you've survived this trail, even more so at the fact that you actually managed to help out with your unrefined skills and instinctual talents. The herm makes no bones about telling you off though, and you actually pull back some as you try to whether the storm of the other's wrath. However, once the eight foot Dalmatian has calmed down he tiredly reaches around you to take you into his arms before hugging you tight. No words need be spoken between either of you as you both understand what the other is thinking. Ironically the military shows up to help, late as usual, some minutes later to lead you and everyone else back to one of their campsites.";
					say "     When you return with the armed forces back to their military camp to get checked over properly this time, you managing to drag the other Dals with you through some smooth jive talk, there's a lot of noise about you becoming a firefighter professionally after everything is said and done. However, you barely pay this any mind as you simply want to just be with Kenaz right now. The larger Dal is all too happy to comply with your desires, especially once the both of you get some alone time together at the behest of one of the scientist involved with checking you and Kenaz over. The howls you and your lover make are still talked about amongst the soldiers in the military to this day as many of them found themselves remembering the way a certain rickety cot inside of the tent you and Kenaz had been housed in literally squeaked and rocked a full night long.";
				else:
					say "     Othala seems more pissed at you than Kenaz as the former female Dal barks into your face as he tells you about how stupid you were. Of course just as soon as his anger has calmed down Othala is quick to congratulate you on doing such a fine job, what with your unrefined skills and all. You're not sure whether to be proud of yourself or ashamed as the growls from the former female Dalmatian have actually made the hairs on your body stand up on end. However, when Kenaz comes over to take you into his arms you find yourself melting as the other Dal kisses and licks you across the slightly burnt fur of your muzzle you find yourself blushing and then smiling tiredly up at the other as he goes about showering you in affection.";
					say "     When the military comes along to check over you, you find yourself, along with the rest of the pack, being taken in for inspection, much to everyone's annoyance. Being the [']hero['] of the hour does net you some perks though as when you and Kenaz finish being tested over by some of the weird procedures the doctors here have dreamed up for mutates of your species, the anal probing with thermometer is something you're still wondering about to this day, you find yourself being allowed some private time alone with Kenaz. No one present needed to guess what would happen next once the single flap to the tent you and your companion had been left in flipped to a close. And yet, the sounds of your [italic type]enjoyment[roman type] at being reunited with the Dalmatian makes for some interesting gossip amongst the both military and the pack of firefighting Dals days later. However, by that time your biggest concern has shifted from whether or not you and Kenaz were an item to whether or not you should become a full-fledged firefighter and stay with the others or not.";
					say "     The offer is very tempting, considering that Kenaz and the others have decided to all buy a large condo together to make into their new den. However, you have a lot to think over first...";

Dalmatian ends here.
