Version 1 of David by Wahn begins here.
[Version 1 - Put into its own file]

[ David, the npc                                                        ]
[                                                                       ]
[ HP states of David - Location                                         ]
[   0: on patrol                                                        ]
[   1: got called in to Camp Bravo                                      ]
[   2: met the player in Camp Bravo                                     ]
[   3: liaison to the player - in Camp Bravo                            ]
[   4: liaison to the player - in the Bunker                            ]
[ 100: demon brute pet's slave - in the amulet                          ]
[                                                                       ]
[ thirst states of David - Relationship with the Player                 ]
[   0: had no sex of any kind with the player                           ]
[   1: had some sort of intimate contact with the player - once         ]
[   2: had some sort of intimate contact with the player - often        ]
[   5: the point at which he'll ask the player to be his girl/boyfriend ]
[  10: is the player's fuck-buddy                                       ]
[  20: player is his girl/boyfriend                                     ]
[                                                                       ]
[ lust states of David - Gay Sex Variable                               ]
[   0: anal virgin                                                      ]
[   1: got fucked in the ass                                            ]
[   2: got fucked in the ass + sucked player cock                       ]
[  51: de-virginized by Brutus                                          ]
[  51: de-virginized by Carl                                            ]
[                                                                       ]
[ libido states of David - Demon Brute Pet Interaction                  ]
[   0: hasn't seen the player with Brutus yet                           ]
[   1: got frightened as he saw evil Brutus, no special sex prepped     ]
[  50: talked to a 'cleansed' Brutus, noticed Brutus staring            ]
[  51: player asked Brutus about why he stares at David                 ]
[  52: Brutus removed the enslavement mark from David (hurting himself) ]
[  53: David thanked Brutus for helping him                             ]
[  54: David & Brutus had fun together                                  ]
[  55: had the after-sex talk with Brutus (not David)                   ]
[  56: had the after-sex talk with David (not Brutus)                   ]
[  57: had the after-sex talk with David and Brutus                     ]
[  58: David suggested taking Brutus out for trips                      ]
[  59: player knows about Brutus urges                                  ]
[  60: Brutus is controlled not to act on the urges                     ]
[  61: Brutus is controlled not to act on the urges, David knows        ]
[  62: Talked with Nermine about sharing Brutus with David - refused    ]
[  63: Ritual by Nermine is ready (sharing Brutus with David)           ]
[  64: Talked with Lilith about sharing Brutus with David - refused     ]
[  65: Talked with Lilith - freed Liam                                  ]
[  66: Ritual by Lilith is ready (sharing Brutus with David)            ]
[  67: refused both Lilith and Nermine                                  ]
[  68: refused both Lilith and Nermine                                  ]
[  69: Did the Ritual, Brutus and David are 'married'                  ]
[  81: Brutus is ready to snap and dom-fuck David                       ]
[  82: Brutus got dommy and fucked David                                ]
[  83: Brutus is locked into the enslavement path with David            ]
[  84: Brutus has a shopping list for ritual supplies                   ]
[  85: Brutus is ready to do the binding with David                     ]
[  86: David's now in the amulet with Brutus                            ]
[  87: Talked with Nermine about the ritual                             ]
[  89: revenge fuck option enabled when talking to him                  ]
[  90: fucked the demon, lost his fear                                  ]
[  99: player agreed to have the demon brute fuck him                   ]
[ 100: got fucked & enslaved by the demon brute                         ]
[                                                                       ]
[ Dexterity of David - Sven Interaction                                 ]
[   0: nothing yet                                                      ]
[   1: got blown by Sven                                                ]
[  99: player didn't give Sven the go-ahead to blow him                 ]
[                                                                       ]
[ DavidBrutusMarcVar - interactions with Marc                           ]
[   0: nothing yet                                                      ]
[   1: Had sexy fun with Marc                                           ]


RyouseiDavidInteraction is a number that varies.
lastRyouseiDavidInteraction is a number that varies. lastRyouseiDavidInteraction is usually 10000.

Section 1 - Events

Captured Demon is a situation.
The sarea of Captured Demon is "Red".
when play begins:
	add Captured Demon to badspots of guy; [male soldier, demon brute]
	add Captured Demon to badspots of hellspawn; [demon brute]

Instead of resolving a Captured Demon:
	say "     Moving through an alley in the seedier part of town, you hear voices from the smashed window of a nearby bar. Careful not to step on anything and make a sound, you slowly walk closer and listen.";
	say "     'The brute smashed our only working radio. Now we got the mission objective locked down, but can't call in the retrieval team. Anderson's dead and that claw-slash on Kowalski's leg doesn't look good.' You peek over the window-still and see a mid-sized bar, its interior devastated by a fight. In the midst of bullet-holed walls and smashed furniture, there is a demon brute slumped down on a chair, bound with leather straps and chains. Near him, there are four soldiers, one of them just being bandaged on the thigh.";
	say "     The apparent leader watches the wounded man being patched up, then says 'It can't be helped. No way a man supporting a wounded comrade can make it through the streets alone. I'll have to go with them. Private Jackson, guard the captive until the retrieval team arrives. If need be, give him more sedatives.' He nods to a young-looking soldier, who salutes and says 'Yes sir!' You don't want to get shot by stressed out soldiers, so you have to hurry down the alley a bit to hide behind a dumpster not to get spotted as they move out.";
	WaitLineBreak;
	say "     After waiting some minutes so be sure they're gone, you go back to the window and look in. Now there's only that one soldier in there, looking from the demon to the entrance door and back again. He looks rather nice, slender but muscular and with a handsome face. While you're still wondering if you could perhaps go in and talk to him, the demon brute makes a snorting sound, startling the soldier and you as a slight movement runs through his bound body. Private Jackson raises his weapon and steps closer, poking the demon in the chest to check if he's still unconscious.";
	say "     ...which is exactly what the brute has been waiting for. With a metallic screech the chains holding him rip apart as he flexes his muscles, then grips the barrel of the rifle and bends it to a right angle. His other hand quickly grabs the young soldier around the throat and stops any attempt to escape.";
	WaitLineBreak;
	project the figure of Brutus_evil_face_icon;
	say "     Chuckling in a deep gravelly voice, the demon says 'Did you really think it'd be that easy to capture a soldier of the infernal legion? You'll pay for your insolence!' and rips the soldier's uniform off his body. With an evil chuckle, the brutish demon uses his sharp nails to give him some shallow, bleeding scratches, then murmurs something you can't quite make out and there is a short purple flash between them. Carrying his captive to the bar, the creature then bends him over it and gives his ass a hard slap, leaving a reddening hand-print on the pale flesh of the young soldier's right bun. 'If you try running, I'll disembowel you. But feel free to struggle and scream - I like it,' the demon says, then grabs his massive erection and strokes it.";
	WaitLineBreak;
	project the figure of David_face_hurt_icon;
	say "     [bold type]Seeing the demon prepare to rape the young soldier, you wonder if you should step in and stop him. The safer option would be to just watch it happen, but can you just leave Private Jackson to his fate?[roman type][line break]";
	say "     ([link]Y[as]y[end link]) - What's going on in there isn't your problem. Watch, but don't intervene.";
	say "     ([link]N[as]n[end link]) - You can't let the beast just violate this poor man. Get in there now!";
	if player consents: [just watch]
		LineBreak;
		say "     The demon smacks his manhood against the human's ass several times, creating slapping noises and making him grunt in pain. Looking down at the reddened cheeks and the deeper red hand-print on them, the demon aims his cock at Private Jackson's virgin pucker and plunges it right in. His victim whimpers in pain as the infernal cock forces his asshole to open and the thick shaft of the demon's cock sinks inside his body. You watch the otherworldly beast fuck the poor man without restraint, slamming in and out and just getting more and more aroused as the soldier begs and struggles weakly to push him off.";
		say "     Then finally, the demon brute slams his whole shaft inside, roaring in satisfaction as the contents of his balls erupt into his human captive. He keeps pumping blast after blast of cum into the young man, pumping slowly in and out of his hole with squishy noises as cum starts to squirt out around his shaft from the overfilled ass. Pulling Private Jackson's head up by the hair, the demon licks his cheek slowly, then says 'Feel my infernal seed fill your innermost being, little man. You're mine now - now and forever!' With that, he pulls the soldier up against his chest, holding him against his body with his cock still inside the man. Then black-purple smoke starts forming around them both, obscuring them from sight. When it spreads out in the room and slowly blows away, there's nothing to be seen of the demon or his newest slave.";
	else: [fight]
		LineBreak;
		say "     Your decision to rush into the bar almost comes too late. The demon already has the tip of his cock poised at the soldier's virgin pucker as you throw the nearest item - a cracked beer glass - at his back to distract him. He turns with an annoyed grunt, growling 'Another mortal who wants to ride my shaft? Bring it on, weakling.'";
		now inasituation is true;
		challenge "Demon Brute";
		now inasituation is false;
		if fightoutcome >= 20 and fightoutcome <= 29: [lost]
			say "     Having dealt with you, the demon turns back to Private Jackson, who's tried to crawl off in the meantime. He picks the man up by his neck, choking him a bit and runs a clawed hand down his side, leaving shallow but long lines bloody in his pale flesh. 'Don't try to flee again. You're taxing my patience.' With that, he throws his captive back on the bar, bent over and his rear sticking out at the right height.";
			say "     The demon smacks his manhood against the human's ass several times, creating slapping noises and making him grunt in pain. Looking down at the reddened cheeks and the deeper red hand-print on them, he aims his cock at Private Jackson's virgin pucker and plunges it right in. His victim whimpers in pain as the infernal cock forces his asshole to open and the thick shaft of the demon's cock sinks inside his body. You watch the otherworldly beast fuck the poor man without restraint, slamming in and out and just getting more and more aroused as the soldier begs and struggles weakly to push him off.";
			say "     Then finally, the demon brute slams his whole shaft inside, roaring in satisfaction as the contents of his balls erupt into his human captive. He keeps pumping blast after blast of cum into the young man, pumping slowly in and out of his hole with squishy noises as cum starts to squirt out around his shaft from the overfilled ass. Pulling Private Jackson's head up by the hair, the demon licks his cheek slowly, then says 'Feel my infernal seed fill your innermost being, little man. You're mine now - now and forever!' With that, he pulls the soldier up against his chest, holding him against his body with his cock still inside the man. Then black-purple smoke starts forming around them both, obscuring them from sight. When it spreads out in the room and slowly blows away, there's nothing to be seen of the demon or his newest slave.";
		else if fightoutcome >= 30: [fled]
			say "     Recognizing a lost fight, you just take your legs under your arms and run as fast as you can. You can only guess what happened to the young soldier you left behind with the demon brute. Nothing good, you're sure...";
		else if fightoutcome >= 10 and fightoutcome <= 19: [won]
			say "     After the demon vanishes, you take care of Private Jackson, who's still rather groggy from being choked and manhandled like that. You help him by tying the shreds of his shirt around his wounded chest as an improvised bandage and also to get his now ragged pants back on. With all the naked skin he's showing, the realization how handsome he is prods awake your libido, but since his thoughts are anywhere but at sex right now, you wish him the best as he moves out to rejoin his unit.";
			LineBreak;
			say "     Something tells you this might not be the last time you'll see this young man. Maybe you should go looking for the handsome [bold type]soldier[roman type] sometime... out in the city, as you doubt he'll be back in the red light district anytime soon.";
			Now Thankful Soldier is unresolved;
			increase score by 5;
	now Captured Demon is resolved;

Thankful Soldier is a situation. Thankful Soldier is resolved. [meeting the guy from 'Captured Demon' again - if you saved him]
The sarea of Thankful Soldier is "Outside".
when play begins:
	add Thankful Soldier to badspots of guy; [male soldier]

TSEventCounter is a number that varies. TSEventCounter is normally 0.
LastTSEvent is a number that varies. LastTSEvent is normally 555.

Instead of resolving a Thankful Soldier:
	if (LastTSEvent - turns < 4):
		say "     You walk through the alley where you last met David and check the surrounding area - no luck. Seems like your soldier-friend is patrolling or scouting somewhere else right now. Maybe you should try a bit later again...";
	else:
		project the figure of David_clothed_icon;
		if TSEventCounter is 0: [first meeting]
			say "     Moving through the city, you run into a lone soldier patrolling an alley near a small military encampment. It's Private Jackson, the young soldier you saved from that demon brute in the red light district. He's got a slender but still muscular build and a nice-looking face with a boyish charm.";
			say "     At first raising his weapon in alarm, he then lowers it again as he recognizes you in turn. 'Hello there. You saved me from that hellish thing in the bar. Thanks a lot for that - sorry I didn't say anything then, but I was pretty groggy after that beating. I'm David, by the way.' He pulls his backpack off and digs around in it for a moment, then turns to you holding three MREs and a water bottle. 'Please accept these as thanks.'";
			LineBreak;
			say "     [bold type]Do you graciously accept the supplies... or would you rather take the handsome Private as your reward?[roman type][line break]";
			LineBreak;
			say "     ([link]Y[as]y[end link]) - Yes.";
			say "     ([link]N[as]n[end link]) - No.";
			if player consents: [accept supplies]
				LineBreak;
				say "     You take the items he offers you and stash them in your pack. 'Hope that'll help you a bit. Stay safe - help is coming, it's just a question of time till more troops arrive and the scientists figure out this whole mess.' He nods to you, then continues his patrol route. You memorize where the alley is in the city, hoping you can catch him on patrol again sometime later.";
				say "     Food x3, Water x1 obtained.";
				increase carried of food by 3;
				increase carried of water bottle by 1;
			else: [fuck the soldier]
				LineBreak;
				say "     Stepping closer to the good-looking young soldier, you pull him tight against your body and give him a deep kiss before he can react. The initial look of alarm in his eyes quickly fades as you make out with him, exploring his mouth with your tongue as you run a hand through his hair and goose his bubble butt with the other one.";
				say "     As you come back up for air, he stammers 'I - I shouldn't... we're not supposed to...', but he moans as you squeeze his ass and his bulge pressing against your body show that he's quite ready for some action. Not getting any relief except rushed masturbation in the weeks and months since the outbreak started, Private Jackson is like putty in your hands, his horny body telling him to go along with anything you want.";
				if (cocks of player > 0 and cunts of player > 0):
					LineBreak;
					say "     [bold type]Being dual-gendered, which way do you want to enjoy your new soldier friend?[roman type][line break]";
					LineBreak;
					say "     ([link]Y[as]y[end link]) - Fuck his ass.";
					say "     ([link]N[as]n[end link]) - Take him in your pussy.";
					if player consents: [fuck his ass]
						LineBreak;
						say "[DavidPatrolAnal]";
					else: [let him fuck your pussy]
						LineBreak;
						say "[DavidPatrolVaginal]";
				else if(cocks of player > 0):
					say "[DavidPatrolAnal]";
				else if(cunts of player > 0):
					say "[DavidPatrolVaginal]";
				else:
					say "[DavidPatrolRubbing]";
				LineBreak;
				say "     For now, you leave your handsome soldier boy to gather up his clothes and continue with his patrol. Hopefully you can catch him here again on his next patrol...";
				now thirst of David is 1;
			WaitLineBreak;
			increase score by 5;
			now LastTSEvent is turns;
			increase TSEventCounter by 1;
		else if TSEventCounter > 3: [all good things come to an end - he's ordered to Camp Bravo]
			say "     Moving through the city, you run into a lone soldier walking down a street. It's Private Jackson, the young soldier you saved from that demon brute in the red light district. He's got a slender but still muscular build and a nice-looking face with a boyish charm. Currently he's pretty loaded with equipment, a large backpack full and all kinds of stuff hanging on straps and his belt.";
			say "     As he recognizes you, he gives you a little wave and walks up to talk. He says [if thirst of David < 2]'Hello and goodbye I guess. I got new order to report to one of the larger beachhead camps in the city for some special duties, so I'm afraid we won't be seeing each other again for now.' You ask him if he knows what he's supposed to do there and he shrugs, saying that he just got ordered to report there.[else]with a bit of a sad expression 'I got ordered to report to one of the larger beachhead camps in the city for some other duties. So I guess that's it for our little meetings in that alley... I'll miss you.' After pulling you in for a goodbye-kiss, he walks away, looking back after a while and waving, then continuing on his way.[end if]";
			now HP of David is 1;
			move David to Parade Ground;
			now Thankful Soldier is resolved;
		else: [meeting him in the alley to chat or fuck]
			say "     Moving through the city, you run into a lone soldier patrolling an alley near a small military encampment. It's Private Jackson, the young soldier you saved from that demon brute in the red light district. He's got a slender but still muscular build and a nice-looking face with a boyish charm.";
			say "     As he recognizes you in turn, he gives you a little wave and walks up to you after a last vigilant look up and down the alley. He says [if thirst of David is 0]'Hello again. It's nice to see you're okay. Sadly, I can't share any more supplies...'[else if thirst of David is 1]'Hello. It's... nice to see you again,' his face getting a bit red in embarrassment as he remembers what you did with him last time.[else if thirst of David > 1]'Hi there - I've missed you.'[end if]";
			say "     [bold type]What now?[roman type][line break]";
			LineBreak;
			say "     ([link]Y[as]y[end link]) - Do you want to talk to him.";
			say "     ([link]N[as]n[end link]) - Rather have some hot and sexy action.";
			if player consents: [just talking]
				LineBreak;
				say "     You chat a bit with David about life before the nanite plague and now and what's going on in the city. Speaking to a regular human about these things calms your mind and strengthens your human self-image a bit. After a while, you say your goodbyes and he goes on walking his patrol. Maybe you'll see him again the next time he comes through here...";
				SanBoost 10;
			else: [sex]
				LineBreak;
				if thirst of David is 0:
					say "     Stepping closer to the good-looking young soldier, you pull him tight against your body and give him a deep kiss before he can react. The initial look of alarm in his eyes quickly fades as you make out with him, exploring his mouth with your tongue as you run a hand through his hair and goose his bubble butt with the other one.";
					say "     As you come back up for air, he stammers 'I - I shouldn't... we're not supposed to...', but he moans as you squeeze his ass and his bulge pressing against your body show that he's quite ready for some action. Not getting any relief except rushed masturbation in the weeks and months since the outbreak started, Private Jackson is like putty in your hands, his horny body telling him to go along with anything you want.";
				else:
					say "     Stepping closer to the good-looking young soldier, you pull him tight against your body and give him a deep kiss. [if thirst of David is 1]After a moment of hesitation, he replies in kind and you make out with each other, exploring each other's mouths with your tongues[else if thirst of David > 1]He eagerly complies, hungrily making out with you and exploring your mouth with his tongue[end if]. Meanwhile, you run a hand through his hair and goose his bubble butt with the other one.";
					say "     As you come back up for air, he [if thirst of David is 1]stammers 'I... just can't resist. So... good.', moaning as you squeeze his ass and feel his bulge pressing against your body. Not getting any relief except rushed masturbation in the weeks and months since the outbreak started, Private Jackson is like putty in your hands, his horny body telling him to go along with anything you want.[else if thirst of David > 1]says 'I'm so horny right now. You're amazing...', moaning as you squeeze his ass and feel his bulge pressing against your body. Private Jackson is like putty in your hands, his horny body telling him to go along with anything you want.[end if]";
				if(cocks of player > 0 and cunts of player > 0):
					say "     [bold type]Being dual-gendered, which way do you want to enjoy your soldier friend?[roman type][line break]";
					LineBreak;
					say "     ([link]Y[as]y[end link]) - Fuck his Ass.";
					say "     ([link]N[as]n[end link]) - Take him in your Pussy.";
					if player consents: [fuck his ass]
						LineBreak;
						say "[DavidPatrolAnal]";
					else: [let him fuck your pussy]
						LineBreak;
						say "[DavidPatrolVaginal]";
				else if(cocks of player > 0):
					say "[DavidPatrolAnal]";
				else if(cunts of player > 0):
					say "[DavidPatrolVaginal]";
				else:
					say "[DavidPatrolRubbing]";
				LineBreak;
				say "     For now, you leave your handsome soldier boy to gather up his clothes and continue with his patrol. Hopefully you can catch him here again in a little while...";
				WaitLineBreak;
				if thirst of David < 5:
					increase thirst of David by 1;
			now LastTSEvent is turns;
			increase TSEventCounter by 1;

to say DavidPatrolAnal:
	if lust of David is 0: [anal virgin]
		say "     As you make out with him some more, you slide your hands under his shirt and feel your way up his hard-muscled chest, then pull the fabric up and over his head. Leaning down a bit you run your tongue over his nipples, playfully sucking on first one, then the other. From David's lustful moans, he's ready for the real thing.";
		say "     Opening up the zipper of his pants and letting them drop down, you free his raging hard-on, standing proudly erect in your direction. Quickly stripping off your own clothes, you give him another quick kiss on the lips, then spin him around, your arms around his chest from behind and walk him over to the nearest wall of a building.";
		WaitLineBreak;
		say "     With a moaned 'Stand like this.', you lift his arms up and put them against the wall, then pull his ass towards you a bit. You rub your rock-hard [cock of player] cock up and down between the round buns of his bubble butt, then bring its tip to the tight opening between them. Pushing forward with increasing pressure, David's pucker resists you for a moment, then opens up and allows your cockhead to slide into the tight embrace of his ass. It's virgin territory for sure you're exploring here - and from his lust-filled groans as you slowly slide deeper into him, you're being very well received.";
		say "     As you bottom out inside his ass, you give his cock a few strokes, then move your hands back to his hips. Holding on tightly, you start pulling out almost all the way and hammering your shaft back inside him in quick deep strokes, filling the alley with slapping noises as your hips meet his butt. His tightly gripping hole feels just amazing around your thrusting member, filling you with ecstasy as you very thoroughly take his virginity.";
		say "     Getting shafted like this soon drives your handsome Private over the edge, his cock spraying a huge load of cum all over the stones of the wall he's standing against. David's ass muscles quiver and flex with each shot of seed erupting from his cock, giving you all new sensations as you move in and out of him. Then it's your turn, and with one final deep thrust you push inside David all the way and fill his insides with spurt after spurt of warm seed.";
		WaitLineBreak;
		say "     You keep standing like that for a moment, with your arms around his chest from behind and still connected through your dick in his ass. As both of you come down from the rush of sex and David's brain starts working again, he looks over his shoulder at you with a questioning expression. 'I like... this,' he says and you feel his asshole tighten for a second around your member. 'Does that mean I'm gay?' With a worried look he adds 'I got a girlfriend back home, you know.'";
		say "     After giving him a playful slap on his firm buttocks as you pull out, you calm him down a bit by telling that he just might be bisexual and that he should use the opportunity to try out the whole spectrum of possible partners. The girlfriend situation will surely work itself out once he knows what he really wants. Although judging from his load all over the wall, you're pretty certain you left a lasting impression on him, opening him up more man-on-man action...";
		now lust of David is 1;
	else: [repeat assfucking]
		say "     As you make out with him some more, you slide your hands under his shirt and feel your way up his hard-muscled chest, then pull the fabric up and over his head. Leaning down a bit you run your tongue over his nipples, playfully sucking on first one, then the other. From David's lustful moans, he's ready for the real thing.";
		say "     Opening up the zipper of his pants and letting them drop down, you free his raging hard-on, standing proudly erect in your direction. Quickly stripping off your own clothes, you give him another quick kiss on the lips, then spin him around, your arms around his chest from behind and walk him over to the nearest wall of a building.";
		WaitLineBreak;
		say "     Knowing what's coming, he lifts his arms up and puts them against the wall, bending forward a bit and offering his ass. You rub your rock-hard [cock of player] cock up and down between the round buns of his bubble butt, then bring its tip to the tight opening between them. Pushing forward with increasing pressure, David's pucker resists you for a moment, then opens up and allows your cockhead to slide into the tight embrace of his ass. He's still tight as he was when you took his virginity and giving lust-filled groans as you slowly slide deeper into him.";
		say "     As you bottom out inside his ass, you give his cock a few strokes, then move your hands back to his hips. Holding on tightly, you start pulling out almost all the way and hammering your shaft back inside him in quick deep strokes, filling the alley with slapping noises as your hips meet his butt. His tightly gripping hole feels just amazing around your thrusting member, filling you with ecstasy as you give him a good fucking.";
		say "     Getting shafted like this soon drives your handsome Private over the edge, his cock spraying a huge load of cum all over the stones of the wall he's standing against. David's ass muscles quiver and flex with each shot of seed erupting from his cock, giving you all new sensations as you move in and out of him. Then it's your turn, and with one final deep thrust you push inside David all the way and fill his insides with spurt after spurt of warm seed.";
		WaitLineBreak;
		say "     You keep standing like that for a moment, with your arms around his chest from behind and still connected through your dick in his ass. As both of you come down from the rush of sex, he says 'I still can't believe how good you feel inside me,' he says and you feel his asshole tighten for a second around your member. 'I guess I really am bi, like you said.' With a worried look he adds 'What will Ann say about that when I get back home?'";
		say "     After giving him a playful slap on his firm buttocks as you pull out, you calm him down a bit by telling that his girlfriend surely won't learn about you two once he goes back to her when this is all over. What happens in this city stays in the city. Unless of course you can make him fully yours to keep, you think to yourself...";

to say DavidPatrolVaginal:
	setmonster "human";
	choose row monster from the table of random critters;
	say "     As you make out with him some more, you slide your hands under his shirt and feel your way up his hard-muscled chest, then pull the fabric up and over his head. Leaning down a bit you run your tongue over his nipples, playfully sucking on first one, then the other. From David's lustful moans, he's ready for the real thing.";
	say "     Opening up the zipper of his pants and letting them drop down, you free his raging hard-on, standing proudly erect in your direction. Quickly stripping off your own clothes and putting them down as an improvised blanket, you give him another quick kiss on the lips and lie down on it, pulling him with you by the hand so he ends up on top of you.";
	WaitLineBreak;
	say "     It only takes a helping hand guiding his rod to your pussy lips for the young man's instincts to kick in and his hips plunge downward, thrusting his hard manhood deep into your vagina. He fucks you with smooth strokes, making you moan with the feelings as his shaft hits just the right spots inside you. You run your hands over his chest, feeling his muscles while your legs wrap around his hips to pull him even deeper with each of his thrusts. Soon he speeds up even more, groaning louder and louder as he gets closer to orgasm.";
	say "     Then he shouts 'I'm coming!' and you feel a shudder run through his body as the first blast of his human cum shoots deep inside your body. You pull him down on top of you, hugging him close and kissing him as his cock twitches again and again, filling you to the brink with his fertile seed.[fimpregchance]";
	say "     You lay there for a while, entwined and kissing, with his slowly softening cock still inside you. As both of you come down from the rush of sex and David's brain starts working again, he pants 'Wow, that was... just wow.' and you feel his manhood twitch inside you once. Then a worried look comes over his face and he adds 'But... oh no, I just cheated on my girlfriend. What will she say when I get back home. I - you...'";
	say "     Pulling his mouth to yours for a quick kiss, you tell him to calm down and that his girlfriend surely won't learn about you two once he goes back to her when this is all over. What happens in this city stays in the city. Unless of course you can make him fully yours to keep, you think to yourself...";

to say DavidPatrolRubbing:
	say "     As you make out with him some more, you slide your hands under his shirt and feel your way up his hard-muscled chest, then pull the fabric up and over his head. Leaning down a bit you run your tongue over his nipples, playfully sucking on first one, then the other. From David's lustful moans, he's ready for the something more.";
	say "     Opening up the zipper of his pants and letting them drop down, you free his raging hard-on, standing proudly erect in your direction. Quickly stripping off your own clothes, you give him another quick kiss on the lips, then start rubbing your naked body against his. Grasping his hard manhood in your hand, you jerk a few times up and down on it, then and stroke the sensitive skin of your flat crotch with its tip. Even though you don't have anything there as a neuter, it still gives you a warm and pleasant feeling to feel the warmth of his shaft against you and hear his lustful moans.";
	say "     You switch between grinding against David, fondling his body and making out with him, filling the alley with both of your moans and groans. Not being able to cum yourself, you could keep this up forever, but your horny soldier's urges all too soon have him gasping faster and faster as he gets closer to orgasm. Then it's time - his thick shaft pules in your hand as blasts of cum jet out of its head to splat all over your crotch and stomach.";
	WaitLineBreak;
	say "     Gathering up some cum with your finger, you lick it off, then give your handsome Private a kiss, making him taste his own cum on your lips. You keep standing like that for a moment, your arms around his chest and slowly making out. As both of you come down from the rush of sex and David's brain starts working again, he says 'That felt amazing - but... what exactly are you?' with a nod to your genderless nether region. With a worried look he adds 'Anyways... maybe this was wrong. We didn't really have sex, but you made me cum. Feels like I'm cheating on my girlfriend Ann back home.'";
	say "     Stroking his cheek, you tell him to calm down and that his girlfriend surely won't learn about you two once he goes back to her when this is all over. What happens in this city stays in the city. Unless of course you can make him fully yours to keep, you think to yourself...";

Section 2 - NPC

David is a man.
The description of David is "     David Jackson is a young soldier, pretty friendly if a bit shy. He has a slender but still muscular build, a handsome face and short-cut brown hair. [if debugactive is 1][line break]DEBUG -> Dexterity: [Dexterity of David], HP: [HP of David], Libido: [libido of David], Lust: [lust of David], Thirst: [thirst of David] <- DEBUG[end if]".
The conversation of David is { "Oh, hello." }.
The icon of David is Figure of David_clothed_icon.
DavidBunkerEntry is a number that varies.
BrutusEscalationTimer is a number that varies.
DavidBrutusMarcVar is a number that varies.

The scent of David is "     David has a nice masculine human smell.".

Instead of fucking David:
	if(lastfuck of David - turns < 5):
		say "     David says 'I'd love to, but I'm still pretty worn out from the last time...'";
	else:
		if David is in Parade Ground:
			say "     You walk up to David and tell him you want to 'talk' to him - alone. [if thirst of David < 2]He salutes and leads you to a nearby tent. Soon you're standing between several bunk beds, alone in the tent with the handsome soldier..[else]He gives you a knowing wink and leads you to a nearby tent. Soon you're standing between several bunk beds, alone in the tent with the handsome soldier...[end if]";
		now sextablerun is 0;
		project Figure of David_naked_icon;
		blank out the whole of table of fucking options;
		[]
		choose a blank row in table of fucking options;
		now title entry is "Suck David's cock";
		now sortorder entry is 1;
		now description entry is "Give him a blow-job.";
		[]
		if (lust of David > 0 and cocks of player > 0):
			choose a blank row in table of fucking options;
			now title entry is "Have him suck your cock";
			now sortorder entry is 2;
			now description entry is "Get a blow-job.";
		[]
		if (cunts of player > 0):
			choose a blank row in table of fucking options;
			now title entry is "Let David fuck your pussy";
			now sortorder entry is 3;
			now description entry is "Let the young soldier breed you.";
		[]
		if (lust of David > 0):
			choose a blank row in table of fucking options;
			now title entry is "Let David fuck your ass";
			now sortorder entry is 4;
			now description entry is "Let the young soldier fill your ass with his seed.";
		[]
		if (cocks of player > 0):
			choose a blank row in table of fucking options;
			now title entry is "Take David's ass";
			now sortorder entry is 5;
			now description entry is "Fill the young soldier's ass with your cock.";
		[]
		if (Dexterity of David is 2 and David is in bunker and Sven is in bunker):
			choose a blank row in table of fucking options;
			now title entry is "Threesome with Sven";
			now sortorder entry is 6;
			now description entry is "Let the young soldier fuck Sven's ass.";
		[]
		if (libido of David > 56 and libido of David < 89 and David is in bunker and DBCaptureQuestVar is 7):
			choose a blank row in table of fucking options;
			now title entry is "Brutus & David Scene (David gives oral)";
			now sortorder entry is 7;
			now description entry is "Give them some time to have fun with each other. (David goes down on Brutus)";
		[]
		if (libido of David > 56 and libido of David < 89 and David is in bunker and DBCaptureQuestVar is 7):
			choose a blank row in table of fucking options;
			now title entry is "Brutus & David Scene (BJ by Brutus)";
			now sortorder entry is 8;
			now description entry is "Give them some time to have fun with each other. (Brutus blows David)";
		[]
		if (libido of David > 56 and libido of David < 89 and David is in bunker and DBCaptureQuestVar is 7):
			choose a blank row in table of fucking options;
			now title entry is "Brutus & David Scene (Brutus gets fucked)";
			now sortorder entry is 9;
			now description entry is "Give them some time to have fun with each other. (David fucks Brutus)";
		[]
		if (libido of David > 56 and libido of David < 89 and David is in bunker and DBCaptureQuestVar is 7 and DemonBruteStatus < 2):
			choose a blank row in table of fucking options;
			now title entry is "Brutus & David Scene (David gets fucked)";
			now sortorder entry is 10;
			now description entry is "Give them some time to have fun with each other. (Brutus fucks David)";
		[]
		if (libido of David > 56 and libido of David < 89 and David is in bunker and DBCaptureQuestVar is 7 and DemonBruteStatus < 2):
			choose a blank row in table of fucking options;
			now title entry is "Threesome with Brutus & David (DP Brutus)";
			now sortorder entry is 11;
			now description entry is "Fuck Brutus together with David.";
		[]
		sort the table of fucking options in sortorder order;
		repeat with y running from 1 to number of filled rows in table of fucking options:
			choose row y from the table of fucking options;
			say "[link][y] - [title entry][as][y][end link][line break]";
		say "[link]100 - Nevermind[as]100[end link][line break]";
		while sextablerun is 0:
			say "Pick the corresponding number> [run paragraph on]";
			get a number;
			if calcnumber > 0 and calcnumber <= the number of filled rows in table of fucking options:
				now current menu selection is calcnumber;
				choose row calcnumber in table of fucking options;
				say "[title entry]: [description entry]?";
				if player consents:
					let nam be title entry;
					clear the screen and hyperlink list;
					now sextablerun is 1;
					if nam is "Suck David's cock":
						say "[DavidSex1]";
					else if (nam is "Have him suck your cock"):
						say "[DavidSex2]";
					else if (nam is "Let David fuck your pussy"):
						say "[DavidSex3]";
					else if (nam is "Let David fuck your ass"):
						say "[DavidSex4]";
					else if (nam is "Take David's ass"):
						say "[DavidSex5]";
					else if (nam is "Threesome with Sven"):
						say "[DavidSex6]";
					else if (nam is "Brutus & David Scene (David gives oral)"):
						say "[DavidSex7]";
					else if (nam is "Brutus & David Scene (BJ by Brutus)"):
						say "[DavidSex8]";
					else if (nam is "Brutus & David Scene (Brutus gets fucked)"):
						say "[DavidSex9]";
					else if (nam is "Brutus & David Scene (David gets fucked)"):
						say "[DavidSex10]";
					else if (nam is "Threesome with Brutus & David (DP Brutus)"):
						say "[DavidSex11]";
					WaitLineBreak;
			else if calcnumber is 100:
				say "Break off?";
				if the player consents:
					now sextablerun is 1;
					say "     You step back from the young soldier, shaking your head slightly as he gives a questioning look.";
					WaitLineBreak;
				else:
					say "Pick between 1 and [the number of filled rows in the table of fucking options] or 100 to exit.";
			else:
				say "Invalid Option. Pick between 1 and [the number of filled rows in the table of fucking options].";
		clear the screen and hyperlink list;
		if thirst of David < 5:
			increase thirst of David by 1;
		now lastfuck of David is turns;

instead of conversing David:
	if HP of David < 2:
		say "     Error! He shouldn't be talking yet - please report on the forum how you saw this.";
	project the figure of David_face_icon;
	if HP of David is 2:
		say "     David says 'I'm still waiting for my number to come up. Doesn't seem as frightening as before though - maybe it's the strange smell in the air here...'";
	else if HP of David > 2:
		now sextablerun is 0;
		blank out the whole of table of fucking options;
		[]
		choose a blank row in table of fucking options;
		now title entry is "Just chat";
		now sortorder entry is 1;
		now description entry is "Chat a bit with David";
		[]
		if HP of David is 3:
			choose a blank row in table of fucking options;
			now title entry is "Send him to the bunker";
			now sortorder entry is 2;
			now description entry is "Send David to stay with you in the bunker";
		[]
		if HP of David is 4:
			choose a blank row in table of fucking options;
			now title entry is "Send him to Camp Bravo";
			now sortorder entry is 3;
			now description entry is "Send David to stay with the soldiers of Camp Bravo";
		[]
		if libido of David > 50 and libido of David < 86:
			choose a blank row in table of fucking options;
			now title entry is "Talk about Brutus";
			now sortorder entry is 4;
			now description entry is "Bring up the demon brute in your conversation";
		[]
		if libido of David > 57 and libido of David < 80 and HP of David is 4 and Beach Plaza is known:
			choose a blank row in table of fucking options;
			now title entry is "Suggest a trip to the beach with Brutus";
			now sortorder entry is 5;
			now description entry is "Spend some time on the beach with David and Brutus";
		[]
		if libido of David > 57 and libido of David < 80 and HP of David is 4 and Camp Bravo Entrance is known:
			choose a blank row in table of fucking options;
			now title entry is "Suggest a trip to Camp Bravo with Brutus";
			now sortorder entry is 6;
			now description entry is "Visit the camp and let David show Brutus around";
		[]
		if libido of David is 60 and HP of David is 4:
			choose a blank row in table of fucking options;
			now title entry is "Tell him about Brutus inner turmoil";
			now sortorder entry is 7;
			now description entry is "Explain Brutus dark urges to David";
		[]
		sort the table of fucking options in sortorder order;
		repeat with y running from 1 to number of filled rows in table of fucking options:
			choose row y from the table of fucking options;
			say "[link][y] - [title entry][as][y][end link][line break]";
		say "[link]100 - Nevermind[as]100[end link][line break]";
		while sextablerun is 0:
			say "Pick the corresponding number> [run paragraph on]";
			get a number;
			if calcnumber > 0 and calcnumber <= the number of filled rows in table of fucking options:
				now current menu selection is calcnumber;
				choose row calcnumber in table of fucking options;
				say "[title entry]: [description entry]?";
				if player consents:
					let nam be title entry;
					clear the screen and hyperlink list;
					now sextablerun is 1;
					if nam is "Just chat":
						say "[DavidTalk1]";
					if nam is "Send him to the bunker":
						say "[DavidTalk2]";
					if nam is "Send him to Camp Bravo":
						say "[DavidTalk3]";
					if nam is "Talk about Brutus":
						say "[DavidTalk4]";
					if nam is "Suggest a trip to the beach with Brutus":
						say "[DavidTalk5]";
					if nam is "Suggest a trip to Camp Bravo with Brutus":
						say "[DavidTalk6]";
					if nam is "Tell him about Brutus inner turmoil":
						say "[DavidTalk7]";
					WaitLineBreak;
					now lastfuck of David is turns;
			else if calcnumber is 100:
				say "Break off?";
				if the player consents:
					now sextablerun is 1;
					say "     You step back from the young soldier, shaking your head slightly as he gives a questioning look.";
					WaitLineBreak;
				else:
					say "Pick between 1 and [the number of filled rows in the table of fucking options] or 100 to exit.";
			else:
				say "Invalid Option. Pick between 1 and [the number of filled rows in the table of fucking options].";
		clear the screen and hyperlink list;

to say DavidTalk1: [chatting]
	if HP of David is 3: [in the camp]
		say "     David says 'As you can see, the sample gathering is still going well. It's unbelievable how much stamina Tiny Tim has. [if CampBravoWomenAllowed is 1]Several of the female soldiers got sent out as well by now, their bellies already swelling with minotaur calves.' [end if][if Adam is in Quartermaster's Tent]The quartermaster had a half-minotaur son too - he's in her tent helping her out.' [end if]";
	if HP of David is 4: [in the bunker]
		if Sarahpups > 3:
			say "     David says 'Sarah's puppies keep trying to chew up my boots. They're sweet and all, but sometimes they get on my nerves. I've been going up into the library to get some peace and quiet and read[if Fang is in the Grey Abbey Library]. Of course, there your wolf keeps staring at me like he wants to mount me[end if].'";
		else:
			say "     David says 'Pretty quiet down here in the bunker. I've been going up into the library to grab a book or two to read[if Fang is in the Grey Abbey Library]. And your wolf kept looking at me all the time like he wanted to mount me[end if].'";

to say DavidTalk2: [send him to the bunker]
	say "     David gives you a salute and says [if thirst of David is 20]'See you there, baby.' [else]'As you wish, sir.' [end if]before going to collect his clothes and equipment.";
	move David to Bunker;
	now HP of David is 4;
	now DavidBunkerEntry is turns;

to say DavidTalk3: [send him to Camp Bravo]
	say "     David gives you a salute and says [if thirst of David is 20]'See you there, baby.' [else]'As you wish, sir.' [end if]before going to collect his clothes and equipment.";
	move David to Parade Ground;
	now HP of David is 3;

to say DavidTalk4: [talk about Brutus]
	if libido of David is 51:
		say "     Bringing up the topic of Brutus, you explain that your demon companion thinks that the demon who attacked him did something, possibly leaving what Brutus called a 'seal of enslavement'. Continuing with the offer by Brutus to have a look for it, you see David become rather uncomfortable as he imagines stripping before the demon. Still, he might be in real danger from it, if he actually has the seal on him and it draws other demons like it seems to be affecting Brutus. You do your best to convince David to agree to Brutus examining him, and...";
		LineBreak;
		let bonus be (( the Charisma of the player minus 10 ) divided by 2);
		let diceroll be a random number from 1 to 20;
		say "You roll 1d20([diceroll])+[bonus]: [diceroll + bonus] in a Charisma-Check.";
		increase diceroll by bonus;
		if diceroll > 12:
			say "     ...manage to convince David to do it.";
			LineBreak;
			if DemonBruteStatus is 2: [female]
				say "     [if HP of David is 3]After moving over to an empty tent a bit out of the way from the parade ground,[else if HP of David is 4]After moving to the far corner of the bunker,[end if] you give the young soldier a squeeze on the shoulder and an encouraging nod. With a look up at the demon waiting beside you, and another at Brutus (again) moist and swollen pussy, David gives himself a small shake, then pulls his shirt over his head and strips down. As the young man slides the last bit of fabric off and stands completely naked before you. He trembles uncontrollably as Brutus steps up to him. Brutus looks down on the naked human, then carefully puts a hand on David's shoulder. 'I'm... sorry about what was done to you. And that I make you feel like this.' David looks up, meeting Brutus eyes, and after a moment you see him slowly relax a bit as he sees the concern and apology in the demon's large, slitted pupils.";
			else: [male+herm]
				say "     [if HP of David is 3]After moving over to an empty tent a bit out of the way from the parade ground,[else if HP of David is 4]After moving to the far corner of the bunker,[end if] you give the young soldier a squeeze on the shoulder and an encouraging nod. With a look up at the demon waiting beside you, and another at Brutus (again) hardening cock, David gives himself a small shake, then pulls his shirt over his head and strips down. As the young man slides the last bit of fabric off and stands completely naked before you. He trembles uncontrollably as Brutus steps up to him. Brutus looks down on the naked human, then carefully puts a hand on David's shoulder. 'I'm... sorry about what was done to you. And that I make you feel like this.' David looks up, meeting Brutus eyes, and after a moment you see him slowly relax a bit as he sees the concern and apology in the demon's large, slitted pupils.";
			WaitLineBreak;
			say "     Slowly stepping around David, Brutus looks closely at him, lightly touching the scars the other demon left. Then he has the young man raise his right arm, and brushes his clawed fingers over a bit of scar tissue there. 'This is it - the seal. This will make you amplify your fear, almost paralyze you with it, while at the same time craving to serve, being degraded, everything like that. You would follow your master everywhere, even to hell.'";
			say "     Concentrating, murmuring a chain words that you couldn't even pronounce while holding his hand in place over David, Brutus draws some purple smoke out of the young soldier. It coalesces into a faintly glowing, eye-twisting rune in the air above David's skin. You notice that there seems to be quite a bit of effort involved - judging from the beads of sweat forming on Brutus skin and dripping off the demon's brow. In an earnest tone, he says 'I'm sorry for all the innocents I too bound like this. You, at least, will be free.' then slashes his claws through the glowing symbol.";
			WaitLineBreak;
			say "     With a loud crack of power, Brutus is thrown several feet backwards, where he crumples to the ground. The smell of burned flesh rises in the air. For a second of shocked silence, no one moves - not you, and not David, who stands where he was, not affected or hurt at all by what happened. Then both of you rush forward to kneel beside the fallen demon brute. Thankfully, he's okay - mostly. With a groan, Brutus starts moving again and opens his eyes. He lifts his head a bit so he can look at his hand as he raises it with a pained hiss, grunting at the view of blistered, burned skin. 'Mh - it will heal,' he says, his head slumping back as he takes a deep breath.";
			say "     Next, Brutus eyes focus on David, mostly on his face but wandering down to gaze at the young man's naked body too. 'It is done. You should be free. Do you still fear me, human?' David looks down at the demon's prone form, meeting his eyes for a moment before replying 'No', a thoughtful expression on his face. Brutus lips form what can be called a smile, even if it looks rather frightening with all the teeth it shows. He turns his head to you, not quite suppressing a pained wince as he tries lowering his hand to rest on the ground at the same time. 'Master, may I rest?' Not wanting to see your companion suffer any longer, you immediately intone the magic words to send him back into the amulet.";
			if companion of player is demon brute:
				now companion of player is nullpet;
			now libido of David is 52;
		else:
			say "     ...get an answer of 'Sorry, I just can't. Be close to one of those things...' David shudders.";
	else if libido of David is 52: [Brutus helped David, got hurt - first meeting after]
		if companion of player is demon brute: [is the active pet]
			say "     David inquires how Brutus is now and is visibly relieved when the demon shows him his fully healed hand. Turning into smoke and back regularly means that he has lots of practice in reassembling himself after all. David nods, then falls silent for a moment, thinking. He pulls you aside out of earshot of your demon companion before asking 'Did you order him to do it? Did you... know it would hurt him?' Both of those questions you truthfully say no to, recounting Brutus shameful admission of certain... urges, then him pleading to look at David. 'So it was all him? That's... quite something. For a demon.' He rubs his side where the demonic seal once was hidden, biting his lip before he continues. 'Could I... talk to him sometime?'";
			WaitLineBreak;
			say "     Why wait - you call Brutus over. David walks up to him, putting a hand on his muscled arm. 'I wanted to thank you again for dealing with that evil symbol. It was... unexpected, for you to take such a risk for me.' Then he holds out his hand to Brutus, offering it to him. 'So... friends?' The demon looks down at him nonplussed for a second as he tries to come up with a response to a topic that hasn't been part of his life for eons - then he exuberantly shakes the smaller human's hand and pulls him into an embrace.";
		else:
			say "     As you bring up Brutus again, David inquires how he is now and is visibly relieved when you tell him he came out alright. Turning into smoke and back regularly means that he has lots of practice in reassembling himself after all. David nods, then falls silent for a moment, thinking, before asking 'Did you order him to do it? Did you... know it would hurt him?' Both of those questions you truthfully say no to, recounting Brutus shameful admission of certain... urges, then him pleading to look at David. 'So it was all him? That's... quite something. For a demon.' He rubs his side where the demonic seal once was hidden, biting his lip before he continues. 'Could I... talk to him sometime?'";
			WaitLineBreak;
			say "     Why wait - you murmur the magic words to summon Brutus, making him appear from a cloud of purple smoke. The demon bows his head to you, saying 'Master', then turns to the soldier beside you and says 'Hello, David'. David walks up to him, putting a hand on his muscled arm. 'I wanted to thank you again for dealing with that evil symbol. It was... unexpected, for you to take such a risk for me.' Then he holds out his hand to Brutus, offering it to him. 'So... friends?' The demon looks down at him nonplussed for a second as he tries to come up with a response to a topic that hasn't been part of his life for eons -then he exuberantly shakes the smaller human's hand and pulls him into an embrace.";
		if DemonBruteStatus is 2: [female]
			say "     They stay in that tight hug for a moment, David pressed against Brutus chest, his arms not even close long enough to reach around the demon's wide chest. Then suddenly, Brutus clears his throat, his face taking on an interesting shade of embarrassed purple as he lets the young soldier in his arms go. As David steps away, you see the pussy in a quite aroused state, its lips swollen, a wet spot on David's clothing where he must have been pressed right against it. With you standing right next to them, both the soldier and the demon seem to come to the decision to ignore the last bit at the same time, resulting in a somewhat awkward 'See ya.' and 'Sure, friend.'";
		else: [male+herm]
			say "     They stay in that tight hug for a moment, David pressed against Brutus chest, his arms not even close long enough to reach around the demon's wide chest. Then suddenly, Brutus clears his throat, his face taking on an interesting shade of embarrassed purple as he lets the young soldier in his arms go. As David steps away, you see the demon's cock in a quite aroused state, hanging where it must have pressed right against David. With you standing right next to them, both the soldier and the demon seem to come to the decision to ignore the last bit at the same time, resulting in a somewhat awkward 'See ya.' and 'Sure, friend.'";
		now libido of David is 53;
	else if libido of David is 53: [talking after they've become friends]
		say "     As you bring your demon companion up, David says 'I still can't quite believe that Brutus is so... nice. No, that's the wrong word. Normal. After seeing that big beast in the bar you had to save me from, I'd never have believed one of them could be like a normal guy. Ever.' He rubs the claw-marks on his side, then shakes off the memory again, continuing with 'Now Brutus is a friend, and couldn't be more different than that other demon. Well - except his strength. Awesome muscles on him. He really had me tight with that hug, and right against his... er' David's face turns a bit red as he stops talking, then quickly continues with 'Anyways, we're both lucky you came along when you did. Saving me and saving him, from himself.'";
		LineBreak;
		say "     Despite David's attempt of changing the topic, it seems pretty obvious to you that there's some... interest for each other between your two friends. The thought comes up from somewhere inside your head that it might be a good idea to just get the two of them alone for a while and see what develops.";
		say "     [bold type]Do you want to follow it?[roman type][line break]";
		LineBreak;
		say "     ([link]Y[as]y[end link]) - Yes.";
		say "     ([link]N[as]n[end link]) - No.";
		if player consents: [arrange for them to be alone together]
			LineBreak;
			say "     Your decision made, you mull over how to arrange things for a moment, then turn back to your soldier friend and suggest that he check the contents of the piles of crates stacked up in a storeroom at the back of the library. In all likelihood just books, but since there was a tiny store at the entrance, selling various small stuff, there might just be something interesting there. 'Good idea' David says with a nod, then starts out towards the stairs up to the library.";
			say "     Before he can make more than two steps, you continue to say that he should take Brutus along, to help with carrying stuff and so on. The young soldier turns, his eyes immediately seeking out your demon companion's muscular chest and arms, then dropping lower to pass over his... other endowments. His cheeks slightly red as he tears his eyes away and looks back to you, David says 'Err... of course.' Then the soldier and demon walk off together, on their way to the library storeroom.";
			WaitLineBreak;
			say "     You're certainly curious what will come of this.";
			say "     [bold type]Maybe you should follow them unobtrusively and have a look - or do you want to give them real privacy to deal with their issues after all?[roman type][line break]";
			LineBreak;
			say "     ([link]Y[as]y[end link]) - Follow.";
			say "     ([link]N[as]n[end link]) - Give them privacy.";
			if player consents: [follow them]
				LineBreak;
				say "     Waiting a few minutes to give them enough time to get where they are going, you then make your way to the stairs and walk in the direction of the storeroom when you get up into the library. As you silently walk along the hallway towards its open door, you can hear voices from within. David says '...and some more books. Could you please move these two crates over to that corner. We need them out of the way.'";
				say "     Then you're at the door and carefully peek inside the room. There are quite a few crates, large and small, in it, and in the midst of those stand David and Brutus. As you watch, the demon brute puts the lid of a large wooden crate that he was holding back on it, then bends to effortlessly pick up the heavy crate. From the looks of it and the pallet it stood on, no human could have moved it without a pallet jack. Impressed by that feat of superhuman strength, David can't suppress a 'Whoa' as he watches Brutus carry the heavy load and set it down where it was supposed to go, followed by the second crate. Grinning widely as he walks back, Brutus comes to stand before the young man, flexing his chest and arms demonstratively. David reaches out to run his fingers over Brutus chest, then stops himself, clearing his throat as he says 'Let's check out the next crate.'";
				WaitLineBreak;
				say "     As the two of them continue to open and move aside box after heavy box of books, you overhear them chatting a bit about this and that and observe David slowly losing his reflexive inhibition at watching Brutus body - all of his body. The demon just eats up the admiration for his physique, often flexing and stretching to show off, grinning happily when David compliments him.";
				say "     Finishing with the first row of pallets and the crates on them, they come to a pallet laden with a bit smaller carton boxes. 'This could be something' David says, pulling one of the top ones off and setting it on the ground with a thump. He leans over it, opening up its lid, then grumbles 'Oh great, pencils.' Brutus doesn't react to the disappointing contents of the box, his whole attention riveted to the curve of David's ass, looking very nice in the bent over young soldier's pants. With a lustful grunt, the aroused demon steps forward, his purple dick having quickly reached its full hardness. Putting his clawed hands on David's body, he cups the cheeks of the young man's ass and gives them a squeeze. 'Oh? Ooh...' David says breathlessly as he stands up again and turns, looking at Brutus chest, then quickly down to his crotch, then up into his azure blue eyes. After just a moment more of hesitation, the floodgates break, with the young soldier being pulled into a tight embrace against the demon's chest, eagerly meeting his lips as they start making out. In between the hungry kisses, moans fill the storeroom, coupled with pleased rumbles out of Brutus chest.";
				WaitLineBreak;
				say "     Then, as David gets lowered back to the ground, Brutus says in his deep voice 'I want you - now!', his hands moving to pull off David's shirt, accidentally tearing it to shreds in his haste. With eager, hurried movements, the young soldier kicks off his boots, almost falls over as he stands on one leg, then the other, to pull off and throw aside his socks and finally manages to undo his belt and pants, letting them drop to the ground. His boxer briefs end up cleanly sliced off his body by one of Brutus sharp claws, leaving David standing in the buff before the equally naked Brutus.";
				if DemonBruteStatus is 0 or DemonBruteStatus is 1: [male+herm]
					say "     Leaning forward to lick his forked tongue over the young soldier's chest, then along his neck, Brutus gives a lust-filled grunt, the veins on his hard shaft throbbing in anticipation. He picks up David, one hand cupping his ass, the other guiding the human's head to his own so they can kiss, then carries him over to a crate that's hip-height for himself and covered in some soft plastic wrap. As he lowers David onto it softly, the demon says 'I wanted you since I first saw you - and now that you're my friend, I want you even more.' His large hand strokes over David's chest, stops to jerk the man's cock a few times before moving even lower, rubbing over his butthole, pulling a breathless pant from the soldier.";
					WaitLineBreak;
					if lust of David is 0: [anal virgin]
						say "     David moans 'I - I haven't had anyone... go there before', still somewhat hesitant even though deeply in the grasp of his own lust. With surprising gentleness, Brutus replies 'Don't worry my friend, I'll go slow, at first. Make it good.' then leans forward to kiss David on the lips before crouching down and bringing his tongue to lick the man's buttcheeks. Then he moves it along David's crack, playing over his pucker several times before pushing it inside, probing and licking him. After several minutes of this during which David's hole is carefully teased and spread, lubed with Brutus spit as David moans and writhes in pleasure, your demon companion stands up again, now bringing his hard shaft up against David with a guiding hand. Looking down with clear concern for the human, Brutus caresses his chest again, then says 'Tell me how fast I can go, ok?' and gets a nod from the lying human.";
						say "     After nudging the tip of his shaft against David's pucker several times to prepare him for what's coming, Brutus presses in, giving a deep grunt of pleasure as his head pops into the soldier's body. David's reaction is a short, pained gasp, as he loses his virginity to a very large male indeed and Brutus stops immediately, holding still inside him. After a few deep breaths, David pants 'Keep going', and the demon brute takes up sinking his manhood into him slowly again, bit by bit spreading the freshly deflowered human's passage around his shaft. At some point, the pleasurable feelings of having the bumps on Brutus cock rub his insides outweigh the discomfort and David's utterances turn from gasps and pants to moans, coupled with demands to take him deeper. Finally, the demon bottoms out inside him and leans in for another long kiss.";
						now lust of David is 51; [de-virginized by Brutus]
					else:
						say "     David moans 'I'm still a bit new to this, never did it with men before... [if lust of David < 50]you know, your master[else]you know, getting here[end if]', still somewhat hesitant even though deeply in the grasp of his own lust. With surprising gentleness, Brutus replies 'Don't worry my friend, I'll go slow, at first. Make it good.' then leans forward to kiss David on the lips before crouching down and bringing his tongue to lick the man's buttcheeks. Then he moves it along David's crack, playing over his pucker several times before pushing it inside, probing and licking him. After several minutes of this during which David's hole is carefully teased and spread, lubed with Brutus spit as David moans and writhes in pleasure, your demon companion stands up again, now bringing his hard shaft up against David with a guiding hand. Looking down with clear concern for the human, Brutus caresses his chest again, then says 'Tell me how fast I can go, ok?' and gets a nod from the lying human.";
						say "     After nudging the tip of his shaft against David's pucker several times to prepare him for what's coming, Brutus presses in, giving a deep grunt of pleasure as his head pops into the soldier's body. Thankfully being prepared to taking a dick through your own intimate encounters with him as well as Brutus oral attention, David is relaxed about taking him, reacting only with a short gasp, then says 'I'm okay, keep going.' After a few moment of hesitation, the demon brute takes up sinking his manhood into him slowly again, bit by bit spreading the human's passage around his shaft. David pants and moans in lust, and after a while even calls out for Brutus to go faster, deeper. Finally, the demon bottoms out inside him and leans in for another long kiss.";
					WaitLineBreak;
					say "     Raising his upper body back up, the horny demon puts his hands on David's shoulders to hold him from sliding back on his padded crate, then slowly pulls out of him before thrusting back in with a lusty grunt, his massive balls hitting David's ass with a meaty slap. He goes slow at first, then speeds up bit by bit as the young soldier's inner muscles are stretched out and get used to the thick invading member moving in and out of David's body. Before long, their loud moans and gasps are joined by scraping sounds as the crate David is lying on gets shifted further and further back when Brutus harder thrusts hit it. Which means that you can relax your self-control finally, no longer having to suppress your own noises with all the racket they're making. Having been thoroughly turned on by spying on your friend's coupling, you bring your hand to your crotch, [if cocks of player > 0]stroking your manhood[else]stroking yourself[end if] in rhythm with Brutus thrusts.";
					say "     The hot sex between the two very different partners continues for some more time, with the moans, pants and slapping noises of Brutus balls against David's ass getting ever faster and louder. Their coupling builds up to an impressive - and pretty noisy - climax. David is the first to go, shouting 'Oooh fuck... oh, oh... god... I'm gonna cummmMM...' as his hard cock pulses, shooting long streaks of cum over his chest and even hitting him in the face. With the human's inner muscles gripping him tightly, flexing around Brutus shaft as David rides out his orgasm, it doesn't take much longer for the demon to join him too. With a long and very satisfied grunt, Brutus slams into David one last time, bottoming out as he unloads a veritable flood of cum into him. As he pumps more and more seed into David, the human's belly bulges slightly, as if he was in the early stages of pregnancy, with even more cum squirting around his thick shaft and running down over the crate. Eager to join the two of them in their satisfaction, you speed up your own efforts, only moments later [if cocks of player > 0]shooting a load all over the wall at the storeroom's entrance[else if cunts of player > 0]squirting femcum on the floor to form a small wet patch[else]feeling a pleasant tingle fill your whole body[end if].";
					WaitLineBreak;
					say "     Picking up the exhausted human still impaled on his cock, Brutus holds David against his chest as he himself staggers a few steps to another crate and sits on it. Stroking the naked soldier's back slowly and affectionately, he rumbles 'I love fucking you. And even just holding you. Best friend ever.' David raises his head from where it leaned against Brutus broad chest, reaching up to caress the demon's cheek. 'I like you too, big guy. A whole lot.' He chuckles, saying 'If someone had told me six months ago I'd be doing... this' *he rocks back on the demon's slowly softening shaft in his ass* 'I'd have told them they were bonkers. Crazy, how times change.'";
					LineBreak;
					say "     Looks like they'll stay like that for a while yet, just holding each other and being close together, so you make your exit from the scene before they might spot you after all. Moving back down into the bunker, you busy yourself with some work so it doesn't see, that you were waiting on them. Some time later, David and Brutus also come back down from above. With it having been ripped up, the young man is now shirtless and his hair is a bit dishevelled, while the large demon following him has a pretty self-satisfied grin on his face. As the two of them walk up to you, David says 'Just a lot of books, writing supplies and other useless crap, sorry. We moved them to block the back door though, that should help a bit at least to keep the building safer.' Noticing you looking at his bare chest, David's cheeks get a slight tinge of redness and he quickly says 'I caught my shirt on a crate's splintered edge and ripped it. That's all. Nothing else.' He quickly moves over to his bed, grabbing a new shirt to put on.";
				else: [female]
					say "     <Sex scene with David + cuntboy Brutus here>";
			else: [give them privacy]
				LineBreak;
				say "     Nah, you decide to let them deal with what they'll do in private, without you following them around and snooping in. Though with your curiosity still burning, almost making you go back on your choice, you start various time-consuming tasks in the bunker to distract yourself.";
				LineBreak;
				say "     Quite a while later, David and Brutus come back down from above. Interestingly, the young man is now shirtless and his hair a bit dishevelled, while the large demon following him has a pretty self-satisfied grin on his face. As the two of them walk up to you, David says 'Just a lot of books, writing supplies and other useless crap, sorry. We moved them to block the back door though, that should help a bit at least to keep the building safer.' Noticing you looking at his bare chest, David's cheeks get a slight tinge of redness and he quickly says 'I caught my shirt on a crate's splintered edge and ripped it. That's all. Nothing else.' He quickly moves over to his bed, grabbing a new shirt to put on.";
			now libido of David is 54;
		else:
			LineBreak;
			say "     Maybe it's not such a great idea after all. David might not like you arranging things, manipulating him and Brutus...";
	else if libido of David is 54 or libido of David is 55: [talking after they had sex]
		say "     As you bring your demon companion up, David gets a bit red in the face then hastily says 'Err - he was a great help in the storeroom. Too bad we didn't find anything usef-' Stopping himself, the handsome soldier bites his lip for a second, then bursts out 'Ah, what the hell - I'll just admit it - we had sex with each other. And it was awesome! Brutus is a really great guy - so big and strong, but nevertheless so gentle when it counts, and so nice even though he's a demon and...' Then suddenly his stream of words abates and he really takes in your knowing expression throughout all this in for the first time. 'Wait - why are you grinning like that? Did you... know?' As the light of realization goes on in his eyes, David continues 'You arranged it, didn't you? Thank you! Thank you for helping me get over the... demon thing... and letting me get to know him.' He throws his arms around you and gives you a hug, just holding on to you for a while and giving a happy sigh.";
		if libido of David is 55: [only talked with Brutus]
			now libido of David is 57; [both talks done]
		else:
			now libido of David is 56; [only talked with David]
	else if libido of David is 56 or libido of David is 57 or libido of David is 58 or libido of David is 59: [after having talked with David about him and Brutus having sex]
		say "     As you bring your demon companion up, David gets dreamy look in his eyes for a moment, then gives a happy little sigh and focuses back on you. 'I can't believe how much I care about Brutus. I know he was a demon but he's so nice and... gentle when he wants to be. And that body is hot - nice and tall, with those muscles and... you know.' *he does a little wave to his own crotch area and gives you a knowing nod* 'Thank you for redeeming him from his evil ways and letting me get to know him!'";
	else if libido of David is 60: [Brutus controlled to suppress urges, David does not know]
		say "     As you bring your demon companion up, David gets dreamy look in his eyes for a moment, then gives a happy little sigh and focuses back on you. 'I can't believe how much I care about Brutus. I know he was a demon but he's so nice and... gentle when he wants to be. And that body is hot - nice and tall, with those muscles and... you know.' *he does a little wave to his own crotch area and gives you a knowing nod*";
		say "     Then suddenly, a thoughtful expression crosses David's face, 'I noticed he's a little bit more closed-up and less talkative lately. Everything is alright with him, isn't it?' As you don't want to worry David with something he can't help with at the moment, you just nod, keeping Brutus problems under wraps.";
	else if libido of David is 61: [Brutus controlled to suppress urges, David does know]
		say "     As you bring your demon companion up, a mixture of love and concern spreads over David's features. His eyes get a faraway look for a moment and he bites his lips, then gives a little sigh and focuses back on you. 'I can't believe how much I care about Brutus. I know he was a demon and that there are still these urges in him frightens me, but... I really want to be close to him and can't stay away. He loves me, that I know. Just look at him when we're together.' A pleading look fills his eyes as he continues, 'But even then, there's the knowledge that the inside of his mind is twisted into knots and he's hurting - because of me. Please, there must be a way to help him get over this?!'";
	else if libido of David is 62: [Talked with Nermine about sharing Brutus with David - refused]
		say "     As you bring your demon companion up, a mixture of love and concern spreads over David's features as the dominance issue between Brutus and him rears its head. He gets a hopeful expression as you explain that Nermine might have a solution, then presses his lips together and nods as you recount the deal the jackaless offered. 'If you go that way again and maybe visit her... I'd say let him do it. Please. It's just sex, after all. I just want to be with him, together.'";
	else if libido of David is 63: [Ritual by Nermine is ready (sharing Brutus with David)]
		if companion of player is not demon brute:
			say "     As you bring your demon companion up, a mixture of love and concern spreads over David's features as the dominance issue between Brutus and him rears its head. He gets a hopeful expression as you explain that you got what should be a solution from Nermine. 'So, if I - if we - do the ritual together, he'll be bound to me too? Through the amulet? I - I can't agree to that without talking to him first. Could you please call him?' After a quick intonation of the magic words with your demontooth amulet held high, Brutus appears in a cloud of purple smoke, solidifying in his usual tall and naked form. ";
		else:
			say "     As you bring your demon companion up, a mixture of love and concern spreads over David's features as the dominance issue between Brutus and him rears its head. He gets a hopeful expression as you explain that you got the details of a binding ritual from Nermine and that should be the solution of it all. 'So, if I - if we - do the ritual together, he'll be bound to me? Through the amulet?' ";
		say "David steps over to Brutus and takes his hand, then looks up into the demon's azure eyes. He adds in a quiet tone, 'Is that what you want too? I'd never want to force you into it, make you accept another master after what you've been through in the past...' Brutus just smiles at him warmly, then lifts the young soldier off his feet in a tight embrace that ends in a long kiss. 'Do not worry, David. I'm yours already, my love. Fully, with all my heart. This will just force my body - my urges - to accept it finally. You're my man, and I would do anything for you.'";
		say "     Even before the last words of Brutus deep voice have stopped rumbling in his chest, David is kissing him again, and the two unlikely lovers make out in eager haste. Kiss after kiss is exchanged and Brutus hands grope the firm curve of David's rear as their lust flares up hotly. Between the large demon's legs, his massive pole of purple man-meat fills out more and more, soon standing out rock-hard in arousal. After being totally oblivious to the world for another minute or two, just concentrating on each other, David eventually pulls out of another long kiss and turns his head to you. 'We'll do it,' he tells you with a smile, then adds, 'Right now. I don't want to wait another moment!'";
		WaitLineBreak;
		say "     Eager to lend the two lovebirds a hand, you accept the bag of ingredients Brutus makes re-appear in a purple flash. The instructions Nermine penned down for you in her neat handwriting are pretty clear and detailed, guiding you through the steps of putting some sort of powder and different herbs into a bowl and mixing them as good as you can. The next step - 'add demonic essence' - thankfully is no problem at all, as you can simply reach out and hold your bowl up under the large demon's erect cock and catch some of the pre-cum just dripping out of his slit in a steady trickle as he makes out with his human lover. With a generous amount of the clear liquid added to the mixture, you stir it all up to form a light green paste, which is then used to paint a large pentagram on the ground, with David's bed as its center. After finally setting up a thick red candle at each point of the star, you call out to them and say the preparations are done.";
		say "     'Thank you, [if cunts of player > 0 and cocks of player is 0]Mistress[else]Master[end if], the purple demon says, then walks over to the bed with David in his arms and ignites the torches all together with a wave of his hand. Setting his human lover down on his own feet to stand beside the bed, Brutus caresses his face and says, 'Now you must take me, David. Show me that you're the master. Fill me with your seed...' Giving a lusty grunt, the demon steps into the center bit of the large pentagram himself, lying down on the bed on his back. Spreading his muscled legs and holding them open with strong hands, he gets ready to be taken by his lover. It is an unconventional position for him to be in, from their relationship up till now - but Brutus cock is hard as ever and he looks like he's really hungry for David to make him his.";
		WaitLineBreak;
		say "     His eyes locked into a shared gaze with the purple demon - his purple demon - David pulls off his clothes with eager haste, then accepts the demontooth amulet you hold out to him and lays it around his neck with shaking fingers. Naked except for the magic item and his own dog tags, the muscled soldier gets on the bed and climbs on top of Brutus, bracing himself against his broad chest as he leans forward and kisses him right on the lips. 'I love you, big guy,' you can hear him moan, followed by another deep kiss before the young soldier slides down over his otherworldly lover's tall form and gets between his legs. The scene certainly has a bit of a peculiar look to it, with the bigger of your two friends in such a submissive position on his back - but nonetheless, it feels very right at the same time, as the loving bond between them is more than obvious.";
		say "     Leaning his head down, David gives the tip of Brutus shaft a kiss, licking up a gleaming drop of pre-cum at the same time. Then he slowly works his way further down, sliding his lips along the length of the deep purple, towering pole and planting more kisses, until he eventually reaches the demon's balls and gives them several sensual licks. After that, he continues moving in the same direction, finally reaching his lover's buttocks and the prize waiting between them. David's tongue searches out the quivering muscle and presses in against it, making Brutus go from eager panting to a full out moan. 'Fuck me, my David,' he grunts in a deep voice right after, his long tail moving to wrap around his human's hips and pull him closer.";
		WaitLineBreak;
		say "     With such an obvious invitation, David doesn't hesitate any longer and moves into position to give his man what he wants right away. The human's erect manhood gets aligned with Brutus waiting hole, then presses in against it, stretching the demon's rear passage around his girth. The two of them moan in unison as David bottoms out with a deep thrust and his balls hit Brutus ass with a satisfying swat. Then the human pulls back and does it again - and again - and again, pounding into his lover as he bellows to take him ever deeper and faster, really enjoying the hard ride he's getting right now. At the same time, Brutus tail rubs up against David's body and snakes between his legs, seeing out the opening that has more typically been the one penetrated in their couplings.";
		say "     On the next pull back by David, his lover's spaded tail-tip is aligned just the right way to penetrate the human's opening, sinking into him and wiggling against David's inner walls. The man takes the fact that he's getting fucked even as he fucks Brutus in stride, the smile on his face never wavering, just getting wider as he moans at the top of his voice. The demon and human couple grind against each other on the bed, rapidly approaching a mutual orgasm, and then - with a bellowing roar from Brutus, they reach their climax. Brutus purple shaft blasts an obscene amount of slightly steaming demon cum high up into the air - so high in fact, that it hits the ceiling with a splat before raining back down on him and David in a wet drizzle. And at the same time, David's shaft pulses deep in his beloved demon's hole, painting it white and marking the big brute as his. The two of them twitch and gasp as their bodies gush forth with everything they have, until David finally sinks down to rest his head against Brutus cum-splattered pecs.";
		WaitLineBreak;
		say "     'I accept you as my master,' the demon grunts, lovingly patting David's head, and suddenly a bright light starts to shine between them. Surprised, David whips upright again and looks down, to see that the amulet around his neck is the source of the sudden light show. The brightness fades rapidly as the sticky film of cum all over the pointy tooth is rapidly absorbed by it - though that's not the only thing that it absorbed. Once it's no longer painful to look at, you can make out that a band of metal now rings the tooth like a socket and that one of the two tags around David's neck is missing from its chain. Pulling the amulet off, David studies it with tears of joy in his eyes, then throws it to you with the comment, 'Look! I think it worked.' As David moves to kiss Brutus on the lips and make out with him, you inspect the new addition to your amulet and see that the metal ring has an inscription - 'David Jackson', the stenciled letters of his former dog tag perfectly arranged to fit.";
		say "     The two lover's make out session goes on and on, as they can't wait to share their lust and affection with each other, but eventually David has to take a breather and uses that time to ask, 'How do you feel now, Brutus?' The large demon smiles as he caresses his human's face and replies, 'Free. No more urges to dominate you like a pet. Although I still want to fuck you every chance I get...' He slides a large hand down David's back and cups his butt, then adds with a chuckle, 'Who could say no to this, after all? I can't wait to fill you up again soon.' They start kissing again after that, caressing and whispering to each other, so you decide to leave them some privacy now and saunter off, happy that your two friends finally can be together without any issues.";
		now libido of David is 68;
		if BrutusEscalationTimer > 0:
			now BrutusEscalationTimer is 0;
	else if libido of David is 64: [Talked with Lilith about sharing Brutus with David - refused]
		say "     As you bring your demon companion up, a mixture of love and concern spreads over David's features as the dominance issue between Brutus and him rears its head. He gets a hopeful expression as you explain that Lilith might have a solution, then presses his lips together as you recount what she demanded of him in return. 'I - no, I couldn't live with it if... if he had to doom another to a fate as a succubus's plaything. Please find another way - at least this gives me hope that there must be a solution.'";
	else if libido of David is 65: [Talked with Lilith about sharing Brutus with David - freed Liam]
		say "     As you bring your demon companion up, a mixture of love and concern spreads over David's features as the dominance issue between Brutus and him rears its head. He gets a hopeful expression as you explain that Lilith might have a solution, then presses his lips together as you recount what she demanded of him in return. David opens his mouth as if to say something about it, but falls silent as you proceed to tell him what Brutus did next. Nodding and giving a slightly forced smile, he says, 'Well, at least the succubus's victim got away. Too bad he got frightened by Brutus. Not that I acted much different, back when...'";
	else if libido of David is 66: [Ritual by Lilith is ready (sharing Brutus with David)]
		if companion of player is not demon brute:
			say "     As you bring your demon companion up, a mixture of love and concern spreads over David's features as the dominance issue between Brutus and him rears its head. He gets a hopeful expression as you explain that you got what should be a solution from Lilith. 'So, if I - if we - do the ritual together, he'll be bound to me too? Through the amulet? I - I can't agree to that without talking to him first. Could you please call him?' After a quick intonation of the magic words with your demontooth amulet held high, Brutus appears in a cloud of purple smoke, solidifying in his usual tall and naked form. ";
		else:
			say "     As you bring your demon companion up, a mixture of love and concern spreads over David's features as the dominance issue between Brutus and him rears its head. He gets a hopeful expression as you explain that you got the details of a binding ritual from Lilith and that should be the solution of it all. 'So, if I - if we - do the ritual together, he'll be bound to me? Through the amulet?' ";
		say "David steps over to Brutus and takes his hand, then looks up into the demon's azure eyes. He adds in a quiet tone, 'Is that what you want too? I'd never want to force you into it, make you accept another master after what you've been through in the past...' Brutus just smiles at him warmly, then lifts the young soldier off his feet in a tight embrace that ends in a long kiss. 'Do not worry, David. I'm yours already, my love. Fully, with all my heart. This will just force my body - my urges - to accept it finally. You're my man, and I would do anything for you.'";
		say "     Even before the last words of Brutus deep voice have stopped rumbling in his chest, David is kissing him again, and the two unlikely lovers make out in eager haste. Kiss after kiss is exchanged and Brutus hands grope the firm curve of David's rear as their lust flares up hotly. Between the large demon's legs, his massive pole of purple man-meat fills out more and more, soon standing out rock-hard in arousal. After being totally oblivious to the world for another minute or two, just concentrating on each other, David eventually pulls out of another long kiss and turns his head to you. 'We'll do it,' he tells you with a smile, then adds, 'Right now. I don't want to wait another moment!'";
		WaitLineBreak;
		say "     Eager to lend the two lovebirds a hand, you accept the bag of ingredients Brutus makes re-appear in a purple flash. The instructions Lilith scrawled down for you on the scrap of paper are pretty clear, if totally laden with profanities and curses, a sign of her displeasure at how Brutus dealt with Liam. Nevertheless, they serve to guide you through the steps of putting some sort of powder and different herbs into a bowl and mixing them as good as you can. The next step - 'mix with the purple fucking dim-bulb's cum' - thankfully is no problem at all, as you can simply reach out and hold your bowl up under the large demon's erect cock and catch some of the pre-cum just dripping out of his slit in a steady trickle as he makes out with his human lover. With a generous amount of the clear liquid added to the mixture, you stir it all up to form a light green paste, which is then used to paint a large pentagram on the ground, with David's bed as its center. After finally setting up a thick red candle at each point of the star, you call out to them and say the preparations are done.";
		say "     'Thank you, [if cunts of player > 0 and cocks of player is 0]Mistress[else]Master[end if], the purple demon says, then walks over to the bed with David in his arms and ignites the torches all together with a wave of his hand. Setting his human lover down on his own feet to stand beside the bed, Brutus caresses his face and says, 'Now you must take me, David. Show me that you're the master. Fill me with your seed...' Giving a lusty grunt, the demon steps into the center bit of the large pentagram himself, lying down on the bed on his back. Spreading his muscled legs and holding them open with strong hands, he gets ready to be taken by his lover. It is an unconventional position for him to be in, from their relationship up till now - but Brutus cock is hard as ever and he looks like he's really hungry for David to make him his.";
		WaitLineBreak;
		say "     His eyes locked into a shared gaze with the purple demon - his purple demon - David pulls off his clothes with eager haste, then accepts the demontooth amulet you hold out to him and lays it around his neck with shaking fingers. Naked except for the magic item and his own dog tags, the muscled soldier gets on the bed and climbs on top of Brutus, bracing himself against his broad chest as he leans forward and kisses him right on the lips. 'I love you, big guy,' you can hear him moan, followed by another deep kiss before the young soldier slides down over his otherworldly lover's tall form and gets between his legs. The scene certainly has a bit of a peculiar look to it, with the bigger of your two friends in such a submissive position on his back - but nonetheless, it feels very right at the same time, as the loving bond between them is more than obvious.";
		say "     Leaning his head down, David gives the tip of Brutus shaft a kiss, licking up a gleaming drop of pre-cum at the same time. Then he slowly works his way further down, sliding his lips along the length of the deep purple, towering pole and planting more kisses, until he eventually reaches the demon's balls and gives them several sensual licks. After that, he continues moving in the same direction, finally reaching his lover's buttocks and the prize waiting between them. David's tongue searches out the quivering muscle and presses in against it, making Brutus go from eager panting to a full out moan. 'Fuck me, my David,' he grunts in a deep voice right after, his long tail moving to wrap around his human's hips and pull him closer.";
		WaitLineBreak;
		say "     With such an obvious invitation, David doesn't hesitate any longer and moves into position to give his man what he wants right away. The human's erect manhood gets aligned with Brutus waiting hole, then presses in against it, stretching the demon's rear passage around his girth. The two of them moan in unison as David bottoms out with a deep thrust and his balls hit Brutus ass with a satisfying swat. Then the human pulls back and does it again - and again - and again, pounding into his lover as he bellows to take him ever deeper and faster, really enjoying the hard ride he's getting right now. At the same time, Brutus tail rubs up against David's body and snakes between his legs, seeing out the opening that has more typically been the one penetrated in their couplings.";
		say "     On the next pull back by David, his lover's spaded tail-tip is aligned just the right way to penetrate the human's opening, sinking into him and wiggling against David's inner walls. The man takes the fact that he's getting fucked even as he fucks Brutus in stride, the smile on his face never wavering, just getting wider as he moans at the top of his voice. The demon and human couple grind against each other on the bed, rapidly approaching a mutual orgasm, and then - with a bellowing roar from Brutus, they reach their climax. Brutus purple shaft blasts an obscene amount of slightly steaming demon cum high up into the air - so high in fact, that it hits the ceiling with a splat before raining back down on him and David in a wet drizzle. And at the same time, David's shaft pulses deep in his beloved demon's hole, painting it white and marking the big brute as his. The two of them twitch and gasp as their bodies gush forth with everything they have, until David finally sinks down to rest his head against Brutus cum-splattered pecs.";
		WaitLineBreak;
		say "     'I accept you as my master,' the demon grunts, lovingly patting David's head, and suddenly a bright light starts to shine between them. Surprised, David whips upright again and looks down, to see that the amulet around his neck is the source of the sudden light show. The brightness fades rapidly as the sticky film of cum all over the pointy tooth is rapidly absorbed by it - though that's not the only thing that it absorbed. Once it's no longer painful to look at, you can make out that a band of metal now rings the tooth like a socket and that one of the two tags around David's neck is missing from its chain. Pulling the amulet off, David studies it with tears of joy in his eyes, then throws it to you with the comment, 'Look! I think it worked.' As David moves to kiss Brutus on the lips and make out with him, you inspect the new addition to your amulet and see that the metal ring has an inscription - 'David Jackson', the stenciled letters of his former dog tag perfectly arranged to fit.";
		say "     The two lover's make out session goes on and on, as they can't wait to share their lust and affection with each other, but eventually David has to take a breather and uses that time to ask, 'How do you feel now, Brutus?' The large demon smiles as he caresses his human's face and replies, 'Free. No more urges to dominate you like a pet. Although I still want to fuck you every chance I get...' He slides a large hand down David's back and cups his butt, then adds with a chuckle, 'Who could say no to this, after all? I can't wait to fill you up again soon.' They start kissing again after that, caressing and whispering to each other, so you decide to leave them some privacy now and saunter off, happy that your two friends finally can be together without any issues.";
		now libido of David is 68;
		if BrutusEscalationTimer > 0:
			now BrutusEscalationTimer is 0;
	else if libido of David is 67: [refused both Lilith and Nermine]
		say "     As you bring your demon companion up, a mixture of love and concern spreads over David's features as the dominance issue between Brutus and him rears its head. He gets a hopeful expression as you explain that either Lilith or Nermine might have a solution, then presses his lips together as you recount each of their demands in return. David opens his mouth as if to say something about it, but falls silent as you proceed to tell him what Brutus did next. 'If you go that way again and maybe visit Nermine... I'd say let him do it. Please. It's just sex, after all. I just want to be with him, together.' His expression darkens as he adds, 'As for Lilith - what a vile bitch! Let her rot in that ruin. Or better yet, maybe save Liam from her...";
	else if libido of David is 68: [David and Brutus are tied together now - happy couple]
		say "     As you bring your demon companion up, a happy grin spreads over David's features and he gives your shoulder a pat in camaraderie. 'I can't thank you enough for... well, you set it all up, didn't you? Rescuing me, rescuing Brutus, giving us the opportunity to meet, hah - to fuck even. And now this. I - I can feel where he is now, you know. Or at least where the amulet is. Always. And I know in my heart that he'll always be there for me.'";
	else if libido of David is 82: [Brutus fucked David before under his dominant urges]
		say "     As you bring your demon companion up, a flush spreads over David's face and he says, 'I love the big brute. The sex just takes your breath away. I know he can be a bit rough at times, but I... don't mind. He makes me feel soo good.' There may be a smile on David's face and his breathing gets quicker as he gets aroused from speaking about his demon lover, but you heard the little pause he made when talking about getting fucked roughly.";
		let bonus be (( the Charisma of the player minus 10 ) divided by 2);
		let diceroll be a random number from 1 to 20;
		increase diceroll by bonus;
		say "You roll 1d20([diceroll])+[bonus]: [diceroll + bonus] (Charisma-Check)";
		if diceroll > 14:
			say "     With some carefully chosen words, you get David to open up fully. His smile becomes a little brittle as he says, 'I don't know. Part of me says that it's not okay that he just 'uses' me sometimes, just grabs me and goes for it, but... I remember asking for it, wanting everything just like it happened.' For a second, David is hesitant, even a bit confused, then he settles down into a more firm, 'I simply know that I need Brutus cock inside me. It's hard to describe...'";
			LineBreak;
			say "     Hmm... that does sound a bit ominous.";
			say "     [bold type]Do you want to tell David that you think he's beginning to be controlled? Letting those urges out clearly awakened a dark side in Brutus.[roman type][line break]";
			LineBreak;
			say "     ([link]Y[as]y[end link]) - Yes.";
			say "     ([link]N[as]n[end link]) - No.";
			if player consents:
				say "     Taking David by the shoulders and giving him a slight shake, you tell him to listen to what he just said and explain your suspicions about the dark urges of domination the demon still seems to harbor. The young man is taken aback, more than a little shocked at this revelation, then looks aside for a moment to think about what you just told him. After a quiet moment, he swallows visibly, then focuses on you and says, 'I - I know that is not the real him. He's fighting it, and it just... got out this time. No. I will stand by him. Help Brutus through this. Let him know that I love him, no matter what.' A brave decision, knowing David's history with that other demon - but then, you didn't expect otherwise from the man you know him to be.";
				say "     Shortly afterwards, the soldier comes to stand in front of his large demonic friend, stares directly into his eyes and gives him the same words, resolute in his decision. Brutus is left gobsmacked as the fear of losing David over all of this crumbles before the open affection shown by this human, his human, and he snatches the soldier up in a tight embrace. Since you don't want to risk a recurrence of the scene before, you have little choice but to expressly forbid Brutus from acting on those impulses. As you do so, the amulet glows briefly in purple light and gets noticeably warm for a second. You can feel a tingle run down your spine as the controlling magic snaps tight around Brutus mind, straining to enforce your ruling. Something tells you the constant resistance of his deep-seated urges will put greater wear on it than all the random outbursts and flare-ups to escape by the original, evil Brutus.";
				LineBreak;
				say "     So... now there at least are no secrets between them - but you still have to solve the underlying problem. Some sort of specialist in demonic matters and/or interspecies breeding should be able to help, hopefully.";
				now libido of David is 61; [controlled, David knows]
		else:
			say "     You try to get David to open up, but he just evades your questions. There is a clear undertone of something being hidden from you - or maybe from himself, but for now, you're not getting any further. You'll have to try again later if you really want to know.";
	else if libido of David > 82 and libido of David < 85: [Brutus fucked David multiple times under his dominant urges]
		say "     As you bring your demon companion up, a flush spreads over David's face and he says, 'I love the big brute. The sex just takes your breath away. I know he can be a bit rough at times, but I... don't mind. He makes me feel soo good. It's all as it should be.' His breathing gets quicker as he gets aroused from speaking about his demon lover, and you can see David's hand slide under the band of his pants at the back, no doubt to finger himself. Seems he really, really got into submissive fun with Brutus.";
	else if libido of David is 85:
		say "     As you bring your demon companion up and say that he wants to do a ritual with David, the human soldier hesitates just a second, then smiles broadly and says, 'Really? That sounds like a pretty sweet deal! I love the big brute, so being closer and connected is of course something I wanna do. The sex just takes your breath away. I know he can be a bit rough at times, but I... don't mind. He makes me feel soo good. It's all as it should be.' His breathing gets quicker as he gets aroused from speaking about his demon lover, and you can see David's hand slide under the band of his pants at the back, no doubt to finger himself. Seems he really, really got into submissive fun with Brutus.";

to say DavidTalk5: [trip to the beach]
	say "     As you suggest the destination, David nods to you and says, 'The beach? And there's a safe area there? Great idea, some nice time with sand and the sea will be good for all of us.' [if companion of player is demon Brute]You call over Brutus[else]You pull out your demontooth amulet, speak the magic word to summon Brutus[end if] and tell your demon companion that the three of you will take a trip together, to show him what he's been missing out on all this time. 'Thank you,' the purple giant says, looking from you to the young soldier with a happy expression on his face, showing many sharp teeth in a wide smile. After David goes to his bed to grab a few things and puts them in his backpack, you're off, taking the stairs up to the library and exiting out the front doors.";
	if daytimer is day: [sunshine]
		say "     It is an oddly peaceful day out in the city, with barely anyone out on the streets or keeping to themselves if they are - almost as if fate decided to help out a bit for your trip, arranging for undisturbed passage along your chosen route. Before long, your little group arrives at the Beach Plaza. It spreads out before you, surprisingly clean and well kept as it is, in a sunny day scene that might have played out before all the crazy things happened - well, if one ignores that virtually everyone you see isn't human anymore. From the street vendor leaning against a nearby wall to the people lounging around or bathing, there is a wild mixture of fur, scale and feathers being shown, with only perhaps two or three at least still human-looking persons in the mix. The sun shines brightly down on all of it, bathing the whole area in a comfortably warm glow.";
		WaitLineBreak;
		say "     Taking a deep breath of the salty sea air, David moves forward onto the plaza, only to stop after a few steps as he notices Brutus isn't behind him anymore. As it turns out, the big purple brute stopped at the beach-side chapel fronting onto the plaza, hesitantly resting a clawed hand on its wall - it seems to be almost in reverence. David joins him a short moment later, touching the demon's side gently as he asks, 'What is it, big guy? Bad memories?' Brutus shakes his head slowly and replies in his deep voice, 'No. A Good one. This is where the [if cunts of player > 0 and cocks of player is 0]mistress[else]master[end if] extinguished the fire, the burning, inside me. It hurt, but it set me free.' Turning his head from the building, he looks down at the soldier standing next to him, then lays a large hand over the one David still has against his side and continues, 'Thank you for asking.'";
		say "     After a few moments more, David says, 'Come on, let's enjoy ourselves for a while...' He leads Brutus over to the nearby armadillo street vendor with the sign 'Beach Gear Rental' and chats with the guy, haggling a bit to get towels, sunscreen and swim-gear for the three of you in exchange for a can of beans and a power bar. Newly equipped with full beach bags, you then walk down the shallow steps to the beach itself. Brutus seems surprised at first at the large number of people already there, peacefully enjoying the sun and sand with each other. With the very diverse group of beach-goers, even the demon's towering stature draws only few looks, although the orca lifeguard gives him a longer moment of attention before nodding and turning back to watching out over everyone all around.";
		WaitLineBreak;
		say "     Walking over to a free spot on the warm sand, David instructs Brutus on spreading out the big beach towels he rented, then the three of you plant yourselves on them. Brutus sits still for a moment, looking slightly lost on such an everyday human thing like free time and enjoying yourself, then he looks left and right at you and David saying, 'And... now?'";
		LineBreak;
		say "     Which beach-side activities do you recommend? Should Brutus just sunbathe (including getting oiled up with sunscreen by David) [link](1)[as]1[end link], maybe go take a dip in the sea (learn swimming from David) [link](2)[as]2[end link], or the three of you could join a game of volleyball going on not too far away [link](3)[as]3[end link].[line break]";
		now calcnumber is 0;
		while calcnumber < 1 or calcnumber > 3:
			say "Choice? (1-3)>[run paragraph on]";
			get a number;
			if calcnumber is 1 or calcnumber is 2 or calcnumber is 3:
				break;
			else:
				say "Invalid choice. Type [link]1[end link] for sunbathing, [link]2[end link] for swimming or [link]3[end link] for volleyball.";
		if calcnumber is 1: [sunbathing]
			LineBreak;
			say "     You tell Brutus to just relax and lie back, enjoying the sun on his skin and the sounds of the beach. As the large demon does so, stretching out on his belly on the towel, David adds, 'Oh, and we really should put some sunscreen on you - that's important so you don't burn your skin.' Although you strongly suspect that Brutus won't need any protection in that regard, you think 'better safe than sorry' to yourself - and judging from the eager expression on David's face, he's been looking forward to this since you left the library anyways. From a comfortable prone position on your own towel, you watch as the young man pulls off his uniform shirt, pants and undies, quickly followed by him pulling a pair of tight, brightly colored speedos up to his hips. Then the soldier saunters over to Brutus, sunscreen-bottle in hand and straddles his friend's lower back, just above the tail.";
			WaitLineBreak;
			say "     Accompanied by low squirting noises, David puts sunscreen on his hands, rubbing them together to warm it up before he starts to apply it to Brutus broad back. He starts at Brutus neck and runs both hands down along the muscled brute's spine, then up again closer to his sides and over the shoulder blades. Then David returns to the neck area, kneading the demon's strong muscles as he works him over massaging in the milky lotion he spread all over him. Brutus face isn't turned towards you so you can't see his expression at being taken care of like this, but the sounds he makes speak volumes - content groans at David's massage, intermixed with low groans that you recognize as growing arousal.";
			say "     After spending quite a while on the purple giant's back, putting some real effort into giving Brutus a good massage, he grabs the bottle again and proceeds to rub more all over his friend's arms, with his fingers working over every curve of the bulging muscles there. Then David moves on to Brutus head, spreading more protective lotion on his upper neck and the hairless pate of his head. As the young man's stroking fingers brush against the base of Brutus horns, the demon gives an aroused groan and pants, 'Yeah, that... that's good.' Smiling at having found another sensitive spot on the big demon, David gives Brutus horns some extra attention as he continues to rub in the remaining lotion.";
			WaitLineBreak;
			if DemonBruteStatus < 2: [Brutus has a cock]
				say "     Finally finishing up with the sunscreen, David leans forward to give Brutus a little kiss on the cheek and whispers 'my turn' in his ear. The young man sets down the sunscreen-bottle next to Brutus hand and quickly lies down on his own towel, closing his eyes in eager anticipation of feeling the big Brute's hands on his skin. Meanwhile, Brutus starts getting up from where he was lying, which gives you ample opportunity to see the very erect state of his manhood as it literally drips precum all over his towel. Bottle in hand, the big brute then proceeds to imitate David, rubbing and massaging the lotion into his back, arms and legs, all the while taking exquisite care not to scratch David with his claws.";
				say "     Soon, as those big hands move lower and lower to rub the small of David's back, the thick shaft of Brutus dangling erection brushes against the young soldier's leg, prompting him to look back and see the state his friend is in. After only a second of hesitation, the human pants, 'Maybe I should go for a line-less tan this time. Could you... pull those swimming briefs off me and rub in a bit more sunscreen? Don't want to burn my ass.' 'Of course, David' comes the deeply voiced reply from Brutus, who carefully peels the small piece of stretchy fabric off his friend, then puts some lotion on his pale-skinned butt.";
				WaitLineBreak;
				say "     David groans in pleasure as large hands squeeze his buttcheeks, then pants over his shoulder, 'Don't forget the crack in between. You've got to really rub it in everywhere...' One quick squirt of the bottle later, there is quite a bit of sun-lotion between David's buttcheeks, at which point Brutus moves to kneel over him and uses his thick shaft to spread the lotion around, getting it wet and slippery all along its length. He leans over his human lover and gives his neck a kiss, then grunts in a deep voice full of lust and need, 'Are you ready?' - to which David answers, 'Yeah, fuck me!' Not losing one moment, Brutus lines up his erection with David's hole, then moves forward.";
				say "     His massive member slowly increases its pressure against David's asshole until the head pushes open his pucker, stretching it wide as he enters the soldier's body with his hard shaft. Knowing how big your infernal companion's manhood his, you're not surprised at all to hear David gasp from the initial penetration. But then, as it sinks deeper into his body, pleasant feelings prevail as the bumps on Brutus's shaft rub his inner walls. Even as eager and relaxed as David is, it's still quite a lot to take. Thankfully, Brutus seems to know what very well, only slowly moving deeper and often stopping to just hold David so he can get used to it. Finally he bottoms out inside the human, hard shaft buried all the way and his two large cum-factories resting against his skin. Panting deeply, Brutus leans forward to find David's lips and they share kiss after kiss. It's pretty amazing if one thinks about it - this huge, muscular creature who was a ravening beast not too long ago, now together with a human lover on a public beach, being as gentle as he can be with his equipment.";
				WaitLineBreak;
				say "     A few minutes of making out with Brutus later, David tells him to continue - slowly. Moving in and out, the bumps on Brutus's cock rub against David's stretched insides, making him shudder with rising lust. From the looks of it, it becomes easier to have Brutus inside over time, with the demon leaking more and more precum and David's muscles being stretched out and getting used to it. All of which allows your infernal companion to speed up his thrusts, going faster and faster, the slapping noises of his balls against David's hips now coming in rapid succession. Soon, this drives the human's arousal over the edge and with a loud moan, his cock sprays cum over the beach towel under him.";
				say "     Obviously very pleased at getting his friend off, and with David's asshole twitching around his cock as he orgasms, Brutus joins the young soldier in climax just moments later. With a satisfied roar, he slams his massive cock all the way into David and begins to pump his bowels full of his demonic seed. Easily filling David's asshole and intestines, the remaining cum starts squirting out around the demon's thick cock as he thrusts into him a few more times. As he finally removes his cock with a loud *pop*, David's stomach looks distended from the sheer amount of cum that was injected into him, with more of it leaking from his hole to soak into the towel.";
				WaitLineBreak;
				say "     'That was great. Thanks, baby.' Brutus rumbles to David and gives him a quick kiss, then pulls his own towel right up against David's an lies beside him, one arm still draped over the human's back. Well-sated sexually now, they stay like that for some time, soaking up the sun while they continue to silently talk and whisper to each other, until then eventually doze off.";
				say "     Some time later, it's time to go and you wake the two sleeping lovebirds and pack up all the towels and gear with their help. As soon as that's done, you make your way back to the rental guy and drop everything off with him, then turn your steps towards one of the roads leading away from the beachfront plaza. As you pass the chapel again, David says, 'It's nice on the beach, isn't it? Did you have fun today Brutus?' The demon gives the promenade and ocean a last look before he replies, 'Yes, a lot. Thank you both for bringing me here. Maybe we could return sometime?'";
			else: [no cock on Brutus]
				say "     Finally finishing up with the sunscreen, David leans forward to give Brutus a little kiss on the cheek and whispers 'my turn' in his ear. The young man sets down the sunscreen-bottle next to Brutus hand and quickly lies down on his own towel, closing his eyes in eager anticipation of feeling the big Brute's hands on his skin. Meanwhile, Brutus starts getting up from where he was lying, which gives you ample opportunity to see the very aroused state of his pussy as it literally drips femcum all over the towel. Bottle in hand, the big brute then proceeds to imitate David rubbing and massaging the lotion into his back, all the while taking exquisite care not to scratch David with his claws.";
				say "     Soon, as those big hands move lower and lower to rub the small of David's back, Brutus wet and swollen pussy drips some of its juices on the young soldier's leg, prompting him to look back and see the state his friend is in. After only a second of hesitation, the human pants, 'Maybe I should go for a line-less tan this time. Could you... pull those swimming briefs off? And... better put some lotion on my crotch too, it's pretty white yet.' 'Of course, David' comes the deeply voiced reply from Brutus, who carefully peels the small piece of stretchy fabric off his friend, then watches David turn around, revealing his own erect shaft.";
				WaitLineBreak;
				say "     David groans in pleasure as the demon's large hands start to spread sun cream on his front, rubbing over his abs and massaging it into his matted pubic hair. He pants, 'Don't forget my cock please - that's one place I don't want a sunburn on. Get it covered really well...' One quick squirt of the bottle later, there is quite a bit of sun-lotion on David's erection, and after a few jerks, Brutus moves to kneel over him. Holding his human lover's slick manhood up, he then lowers himself down on his pole, groaning in lust as it spreads his nether lips apart and slides into him. Your demonic companion sinks down on David's shaft until it's all the way inside him, then leans down and gives the man a lusty kiss, stroking his hair as their tongues wrestle. It's pretty amazing if one thinks about it - this huge, muscular creature who was a ravening beast not too long ago, now together with a human lover on a public beach, kissing him eagerly while riding his cock. Times sure have changed for Brutus...";
				say "     After a few moments of sharing hungry kisses, Brutus starts rocking his hips, sliding up and down on David's shaft and making it rub his inner walls. But David isn't just a passive partner either - gripping Brutus muscular legs with both hands, he thrusts up into the demon's pussy hard meeting his groin with a slap. Judging from the pleased grunt at that, it seems like your demon companion likes it a bit rough. And David is only too eager to oblige, as he starts to thrust in and out quickly, slamming back into him hard again and again. Groans and grunts from the two lovers draw the attention from almost everyone nearby - and neither of them care one bit about it. Brutus just has his head lair back, moaning and bellowing as David rubs his sensitive spots, while his human partner is murmuring half to himself, 'Yeah... So tight... fucking a demon's pussy on the beach... You're... amazing Brutus...'";
				WaitLineBreak;
				say "     Interestingly, the demon brute is the first one to come from their coupling, his moans first getting deeper and louder, then turning into lust-filled roars as he bucks against David and femcum starts gushing out of his vagina. It lubricates the young soldier's thrusting shaft even more and starts running down between his legs, over his pucker and soaking the towel below. Feeling the muscles in Brutus vagina twitch around his cock, David's arousal mounts very quickly and after just a few more thrusts, he joins your companion in orgasm. With a deep gasp, David slams into him one last time, his shaft buried as deeply as possible inside Brutus pussy as it starts unloading spurt after spurt of his seed.";
				say "     Obviously very pleased at getting his friend off, Brutus stays on top of David for some moments longer and leans down to plant a kiss on his lips. When he eventually moves to get up, the demon puts a hand on his pussy to keep his lover's cum from gushing out, then lies down next to him on his back. One arm stretched to hold David against his side, the two of them stay like that for some time, soaking up the sun while they continue to silently talk and whisper to each other, until then eventually doze off.";
				WaitLineBreak;
				say "     Some time later, it's time to go and you wake the two sleeping lovebirds and pack up all the towels and gear with their help. As soon as that's done, you make your way back to the rental guy and drop everything off with him, then turn your steps towards one of the roads leading away from the beachfront plaza. As you pass the chapel again, David says, 'It's nice on the beach, isn't it? Did you have fun today Brutus?' The demon gives the promenade and ocean a last look before he replies, 'Yes, a lot. Thank you both for bringing me here. Maybe we could return sometime?'";
		if calcnumber is 2: [swimming]
			say "     You suggest that Brutus take a dip in the ocean and swim a bit, to which the demon sheepishly replies in his deep voice, 'I can't swim, master. Water... boils, where I come from. It hurts and unless when being punished, you never touch it.' The large demon's tail whips from left to right in frustration, looking out at the wide open sea with a sullen expression at missing out. His attention is drawn to the side as a hand suddenly touches his arm, it's David who gives him a friendly smile and says, 'No problem, big guy. I'll teach you.' With that, David pulls off his shirt and throws it on his towel, then bends over to dig out a brightly colored speedo from his rented beach bag. Hooking his thumbs under the band of both his pants and undies, the young man then quickly pushes them down his legs, followed by pulling the speedo up to his hips.";
			say "     As David turns back around, he chuckles at the fact that Brutus gaze is still down at his crotch from watching him, then waves for the demon to follow him and says, 'Come on, you'll love it, I'm sure.' Deciding on getting some refreshment yourself - and curious on how this will turn out in the end too, you hurriedly get your own gear on and follow them soon after, walking down towards the surf. It's almost comical to see the large demon brute gingerly step forward onto the wet sand, then start to draw back reflexively and stop himself as a wave washes over his feet. 'It's... cool. Nice.' Brutus mumbles to himself, and David puts a hand on his larger one to pull him forward, walking into the slowly deepening water.";
			WaitLineBreak;
			say "     The two of them, and you following, move out into the ocean, up to a point where the water his about chest high for the young soldier and just barely waist-high for the demon. Choosing that spot for his swimming lessons, David tells Brutus to get down in the water and lay on it lengthwise. 'Just relax,' the young man tells the demon, 'I'll hold you up as you try out some moves.' Brutus does as he is told and David indeed manages to keep him afloat, helped by the buoyancy the salty water gives his friend. What follows are pretty basic lessons about floating and swimming and the demon's early tries for doing the breast stroke and crawl stroke.";
			if DemonBruteStatus < 2: [Brutus has a cock]
				say "     It's sweet to watch David explain things patiently to his large friend, but in the end, not all that interesting, so you think about going for a swim further out alone... until suddenly a larger wave comes along, sloshing over David and his demonic trainee and momentarily panicking Brutus. The fact that he can easily stand here is forgotten in that moment and the demon brute fidgets anxiously, requiring David to move his hands in an attempt to keep him afloat. Then, from one moment to the next, the demon stops struggling and is calm again. The thought what could have distracted Brutus out of his floundering isn't even fully formed when you already see the explanation - as the purple brute puts his feet on the ground to stand up in the water, revealing that David's hand is wrapped around the towering shaft of his manhood.";
				WaitLineBreak;
				say "     Seems like a first accidental contact awakened their lust for each other, letting both of them forget about any swimming lessons or the like with a flare-up of arousal. There is a moment of realization as their eyes drop down on David's hand and Brutus erect shaft, then move to each other's face - until Brutus just sweeps David up out of the water, drawing him against his chest to give him a hungry kiss. They embrace each other and make out for a bit before Brutus soon gives the breathless grunt, 'I want to fuck you. Hard. Now.' David simply moans, 'Yeeessss...' as loud as he can, panting eagerly as Brutus hands move down to cup both his asscheeks and lift him higher.";
				say "     Holding the young soldier with one strong hand, Brutus grabs his mighty shaft and lines it up with his lover's asshole while pulling his speedo aside. Then he lowers David till his cockhead touches the man's pucker. Slowly, slowly, he increases the pressure on his friend bit by tiny bit, until David's opening finally yields and allows him entrance. Brutus really has one big cock, and it's somewhat awe-inspiring and alarming at the same time to see him push into a human and stretch his back door so wide around his shaft. Thankfully, your infernal companion knows just how large his manhood his and he keeps things slow, stopping entirely for a moment each time he hears David gasp from the penetration. But as it sinks deeper into the young man's body, pleasant feelings prevail when the bumps on Brutus's shaft rub David's inner walls. Finally he bottoms out inside the young soldier, his huge dick buried all the way in and his two heavy balls pressing against his skin. Groaning deeply, Brutus leans forward to find David's lips and hungrily extends his long tongue into the human's mouth. It is quite the sight, especially if one thinks about it - this huge creature of pure muscle who was a ravening beast not too long ago, taking great pleasure in having sex with a much smaller human lover, being as gentle as he can be with his equipment.";
				WaitLineBreak;
				say "     After finishing their heavy make-out session, David breathlessly begs Brutus to begin fucking. The demon begins with slow motions, lifting and pushing David up and down on his purple shaft, the bumps on Brutus's cock rub against the soldier's stretched insides, making him shudder with rising lust. As David's moans become more audibly pleasurable, he's clearly gotten used to have Brutus deep inside him over time, with the demon leaking more and more precum and David's muscles being stretched out and getting used to it. All of which allows your infernal companion to speed up his thrusts, going faster and faster, the slapping noises of his balls against David's hips now coming in rapid succession, each slap eliciting a heavy growl from Brutus, and sometimes a barely audible gasp of 'so good' or 'so tight' from behind his clenched teeth. Soon, this drives the human's arousal over the edge, crying out 'oh fuck!' as his cock sprays cum all over Brutus and his own chest.";
				say "     Overwhelmed with euphoria at getting his friend to climax, and with David's asshole twitching around his cock as he orgasms, Brutus pounds the young soldier at a feverish pace, shouting 'I'm gonna cum!' in a loud growl, and reaches his peak a few quick thrusts later. With a mighty roar, he slams his massive cock all the way into David and begins to pump his bowels full of his demonic seed, every muscle in Brutus' body tensing with each spurt. Easily filling David's asshole and intestines, the remaining cum starts flowing out around the demon's thick cock as he finishes his last quick thrusts. As Brutus' thick cock is pulled out of the human's ass with a loud *pop*, David's stomach looks bloated from the sheer amount of demon seed that was pumped into him, with more of it leaking from his hole to drip into the sea.";
				WaitLineBreak;
				say "     'Thank you my friend. I needed that badly.' Brutus breathlessly growls to David and gives him a quick kiss, then just keeps holding him against his chest and starts walking to the shore. Soon after, the two unlikely lovebirds are lying side by side on their beach towels, soaking up the sun and drying out while they continue to silently talk and whisper to each other, until then eventually doze off.";
				say "     Some time later, it's time to go and you wake the two sleeping lovebirds and pack up all the towels and gear with their help. As soon as that's done, you make your way back to the rental guy and drop everything off with him, then turn your steps towards one of the roads leading away from the beachfront plaza. As you pass the chapel again, David says, 'It's nice on the beach, isn't it? Did you have fun today Brutus?' The demon gives the promenade and ocean a last look before he replies, 'Yes, a lot. Thank you both for bringing me here. Maybe we could return sometime?'";
			else: [female Brutus]
				say "     It's sweet to watch David explain things patiently to his large friend, but in the end, not all that interesting, so you think about going for a swim further out alone... until suddenly a larger wave comes along, sloshing over David and his demonic trainee and momentarily panicking Brutus. The fact that he can easily stand here is forgotten in that moment and the demon brute fidgets anxiously, requiring David to move his hands in an attempt to keep him afloat. Then, from one moment to the next, the demon stops struggling and is calm again. The thought what could have distracted Brutus out of his floundering isn't even fully formed when you already see the explanation - as the purple brute puts his feet on the ground to stand up in the water, revealing that David's hand is right between his legs, up to the knuckles inside the demon's pussy.";
				WaitLineBreak;
				say "     Seems like a first accidental contact awakened their lust for each other, letting both of them forget about any swimming lessons or the like with a flare-up of arousal. There is a moment of realization as their eyes drop down on David's hand and Brutus swollen nether lips, then move to each other's face - until Brutus just sweeps David up out of the water, drawing him against his chest to give him a hungry kiss. They embrace each other and make out for a bit before Brutus soon gives the breathless grunt, 'Fuck me. Hard. Now.' David simply moans, 'Yeeessss...' as loud as he can, panting eagerly as Brutus hands move down to cup both his asscheeks for an appreciative grope. Then the demon kneels down in the water, leaving his head still comfortably above the waterline while putting his pussy in just the right height for David.";
				say "     Stroking the young soldier's shaft with a large hand, Brutus gently pulls him closer and brushes the cockhead over his pussy. That's all it takes for David's arousal to run wild and make the young soldier really go for it, thrusting deep into his lover and starting to pound his wet cave. But Brutus isn't just a passive partner to be fucked - gripping David's head, he kisses the man deeply, making out with him hungrily while animating him to deeper thrusts with an arm around his hips. The water really sloshes and splashes between them from all the heavy grinding and fucking - neither of them is holding back much, or at all. Judging from the pleased grunt at each really deep thrust, it seems like your demon companion actually likes it a bit rough. And David is only too eager to oblige. Groans and grunts from the two lovers draw the attention from nearby swimmers and even some people on the beach - not that either of them care one bit about it. Brutus just has his head lair back, moaning and bellowing as David rubs his sensitive spots, while his human partner is murmuring half to himself, 'Yeah... So tight... fucking a demon's pussy on the beach... You're... amazing Brutus...'";
				WaitLineBreak;
				say "     Interestingly, the demon brute is the first one to come from their coupling, his moans first getting deeper and louder, then turning into lust-filled roars as he bucks against David and femcum starts gushing out of his vagina. It swirls around the young soldier's thrusting shaft in a small cloud as he continues to pound into his lover. Feeling the muscles in Brutus vagina twitch around his cock, David's arousal mounts very quickly and after just a few more thrusts, he joins your companion in orgasm. With a deep gasp, David slams into him one last time, his shaft buried as deeply as possible inside Brutus pussy as it starts unloading spurt after spurt of his seed.";
				say "     Overwhelmed with euphoria at getting his friend to climax, and with David's hard cock still sending pulses of seed into his womb, Brutus gives David a deep and lusty kiss that immediately escalates into a long make-out session. The demon gives very pleased rumbles from his throat as his tongue wrestles with David's and his hands just keep wandering over the young man, holding him tight and stroking his body. 'Thank you my friend. I needed that badly.' Brutus breathlessly growls as he comes up for air after a while, then just keeps holding David against his chest and starts walking to the shore. Soon after, the two unlikely lovebirds are lying side by side on their beach towels, soaking up the sun and drying out while they continue to silently talk and whisper to each other, until they eventually doze off.";
				WaitLineBreak;
				say "     Some time later, it's time to go and you wake the two sleeping lovebirds and pack up all the towels and gear with their help. As soon as that's done, you make your way back to the rental guy and drop everything off with him, then turn your steps towards one of the roads leading away from the beachfront plaza. As you pass the chapel again, David says, 'It's nice on the beach, isn't it? Did you have fun today Brutus?' The demon gives the promenade and ocean a last look before he replies, 'Yes, a lot. Thank you both for bringing me here. Maybe we could return sometime?'";
		if calcnumber is 3: [volleyball]
			say "     Waving to the guys with the volleyball, you call and ask if they have room for some more players, getting a 'Sure!' as a reply. While quickly pulling off your clothes and exchanging them for some Speedos, David and you give Brutus a real quick introduction in the rules of the game, after that you're off to have some fun. The teams that gather around the net are pretty mixed, fitting to the ever-changing demographics of people in their different forms these days. Besides Brutus, David and yourself, your own team also has an otter, tiger-shark and a pretty tall and slender anthro mink, while the other team consists of a busty female husky, two dolphins, an anthro seagull and even two of the rare humans on the beach, studly guys with blond hair and the typical 'surfer dude' look.";
			say "     Brutus is a bit hesitant about how to play at first, asking 'I hit this? Just for fun?' while holding the ball. When one of the players tells him, 'Yup, just go for it!', the demon lets his muscles play, sending the volleyball high, high up into the air before it arches down again and falls back onto the beach. 'Good throw - but just go a bit softer next time, okay big guy?' David tells his otherworldly lover with a pat on the arm. After that, the game proceeds in a pretty freestyle manner - which was only to be expected with the wildly different shape and skill of all the players. Gerome the seagull fluttering up to get the ball up in the air, Brutus doing the same through his sheer size and the bendy and weasel-quick mink Andy doing all kinds of stunts might violate a whole lot of volleyball rules, but it's fun nevertheless. Something tells you that the game will need an update anyways to fit in this new and changed world.";
			WaitLineBreak;
			if DemonBruteStatus < 2: [Brutus has a cock]
				say "     While everyone enjoys their time in the sun and people are really getting into the competition, other beach-goers come together to watch and cheer for one side or the other. It's an exciting match with lots of high points - mainly when someone tries out another trick that only their new form allows them to do, or hilarious situations like when one of the surfer dudes misses a ridiculously easy pass because he was staring at Brutus's cock. The other surfer snaps his fingers in front of his eyes and laughingly calls out, 'Earth to Kaleb - stop staring at his junk and play. You cost us a point, boyfriend.' - which makes Kaleb turn a bit red in the face and hurriedly grab the ball that dropped on the sand right at his feet. Though you do notice that his gaze still returns to take in Brutus muscled physique and very generous endowments again and again after that.";
				say "     In the end, your team even are the winners of the friendly game, with the tiger-shark scoring the deciding point. After shaking each other's hands and your side getting numerous congratulations, the crowd and teams quickly break up again as wander off to rest, get something to drink or all kinds of other things. David actually is one of those who walk away, leaving in direction of the surf after saying, 'I'm all sweaty now. Gonna go take a swim to cool down and freshen up.' While your soldier friend goes to the beach, Brutus and you yourself move back to your spot and grab towels from your rented beach bags, then wipe the sweat off your brows and bodies.";
				WaitLineBreak;
				say "     When you lie down to get some rest and sunbathing time, you suddenly hear a human voice call out, 'Hey there - that was a good game. Wanna share a beer with us?' Turning your head a bit, you see between half-lidded eyes that it's the two surfers from before, just now approaching your demon companion with condensation-rimed beer bottles in hand. A generous offer - actual cold drinks, a rarity these days. They must have a generator or solar cells somewhere, plus a cooling bag for trips to the beach. The young man smiles as Brutus accepts, then brushes a long strand of blond hair out of his face and says, 'Great - I'm Robert, this is my boyfriend Kaleb.' Brutus takes a pull from the bottle and says, 'I am called Brutus.' Indicating you on your towel and David out in the water, he continues, 'My master and David brought me here to learn about 'normal' human life. It is... nice.' At that moment, the demon brute gives the two surfers his best attempt at a smile, showing his impressive row of sharp teeth - prompting Robert to take half a step back in alarm.";
				say "     Kaleb on the other hand almost jumps forward, giving the large demon a companionable slap on the arm. The blond surfer then happily chats Brutus up, gushing forth words seemingly without needing to breathe. He says, 'Boah, that's totally radical. So you're a demon, but a good guy and your buddies teach you how to hang on the beach? Cool! What didcha do to get those muscles? I love your abs! And those horns too! Wanna try surfing sometime? Also, I've been wondering about...' He gets interrupted by Robert at that point, 'Just ask him what you want, Kal. Sorry, Brutus - my boy gets a bit excited sometimes and tends to babble.' Kaleb turns to the other surfer at that and lets out a mockingly shocked, 'Hey!' - which Robert just waves off with a smile as he continues. '...as you might have noticed, my boyfriend here has been totally boned up since he laid eyes on you in the first place. He wants that thick shaft of yours deep in his ass. Kal's a total butt-slut.' The other surfer gives him a light hit on the arm at that, then leans in to kiss his cheek and interjects, 'Yeah yeah, and you love me because of it, admit it.' Turning to Brutus, he then says, 'He's right... I do wanna feel you inside dude. That pole of yours looks like a real challenge. So how about it, big boy? Wanna fuck me?' He doesn't wait for an answer, instead just boldly stepping forward to slide a hand under Brutus balls and rub his thick shaft with the other one.";
				WaitLineBreak;
				say "     Knowing Brutus, you immediately recognize the start of the lusty rumble he does when very turned on - it's painfully obvious what he'll answer and do next. This will be a pretty hot show you expect - do you simply stay where you are and watch things unfold ([link]Y[as]y[end link]), or do you maybe want to remind Brutus of David and suggest he wait a moment till the young man is back and maybe can join the fun ([link]N[as]n[end link])?";
				if player consents:
					LineBreak;
					say "     'Sure! Ride my cock!' Brutus growls in his deep voice, then lies down on the towel David prepared for him. With the demon resting comfortably on his back, his massive erection stands proudly upright over his crotch, causing Kaleb almost to drool as his gaze comes to rest on it. The blond surfer immediately steps forward to touch Brutus, putting his hands on the demon's private parts and rubbing them almost reverently. Leaning in to lick the demon's cockhead, the young human slurps up Brutus precum, then slides his lips over the very tip and suckles on it, animating the demon to produce more and more, which Kaleb then uses to lube up Brutus massive shaft. 'I'm gonna do it - mount this primo cock', Kaleb tells Robert excitedly and quickly pushes his shorts off, revealing a shapely pale-skinned butt. Moving to stand over Brutus supine form, he then crouches down, lowering his hips while looking at the thick pole of man-meat he wants to take on.";
					say "     Coming to stand between Brutus legs, Robert watches as Kaleb slides his cheeks up and down along Brutus erection, then says, 'Whoa, he looks even bigger with you right beside him. Be careful and don't break your butt, baby!' Stepping forward to give the other surfer's ass a quick grope, he leans in to kiss Kaleb's neck and adds, 'It'll be hot to see him go into you, but I've got my own plans for it later...' Moving back again to give the purple demon and his boyfriend some room, Robert then pushes his own shorts down far enough to whip out a respectably sized cock, already pretty hard as he starts to slowly jerk on it.";
					WaitLineBreak;
					say "     Kaleb straightens his legs again a bit to get into position right above where Brutus holds his manhood straight up with one big, clawed hand. Then he sinks lower until he can feel the large cockhead right against his pucker - slippery with precum and hot against his skin - and keeps going, giving a breathless gasp as his pressure downwards makes the tip pop right in. He takes a deep breath or two, then laughs and throws his head back as he shouts, 'Maaan! This is one thick pole. I love it!' You're just a bit surprised in how quickly he then proceeds to impale himself on even more of Brutus's manhood, giggling and moaning as the tiny bumps on your infernal companion's manhood rub his inner walls. Robert wasn't kidding - that boy is definitively a well-trained butt-slut. Pleased at the relative ease with which Kaleb is taking his cock, Brutus even relaxes his usual restraint a bit and does little jabs upwards with his hips, grunting lustfully as he penetrates deeper into the young man.";
					say "     Eventually, Kaleb is sitting on Brutus hips with every last inch of the demon's pole buried in his ass. He pants and moans deeply, murmuring, 'Totally rad - I did it. So warm inside me. Sooo gooooodd... unngh - FUCK ME!' With those last shouted words, the young man then starts to bounce up and down on Brutus shaft, incoherently babbling and moaning as Brutus additionally starts to thrust up on his own and puts both hands on Kaleb's hips to grind against him harder when their hips meet. Meanwhile, Robert wanders around the two of them, dick in hand and casually letting his shorts drop completely. Within moments, he arrives beside Brutus upper body. After another long look at his boyfriend having the time of his life, the surfer then says to Brutus, 'You know, I've 'trained' with him for a long time to get him those skills as a bottom. You should thank me. Maybe you could- ngh!' Being pretty direct as he is, Brutus doesn't waste a word and simply pulls the young man down to him at that point, one clawed hand grabbing his butt. Opening his mouth, he then slides his lips over Robert's hard shaft, taking great care to keep his teeth from toughing its sensitive skin.";
					WaitLineBreak;
					say "     It's pretty hot to watch the threesome play out so close to you - and many people nearby do so, with others wandering closer to see what's going on. Murmurs about the demon's sheer size and voices wondering if they could take it can be heard all around, as well as cheering and little gasps and moans as some do start masturbating to this show. The epic threesome finally reaches its climax as Brutus reaches the point of no return, bucking up against Kaleb with a roar and holding his hips tightly against his crotch. The demon's balls twitch as blast after blast of infernal seed it sent on its way, filling the surfer's butthole, then overflowing and squirting out around Brutus shaft. Feeling the thick pole jerk and pulse within him is the last straw for Kaleb to get off himself, so barely seconds after Brutus, he gasps loudly and comes, his cum arching through the air to splat down on the purple skin on Brutus chest.";
					say "     As Kaleb pants heavily to catch his breath after an explosive ejaculation, Robert steps up to him and gives him a kiss on the lips before saying, 'You were amazing, baby. A total pro.' They kiss again and again, until Robert's hands wander down to his boyfriend's shoulders and he gently pushes on them. The freshly bred bottom knows exactly what that means and instantly leans forward to take Robert's rock-hard cock into his mouth. With how wound up Robert already is, it doesn't take long before he too orgasms, filling Kaleb's mouth with a creamy load of cum, then giving him a long and deep kiss on the lips, tasting his own cum. The two surfers make out for a moment, then Kaleb pulls off Brutus shaft with a loud *pop* and a whole gush of cum from his still somewhat gaping asshole. He hugs his boyfriend, then looks down at Brutus and says, 'I want more. Fuck me again!'";
					WaitLineBreak;
					say "     Robert laughs loudly at that and kisses Kaleb on the cheek, then says, 'Totally insatiable. I love you, baby. Have fun while I take a break, okay?' That said, the blond surfer takes a few steps away from the demon and his boyfriend and slumps down on the warm sand, sitting cross-legged to watch what Kaleb and Brutus will do next. With a lusty growl in his throat, Brutus stands up, rising to his full height and drawing Kaleb against himself with one arm. He picks the smaller human up with effortless ease, pulling the young man's head to his own for a hungry kiss. At the same time, the demon's other hand gropes Kaleb's ass while holding him up by it and strong fingers brush lightly over the human's still partly gaping pucker.";
					say "     After some mutual tongue-wrestling, stroking and touching, Brutus lowers his other hand to cup Kaleb's ass and brings the original one up, with its finger covered in creamy cum fresh from the young man's hole. 'Lick it clean,' the demon grunts lustily, and Kaleb immediately draws his large hand to his mouth and starts to lap up its sticky covering. Eagerly slurping up and swallowing everything Brutus has to offer, he finishes up in record time before humming 'Mmmh - tasty! Too bad I can't eat myself out. Robert, you're in for a treat later.' After throwing his boyfriend a quick smile, the blond surfer pushes his hands down between himself and Brutus, groping around before quickly getting his hands on the demon's again fully hard shaft. Elated, he tells the demon, 'Awesome, dude - seems like you're ready for another round. Take me, big boy!'";
					WaitLineBreak;
					say "     More than willing to give the young man another good pounding, Brutus sets him down on his own feet again and growls, 'On all fours. Now.' After Kaleb quickly takes the position demanded of him, the demon kneels behind him with his hard cock in hand, then rubs the thick shaft up and down Kaleb's crack before pushing in against his pucker. With Kaleb being thoroughly trained in anal sex and already having been stretched quite a bit, as well as being filled with copious amounts of cum that is leaking out of - and lubing - his hole, it's actually relatively easy for Brutus to enter someone for once. He does so with visible relish, sinking his thick manhood deep into the slutty human under him. In his lust, Brutus partly forgets his usual restraint in dealing with smaller, more fragile people and gives Kaleb a deep thrust, making him gasp loudly, then pant 'Whoa! Do that again!'";
					say "     Seeing that Kaleb could take him hard without getting hurt, Brutus starts to really go to town on him as soon as the words are out of the surfer's mouth, gripping him tightly with both large hands while pounding into him from behind. It really is a sight to behold - that massive shaft ramming in and out of a young man in a demonstration of the demon's true and untamed bestial nature, free of restraint at last. Witnessing their wild coupling makes you realize that Kaleb can't be just a regular, run of the mill human anymore - not if he can take the hard fuck he's getting and still moan for more. Seems like he's as infected as everyone - though the nanites chose to give him this 'talent' instead of transforming his body.";
					WaitLineBreak;
					say "     Already having come not too long ago, Brutus lasts longer this time and fucks Kaleb with a tireless intensity that draws looks from many all around. But even so, all things have their limits and eventually, the demon's grunts rise in volume first slowly, then faster and faster, eventually becoming full-throated roars. Finally, with a last bellow, the demon starts to come, blasting Kaleb's insides with his seed. Holding the young man tight this time and just keeping his massive prick inside, Brutus voluminous load can't escape and just fills the surfer's insides, making his belly swell a little bit, then a tiny bit more as another spurt shoots into him, and another. Being double-stuffed with demonic cum does drive Kaleb over the edge right with him and the young man shoots long strings of cum into the sand underneath.";
					say "     After he finishes coming, the purple demon pulls out of Kaleb relatively unceremoniously, then flops back on the sand to catch his breath. Meanwhile, his human partner rests his forehead against the sand, panting breathlessly, before soon his boyfriend Robert is by his side and helps him up. Looking down over himself and seeing the way his stomach bulges from all the cum inside him, Kaleb laughs, 'Haha - look, I'm preggers. How rad is that!' Then he kisses Robert full on the lips and tells him to 'feel the baby' while pulling his hand to his own stomach. The other surfer just goes with it, obviously used to the sometimes odd and silly things Kaleb does and says. The two of them play around a bit with that theme, wondering about baby names in between making out, then eventually Kaleb calls out, 'Thanks Brutus, and see ya,' before starting to walk away, hand in Hand with Robert. The last thing you hear from them is the murmur, '...tastes amazing dude. You'll love eating me out when we get to our towels...' ";
					WaitLineBreak;
					say "     After watching his fuck-buddies walk away, still naked and with their shorts just carried in their hands, Brutus turns to you, a curious expression on his face. '[if cocks of player is 0 and cunts of player > 0]Mistress[else]Master[end if],' he says, 'It was great to fuck someone without holding back, amazing really. But... having fun with David seems even better. It feels so good and when I come I can barely breathe. How can that be? I have to be so careful with him.' Not sure how to respond, you simply watch as Brutus returns to resting on the beach, though you clearly make out the Demon murmuring to himself 'David is my favorite. I wonder if I could go all out with him too...'";
					say "     Some short while later, David returns from his swim, his toned body wet and dripping water. Lying down on his towel, the young man proceeds to stretch out for a bit of sunbathing and drying out. The three of you do spend a while longer just lounging around, taking in the warmth and peaceful atmosphere of the beach, then eventually it's time to go. Packing up all the towels and gear, you make your way back to the rental guy and drop it off with him, then turn your steps towards one of the roads leading away from the beachfront plaza. As you pass the chapel again, David says, 'It's nice on the beach, isn't it? Did you have fun today Brutus?' The demon gives the promenade and ocean a last look before he replies, 'Yes, a lot. Thank you both for bringing me here. Maybe we could return sometime?'";
				else: [wait for David]
					LineBreak;
					say "     As you speak up and remind Brutus of David, the demon gets a bit darker purple in the face and wrenches his leering gaze away from Kaleb to look out over the ocean. Quickly finding where David is bobbing along in the open water, he waves to his human friend, who starts to make his way on to the beach as he notices. While Brutus stands straight to watch the young man emerge from the water and walk through the sand, a very sexy figure in his tight speedo, Robert distracts Kaleb by stroking his neck and pulling him aside a step. 'Let's wait a while, mister grabby hands... they're boyfriends,' he murmurs to the other surfer, then draws his head aside to give Kaleb a kiss.";
					say "     Soon, David arrives at the little gathering around your towels, still glistening in the sun with droplets of water all over his toned body. His attention is mostly on Brutus, split between meeting the demon's intense gaze and being drawn towards his a bit more than half-hard cock - so much so that he barely notices the surfers making out right next to him. Then Robert clears his throat, making both of your companions turn to him. 'So... David. Good to meet you again after that nice game earlier. The thing that brings us here is... my boyfie Kaleb really really wants to get your big buddy's cock in him. That okay with you?'";
					WaitLineBreak;
					say "     David's eyes widen a bit and he swallows reflexively, then looks at the two hottie surfers, Brutus - and down at Brutus cock. 'I - err... sure. If you want this, Brutus, go for it. I wouldn't want to stand in the way of your fun,' the young man says, walking closer to his demon friend. He raises a hand to lay it on Brutus arm, then adds in a bit quieter tone, 'But thanks for not just banging him while I was out swimming.' With that, he steps away again, leaving the purple demon to turn to Kaleb - who is almost literally bouncing with excitement, stripping off his shorts in a quick move and revealing a very shapely pale-skinned butt. 'Thanks, man!' he calls out to David, then pounces on Brutus, touching him and putting both hands on the demon's private parts, rubbing them almost reverently. Leaning in to lick the demon's cockhead, the young human slurps up Brutus precum, then slides his lips over the very tip and suckles on it, animating the demon to produce more and more, which Kaleb then uses to lube up Brutus massive shaft.";
					say "     'Whoah, now that's a primo cock!' Kaleb giggles as he wags Brutus slick and shiny manhood towards Robert, then says to the demon himself, 'Can you lay down please? I totally wanna ride you.' With a lusty rumble in his throat, Brutus does just that, stretching out on the large towel David laid out for him earlier. Even so, part of his legs stand out over the end of it - human towels just never were meant for people of his sheer size. As the demon lays there on the beach, his erection stands straight upright, a towering pole that glistens in the sunlight with the spit and precum on it. Kaleb leans down to give it a last appreciative lick before telling Robert excitedly, 'I'm really gonna do it!' Moving to stand over Brutus supine form, the surfer then crouches down, lowering his hips while looking at the thick pole of man-meat he wants to take on.";
					say "     Coming to stand between Brutus legs, Robert watches as Kaleb slides his cheeks up and down along Brutus erection, then says, 'Whoa, he looks even bigger with you right beside him. Be careful and don't break your butt, baby!' Stepping forward to give the other surfer's ass a quick grope, he leans in to kiss Kaleb's neck and adds, 'It'll be hot to see him go into you, but I've got my own plans for it later...' Moving back again to give the purple demon and his boyfriend some room, Robert then pushes his own shorts down far enough to whip out a respectably sized cock, already pretty hard as he starts to slowly jerk on it. Not too far away from him, David has also been taken in by the steamy atmosphere, showing quite a tent in his skimpy Speedos.";
					WaitLineBreak;
					say "     Kaleb straightens his legs again a bit to get into position right above where Brutus holds his manhood straight up with one big, clawed hand. Then he sinks lower until he can feel the large cockhead right against his pucker - slippery with precum and hot against his skin - and keeps going, giving a breathless gasp as his pressure downwards makes the tip pop right in. He takes a deep breath or two, then laughs and throws his head back as he shouts, 'Maaan! This is one thick pole. I love it!' You're just a bit surprised in how quickly he then proceeds to impale himself on even more of Brutus's manhood, giggling and moaning as the tiny bumps on your infernal companion's manhood rub his inner walls. Robert wasn't kidding - that boy is definitively a well-trained butt-slut. Pleased at the relative ease with which Kaleb is taking his cock, Brutus even relaxes his usual restraint a bit and does little jabs upwards with his hips, grunting lustfully as he penetrates deeper into the young man.";
					say "     Eventually, Kaleb is sitting on Brutus hips with every last inch of the demon's pole buried in his ass. He pants and moans deeply, murmuring, 'Totally rad - I did it. So warm inside me. Sooo gooooodd... unngh - FUCK ME!' With those last shouted words, the young man then starts to bounce up and down on Brutus shaft, incoherently babbling and moaning as Brutus additionally starts to thrust up on his own and puts both hands on Kaleb's hips to grind against him harder when their hips meet.";
					WaitLineBreak;
					say "     Meanwhile, Robert wanders around the two of them to get a really good look, dick in hand and casually letting his shorts drop completely. After some moments of jauntily strutting around them, naked and hard, he comes to stand right next to David and asks the soldier in a husky voice, 'Hot show, hm?' David can barely take his eyes off the demon and human, distractedly murmuring 'Yeah' - at least until Robert reaches out to pull the stretched fabric of his Speedos down and takes hold of his cock. As David turns to Robert in surprise and opens his mouth to say... something, the blond surfer just takes the chance of pressing his lips David's, giving him a hungry kiss that is eagerly shared as soon as the soldier gets over the initial shock. Coming up to take a breath some while later, Robert pants, 'Let's have some fun while our boyfriend's are busy.'";
					say "     Arm laid around David's shoulder, the surfer guides him over to his free towel, then gently pushes him to lie down on it and gets down himself, taking the classic 69 position on all fours. With Robert on hands and knees above him, David just has to raise his head a little to take the young man's shaft into his mouth - and he eagerly does so, bobbing his lips up and down over its length. At the other end, Robert takes a quick moment to look over at his boy and Brutus, still fucking hard, then down at the hunky soldier lying under him, and says with a grin 'Oh yeah! That's the life!' With that, he proceeds to go down on David, gently tickling the man's balls and rubbing between his buttcheeks while he does so.";
					WaitLineBreak;
					say "     It's pretty hot to watch the two couples having fun play out so close to you - and many people nearby do so, with others wandering closer to see what's going on. Murmurs about the demon's sheer size and voices wondering if they could take it can be heard all around, as well as cheering and little gasps and moans as some do start masturbating to this show. The epic sex show finally reaches its climax as Brutus reaches the point of no return, bucking up against Kaleb with a roar and holding his hips tightly against his crotch. The demon's balls twitch as blast after blast of infernal seed it sent on its way, filling the surfer's butthole, then overflowing and squirting out around Brutus shaft. Feeling the thick pole jerk and pulse within him is the last straw for Kaleb to get off himself, so barely seconds after Brutus, he gasps loudly and comes, his cum arching through the air to splat down on the purple skin on Brutus chest.";
					say "     As Kaleb pants heavily to catch his breath after an explosive ejaculation, Robert pulls off David's cock with a pop and says, 'Sorry dude, that load is meant for my boy. He can't get enough of my cum, you know. With that, he gives David's own cockhead a little peck of a kiss and stands up, leaving the man lying on his towel alone. Wandering over to Kaleb, the surfer then gives him a kiss on the lips before saying, 'You were amazing, baby. A total pro.' They kiss again and again, until Robert's hands wander down to his boyfriend's shoulders and he gently pushes on them. The freshly bred bottom knows exactly what that means and instantly leans forward to take Robert's rock-hard cock into his mouth. With how wound up Robert already is, it doesn't take long before he too orgasms, filling Kaleb's mouth with a creamy load of cum, then giving him a long and deep kiss on the lips, tasting his own cum. The two surfers make out for a moment, then Kaleb pulls off Brutus shaft with a loud *pop* and a whole gush of cum from his still somewhat gaping asshole. He hugs his boyfriend, then looks down at Brutus and says, 'I want more. Fuck me again!'";
					WaitLineBreak;
					say "     Robert laughs loudly at that and kisses Kaleb on the cheek, then says, 'Totally insatiable. I love you, baby. But don't hog all the cock for yourself - we really should give this awesome dude's boyfriend a turn. I bet that's why they're on the beach together in the fist place.' He looks over to David, whose interesting shade of red in the face reveals that he indeed had some plans in that regard. 'Thought so,' Robert says with a grin, then gives David a hand to stand up. 'We got him all warmed up for you - have fun!' he adds with a look at the supine demon, still panting deeply as he winds down from the amazing orgasm. That said, he pulls Kaleb aside and tells him, 'Come on, let's just watch em. I'll fuck you later, okay?' 'Fine,' Kaleb replies, somewhat disappointed - at least until Robert pulls him down to sit in the sand with him... on his hand, which he then uses to fondle the needy bottom's hole, instantly consoling his boyfriend to not getting fucked again.";
					say "     David watches the two surfer's antics, then turns towards Brutus and climbs on top of him, straddling the demon's abs to lean down and kiss him. The two of them make out for a moment, wrestling each others tongues while David grinds his erection against Brutus muscled chest, then the human pulls his head up a bit and looks deep into the demon's eyes. 'Are you... ready to fuck again? I really need to get off and want you to make me come,' David asks while rubbing the base of Brutus right front horn with a finger. Getting touched in such a sensitive spot makes the purple demon moan and pant loudly, not being able to answer until his friend relents for a moment and lets him speak. 'I'm always *pant* ready for *pant* you,' Brutus says finally, rotating his hips to let his hardon rub against David's butt and illustrate the point.";
					WaitLineBreak;
					say "     Giving an eager moan, David raises his hips, then rubs up against Brutus shaft with his crack, making the demon give a lusty rumble from deep in his chest. Reaching down to take hold of his large friend's cum-slick and fully erect pole, the young man then starts to lean back, pushing its wide head against his pucker. After Kaleb's relatively effortless ride on the thick cock, this seems pretty slow and careful to you - and it is, as Brutus massive prick really is a lot to take. It takes a moment of slowly increasing the pressure down against the cockhead until finally it pops in, stretching David's pucker wide as Brutus manhood enters him. Knowing how big your infernal companion's manhood his, you're not surprised at all to hear David gasp from the initial penetration. But then, as it sinks deeper into his body, pleasant feelings prevail as the bumps on Brutus's shaft rub his inner walls.";
					say "     Thankfully, Brutus does very well in guessing how much his friend can take and only slowly moves deeper, often stopping to just hold David so he can get used to it. Finally he bottoms out inside the human, hard shaft buried all the way and his two large cum-factories resting against his skin. Panting deeply, they find each other's lips and share kiss after kiss. It's pretty amazing if one thinks about it - this huge, muscular creature who was a ravening beast not too long ago, now having sex with a human friend on the beach, being as gentle as he can be with his equipment.";
					WaitLineBreak;
					say "     A few minutes of making out with Brutus later, David starts moving again, rocking back and forth on the thick pole - slowly. Moving in and out, the bumps on Brutus's cock rub against David's stretched insides, making him shudder with rising lust. From the looks of it, it becomes easier to have Brutus inside over time, with the demon leaking more and more precum to add to the remains of cum lubing his entry, and David's muscles being stretched out and getting used to it. All of which allows your infernal companion to start thrusting up against David himself, with increasing speed and strength. Soon, the slapping noises of his balls against David's butt are coming in rapid succession. It doesn't take long before this drives the human's arousal over the edge and with a loud moan, his cock sprays cum all over Brutus chest.";
					say "     Obviously very pleased at getting his friend off, and with David's asshole twitching around his cock as he orgasms, Brutus joins the young soldier in climax just moments later. With a satisfied roar, he slams his massive cock all the way into David and begins to pump his bowels full of his demonic seed. Easily filling David's asshole and intestines, the remaining cum starts squirting out around the demon's thick cock as he thrusts into him a few more times. When he finally removes his cock with a loud *pop*, David's stomach looks a bit distended from the sheer amount of cum that was injected into him, with more of it leaking from his hole to soak into the towel.";
					WaitLineBreak;
					say "     'That was great. Thanks, baby.' Brutus rumbles to David and gives him a quick kiss, then pulls him close to his chest to rest there. Worn out from sex, the two of them end up staying in that position, with David draped over Brutus large form. They continue to silently talk and whisper to each other for some time, then eventually doze off.";
					say "     Turning your attention back to Robert and Kaleb, you see that Kaleb is still getting fingered by his boyfriend, silently moaning as Robert massages his hole and slowly jerks his cock. You can barely hear Robert whisper, 'Looks like the show is over. Let's go back to our own towels, where I can fuck you hard and we won't wake up those two lovebirds.' After that, it doesn't take long at all before the two surfers have retrieved their shorts and are casually walking off, still naked and just holding the shorts in their hands.";
					WaitLineBreak;
					say "     Some time later, as you prepare to leave and David goes to the water again to wash off some dried cum, Brutus turns to you, a curious expression on his face. '[if cocks of player is 0 and cunts of player > 0]Mistress[else]Master[end if],' he says, 'It was great to fuck someone without holding back, amazing really. But... having fun with David was much better. It feels so good and when I come I can barely breathe. How can that be? I have to be so careful with him.' Not sure how to respond, you simply watch as Brutus looks down on the towel with its dried cum-stains, though you clearly make out the Demon murmuring to himself 'David is my favorite. I wonder if I could go all out with him too...'";
					say "     Some short while later, David returns, his toned body now clean and wet with dripping water. Grabbing a towel from the rented bag, he dries off, then gets dressed before helping to pack up all the towels and gear. As soon as that's done, you make your way back to the rental guy and drop everything off with him, then turn your steps towards one of the roads leading away from the beachfront plaza. As you pass the chapel again, David says, 'It's nice on the beach, isn't it? Did you have fun today Brutus?' The demon gives the promenade and ocean a last look before he replies, 'Yes, a lot. Thank you both for bringing me here. Maybe we could return sometime?'";
			else:
				say "     <female Brutus and surfers sex scene placeholder> (sorry, not included in this commission)";
	else: [night]
		say "     It is an oddly peaceful night out in the city, with barely anyone out on the streets or keeping to themselves if they are - almost as if fate decided to help out a bit for your trip, arranging for undisturbed passage along your chosen route. Before long, your little group arrives at the Beach Plaza. It spreads out before you, surprisingly clean and well kept as it is, in a beach nightlife scene that might have played out before all the crazy things happened - well, if one ignores that virtually everyone you see isn't human anymore. From the street vendor leaning against a nearby wall to the people lounging around near one of several fire pits or even still bathing in the dark, there is a wild mixture of fur, scale and feathers being shown, with only perhaps two or three at least still human-looking persons in the mix. The moon bathes everything in its silvery light and the happily crackling fires along the beach give everything a nice warm atmosphere.";
		WaitLineBreak;
		say "     Taking a deep breath of the salty sea air, David moves forward onto the plaza, only to stop after a few steps as he notices Brutus isn't behind him anymore. As it turns out, the big purple brute stopped at the beach-side chapel fronting onto the plaza, hesitantly resting a clawed hand on its wall - it seems to be almost in reverence. David joins him a short moment later, touching the demon's side gently as he asks, 'What is it, big guy? Bad memories?' Brutus shakes his head slowly and replies in his deep voice, 'No. A Good one. This is where the [if cunts of player > 0 and cocks of player is 0]mistress[else]master[end if] extinguished the fire, the burning, inside me. It hurt, but it set me free.' Turning his head from the building, he looks down at the soldier standing next to him, then lays a large hand over the one David still has against his side and continues, 'Thank you for asking.'";
		say "     After a few moments more, David says, 'Come on, let's enjoy ourselves for a while...' He leads Brutus over to the nearby armadillo street vendor with the sign 'Beach Gear Rental' and chats with the guy, haggling a bit to get towels, swim-gear and even a mid-sized bag of marshmallows for the three of you in exchange for a can of beans and a power bar. Newly equipped with full beach bags, you then walk down the shallow steps to the beach itself. Brutus seems surprised at first at the large number of people already there, peacefully enjoying a warm day's aftermath with each other. With the very diverse group of beach-goers, even the demon's towering stature draws only few looks, although the orca lifeguard gives him a longer moment of attention before nodding and turning back to watching out over everyone all around.";
		WaitLineBreak;
		say "     Walking over to a free spot around a big fire pit, David instructs Brutus on laying out the big beach towels he rented, then the three of you plant yourselves on them. Brutus sits still for a moment, looking slightly lost on such an everyday human thing like free time and enjoying yourself, then he looks left and right at you and David saying, 'And... now?'";
		LineBreak;
		say "     Which beach-side activities do you recommend? Should Brutus roast some marshmallows [link](1)[as]1[end link] or maybe go take a dip in the sea (learn swimming from David) [link](2)[as]2[end link]?[line break]";
		now calcnumber is 0;
		while calcnumber < 1 or calcnumber > 2:
			say "Choice? (1-2)>[run paragraph on]";
			get a number;
			if calcnumber is 1 or calcnumber is 2:
				break;
			else:
				say "Invalid choice. Type [link]1[end link] for marshmallows or [link]2[end link] for swimming.";
		if calcnumber is 1: [marshmallows]
			say "     You bring the bag of marshmallows somewhere in one of the beach bags, which sends David over to them to search for it. Soon, you hear a triumphant 'Aha - here it is!' and the soldier returns with a mid-size bag of white candy cubes. 'You'll love these,' he tells Brutus and opens up the bag before continuing, 'You toast these and eat them when they're nice and crunchy, with a molten core. Hmm... we just need some sticks. Wait - hold this...' Handing over the plastic baggy to Brutus, the young man walks off for a moment to talk with the people feeding wood to the fire from a pile next to it, then returns with several thin branches in his hands. Though looking back to where Brutus is sitting, you realize that he doesn't really need one anymore - as the demon just stuck a marshmallow on the pointy end of his long tail and uses that to hold it over the fire.";
			say "     'Oh,' David says with a smile at Brutus, then he gives you your own branch and a whole handful of marshmallows. Afterwards he sits down right next to the big demon and asks, 'So - are you totally fireproof?' 'Not quite,' Brutus replies in his deep voice, 'But I'm used to far more than this small flame.' A moment later, the demon bends his tail closer and dangles the end with the marshmallow in front of David's face, asking 'This okay?' As David nods and tells him to try it, Brutus pulls the now sticky brown-white lump off and throws it in his mouth. The demon's eyes go wide as he tastes the sweet and he gives a very pleased rumble in his throat, then licks the remains of the marshmallow off his fingers. He is so eager for more that he directly impales one out of the bag as David holds it out for him, then stretches the appendage back towards the fire.";
			WaitLineBreak;
			say "     Looking around as you prep some marshmallows on the ends of the branch in your hand, your gaze wanders over the many other beach-goers who share the same fire, sitting around, talking, some just staring into the flames, others roasting their own marshmallows. It's pretty peaceful and communal, giving you hope that maybe a new society might establish itself even if this crazy nanite plague is never cured. Though it'll definitively be quite different than the old one - as demonstrated by your realization that maybe a quarter of the persons sitting nearby are openly fondling each other and the not so distant moaning you can hear over the cash of the surf.";
			say "     Turning back towards Brutus and David, you see the human now sitting between his demonic lover's spread legs, leaning back against Brutus wide chest as he holds a stick with a marshmallow over the fire. Brutus tail is pulled back towards the two of them a moment later, and he pulls a well-toasted piece of candy off it with his fingers, then holds it out to David with a rumbled, 'For you.' 'Thanks,' David replies and happily lets the demon feed it to him. As the demon starts to pull his large hand away afterwards, David takes hold of it to lick Brutus fingers, then takes the tip of his index finger in his mouth to gently suck on it.";
			WaitLineBreak;
			say "     It's pretty sweet how the human and demon feed each other marshmallows and share small caresses as they silently talk and whisper, so you're content with simply watching them without making any great effort of trying to overhear things. Roasting your own sweet candy, watching the flames and hearing waves crash as well as people murmur and moan... is just a nice bit relaxation, which you can really use with everything you're going through every day now.";
			say "     You wish you could just stay here and let things continue like this forever, but every good thing has to come to an end sometime. All the marshmallows are long gone and David has gone over to actually doze against Brutus chest as he is held by the demon when you finally decide that it's time to go. Stretching your arms, you get up a moment later and tell your two companions to help you pack up. As soon as that's done, you make your way back to the rental guy and drop everything off with him, then turn your steps towards one of the roads leading away from the beachfront plaza. As you pass the chapel again, David says, 'It's nice on the beach, isn't it? Did you have fun tonight Brutus?' The demon gives the promenade and ocean a last look before he replies, 'Yes, a lot. Thank you both for bringing me here. Maybe we could return sometime?'";
		if calcnumber is 2: [swimming]
			say "     You suggest that Brutus take a dip in the ocean and swim a bit, to which the demon sheepishly replies in his deep voice, 'I can't swim, master. Water... boils, where I come from. It hurts and unless when being punished, you never touch it.' The large demon's tail whips from left to right in frustration, looking out at the wide open sea with a sullen expression at missing out. His attention is drawn to the side as a hand suddenly touches his arm, it's David who gives him a friendly smile and says, 'No problem, big guy. I'll teach you.' With that, David pulls off his shirt and throws it on his towel, then bends over to dig out a brightly colored speedo from his rented beach bag. Hooking his thumbs under the band of both his pants and undies, the young man quickly pushes them down his legs, followed by pulling the speedo up to his hips.";
			say "     As David turns back around, he chuckles at the fact that Brutus gaze is still down at his crotch from watching him, then waves for the demon to follow him and says, 'Come on, you'll love it, I'm sure.' Deciding on getting some refreshment yourself - and curious on how this will turn out in the end too, you hurriedly get your own gear on and follow them soon after, walking down towards the surf. It's almost comical to see the large demon brute gingerly step forward onto the wet sand, then start to draw back reflexively and stop himself as a wave washes over his feet. 'It's... cool. Nice.' Brutus mumbles to himself, and David puts a hand on his larger one to pull him forward, walking into the slowly deepening water.";
			WaitLineBreak;
			say "     The two of them, and you following, move out into the ocean, up to a point where the water his about chest high for the young soldier and just barely waist-high for the demon. Choosing that spot for his swimming lessons, David tells Brutus to get down in the water and lay on it lengthwise. 'Just relax,' the young man tells the demon, 'I'll hold you up as you try out some moves.' Brutus does as he is told and David indeed manages to keep him afloat, helped by the buoyancy the salty water gives his friend. What follows are pretty basic lessons about floating and swimming and the demon's early tries for doing the breast stroke and crawl stroke.";
			if DemonBruteStatus < 2: [Brutus has a cock]
				say "     It's sweet to watch David explain things patiently to his large friend, but in the end, not all that interesting, so you think about going for a swim further out alone... until suddenly a larger wave comes along, sloshing over David and his demonic trainee and momentarily panicking Brutus. The fact that he can easily stand here is forgotten in that moment and the demon brute fidgets anxiously, requiring David to move his hands in an attempt to keep him afloat. Then, from one moment to the next, the demon stops struggling and is calm again. The thought what could have distracted Brutus out of his floundering isn't even fully formed when you already see the explanation - as the purple brute puts his feet on the ground to stand up in the water, revealing that David's hand is wrapped around the towering shaft of his manhood.";
				WaitLineBreak;
				say "     Seems like a first accidental contact awakened their lust for each other, letting both of them forget about any swimming lessons or the like with a flare-up of arousal. There is a moment of realization as their eyes drop down on David's hand and Brutus erect shaft, then move to each other's face - until Brutus just sweeps David up out of the water, drawing him against his chest to give him a hungry kiss. They embrace each other and make out for a bit before Brutus soon gives the breathless grunt, 'I want to fuck you. Hard. Now.' David simply moans, 'Yeeessss...' as loud as he can, panting eagerly as Brutus hands move down to cup both his asscheeks and lift him higher.";
				say "     Holding the young soldier with one strong hand, Brutus grabs his mighty shaft and lines it up with his lover's asshole while pulling his speedo aside. Then he lowers David till his cockhead touches the man's pucker. Slowly, slowly, he increases the pressure on his friend bit by tiny bit, until David's opening finally yields and allows him entrance. Brutus really has one big cock, and it's somewhat awe-inspiring and alarming at the same time to see him push into a human and stretch his back door so wide around his shaft. Thankfully, your infernal companion knows just how large his manhood his and he keeps things slow, stopping entirely for a moment each time he hears David gasp from the penetration. But as it sinks deeper into the young man's body, pleasant feelings prevail when the bumps on Brutus's shaft rub David's inner walls. Finally he bottoms out inside the young soldier, his huge dick buried all the way in and his two heavy balls pressing against his skin. Groaning deeply, Brutus leans forward to find David's lips and hungrily extends his long tongue into the human's mouth. It is quite the sight, especially if one thinks about it - this huge creature of pure muscle who was a ravening beast not too long ago, taking great pleasure in having sex with a much smaller human lover, being as gentle as he can be with his equipment.";
				WaitLineBreak;
				say "     After finishing their heavy make-out session, David breathlessly begs Brutus to begin fucking. The demon begins with slow motions, lifting and pushing David up and down on his purple shaft, the bumps on Brutus's cock rub against the soldier's stretched insides, making him shudder with rising lust. As David's moans become more audibly pleasurable, he's clearly gotten used to have Brutus deep inside him over time, with the demon leaking more and more precum and David's muscles being stretched out and getting used to it. All of which allows your infernal companion to speed up his thrusts, going faster and faster, the slapping noises of his balls against David's hips now coming in rapid succession, each slap eliciting a heavy growl from Brutus, and sometimes a barely audible gasp of 'so good' or 'so tight' from behind his clenched teeth. Soon, this drives the human's arousal over the edge, crying out 'oh fuck!' as his cock sprays cum all over Brutus and his own chest.";
				say "     Overwhelmed with euphoria at getting his friend to climax, and with David's asshole twitching around his cock as he orgasms, Brutus pounds the young soldier at a feverish pace, shouting 'I'm gonna cum!' in a loud growl, and reaches his peak a few quick thrusts later. With a mighty roar, he slams his massive cock all the way into David and begins to pump his bowels full of his demonic seed, every muscle in Brutus' body tensing with each spurt. Easily filling David's asshole and intestines, the remaining cum starts flowing out around the demon's thick cock as he finishes his last quick thrusts. As Brutus' thick cock is pulled out of the human's ass with a loud *pop*, David's stomach looks bloated from the sheer amount of demon seed that was pumped into him, with more of it leaking from his hole to drip into the sea.";
				WaitLineBreak;
				say "     'Thank you my friend. I needed that badly.' Brutus breathlessly growls to David and gives him a quick kiss, then just keeps holding him against his chest and starts walking to the shore. Soon after, the two unlikely lovebirds are sitting on their beach towels at the fire pit, with David sitting between Brutus spread legs and leaning back in relaxation against the demon's broad chest. Brutus arms embrace the smaller human, and he looks very content in simply holding on to his soldier friend as they silently talk and whisper to each other.";
				say "     Some time later, it's time to go and you call over to the two of them to help you pack up. As soon as that's done, you make your way back to the rental guy and drop everything off with him, then turn your steps towards one of the roads leading away from the beachfront plaza. As you pass the chapel again, David says, 'It's nice on the beach, isn't it? Did you have fun today Brutus?' The demon gives the promenade and ocean a last look before he replies, 'Yes, a lot. Thank you both for bringing me here. Maybe we could return sometime?'";
			else: [female Brutus]
				say "     It's sweet to watch David explain things patiently to his large friend, but in the end, not all that interesting, so you think about going for a swim further out alone... until suddenly a larger wave comes along, sloshing over David and his demonic trainee and momentarily panicking Brutus. The fact that he can easily stand here is forgotten in that moment and the demon brute fidgets anxiously, requiring David to move his hands in an attempt to keep him afloat. Then, from one moment to the next, the demon stops struggling and is calm again. The thought what could have distracted Brutus out of his floundering isn't even fully formed when you already see the explanation - as the purple brute puts his feet on the ground to stand up in the water, revealing that David's hand is right between his legs, up to the knuckles inside the demon's pussy.";
				WaitLineBreak;
				say "     Seems like a first accidental contact awakened their lust for each other, letting both of them forget about any swimming lessons or the like with a flare-up of arousal. There is a moment of realization as their eyes drop down on David's hand and Brutus swollen nether lips, then move to each other's face - until Brutus just sweeps David up out of the water, drawing him against his chest to give him a hungry kiss. They embrace each other and make out for a bit before Brutus soon gives the breathless grunt, 'Fuck me. Hard. Now.' David simply moans, 'Yeeessss...' as loud as he can, panting eagerly as Brutus hands move down to cup both his asscheeks for an appreciative grope. Then the demon kneels down in the water, leaving his head still comfortably above the waterline while putting his pussy in just the right height for David.";
				say "     Stroking the young soldier's shaft with a large hand, Brutus gently pulls him closer and brushes the cockhead over his pussy. That's all it takes for David's arousal to run wild and make the young soldier really go for it, thrusting deep into his lover and starting to pound his wet cave. But Brutus isn't just a passive partner to be fucked - gripping David's head, he kisses the man deeply, making out with him hungrily while animating him to deeper thrusts with an arm around his hips. The water really sloshes and splashes between them from all the heavy grinding and fucking - neither of them is holding back much, or at all. Judging from the pleased grunt at each really deep thrust, it seems like your demon companion actually likes it a bit rough. And David is only too eager to oblige. Groans and grunts from the two lovers draw the attention from nearby swimmers and even some people on the beach - not that either of them care one bit about it. Brutus just has his head lair back, moaning and bellowing as David rubs his sensitive spots, while his human partner is murmuring half to himself, 'Yeah... So tight... fucking a demon's pussy on the beach... You're... amazing Brutus...'";
				WaitLineBreak;
				say "     Interestingly, the demon brute is the first one to come from their coupling, his moans first getting deeper and louder, then turning into lust-filled roars as he bucks against David and femcum starts gushing out of his vagina. It swirls around the young soldier's thrusting shaft in a small cloud as he continues to pound into his lover. Feeling the muscles in Brutus vagina twitch around his cock, David's arousal mounts very quickly and after just a few more thrusts, he joins your companion in orgasm. With a deep gasp, David slams into him one last time, his shaft buried as deeply as possible inside Brutus pussy as it starts unloading spurt after spurt of his seed.";
				say "     Overwhelmed with euphoria at getting his friend to climax, and with David's hard cock still sending pulses of seed into his womb, Brutus gives David a deep and lusty kiss that immediately escalates into a long make-out session. The demon gives very pleased rumbles from his throat as his tongue wrestles with David's and his hands just keep wandering over the young man, holding him tight and stroking his body.";
				WaitLineBreak;
				say "     'Thank you my friend. I needed that badly.' Brutus breathlessly growls to David and gives him a quick kiss, then just keeps holding him against his chest and starts walking to the shore. Soon after, the two unlikely lovebirds are sitting on their beach towels at the fire pit, with David sitting between Brutus spread legs and leaning back in relaxation against the demon's broad chest. Brutus arms embrace the smaller human, and he looks very content in simply holding on to his soldier friend as they silently talk and whisper to each other.";
				say "     Some time later, it's time to go and you call over to the two of them to help you pack up. As soon as that's done, you make your way back to the rental guy and drop everything off with him, then turn your steps towards one of the roads leading away from the beachfront plaza. As you pass the chapel again, David says, 'It's nice on the beach, isn't it? Did you have fun today Brutus?' The demon gives the promenade and ocean a last look before he replies, 'Yes, a lot. Thank you both for bringing me here. Maybe we could return sometime?'";

to say DavidTalk6: [trip to Camp Bravo]
	say "     As you suggest the destination, David eyes widen, then he slowly nods, a thoughtful look in his eyes. 'Camp Bravo? Yes, that does make sense. Best to get the men used to seeing Brutus, because eventually this whole mess is gonna end and it'd be good if others could attest his character.' A smile sneaks over his face momentarily and he adds, 'And I do know one guy who'd surely love to... meet Brutus. Let's go right now.' [if companion of player is demon Brute]You call over Brutus[else]You pull out your demontooth amulet, speak the magic word to summon Brutus[end if] and tell your demon companion that the three of you will take a trip together, to introduce him to other members of the military. Show them he's a good guy and all that. 'Thank you,' the purple giant says, looking from you to the young soldier with a happy expression on his face, showing many sharp teeth in a wide smile. After David goes to his bed to grab a few things and puts them in his backpack, you're off, taking the stairs up to the library and exiting out the front doors.";
	WaitLineBreak;
	say "     The trip through the streets leads you past a number of different creatures, from [one of]needily rutting huskies[or]a small pack of latex wolves[or]a solitary gargoyle[or]a stalking panther taur[at random] to [one of]a blue gryphon in the sky[or]a harpy circling overhead[or]a German shepherd looting a building[at random] - some of them give you interested and/or hungry looks, but with Brutus towering behind David and there being three of you, they hold back from doing anything to bother you. As you come closer to the camp, the number of infected out on the street drops quickly, with finally no one at all being in sight as you pass within 300 feet of the camp and walk the path between all the wrecked cars up to its entrance. David at that point tells Brutus to stay behind him no matter what, then walks toward the camp, waving and shouting, 'Private David Jackson and company coming in, don't shoot!'";
	say "     Some moments later, a man whom you recognize as Private Cooper calls back, 'HALT! Stop right there. You're not bringing one of those beasts in here!' What follows is a shouted discussion in which David tries to convince the guard of Brutus harmlessness, without much success - it takes you joining in and flat out ordering the man to let you through (taking up your invented role as special agent again) until you finally hear him call, 'Fine! But I'll be watching that thing!' Some moments later, you stand at the car wreck barricade that is the entrance to Camp Bravo, with Cooper a standoffish distance away, clutching his rifle, and the far less hostile Private Orwell coming out from his guard position to greet you. 'Hey there,' he says, nodding to David and you, then looking at Brutus with wide eyes. You do notice that the man's gaze is instantly drawn to Brutus crotch and he has to shake out of staring at Brutus massive shaft before he can look up, and up to meet Brutus eyes and say, '...and hello to you too.'";
	WaitLineBreak;
	say "     David walks up to the other soldier and claps him on the shoulder, then says, 'Nice to see you again, Marc. How have things been here at the camp?' The military men have a short chat, in which David states again how peaceful and even helpful Brutus really is - with a look at the scowling Private Cooper. It's clear that Private Orwell is pretty interested in the otherworldly visitor and would have loved to talk more, but soon Cooper snubs him, 'Get back on your post soldier! We're not here to gossip. Do your duty, you damned fag!' Suppressing a scowl at the insult, Marc Orwell gets back into position to scan the camp's approaches. With one guard just staring at you with hostility and the other unable to talk freely, you're left standing at the entrance alone. A moment later, Brutus looks left and right at you and David before asking, 'And... now?'";
	LineBreak;
	say "     What shall you do in Camp Bravo? Visit the commanding officer [link](1)[as]1[end link], or maybe go do a 'perimeter patrol' with Marc Orwell (getting him alone for once) [link](2)[as]2[end link]?[line break]";
	now calcnumber is 0;
	while calcnumber < 1 or calcnumber > 2:
		say "Choice? (1-2)>[run paragraph on]";
		get a number;
		if calcnumber is 1 or calcnumber is 2:
			break;
		else:
			say "Invalid choice. Type [link]1[end link] for meeting Major Padgett or [link]2[end link] for a patrol with Marc.";
	if calcnumber is 1: [Meet the Major]
		if DemonBruteStatus < 2: [Brutus has a cock]
			say "     Telling your friends that the commanding officer should meet Brutus, you lead the way, moving towards the big headquarters tent. Walking through the camp, you pass the... breeding ground... in the center, which leads to the demon getting aroused as he watches the Minotaur there mount a naked soldier. Brutus cock swells with blood and he gives lusty grumbles from the depth of his chest with each thrust of the big beast into the man below. Then he suddenly stops, his attention on the current breeding subject's partner, standing ready in his birthday suit to go next, and holding a butt plug to seal Tiny Tim's seed inside his buddy. Your purple giant's clawed hand takes hold of his massive prick, jerking it and making a large drop of pre-cum appear at the tip. Then he gives David and you a look and says, 'I'm horny. And that man is waiting to be fucked - can I take him?'";
			say "     'Not right now, my friend,' David replies, then hastily adds, 'Come on, let's go meet the Major and...' The sentence he wanted to say fades away as the young man's eyes come to rest on Brutus erection, standing straight and radiating perceptible heat. 'Nevermind, can't go to him like that. Err... come with me.' Taking the demon by his large clawed hand, David guides you to the side, away from the commander's tent again. Passing tent after tent along a twisting path, you soon come to an area that seems less lively. Looking around, you see why - these are the storage tents in which all kinds of stuff is stacked up, and behind them is the windowless back wall of a building. As soon as you are mostly out of sight behind the tents, David pants, 'I'll take care of you, big guy.' He pulls on Brutus arm to make him lean down for a kiss, then lays a hand on Brutus cock, stroking along the thick shaft.";
			WaitLineBreak;
			say "     Do you want to watch as the unequal lovers have some fun with each other?";
			if player consents:
				say "     The large demon and his smaller human lover make out hungrily with each other. While David rubs Brutus manhood, the purple giant squeezes his buttcheeks with both hands and wraps the end of his tail around David's legs in a small extra-embrace. In between making out and caressing each other, the young soldier manages to pull off his uniform piece by piece somehow, simply throwing it aside to land in a small heap in his eagerness to have some fun. Soon, as David is just bending over to step out of his undies, Brutus rubs a finger up and down his crack, then leans over to kiss the human's back. A breathless grunt of, 'I want to fuck you. Hard. Now.' has David moaning in lust, loudly panting 'Yeeessss...' as Brutus hands get a tight grip on his ass and lift him up by it.";
				say "     Holding the young soldier with one strong hand against his chest, Brutus grabs his mighty shaft and lines it up with his lover's asshole. Then he lowers David till his cockhead touches the man's pucker. Slowly, slowly, he increases the pressure on his friend bit by tiny bit, until David's opening finally yields and allows him entrance. Brutus really has one big cock, and it's somewhat awe-inspiring and alarming at the same time to see him push into a human and stretch his back door so wide around his shaft. Thankfully, your infernal companion knows just how large his manhood his and he keeps things slow, stopping entirely for a moment each time he hears David gasp from the penetration. But as it sinks deeper into the young man's body, pleasant feelings prevail when his shaft rubs David's prostate. Finally he bottoms out inside the young soldier, his huge dick buried all the way in and his two heavy balls pressing against his skin. Groaning deeply, Brutus leans forward to find David's lips and playfully extends his long tongue into the human's mouth. It is quite the sight, especially if one thinks about it - this huge creature of pure muscle who was a ravening beast not too long ago, taking great pleasure in having sex with a much smaller human lover, being as gentle as he can be with his equipment.";
				WaitLineBreak;
				say "     After finishing their heavy make-out session, David breathlessly begs Brutus to begin fucking. The demon begins with slow motions, lifting and pushing David up and down on his purple shaft, the bumps on Brutus's cock rub against the soldier's stretched insides, making him shudder with rising lust. As David's moans become more audibly pleasurable, he's clearly gotten used to have Brutus deep inside him over time, with the demon leaking more and more precum and David's muscles being stretched out and getting used to it. All of which allows your infernal companion to speed up his thrusts, going faster and faster, the slapping noises of his balls against David's hips now coming in rapid succession, each slap eliciting a heavy growl from Brutus, and sometimes a barely audible gasp of 'so good' or 'so tight' from behind his clenched teeth. Soon, this drives the human's arousal over the edge, crying out 'oh fuck!' as his cock sprays cum all over Brutus and his own chest.";
				say "     Overwhelmed with euphoria at getting his friend to climax, and with David's asshole twitching around his cock as he orgasms, Brutus pounds the young soldier at a feverish pace, shouting 'I'm gonna cum!' in a loud growl, and reaches his peak a few quick thrusts later. With a mighty roar, he slams his massive cock all the way into David and begins to pump his bowels full of his demonic seed, every muscle in Brutus' body tensing with each spurt. Easily filling David's asshole and intestines, the remaining cum starts flowing out around the demon's thick cock as he finishes his last quick thrusts. Breathing heavily, Brutus then sits down to lean against the stone wall behind the tents, still holding David against his chest and having him impaled on his cock. They stay like that as their respective orgasms wind down, silently whispering to each other and giving small caresses.";
				WaitLineBreak;
				say "     Eventually, David stands up on shaky legs, a veritable flood of cum splashing out of his hole as he pulls off Brutus cock. As the young man looks down at his lover's creamy load trickling down the inside of his legs, then over to his uniform lying in a small heap nearby, he blows out is breath, clearly wondering how he can make himself presentable again. The purple demon solves that problem by just reaching out and pulling David close again, then licking his own load up from the human's skin and finally burying his face between David's cheeks. The young soldier gasps in renewed lust as Brutus tongue wiggles deep into him, stroking sensitive spots while the demon eats out his human friend. Before long, this stimulation even drives David over the edge to another orgasm, moaning deeply as his cock spurts with blast after blast of cum that splatters the ground in front of him.";
			else:
				say "     Deciding to let them have their 'privacy' - or what passes for it in a semi-public spot like this - you wander over to a nearby tent and have a look inside. Hmm... toilet paper, pens, gun oil, ... there's piles of all kinds of stuff. You check out box by box while hearing the grunts and eventually roars from outside that accompany your friend's coupling. Eventually, the sounds ebb out and you emerge from the tent - your pack now holding the two MRE's that you found and quietly pocketed. Looking around, you see Brutus sitting against the brick wall of the nearby building, with David straddling his hips and impaled on the demon's thick shaft. The two of them rest a while longer like that, panting to catch their breath, then David stands up on shaky legs, a veritable flood of cum splashing out of his hole as he pulls off Brutus cock.";
				say "     As the young man looks down at his lover's creamy load trickling down the inside of his legs, then over to his uniform lying in a small heap nearby, he blows out is breath, clearly wondering how he can make himself presentable again. The purple demon solves that problem by just reaching out and pulling David close again, then licking his own load up from the human's skin and finally burying his face between David's cheeks. The young soldier gasps in renewed lust as Brutus tongue wiggles deep into him, stroking sensitive spots while the demon eats out his human friend. Eventually, this stimulation even drives David over the edge to another orgasm, moaning deeply as his cock spurts with blast after blast of cum that splatters the ground in front of him.";
				increase carried of food by 2;
			WaitLineBreak;
			say "     With David now licked clean, inside and out, he puts on his uniform again as soon as he regains his composure, then all of you make your way to the camp commander's tent. Major Padgett is startled as the large demon enters his presence, but between you and David, you manage to calm him down pretty quickly and explain that Brutus is not a threat - and is indeed quite helpful to your task as a bodyguard. The man huffs, 'I can see that, but he's still a danger. Do you realize what creatures like him do to people they catch?' Brutus interjects, 'Terrible things. They do - I did - terrible things. But... the master made me better. Took away my rage and pain.' The major gets pretty interested as he hears about you being the demon's master and lets you show him the amulet, then says, 'Be sure to include all details about that in your report, agent. This could be a boon for the military. But no matter how... tame your creature might be, after all the reports about others of his kind, I do not think that anyone will relax or let their guard down in his presence.'";
			say "     Since the Major isn't interested in actually talking to Brutus, but rather starts to build cloud-castles about heavy weapons demon support troops, you excuse yourself and walk back out. Brutus remarks, 'There are many masters, bad and... worse. I am happy to actually have been taken into service by a good one. So - thank you again for everything you have done, and letting me meet David.' He lays a hand on David's shoulder and gives him an affectionate squeeze, then the three of you make your way out of the camp and travel back to the library.";
		else: [cuntboy Brutus]
			say "     <placeholder for cuntboy Brutus (sorry, scene wasn't included in the commission)>";
	else if calcnumber is 2: [patrol with Marc]
		say "     Clearing your throat, you loudly call out for Private Orwell and wait for the young man to walk up to you before declaring that he really should be doing a perimeter patrol of the camp. After all, something might try to sneak in, or burrow, or the nanites might be dissolving walls and barricades. Marc's face takes on a knowing look as he realizes that you're still talking quite loud even though he's right in front of you. He gives Private Cooper a quick look from the corner of his eye, then stealthily winks at you before answering loudly, 'Yes Sir! But if there really is an incursion, it'd be best if the patrol force was large enough to deal with whatever it may be straight away. Maybe you and your companions could... accompany me? For the security of the camp, you know.'";
		say "     Demonstratively praising the handsome soldier for his sense of duty and such an excellent idea, you call out that Cooper should hold this position, then lead your whole little group off along the road, on a winding path between several wrecked cars. The dour soldier you leave behind grimaces as if he just took a bite out of a lemon as the target of his raging hate-on is removed from his influence for now, but he can't really protest what you're doing.";
		WaitLineBreak;
		if DemonBruteStatus < 2: [Brutus has a cock]
			if DavidBrutusMarcVar is 0: [first time]
				say "     Soon, the route of your little gang leads you out of earshot and then out of sight of the camp's entrance, at which point Marc Orwell gives a relieved sigh. 'Man, that's really a miserable excuse of a person back there. There literally is no one who likes him - and because I'm on the Major's shit list because of the coffee incident, I'm permanently assigned on shifts with that jackass. But let's talk about something else...' With that, Marc gives a last look back and shakes his head, as if banishing the specter of Cooper from his thoughts. Clearing his throat, he then puts an arm around David's shoulders in camaraderie and asks, 'So - you and Brutus, hm? It's pretty obvious you're a couple. Interesting choice for a boyfriend, but... I can see the appeal.' The blond man lets his eyes wander over Brutus crotch and muscles, then gives the purple giant a charming smile, accompanied by a, 'Nice bod, bro.' Marc meets Brutus eyes and watches him intently for a moment, then asks, 'You treating my boy here good? You'd better be. Soldiers hold together you know.' The demon lowers his head a bit as he answers, 'You are right to mistrust my kind. I was... a beast before the master freed me. But now, I care for David. Deeply.'";
				say "     Satisfied, Marc gives a nod, then asks, 'Great. Then we have that cleared up. Now tell me - how did you end up a couple? I'm pretty curious about it.' David proceeds to lay out the story for the other soldier as you walk along, starting with the day he was almost dragged to hell by a demon, only to be saved by you. 'That bastard got me good before he had his ass handed to him by our friend here - just look at the scars,' David soon explains, pulling off his shirt to show the three long claw-marks on his chest, frowning at the memory of getting them. Marc hisses in sympathy as he sees the scars, gently tracing their shape from bottom to top, then hesitating a second before letting his hand idly stray to David's left nipple. With one playful pinch the blond man instantly breaks the somber mood of the remembered pain, making David squeal, 'Hey!' He bats Marc's hand away quickly, then says with a smile on his face, 'You wanna hear the story or not?'";
				WaitLineBreak;
				say "     After an intentionally over-acted apology by Marc that serves to lighten the atmosphere even more, David goes through the further meetings you two had, then coming to Camp Bravo. 'I sure was frightened of being put in a list to be bred by... you know - him,' he explains, nodding towards the camp as the loud bellow of its resident minotaur reaches your ears, who's right now filling another brave man with a massive load of cum. '...so was a real relief when I came to the library. And then Brutus showed up and gave me this intense look - as it turns out, the other demon had put some dark magic on me. But this handsome devil got rid of that...' David reaches out at that point, brushing his hand affectionately along his otherworldly lover's side, then taking his hand and pulling on it softly. Leaning down, your demonic companion shares a long kiss with the human, breathing heavily by the time their lips pull apart again.";
				say "     'So, he showed me that he's a pretty nice guy, despite being what he is, and... after that, I guess I couldn't help thinking about Brutus. So big and muscular, yet... gentle, in his way. And the brow ridges and horns are sexy as hell, once you get used to them.' Wanting to illustrate his point, David strokes Brutus face, then rubs along the base of his front horns, drawing a lusty rumble from the demon. All of you can feel the warmth radiating from Brutus cock as it quickly goes from half-hard to full mast. 'It wasn't long before a certain someone arranged for us to be alone together, and...' 'I fucked him good,' Brutus interjects in his deep voice, showing a wide tooth-filled smile as he puts a large hand on David's shoulder and wraps his tail around the soldier's hips. 'It was breathtaking how much better sex feels if you really care about the other. I am very thankful that David accepts me as I am, and that the Master allows us to spend time together.'";
				WaitLineBreak;
				say "     Sexual tension almost crackles in the air between the shirtless David and fully erect Brutus, then Marc asks in a smooth voice, 'So... are you two lovebirds open for some fun with others? I always thought you were cute David, and it'd be a shame if I missed the chance to ride such a big boy like Brutus. So, what do you say?' The heavy throb of Brutus shaft at the offer makes his opinion quite obvious, and David also quickly replies, 'Of course! This'll be so hot!' Looking around for a nice spot to get it on, a moderately big lawn in front of a building is chosen, as its high grass will provide at least some comfort - and neither of the three horny guys has the patience to find another spot. As David and Marc start stripping, putting their uniforms and gear in a pile, you take up position to keep the road and other approaches under observation - this is still a wildly chaotic city full of dangerous creatures, after all. Despite not being able to participate, this promises to be quite a bit of fun, as you're having a ringside seat of the hot threesome.";
				say "     Soon, two handsome young men and one towering demon stand naked before you, all of them providing ample eye-candy with hard cocks and well-muscled bodies. After a moment of feasting his eyes on the others, Marc suggests, 'Well, then - Brutus fucks me and I fuck you, David? I wanna feel that thick purple cock inside me and I've had thoughts of fucking you since I first saw you in the showers. Okay? Great! Let's start with a bit of rimming...' Smiling in anticipation, Marc directs David to get on all fours and then takes position behind him, spreading the other man's firm cheeks with his hands and leaning forward to give him a first lick. Brutus is down on the green grass too an eye-blink later, just lying on his stomach with his upper body propped up on both elbows so he can start eating out the blond soldier. His long, forked tongue slithers up and down between Marc's cheeks, drawing a pleased 'Ah ah' from the man, followed by a gasped, 'AaaahHHH - man, that tongue! Wow!' as the demon pushes in against Marc's pucker and his tongue starts to wiggle into the man's back passage.";
				WaitLineBreak;
				say "     The little rimming chain goes on for a while, with Marc loudly moaning from getting tongue-fucked by Brutus while he himself gives quite a bit of pleasure to David with his own talented tongue and fingers. Eventually, the blond man pushes himself up from his position on all fours, reaching back to grab Brutus by one of his horns and panting breathlessly. 'Wait - if you keep that up, I'm gonna cream the grass. And I haven't even been fucked yet,' Marc brings out in a quick burst before he gives another deep moan, most likely from Brutus lapping at his prostate. With a chuckle rumbling in his wide chest, the demon relents, withdrawing from the gay man's love-hole and giving him an appreciative slap on the butt with a hand large enough to cover one whole cheek completely.";
				say "     'He's great, isn't he?' David says as he gets up to a kneeling position himself and turns around. He smiles lovingly at the large demon, prompting Brutus to move up and pull him close for an eager bit of tongue-wrestling. While the two unlikely lovers make out, Marc comes to stand beside you in unashamed nakedness, taking deep breaths till his libido cools down a bit again. 'Phew - I don't think I've ever been rimmed as good as that before. Makes me wonder what he'll be able to do with that cock of his,' the young man tells you with a chuckle, then confidently steps up to the others again. 'Brutus, could you please lie down on your back, with David still in your arms?' Marc asks, and the demon does as requested a moment later.";
				WaitLineBreak;
				say "     With Brutus stretched out on the green grass and David still making out with him, the soldier is now straddling his boyfriend's chest, leaving a space just right for one person between himself and the demon's towering pole. Marc is only too happy to slip right in behind David, running his hands over the other man's muscled back and sides. Then he shouts in a passable imitation of a drill instructor, 'Ready to be fucked soldier?' Pulling his lips from Brutus for a moment, David looks over his shoulder and gives the other man beaming grin, then replies, 'Sir! Yes! Sir!' Marc accept this with an overplayed grudging nod and adds, 'Good man! That's the spirit!' before he whacks his cock between David's buttcheeks a few times and then pushes in against his pucker.";
				say "     A lusty groan comes from the two men as the blond man takes his buddy's well-prepared hole in one fluid thrust, burying his whole cock deep. 'Oooh yeah,' Marc moans as he starts sliding in and out, 'You've got one fine ass on you, man.' Then he puts his hand on Brutus muscled leg, squeezing it as he addresses the demon, 'Did you train our boy like this, my purple friend? *Unngh* Yeah! He knows just when to squeeze a man. *Pant* I'm getting kinda jealous, you know...' Looking past his human lover, Brutus focuses on Marc and replies in a deep voice, [if lust of David is 51]'David let me have his virginity. It was - beautiful, to be given such a gift. I care for him and want to fuck him any chance I get.'[else if lust of David is 52]'Another soldier, wearing fur and a tail took my friend's virginity. I believe his knotted cock taught David a lot. And yeah, he's an amazing lay. I care for him and want to fuck him any chance I get.'[else]'My master took David's virginity. I believe his skilled cock taught David a lot. And yeah, he's an amazing lay. I care for him and want to fuck him any chance I get.'[end if]";
				WaitLineBreak;
				say "     'Right you are on that B,' Marc moans as he bottoms out in David once more, then he continues with, 'But you must be getting a bit blue-balled, with me pounding your boy and all. Let's do something about that!' Leaning back, the blond solder proceeds to slide his hand over Brutus towering pole, saying, 'Oh man, that's a big one,' under his breath. Then he pulls the head a bit forward, aligning the massive cock in just the right way that he can slide back against it as he starts pulling out of David. The gay man gives a very satisfied grunt as Brutus thick cockhead pops past his pucker, then takes a few deep breaths before continuing to sink himself down on the demon's pole. Bit by bit, the huge piece of man-meat vanishes inside Marc's hole, until finally, the orbs of Brutus mighty balls touch the man's buttcheeks and the demon's pubic hair tickles his skin.";
				say "     'I did it!' Marc shouts in the same triumphant tone as a mountain climber on a new peak. He gives David's butt a playful slap and says, 'No wonder you've gotten so good at this in such a short time. You had to, after jumping right in the deep end with an expert bottom's caliber of cock.' David doesn't reply, being too busy making out with his boyfriend, so Marc then just goes ahead to pull the other man's ass a bit closer, creating an unbroken chain of three males connected by their cocks. With Brutus inside his ass, and sinking his own erection into David, Marc starts to move back and forth, taking a thick cock and fucking his army buddy at the same time. The sexy threesome continues for quite a while, with the two lovers in each other's arms, moaning and grunting in between the kisses they share, while Marc does his best to satisfy all of them, fucking himself on Brutus shaft and hammering David's needy hole with his own quite impressive manhood.";
				WaitLineBreak;
				say "     Eventually, Brutus is the first to reach his climax, with the first signs of his impending cum-eruption being a deep, lusty rumble from his broad chest. Lips tightly locked to David's, he lets his hands wander over the smaller human's whole body, and you can see the muscles in his legs start to tense, then flex as the demon thrusts up with his hips. Marc gasps in a mixture of pain and pleasure about the unexpected deep penetration, while he himself is driven forward too, sinking his cock deep into David's hole. With Brutus in this position - spread legs tense to hold up the purple demon's hips, and with his cock almost all the way in Marc, you're treated to quite a show. Above the long tail whipping wildly through the air right now, the purple male's balls pulse in intense rhythmic twitches, sending strings of cum deep into Marc's body. You can literally see his pole get thicker as another blast and another erupts into Marc, causing cum to squish out around the edges of his cock as the man's anal capacity is reached.";
				say "     Being filled like he never has been before obviously turns Marc on immensely. He reaches behind to feel Brutus slick manhood, then brings his hand to his mouth and licks the cum off it. 'Oh boy, David - your man is a real shooter. I'm feeling fuller than even on the night me and the guys in squad eight got pissed together and they gang-banged me. I think I'm in love. Wanna time-share your boyfriend with me?' 'You wish!' David shoots back, looking over his shoulder. Then he adds in a needy pant, 'Now go on fucking me. I'm really close.' 'Sure thing,' Marc replies and starts to slide in and out of the other soldier again, moaning loudly as the movement makes the ring of his pucker slide up and down over Brutus thick shaft and even more cum squish out of his well-bred hole.";
				WaitLineBreak;
				say "     After that, it doesn't take long at all before the two men reach their respective orgasms more or less at the same time, groaning in lust as they start to shoot. Marc blasting his seed deep into David's love-hole, and David splattering Brutus broad chest with his own load, with the creamy cum soon oozing into the dips and valleys between the demon's rock-hard muscles. After all three of them wind down a bit and catch their breaths, Marc gently pulls out of David, groaning as the movement sinks his ass a little bit deeper on Brutus shaft. Then he gets up into a crouch and stretches his legs slowly, eventually resulting in the head of the demon's cock leaving his ass with a loud slurp and a not so little gush of cum.";
				say "     Stepping away from his position over Brutus hips, the blond man feels his stretched asshole for a second, then concentrates on flexing the muscle closed so he doesn't drip cum all over the place. 'Enough to knock up a convent or two,' the soldier jokes to you in a jovial tone, looking down over himself and inspecting the trickle of demonic cum down the inside of his legs. 'Good that I always come prepared,' he chuckles, then goes to dig out a box of wet-wipes out of his backpack. You watch the handsome man use more than a few of them to clean himself up and even do some nude posing for you as he does so. When he eventually finishes, he turns back to David and Brutus with the box in hand as if to offer it, then lets it sink down and gives a chuckle. Having a look yourself, you see that the two of them are now in a classic 69 position, with Brutus tongue buried deep between David's cheeks and the soldier busy lapping at Brutus thick shaft.";
				WaitLineBreak;
				say "     Eventually, all of the guys are cleaned up and presentable again, so you proceed with your perimeter patrol of the camp, chatting merrily as you go along. When you've almost completed a full circuit, you stop at a position still out of sight of Private Cooper and say your goodbyes there. Brutus gives Marc an appreciative nod and says, 'It was fun to meet - and fuck - one of David's compatriots. I am glad to have gained a new friend in you.' Marc replies, 'Same right back at you, big boy. If the two of you wanna have more fun, you know where you can find me...' He pats Brutus thigh and gives his manhood another long look, then grips David hand in a strong handshake between friends and says his goodbyes to you to. With a last wink and 'See you later,' the soldier then makes his way back to his post, while you lead your small party back to the library.";
			else: [repeat]
				say "     Soon, the route of your little gang leads you out of earshot and then out of sight of the camp's entrance, at which point Marc Orwell gives a relieved sigh. 'Man, that's really a miserable excuse of a person back there. There literally is no one who likes him - and because I'm on the Major's shit list because of the coffee incident, I'm permanently assigned on shifts with that jackass. But let's talk about something else...' With that, Marc gives a last look back and shakes his head, as if banishing the specter of Cooper from his thoughts. Clearing his throat, he then puts an arm around David's shoulders in camaraderie and asks, 'So - wanna share your boyfriend with me again? We had so much fun last time... I've been thinking of you two a lot since then.' The purple giant walking beside them gives Marc a nod and lets his eyes wander over the man's trained body, then says, 'Yes, I'd like to fuck him. Hard. Let's do it.'";
				say "     'There you have it,' David says with an insinuating smile towards Marc, then slides his hand under Brutus own and squeezes it in a gesture of affection. 'I wouldn't dream of denying my big buddy what he really wants. And... your shaft did feel quite nice,' the man adds a moment later. Pleased at his human boyfriend's decision, Brutus draws David into his arms, holding him tightly as they share a long kiss. After they eventually pull their lips apart again, and the large demon sets David down back on his feet, there is a marked increase in your group's speed, as everyone hastens their step towards the nice little spot they had their threesome at last time.";
				WaitLineBreak;
				say "     Sexual tension almost crackles in the air between the three males as you arrive at the unmowed lawn in front of one of the buildings nearby, and after dropping their backpacks and gear, David pulls his shirt off right away, adding it to the pile. Boots, socks, pants and finally underwear is added in quick succession, leaving the two soldiers to show off their gloriously nude bodies and Brutus already more than half-hard from watching the show. 'This'll be so hot!' David says in eager anticipation, giving his own cock a few strokes as he gives Brutus and the other soldier loving and lusty looks. While the guys get ready to have some sexy fun, you take up position to keep the road and other approaches under observation - this is still a wildly chaotic city full of dangerous creatures, after all. Despite not being able to participate, this promises to be quite a bit of fun, as you're having a ringside seat of the hot threesome.";
				say "     After a moment of feasting his eyes on the others, Marc suggests, 'Well, then - Brutus fucks me and I fuck you, David? I wanna feel that thick purple cock inside me and I've had thoughts of tapping that ass since I first saw you in the showers. Okay? Great! Let's start with a bit of rimming...' Smiling in anticipation, Marc directs David to get on all fours and then takes position behind him, spreading the other man's firm cheeks with his hands and leaning forward to give him a first lick. Brutus is down on the green grass too an eye-blink later, just lying on his stomach with his upper body propped up on both elbows so he can start eating out the blond soldier. His long, forked tongue slithers up and down between Marc's cheeks, drawing a pleased 'Ah ah' from the man, followed by a gasped, 'AaaahHHH - man, that tongue! Wow!' as the demon pushes in against Marc's pucker and his tongue starts to wiggle into the man's back passage.";
				WaitLineBreak;
				say "     The little rimming chain goes on for a while, with Marc loudly moaning from getting tongue-fucked by Brutus while he himself gives quite a bit of pleasure to David with his own talented tongue and fingers. Eventually, the blond man pushes himself up from his position on all fours, reaching back to grab Brutus by one of his horns and panting breathlessly. 'Wait - if you keep that up, I'm gonna cream the grass. And I haven't even been fucked yet,' Marc brings out in a quick burst before he gives another deep moan, most likely from Brutus lapping at his prostate. With a chuckle rumbling in his wide chest, the demon relents, withdrawing from the gay man's love-hole and giving him an appreciative slap on the butt with a hand large enough to cover one whole cheek completely.";
				say "     'He's great, isn't he?' David says as he gets up to a kneeling position himself and turns around. He smiles lovingly at the large demon, prompting Brutus to move up and pull him close for an eager bit of tongue-wrestling. While the two unlikely lovers make out, Marc comes to stand beside you in unashamed nakedness, taking deep breaths till his libido cools down a bit again. 'Phew - I kinda want to just let him get me off with that tongue alone. But no, Brutus cock is just too tempting. I wanna feel that massive prick inside me again,' the young man tells you with a chuckle, then confidently steps up to the others again. 'Brutus, could you please lie down on your back, with David still in your arms?' Marc asks, and the demon does as requested a moment later.";
				WaitLineBreak;
				say "     With Brutus stretched out on the green grass and David still making out with him, the soldier is now straddling his boyfriend's chest, leaving a space just right for one person between himself and the demon's towering pole. Marc is only too happy to slip right in behind David, running his hands over the other man's muscled back and sides. Then he shouts in a passable imitation of a drill instructor, 'Ready to be fucked soldier?' Pulling his lips from Brutus for a moment, David looks over his shoulder and gives the other man beaming grin, then replies, 'Sir! Yes! Sir!' Marc accept this with an overplayed grudging nod and adds, 'Good man! That's the spirit!' before he whacks his cock between David's buttcheeks a few times and then pushes in against his pucker. A lusty groan comes from the two men as the blond man takes his buddy's well-prepared hole in one fluid thrust, burying his whole cock deep. 'Oooh yeah,' Marc moans as he starts sliding in and out, 'You've got one fine ass on you, man.'";
				say "     Enjoying some hard thrusts into David's depths, his hips slapping against the other man's ass, Marc fucks David for a moment in total concentration, then eventually pauses and takes a deep breath. You can see that he literally has to force himself to stop, only pulling his hand away from David's hips after a moment of hesitation. 'Sorry Brutus, you must be getting a bit blue-balled, with me just pounding your boy and all. Let's do something about that!' Leaning back, the blond solder proceeds to slide his hand over Brutus towering pole, saying, 'Oh man, I love how big this fucker is,' under his breath. Then he pulls the head a bit forward, aligning the massive cock in just the right way that he can slide back against it as he starts pulling out of David. The gay man gives a very satisfied grunt as Brutus thick cockhead pops past his pucker, then takes a few deep breaths before continuing to sink himself down on the demon's pole. Bit by bit, the huge piece of man-meat vanishes inside Marc's hole, until finally, the orbs of Brutus mighty balls touch the man's buttcheeks and the demon's pubic hair tickles his skin.";
				WaitLineBreak;
				say "     'I did it!' Marc shouts in the same triumphant tone as a mountain climber on a new peak. He gives David's butt a playful slap and says, 'No wonder you've gotten so good at this in such a short time. You had to, after jumping right in the deep end with an expert bottom's caliber of cock.' David doesn't reply, being too busy making out with his boyfriend, so Marc then just goes ahead to pull the other man's ass a bit closer, creating an unbroken chain of three males connected by their cocks. With Brutus inside his ass, and sinking his own erection into David, Marc starts to move back and forth, taking a thick cock and fucking his army buddy at the same time. The sexy threesome continues for quite a while, with the two lovers in each other's arms, moaning and grunting in between the kisses they share, while Marc does his best to satisfy all of them, fucking himself on Brutus shaft and hammering David's needy hole with his own quite impressive manhood.";
				say "     Eventually, Brutus is the first to reach his climax, with the first signs of his impending cum-eruption being a deep, lusty rumble from his broad chest. Lips tightly locked to David's, he lets his hands wander over the smaller human's whole body, and you can see the muscles in his legs start to tense, then flex as the demon thrusts up with his hips. Marc gasps in a mixture of pain and pleasure about the unexpected deep penetration, while he himself is driven forward too, sinking his cock deep into David's hole. With Brutus in this position - spread legs tense to hold up the purple demon's hips, and with his cock almost all the way in Marc, you're treated to quite a show. Above the long tail whipping wildly through the air right now, the purple male's balls pulse in intense rhythmic twitches, sending strings of cum deep into Marc's body. You can literally see his pole get thicker as another blast and another erupts into Marc, causing cum to squish out around the edges of his cock as the man's anal capacity is reached.";
				WaitLineBreak;
				say "     Being filled like this obviously turns Marc on immensely. He reaches behind to feel Brutus slick manhood, then brings his hand to his mouth and licks the cum off it. 'Oh boy, David - your man is a real shooter. I'm feeling fuller than even on the night me and the guys in squad eight got pissed together and they gang-banged me. I think I'm in love. Wanna time-share your boyfriend with me?' 'You wish!' David shoots back, looking over his shoulder. Then he adds in a needy pant, 'Now go on fucking me. I'm really close.' 'Sure thing,' Marc replies and starts to slide in and out of the other soldier again, moaning loudly as the movement makes the ring of his pucker slide up and down over Brutus thick shaft and even more cum squish out of his well-bred hole.";
				say "     After that, it doesn't take long at all before the two men reach their respective orgasms more or less at the same time, groaning in lust as they start to shoot. Marc blasting his seed deep into David's love-hole, and David splattering Brutus broad chest with his own load, with the creamy cum soon oozing into the dips and valleys between the demon's rock-hard muscles. After all three of them wind down a bit and catch their breaths, Marc gently pulls out of David, groaning as the movement sinks his ass a little bit deeper on Brutus shaft. Then he gets up into a crouch and stretches his legs slowly, eventually resulting in the head of the demon's cock leaving his ass with a loud slurp and a not so little gush of cum.";
				WaitLineBreak;
				say "     Stepping away from his position over Brutus hips, the blond man feels his stretched asshole for a second, then concentrates on flexing the muscle closed so he doesn't drip cum all over the place. 'Enough to knock up a convent or two,' the soldier jokes to you in a jovial tone, looking down over himself and inspecting the trickle of demonic cum down the inside of his legs. 'Good that I always come prepared,' he chuckles, then goes to dig out a box of wet-wipes out of his backpack. You watch the handsome man use more than a few of them to clean himself up and even do some nude posing for you as he does so. When he eventually finishes, he turns back to David and Brutus with the box in hand as if to offer it, then lets it sink down and gives a chuckle. Having a look yourself, you see that the two of them are now in a classic 69 position, with Brutus tongue buried deep between David's cheeks and the soldier busy lapping at Brutus thick shaft.";
				LineBreak;
				say "     Eventually, all of the guys are cleaned up and presentable again, so you proceed with your perimeter patrol of the camp, chatting merrily as you go along. When you've almost completed a full circuit, you stop at a position still out of sight of Private Cooper and say your goodbyes there. Brutus gives Marc an appreciative nod and says, 'It was fun to meet - and fuck - one of David's compatriots. I am glad to have gained a new friend in you.' Marc replies, 'Same right back at you, big boy. If the two of you wanna have more fun, you know where you can find me...' He pats Brutus thigh and gives his manhood another long look, then grips David hand in a strong handshake between friends and says his goodbyes to you to. With a last wink and 'See you later,' the soldier then makes his way back to his post, while you lead your small party back to the library.";
		else: [cuntboy Brutus]
			say "     <placeholder for cuntboy Brutus (sorry, scene wasn't included in the commission)>";

to say DavidTalk7:
	say "     Pulling David aside to have a quiet word, you explain to him what you learned from Brutus, bringing up the dark urges of domination the demon still harbors. The young man is taken aback, more than a little shocked at this revelation, then looks aside for a moment to think about what you just told him. After a quiet moment, he swallows visibly, then focuses on you and says, 'I will stand by him. Help Brutus through this. He's fighting part of himself - for me. So... the least I can do let him know I love him, no matter what.' A brave decision, knowing David's history with that other demon - but then, you didn't expect otherwise from the man you know him to be.";
	say "     Shortly afterwards, the soldier comes to stand in front of his large demonic friend, stares directly into his eyes and gives him the same words, resolute in his decision. Brutus is left gobsmacked as the fear of losing David over all of this crumbles before the open affection shown by this human, his human, and he snatches the soldier up in a tight embrace.";
	LineBreak;
	say "     So now there at least are no secrets between them - but you still have to solve the underlying problem. Some sort of specialist in demonic matters and/or interspecies breeding should be able to help, hopefully.";
	now libido of David is 61;

after of going to Parade Ground while HP of David is 1:
	now HP of David is 2;
	say "     As you enter Camp Bravo, you see a familiar face standing on the parade ground - it's David Jackson, your handsome Private from out in the city. He's watching the minotaur with a bit of a wide-eyed expression. Moving up to him, you say hello.";
	LineBreak;
	project the figure of David_face_icon;
	say "     'Hello again. I was told there might be a special agent coming to talk to us, but I never thought it'd be you. You never told me you're with the government...' You apologize, giving him some airy explanation about needed secrecy and gathering unbiased information. Quickly leading over to another topic, you ask him about what he thinks about the Camp.";
	say "     David points over at the minotaur, saying 'Just look at the thing - it's huge. Almost couldn't believe it when the first group of men came out and it stuck its cock up their asses and fucked them. And the whole story about why we're doing this sounds a bit fishy to me... but orders are orders.' He gives the minotaur another look and rubs his ass. 'I worry a bit that it'll be my turn soon...'";

after of going to Parade Ground while thirst of David is 5 and HP of David is 3:
	say "     As you step on the parade ground of Camp Bravo, David walks up to you and pulls you aside, saying he has something important to talk to you about. He looks a bit embarrassed about it, hesitating before he says 'Listen, you saved me from minotaur duty, and I like being with you and... you know. I wanted to ask how you see - you and me - us.' He looks at you with an earnest and hopeful expression.";
	project the figure of David_face_icon;
	say "     [bold type]What do you tell him?[roman type][line break]";
	say "     ([link]Y[as]y[end link]) - You think there's something more between him and you...";
	say "     ([link]N[as]n[end link]) - You just see him as a fuck buddy.";
	if player consents:
		LineBreak;
		now thirst of David is 20; [boyfriend]
		say "     He smiles and gives you a kiss and a tight embrace.";
	else:
		LineBreak;
		now thirst of David is 10; [fuck-buddy]
		say "     'Oh, ok - just buddies, you say. I'll go back to Ann then when all this is over.'";

after of going to Bunker while Dexterity of David is 0 and HP of David is 4 and (DavidBunkerEntry - turns > 8) and Sven is in bunker and HP of Sven >= 8 and HP of Sven < 50:
	if debugactive is 1:
		say "     DEBUG: DAVID/SVEN (DEXTERITY 0) WALKIN[line break]";
	if HP of Sven < 30: [pet Sven]
		say "     As you enter the bunker, you swing by the rows of beds set up in the room and find David in one of them, stretched out on his back and sleeping. The thin blanket he's under is showing a large tent over his crotch, making it pretty obvious that he's got a boner right now. That must be one nice dream he's having. And you're not the only one who noticed that - not far away, Sven is sitting cross-legged on his own bed, stealing glances at the sleeping man. The snowmeow shyly lowers his gaze and flirts his long tail through the air in front of himself as he notices your attention. It's clear that he's... interested in David, though he'd never make a first move, being as shy and submissive as he is - and your pet on top of that.";
		LineBreak;
		say "     Do you want to tell Sven that he should... give David's dream a happy ending ([link]Y[as]y[end link]), or do you let things stand as they are, with him just looking ([link]N[as]n[end link])? ";
		if player consents:
			now Dexterity of David is 1; [he gets a blowjob]
			LineBreak;
			say "     Walking over to the snow leopard, you sit down beside him and stroke his fur, getting a pleased sigh and rumbling purr from him. Your affectionate snowmeow pet snuggles up to your touch, purring a bit louder as you rub his soft-furred belly, then gives a slight moan as your hand reaches down to cup his balls and fondles them. After petting him some more till he's pretty aroused and about half-hard, you whisper in Sven's ear what you'd like him to do next. Sven quickly looks over to David again and blushes brightly in his ears. 'While he's sleeping? I... I could not. It would be so forward,' he says as his cock throbs hard in your hand, your kitty clearly aroused at the thought of doing something so naughty as that.";
			say "     'Do it, my pet. You know you want to,' you tell him, giving him a pat on his rear in the right direction for added encouragement. There is a last little moment of hesitation as he looks back to you, then David, and back again, followed by a happy kiss on your cheek. Then your horny little kitty almost flows out of the bed, silently stalking over to the soldier's bed in all his feline grace. Carefully taking hold of David's blanket, he slowly pulls it off, grinning wider and wider as more and more of the sleeping man's naked body comes into sight.";
			WaitLineBreak;
			say "     Soon, the blanket is in a small heap at the foot of the bed, with David's naked body in full view of everyone and his hard cock standing up like a flagpole. Sven almost pounces on it in his eagerness, taking the young soldier's cock in a hand-paw and licking up and down its side before giving its head a little peck and then sliding his muzzle down over David's shaft. As the snowmeow goes down on him, soft moans start coming from the still sleeping David, his dream seemingly going into a more active phase to follow his body's impressions. In between the moans, he mumbles a bit, slowly getting more coherent while getting the blowjob, until there finally is an understandable 'Yeah, suck it baby.' and one of David's hands grabs Sven's head to pull him down against his crotch.";
			say "     It's pretty obvious that he's mostly awake now, though he still has his eyes closed and thinks this is all still part of his dream. Moving his other hand to grab Sven's head too, David pulls him down on his shaft with quickly growing urgency, then thrusts his hips upwards with a grunt as he orgasms, blowing his load into the eager kitty's mouth. His whole body twitches with each blast of cum and the soldier is panting audibly by the time he's done shooting.";
			say "     His climax over, the satisfied soldier raises his head and looks down with a sleepy expression at the kitty - who grins shyly and dips his ears nervously, fretting he might be in trouble. But David only smiles groggily and says 'Huh? *pant* Sven? That felt *pant* amazingly *pant* good.' Sven purrs in relief and David continues 'Pretty kzzzZZZ...', falling asleep again, rather worn out by the climax after his sudden awakening. Sven dutifully puts the blanket back on him, then bounces back to you to thanks you for being such a great [if cunts of player > 0 and cocks of player is 0]mistress[else]master[end if] by encouraging your kitty pet.";
		else:
			now Dexterity of David is 99; [no blowjob from Sven]
			LineBreak;
			say "     Walking over to the snow leopard, you sit down beside him and stroke his fur, getting a pleased sigh and rumbling purr from him. After a few minutes with your affectionate snowmeow pet, relaxing as you rub his soft belly-fur and he snuggles up to your touch, you stand up and turn your attention back to the task of surviving in this changed city.";
	else: [confident Sven]
		say "     As you enter the bunker, you swing by the rows of beds set up in the room and find David in one of them, stretched out on his back and sleeping. The thin blanket he's under is showing a large tent over his crotch, making it pretty obvious that he's got a boner right now. That must be one nice dream he's having. And you're not the only one who noticed that - not far away, Sven is sitting cross-legged on his own bed, stealing glances at the sleeping man. The snow-leopard grins at you, then nods towards David and flirts his long tail through the air in a flowing, sinuous movement. It is clear that the anthro cat has more than a little bit of interest in the other man. Then from one moment to the next, he's on his feet, stalking towards the sleeping soldier on silent paw-pads.";
		LineBreak;
		say "     [bold type]Do you want to watch what Sven's planning to do with David ([link]Y[as]y[end link]), or will you intercept him, making sure that David sleeps unmolested ([link]N[as]n[end link])?[roman type][line break]";
		if player consents:
			now Dexterity of David is 1; [he gets a blowjob]
			LineBreak;
			say "     As you watch, Sven quickly closes up to the bed in which David is sleeping, then sits down on its edge slowly, not wanting to wake the man up (yet). With a low purr humming in his chest, the snow leopard leans over the sleeping soldier, his paw-hand barely touching David as he runs it over the man's chest, feeling the warmth of his skin through the thin sheet covering his chest. Then the anthro feline reaches the tent standing over David's crotch and brushes his fingers over the stretched fabric, reaching the top and giving the soldier's erection a teasing rub. A moan is audible as the man stirs a little bit, then relaxes again into his pillow. You hear Sven's purr become a little louder, with his tail swishing through the air in excitement - seems he likes dancing on the edge of being caught... and possibly being caught too, under the right circumstances.";
			say "     Waiting a few seconds to make sure that David is all the way relaxed again, Sven then carefully takes hold of the blanket and starts to pull it off. More and more of the sleeping man's body comes into sight, first his strong arms and chest revealed inch by muscled inch, then the first hints of his pubic hair in a little treasure trail down from his navel, ending in a well-trimmed bush on his crotch. Soon, the blanket is in a small heap at the foot of the bed, with David's naked body in full view and his hard cock standing up like a flagpole. Sven focuses on it as if in a trance and leans down to take the young soldier's cock in a hand-paw. He gently licks up and down its side before giving its head a little peck and then sliding his muzzle down over David's shaft. As the snow leopard goes down on him, soft moans start coming from the still dozing David, his dream seemingly going into a more active phase to follow his body's impressions.";
			WaitLineBreak;
			say "     In between the rising moans, David mumbles a bit, slowly getting more coherent while getting the blowjob, until there finally is an understandable 'Yeah, suck it baby,' and one of David's hands grabs Sven's head to pull him down against his crotch. It is pretty obvious that he's mostly awake now, though he still has his eyes closed and thinks this is all still part of his dream. Moving his other hand to grab Sven's head too, David pulls him down on his shaft with quickly growing urgency, then thrusts his hips upwards with a grunt as he orgasms, blowing his load into the eager kitty's mouth. His whole body twitches with each blast of cum and the soldier is panting audibly by the time he's done shooting.";
			say "     His climax over, the satisfied soldier raises his head and looks down with a sleepy expression at the snow leopard - who grins impishly at him and flicks his ears while giving a playful purr. David only smiles groggily and says 'Huh? *pant* Sven? That felt *pant* amazingly *pant* good.' Sven purrs in pleasure and David continues 'You're one sexy kzzzZZZ...', falling asleep again, rather worn out by the climax after his sudden awakening. Sven dutifully puts the blanket back on him, then bounces up from the bed, winking at you as he flounces back to his own cot.";
		else:
			now Dexterity of David is 99; [no blowjob from Sven]
			LineBreak;
			say "     Walking over towards David's bed, you shake your head at Sven as he sits down next to the sleeping man, but the snow leopard doesn't really notice it, being all eyes for the handsome soldier. He has already started to gently tug the blanket off David by the time you get there, revealing part of the man's naked, muscular chest. Then you're up close and in Sven's face, doing your best to keep quiet and not wake David as you give the snow leopard a clear head-shake in negation and make shooing motions away from the soldier.";
			say "     Sven looks from you to the sleeping man, pointing at the two of you and pantomiming with his hands gripping each other, then shrugs and gives a bit of a disappointed huff. He throws you a somewhat reluctant nod, then leans in and teasingly runs his hand over the curve of David's erection, making the man moan in his sleep. After steeling that little touch, the snow leopard gives David a last hungry look before flouncing away. This leaves you standing next to a still sleeping soldier, leaving the man none the wiser that he almost got a 'happy ending' to his dream from your feline friend.";

after of going to Bunker while Dexterity of David is 1 and HP of David is 4 and Sven is in bunker and HP of Sven >= 8 and HP of Sven < 50:
	if debugactive is 1:
		say "     DEBUG: DAVID/SVEN (DEXTERITY 1) WALKIN[line break]";
	if HP of Sven < 30: [pet Sven]
		if cunts of player > 0 and cocks of player is 0: [female player]
			say "     As you enter the bunker, you see David sitting on one of the closer beds, right next to Sven. They're talking and you overhear David say '...so let me get this straight, you're -' 'Her pet, yes. She saved me and brought me here, takes care of me - the best and strongest and bravest mistress one can have. She even gave me this nice collar. I love her and am hers.' Sven happily replies, smiling at the young soldier as he praises you. David looks slightly nonplussed at the transformed student's so totally submissive behavior, then shrugs to himself and says 'Well, if that's what you want.' After a quick look down at his crotch and with his cheeks reddening slightly, he continues 'Err - about what you did earlier... thanks? That was... pretty amazing. I thought I was dreaming till after I came and realized you felt pretty furry.'";
			say "     Sven blushes at the hesitant compliment and ducks momentarily behind his fluffy tail. 'Anything for my mistress's friends,' he says softly. Releasing his furry appendage, he lets it wind around David's waist as he slips up beside him, nuzzling against the young man's shoulder. 'And... and I like you too - you are very nice and very attractive,' he adds quietly as he snuggles all the closer. Confronted with such a soft-spoken and cuddly snowmeow, David can't help himself but stroke Sven's fur too, accepting this strange bunker-mate for what he is.";
		else: [male/herm/neuter player]
			say "     As you enter the bunker, you see David sitting on one of the closer beds, right next to Sven. They're talking and you overhear David say '...so let me get this straight, you're -' 'His pet, yes. He saved me and brought me here, takes care of me - the best and strongest and bravest master one can have. He even gave me this nice collar. I love him and am his.' Sven happily replies, smiling at the young soldier as he praises you. David looks slightly nonplussed at the transformed student's so totally submissive behavior, then shrugs to himself and says 'Well, if that's what you want.' After a quick look down at his crotch and with his cheeks reddening slightly, he continues 'Err - about what you did earlier... thanks? That was... pretty amazing. I thought I was dreaming till after I came and realized you felt pretty furry.'";
			say "     Sven blushes at the hesitant compliment and ducks momentarily behind his fluffy tail. 'Anything for my master's friends,' he says softly. Releasing his furry appendage, he lets it wind around David's waist as he slips up beside him, nuzzling against the young man's shoulder. 'And... and I like you too - you are very nice and very attractive,' he adds quietly as he snuggles all the closer. Confronted with such a soft-spoken and cuddly snowmeow, David can't help himself but stroke Sven's fur too, accepting this strange bunker-mate for what he is.";
	else: [confident Sven]
		say "     As you enter the bunker, you see David sitting on one of the closer beds, right next to Sven. They're talking and you overhear David say '...so let me get this straight, you're an exchange student?' Sven replies, 'Yes I am, from Norway. I was hiding out in my basement apartment after things went crazy and I had a run-in with a horny snow leopard. After he... forced me to do things, I did not dare go out anymore, I was too afraid. So I was really glad when our shared friend found me and helped out with some much needed water. But after a few days - that leopard bastard sniffed my place out - or maybe he just stumbled upon it. No matter what, he tried to break in, but we fought him off together and I saw that he wasn't so tough after all...' After Sven falls silent, David in turn recounts your meeting with him, telling Sven about your heroics with the demon brute and getting him out of the 'safety' of Camp Bravo and being fucked by a minotaur.";
		say "     The two of them chat a bit more about this and that, then eventually David glances down to his crotch and over at his own bed. His cheeks redden slightly and he says, 'Err - about what you did earlier... thanks? That was... pretty amazing. I thought I was dreaming till after I came and realized you felt pretty furry.' Sven smiles at the hesitant compliment and playfully flirts his tail under the handsome soldier's nose. 'Sorry if I caught you a bit by surprise there, but... if I learned anything from all this, it is that you just sometimes have to go for it,' he says softly, then winks at the man and adds, 'Just wanted to give that dream of yours a happy ending.' Letting his tail settle down a bit more, the snow leopard winds it around David's waist as he slips closer beside him, nuzzling against the young man's shoulder. 'And who could resist helping out such a hunk as yourself,' he adds in a husky tone, sliding an arm around David's shoulders. Confronted with the soft-spoken and quite touch-friendly feline, David can't help himself but stroke Sven's fur too, accepting this furred bunker-mate's affection.";
	now Dexterity of David is 2;

after of going to Bunker while thirst of David is 5 and HP of David is 4:
	if debugactive is 1:
		say "     DEBUG: DAVID (THIRST 5) RELATIONSHIP WALKIN[line break]";
	say "     As you step on the parade ground of Camp Bravo, David walks up to you and pulls you aside, saying he has something important to talk to you about. He looks a bit embarrassed about it, hesitating before he says 'Listen, you saved me from minotaur duty, and I like being with you and... you know. I wanted to ask how you see - you and me - us.' He looks at you with an earnest and hopeful expression.";
	project the figure of David_face_icon;
	say "     [bold type]What do you tell him?[roman type][line break]";
	LineBreak;
	say "     ([link]Y[as]y[end link]) - You think there's something more between him and you...";
	say "     ([link]N[as]n[end link]) - You just see him as a fuck buddy.";
	if player consents:
		LineBreak;
		now thirst of David is 20; [boyfriend]
		say "     He smiles and gives you a kiss and a tight embrace.";
	else:
		LineBreak;
		now thirst of David is 10; [fuck-buddy]
		say "     'Oh, ok - just buddies, you say. I'll go back to Ann then when all this is over.";

after of going to Bunker while Eric is in bunker and thirst of David > 5 and HP of David is 4 and HP of Eric > 0 and lust of Eric is 0: [David spots Eric's genitals and wants to talk about them]
	if debugactive is 1:
		say "     DEBUG: DAVID/ERIC (LUST [lust of DAVID]) 1 WALKIN[line break]";
	project the figure of David_face_icon;
	say "     As you enter the bunker, David walks up to you and pulls you to the side, whispering he has something talk to you about. He looks a bit embarrassed about it, and you notice his eyes straying over to where Eric sits on his bunk (reading something with his back to you) before he continues. 'I - I accidentally saw Eric when he changed his clothes. I didn't spy on him or anything, it just happened, and... he's...'";
	if HP of Eric is 1:
		say "     '...a woman, down below. I didn't know the infections could do that - change only your gender and nothing else. It must be very strange for him.'";
		LineBreak;
		say "     You explain that Eric was bitten and got that rather surprising transformation out of it, leaving him a bit conflicted about his new form. You can't help but think to yourself that maybe you should talk to him about that sometime... either he has to accept his new gender, or maybe you could help find a 'cure' somewhere. Meanwhile, David looks over to Eric and opens his mouth to ask another question, but you put a hand on his arm and shake your head. Explaining that you don't really want to gossip about Eric, you suggest he ask the young man himself - and that he should be nice about it, as Eric has been through a lot.";
		now lust of Eric is 1;
	else if (HP of Eric > 9 and HP of Eric < 16):
		say "     '...a woman, down below. I didn't know the infections could do that - change only your gender and nothing else. It must be very strange for him.'";
		LineBreak;
		say "     You explain that Eric was bitten and got that rather surprising transformation out of it, leaving him a bit conflicted about his new form. You can't help but think to yourself that hopefully, he'll accept his new gender in time. Meanwhile, David looks over to Eric and opens his mouth to ask another question, but you put a hand on his arm and shake your head. Explaining that you don't really want to gossip about Eric, you suggest he ask the young man himself - and that he should be nice about it, as Eric has been through a lot.";
		now lust of Eric is 1;
	else if HP of Eric is 20:
		say "     '...a woman, down below. I didn't know the infections could do that - change only your gender and nothing else. It must be very strange for him.'";
		LineBreak;
		say "     You explain that Eric was bitten and got that rather surprising transformation out of it, leaving him a bit conflicted about his new form. You can't help but think to yourself about ways to 'fix' him. Meanwhile, David looks over to Eric and opens his mouth to ask another question, but you put a hand on his arm and shake your head. Explaining that you don't really want to gossip about Eric, you suggest he ask the young man himself - and that he should be nice about it, as Eric has been through a lot.";
		now lust of Eric is 1;
	else if HP of Eric is 21 or HP of Eric is 22:
		say "     '...got a horse's penis. But he's human everywhere else. I didn't know the infections could do that - change only your genitals without the rest. It must be very strange for him.'";
		say "     You start explaining that he should have seen Eric before - then stop yourself, as the young man might not appreciate gossip about his personal issues. Meanwhile, David looks over to Eric and opens his mouth to ask another question, but you put a hand on his arm and shake your head. Explaining that you don't really want to go into any more detail, you suggest he ask the student himself - and that he should be nice about it, as Eric has been through a lot.";
		now lust of Eric is 1;
	else if HP of Eric is 31 or HP of Eric is 32:
		say "     '...got a goat's penis. But he's human everywhere else. I didn't know the infections could do that - change only your genitals without the rest. It must be very strange for him.'";
		say "     You start explaining that he should have seen Eric before - then stop yourself, as the young man might not appreciate gossip about his personal issues. Meanwhile, David looks over to Eric and opens his mouth to ask another question, but you put a hand on his arm and shake your head. Explaining that you don't really want to go into any more detail, you suggest he ask the student himself - and that he should be nice about it, as Eric has been through a lot.";
		now lust of Eric is 1;
	else if HP of Eric is 99:
		say "     '...a woman, down below. I didn't know the infections could do that - change only your gender and nothing else. It must be very strange for him.'";
		LineBreak;
		say "     You just tell him not to worry about it - Eric's got a pussy now and needs to be fucked. Maybe he wants a ride too? David opens his mouth as if to say something, then stops and shakes his head 'I couldn't just take advantage of him - we're supposed to help people.'";
		LineBreak;
		say "     His moment of hesitation tells you that David wouldn't be completely adverse to fucking your submissive cuntboy. If you could get him over the initial hangup and into that juicy pussy... maybe you should talk to Eric about making that happen.";
		now lust of Eric is 2;
	else:
		say "ERROR-Eric-[HP of Eric]C: He isn't in one of the states he should be in! Please report how you got to this message.";

after of going to Bunker while Erica is in bunker and thirst of David > 5 and HP of David is 4 and HP of Eric is 200 and (lust of Erica is 0 or lust of Erica is 50): [David finds out about Erica]
	if debugactive is 1:
		say "     DEBUG: DAVID/ERICA (LUST [lust of DAVID]) 1 WALKIN[line break]";
	project the figure of David_face_icon;
	if lust of Erica is 0:
		say "     As you enter the bunker, David walks up to you and pulls you to the side, whispering he has something talk to you about. He looks a bit embarrassed about it, and you notice his eyes straying over to where Erica sits on her bunk (reading something with her back to you) before he continues. 'I - I accidentally found Erica's student ID, and it... says she - he - is named Eric and a guy. It was just lying on the ground over there, must have fallen out of his pocket. Just so you know I didn't dig through his stuff, but...' David gets somewhat red-faced as he searches for words, then clears his throat suddenly and brings out, 'He's - she's - really cute, but... is she a transvestite?'";
		say "     You shake your head and reply that that's not quite it and make some vague mentions of Erica's extraordinary transformations, as compared to the regular stuff going on these days. David looks over to Erica and opens his mouth to ask for specifics, but you put a hand on his arm and shake your head. After all, Erica might not want just anyone to know everything about her, so David will just have to ask her himself if he is curious enough. That explanation seems enough for the young man... for now, but the interested gleam in his eye shows you that it won't be the end of it with him.";
	else if lust of Erica is 50:
		say "     As you enter the bunker, David walks up to you and pulls you to the side, whispering he has something talk to you about. He looks a bit embarrassed about it, and you notice his eyes straying over to where Erica sits on her bunk (reading something with her back to you) before he continues. 'So... I saw you take Eric aside earlier and didn't want to intrude but... he looks so different than before.' David's hands make a little circling movement over his chest and face, then he continues, 'He's - she's - really cute, but... is she a transvestite and you helped her come out or something?'";
		say "     You shake your head and reply that that's not quite it and make some vague mentions of Erica's extraordinary transformations, as compared to the regular stuff going on these days. David looks over to Erica and opens his mouth to ask for specifics, but you put a hand on his arm and shake your head. After all, Erica might not want just anyone to know everything about her, so David will just have to ask her himself if he is curious enough. That explanation seems enough for the young man... for now, but the interested gleam in his eye shows you that it won't be the end of it with him.";
	now lust of Erica is 1;

after of going to Bunker while Eric is in bunker and thirst of David > 5 and HP of David is 4 and HP of Eric > 0 and lust of Eric is 1: [David talks with Eric about his gender and they exchange stories]
	if debugactive is 1:
		say "     DEBUG: DAVID/ERIC TALK WALKIN[line break]";
	say "     As you enter the bunker, you see David and Eric sitting together on one of the far bunks, talking. Curious about what's going on, you unobtrusively walk closer and overhear:";
	LineBreak;
	say "     [DavidEricTalk]";

An everyturn rule: [you can just wait for them to talk too]
	if player is in bunker and Eric is in bunker and thirst of David > 5 and HP of David is 4 and HP of Eric > 0 and lust of Eric is 1:
		say "     As you spend some time in the bunker, you notice David and Eric sitting together on one of the far bunks, talking. Curious about what's going on, you unobtrusively walk closer and overhear:";
		LineBreak;
		say "     [DavidEricTalk]";
	if BrutusEscalationTimer > 1:
		decrease BrutusEscalationTimer by 1;
	else if BrutusEscalationTimer is 1:
		now libido of David is 81; [The urges push through]
		now BrutusEscalationTimer is 0;

after of going to Bunker while Erica is in bunker and thirst of David > 5 and HP of David is 4 and HP of Erica > 0 and lust of Erica is 1: [David talks with Erica and they exchange stories]
	if debugactive is 1:
		say "     DEBUG: DAVID/Erica TALK WALKIN[line break]";
	say "     As you enter the bunker, you see David and Erica sitting together on one of the far bunks, talking. Curious about what's going on, you unobtrusively walk closer and overhear:";
	LineBreak;
	say "     [DavidEricaTalk]";

An everyturn rule: [you can just wait for them to talk too]
	if player is in bunker and Erica is in bunker and thirst of David > 5 and HP of David is 4 and HP of Erica > 0 and lust of Erica is 1:
		say "     As you spend some time in the bunker, you notice David and Erica sitting together on one of the far bunks, talking. Curious about what's going on, you unobtrusively walk closer and overhear:";
		LineBreak;
		say "     [DavidEricaTalk]";

instead of going to Bunker while HP of David is 4 and (libido of David is 57): [David wants Brutus to get out more]
	move player to Bunker;
	if debugactive is 1:
		say "     DEBUG: DAVID/BRUTUS TRIP INTERACTION[line break]";
	project the figure of David_face_icon;
	say "     As you enter the bunker, David is already waiting for you and waves you over. When you come closer, he says, 'I've been thinking... about Brutus, you know. He's never had a normal life, has he? Just forever as a rampaging beast like that one demon who attacked me.' The young man shudders, rubbing the healed claw-mark on his side as he thinks back to it, then catches himself and continues, 'So - how about we take Brutus out for a nice trip or two, show him what he's been missing. Come on, it'll be good for him and between the three of us, there shouldn't be too much danger in going outside. I bet you know a few nice places to visit. Just talk to me if you wanna go out...'";
	now libido of David is 58;

instead of going to Bunker while HP of David is 4 and (libido of David is 0 or libido of David is 1 or libido of David is 50 or libido of David is 52 or libido of David is 58 or libido of David is 81 or libido of David is 83) and companion of player is demon brute: [David reacts when the player comes in with the demon brute pet]
	move player to Bunker;
	if debugactive is 1:
		say "     DEBUG: DAVID/BRUTUS INTERACTION 1[line break]";
	if libido of David is 0: [first time David sees the player with a demon brute]
		if DBCaptureQuestVar is 5: [original, evil Brutus]
			say "     As you enter the bunker with your demon brute pet in tow and David spots it, he jumps up from where he was sitting on one of the many cots and shouts 'Watch out, there's a dem...', then suddenly falls silent as he realizes the big creature is following you and controlled. 'What the fuck?' he says, still a bit shocked and wide-eyed. Explaining that you've got him tightly controlled and the demon can't hurt him, you assure David that he can calm down. The young soldier accepts your word on it, but still moves to distance himself from the demon brute as far as possible.";
			if (DemonBruteStatus is 0 or DemonBruteStatus is 1): [male/herm]
				say "     Watching David move to the far side of the underground room, you feel some heat against your arm that wasn't there before. Turning, you see the massive cock of the demon brute beside you, hanging down between his legs fully engorged, radiating a fair amount of warmth as it pulses in anticipation. Your pet's eyes follow David and he sniffs the air through his slit-like nostrils, a pleased rumble going through his chest. Quite a reaction... curious what prompted it so instantly, you ask the brute to explain himself.";
				say "     Looking over to you, the demon gives an evil grin. 'That one has felt the touch of the Infernal Legion - I can smell his fear.' At that, he pulls in another lungful of air through his nose and precum starts dripping from his erection. He moves his claws over his chest, at the approximate positions where David had bloody slashes from the other demon on your first meeting 'He is marked to be a Bal'ssh'avizatz'gul's slave, but can still walk without hobbling, so he hasn't been taken properly. I WANT him as mine!' His eyes flash brightly and his gaze bores into yours. 'Give him to me and I won't rip your arms off when I finally get free.'";
				LineBreak;
				say "     Chuckling at the demon brute making demands even though he's yours to command, you grasp your demontooth amulet and whisper the command word, banishing him inside. Enough of this, for now.";
				now libido of David is 1; [first-time fright scene resolved]
				[
				say "     The things you had to do to survive in this city certainly has some effect on your morality - or is it the ritual with which you bound the demon to you causing some of his evil to leak into you? No matter what, you imagine seeing your demon brute pet shoving his thick shaft into David's ass for a second, a hot flash of lust running through you at the same time.";
				say "     Shaking your head softly to shake off the vision, your answer to the demon brute is...";
				if player consents: [let's be evil]
					say "     Willing to indulge your pet, you tell him he'll get to mount the soldier - but not here in the bunker. An alley out in the city seems much more appropriate, and you can arrange David being out there alone when you send him towards Camp Bravo again...";
					now libido of David is 99; [open up the 'lure out and fuck' in David's code]
				else: [nope, David won't be raped by the demon in an alley]
					say "     Chuckling at the demon brute making demands even though he's yours to command, you grasp your demontooth amulet and whisper the command word, banishing him inside. Enough of this, for now.";
					now libido of David is 1; [first-time fright scene resolved]
				]
			else if DemonBruteStatus is 2: [cuntboy demon brute]
				say "     Watching David move to the far side of the underground room, you notice the demon brute fidgeting beside you. Turning, you see the pussy between his legs, its lips open and swollen in arousal, moisture glistening on them. Your pet's eyes follow David and he sniffs the air through his slit-like nostrils, a pleased rumble going through his chest. His left hand moves to his crotch as if to grab his nonexistent cock and he snarls as he is reminded of you modifying his body. Quite a reaction... curious what prompted it so instantly, you ask the brute to explain himself.";
				say "     Looking over to you, the demon grumbles. 'That one has felt the touch of the Infernal Legion - I can smell his fear.' At that, he pulls in another lungful of air through his nose and you can see droplets of female juices drip out of his pussy - much to the demon's chagrin as he looks down at his crotch. He moves his claws over his chest, at the approximate positions where David had bloody slashes from the other demon on your first meeting 'He is marked to be a Bal'ssh'avizatz'gul's slave, but can still walk without hobbling, so he hasn't been taken properly. I WANT him as mine!' His eyes flash brightly and his gaze bores into yours. 'I'll flay you alive for gelding me and taking this chance away when I finally get free.'";
				LineBreak;
				say "     Chuckling at the demon brute making threats even though he's yours to command, you grasp your demontooth amulet and whisper the command word, banishing him inside. Enough of this, for now.";
				now libido of David is 1; [first-time fright scene resolved]
				[
				Revenge fuck path:
				"- though a new image appears before your mental eye... seeing your demon brute pet on the ground, David pounding into his pussy in a revenge-fuck. That would surely show the demon his place and get David over his fear.";
				say "     Shaking your head softly to shake off the vision, you wonder if that's really such a good idea.";
				if player consents: [prep the revenge fuck by David]
					say "     Well, the demon brute certainly deserves it. You decide to bring it up with David later when you talk to him again.";
					now libido of David is 89; [open up the 'revenge fuck' in David's code]
				else: [nope]
					say "     Better not - who knows how David would react if you suggested this to him.";
					now libido of David is 1; [first-time fright scene resolved]
				]
		else if DBCaptureQuestVar > 5 and DBCaptureQuestVar < 99: [cleansed brute]
			say "     As you enter the bunker with your demon brute pet in tow and David spots it, he jumps up from where he was sitting on one of the many cots and shouts 'Watch out, there's a dem...', then suddenly falls silent as he realizes the big creature is following you obediently. 'What the fuck?' he says, still a bit shocked and wide-eyed. Introducing Brutus to him, you explain that while he is a demon, you cleansed him of his inner evil.";
			if DemonBruteStatus is 2: [female]
				say "     A somewhat doubtful expression on his face, David nods to you, then looks up as he notices the demon's eyes fixed on him in an intense stare. 'Why is he looking at me like that?' he asks, followed by him dropping his gaze down to Brutus crotch, where the demon's pussy looks pretty aroused and moist at the moment. Shaking his head vehemently and looking back to you, David says 'Just keep him away from me please. I don't want to be reminded of what happened in that bar.' With that, David grips his books tightly and goes up into the library for a while. Brutus follows him with a curious, interested gaze. When he looks down to his crotch afterwards, an uncomfortable, even ashamed, look comes over his face.";
			else: [male+herm]
				say "     A somewhat doubtful expression on his face, David nods to you, then looks up as he notices the demon's eyes fixed on him in an intense stare. 'Why is he looking at me like that?' he asks, followed by him dropping his gaze down to Brutus crotch, where the demon's massive, veined shaft gives a small, but noticeable throb. Shaking his head vehemently and looking back to you, David says 'Just keep him away from me please. I don't want to be reminded of what happened in that bar.' With that, David grips his books tightly and goes up into the library for a while. Brutus follows him with a curious, interested gaze. When he looks down to his cock, partly erect now, an uncomfortable, even ashamed, look comes over his face.";
			say "     [bold type]What is this about? Maybe you should ask Brutus about it sometime...[roman type]";
			now libido of David is 50; [met the cleansed Brutus, noticed him staring]
	else if libido of David is 1: [saw the evil brute with the player before]
		if DBCaptureQuestVar is 5 and a random chance of 4 in 10 succeeds: [repeat for the original, evil Brutus]
			say "     As you enter the bunker with your demon brute pet in tow, you run into David who was just on his way up into the library with a stack of books in his hands. The demon growls at David, chuckling as the young soldier flinches away from him and drops several of the books - at least until you order the enslaved demon to shut up. Eying the large creature with a frightened expression, David says to you 'Why do you keep that thing around all the time? Can't you... have it wait for you outside the library or something?' Then he picks up his books and quickly climbs the stairs, only returning about twenty minutes later with some new ones.";
		else if DBCaptureQuestVar > 5 and DBCaptureQuestVar < 99: [first meeting with the cleansed brute]
			say "     As you enter the bunker with Brutus in tow, you run into David who was just on his way up into the library with a stack of books in his hands. The young soldier stops in his tracks, eyes widening as he takes in the demon standing obediently behind you. Seeing that Brutus is under control and not about to attack or anything, David asks 'Is that the same thing you brought with you before? It looks... different, doesn't it? No longer snarling all the time too.' You tell him that your companion now has a name - Brutus - and that he is indeed the same demon, which you cleansed of his inner evil.";
			if DemonBruteStatus is 2: [female]
				say "     A somewhat doubtful expression on his face, David nods to you, then looks up as he notices the demon's eyes fixed on him in an intense stare. 'Why is he looking at me like that?' he asks, followed by him dropping his gaze down to Brutus crotch, where the demon's pussy looks pretty aroused and moist at the moment. Shaking his head vehemently and looking back to you, David says 'Just keep him away from me please. I don't want to be reminded of what happened in that bar.' With that, David grips his books tightly and goes up into the library for a while. Brutus follows him with a curious, interested gaze. When he looks down to his crotch afterwards, an uncomfortable, even ashamed, look comes over his face.";
			else: [male+herm]
				say "     A somewhat doubtful expression on his face, David nods to you, then looks up as he notices the demon's eyes fixed on him in an intense stare. 'Why is he looking at me like that?' he asks, followed by him dropping his gaze down to Brutus crotch, where the demon's massive, veined shaft gives a small, but noticeable throb. Shaking his head vehemently and looking back to you, David says 'Just keep him away from me please. I don't want to be reminded of what happened in that bar.' With that, David grips his books tightly and goes up into the library for a while. Brutus follows him with a curious, interested gaze. When he looks down to his cock, partly erect now, an uncomfortable, even ashamed, look comes over his face.";
			say "     What is this about? Maybe you should ask Brutus about it sometime...";
			now libido of David is 50; [met the cleansed Brutus, noticed him staring]
	else if libido of David is 50: [saw the cleansed Brutus with the player before]
		if DBCaptureQuestVar > 5 and DBCaptureQuestVar < 99 and a random chance of 4 in 10 succeeds: [repeat meeting with the cleansed brute]
			if DemonBruteStatus is 2: [female]
				say "     As you enter the bunker with your demon brute companion in tow, you run into David who was just on his way up into the library with a stack of books in his hands. After flinching slightly in the first moment he sees the large creature, David grips his books tightly, quickly passing you as he continues going up into the library for a while. Brutus follows him with a curious, interested gaze. When he looks down to his crotch afterwards, which shows his pussy being pretty moist and aroused, an uncomfortable, even ashamed, look comes over his face.";
			else: [male+herm]
				say "     As you enter the bunker with your demon brute companion in tow, you run into David who was just on his way up into the library with a stack of books in his hands. After flinching slightly in the first moment he sees the large creature, David grips his books tightly, quickly passing you as he continues going up into the library for a while. Brutus follows him with a curious, interested gaze. When he looks down to his cock afterwards, which went slightly hard, an uncomfortable, even ashamed, look comes over his face.";
			say "     What is this about? Maybe you should ask Brutus about it sometime...";
	else if libido of David is 51: [Brutus wants to check David out, told the player]
		if a random chance of 4 in 10 succeeds: [repeat urging to look at David]
			say "     As you enter the bunker with your demon brute companion in tow, you see David, sitting on his bed as he so often does, reading. Brutus gives him an intense look, then turns to you. 'I must see his scars, please Master. There is a possibility that his attacker has put the seal of enslavement on his body.' Looking down again, he continues silently '...if that's the case, I'm not shaming my Master after all.' and goes back to his usual tone 'But the soldier would be in danger!'";
	else if libido of David is 52: [Brutus hurt himself when removing the enslavement mark - first meeting afterwards]
		say "     As you enter the bunker with your demon brute companion in tow, David immediately comes over to ask how Brutus is doing. He is visibly relieved when the demon shows him his fully healed hand. Turning into smoke and back regularly means that he has lots of practice in reassembling himself after all. David nods, then falls silent for a moment, thinking. He pulls you aside out of earshot of your demon companion before asking 'Did you order him to do it? Did you... know it would hurt him?' Both of those questions you truthfully say no to, recounting Brutus shameful admission of certain... urges, then him pleading to look at David. 'So it was all him? That's... quite something. For a demon.' He rubs his side where the demonic seal once was hidden, biting his lip before he continues. 'Could I... talk to him sometime?'";
		WaitLineBreak;
		say "     Why wait - you call Brutus over. David walks up to him, putting a hand on his muscled arm. 'I wanted to thank you again for dealing with that evil symbol. It was... unexpected, for you to take such a risk for me.' Then he holds out his hand to Brutus, offering it to him. 'So... friends?' The demon looks down at him nonplussed for a second as he tries to come up with a response to a topic that hasn't been part of his life for eons - then he exuberantly shakes the smaller human's hand and pulls him into an embrace.";
		if DemonBruteStatus is 2: [female]
			say "     They stay in that tight hug for a moment, David pressed against Brutus chest, his arms not even close long enough to reach around the demon's wide chest. Then suddenly, Brutus clears his throat, his face taking on an interesting shade of embarrassed purple as he lets the young soldier in his arms go. As David steps away, you see the demon's pussy in a quite aroused state, its lips swollen, a wet spot on David's clothing where he must have been pressed right against it. With you standing right next to them, both the soldier and the demon seem to come to the decision to ignore the last bit at the same time, resulting in a somewhat awkward 'See ya.' and 'Sure, friend.'";
		else: [male+herm]
			say "     They stay in that tight hug for a moment, David pressed against Brutus chest, his arms not even close long enough to reach around the demon's wide chest. Then suddenly, Brutus clears his throat, his face taking on an interesting shade of embarrassed purple as he lets the young soldier in his arms go. As David steps away, you see the demon's cock in a quite aroused state, hanging where it must have pressed right against David. With you standing right next to them, both the soldier and the demon seem to come to the decision to ignore the last bit at the same time, resulting in a somewhat awkward 'See ya.' and 'Sure, friend.'";
		now libido of David is 53;
	else if libido of David is 58 and a random chance of 8 in 10 succeeds and DemonBruteStatus < 2:
		say "     As you enter the bunker with your demon brute companion in tow, you spot David in the back of the room, doing sit-ups on a blanket spread on the floor. Him being a soldier and all, that's not surprising - what is, on the other hand, is the low growl from Brutus at the sight of his special friend's sweat-glistening body. Having instantly gotten hard, the purple giant pushes the towering erection between his legs down as if to hide it. Then without a word, he suddenly whirls around and leaves through the door you just came through. Now what is going on here?!";
		say "     Going after your demonic companion, you find Brutus one landing up in the stairwell, leaning forward with his head against the wall, hands pressed against the cool stone as he takes deep breaths. As you walk up to the demon and call his name, Brutus reflexively tenses his fingers, making hard claws dig into the wall with a crunch. He steps away from it with a sheepish expression, stone dust and small fragments tumbling to the floor. 'Master! I am sorry that I left your side. It is just that my lust for him has increased far beyond what I ever felt. And I do not want to frighten David by... appearing... like the beast I was before.'";
		now libido of David is 59; [player knows something is up with Brutus]
		WaitLineBreak;
		say "     Looking down at his monster of a cock, Brutus takes a deep breath and composes his face to a stoic expression. You can actually see his erection soften a bit while he gives low grunts, soon becoming as soft as he ever gets. Bowing his head to you, he then says, 'I will control myself better from now on.' With that, your powerful companion stalks down the stairs again, clearly wanting to prove to you - and himself - that he's all better now.";
		let bonus be (( the Perception of the player minus 10 ) divided by 2);
		let diceroll be a random number from 1 to 20;
		increase diceroll by bonus;
		if diceroll > 12:
			say "     (Perception-Check Success) As you start to turn to the downwards stairs, wanting to get back to what you had planned to do in the bunker, you spot something from the corner of your eye. There are a few purple splotches on the ground where Brutus stood not too long ago. Crouching down, you have a closer look - it's blood! He must have been making a tight fist with one hand, digging his claws into the palm and holding it behind his body so you wouldn't see. Clearly, there is more of a problem with Brutus urges than he wants you to believe. You should REALLY talk to him about this!";
		now BrutusEscalationTimer is 12;
	else if libido of David is 81 and a random chance of 3 in 10 succeeds and DemonBruteStatus < 2: [dominant sex]
		say "     As you enter the bunker with your demon brute companion in tow, then walk a short distance into the main room, you notice that Brutus leaves your side almost immediately after spotting David, moving towards the human with quick strides. His thick pole of a cock dangles fully erect between the demon's legs and is the first thing to greet David as he turns to welcome his friend. 'Suck it,' Brutus says in an uncharacteristically aggressive tone before David even has time to finish his, 'Hello B-' He gives a commanding, lusty growl that makes David's eyes go wide, and he quickly replies, 'Oh... okay. S-sure.' Flustered, the young man brings his hands up to stroke his demon lover's shaft and bends his neck to give it a slow lick, only to suddenly feel Brutus large hand on his head, pushing David's face against his cock as he barks, 'Faster!'";
		say "     Following the demon's commands, David starts to lap at his cock and balls more vigorously, also stroking the massive purple shaft with both his hands. Having his human friend worship his cock clearly satisfies the purple giant quite a bit, and for a moment he just stands there, his hand loosening its grip on David's head until it only rests softly on the young man's hair. You can even hear a little whisper of, 'Thank you, my love,' from the tall male - but then, moments later, his lust flares up again hotly and Brutus gives deep-voiced growls and grunts of arousal. 'More!' he bellows, then leans forward to reach down David's back side.";
		LineBreak;
		say "     Something about this sudden swing back and forth in Brutus character seems a bit odd. Or how do you see it?";
		LineBreak;
		say "     [link](1)[as]1[end link] - It's kinda hot. Watch as they take their relationship to the dominant/submissive level.[line break]";
		say "     [link](2)[as]2[end link] - A bit rough for your taste. Let them have their fun, but don't watch.[line break]";
		say "     [link](3)[as]3[end link] - Something about this is wrong. Step in now.[line break]";
		now calcnumber is 0;
		while calcnumber < 1 or calcnumber > 3:
			say "Choice? (1-3)>[run paragraph on]";
			get a number;
			if calcnumber is 1 or calcnumber is 2 or calcnumber is 3:
				break;
			else:
				say "Invalid choice. Type [link]1[end link] to watch, [link]2[end link] to leave them to it and not watch or [link]3[end link] stop this now.";
		if calcnumber is 1: [watch]
			LineBreak;
			say "     Gripping David's with a large hand, Brutus yanks them down and gives the soldier's ass a slap before groping it tightly. 'Really nice,' comes another growl, followed by Brutus thick index finger running up and down David's crack, then being mercilessly thrust in through the young man's pucker. David cries out at the sudden anal invasion, saying, 'Hey, that hur- *aaooogodOGOD*' His protest is forgotten as he can't help but moan and scream as his prostate is being rubbed, pleasure overwhelming the pain and outrage at his rough handling. And he doesn't get another chance to say anything either, as Brutus pushes his shaft into David's open mouth, making him suck on his large cockhead.";
			say "     'That's a good slut,' Brutus growls, a gleeful smile on his face as he pushes into David's body from both ends, then adds, 'You're mine. Mine!' David is face-fucked and fingered for several more minutes, before the demon eventually legs go of his head, freeing the man to moan and whimper at the continued aggressive fingering. 'Do you want me to stop, little slut?' Brutus asks, chuckling darkly a moment later at the answer of, 'NO! *unghh* No. *pant* *pant*' He then continues to say, 'You want my cock. You love getting fucked in the ass, don't you? Do you want more, lover?' ...and in between pants and moans, half-delirious as he is, David just screams, 'Yes. Yes. YES!'";
			WaitLineBreak;
			say "     Laughing, Brutus drives his finger even deeper than before after that and wiggles it around, making David give a breathless grunt, followed by a whimper as the demon then suddenly yanks his digit out. This leaves the young soldier's pucker to gape for a moment before it winks shut, then open again - David's muscles being as overwhelmed and confused as he himself is. 'Beg for it. Beg for my cock. Beg to be bred,' Brutus demands of his partner, and in a slightly quavering voice, David does just that, still breathing hard from his previous ordeal.";
			say "     'As you wish, my love,' the purple demon grunts in satisfaction, albeit with a weird undertone to the last two words, then snatches David up in his arms. Holding the man tight against his broad, muscled chest, he quickly removes his clothes, uncaring if he rips them or not. Carrying David under one arm, Brutus moves over to the nearest bed next, dropping the man to stand on shaky legs before he lays down. Stretched out over the end of the human-sized bed with his lower leg, the demon gives his human play-toy a leering look, then wags his proudly standing erection left and right with a twitch of his hips. 'Climb on, slut.'";
			WaitLineBreak;
			say "     David hesitates a moment, but can't help but give Brutus shaft a needy look... then he takes a deep breath and steps up on the bed. He moves to straddle Brutus chest, only to be held back by the demon's hands, followed by a grunted, 'Turn around. Show me that tight ass of yours!' So David obediently follows the instructions, coming to stand with his feet left and right of Brutus hips and sticking out his shapely buttocks. There is a satisfied groan from the purple giant and you can see his shaft throb as a large drop of precum forms at the tip. Then he reaches up, slapping David's cheeks and saying, 'Go on, show me how ready you are to please!'";
			say "     With an aroused whimper at being man-handled like this, the human soldier starts to sink down, soon feeling Brutus infernal shaft hotly against his crack. He gives a deep breath, then aligns himself just right and pushes his pucker down against the wide cockhead - until the muscle yields and it pops into him with a sudden jerk. 'UuunnggghhHH! So big and warm!' David groans in arousal, panting rapidly as he tries to get himself under control again, then eventually starts to sink lower down on the thick pole. Brutus chuckles as he watches the young man fuck himself on his manhood, enjoying the submission and obedient behavior just as much as the actual penetration. 'That's it! Work for it, my lovely little slut!'";
			WaitLineBreak;
			say "     David rides Brutus massive cock with eager dedication, slowly sliding his stretched ass-lips over the thick shaft and making both of them moan and groan in lust - but eventually, that isn't enough anymore for the demon. 'More!' he grunts to himself, then says, 'I'll show you how to really fuck!' With that said, Brutus hands grip David's hips tightly and he impales the human on his shaft fully in one rough pull, making him yelp with yet another forceful invasion of his insides. But Brutus doesn't stop there - he just keeps going, sliding his helplessly moaning partner up again and hammering him down against his hips - repeatedly and in a merciless tempo.";
			say "     There is something completely untamed and bestial in the way Brutus mates with David, without stop or pause until his cock erupts deep inside the young soldier's ass, pumping blast after blast of cum into him. Meanwhile, David fulfills his new role as needy fuckhole to perfection, orgasming from the feeling of having his partner breed his ass. He groans loudly and sprays several spurts of cum over the sheets, even hitting the inside of Brutus lower legs with a few of them.";
			WaitLineBreak;
			say "     Eventually, as the two of them cool down from their orgasms a little bit, David pulls his sore ass gingerly off Brutus still half-hard shaft, only to be pulled close against the demon's chest right away. Grinning at his freshly bred human boyfriend, Brutus tells him, 'I love you, David. You're just the perfect little love slut for me. The feeling of your tight ass clenching on my shaft, milking the cum out of it - priceless.' Then he plants a long kiss on the human's mouth, leaving both of them breathless for a second when they pull apart a short while later.";
			say "     A slightly conflicted look crosses David's face and he opens his mouth, then stops with his words unsaid as Brutus shifts his hand to cup his ass. 'You liked it, didn't you my love?' Brutus asks a moment later, in a tone that seems just a tad insecure in another of his strange behavior swings, to which David eventually answers, 'Yeah, it was... good. Unexpected, but good. I'm sure I'll get used to it.'";
			now libido of David is 82;
		else if calcnumber is 2: [don't watch]
			say "     Turning your back at their wild coupling, you concentrate on other matters, although you can't help but hear the loud moans and whimpers, the bark of Brutus commands or the submissive replies David gives. Sounds like they slid right into their roles with a click, even after the somewhat hesitant start on David's part. You can likely expect more of this from them in the future.";
			now libido of David is 82;
		else if calcnumber is 3: [stop]
			LineBreak;
			say "     'Stop,' you say in a commanding voice, the demontooth amulet in your hand. Instantly freezing in his tracks Brutus turns his head up to look at you, bearing an unthinking expression full of lust for several long moments. Then the inner glow of his eyes weakens a bit and confusion spreads over his face. 'Master?' he asks, concern starting to rise in his voice. He impotently strains against the magic that compels him, wanting to look down at David, until you allow him to move again.";
			say "     Brutus pales visibly as he realizes what he was about to do, wrenching his large hand away from where it was gripping the seat of David's pants. He flinches back from the young man, giving an anguished howl, then wails, 'I'm sorry! I love you David, but the urges were too strong after I kept them in check for so long! I - lost control.' He stares down at his still painfully hard cock and gives a determined grunt, visibly fighting with himself. The demon's muscles tremble as he clenches is fists and you see beads of sweat appear on his brow.";
			WaitLineBreak;
			say "     As the first droplet of dark violet blood starts to drip from where Brutus claws are digging into his palms, David is broken out of the shocked paralyzis he was in until now. With a shout of, 'No! Don't hurt yourself,' he lunges forward, pulling on Brutus hands to open them. Letting the smaller human pry open his clenched fingers without any resistance, the demon asks in a baffled tone, 'You don't hate me now? I wanted to -' 'No, you big lug! I love you!' David shouts back, instantly quieting Brutus, who falls to his knees at all the terrified tension leaves his body.";
			say "     You walk towards the two of them, stepping up beside David as he holds his otherworldly boyfriend's head against his chest, gently stroking his purple skin. 'We will get through this. Somehow,' David sighs, then notices and gives you a helpless look. Realizing you are close, Brutus turns to look at you himself, then says, 'Master... please lock the beast inside me away. I - I tried to be strong, as not to shame you or frighten David, but I cannot... the urges are just too strong. I can't bear the thought of hurting him - so please. Please!'";
			WaitLineBreak;
			say "     You have little choice but do as asked, expressly forbidding him from acting on those impulses. As you do so, the amulet glows briefly in purple light and gets noticeably warm for a second. You can feel a tingle run down your spine as the controlling magic snaps tight around Brutus mind, straining to enforce your ruling. Something tells you the constant resistance of his deep-seated urges will put greater wear on it than all the random outbursts and flare-ups to escape by the original, evil Brutus.";
			say "     Well, Brutus should be under control now, but he'll still be tearing himself up inside. Just suppressing issues is seldom the answer. You should better find a specialist to consult. Someone with a deeper understanding of demons - or maybe interspecies sex - to resolve this in a more healthy way for Brutus...";
			now libido of David is 61;
	else if libido of David is 83:
		say "     As you enter the bunker with Brutus by your side, the demon gives a low rumble from his broad chest when his gaze falls upon David, who's just doing sit-ups on the other side of the large room. Pulling you aside, he looks at you with an intense expression, then says, 'Master... as you know, I care a lot for David. I am yours and serve as your companion, but at the same time, I often think of him, worry that someone or something might take him from me.' The large demon's fist clenches as he seems to envision David being dragged off and his lips draw back in a slight snarl. 'I just want him safe. So please, will you allow me to perform a ritual that binds the amulet to him, as well as you? That will allow me to... know where he is. Always. Protect him no matter what.' He lowers his head a bit, showing submission, but the bright glow in his eyes never diminishes as he adds, 'It is your choice, as my master. But I think I could serve you... better, if you allowed this. The jackal merchant in the mall you visited earlier to help capture me should have everything that is needed.' Brutus then proceeds to give you a short list of herbs and ingredients that he needs.";
		say "     It is clear that he has genuine feelings about David and does feel very attached to the young soldier. Still, the purple giant's careful choice of words to you just now makes you think that... there might be more to this. You should think carefully if you really do want to fulfill his request.";
		now libido of David is 84;

instead of going to Bunker while HP of David is 4 and companion of player is demon brute and libido of David > 52 and libido of David < 80 and a random chance of 1 in 3 succeeds: [David reacts when the player comes in with the demon brute pet]
	move player to Bunker;
	if debugactive is 1:
		say "     DEBUG: DAVID/BRUTUS INTERACTION 2[line break]";
	if libido of David is 53: [David thanked Brutus after he got hurt - some attraction here]
		if a random chance of 4 in 10 succeeds: [40% chance]
			let bonus be (( the Perception of the player minus 10 ) divided by 2);
			let diceroll be a random number from 1 to 20;
			increase diceroll by bonus;
			if a random chance of 1 in 2 succeeds: [David watches Brutus - perceptive players notice his looks linger on Brutus naked body]
				say "     As you walk into the bunker with Brutus in tow, you see David [one of]sitting on his bed, reading[or]sorting through his supplies[or]writing in a notebook[at random]. The young soldier looks up as he notices you, greeting you and your demon companion with a smile and a wave. [if diceroll > 15]Perceptive as you are, you notice that David's gaze lingering on Brutus muscular chest, then wandering lower to the large demon's crotch. The young man bites his lip, then suddenly realizes you're watching him stare at Brutus and looks back down, embarrassment giving him reddened cheeks.[end if]";
			else: [Brutus is more obvious - just stands and stares]
				say "     As you walk into the bunker with Brutus in tow, you see David [one of]just getting up after taking a rest[or]pull out some clean clothes out of his bag[or]walk to his bed half-dressed after freshening up[at random], his back turned to you. Walking along to the open area in the middle of the bunker, you notice the presence of Brutus missing from where he always walks along - behind your shoulder on the right side. Turning around, you find the demon still standing at the entrance, busy watching the young soldier pulling on a new pair of pants. There seems to be some interest for David in him, judging from [if DemonBruteStatus is 0 or DemonBruteStatus is 1]his semi-hard and throbbing member[else]soon drippingly wet pussy[end if]. As you're still deciding if you should say something, Brutus notices you looking at him and hurries after you, taking his usual place with a murmured 'Sorry, master.'";
	else if libido of David > 53 and libido of David < 57: [they had some fun together]
		if a random chance of 1 in 2 succeeds: [David greets the player and Brutus]
			say "     As you walk into the bunker with Brutus in tow, you run into David just on his way up to the library to return a book and grab a new one. He gives the both of you a friendly smile, greeting you and giving Brutus a clap on the arm, squeezing it affectionately as he says 'Nice to see you, big guy.' Then he moves on, walking up the stairs and returning some time later with something new to read.";
		else: [Brutus is rather more obvious]
			say "     As you walk into the bunker with Brutus in tow, the large demon makes a beeline for David, who was just [one of]reading a book[or]sorting through his supplies[or]cleaning his weapon[or]making his bed[or]folding his clothes[at random]. With a loud 'Hello, my friend!' he pulls the young soldier into a tight embrace, the smaller human pressed against his muscled chest. Watching them, you notice the demon's hand cupping David's ass as he holds him. Putting the man down a moment later, Brutus walks back to you and takes his usual place - behind your shoulder on the right side.";
	else if libido of David > 56 and libido of David < 80: [the player talked with them both about each other]
		if a random chance of 1 in 2 succeeds: [David greets the player and Brutus]
			say "     As you walk into the bunker with Brutus in tow, you run into David just on his way up to the library to return a book and grab a new one. He gives the both of you a friendly smile, greeting you and giving Brutus a clap on the arm, squeezing it affectionately as he says 'Nice to see you, big guy.' Though David doesn't stop with that and proceeds to stroke his hand over Brutus wide and muscular chest, finally reaching up for his shoulder to pull the tall demon down a bit and give him a kiss. With a flirty 'See you later' and a slap on your infernal companion's ass, David then moves on, walking up the stairs and returning some time later with something new to read.";
		else: [Brutus is rather more obvious]
			say "     As you walk into the bunker with Brutus in tow, the large demon makes a beeline for David, who was just [one of]reading a book[or]sorting through his supplies[or]cleaning his weapon[or]making his bed[or]folding his clothes[at random]. With a loud 'Hey there, David!' he pulls the young soldier into a tight embrace, the smaller human pressed against his muscled chest. Then he lowers his head and runs his forked tongue along his friend's neck before giving him a lust-filled kiss that is eagerly returned. Watching them make out, you notice the demon's hand cupping David's ass as he holds him, giving it an appreciative squeeze. Putting the man down some short while later, Brutus walks back to you and takes his usual place - behind your shoulder on the right side.";

instead of navigating Grey Abbey Library while (HP of David is 4 and companion of player is demon brute and libido of David > 81 and libido of David < 86 and a random chance of 1 in 5 succeeds):
	say "[NavCheck Grey Abbey Library]";
	if NavCheckReturn is false, stop the action;
	move player to Grey Abbey Library;
	if debugactive is 1:
		say "     DEBUG -> DAVID BRUTUS DOMINATION SEX WALKIN <- DEBUG[line break]";
	if libido of David is 82:
		increase libido of David by 1;
	let randomnumber be a random number from 1 to 3;
	if randomnumber is:
		-- 1:
			say "     As you enter the library and go about your business, you notice at some point that Brutus isn't by your side anymore. Now where did he go? Usually he couldn't be more dutiful, never leaving his spot behind your left shoulder. Then suddenly, you hear a loud gasp from between the long bookshelves several rows over, followed by deep-voiced lustful grunts. Ah, that explains it - recognizing the tone of voice, you realize it's David that drew the purple giant... and given the noises you have no doubts what activity they're busy with.";
			LineBreak;
			say "     Do you want to go and watch?";
			if player consents:
				say "     Now that's a show you don't want to miss, so you get over to the right aisle right away - a sign above tells you it's the history section, not surprising as David has been spending some time reading about ancient battles lately. As you turn the corner, you find a pretty chaotic scene in front of you. A number of books are strewn all over the floor, in the midst of which David is kneeling on the floor - and not even on all fours, just his ass raised, head and shoulders pressed against the floor as Brutus thrusts into him. The young man's pants are still around his lower legs and his shirt just pushes up on his body - seems like Brutus just grabbed him right in the middle of what he was doing, bent him over and started sliding that massive prick of his into the smaller human.";
				say "     Not that David is complaining or anything - you can see his erect cock swing wildly with each of Brutus unrestrained thrusts, dribbling copious amounts of precum all over the place. And each slap of the demon's balls against his butt is accompanied by a lusty moan, sometimes even a high-pitched gasp of, 'Yeah', 'Fuck me', 'Harder', ...and various other noises that are hard to understand. Brutus meanwhile mostly gives guttural grunts as he hammers away at his human lover - quite roughly too. His left hand is holding the soldier by the back of the neck, pressing down and holding on so that he isn't pushed away by the force of hard thrusts against his ass. Interspersed with the sounds of sex are some grunts of, 'Good slut', 'So tight', or just David's name.";
				WaitLineBreak;
				say "     One thing is clear - those two are totally into having sex like this, having slid into the roles of submissive slut and dominant master. And even though the fuck is pretty wild, you can almost feel a bond of love and attraction hum in the air between them. It is pretty hot to watch Brutus large form bent over the man below him, David's well-built and muscular form looking rather small compared to the demon's scale and bulk. Brutus continues to thrust deep into his lover as you watch them, drawing breathless gasps and aroused grunts from David. The sight of his massive shaft sliding in and out of the human's stretched pucker makes you wonder for a second if the nanites are helping along to make such wildly different couplings even possible, but - ah, who cares... it's just really really hot to watch.";
				say "     It doesn't take much longer until Brutus rutting brings the purple giant closer and closer to orgasm, his increasingly loud bellows starting to shake the books of the shelves around you. Then suddenly, the purple demon pulls out all the way, grinning in satisfaction at the sight of his lover's widely stretched hole gaping in unspoken need - and rams his full shaft all the way into David with one thrust, making the man scream in pain and lust. Mostly lust, though - as David's own cock starts to throb with spurt after spurt of cum that he blasts all over the floor between his legs. The twitch of David's muscles around his thick shaft is enough to give Brutus the last little push he needed, and with a deep growl of, 'Take it like a good little slut!' he starts filling David with his load. The two mighty orbs under Brutus manhood start to pulse visibly as they send spurt after spurt of his creamy load deep into David's ass, claiming the human as his once more.";
				WaitLineBreak;
				say "     Clearly, the feeling of his demonic lover's cum blasting into him makes David feel really good, as the young man keeps moaning and panting for Brutus to breed his ass even after his own orgasm has wound down. And that he does, for longer than you had thought possible, even with his weighty balls. Spurt after spurt make that purple rod of man-meat throb, giving David a mightily good filling. When the purple giant finally pulls out of his boyfriend's hole, it is with a gush of cum, making quite a creamy, dripping mess out of the young man. David stays as he is as Brutus straightens himself and pulls back a little, still with his head resting on the ground and using one hand to finger his leaking hole. Man, the straight little soldier you once picked up has become a total cum-slut!";
				say "     With a more gentle stroke over his naked back and saying, 'Good boy. I love you, David,' Brutus gets up and walks over to you to take his usual place. His cock literally drips with cum, and you can feel it's a sign of pride for him - proving that he's given his mate, his man, one hell of a fuck. Leaving David to clean himself up - once he's had enough of fingering himself and rubbing Brutus seed into his skin - you walk back out into the open area near the library entrance.";
			else:
				say "     No - let them have their privacy. Or at least as much privacy as you ever get when you have wild sex in a public library. You turn your thoughts to other things and tune them out - at least until you hear the deep growl of, 'Take it like a good little slut!' and the moans and grunts that accompany Brutus filling David's ass with his seed (or so you assume). Soon after, the purple demon comes out of an aisle between the shelves not too far off, cum literally dripping from his massive cock. You don't say anything about it as you can feel it's a sign of pride for him - proving that he's given his mate, his man, one hell of a fuck.";
		-- 2:
			say "     As you enter the library and go about your business, you notice at some point that Brutus isn't by your side anymore. Now where did he go? Usually he couldn't be more dutiful, never leaving his spot behind your left shoulder. Then suddenly, you hear a loud gasp from between the long bookshelves several rows over, followed by deep-voiced lustful grunts. Ah, that explains it - recognizing the tone of voice, you realize it's David that drew the purple giant... and given the noises you have no doubts what activity they're busy with.";
			LineBreak;
			say "     [bold type]Do you want to go and watch?[roman type][line break]";
			LineBreak;
			say "     ([link]Y[as]y[end link]) - Yes.";
			say "     ([link]N[as]n[end link]) - No.";
			if player consents:
				LineBreak;
				say "     Now that's a show you don't want to miss, so you get over to the right aisle right away - a sign above tells you it's the history section, not surprising as David has been spending some time reading about ancient battles lately. As you turn the corner, you find a pretty chaotic scene in front of you. A number of books are strewn all over the floor, in the midst of which David is kneeling on the floor - and standing over him with slightly bent legs is Brutus, sliding the head of his thick shaft in and out of his human lover's mouth. One large hand rests on David's head, holding him still for what is more a face-fuck than a blowjob. The young man pants are pooled around his knees, with the shirt he was wearing hanging in tatters around his shoulders - seems like Brutus just grabbed him right in the middle of what he was doing and pushed that massive prick into his mouth.";
				say "     Not that David is complaining or anything - you can see his erect cock swing with each of Brutus quick thrusts, dribbling copious amounts of precum all over the place. Eventually, as David is let go to worship the purple giant's balls a bit, you can hear him give lusty moans, even mumbling to himself, 'So good - I love blowing you.' Brutus meanwhile mostly gives guttural grunts as his balls are being fondled and licked. He looks down at David, groaning 'Such a perfect little slut. You're made for me.' With that said, his long tail whips around, wrapping around the kneeling soldier's hips, then pressing against his pucker with the spaded tip.";
				WaitLineBreak;
				say "     A long moan comes from David's mouth as the purple giant starts to tail-fuck his tight ass, followed by a breathless mantra of, 'Oooh, fuck me, fuck me, so good, fuck me, ...' Brutus enjoys letting his man continue in needy panting for a while, then eventually slides his thick prick back between David's welcoming lips. One thing is clear - those two are totally into having sex like this, having slid into the roles of submissive slut and dominant master. And even though the fuck is pretty wild, with Brutus doing hard thrusts into David's mouth while his tail really pushes deep, you can almost feel a bond of love and attraction hum in the air between them.";
				say "     It is a pretty nice show - watching Brutus large form tower over the man below him, David's well-built and muscular form looking rather small compared to the demon's scale and bulk. The purple giant continues to face-fuck his lover as you watch them, drawing pleased hums and aroused grunts from David. The sight of his massive shaft sliding in and out between widely stretched lips and the way David's neck bulges with the deeper and deeper thrusts makes you wonder for a second if the nanites are helping along to make such wildly different couplings even possible, but - ah, who cares... it's just really really hot to watch.";
				WaitLineBreak;
				say "     It doesn't take much longer until Brutus rutting brings the purple giant closer and closer to orgasm, his increasingly loud bellows starting to shake the books of the shelves around you. Then suddenly, the purple demon pulls out all the way, grinning in satisfaction at the sight of his lover's open mouth and the way he stretches his neck to follow - then rams his full shaft all the way into David with one thrust, making the man give a gurgling sound as he deep-throats that massive cock and Brutus heavy balls come to rest against his chin. It looks impossible that this could fit, but then, impossible things are kind of the norm, these days. And David obviously enjoys the sensation - as the young man's own cock starts to throb with spurt after spurt of cum that he blasts all over the floor between Brutus legs.";
				say "     The twitch of David's muscles around his thick shaft as the human swallows reflexively is enough to give Brutus the last little push he needed too, and with a deep growl of, 'Take it like a good little slut!' he starts filling David with his load. The two mighty orbs under Brutus manhood start to pulse visibly as they send spurt after spurt of his creamy load directly into David's stomach, claiming the human as his once more. The purple rod of man-meat just continues to throb inside David's throat, giving the man a mightily good filling - and with no end in sight. It seems like Brutus wants to empty everything he has, everything he is, into the unlikely partner he shares such a tight bond with.";
				WaitLineBreak;
				say "     Eventually though, by the time David's stomach is already slightly bulging with all the cum, the soldier can't help but push back against Brutus hips, tapping out so the demon pulls back. With a wet slurp, the mighty shaft pulls out of David's mouth and the young man collapses down to all fours, wheezing desperately for breath - and still, Brutus keeps coming, his long cum-splurts now splashing over David's back, giving him a veritable bath in his demonic seed. An edge of concern enters the large demon's voice as he asks between heavy breaths, 'Are you okay, David?' In reply, the soldier pushes himself back up, still gasping for breath, but nevertheless taking Brutus cum-hose of a shaft and aiming it at his chest. As the first blast of creamy seed covers his front, David pants, 'Yes, my love. I just wish I could have taken all of your load.' Man, the straight little soldier you once picked up really has become a total cum-slut!";
				say "     Eventually, even Brutus titanic eruption ebbs off, though not before David is soaked - inside and out - in his sperm. With a gentle stroke over his human boyfriend's head, the demon says, 'Good boy. I love you, David.' After that, he simply walks over to you and takes his usual place. His cock still literally drips with cum, and you can feel it's a sign of pride for him - proving that he's given his mate, his man, one hell of a fuck. Leaving David to clean himself up - once he's had enough of fingering himself and rubbing Brutus seed into his skin - you walk back out into the open area near the library entrance.";
			else:
				LineBreak;
				say "     No - let them have their privacy. Or at least as much privacy as you ever get when you have wild sex in a public library. You turn your thoughts to other things and tune them out - at least until you hear the deep growl of, 'Take it like a good little slut!' and the moans and grunts that accompany Brutus filling David's stomach with his seed (or so you assume). Soon after, the purple demon comes out of an aisle between the shelves not too far off, cum literally dripping from his massive cock. You don't say anything about it as you can feel it's a sign of pride for him - proving that he's given his mate, his man, one hell of a fuck.";
		-- 3:
			say "     As you enter the library, you notice that David is sitting on one of the sofas near the entrance, seemingly waiting for you. Literally jumping to his feet as he sees you coming, the young man walks up in an impatient stride, then... just passes you by with only a casual hello, coming to stand before Brutus. Almost before he's done saying, 'Hello Brutus,' one of David's hands is resting on the large demon's shaft, rubbing its tick length, and the next words out of the soldier's mouth are, 'Man, I don't know what's up with me. I - I've been feeling so incredibly horny all day. Thinking about you, about... this thick cock. Please, my love - take me now. I need it.' Giving a satisfied rumble from his throat as his erection becomes fully hard, the large demon replies, 'Of course! You're one hot fuck that I just can't get enough of!' That said, he just picks up David, holding him in a tight embrace and making out with the young man as he carries him back to the sofa.";
			say "     A moment later, the human soldier is dropped to land with his back on the soft surface, where he immediately kicks off his shoes and starts to shimmy out of his pants. Meanwhile, Brutus leans over the needily panting human and kisses him again, putting a large hand on his chest to feel David's muscles. He draws in the thin fabric of what soon is the soldier's only piece of clothing left, then gives it a quick wrench, leaving David completely naked. Flinging the ripped cloth aside, Brutus lowers his head to start licking his human boyfriend's balls and cock, then works his say up, forked tongue flicking to play over David's nipples before he reaches his head and their lips meet again in a long kiss. The position with David on his back and Brutus body covering all of his puts them in a perfect position to fuck, and the young man eagerly spreads his leg for his beloved purple giant.";
			LineBreak;
			say "     [bold type]Do you want to watch their coupling?[roman type][line break]";
			LineBreak;
			say "     ([link]Y[as]y[end link]) - Yes.";
			say "     ([link]N[as]n[end link]) - No.";
			if player consents:
				LineBreak;
				say "     Now that's a show you don't want to miss, so you get closer, sitting down comfortably on another sofa in a position from which you can see and hear everything. Like... David giving a needy groan as the two lover's kiss finally ends, then sighing, 'I can't wait to feel you inside again. It just feels... right. You - you can take me as hard as you want.' And Brutus is more than ready to do just that. He reacts to the submissive soldier's plea by simply pushing his hips forward, grunting in lust as his thick shaft presses against David's hole and its large cockhead pops inside. He grins widely at how loudly David moans from just having the head in his love tunnel, then grips the young man's hips with both hands and says, 'You asked for it.' And then... he does a hard thrust forward, driving most of his shaft into the young man from one moment to the next, making David scream in a mixture of pain and pleasure. He pushes the last little bit in and gives a possessive growl, then pulls back most of the way - and thrusts in again.";
				say "     It looks pretty unbelievable, that Brutus massive manhood can even fit the human under him without a lot of gentle stretching first, but then... David has taken the big guy's cock a number of times by now. Not that David is complaining about the harsh fuck - you can see his erect cock sticking up, bouncing back and forth with each of Brutus unrestrained thrusts, dribbling copious amounts of precum all himself. And each slap of the demon's balls against his butt is accompanied by a lusty moan, sometimes even a high-pitched gasp of, 'Yeah', 'Fuck me', 'Harder', ...and various other noises that are hard to understand. Brutus meanwhile mostly gives guttural grunts as he hammers away at his human lover - quite roughly too. His hands are still clutched around the soldier's hips, holding him so he isn't pushed away by the force of hard thrusts against his ass. Interspersed with the sounds of sex are some grunts of, 'Good slut', 'So tight', or just David's name.";
				WaitLineBreak;
				say "     One thing is clear - those two are totally into having sex like this, having slid into the roles of submissive slut and dominant master. And even though the fuck is pretty wild, you can almost feel a bond of love and attraction hum in the air between them. It is pretty hot to watch Brutus large form bent over the man below him, David's well-built and muscular form looking rather small compared to the demon's scale and bulk. Brutus continues to thrust deep into his lover as you watch them, drawing breathless gasps and aroused grunts from David. The sight of his massive shaft sliding in and out of the human's stretched pucker makes you wonder for a second if the nanites are helping along to make such wildly different couplings even possible, but - ah, who cares... it's just really really hot to watch.";
				say "     It doesn't take much longer until Brutus rutting brings the purple giant closer and closer to orgasm, his increasingly loud bellows starting to shake the books of the shelves around you. Then suddenly, the purple demon pulls out all the way, grinning in satisfaction at the sight of his lover's widely stretched hole gaping in unspoken need - and rams his full shaft all the way into David with one thrust, making the man scream again in pain and lust. Mostly lust, though - as David's own cock starts to throb with spurt after spurt of cum that he blasts all over his own chest. The twitch of David's muscles around his thick shaft is enough to give Brutus the last little push he needed, and with a deep growl of, 'Take it like a good little slut!' he starts filling David with his load. The two mighty orbs under Brutus manhood start to pulse visibly as they send spurt after spurt of his creamy load deep into David's ass, claiming the human as his once more.";
				WaitLineBreak;
				say "     Clearly, the feeling of his demonic lover's cum blasting into him makes David feel really good, as the young man keeps moaning and panting for Brutus to breed his ass even after his own orgasm has wound down. And that he does, for longer than you had thought possible, even with his weighty balls. Spurt after spurt make that purple rod of man-meat throb, giving David a mightily good filling. When the purple giant finally pulls out of his boyfriend's hole, it is with a gush of cum, making quite a creamy, dripping mess out of the young man and the sofa below. David stays as he is as Brutus straightens himself and pulls back a little, still breathing heavily as he lays there - and using one hand to finger his leaking hole. Man, the straight little soldier you once picked up has become a total cum-slut!";
				say "     With a more gentle stroke down his side and saying, 'Good boy. I love you, David,' Brutus gets up and walks over to you to take his usual place. His cock literally drips with cum, and you can feel it's a sign of pride for him - proving that he's given his mate, his man, one hell of a fuck. Leaving David to clean himself up - once he's had enough of fingering himself and rubbing Brutus seed into his skin - you turn your attention back to everyday survival matters.";
			else:
				LineBreak;
				say "     No - let them have their privacy. Or at least as much privacy as you ever get when you have wild sex in a public library. Right in front of the entrance, on one of the most exposed sofas of the whole building. Almost under the stairs leading up to the first floor, from where anyone has a perfect view of the two. Man, David and his lover sure aren't shy about getting it on - at least, not anymore.";
				say "     You, on the other hand, turn your thoughts to other things, stroll between the shelves and tune them out as best as you can - at least until you hear the deep growl of, 'Take it like a good little slut!' and the moans and grunts that accompany Brutus filling David's ass with his seed (or so you assume). Soon after, the purple demon enters the aisle you're in and takes his place by your shoulder, cum literally dripping from his massive cock. You don't say anything about it as you can feel it's a sign of pride for him - proving that he's given his mate, his man, one hell of a fuck.";

to say DavidEricTalk:
	if HP of Eric is 1 or HP of Eric is 20: [gender not addressed yet, or Eric waiting for a cure]
		say "     '...and then, as I was bandaging my arm, I felt this wrenching pain in my gut and passed out. When I came back to I was...' Eric waves a hand at his crotch. 'You know. Different.' David nods in silent understanding and puts a hand on Eric's shoulder. 'I don't believe I can understand what you went through, but... look at it from this point - you're still a human, good-looking guy and above all still have your own mind. You should see some of the infected out there, behaving like beasts. So what if you're female down below now - that's not all that defines you...' Eric gets a thoughtful expression, then bites his lip before... whispering something.";
		say "     Standing there, craning your head to maybe catch his words, you suddenly realize how ridiculous you must look - and that it's not a good thing to spy on friends. Not wanting to listen in any more than you already have, you go to the other side of the room and busy yourself by counting and sorting your supplies.";
		WaitLineBreak;
		say "     Quite a while later, now knowing exactly how many blankets and other things are in the bunker, you turn back to the bunks and see that your two friends are still sitting there, now seemingly in much higher spirits. David gestures wildly and says '...it really was this big, a massive brute of a thing. I had no chance, until...' he spots you and smiles, waving you closer to them 'Hi there, we're just regaling each other with tales of your heroics - kicking demon butt and taking down green cheerleaders. Thanks to your timely intervention, both of us are hanging around here now in nice company, instead of getting buggered by who knows what.' Both of them smile at you and invite you to sit with - or rather between - them. Then Eric starts another story, this time about fighting against the incubus and succubus you two met while on the campus...";
		LineBreak;
		say "     Being on a bunk with David on one side and Eric on the other makes your thoughts wander a bit, imagining what it would be like to do... other things on a bed together. From what you can see, they like each other and might possibly be down for it... though you should surely first sort out Eric's gender issues. Bringing up fun with David up before he's really comfortable in his skin wouldn't be a good idea.";
	if HP of Eric is 10 or (HP of Eric > 10 and HP of Eric < 16): [Eric talked into accepting his female parts or already fucked]
		say "     '...and then, as I was bandaging my arm, I felt this wrenching pain in my gut and passed out. When I came back to I was...' Eric waves a hand at his crotch. 'You know. Different.' David nods in silent understanding and puts a hand on Eric's shoulder. 'I don't believe I can understand what you went through, but... look at it from this point - you're still a human, good-looking guy and above all still have your own mind. You should see some of the infected out there, behaving like beasts. So what if you're female down below now - that's not all that defines you...' Eric gets a thoughtful expression, then bites his lip before... whispering something.";
		say "     Standing there, craning your head to maybe catch his words, you suddenly realize how ridiculous you must look - and that it's not a good thing to spy on friends. Not wanting to listen in any more than you already have, you go to the other side of the room and busy yourself by counting and sorting your supplies.";
		WaitLineBreak;
		say "     Quite a while later, now knowing exactly how many blankets and other things are in the bunker, you turn back to the bunks and see that your two friends are still sitting there, now seemingly in much higher spirits. David gestures wildly and says '...it really was this big, a massive brute of a thing. I had no chance, until...' he spots you and smiles, waving you closer to them 'Hi there, we're just regaling each other with tales of your heroics - kicking demon butt and taking down green cheerleaders. Thanks to your timely intervention, both of us are hanging around here now in nice company, instead of getting buggered by who knows what.' Both of them smile at you and invite you to sit with - or rather between - them. Then Eric starts another story, this time about fighting against the incubus and succubus you two met while on the campus...";
		LineBreak;
		say "     Being on a bunk with David on one side and Eric on the other makes your thoughts wander a bit, imagining what it would be like to do... other things on a bed together. From what you can see, they like each other and might possibly be down for it... [if HP of Eric is 10]though for now, it would be best if you spent some time with Eric first and took his virginity. Pushing sex with someone he barely knows on Eric might otherwise put him back into denying his new gender.[else if HP of Eric is 12 or HP of Eric is 14]though for now, it would be best if you spent some time with Eric yourself. You doubt he'd let you just play matchmaker without 'getting to know' you much better first.[else if HP of Eric is 11 or HP of Eric is 13 or HP of Eric is 15]Eric should be comfortable enough with sex now to be open for some fun - as long as you're part of it. It's worth a try to talk to him about it.[end if]";
	else if HP of Eric is 21 or HP of Eric is 22 or HP of Eric is 31 or HP of Eric is 32: [horse/satyr hung Eric]
		say "     '...and then, as I was bandaging my arm, I felt this wrenching pain in my gut and passed out. When I came back to I was...' Eric waves a hand at his crotch. 'You know. Different. And when we tried to fix me later, it made me part [if HP of Eric is 21 or HP of Eric is 22]horse[else if HP of Eric is 31 or HP of Eric is 32]goat-man[end if].' David nods in silent understanding and puts a hand on Eric's shoulder. 'I don't believe I can understand what you went through, but... look at it from this point - you're still a human, good-looking guy and above all still have your own mind. You should see some of the infected out there, behaving like beasts. So what if you're different now down below - that's not all that defines you...' Eric gets a thoughtful expression, then bites his lip before... whispering something.";
		say "     Standing there, craning your head to maybe catch his words, you suddenly realize how ridiculous you must look - and that it's not a good thing to spy on friends. Not wanting to listen in any more than you already have, you go to the other side of the room and busy yourself by counting and sorting your supplies.";
		WaitLineBreak;
		say "     Quite a while later, now knowing exactly how many blankets and other things are in the bunker, you turn back to the bunks and see that your two friends are still sitting there, now seemingly in much higher spirits. David gestures wildly and says '...it really was this big, a massive brute of a thing. I had no chance, until...' he spots you and smiles, waving you closer to them 'Hi there, we're just regaling each other with tales of your heroics - kicking demon butt and taking down green cheerleaders. Thanks to your timely intervention, both of us are hanging around here now in nice company, instead of getting buggered by who knows what.' Both of them smile at you and invite you to sit with - between - them. Then Eric starts another story, this time about fighting against the incubus and succubus you two met while on the campus...";
		LineBreak;
		say "     Being on a bunk with David on one side and Eric on the other makes your thoughts wander a bit, imagining what it would be like to do... other things on a bed together. From what you can see, they like each other and might possibly be down for it... [if lust of David is 0]though you should break David's ass in first. You'll have to get the soldier used to taking it up the rear end, otherwise he'll refuse to even consider Eric's enlarged meat. [else if lust of David > 0]with the pleasure he had from getting shafted in the ass before, David would surely like it. [end if][if HP of Eric is 21]And Eric - it'd likely be best if you broke in the newly virgin shaft yourself first...[else if HP of Eric is 22]And Eric - with how much he enjoys his new cock, you're sure he'll jump at the opportunity. You really should talk to him about it.[end if]";
	now lust of Eric is 2;

to say DavidEricaTalk:
	say "     '...and then, as I was bandaging my arm, I felt this wrenching pain in my gut and passed out. When I came back to I was...' Erica waves a hand at her crotch. 'You know. Different. Stuck halfway. That was... pretty strange. But now I'm a real woman, and I have to say - I really like it.' David nods in silent understanding and puts a hand on Erica's shoulder. 'I don't believe I can understand what you went through, but... I'm glad you feel that way about it now. And look at it from this point - you're still a human, and a very good-looking one at that. Also, above everything else - you still have your own mind. It's not pretty with some of the infected out there, behaving like beasts.' Erica gets a thoughtful expression, then bites her lip before... whispering something.";
	say "     Standing there, craning your head to maybe catch his words, you suddenly realize how ridiculous you must look - and that it's not a good thing to spy on friends. Not wanting to listen in any more than you already have, you go to the other side of the room and busy yourself by counting and sorting your supplies.";
	WaitLineBreak;
	say "     Quite a while later, now knowing exactly how many blankets and other things are in the bunker, you turn back to the bunks and see that your two friends are still sitting there, now seemingly in much higher spirits. David gestures wildly and says '...it really was this big, a massive brute of a thing. I had no chance, until...' he spots you and smiles, waving you closer to them 'Hi there, we're just regaling each other with tales of your heroics - kicking demon butt and taking down green cheerleaders. Thanks to your timely intervention, both of us are hanging around here now in nice company, instead of getting buggered by who knows what.' Both of them smile at you and invite you to sit with - or rather between - them. Then Erica starts another story, this time about fighting against the incubus and succubus you two met while on the campus...";
	LineBreak;
	say "     Being on a bunk with David on one side and Erica on the other makes your thoughts wander a bit, imagining what it would be like to do... other things on a bed together. From what you can see, they like each other and might possibly be down for it... [if HP of Erica is 0]though for now, it would be best if you spent some time with Erica first and took her virginity. You wouldn't want to push sex with anyone at her if she doesn't feel ready to enjoy it in the role of a woman yet.[else if HP of Erica is 1]Erica should be comfortable enough with sex now to be open for some fun - as long as you're part of it. It's worth a try to talk to her about it.[end if]";
	now lust of Erica is 2;

to say DavidSex1: [player sucks him]
	if thirst of David is 0:
		if David is in Parade Ground:
			say "     Stepping up close to the young soldier, you put your arms around him and pull him in for a deep kiss before he can react. There's a look of alarm in his eyes for a second, then he accepts your tongue exploring his mouth and gives in. As you come back up for air, he stammers 'I - I shouldn't... we're not supposed to...', but quickly falls silent as you reach down and stroke the bulge in his pants. With all the minotaur pheromones in the air here, he's already half hard and pretty pliable.";
		else:
			say "     Stepping up close to the young soldier, you put your arms around him and pull him in for a deep kiss before he can react. There's a look of alarm in his eyes for a second, then he accepts your tongue exploring his mouth and gives in. As you come back up for air, he stammers 'I - I shouldn't... we're not supposed to...', but quickly falls silent as you reach down and stroke his crotch, a bulge quickly forming in his pants. Not getting any relief except rushed masturbation in the weeks and months since the outbreak started, Private Jackson is like putty in your hands, his horny body telling him to go along with anything you want.";
		say "     Kneeling down in front of him, you undo David's zipper and pull out his cock, making the man moan as you handle his erect manhood. Stroking up and down on his shaft, you have him rock-hard in no time, then move your head forward a bit and lick over the tip. Next you take his cock into your mouth, and start bobbing up and down on it, while David groans and murmurs things like 'So good...' and 'You're a lot better than...'";
		say "     You give the young soldier a long and amazing blow-job, keeping at it until he suddenly shouts 'I'm coming!' and starts to shoot strings of cum into your mouth. You wait till he stops twitching and the last spurt of semen leaves his cock, then stand up and start making out with him, smiling inwardly as you push some of his own cum in David's mouth with your tongue to give him a taste.'";
		WaitLineBreak;
		say "     As he comes down from the rush of orgasm a while later and David's brain starts working again, he pants 'Wow, you're better than... Oh!' with a guilty expression suddenly shadowing his face. 'I got a girlfriend - and now I've cheated on her having oral sex! What will she say when I get back home? I - you...'";
		say "     Pulling his mouth to yours for another quick kiss, you tell him to calm down and that his girlfriend surely won't learn about you two once he goes back to her when this is all over. What happens in this city stays in the city. Unless of course you can make him fully yours to keep, you think to yourself...";
	else:
		if David is in Parade Ground:
			say "     Stepping up close to the young soldier, you put your arms around him and pull him in for a deep kiss, then feel the bulge in his pants. With all the minotaur pheromones in the air here, he's already half hard. As you pull away to get some air, you moan 'Let me take care of that for you.', getting an eager nod from David as answer.";
		else:
			say "     Stepping up close to the young soldier, you put your arms around him and pull him in for a deep kiss, then let your hands wander down to his crotch. Through the fabric you feel his manhood already filling out, as his body reacts to you kiss and touch.";
		say "     Kneeling down in front of him, you undo David's zipper and pull out his cock, making the man moan as you handle his erect manhood. Stroking up and down on his shaft, you have him rock-hard in no time, then move your head forward a bit and lick over the tip. Next you take his cock into your mouth, and start bobbing up and down on it, while David groans and murmurs things like 'So good...' and 'You're a lot better than...'";
		say "     You give the young soldier a long and amazing blow-job, keeping at it until he suddenly shouts 'I'm coming!' and starts to shoot strings of cum into your mouth. You wait till he stops twitching and the last spurt of semen leaves his cock, then stand up and start making out with him, smiling inwardly as you push some of his own cum in David's mouth with your tongue to give him a taste.'";
		WaitLineBreak;
		if thirst of David is 10: [fuck buddy]
			say "     As he comes down from the rush of orgasm a while later and David's brain starts working again, he pants 'Wow, you're better than Ann. Best fuck-buddy ever. I'll miss you when I'm back with her.'";
		else if thirst of David is 20: [boy/girlfriend]
			say "     As he comes down from the rush of orgasm a while later and David's brain starts working again, he pants 'You're better than Ann ever was. I love having you as my [if cocks of player > 0]boyfriend[else]girlfriend[end if].'";
		else: [worrying about cheating on his girlfriend]
			say "     As he comes down from the rush of orgasm a while later and David's brain starts working again, he pants 'Wow, you're better than Ann.' with a somewhat guilty expression. 'And I've just cheated on her - again!'";

to say DavidSex2: [he sucks the player]
	if David is in Parade Ground:
		say "     Stepping up close to the young soldier, you put your arms around him and pull him in for a deep kiss, then feel the bulge in his pants. With all the minotaur pheromones in the air here, he's already half hard.";
	else:
		say "     Stepping up close to the young soldier, you put your arms around him and pull him in for a deep kiss, then let your hands wander down to his crotch. Through the fabric you feel his manhood already filling out, as his body reacts to you kiss and touch.";
		say "     Pulling back from David, you quickly strip off your clothes and sit at the edge of one of the nearby bunk beds. Holding out your hard [cock of player] manhood, you wave him closer and tell the young soldier to suck you off. [if lust of David is 1 or lust of David is 51 or lust of David is 52]He just stands there for a moment, staring at your cock until you say 'Come on, you liked getting fucked with it, didn't you? Just give it a try...' then steps up and kneels between your legs.[else]He smiles at you, licking his lips, then steps up and kneels between your legs.[end if]";
	say "     Taking hold of your cock, the young soldier holds it up and licks along the shaft before taking the tip in his mouth. You put your hands on his head and softly push it down on your cock, helping him to get into sucking on it. Soon you have him bobbing up and down on your manhood, with his lips tight around the shaft. [if lust of David is 1]Even though it's his first blow-job, he's pretty good at it, knowing how to handle a cock from being a man himself.[else]He's very eager to please you, even trying to deep-throat you once or twice.[end if]";
	say "     Before too much longer, you feel the need to cum rise in your balls and say 'I'm close, suck me harder.' [if lust of David is 0]You pull his head against your crotch as you start shooting, spurt after spurt of your seed filling his hot mouth.[else]He pushes your cock into his mouth all the way as you orgasm, making you shoot directly down his throat and into his stomach.";
	WaitLineBreak;
	if thirst of David is 10: [fuck buddy]
		say "     After softly sucking on your cock a bit more, David pulls it out of his mouth and looks up at you, saying 'How was that, fuck-buddy?'";
	else if thirst of David is 20: [boy/girlfriend]
		say "     After softly sucking on your cock a bit more, David pulls it out of his mouth and looks up at you with a smile. Then he moves up and pushes you back to lie on the bunk so you can make out. 'You're amazing. I love having you as my boyfriend.'";
	else: [worrying about cheating on his girlfriend]
		say "     After softly sucking on your cock a bit more, David pulls it out of his mouth and looks up at you, saying 'Cock-sucking isn't so bad - I somehow even like the taste of cum. Ann always said it tastes horrible.' with a somewhat guilty expression.";
	now lust of David is 2;

to say DavidSex3: [player pussy fucked]
	setmonster "human";
	choose row monster from the table of random critters;
	if thirst of David is 0: [first time]
		if David is in Parade Ground:
			say "     Stepping up close to the young soldier, you put your arms around him and pull him in for a deep kiss before he can react. There's a look of alarm in his eyes for a second, then he accepts your tongue exploring his mouth and gives in. As you come back up for air, he stammers 'I - I shouldn't... we're not supposed to...', but quickly falls silent as you reach down and stroke the bulge in his pants. With all the minotaur pheromones in the air here, he's already half hard and pretty pliable.";
		else:
			say "     Stepping up close to the young soldier, you put your arms around him and pull him in for a deep kiss before he can react. There's a look of alarm in his eyes for a second, then he accepts your tongue exploring his mouth and gives in. As you come back up for air, he stammers 'I - I shouldn't... we're not supposed to...', but quickly falls silent as you reach down and stroke his crotch, a bulge quickly forming in his pants. Not getting any relief except rushed masturbation in the weeks and months since the outbreak started, Private Jackson is like putty in your hands, his horny body telling him to go along with anything you want.";
		say "     As you make out with him some more, you slide your hands under his shirt and feel your way up his hard-muscled chest, then pull the fabric up and over his head. Leaning down a bit you run your tongue over his nipples, playfully sucking on first one, then the other. From David's lustful moans, he's ready for the real thing.";
		say "     Opening up the zipper of his pants and letting them drop down, you free his raging hard-on, standing proudly erect in your direction. Quickly stripping off your own clothes, you grab David and pull him with you to one of the nearby bunks, lying down with him on top of you.";
		WaitLineBreak;
		say "     It only takes a helping hand guiding his rod to your pussy lips for the young man's instincts to kick in and his hips plunge downward, thrusting his hard manhood deep into your vagina. He fucks you with smooth strokes, making you moan with the feelings as his shaft hits just the right spots inside you. You run your hands over his chest, feeling his muscles while your legs wrap around his hips to pull him even deeper with each of his thrusts. Soon he speeds up even more, groaning louder and louder as he gets closer to orgasm.";
		say "     Then he shouts 'I'm coming!' and you feel a shudder run through his body as the first blast of his human cum shoots deep inside your body. You pull him down on top of you, hugging him close and kissing him as his cock twitches again and again, filling you to the brink with his fertile seed.[fimpregchance]";
		LineBreak;
		say "     You lay there for a while, entwined and kissing, with his slowly softening cock still inside you. As both of you come down from the rush of sex and David's brain starts working again, he pants 'Wow, that was... just wow.' and you feel his manhood twitch inside you once. Then a worried look comes over his face and he adds 'But... oh no, I just cheated on my girlfriend. What will she say when I get back home. I - you...'";
		say "     Pulling his mouth to yours for a quick kiss, you tell him to calm down and that his girlfriend surely won't learn about you two once he goes back to her when this is all over. What happens in this city stays in the city. Unless of course you can make him fully yours to keep, you think to yourself...";
	else:
		if David is in Parade Ground:
			say "     Stepping up close to the young soldier, you put your arms around him and pull him in for a deep kiss, then feel the bulge in his pants. With all the minotaur pheromones in the air here, he's already half hard.";
		else:
			say "     Stepping up close to the young soldier, you put your arms around him and pull him in for a deep kiss, then let your hands wander down to his crotch. Through the fabric you feel his manhood already filling out, as his body reacts to your kiss and touch.";
		say "     As you make out with him some more, you slide your hands under his shirt and feel your way up his hard-muscled chest, then pull the fabric up and over his head. Leaning down a bit you run your tongue over his nipples, playfully sucking on first one, then the other. From David's lustful moans, he's ready for the real thing.";
		say "     Opening up the zipper of his pants and letting them drop down, you free his raging hard-on, standing proudly erect in your direction. Quickly stripping off your own clothes, you grab David and pull him with you to one of the nearby bunks, lying down with him on top of you.";
		WaitLineBreak;
		say "     It only takes a helping hand guiding his rod to your pussy lips for the young man's instincts to kick in and his hips plunge downward, thrusting his hard manhood deep into your vagina. He fucks you with smooth strokes, making you moan with the feelings as his shaft hits just the right spots inside you. You run your hands over his chest, feeling his muscles while your legs wrap around his hips to pull him even deeper with each of his thrusts. Soon he speeds up even more, groaning louder and louder as he gets closer to orgasm.";
		say "     Then he shouts 'I'm coming!' and you feel a shudder run through his body as the first blast of his human cum shoots deep inside your body. You pull him down on top of you, hugging him close and kissing him as his cock twitches again and again, filling you to the brink with his fertile seed.[fimpregchance]";
		LineBreak;
		if thirst of David is 10: [fuck buddy]
			say "     You lay there for a while, entwined and kissing, with his slowly softening cock still inside you. As both of you come down from the rush of sex, he pants 'Wow, that was... just wow.' and you feel his manhood twitch inside you once. 'You're an amazing fuck-buddy, you know. I'll miss you after all this is over.'";
		else if thirst of David is 20: [boy/girlfriend]
			say "     You lay there for a while, entwined and kissing, with his slowly softening cock still inside you. As both of you come down from the rush of sex, he pants 'Wow, that was... just wow.' and you feel his manhood twitch inside you once. 'I love having you as my [if cocks of player > 0]boyfriend[else]girlfriend[end if]. You're just amazing,' he says and gives you another deep kiss.";
		else: [worrying about cheating on his girlfriend]
			say "     You lay there for a while, entwined and kissing, with his slowly softening cock still inside you. As both of you come down from the rush of sex and David's brain starts working again, he pants 'Wow, that was... just wow.' and you feel his manhood twitch inside you once. Then a worried look comes over his face and he adds 'But... I just cheated on Ann - again!'";

to say DavidSex4: [player ass fucked]
	setmonster "human";
	choose row monster from the table of random critters;
	if David is in Parade Ground:
		say "     Stepping up close to the young soldier, you put your arms around him and pull him in for a deep kiss, then feel the bulge in his pants. With all the minotaur pheromones in the air here, he's already half hard.";
	else:
		say "     Stepping up close to the young soldier, you put your arms around him and pull him in for a deep kiss, then let your hands wander down to his crotch. Through the fabric you feel his manhood already filling out, as his body reacts to your kiss and touch.";
	say "     As you make out with him some more, you slide your hands under his shirt and feel your way up his hard-muscled chest, then pull the fabric up and over his head. Leaning down a bit you run your tongue over his nipples, playfully sucking on first one, then the other. From David's lustful moans, he's ready for the real thing.";
	say "     Opening up the zipper of his pants and letting them drop down, you free his raging hard-on, standing proudly erect in your direction. Quickly stripping off your own clothes, you push David to lie on one of the nearby bunks, then climb on top of him, straddling his hips.";
	WaitLineBreak;
	say "     Reaching back to hold his hard cock up, you push it against your hole, then slowly sink your ass down, impaling yourself on his manhood. David moans 'So tight.' as his shaft goes deeper into your tightly gripping asshole, his hands holding on to and stroking your hips. Then he bottoms out in you and you can feel a pleasant fullness and the warmth of his crotch against your buns. You stay still for a moment to revel in the feeling, then start sliding up and down on the hard shaft.";
	say "     Fucking yourself on his cock, you make David moan and gasp under you, holding on tight to sides of the bunk. Then, after a while, you pull off him with a slight *plop* and say 'Your turn on top - fuck me hard and deep.' Laying down next to him, you give him a quick kiss, then spread your legs and wiggle your ass invitingly.";
	say "     Without hesitation, he moves to kneel behind you, then sets the tip of his hard cock against your pucker and plunges in. The young soldier fucks you hard and fast, grinding his hips against your ass and moaning into your ear with his arms around your chest. With each frenzied thrust you move closer to orgasm, and soon you're pushed over the brink, spraying your seed into the bedsheets below you. Your anal muscles twitching and tightening around his cock with each burst of your cum, David joins you in orgasm, flooding your insides with his human seed.[mimpregchance]";
	LineBreak;
	if thirst of David is 10: [fuck buddy]
		say "     You lay there for a while, with him resting on your back and his slowly softening cock still inside you. As both of you come down from the rush of sex, he pants 'Nice ass, it's really tight' and you feel his manhood twitch inside you once. 'You're an amazing fuck-buddy, you know. I'll miss you after all this is over.'";
	else if thirst of David is 20: [boy/girlfriend]
		say "     You lay there for a while, with him resting on your back and his slowly softening cock still inside you. As both of you come down from the rush of sex, he pants 'Wow, that was... just wow.' and you feel his manhood twitch inside you once. 'I love having you as my [if cocks of player > 0]boyfriend[else]girlfriend[end if]. You're just amazing,' he says and slides over to lie beside you, giving you another deep kiss.";
	else: [worrying about cheating on his girlfriend]
		say "     You lay there for a while, with him resting on your back and his slowly softening cock still inside you. As both of you come down from the rush of sex and David's brain starts working again, he pants 'Wow, that was... just wow.' and you feel his manhood twitch inside you once. Then a worried look comes over his face and he adds 'But... I just cheated on Ann - again!'";

to say DavidSex5: [David ass fucked]
	if thirst of David is 0: [first time]
		if David is in Parade Ground:
			say "     Stepping up close to the young soldier, you put your arms around him and pull him in for a deep kiss before he can react. There's a look of alarm in his eyes for a second, then he accepts your tongue exploring his mouth and gives in. As you come back up for air, he stammers 'I - I shouldn't... we're not supposed to...', but quickly falls silent as you reach down and stroke the bulge in his pants. With all the minotaur pheromones in the air here, he's already half hard and pretty pliable.";
		else:
			say "     Stepping up close to the young soldier, you put your arms around him and pull him in for a deep kiss before he can react. There's a look of alarm in his eyes for a second, then he accepts your tongue exploring his mouth and gives in. As you come back up for air, he stammers 'I - I shouldn't... we're not supposed to...', but quickly falls silent as you reach down and stroke his crotch, a bulge quickly forming in his pants. Not getting any relief except rushed masturbation in the weeks and months since the outbreak started, Private Jackson is like putty in your hands, his horny body telling him to go along with anything you want.";
	else: [already had some sex]
		if David is in Parade Ground:
			say "     Stepping up close to the young soldier, you put your arms around him and pull him in for a deep kiss, then feel the bulge in his pants. With all the minotaur pheromones in the air here, he's already half hard.";
		else:
			say "     Stepping up close to the young soldier, you put your arms around him and pull him in for a deep kiss, then let your hands wander down to his crotch. Through the fabric you feel his manhood already filling out, as his body reacts to your kiss and touch.";
	say "     As you make out with him some more, you slide your hands under his shirt and feel your way up his hard-muscled chest, then pull the fabric up and over his head. Leaning down a bit you run your tongue over his nipples, playfully sucking on first one, then the other. From David's lustful moans, he's ready for the real thing.";
	if lust of David is 0: [anal virgin]
		say "     Opening up the zipper of his pants and letting them drop down, you free his raging hard-on, standing proudly erect in your direction. Quickly stripping off your own clothes, you give him another quick kiss on the lips, then spin him around and push him towards one of the nearby bunks.";
		WaitLineBreak;
		say "     With a moaned 'On all fours', you guide him onto the mattress, then pull his ass up a bit as you kneel behind him. You rub your rock-hard [cock of player] cock up and down between the round buns of his bubble butt, then lean over him and whisper 'I'm gonna fuck you now' in his ear. As horny as you've gotten him, he doesn't protest and just moans as you bring the tip of your cock to his tight opening. Pushing forward with increasing pressure, David's pucker resists you for a moment, then opens up and allows your cockhead to slide into the tight embrace of his ass. It's virgin territory for sure you're exploring here - and from his lust-filled groans as you slowly slide deeper into him, you're being very well received.";
		say "     As you bottom out inside his ass, you give his cock a few strokes, then move your hands back to his hips. Holding on tightly, you start pulling out almost all the way and hammering your shaft back inside him in quick deep strokes, filling the [if David is in Bunker]room [else]tent [end if]with slapping noises as your hips meet his butt. His tightly gripping hole feels just amazing around your thrusting member, filling you with ecstasy as you very thoroughly take his virginity.";
		say "     Getting shafted like this soon drives your handsome Private over the edge, his cock spraying a huge load of cum all over the bedsheets under him. David's ass muscles quiver and flex with each shot of seed erupting from his cock, giving you all new sensations as you move in and out of him. Then it's your turn, and with one final deep thrust you push inside David all the way and fill his insides with spurt after spurt of warm seed.";
		now lust of David is 1;
	else: [repeat anal]
		say "     Opening up the zipper of his pants and letting them drop down, you free his raging hard-on, standing proudly erect in your direction. Quickly stripping off your own clothes, you give him another quick kiss on the lips and say 'Let's fuck.'";
		WaitLineBreak;
		say "     Eager to get fucked, David gets on the next bunk on all fours, invitingly wiggling his ass at you. You kneel behind him and rub your rock-hard [cock of player] cock up and down between the round buns of his bubble butt, then lean over him and kiss is neck. He moans as you bring the tip of your cock to his tight opening and tease him a bit with it. Pushing forward with increasing pressure, David's pucker resists you for a moment, then opens up and allows your cockhead to slide into the tight embrace of his ass. He's still tight as he was when you took his virginity and giving lust-filled groans as you slowly slide deeper into him.";
		say "     As you bottom out inside his ass, you give his cock a few strokes, then move your hands back to his hips. Holding on tightly, you start pulling out almost all the way and hammering your shaft back inside him in quick deep strokes, filling the [if David is in Bunker]room [else]tent [end if]with slapping noises as your hips meet his butt. His tightly gripping hole feels just amazing around your thrusting member, filling you with ecstasy as you give him a good fucking.";
		say "     Getting shafted like this soon drives your handsome Private over the edge, his cock spraying a huge load of cum all over the bedsheets under him. David's ass muscles quiver and flex with each shot of seed erupting from his cock, giving you all new sensations as you move in and out of him. Then it's your turn, and with one final deep thrust you push inside David all the way and fill his insides with spurt after spurt of warm seed.";
	WaitLineBreak;
	if thirst of David is 10: [fuck buddy]
		say "     You keep kneeling like that for a moment, with your arms around his chest from behind and still connected through your dick in his ass. As both of you come down from the rush of sex, he pulls off your cock and sits next to you on the bed. 'Incredible how good having something up my ass feels. I'll have to talk Ann into getting some toys...'";
	else if thirst of David is 20: [boy/girlfriend]
		say "     You keep kneeling like that for a moment, with your arms around his chest from behind and still connected through your dick in his ass. As both of you come down from the rush of sex, you pull out and lie on the bed with David, face to face. He smiles at you, cuddling close and gives you a kiss. 'That was amazing. You're an incredible boyfriend, you know.'";
	else if thirst of David is 0: [first time worrying]
		say "     You keep kneeling like that for a moment, with your arms around his chest from behind and still connected through your dick in his ass. As both of you come down from the rush of sex and David's brain starts working again, he looks over his shoulder at you with a questioning expression. 'I like... this,' he says and you feel his asshole tighten for a second around your member. 'Does that mean I'm gay?' With a worried look he adds 'I got a girlfriend back home, you know.'";
		say "     After giving him a playful slap on his firm buttocks as you pull out, you calm him down a bit by telling that he just might be bisexual and that he should use the opportunity to try out the whole spectrum of possible partners. The girlfriend situation will surely work itself out once he knows what he really wants. Although judging from his load all over the wall, you're pretty certain you left a lasting impression on him, opening him up more man-on-man action...";
	else: [worrying about cheating on his girlfriend]
		say "     You keep kneeling like that for a moment, with your arms around his chest from behind and still connected through your dick in his ass. As both of you come down from the rush of sex and David's brain starts working again, he looks over his shoulder at you with a questioning expression. 'I like... this,' he says and you feel his asshole tighten for a second around your member. 'But even if I'm just Bi as you say - this is till cheating on Ann.'";

to say DavidSex6: [Sven's ass gets fucked by David]
	setmonster "human";
	choose row monster from the table of random critters;
	say "     Stepping up close to the young soldier, you put your arms around him and pull him in for a deep kiss, then let your hands wander down to his crotch. Through the material of his pants you feel his manhood already filling out, as his body reacts to your kiss and touch. As you make out with him some more, you slide your hands under his shirt and feel your way up his hard-muscled chest, then pull the fabric up and over his head. Leaning down a bit you run your tongue over his nipples, playfully sucking on first one, then the other. From David's urgent moans, he's ready for some action.";
	say "     Smiling, you whirl David around and wrap your arms around his chest from behind, then move a hand down to his crotch. Sliding it under the band of his pants, you fondle your soldier boy's cock and balls, making him pant and groan in lust some more, then whisper in his ear to look over to one of the farther-away beds in the bunker. There, your snowmeow kitty Sven is lying on his stomach, reading a book, tail waving in the air above his enticing furry butt. As wound-up as you already have David, it doesn't take much more than describing how Sven's tight and ready hole would feel around his cock to get him interested. After undoing the soldier's pants and letting them drop, you quickly get rid of your own clothes and the two of you walk over towards Sven naked.";
	WaitLineBreak;
	say "     You're almost at the bed before Sven notices you and turns his head, eyes going wide as he sees [if cunts of player > 0 and cocks of player is 0]his mistress and her human friend [else]his master and his human friend [end if]walk towards him in the nude - and quite obviously horny. A shy but eager smile spreads over his face, then you're with him and start softly scritching behind his ears, which has Sven close his eyes and purr in contentment. David meanwhile runs a hand along the snow leopard's tail flirting in the air before him and asks 'I - can I fuck you?' Sven just keeps purring loudly, then stretches his body and raises his furry butt in unmistakable eagerness.";
	say "     Taking a kneeling position behind the sexy kitty, David grabs his hard cock and rubs it teasingly over Sven's pucker and making it wet with his precum. Your feline pet's tail meanwhile strokes against David's naked chest, its end curling around his back almost as if to pull him closer. You can hear David mutter 'Such soft fur you have, pretty kitty' under his breath, then he's pressing forward against Sven, his hard cock spreading open the snowmeow's tailhole. 'Yes! Fuck me, please!' Sven mrowls in delight, grinding his ass backwards to meet each thrust as David starts pounding into him.";
	WaitLineBreak;
	if cocks of player > 0:
		say "     With your two friends already enjoying each other's bodies, it's for you to decide where and how you want to join in.";
		say "     [bold type]Do you present your cock to Sven and have him lick it, or will you move in behind David and fuck his ass?[roman type][line break]";
		LineBreak;
		say "     ([link]Y[as]y[end link]) - Present your cock to Sven and have him lick it.";
		say "     ([link]N[as]n[end link]) - Move in behind David and fuck his ass.";
		if player consents:
			LineBreak;
			say "     Getting on the bed at its head end, you sit right in front of Sven and spread your legs wide, then pull his head down on your crotch. The eager feline licks and sucks at your cock, getting it fully hard before taking it into his muzzle[if cunts of player > 0] while his paws stroke and tease at your pussy[end if]. He's gotten quite good at this now in just a short time - amazingly so, in fact, as your feline sex pet can still do it while distracted by a hard cock fucking his ass. You continue to stroke his head and ears as you moan compliments to Sven and he bobs his head steadily over your cock while his raspy tongue slides all over it, focusing on every sensitive spot he's learned.";
			say "     His softly furred paws travel over your rear, caressing your hips and thighs[if cunts of player > 0] before sinking a pair of fingers into your cunt[end if]. He makes sure to pace his licking and sucking, letting you build increasingly to greater heights. When finally your climax does come, you blast your cum down his throat as you drain your aching balls with a loud groan of ecstasy. Smiling around your cock, he makes sure to swallow it all down. Just moments later, the satisfaction of getting his mistress off pushes your kitty over the edge too and with a yowl, he starts blasting his ample load onto the blanket below. And not long after that, David joins the two of you in orgasm, slamming deep into the snowmeow's ass and sending shot after shot into the feline's furry butt. After taking a moment to catch his breath, David eases his cock out of Sven's freshly creamed hole and moves over to give you a kiss. Then he says 'Thanks little buddy, you were amazing.' to Sven and starts petting and stroking your pet's furry body all over.";
		else:
			LineBreak;
			if lust of David is 0: [anal virgin]
				say "     Your eyes on the shapely form of David's bubble butt, you get on the bed behind him. Then you move a bit closer and cup his firm cheeks, spreading them a bit as your hard [cock of player] cock bumps against his virgin hole. This is such a nice opportunity to break David in for some good fucking that you just can't wait to get into him. Taking hold of your shaft with one hand, you line it up with his pucker, then push in against the soldier's body. Soon the muscle yields and you pop in, becoming the first man to explore his delightfully tight depths. David gasps as his hole is spread for the first time by your invading member, but soon starts moaning even louder than before as you sink yourself deeper and deeper, rubbing against his prostate.";
				now lust of David is 1; [anally de-virginized]
			else:
				say "     Your eyes on the shapely form of David's bubble butt, you get on the bed behind him. Then you move a bit closer and cup his firm cheeks, spreading them a bit as your hard [cock of player] cock bumps against his hole. You can't wait to get back into his nice and tight soldier ass. Taking hold of your shaft with one hand, you line it up with his pucker, then push in against the soldier's body. David gasps in lust as his hole is spread by your invading member, then starts moaning even louder than before as you sink yourself deeper and deeper, rubbing against his prostate.";
			say "     Pounding David's ass with deep thrusts, you revel in the moans, gasps and slapping noises of your hips against his ass filling the whole bunker. Who'd have thought that post-apocalyptic survival would be like this? Fucking the tight hole of a handsome man while he himself is balls deep in a hot little catboy who's your pet - hell yeah, you'd pick this any day against your 'normal' life before. But moving your thoughts back to the thing at hand - or rather the hole you're balls deep in - you decide to change your rhythm of thrusts to match David's, moving in unison as the three of you fuck.";
			WaitLineBreak;
			say "     Being penetrated at the same time as fucking Sven's furry ass has David pretty hot and bothered, and before too much longer, he moans 'I'm gonna... cummMMM!' He grabs the snow leopard's hips to pull him tight against his crotch as his whole body shudders when spurt after spurt of cum shoot out of his cock and deep into Sven's body. Getting bred by the young man, his body being filled with spurt after spurt of cum, drives your feline pet over the edge right with him, and with a lust-filled yowl, Sven starts blasting his ample load onto the blanket below. Meanwhile, your thrusting member being gripped by David's twitching anal muscles soon gives you the last bit of stimulation you need. Shoving your cock in all the way as you feel the need to cum rise inside your balls, a massive load of cum blasts through your shaft and into David's hole.";
			say "     Exhausted by the hot fuck, you wrap your arms around David from the back and just hold on to him, your slowly softening shaft still inside his asshole. After catching your breath, you pull out and give your human friend a deep kiss, then go grab a towel and clean yourself up a bit. David eases his cock out of Sven's freshly creamed hole, then says 'Thanks little buddy, you were amazing.' to the still purring kitty and starts petting and stroking your pet's furry body all over.";
	else if cunts of player > 0:
		say "     Getting on the bed at its head end, you sit right in front of Sven and spread your legs wide, then pull his head down on your crotch. The eager feline licks and fingers your pussy, getting you quite excited before alternating between diving his tongue and sliding [if cunt width of player > 5]a paw into your wide pussy[else if cunt width of player > 2]three fingers into your ample pussy[else]a pair of fingers into your wet pussy[end if]. He's gotten quite good at this now in just a short time - amazingly so, in fact, as your feline sex pet can still do it while distracted by a hard cock fucking his ass. He tweaks your clit while his raspy tongue slides everywhere it can get, focusing on every sensitive spot he's learned.";
		say "     Sven makes sure to pace his licking and fingering, letting you build increasingly to greater heights. When finally your climax does come, you spray your hot juices over his tongue and paw with a loud groan of ecstasy. Just moments later, the satisfaction of getting his mistress off pushes your kitty over the edge too and with a yowl, he starts blasting his ample load onto the blanket below. And not long after that, David joins the two of you in orgasm, slamming deep into the snowmeow's ass and sending shot after shot into the feline's furry butt. After taking a moment to catch his breath, David eases his cock out of Sven's freshly creamed hole and moves over to give you a kiss. Then he says 'Thanks little buddy, you were amazing.' to Sven and starts petting and stroking your pet's furry body all over.";
	else:
		say "     Not having any genitals of your own, you just get on the bed at the head end and sit right in front of Sven, your hands still rubbing and stroking him affectionately. Purring loudly, he replies in kind, caressing your body and lapping at your bare but nevertheless sensitive crotch to give you pleasure. Sven makes sure to pace his licking and fingering, letting you build increasingly to greater heights. When finally your climax does come, a tingling feeling of fulfillment spreads out through your body, making you groan loudly in ecstasy. Just moments later, the satisfaction of getting his master off pushes your kitty over the edge too and with a yowl, he starts blasting his ample load onto the blanket below. And not long after that, David joins the two of you in orgasm, slamming deep into the snowmeow's ass and sending shot after shot into the feline's furry butt. After taking a moment to catch his breath, David eases his cock out of Sven's freshly creamed hole and moves over to give you a kiss. Then he says 'Thanks little buddy, you were amazing.' to Sven and starts petting and stroking your pet's furry body all over.";

to say DavidSex7: [Brutus & David Scene (David gives oral)]
	say "     Stepping up close to the young soldier, you... casually mention that you won't be needing Brutus assistance for a while. [if companion of player is demon brute]Perking up visibly at your announcement, David's eyes immediately are drawn to the demon's muscular form, standing not too far away in all his naked glory. With a chuckle, you tell the man to just go for it and spend some time with his friend. [else]Perking up visibly at your announcement, David's eyes immediately are drawn to the demontooth amulet around your neck. With a chuckle at the mixed expression of hope and lust in his gaze, you give him a nod and intone the magic words to summon Brutus. While the cloud of purple smoke starts to swirl out of the amulet to coalescence into Brutus form, you tell David to have fun as he spends some time with his friend. [end if]Not wasting a second, David immediately moves over to Brutus and puts a hand on his arm, giving it an affectionate squeeze, and says 'Hey there, big guy. Looks like you've got some time off, so how about we...' And that's as far as he gets, as your demon companion just leans down with a rumbling purr and gives him a hungry kiss, then bodily picks up his human friend and gently gropes his ass with a clawed hand.";
	say "     With David still held tight against his broad chest, Brutus walks over to the soldier's bed and sits down on it, then proceeds to make out passionately with the young man. For now, you just watch your two friends kiss and touch each other, staying far enough away to give them at least some privacy. The demon and human whisper a bit back and forth in between kisses, then after a while, David stands up from his position on Brutus lap and starts to undress. His boots are quickly pulled off and thrown aside, followed by socks and his pants. Then the young man pulls his shirt up over his head, revealing a fit chest and nicely sculpted abs. With a wide smile on his face, he finishes up by turning around, then bending over to push down his underwear, giving Brutus a very nice and close view of his firm butt.";
	WaitLineBreak;
	if DemonBruteStatus is 0 or DemonBruteStatus is 1: [male+herm Brutus]
		say "     After his little strip-show, David kneels down between the legs of a now - very - obviously aroused Brutus and reaches out to touch the demon's massive cock. Your infernal companion lets out a lust-filled groan as David fondles his weighty balls for a moment, then proceeds to stroke Brutus erection. Holding the thick shaft up, David runs his tongue up the underside until he gets to the tip and licks up the big drop of precum forming at its slit. 'Mmmmh!' the young man hums loudly, then slides his lips over Brutus cockhead, suckling on it and teasing it with his tongue. With that being the maximum he can fit into his mouth, David puts both hands on Brutus shaft, jerking him off while giving him a blowjob.";
		say "     When the redeemed demon's lustful grunts become louder and more urgent pretty quickly, David slows down a bit, not wanting to get Brutus off too quickly. Pulling off the thick shaft, he lets his hands wander over Brutus body for a moment, stroking and caressing the curves of his muscular physique before getting back to slowly stroking the demon's erection. He keeps going on like that for some time, jerking and touching Brutus, as well as giving him some teasing licks with his tongue, keeping his infernal friend just at the edge of orgasm. Brutus moans take on an almost pleading tone after a while and his hands['] grip on the metal frame of the bed gets tighter and tighter, but no matter what, he keeps sitting still, having surrendered control over him getting off to David.";
		WaitLineBreak;
		say "     Finally, the soldier decides that he's teased Brutus enough and gets back to all-out sucking on the demon's massive cock, jerking its shaft with both hands. Having been so close to orgasm for some time now, it doesn't take more than a moment until Brutus reaches his climax with a loud roar and the first of many big spurts of cum shoots into David's mouth. He does his best to swallow it all, but before he can manage that, the next blast and the next force David to pull off the demon's shaft, making further blasts splash all over his neck and chest. When Brutus finally winds down from his orgasm, his human friend is literally dripping with cum and there is an off-white puddle on the bunker floor under him.";
		say "     'That was great. Thanks, baby.' Brutus rumbles to David and gives him a kiss, then lifts the smaller human on his lap and starts to lap at his chest, slurping up his own cum and playing a long forked tongue over David's muscles. After the hot make-out session that Brutus method of 'cleaning up' soon escalates into, the two of them get on the bed together and rest, with David half draped over Brutus large form. They continue to silently talk and whisper to each other for some time, then eventually doze off.";
	else if DemonBruteStatus is 2: [female Brutus]
		say "     After his little strip-show, David kneels down between the legs of a now - very - obviously aroused Brutus and reaches out to touch the demon's pubic mound. Your infernal companion lets out a lust-filled groan as David brushes his fingers over his sensitive pussy lips for a moment, then proceeds to push Brutus legs a bit further apart. Leaning forward, David licks over Brutus now spread folds, making the demon shiver and pant as he teases his clit with the tip of his tongue. After giving him some oral attention for a while, David then proceeds to stick to fingers in between Brutus nether lips, pushing them in and out of the gender-shifted demon.";
		say "     With David switching up between licking and teasing as well as finger-fucking Brutus, the redeemed demon's lustful grunts become louder and more urgent pretty quickly, so David slows down a bit, not wanting to get Brutus off too quickly. Pulling back from Brutus crotch, he lets his hands wander over the demon's body for a moment, stroking and caressing the curves of his muscular physique before getting back to gently brushing over his pussy lip. David keeps going on like that for some time, stroking and licking Brutus, keeping his infernal friend just at the edge of orgasm. Brutus moans take on an almost pleading tone after a while and his hands['] grip on the metal frame of the bed gets tighter and tighter, but no matter what, he keeps sitting still, having surrendered control over him getting off to David.";
		WaitLineBreak;
		say "     Finally, the soldier decides that he's teased Brutus enough and gets back to all-out pleasing the demon, licking at his clit while pumping his fingers in and out of Brutus pussy. Having been so close to orgasm for some time now, it doesn't take more than a moment until Brutus reaches his climax with a loud roar and twitching and bucking as femcum gushes out of his vagina and splashes all over David. When Brutus finally winds down, his human friend is literally dripping, with a puddle on the bunker floor at his feet.";
		say "     'That was great. Thanks, baby.' Brutus rumbles to David and gives him a kiss, then lifts the smaller human on his lap and starts to lap at his chest, slurping up his own femcum and playing a long forked tongue over David's muscles. After the hot make-out session that Brutus method of 'cleaning up' soon escalates into, the two of them get on the bed together and rest, with David half draped over Brutus large form. They continue to silently talk and whisper to each other for some time, then eventually doze off.";
	else:
		say "ERROR-Demon Brute-[DemonBruteStatus]C: He isn't in one of the states he should be in! Please report how you got to this message.";

to say DavidSex8: [Brutus & David Scene (BJ by Brutus)]
	say "     Stepping up close to the young soldier, you... casually mention that you won't be needing Brutus assistance for a while. [if companion of player is demon brute]Perking up visibly at your announcement, David's eyes immediately are drawn to the demon's muscular form, standing not too far away in all his naked glory. With a chuckle, you tell the man to just go for it and spend some time with his friend. [else]Perking up visibly at your announcement, David's eyes immediately are drawn to the demontooth amulet around your neck. With a chuckle at the mixed expression of hope and lust in his gaze, you give him a nod and intone the magic words to summon Brutus. While the cloud of purple smoke starts to swirl out of the amulet to coalescence into Brutus form, you tell David to have fun as he spends some time with his friend. [end if]Not wasting a second, David immediately moves over to Brutus and puts a hand on his arm, giving it an affectionate squeeze, and says 'Hey there, big guy. Looks like you've got some time off, so how about we...' And that's as far as he gets, as your demon companion just leans down with a rumbling purr and gives him a hungry kiss, then bodily picks up his human friend and gently gropes his ass with a clawed hand.";
	say "     With David still held tight against his broad chest, Brutus walks over to the soldier's bed and sits down on it, then proceeds to make out passionately with the young man. For now, you just watch your two friends kiss and touch each other, staying far enough away to give them at least some privacy. The demon and human whisper a bit back and forth in between kisses, then after a while, David stands up from his position on Brutus lap and starts to undress. His boots are quickly pulled off and thrown aside, followed by socks and his pants. Then the young man pulls his shirt up over his head, revealing a fit chest and nicely sculpted abs. With a wide smile on his face, he finishes up by turning around, then bending over to push down his underwear, giving Brutus a very nice and close view of his firm butt.";
	WaitLineBreak;
	say "     Not being able to keep his hands to himself during such an enticing show, Brutus reaches out and caresses the young man's cheeks, then pulls him closer to himself. Reaching around David, the large demon takes hold of his human lover's cock and slowly strokes it, making him pant and moan in lust. The soldier just enjoys getting touched for a moment, then gently takes hold of Brutus large hands and pulls them away, turning and stepping up on the bed in the progress. Coming to stand with his feet left and right of the demon's legs, David's hips now being at just about the right height for Brutus to suck his cock. The human and demon share an intense, lust-filled gaze into each other's eyes for a moment, then David takes hold of Brutus front horns and pulls his head towards his crotch.";
	say "     Following his partner's guidance, Brutus doesn't hesitate to bring his long forked tongue into play, running it over David's crotch, licking his balls, even snaking it between his legs to poke the young soldier's asshole for a second, before he wraps it around his cock. His large hands reach up to hold on to David's hips, fingers softly squeezing his buttcheeks while his tongue plays over the human's manhood, licking and squeezing. After some more teasing, he gently takes hold of it with his lips and goes down on it, taking care to keep the precious piece away from all the sharp teeth filling his mouth as he bobs up and down. Judging from David's groans and urgent panting, it's pretty obvious that he's doing an amazing job at giving oral sex.";
	WaitLineBreak;
	say "     As good as the blowjob is making him feel, David still doesn't forget about Brutus pleasure. You can see him look over his shoulder and down at Brutus massive, hard cock, then he tells the demon to stop for a moment and pulls his own cock out of Brutus mouth. Holding on to his partner's wide shoulders, David then lowers himself to kneel over Brutus lap, allowing the demon's hot shaft to rub against his body. Having David slide his crack up and down on his infernal pole makes Brutus give an aroused groan, just panting loudly for a moment before he leans forward and down and starts up with the blowjob again.";
	say "     With the two of them pretty wound up and close, it doesn't take too much longer until David shouts 'I'm gonna cuummmMMM!' and thrusts his hips forward, holding on tight to Brutus horns as he blasts his load down in the demon's mouth. His whole body shakes and twitches with each spurt that Brutus eagerly swallows. When David finally winds down some short while after, he sinks down to fully sit on Brutus lap and seeks out his lips for a long and deep kiss, followed by another and another. While still tongue-wrestling with his demon friend, he starts sliding himself back and forth on top of Brutus still massively erect cock, driving him to his own orgasm just moments later. The thick member starts pulsing as squirt after massive squirt of cum blasts out of it, shooting as far as the bed two rows over, almost reaching the third and creating a long line of white splatters.";
	WaitLineBreak;
	say "     'That was great. Thanks, baby.' Brutus rumbles to David and gives him a quick kiss, then pulls him close to his chest as he lies down on the bed. Worn out from sex, the two of them end up resting together, with David half draped over Brutus large form. They continue to silently talk and whisper to each other for some time, then eventually doze off.";

to say DavidSex9: [Brutus & David Scene (Brutus gets fucked)]
	say "     Stepping up close to the young soldier, you... casually mention that you won't be needing Brutus assistance for a while. [if companion of player is demon brute]Perking up visibly at your announcement, David's eyes immediately are drawn to the demon's muscular form, standing not too far away in all his naked glory. With a chuckle, you tell the man to just go for it and spend some time with his friend. [else]Perking up visibly at your announcement, David's eyes immediately are drawn to the demontooth amulet around your neck. With a chuckle at the mixed expression of hope and lust in his gaze, you give him a nod and intone the magic words to summon Brutus. While the cloud of purple smoke starts to swirl out of the amulet to coalescence into Brutus form, you tell David to have fun as he spends some time with his friend. [end if]Not wasting a second, David immediately moves over to Brutus and puts a hand on his arm, giving it an affectionate squeeze, and says 'Hey there, big guy. Looks like you've got some time off, so how about we...' And that's as far as he gets, as your demon companion just leans down with a rumbling purr and gives him a hungry kiss, then bodily picks up his human friend and gently gropes his ass with a clawed hand.";
	say "     With David still held tight against his broad chest, Brutus walks over to the soldier's bed and sits down on it, then proceeds to make out passionately with the young man. For now, you just watch your two friends kiss and touch each other, staying far enough away to give them at least some privacy. The demon and human whisper a bit back and forth in between kisses, then after a while, David stands up from his position on Brutus lap and starts to undress. His boots are quickly pulled off and thrown aside, followed by socks and his pants. Then the young man pulls his shirt up over his head, revealing a fit chest and nicely sculpted abs. With a wide smile on his face, he finishes up by turning around, then bending over to push down his underwear, giving Brutus a very nice and close view of his firm butt.";
	WaitLineBreak;
	if DemonBruteStatus is 2 or DemonBruteStatus is 1: [female+herm Brutus]
		say "     Not being able to keep his hands to himself during such an enticing show, Brutus reaches out and caresses the young man's cheeks, then takes hold of his erect manhood. The demon slowly jerks his friend off for a moment, then his deep voice rumbles 'I want to feel you inside me...' Leaning back on the bed Brutus pulls up his legs, holding them with both hands in a spread position that bares his wet pussy for David. Spinning to face his demon lover, the soldier eagerly steps forward and rubs his cock over Brutus's swollen nether lips, then nudges them apart with the tip of his shaft. Both of them moan in arousal as David's invading member sinks deeper into his infernal partner's warm depths. When he finally bottoms out inside him, David's balls resting against Brutus crotch, he takes a moment to savor the feeling, taking deep breaths and stroking Brutus legs.";
		say "     After a short while of having his human partner just stay still with his cock buried in his vagina, Brutus gets a bit impatient and starts to flex his inner muscles around David's shaft. In a tone that betrays his deep-seated need, he groans 'Fuck me. Now!' - prompting David to immediately pull back till only the head of his cock is left inside him, then start thrusting in and out. The demon moans loudly each time his human partner bottoms out inside him and quickly starts to pant 'Harder! Faster!' Speeding up more and more oblige Brutus, soon David is really pounding the demon, his hips slapping against Brutus muscular buttcheeks with each thrust. While he's getting fucked hard and deep, Brutus long tail rubs up against David, sometimes wrapping around his chest or leg.";
		WaitLineBreak;
		say "     The demon brute is the first one to cum from their coupling, his moans first getting deeper and louder, then turning into lust-filled roars as he bucks against David [if DemonBruteStatus is 1]and starts spraying long ropes of cum all over himself while gushing gushing femcum out of his vagina[else]and his pussy gets wet with femcum gushing out of it[end if]. With Brutus inner muscles twitching around his cock, David isn't far behind, his arousal quickly mounting to a breathtaking orgasm after just a few more thrusts. Bringing out a loud gasp, he slams into Brutus one last time, his shaft buried deeply as it starts unloading spurt after spurt of cum. Holding on to the demon's legs as his own knees get a bit weak, the young man fills Brutus womb with his human seed.";
		say "     As he finishes coming, David gently pulls his softening cock out, then climbs on the bed to give Brutus a kiss. After a bit of moving around, the two of them end up stretched out on the bed together, with David half draped over Brutus large form. They continue to silently talk and whisper to each other for some time, then eventually doze off.";
	else if DemonBruteStatus is 0: [male Brutus]
		say "     Not being able to keep his hands to himself during such an enticing show, Brutus reaches out and caresses the young man's cheeks, then takes hold of his erect manhood. The demon slowly jerks his friend off for a moment, then his deep voice rumbles 'I want to feel you inside me...' Leaning back on the bed Brutus pulls up his legs, holding them with both hands in a spread position that bares his asshole for David. Spinning to face his demon lover, the soldier eagerly steps forward and rubs his cock over Brutus's pucker, then slowly pushes forward until his shaft pops inside. Both of them moan in arousal as David's invading member sinks deeper into his infernal partner's warm depths. When he finally bottoms out inside him, David's balls resting against Brutus muscled cheeks, he takes a moment to savor the feeling, taking deep breaths and stroking Brutus legs.";
		say "     After a short while of having his human partner just stay still with his cock buried in his ass, Brutus gets a bit impatient and starts to flex his inner muscles around David's shaft. In a tone that betrays his deep-seated need, he groans 'Fuck me. Now!' - prompting David to immediately pull back till only the head of his cock is left inside him, then start thrusting in and out. The demon moans loudly each time his human partner bottoms out inside him and quickly starts to pant 'Harder! Faster!' Speeding up more and more oblige Brutus, soon David is really pounding the demon's ass, his hips slapping against Brutus muscular buttcheeks with each thrust. While he's getting fucked hard and deep, Brutus long tail rubs up against David, sometimes wrapping around his chest or leg.";
		WaitLineBreak;
		say "     The demon brute is the first one to cum from their coupling, his moans first getting deeper and louder, then turning into lust-filled roars as he bucks against David and cum starts gushing out of his thick shaft. Spurt after massive spurt jets up into the air, most landing on his chest and a few even hitting Brutus in the face, to be quickly licked up by his long forked tongue. With Brutus anal muscles twitching around his cock with each burst of the demon's cum, David isn't far behind, his arousal quickly mounting to a breathtaking orgasm after just a few more thrusts. Bringing out a loud gasp, he slams into Brutus one last time, his shaft buried deeply as it starts unloading spurt after spurt of cum. Holding on to the demon's legs as his own knees get a bit weak, the young man fills Brutus insides with his human seed.";
		say "     As he finishes coming, David gently pulls his softening cock out, then climbs on the bed to give Brutus a kiss. After a bit of moving around, the two of them end up stretched out on the bed together, with David half draped over Brutus large form. They continue to silently talk and whisper to each other for some time, then eventually doze off.";
	else:
		say "ERROR-Demon Brute-[DemonBruteStatus]C: He isn't in one of the states he should be in! Please report how you got to this message.";

to say DavidSex10: [Brutus & David Scene (David gets fucked)]
	say "     Stepping up close to the young soldier, you... casually mention that you won't be needing Brutus assistance for a while. [if companion of player is demon brute]Perking up visibly at your announcement, David's eyes immediately are drawn to the demon's muscular form, standing not too far away in all his naked glory. With a chuckle, you tell the man to just go for it and spend some time with his friend. [else]Perking up visibly at your announcement, David's eyes immediately are drawn to the demontooth amulet around your neck. With a chuckle at the mixed expression of hope and lust in his gaze, you give him a nod and intone the magic words to summon Brutus. While the cloud of purple smoke starts to swirl out of the amulet to coalescence into Brutus form, you tell David to have fun as he spends some time with his friend. [end if]Not wasting a second, David immediately moves over to Brutus and puts a hand on his arm, giving it an affectionate squeeze, and says 'Hey there, big guy. Looks like you've got some time off, so how about we...' And that's as far as he gets, as your demon companion just leans down with a rumbling purr and gives him a hungry kiss, then bodily picks up his human friend and gently gropes his ass with a clawed hand.";
	say "     With David still held tight against his broad chest, Brutus walks over to the soldier's bed and sits down on it, then proceeds to make out passionately with the young man. For now, you just watch your two friends kiss and touch each other, staying far enough away to give them at least some privacy. The demon and human whisper a bit back and forth in between kisses, then after a while, David stands up from his position on Brutus lap and starts to undress. His boots are quickly pulled off and thrown aside, followed by socks and his pants. Then the young man pulls his shirt up over his head, revealing a fit chest and nicely sculpted abs. With a wide smile on his face, he finishes up by turning around, then bending over to push down his underwear, giving Brutus a very nice and close view of his firm butt.";
	WaitLineBreak;
	if a random chance of 1 in 2 succeeds: [missionary]
		say "     Not being able to keep his hands to himself during such an enticing show, Brutus reaches out and caresses the young man's cheeks, then pulls him closer to himself and leans forward. Bringing his long forked tongue into play, the demon runs it up and down David's crack, teasing his pucker with the tip, then even snakes it between his legs to lick the soldier's balls and cock for a second, before coming back to his asshole. With a gentle push, it slips in, wiggling deep into David's body and teasing him in spots that make the young man shiver and gasp in arousal. While expertly eating out David's hole, Brutus strokes his massive erection with one hand spreading his precum all over it to get it nice and slippery, making very clear what he wants to do next. After some moments more of this, the demon suddenly stands and sweeps up David in his muscular arms, then lowers him on the bed to lie under him.";
		say "     In a deep voice full of lust and need, Brutus says, 'I want to fuck you. Now. Hard,' and David just moans yes and pulls his head down for a kiss. After coming back up for air, Brutus lifts and spreads his human lover's legs, then he moves forward, his massive member slowly increasing its pressure against David's asshole until the head pushes open his pucker, stretching it wide as he enters the soldier's body with his hard shaft. Knowing how big your infernal companion's manhood his, you're not surprised at all to hear David gasp from the initial penetration. But then, as it sinks deeper into his body, pleasant feelings prevail as the bumps on Brutus's shaft rub his inner walls. Even as relaxed as his muscles got during the thorough eating out the demon gave him it's still quite a lot to take. Thankfully, Brutus seems to know what very well, only slowly moving deeper and often stopping to just hold David so he can get used to it. Finally he bottoms out inside the human, hard shaft buried all the way and his two large cum-factories resting against his skin. Panting deeply, they find each other's lips and share kiss after kiss. It's pretty amazing if one thinks about it - this huge, muscular creature who was a ravening beast not too long ago, now together with a human on a bed, being as gentle as he can be with his equipment.";
		WaitLineBreak;
		say "     A few minutes of making out with Brutus later, David tells him to continue - slowly. Moving in and out, the bumps on Brutus's cock rub against David's stretched insides, making him shudder with rising lust. From the looks of it, it becomes easier to have Brutus inside over time, with the demon leaking more and more precum and David's muscles being stretched out and getting used to it. All of which allows your infernal companion to speed up his thrusts, going faster and faster, the slapping noises of his balls against David's hips now coming in rapid succession. Soon, this drives the human's arousal over the edge and with a loud moan, his cock sprays cum all over his chest.";
		say "     Obviously very pleased at getting his friend off, and with David's asshole twitching around his cock as he orgasms, Brutus joins the young soldier in climax just moments later. With a satisfied roar, he slams his massive cock all the way into David and begins to pump his bowels full of his demonic seed. Easily filling David's asshole and intestines, the remaining cum starts squirting out around the demon's thick cock as he thrusts into him a few more times. As he finally removes his cock with a loud *pop*, David's stomach looks distended from the sheer amount of cum that was injected into him, with more of it leaking from his hole to soak into the sheets.";
		WaitLineBreak;
		say "     'That was great. Thanks, baby.' Brutus rumbles to David and gives him a quick kiss, then pulls him close to his chest as he rolls them over. Worn out from sex, the two of them end up resting together, with David half draped over Brutus large form. They continue to silently talk and whisper to each other for some time, then eventually doze off.";
	else: [doggy]
		say "     Not being able to keep his hands to himself during such an enticing show, Brutus reaches out and caresses the young man's cheeks, then pulls him closer to himself and leans forward. Bringing his long forked tongue into play, the demon runs it up and down David's crack, teasing his pucker with the tip, then even snakes it between his legs to lick the soldier's balls and cock for a second, before coming back to his asshole. With a gentle push, it slips in, wiggling deep into David's body and teasing him in spots that make the young man shiver and gasp in arousal. While expertly eating out David's hole, Brutus strokes his massive erection with one hand spreading his precum all over it to get it nice and slippery, making very clear what he wants to do next. After some moments more of this, the demon eventually tugs on David's hips, telling him to get on his knees. As his human friend readily obeys, Brutus kneels behind him in turn, the erect cock between his legs swinging up and down as if in anticipation. ";
		say "     In a deep voice full of lust and need, Brutus says, 'I want to fuck you. Now. Hard,' and David just moans yes and lowers his head to the ground, raising his ass in invitation. Brutus grunts deeply at the submission his lover shows, then shifts forward a little, bringing the cockhead of his massive member to rub up and down along David's crack. There is an intake of breath from the kneeling man as it catches an edge of his pucker and Brutus starts pushing against it, slowly increasing its pressure against David's asshole until the head suddenly pops in. Knowing how big your infernal companion's manhood his, you're not surprised at all to hear David gasp from the initial penetration. But then, as it sinks deeper into his body, pleasant feelings prevail as the bumps on Brutus's shaft rub his inner walls. Even as relaxed as his muscles got during the thorough eating out the demon gave him it's still quite a lot to take. Thankfully, Brutus seems to know what very well, only slowly moving deeper and often stopping to just hold David so he can get used to it. Finally he bottoms out inside the human, hard shaft buried all the way and his two large cum-factories resting against his skin. Panting deeply, the demon bends forward to hug his lover from behind, and the two of them find each other's lips and share kiss after kiss. It's pretty amazing if one thinks about it - this huge, muscular creature who was a ravening beast not too long ago, now together with a human in an embrace, being as gentle as he can be with his equipment.";
		WaitLineBreak;
		say "     A few minutes of making out with Brutus later, David tells him to continue - slowly. Moving in and out, the bumps on Brutus's cock rub against David's stretched insides, making him shudder with rising lust. From the looks of it, it becomes easier to have Brutus inside over time, with the demon leaking more and more precum and David's muscles being stretched out and getting used to it. All of which allows your infernal companion to speed up his thrusts, going faster and faster, the slapping noises of his balls against David's ass now coming in rapid succession. Soon, this drives the human's arousal over the edge and with a loud moan, his cock sprays cum all over the ground under him.";
		say "     Obviously very pleased at getting his friend off, and with David's asshole twitching around his cock as he orgasms, Brutus joins the young soldier in climax just moments later. With a satisfied roar, the demon's cock starts pumping the man's bowels full of his demonic seed, easily filling David's asshole and intestines in a few big throbs. When more and more cum starts to squirt out around the purple pole from David's well-bred ass, Brutus finally pulls back, removing his erection from David's hole with a wet slurp and having it geyser even more demon seed all over the soldier's back. By the time the demon brute's orgasm finally subsides, David is thoroughly drenched in cum, inside and out.";
		WaitLineBreak;
		project the figure of BrutusFuckingDavid_icon;
		WaitLineBreak;
		say "     'That was great. Thanks, baby.' Brutus rumbles to David and gives him a quick kiss, then pulls him close to his chest as lays back. Worn out from sex, the two of them end up resting together, with David draped over Brutus large form. They continue to silently talk and whisper to each other for some time, then eventually doze off.";

to say DavidSex11: [Brutus & David Threesome (Brutus gets DP'd)]
	say "     Stepping up close to the young soldier, you put your arms around him and pull him in for a deep kiss, then let your hands wander down to his crotch. Through the material of his pants you feel his manhood already filling out, as his body reacts to your kiss and touch. As you make out with him some more, you slide your hands under his shirt and feel your way up his hard-muscled chest, then pull the fabric up and over his head. Leaning down a bit you run your tongue over his nipples, playfully sucking on first one, then the other. From David's urgent moans, he's ready for some action.";
	say "     Smiling, you whirl David around and wrap your arms around his chest from behind, then move a hand down to his crotch. Sliding it under the band of his pants, you fondle your soldier boy's cock and balls, making him pant and groan in lust some more, then ask him if he'd like to make this a threesome. [if companion of player is demon brute]Following a little nod of your head with his gaze, David's eyes get wide as he sees Brutus standing not too far away, already sporting a massive erection from just watching you fondle David. With a boyish grin, the young soldier tells you 'Sure, let's have some fun together', then waves Brutus closer with an eager expression[else]Following a little nod of your head with his gaze, David's eyes get wide as he focuses on the demontooth amulet around your neck. He runs a finger along the leather band and over the blackened tooth, then tells you with a boyish grin 'Sure, let's have some fun together.' Smiling at the eagerness of the young soldier, you intone the magic words to summon Brutus, who materializes in his full naked glory moments later[end if]. The three of you end up touching, kissing and undressing each other, which is so much fun that you almost have to force yourself to stop and guide your two friends over to David's bed.";
	WaitLineBreak;
	say "     Sliding a hand down Brutus back, you give his left buttcheek an appreciative squeeze, then playfully brush your fingers over his pucker and tell the demon that you want to fuck his ass - together with David. With a pleased rumble, he answers, 'Of course, Master,' his cock twitching a bit in anticipation. 'Anything for you - and for you, too,' he says, the last bit directed to David and immediately followed by a deep kiss with the young soldier. Leaning down, Brutus picks David up bodily, then gently lowers him on his bed and climbs on it himself, moving into position on all fours over him. Brutus slides his hips down a bit, then a bit more until he feels David's hard cock against himself. Without any hesitation, he sinks his hole down over the human's erection, groaning in pleasure as it fills his tight hole.";
	say "     Watching your infernal companion fuck himself on David's manhood has you spellbound for a moment - such a big creature so eagerly riding a smaller male - until your throbbing erection reminds you to get involved yourself. Stepping up on the bed, you move into position behind Brutus and kneel down, taking hold of the base of his tail to get him to hold still for a moment. Then you line up your cock with his pucker and press in beside David's hard shaft. There is a groan from Brutus as you pop in and force his already stretched pucker to open even wider, though as you hold still for a moment and ask if he's okay, the demon just grunts 'Yes. Just fuck me. Hard. Now!' Obliging the urgent request, you go on and thrust in, stuffing Brutus ass with your cock.";
	WaitLineBreak;
	say "     The demon's hole is hot and tight around your [cock of player] manhood and the pulsing and grinding of your friend David's cock against your own only makes it even better[if cock length of player < 6]. When compared to David's nicely long shaft, your own his a bit shorter, but it still adds more to a well-stuffed hole. Brutus pants and moans loudly as his two favorite persons fuck him, really enjoying the full feeling it gives him.[else if cock length of player < 11]. Further adding your [cock length of player] inch shaft alongside David's further stretches an already well-stuffed hole. The two of you are roughly the same length and you vie with him for who can thrust deeper into Brutus. The demon himself just pants and moans loudly as his two favorite persons fuck him, really enjoying the full feeling it gives him.[else]. The addition of your cock, even longer than David's well-sized one, further stretches an already well-stuffed hole. Being the shorter one of you two just animates David to thrust even harder into Brutus ass, while the demon himself just pants and moans loudly as his two favorite persons fuck him, really enjoying the full feeling it gives him.[end if]";
	say "     Getting fucked in his muscled ass from below and behind drives Brutus further and further into a state of uncontrolled arousal. His moans and grunts get louder and wilder, gaining a beast-like intensity as he nears the point of no return. Then finally, he gives a loud roar and comes, hot demon seed spurting from his shaft and all over David's chest and face. The way the Brutus's ass clamps down around your poles and twitches with each blast of his cum shooting out sets the David and yourself off as well, blasting your loads deep into the demon's bowels. Your [cum load size of player] output mixes with the soldier's heavy load, filling the demon's ass with cream.";
	WaitLineBreak;
	say "     Looking back over his shoulder, Brutus says 'Thank you, master', then he turns back to David ands tarts to lap at his chest and face, slurping up his own cum and playing a long forked tongue over David's muscles. Brutus method of 'cleaning up' soon escalates into a hot make-out session, and after a while the two of them move around a bit so they can stretch out on the bed together, with David half draped over Brutus large form.";

instead of going down from the Grey Abbey Library while (David is in Bunker and RyouseiDavidInteraction is 0 and companion of player is royal tiger):
	move player to Bunker;
	if debugactive is 1:
		say "     DEBUG: David meets Ryousei; RyouseiDavidInteraction: [RyouseiDavidInteraction][line break]";
	say "     As you come down the stairway and walk into the main room of the bunker, you spot David nearby - casually leaning against the wall while reading a book. He seems quite absorbed by the story playing out in the pages of his novel, so you decide not to call out to him in greeting and just get on with what you were doing. Yet as you turn away from the young soldier and take your first step, your tiger companion lets out a deep-voiced mrowl from the depth of his throat and walks over to David instead. The muscular man remains focused on his book for a few more heartbeats, then notices Ryousei's movement towards him and looks up.";
	say "     'What the - a tiger?!' David exclaims, becoming wide-eyed as he takes in the six and a half foot tall anthro tiger walking purposefully towards him. Taking to a more active stance in an eye-blink, trained muscles tensing as he tries to decide what's going on, the soldier's gaze flicks over the room around him to take everything in at a rush. Things like ways of escape, options to take in a fight, other people - like you, for example. He looks at you and is momentarily surprised at how calm you are, watching him and Ryousei. Then the large cat is upon him, showing David a smile that reveals his impressive set of teeth and giving a little bow in greeting.";
	WaitLineBreak;
	say "     'Hajimemashite, human. I am Ryousei, first general of the mighty shogun Aki,' your feline companion introduces himself, patiently waiting for David to get over his initial shock, then come to attention. 'David Jackson, private in the US army. Er - nice to meet you sir?' the soldier replies, still rather surprised at the calm and cultured demeanor of this nonhuman companion of yours. 'Splendid. May I ask you a question, David Jackson?' Ryousei continues, still giving David a friendly smile. Getting a nod from the human soldier a few seconds later, the anthro tiger reaches out to hook a finger under the chain of David's dog tags, pulling them up to dangle freely in the light.";
	say "     'So from what I could so far learn of your culture, these are worn by soldiers in these parts. I was wondering - what is their effect? Do they protect you from mental influence? Stop wounds from bleeding?' he asks David, curiosity clearly audible in his voice. David gapes a moment at the question, then replies, 'No - they're just... dog tags. You know, to show who you are. If... something happens and it is hard to tell otherwise.' This explanation surprises Ryousei quite a bit, making the tiger's brows draw together in puzzlement. 'You fight enemies that would disfigure their fallen opponents?! Take away their faces? What a vile practice! In our land, the historian accompanying each army will record the names and grave-sites of everyone on both sides who met their fate. If your enemy fought bravely, the last you can do is remember them.'";
	WaitLineBreak;
	say "     The tall tiger's assumptions and revelations make David pause for a moment, opening his mouth but not quite knowing what to say. Then finally he finds his voice and replies, 'Er... yes. That sounds pretty nice and civilized. But - war is war, you know?' Ryousei nods thoughtfully, then makes a fist over his heart and makes a slightly lower bow than before. Raising his hand, he puts it on David's shoulder and gives the human a friendly squeeze while saying, 'You have my respect, human warrior. Going into battle against those... face-stealer savages wearing an amulet that does nothing more than tell who you are if you fall. You are indeed a brave man, maybe even akin to those few that accompanied me on the hunt for red oni. Few are ready to die and be forgotten - either as faceless husks or a monster's meal.'";
	say "     With that said, Ryousei gives David a friendly pat and adds, 'I do hope we see each other again soon, David Jackson. Maybe we can trade battle-tales.' Then the tall anthro walks away from his new acquaintance, leaving the puzzled young man behind as he takes his position beside you again.";
	now RyouseiDavidInteraction is 1;
	now lastRyouseiDavidInteraction is turns;

after going down from Grey Abbey Library while (David is in Bunker and RyouseiDavidInteraction < 2 and companion of player is royal tiger and (lastRyouseiDavidInteraction - turns > 6)):
	if RyouseiDavidInteraction is 1:
		if debugactive is 1:
			say "     DEBUG: David & Ryousei Scene; RyouseiDavidInteraction: [RyouseiDavidInteraction][line break]";
		say "[DavidRyouseiScene1]";
	else if RyouseiDavidInteraction is 2:
		if debugactive is 1:
			say "     DEBUG: David & Ryousei Scene; RyouseiDavidInteraction: [RyouseiDavidInteraction][line break]";
		say "[DavidRyouseiScene2]";
	else if RyouseiDavidInteraction is 3:
		if debugactive is 1:
			say "     DEBUG: David & Ryousei Scene; RyouseiDavidInteraction: [RyouseiDavidInteraction][line break]";
		say "[DavidRyouseiScene3]";

to say DavidRyouseiScene1:
	say "     Coming down into the bunker, you soon find yourself without your tiger companion by your side, as Ryousei wanders off to say hello to David when he spots the young man doing push-ups a short distance away. 'Greetings, David Jackson,' the anthro feline says in a friendly tone, giving a little bow. David goes on to finish his current set of... six, seven, eight push-ups, then pushes himself off strongly, getting his feet under him and standing up straight in an impressive show of athleticism. 'Hello Ryousei, nice to see you big guy,' the human tells your tiger companion, offering him his hand to shake and adding, 'And by the way, you can just call me David, okay? Don't need the last name all the time.'";
	say "     'Of course. David it is then,' Ryousei answers, bypassing the human's hand and giving his underarm a tight grip, something your soldier friend returns after catching on a second or two later. 'I see you are in training, steeling yourself for battle. A warrior's work never ends, right?' the tiger starts a nice little banter with David, and the two of them chat about keeping fit and training. Eventually, Ryousei says, 'I have to say that I am curious what sort of techniques your people use in a fight. How about a friendly duel to measure up against each other? And don't worry, I'll keep the claws sheathed for this one.' Accompanying the last sentence, the tiger flexes the fingers on one hand to show off his set of curved feline claws, then lets them retract again with a twitch.";
	WaitLineBreak;
	say "     'Sure - I guess,' David replies while scratching the back of his head a bit unsurely. Seems like the man still doesn't know what to expect from his new acquaintance - and how could he, given Ryousei's otherworldly origin. With the decision made to fight, the tiger is quick to collect the thin mattresses from a number of unused beds, spreading them on the ground as an improvised training mat. After that, he strips down, unwrapping his muscular body from its kimono till the only garment on his body is a white fundoshi. Gesturing for David to take position on one end while he himself takes a stance on the other, the fight is set up. After another bow, the tiger starts to approach his human opponent in a combat-ready stance, moving slowly to study David's movements. Tension builds between them as they circle one another, then the first blow is struck - and ducked, by David.";
	say "     What follows is a flurry of punches, strikes and grappling - none of it too hard, as both of the men try not to hurt the other. It is fairly fun to watch, two trained men making blow and counter-blow, ducking and evading or sometimes even intentionally taking a hit to get into a better position. Still, it isn't hard to realize that Ryousei has been going easy on his human buddy, especially when you see the lightning-quick leg sweep with which he sends David down on the mat at the end of it. The human soldier lies panting on the mattress for a second, then sees Ryousei's tail flicking past in his line of sight and makes a grab for it. Hands closing on the striped appendage, the soldier takes a tight grip and gives a sudden tug, unbalancing a very surprised-looking Ryousei. A (soft) kick to the back of the tiger's hollow of the knee brings Ryousei down on his back too, hitting the mattresses right next to the soldier.";
	WaitLineBreak;
	say "     For a moment, the two fighters just stay lying flat, taking deep breaths and grinning, then David pushes himself up on one elbow and says loudly, 'Good workout! That was fun - even if you clearly could have kicked my ass at any moment. I wouldn't mind learning some of those moves.' Ryousei in the meantime gets his paws back under him, but stays crouched down next to his buddy to talk to him. 'I will gladly teach you, my friend. I do have one question first though... that last thing you did - was that just an expression of your people's 'no holds barred' fighting style for beating the face-stealers, or did you actually mean it?'";
	say "     David's eyebrows rise and he takes on a somewhat concerned expression as he says, 'Err... what do you mean?' Ryousei chuckles, 'Stroking another male's tail is... an intimate gesture. One of the traditional ways of declaring interest. A two-handed yank - like yours, hah - is comparable to, well... shouting your intentions out loud on the market square.' The soldier gapes at him, mouth open in an 'o' and cheeks reddening. Ryousei laughs at his friend's shock, then adds, 'I thought as much. Guess you just have to use every weapon in your disposal to beat those merciless opponents of yours - even amorous gestures to unbalance your enemy.'";
	WaitLineBreak;
	say "     Closing his open mouth with a snap and gulping, David starts to apologize, only to be stilled by Ryousei's large hand on his chest in a calming gesture. 'It is okay friend. I'm not offended. In fact... weather you meant it in earnest or not, I can say that I am... interested. Given the weeks and months on campaign, finding some rest in the arms of a fellow soldier is just natural.' Ryousei's grin gets a little wider and a loud purr resonates in the depth of his broad chest. The anthro tiger strokes his hand down David's front, feeling the trained man's pecs and abs, then pulls it away and stands up. 'Feel free to think about it and to tell me if you want to try other fun things to do on mattresses,' Ryousei says with a wink, then leaves David to think in peace and goes to put on his kimono again.";
	now RyouseiDavidInteraction is 2;
	now lastRyouseiDavidInteraction is turns;

to say DavidRyouseiScene2:
	say "";

to say DavidRyouseiScene3:
	say "";

Section 3 - Endings

David ends here.
