Version 1 of Erica by Wahn begins here.
[Version 1: split off from Eric]

"Adds an NPC named Erica to the Flexible Survival game"

[ Dexterity states of Erica                                           ]
[   0: Erica quest not started                                        ]
[   1: Eric asked for help in becoming Erica                          ]
[   2: talked with Valerie                                            ]
[   3: talked with Hera                                               ]
[   4: found Joel                                                     ]
[   5: gave the seed to Eric                                          ]
[ 100: quest refused /failed                                          ]

[ HP states of Erica                                                  ]
[   0: virgin in the Bunker                                           ]
[   1: in the Bunker                                                  ]

[ Thirst states of Erica (for the smell)                              ]
[   0: Smells female + fertile                                        ]
[   1: Smells female + pregnant pussy                                 ]

[ Libido states of Erica (for reactions against a player furling)     ]
[   0: Erica has never seen the player in Furling shape               ]
[   1: Erica has seen the player in Furling shape - is not frightened ]

[ Level states of Erica (for sex with the Felinoid)                   ]
[   0: starting state                                                 ]
[   1: Felinoid fucked her (unseen by the player)                     ]
[   2: Felinoid fucked her (unseen by the player, but she told them)  ]
[   3: Felinoid fucked her (seen by the player)                       ]
[   4: Player told her that they're okay with it                      ]
[  99: the player stopped the Felinoid from fucking her               ]

[ XP states of Erica (for sex with Fang)                              ]
[   0: starting state                                                 ]
[   1: Fang fucked her (unseen by the player)                         ]
[   2: Fang fucked her (unseen by the player, but she told them)      ]
[   3: Fang fucked her (seen by the player)                           ]
[   4: Player told her that they're okay with it                      ]
[  99: the player stopped Fang from fucking her                       ]

[ CarlEricInteraction                                                 ]
[   0: not met                                                        ]
[   1: ran into each other in the library                             ]
[   2: Jogged together & Talked                                       ]
[   3: Talked about being a dog & being a former male                 ]
[   4: Did sit-ups together                                           ]
[   5: Carl got the go-ahead from the player for a move on Erica      ]
[   6: Carl fucked Erica                                              ]
[  50: player told Carl to stop pursuing Erica                        ]

[ Lust states of Erica (for sex with David)                           ]
[   0: starting state                                                 ]
[   1: talked with David about Erica                                  ]
[   2: David talked with Erica                                        ]
[   3: ready for sex with David                                       ]
[   4: had sex with David                                             ]
[  50: David was present for Eric's transformation                    ]

CarlEricaInteraction is a number that varies.

instead of going down from the Grey Abbey Library while (Dexterity of Erica is 0 and (HP of Eric > 9 and HP of Eric < 16)):
	move player to Bunker;
	if debugactive is 1:
		say "     DEBUG: ERIC/ERICA QUESTION[line break]";
	say "     As you come down the stairs and enter the bunker, you find Eric waiting for you. He swallows visibly, then walks up to you and says in a halting voice, 'I - I've been thinking. Maybe... if - you know,' he waves a hand at his crotch meaningfully, then takes a breath and continues, 'If the pussy is here to stay... wouldn't it be better if I saw this thing through all the way somehow? If I was a real woman? Not - stuck like this. Halfway. A freak for some...'";
	say "     It's clear that the young man is pretty unsure about his whole body image, even though he may have accepted his new gender. And now he turns to you, his savior, hoping that you'll make a decision for him. Better choose well, Eric will take what you say next to heart.";
	LineBreak;
	say "     So, what do you tell him?";
	say "     ([link]Y[as]y[end link]) - That he's perfect as he is and shouldn't worry about what others think.";
	say "     ([link]N[as]n[end link]) - That you'll support his wish to become fully female.";
	if player consents:
		LineBreak;
		say "     Gently putting a hand on Eric's shoulder, you talk to him until he calms down and say that he shouldn't have to change to conform to anyone's views. What's important is that he feels good in his own skin. After a short conversation in which you build up his confidence in himself, reminding him of his athletic achievements and all that, the cuntboy gives a relieved smile and puts his idea of maybe being a woman to rest.";
		now dexterity of Erica is 100; [Erica transformation quest blocked]
	else:
		LineBreak;
		say "     Gently putting a hand on Eric's shoulder, you talk to him until he calms down and say that completing his transformation might be best. Just as long as it's what he himself really wants, not simply conforming to anyone else's views. After a short conversation in which he mulls it over again, then decides that he truly wants to be a full woman. A moment later, the young man says, 'Ha - here I am talking like I got a transformation pill in my pocket. Since it seems that the nanites can't finish what they started, we don't even know if there is a way to do this.'";
		say "     At least on that front, you've got an idea. Magic might help out where technology fails. There could be any number of helpful artifacts in the depths of the [bold type]museum[roman type]. Maybe you should visit it sometime...";
		now dexterity of Erica is 1; [Erica transformation quest step 1 - Talk to Valerie]

[ Next part of the quest in /Sarokcat/Museum.i7x (talking to Valerie)]

Temple of Hera is a situation.
The sarea of Temple of Hera is "Museum".
when play begins:
	add Temple of Hera to badspots of guy;       [male soldiers]
	add Temple of Hera to badspots of furry;     [female husky involved]
	now Temple of Hera is resolved;

Instead of resolving a Temple of Hera:
	say "     After walking through the labyrinthine passages of the museum for quite a while, it becomes more and more obvious that something strange and unusual happened to this place when all the craziness started. It's a bit hard to say with hallways seemingly looping around and suddenly having developed new forks when you get to a portion that you went through before, but your guess is that you're about half a mile deep in here. At least the glowing 'EXIT' signs that every room and hallway holds give you confidence that you'll find your way back out, as every time you tried, the museum foyer was just two or three rooms back - if one follows the green arrows...";
	say "     Almost ready to call off the search after stumbling into the Easter Islands exhibit - again - for the third time, your eyes suddenly notice a sign on the wall. 'Ancient Greece' is shown above a doorway flanked by two tall Doric columns. Hopeful that you've finally found what you're looking for, you hastily make your way to the door and step through it - right into a large chamber that might just belong in an ancient temple. Marble plates cover the floor and walls, shining in an unearthly light that radiates from a large golden throne in the middle of the room and also adding in a slight echo. On it, a majestic-looking woman sits, garbed in a magnificent white tunic with gold embroidery at its edges. She sets down the large pomegranate in her hand on the armrest of the golden throne, then turns her beautiful visage to look at you.";
	WaitLineBreak;
	say "     The woman's voice rings with power as she addresses you, 'Ah, there you are mortal. Finally. Did you take your time because you were afraid? Since that slanderer Homer, you people seem to think my domain is vengeance, not women and marriage.' A hint of annoyance crosses her features, then she gives a throwing-away gesture and adds with a little smile, 'Oh well, I'm a goddess - and he's dead.' She waits a second after the slight echo of her last word fades, then clears her throat and leans forward, 'But let's get to more current matters. You come before Hera with a request for your friend Eric. His, or rather her little problem. Fine. I will aid you after you have completed a task for me.' With that, Hera turns her head to the side and commands, 'Show yourself, child. Tell this [if player is puremale]little man[else if player is purefemale]woman[else]being[end if] your story and needs.'";
	say "     A young woman steps out behind the golden throne, dressed in a similar, if less elaborate gown as Hera herself. Her eyes are a bit reddened, likely from by-now dried tears. She takes a deep breath and says, 'My name is Rebecca. I - We - me and my fiancée Joel were in the downtown area when things started to happen and... they took him from me! There were those bikers, and when he stepped between them and me to protect me, the leader just punched him out. And before I knew what was happening, he was bundled over a bike and they drove off!' She halts for a second, wiping away a new tear, then composes herself and adds, 'My mistress Hera told me he is alive and that you would come and help me. Please - find those guy's [bold type]hangout[roman type] in the [bold type]Junkyard[roman type] and bring Joel back to me!'";
	WaitLineBreak;
	say "     Hera herself adds in, 'There you have it. Go forth and knock a few heads together - you mortals are good at that, aren't you...' With a slight flick of her wrist, you feel yourself pushed out the door, stumbling right into the museum foyer through it.";
	now Temple of Hera is resolved;
	now Dexterity of Erica is 3;

Biker Hangout is a situation.
The Prereq1 of Biker Hangout is Temple of Hera.
The sarea of Biker Hangout is "Junkyard".
when play begins:
	add Biker Hangout to badspots of guy;
	add Biker Hangout to badspots of furry;

Instead of resolving a Biker Hangout:
	say "     After a while of searching, you do find a chain-link gate that leads on to the junkyard proper from an adjoining dark alley. Near that back entrance, there is a run-down shack with three bikes parked in front of it. Seems you've found the hideout of the biker gang that kidnapped Joel. There is no one in sight right now, but where the bikes are, the bikers to go with them can't be far... so you decide to scout the place out stealthily first. As you carefully make your way through the piles of rusty cars and metal scrap, always using what concealment from observation through the shack's dirty windows you can get, you soon find out that there is another structure behind the shack - a chain link dog kennel. In it, you see the humanoid figure of an anthro dog lying on the ground, a short chain connecting his collar to an iron ring anchored in the concrete floor. From the looks of it, that chain doesn't even allow him to sit up, only to cower low to the ground or lie flat.";
	say "     Before you can even think of doing anything, a scruffy-looking, mostly human man comes out of a door at the back of the shack, holding a metal bowl in his hand. He casually strolls over to the kennel, then laughs as his shout of 'Hey Joey!' makes the canine flinch. Setting the bowl of dog kibble down on the ground, the man pulls a key ring from his pocket, unlocking the door into the kennel and stepping inside. 'Time to earn your food, doggie. Let's play hide the boner,' he says with a dark chuckle, rubbing the front of his pants with one hand. Rebecca's transformed fiancée just gives a resigned whine, then lifts himself off the ground to crouch on all fours with his rear end towards his captor, who opens up his fly to pull out an erect cock. Even so, the canine has to lean his head down because the chain just isn't any longer.";
	LineBreak;
	say "     [link](1)[as]1[end link] - Stop this. Now. (Attack)[line break]";
	say "     [link](2)[as]2[end link] - Wait till the man is 'busy', then knock him out from behind.[line break]";
	say "     [link](3)[as]3[end link] - Arrange a distraction.[line break]";
	now calcnumber is 0;
	while calcnumber < 1 or calcnumber > 3:
		say "Choice? (1-3)>[run paragraph on]";
		get a number;
		if calcnumber is 1 or calcnumber is 2 or calcnumber is 3:
			break;
		else:
			say "Invalid choice. Type [link]1[end link] to attack the man, [link]2[end link] to beat him over the head while he's... busy or [link]3[end link] to arrange for a distraction.";
	if calcnumber is 1: [fight]
		say "     You rush forward, engaging the man before he can abuse Joel any more.";
		challenge "Human Gangmember";
		if fightoutcome >= 20 and fightoutcome <= 29:[lost]
			say "     Beaten, you fall down before the man's onslaught - but he doesn't stop hitting you, so enraged is he about your interference. 'So you thought you could just come here to our place and make trouble? Big mistake, buddy!' You're kicked and punched again and again, even harder when the biker's friends join him some moments later. Eventually, they drag you some distance away in the junkyard, laughing about leaving you to be devoured by a hydra. After they leave you, basically to die, the nanites infusing everything these days do their work, rebuilding your body and healing you in short order. Therefore you can actually get up and walk away, just minutes later - long before the appearance of their supposed hydra.";
			say "     With the bikers now forewarned that someone wants to get Joel back from them, you don't think that you'll be able to do so. They are sure to be more vigilant from now on, so there is little choice but to abandon this quest. Making your way back to the library, you tell Eric about what happened. 'Thanks... at least you tried,' he replies, a tone of sadness in his voice as he finally accepts that he'll just have to stay a cuntboy.";
			now Dexterity of Erica is 100;
			now Resolution of Biker Hangout is 2; [fought, lost]
			move player to bunker;
		else if fightoutcome >= 30:[fled]
			say "     Running off as quickly as you can, you leave the biker behind. It doesn't seem like he wants to follow you too much and instead gets busy fucking his 'pet' in short order. With the bikers now forewarned that someone wants to get Joel back from them, you don't think that you'll be able to do so. They are sure to be more vigilant from now on, so there is little choice but to abandon this quest. Making your way back to the library, you tell Eric about what happened. 'Thanks... at least you tried,' he replies, a tone of sadness in his voice as he finally accepts that he'll just have to stay a cuntboy.";
			now Dexterity of Erica is 100;
			now Resolution of Biker Hangout is 3; [fought, fled]
			move player to bunker;
		else if fightoutcome >= 10 and fightoutcome <= 19: [won]
			say "     Punching out the only lightly infected human, you bend down to pick up the key ring that he dropped during your fight and step forward to free the anthro canine. From this close up, you have your first real look at him - Joel has become a saluki, a slender and wiry breed of dog with a long and thin muzzle. With a short golden coat of fur and whitish-blond long hair on his ears and tail, as well as forming feathery fringes to his arms and legs, he looks pretty beautiful - even if the hair on his tail and the sides of his leg is crusted together by dried cum right now. It only takes a moment to free the young man from the collar padlocked to his neck, though he remains as he is, head lowered and shivering slightly. Man, these guys really did a number on him...";
			now Resolution of Biker Hangout is 1; [fought, won]
			say "[JoelSaved]";
	else if calcnumber is 2: [wait and hit]
		say "     As the human biker drops his pants and crouches down behind his anthro sex pet, then just rams his erection up Joel's abused asshole, you quietly pick up a rusty pipe from the piles of trash all around you. Walking towards the kennel while trying to stay out of sight from the shack windows at all times, you can't avoid stepping on some spots of rough gravel - but thankfully the gang-member doesn't hear you above the pained whining of his victim. And then, you're right behind him... raise the pipe and club the man over the head with a dull thunk. As his body falls forward on Joel's back, the transformed young man gives a frightened whine - at least until you hiss at him to keep quiet and that you're rescuing him.";
		WaitLineBreak;
		say "     Pulling the unconscious man off Rebecca's fiancée, you get your first real look at Joel - he has become a saluki, a slender and wiry breed of dog with a long and thin muzzle. With a short golden coat of fur and whitish-blond long hair on his ears and tail, as well as forming feathery fringes to his arms and legs, he looks pretty beautiful - even if the hair on his tail and the sides of his leg is crusted together by dried cum right now. It only takes a moment to free the young man from the collar padlocked to his neck, though he remains as he is, head lowered and shivering slightly. Man, these guys really did a number on him...";
		now Resolution of Biker Hangout is 4; [sneaked up and hit them]
		say "[JoelSaved]";
	else: [distraction]
		say "     Dashing back towards the front of the shack, you move up next to one of the bikes, their owner's pride and joy - then give it a powerful shove that makes it fall over, crashing down on the gravelly ground with the sounds of splintering glass and dented metal. You do the same for a second bike, then rush towards the shack, pressing yourself against its wall right at the corner - and it works... the scruffy biker who was in the kennel a moment ago comes running to the front of the shack, right past where you're hiding around the corner. It's almost comical - since the man is naked from the waist down, his cock flapping in the wind as he passes you... but then, you remind yourself just what the bastard was doing and the smile vanishes from your lips instantly. He curses loudly as he sees the damage on his bike and looks around (away from the shack) while bending over it to inspect the heavy machine.";
		WaitLineBreak;
		say "     Meanwhile, you duck behind the shack and get to the kennel as quickly as you can, pulling the key ring out of the biker's abandoned pants and stepping forward to free the anthro canine. From this close up, you have your first real look at him - Joel has become a saluki, a slender and wiry breed of dog with a long and thin muzzle. With a short golden coat of fur and whitish-blond long hair on his ears and tail, as well as forming feathery fringes to his arms and legs, he looks pretty beautiful - even if the hair on his tail and the sides of his leg is crusted together by dried cum right now. It only takes a moment to free the young man from the collar padlocked to his neck, though he remains as he is, head lowered and shivering slightly. Man, these guys really did a number on him...";
		now Resolution of Biker Hangout is 5; [distracted them]
		say "[JoelSaved]";
	now Biker Hangout is resolved;

to say JoelSaved:
	say "     Only when you gently put a hand on his shoulder and tell the saluki that his girlfriend sent you does he look up, focusing on you with sad eyes that widen as a small shimmer of hope flickers up in them. 'Rebecca? She... she's alive? I - I had lost all hope.' You are guiding the abused man from the kennel, softly explaining about his love being safe in the museum - when the shack back door opens and someone calls out, 'You done with the little bitch yet, Andy? Don't hog him all to yourself, other guys need to drain their balls too!' Then the man actually looks outside for the first time since he started talking, shouting, 'What the fuck! We got a poacher, and Andy is down! Bring the shotgun, Ulrich!'";
	WaitLineBreak;
	say "     As the unwashed human snatches up a baseball bat from beside the door and rushes outside, you hear the sound of a weapon being loaded. Ohoh - time to get out of here! Hand on Joel's slender arm, you run for your lives - literally, as a shotgun blast only narrowly misses your head a moment later. You are lucky enough not to get hurt too much, other than a scratch resulting from a little piece of shrapnel, and do manage to lose the angry bikers. Finally coming to a stop and catching your breath on the far side of the junkyard, you're left with a skittish and frightened anthro dog, who lowers his head to look at your feet as he gives a pleading whine. 'Could you - bring me to her? Please, I just want to be back with Rebecca. If - if she'll take me like this.'";
	say "     Well, that's what you're here for after all, so you console Joel, telling him that they love each other and that a little fact like suddenly being different species doesn't change a thing about that. With the shy and still from time to time trembling man in tow, you make your way back to the museum, this time finding the sign to the Greek wing after just a few rooms and hallways to walk through. Stepping into the temple of Hera, Joel is almost jumped by Rebecca, finding himself in a tight embrace with her kissing his muzzle deeply. Hera leans back on her throne and smiles as she watches the two of them kiss and talk to each other, then she eventually calls out, 'Present your mate before me, priestess.'";
	WaitLineBreak;
	say "     Power vibrates in the air as the goddess eyes the anthro canine after his lover guides the pretty frightened man before her mistress. 'A gentle soul who will be faithful and a good father to your children, I see.' After giving this judgment and nodding to Rebecca with a smile, Hera's brows draw a bit together as she continues, 'But he has been... damaged, by his ordeal. So let this be my gift to your union.' With a wave of her hand, a small sphere of golden sparkles comes into existence around Joel's head, then flickers out a moment later. The effect leaves him to stand straighter and no longer looking as if he was expecting a kick at any moment. Instant psychotherapy, you guess...";
	say "     'I hereby declare you husband and wife,' Hera says in a regal tone, then watches with a smile as Rebecca pulls Joel with her towards a side door, an eager gleam in her eyes. Calling after the newlyweds, 'May Aphrodite bless you,' the goddess then turns to you. 'You have done your task, mortal. Here is the reward your friend needs from you. Plucking a single pomegranate seed out of the fruit that is one of her divine symbols, Hera throws it towards you, making you jump forward to catch it from the air. It is tiny, but lies heavily in your hand, almost thrumming with the power that it holds. Bowing deeply before the goddess, you leave, arriving back at the museum foyer in short order.";
	move player to Museum Foyer;
	now Dexterity of Erica is 4;
	increase carried of pomegranate seed by 1;

Table of Game Objects (continued)
name	desc	weight	object
"pomegranate seed"	"A tiny seed, surrounded by red transparent pulp. It is surprisingly heavy and almost hums with inherent power."	1	pomegranate seed

instead of sniffing pomegranate seed:
say "Smells fruity.";

pomegranate seed is a grab object. pomegranate seed is not temporary.
the usedesc of pomegranate seed is "[pomegranate seed use]";

to say pomegranate seed use:
	say "After going through all the trouble of getting this thing in the first place, you shouldn't just eat it yourself. It's highly doubtful that you'd get another from Hera. Better give it to the intended recipient - Eric.";

Section 1 - Erica the female athlete

Table of GameCharacterIDs (continued)
object	name
Erica	"Erica"

Erica is a woman. The HP of Erica is usually 0. The Dexterity of Erica is usually 0.
The description of Erica is "[Ericadesc]".
The conversation of Erica is { "Mew!" }.

instead of sniffing Erica:
	if thirst of Erica is 0: [Starting state]
		say "Erica has a pretty nice, enticing smell. Underlying that, there's a slight hint of the state of her female genitalia - fertile and ready.";
	if (thirst of Erica is 1): [pregnant]
		say "Erica has a pretty nice, enticing smell. Underlying that, there's a slight hint of the state of her female genitalia - it's notably different than when you first met her. Could it be she's expecting?";

to say Ericadesc:
	if debugactive is 1:
		say "DEBUG -> HP: [HP of Erica], DEXTERITY: [Dexterity of Erica], THIRST: [thirst of Erica], LIBIDO: [libido of Erica], LUST: [lust of Erica], LEVEL: [level of Erica], XP: [XP of Erica] <- DEBUG[line break]";
	say "     Erica is a college age young woman with ginger hair, light skin and quite a few freckles. Her unlined face has a very cute look to it and she often smiles while talking. She's wearing a black t-shirt that shows off the alluring bumps of her perky B-cup breasts. Under that, the college athlete has red running shorts on, giving you a good look at those long legs that clearly show she's a runner. All in all, a very nice package - nicely muscled, while still being lithe and lean. Her left underarm shows a thin oval line of redness - a fading scar from the bite that started her initial transformation. [if UrikEricInteraction > 6]Erica also bears two small healed puncture marks just above her collarbone on the right - an affectionate mark of being Urik's honorary orc breeder slut.[end if]";
	LineBreak;
	say "     She's lived herself in at the bunker by now, and it looks like she has gone out and brought some more of her stuff in here in the meantime. Beside her camp bed there are several sports bags full of clothing and supplies, and a baseball bat rests against it for when she goes outside. You often see her stretching and working out - like right now for example, as you stop and watch her move her inviting lithe body. Erica notices you standing there, and gives you a shy smile, then goes on with her exercises.";

instead of conversing the Erica:
	LineBreak;
	say "What do you want to talk with Eric about?";
	now sextablerun is 0;
	blank out the whole of table of fucking options;
	[]
	choose a blank row in table of fucking options;
	now title entry is "Just chat";
	now sortorder entry is 1;
	now description entry is "Talk a bit with Erica";
	[]
	if (lust of Erica is 2):
		choose a blank row in table of fucking options;
		now title entry is "Talk about sex with David";
		now sortorder entry is 2;
		now description entry is "Convince Erica to fuck David";
	[]
	sort the table of fucking options in sortorder order;
	repeat with y running from 1 to number of filled rows in table of fucking options:
		choose row y from the table of fucking options;
		say "[link][y] - [title entry][as][y][end link][line break]";
	say "[link]0 - Nevermind[as]0[end link][line break]";
	while sextablerun is 0:
		say "Pick the corresponding number> [run paragraph on]";
		get a number;
		if calcnumber > 0 and calcnumber <= the number of filled rows in table of fucking options:
			now current menu selection is calcnumber;
			choose row calcnumber in table of fucking options;
			say "[title entry]: [description entry]?";
			if player consents:
				let nam be title entry;
				clear the screen and hyperlink list;
				now sextablerun is 1;
				if nam is "Just chat":
					say "[EricaTalk1]";
				if nam is "Talk about sex with David":
					say "[EricaTalk2]";
				wait for any key;
		else if calcnumber is 0:
			say "Break off?";
			if player consents:
				now sextablerun is 1;
				say "     You step back from the young woman, shaking your head slightly as she gives a questioning look.";
				wait for any key;
			else:
				say "Pick between 1 and [the number of filled rows in the table of fucking options] or 0 to exit.";
		else:
			say "Invalid Option. Pick between 1 and [the number of filled rows in the table of fucking options].";
	clear the screen and hyperlink list;

to say EricaTalk1:
	say "     She says [one of]'Thank you for everything. I feel... complete now.'[or]'Being a full woman is even better than I imagined. Thank you so much for this.[at random]";

to say EricaTalk2:
	say "     You hug Erica close to you and give her a kiss, then ask her what she thinks of David, specifically if she finds him attractive. 'Sure, he's handsome, but I already have you,' Erica answers and gives you a peck on the lips. Smiling, you run a hand down Erica's chest, gently brushing over her shapely breasts and sensitive nipples before pushing it under the band of her shorts. As you start to fondle the young woman's pussy lips, you explain that David is a really good friend of yours and... - just as you push a finger into Erica's vagina, making her gasp in lust - ...that you'd really like the three of you to have some fun together.";
	say "     With that, you add another finger, pushing them in and out of Erica's hole and stroking her inner passage. Making out with the beautiful student, you drive her arousal higher and higher, then ask if she'd like to have some fun with David too, speeding up your manual stimulation of his pussy even more as you do so. 'Yes. Yes. YESSS!' Your hot little athlete gasps as you drive her over the edge to orgasm and a gush of femcum starts running down over your fingers. After catching her breath a moment later, Erica says 'Yes. Whatever you want. That soldier friend of yours really is quite a looker, now that I think of it...'";
	now lust of Erica is 3;

Section 3 - Fucking Erica

Instead of fucking the Erica:
	if (HP of Erica is 0): [virgin woman]
		if player is male:
			say "     Stepping up to Erica, you embrace her and give her a deep kiss. When you come back up for air, you look deep into her eyes and ask to be her first man and show her what it really means to be a woman. There's only a short moment of hesitation, then Erica nods and leans her head forward to kiss you back.";
			say "     The two of you make out for a moment, holding on to each other. In between playful tongue-wrestling, you let your hands wander all over her, feeling up her slender body, cupping the perky breasts through her t-shirt and giving those nice firm buns of her ass a slight squeeze. While she still has the build of an athlete, it is clearly a female now, with feminine curves in addition to toned muscle. Eager to get to know her more intimately, you grab her by the hand and lead the young woman to your bunk.";
			say "     Erica quickly takes off her shoes and socks, then pulls off her shirt and throws it aside, revealing a nicely defined chest - and the perfectly shaped mounds of her two B-cup breasts. You follow suit, rapidly sliding off your own clothing, then step close to your waiting partner. Gently cupping her breasts, you use your fingers to rub and brush over her nipples, making the young woman gasp for a second. Seems like your handsome student has gotten quite sensitive there after her transformation. With a smile on your face you lean down and run your tongue over her chest, then circle each of her nipples with its tip and finally suck on them. Making Erica pant in lust is a lot of fun, and with your nose pressed against her warm skin you also take a deep breath of her clearly feminine scent.";
			WaitLineBreak;
			say "     Feeling Erica's readiness to move on, you soon push her back softly, making her sit, then lie on your camp bed. After that, you move your hands to the band of her shorts, pulling them down over her long legs as she raises her ass a bit to let the fabric slide over its smooth curve. Under them, a flimsy white tanga comes into view, making Erica show a moment of embarrassment as she says,'I really, really like... soft panties against my skin. Good that I'm a real woman now, ha.' You lean in for a quick kiss, telling her how hot she looks in the skimpy underwear and then slide it off with great satisfaction.";
			say "     Now fully naked, Erica looks up from the bed to you, her eyes inevitably drawn to your by now rock-hard cock. With an inviting smile she spreads her legs for you, the lips of her slightly swollen pussy glistening with female juices. Eagerly, you climb on the bed with her, stroking her smooth legs as you kneel between them. Erica gasps as your dick touches her pussy the first time, followed by rapid panting as you rub up and down against its folds. Then you put your cockhead against her opening and slowly push forward, moaning in lust yourself as her nether lips spread for you, enveloping your shaft in a warm and tight embrace.";
			say "     Sliding deeper into her, your progress soon meets resistance as your cock pushes against a soft flexible barrier inside her - Erica's hymen. You lean down and put your arms around her then let your lips meet and give her a deep kiss. While distracting her with some playful tongue-wrestling, you push forward with your hips, increasing the pressure until you break through the thin flesh and make a real woman out of her.";
			WaitLineBreak;
			say "     You rest your hard shaft inside Erica for a moment to allow her to get used to it, then start moving in and out, moaning in unison with your handsome athlete. Her legs wrap around your hips and pull you tight against her with each of your thrusts. Fucking this tight virgin pussy has you incredibly aroused and you have to control yourself pretty hard to last at least a little bit longer. And you're not the only one - soon Erica's moans and groans rise to a pretty noisy climax and you feel the femcum leak from her pussy and squirt out around your cock. She pulls you down on top of her, going for a breathtaking kiss, then whispers 'Finish it - come inside me.'";
			say "     Giving her another quick kiss on the lips, you eagerly follow the beautiful student's request and pump your hips up and down rapidly, thrusting hard and deep into her body. With your cock already primed and ready to go, it takes just a few more thrusts for the cum to boil up from your balls and pulse through your cock, spurt after spurt blasting into her. You fill Erica's pussy with your fertile seed, feeling a deep satisfaction as you imagine the millions of little swimmers invading her womb in search of an egg. Your cock still inside her, the two of you move to lie on your sides on the bed, holding each other and reveling in post-coital bliss. Lying there, Erica softly strokes your side and says 'That was amazing - thank you.'";
			now HP of Erica is 1;
			now thirst of Erica is 1;
			now lastfuck of Erica is turns;
		else:
			say "     Stepping up to Erica, you embrace her and give her a deep kiss. She practically melts into your arms as you hold her, eagerly returning your attentions with more kisses while her hands roam over your body. Looks like she's ready and willing to lose her virginity now - too bad you don't have the right 'equipment' for that at the moment... better try again later once you've gotten a cock to fuck her with.";
	else if (HP of Erica is 1): [female repeat sex]
		if (lastfuck of Erica - turns < 6):
			say "     As you approach Erica, she immediately sees the lust-filled twinkle in your eyes. Running a hand up the side of your arm and stroking your cheek, the attractive college student says, 'I love you baby, but I need some rest in between. Can we play another time?' She gives you a soft kiss on the lips as you nod, already thinking about what you want to do with her later.";
		else:
			say "     You walk over to Erica, who immediately starts smiling as she sees the lust-filled twinkle in your eyes. Throwing her arms around you, her lips find yours for a quick kiss, then she suggestively nods over to her bunk.";
			LineBreak;
			say "[EricaSexMenu]";

to say EricaSexMenu:
	now sextablerun is 0;
	blank out the whole of table of fucking options;
	[]
	if player is male:
		choose a blank row in table of fucking options;
		now title entry is "Have her blow your cock";
		now sortorder entry is 1;
		now description entry is "Put your horny friend's mouth to good use";
	[]
	if player is female:
		choose a blank row in table of fucking options;
		now title entry is "Have her lick your pussy";
		now sortorder entry is 2;
		now description entry is "Put your horny friend's mouth to good use";
	[]
	choose a blank row in table of fucking options;
	now title entry is "Finger her pussy";
	now sortorder entry is 3;
	now description entry is "Finger-fuck Erica to make her cum";
	[]
	if player is male:
		choose a blank row in table of fucking options;
		now title entry is "Fuck her pussy";
		now sortorder entry is 4;
		now description entry is "Fill the young woman with your cock";
	[]
	if player is male:
		choose a blank row in table of fucking options;
		now title entry is "Take Erica's ass";
		now sortorder entry is 5;
		now description entry is "Fill your horny friend's ass with your cock";
	[]
	if HP of Erica is 1 and lust of Erica is 3 and HP of David is 4 and lastfuck of David - turns >= 6: [Erica ready for sex with David, non-virgin female, David in the bunker and ready]
		choose a blank row in table of fucking options;
		now title entry is "Have David fuck Erica's pussy";
		now sortorder entry is 6;
		now description entry is "Make the soldier boy fuck Erica";
	[]
	if lust of Erica is 4 and HP of David is 4 and lastfuck of David - turns >= 6: [David+Erica had sex, David in the bunker and ready]
		choose a blank row in table of fucking options;
		now title entry is "Threesome with David and Erica";
		now sortorder entry is 7;
		now description entry is "Have some fun with both of them together";
	[]
	if (Level of Erica is 4 and player is not neuter): [talked with Erica about the felinoid fucking her and having approved]
		choose a blank row in table of fucking options;
		now title entry is "Threesome with Klauz and Erica";
		now sortorder entry is 8;
		now description entry is "Have some fun with both of them together";
	[]
	sort the table of fucking options in sortorder order;
	repeat with y running from 1 to number of filled rows in table of fucking options:
		choose row y from the table of fucking options;
		say "[link][y] - [title entry][as][y][end link][line break]";
	say "[link]0 - Nevermind[as]0[end link][line break]";
	while sextablerun is 0:
		say "Pick the corresponding number> [run paragraph on]";
		get a number;
		if calcnumber > 0 and calcnumber <= the number of filled rows in table of fucking options:
			now current menu selection is calcnumber;
			choose row calcnumber in table of fucking options;
			say "[title entry]: [description entry]?";
			if player consents:
				let nam be title entry;
				clear the screen and hyperlink list;
				now sextablerun is 1;
				if nam is "Have her blow your cock":
					say "[EricaSex1]";
				if nam is "Have her lick your pussy":
					say "[EricaSex2]";
				if nam is "Finger her pussy":
					say "[EricaSex3]";
				if nam is "Fuck her pussy":
					say "[EricaSex4]";
				if nam is "Take Erica's ass":
					say "[EricaSex5]";
				if nam is "Have David fuck Erica's pussy":
					say "[EricaSex6]";
				if nam is "Threesome with David and Erica":
					say "[EricaSex7]";
				if nam is "Threesome with Klauz and Erica":
					say "[EricaSex8]";
				now lastfuck of Erica is turns;
				wait for any key;
		else if calcnumber is 0:
			say "Break off?";
			if player consents:
				now sextablerun is 1;
				say "     You step back from the young woman, shaking your head slightly as she gives a questioning look.";
				wait for any key;
			else:
				say "Pick between 1 and [the number of filled rows in the table of fucking options] or 0 to exit.";
		else:
			say "Invalid Option. Pick between 1 and [the number of filled rows in the table of fucking options].";
	clear the screen and hyperlink list;

to say EricaSex1: [cock sucked by Erica]
	say "     Staying right where you are, you give Erica's shoulders a soft push to make her crouch down before you. Pulling down your rapidly hardening [cock of player] cock, you stroke it a few times and then hold it out for her. The beautiful young woman licks the head playfully, then takes it into her mouth without any hesitation, clearly eager to satisfy your lust. She looks up at you adoringly with your manhood sliding in and out of her mouth - it's quite an arousing sight that makes you twitch and leak a small spurt of precum right on her tongue. You stroke the athletic student's neck, then run your hand through her red hair and grab hold of it. Pulling her mouth deeper onto your shaft, you start fucking her face, going slow at first for her to get used to it, then speed up and go deeper and deeper.";
	say "     Her soft lips and warm mouth around your cock give you an amazing feeling, making you moan in lust. She might be new to sucking cocks, but having been a male herself not too long ago, Erica clearly knows how to please you orally. And she's very eager and willing to learn, even going for a few deep throat moments after taking large breaths. With such a beautiful young woman eager to please, it doesn't take long until your balls tighten and your cock pulses with the burst after burst of cum it is depositing into Erica's mouth. After you finish cumming, she sticks her tongue out for a moment to let you see your white, creamy load, then closes her mouth and swallows it all down. Standing up, the slender beauty puts her arms around you and gives you a quick kiss, leaving you with a warm feeling and the taste of cum on your lips.";

to say EricaSex2: [cunt licked by Erica]
	say "     Strolling towards the bed you slide off your clothing, then lie down on it and spread your legs, telling Erica to give you pleasure with her tongue. She kneels down in front of the bed and moves one hand forward to spread your nether lips, then licks over them. 'Stacy always said I'm good at oral sex. And I... practiced a bit with my own after I got... transformed.'";
	say "     It's true - your eager student licks and fondles your sex expertly, making you moan in rising arousal in short notice. Looks like becoming a woman has given her an insight on the whole matter. After a quite pleasurable time where she rubs erogenous zones inside your pussy you barely knew existed, you moan loudly and orgasm, dripping female juices over her fingers. Erica just keeps going, fondling your lips as you shiver in pleasure and she slurps up your femcum. When she eventually stands up again, she gives you a deep kiss, sharing the taste of your own juices with you.";

to say EricaSex3: [Erica's cunt licked/fingered]
	say "     Taking Erica by the hand, you lead her over to the bed and push your hands under her shirt. Feeling up the firm muscles of her chest, then cupping the soft and round curves of her breasts for a moment, you take hold of the shirt's edge and pull it off her. Then it's time for her shorts, which you slide down those long runner's legs, stroking over Erica's soft skin as you go. Now your handsome athlete is almost naked before you, just wearing a skimpy white tanga already showing a little damp spot at the front. Running your hands over her body, you pull Erica in for another quick kiss, then softly push her backwards against the bed and make her lie down on it. You stroke over the thin fabric of her panties with your fingers, making her moan needily. Looks like your female friend is about ready... you pull the panties off her body, revealing the swollen pussy between her legs, with its open and glistening lips.";
	say "     Kneeling down, you give a careful lick and taste her juices, then really go to town on her - licking and fondling her female bits until she's panting and squirming in arousal, her hands grabbing the sheets tightly. You keep going for quite a bit until suddenly she gives a lustful scream and orgasms, dripping femcum from her spread pussy. Sitting down beside her on the camp bed, you continue to softly stroke her body as she rides out the sexual high. When the attractive student finally comes down to normal a while later, she pulls you down to lie beside her and gives you a kiss. 'If I had known it'd be like this, I'd have jumped you the moment you came to me. Who wouldn't want to be a woman with you...'";

to say EricaSex4: [Erica's pussy fucked by player]
	say "     Taking Erica by the hand, you lead her over to her bed and push your hands under her shirt. Sliding up over smooth skin, you feel her firm abs for a moment and even reach as far up as the curves of her B-cup breasts. Covering those perfect orbs with your hands, you stroke over them and rub her nipples, which makes the athletic student pant in arousal. You almost have to force yourself to let go of them again, taking hold of the shirt next and pulling it over Erica's head. Then it's time for her shorts, which you slide down her long runner's legs, stroking over her soft skin as you go. Now your handsome athlete is almost naked before you, just wearing a skimpy white tanga already showing a little damp spot at the front.";
	say "     Running your hands over her body, you pull Erica in for another quick kiss, then softly push her backwards against the bed and make her lie down on it. You stroke over the thin fabric of her panties with your fingers, making her moan needily. Looks like your redheaded beauty about ready... slowly pulling the panties off her body you reveal her swollen pussy with its open, glistening lips.";
	WaitLineBreak;
	say "     Quickly stripping off your own clothing, you climb on the bed with Erica and kneel between her spread legs. She just looks so delicious, lying before you naked and beautiful, with an eager expression on her face. You barely manage to control the impulse to just plunge in and take her then and there, instead going slow and rubbing the tip of your cock up and down over her pussy lips and clit, making her pant in need. After pushing softly against her opening several times, then going back to more rubbing, Erica moans 'Please - I need you in me.'";
	say "     Following the female student's needful request, you aim your shaft and push forward, giving both your bodies the unity they craved for. As you sink deeper inside her, you lean down and make out with Erica, moaning into each other's mouth when you bottom out inside her. With the warm, tight hole around your cock, all restraint is soon forgotten and you start fucking her hard and deep. Erica gives lustful grunts to accompany the sound of your hips slapping against her crotch and wraps her arms and legs around you in an intimate embrace.";
	WaitLineBreak;
	say "     You fuck each other like sex-starved bunnies for at least an hour, only stopping for a moment when you cum inside her and fill her womb with your fertile seed, then make out a bit until you're ready to go on. It's a wild ride, but finally - after her and you coming three times - you come to lie on the bed together in each other's arms. Erica gives you a soft kiss on the lips. After the soft murmur of, 'I love you,' she dozes off afterwards. You kiss her forehead and wish you could stay like this forever, your arms around her and your softening cock still inside her cum-filled pussy. With a last thought you imagine your cum exploring her womb for an egg to create life with, then fall asleep yourself.";

to say EricaSex5: [fucking Erica's ass]
	say "     Taking Erica by the hand, you lead her over to her bed and push your hands under her shirt. Sliding up over smooth skin, you feel her firm abs for a moment and even reach as far up as the curves of her B-cup breasts. Covering those perfect orbs with your hands, you stroke over them and rub her nipples, which makes the athletic student pant in arousal. You almost have to force yourself to let go of them again, taking hold of the shirt next and pulling it over Erica's head. Then it's time for her shorts, which you slide down her long runner's legs, stroking over her soft skin as you go. Now your handsome athlete is almost naked before you, just wearing a skimpy white tanga already showing a little damp spot at the front.";
	say "     Running your hands over her body, you pull Erica in for another quick kiss, then softly push her backwards against the bed and make her lie down on it. You stroke over the thin fabric of her panties with your fingers, making her moan needily. Looks like your redheaded beauty about ready... slowly pulling the panties off her body you reveal her swollen pussy with its open, glistening lips.";
	WaitLineBreak;
	say "     Quickly stripping off your own clothing, you climb on the bed with Erica and kneel between her spread legs. She just looks so delicious, lying before you naked and beautiful, with an eager expression on her face. You barely manage to control the impulse to just plunge in and take her then and there, instead going slow and rubbing the tip of your cock up and down over her pussy lips and down the crack of her ass, making her pant in need.";
	if EricAnalCounter < 2:
		say "     When you start pushing softly against her rear opening, Erica's eyes looking up at you get very round for a second. You don't think she had any anal sex before all this happened, but... after everything you've done for her, she is ready to try almost anything that you suggest. After the moment of hesitation, she smiles up at you, indicating to go on.";
	else:
		say "     When you start pushing softly against her rear opening, Erica lets out a pleased sigh, anticipating your entry into her tight passage. While she may not have had any gay encounters before this whole mess with the nanites started, her recent encounters have shown the athletic student that her asshole can be a source of great pleasure. Well, and with going so far as to become completely female, her readiness to take cocks into her body increased a lot too of course. You're pretty sure she'd be willing to try anything with you. Smiling impishly up at you, she indicates to go on.";
	say "     With the female student now ready for it, you aim your shaft and push forward, giving both your bodies the unity they crave for. As you sink deeper inside her, you lean down and make out with Erica, moaning into each other's mouth when you bottom out inside her tight ass. With the warm hole around your cock, all restraint is soon forgotten and you start fucking her hard and deep. Erica gives lustful grunts to accompany the sound of your hips slapping against her and wraps her arms and legs around you in an intimate embrace.";
	WaitLineBreak;
	say "     You fuck each other like sex-starved bunnies for at least an hour, only stopping for a moment when you cum inside her and fill her ass with your fertile seed, then make out a bit until you're ready to go on. It's a wild ride, but finally - after her and you coming three times - you come to lie on the bed together in each other's arms. Erica gives you a soft kiss on the lips. After the soft murmur of, 'I love you,' she dozes off afterwards. You kiss her forehead and wish you could stay like this forever, your arms around her and your softening cock still inside her cum-filled hole. Then you too fall asleep.";
	increase EricAnalCounter by 1;

to say EricaSex6: [have David fuck Erica's pussy - first time]
	say "     You ask Erica if she's ready for some fun with David. She just smiles eagerly, nodding before giving you another quick kiss on the lips. Taking the beautiful redhead by the hand, you lead her over to David's camp bed and push your hands under her shirt, letting them slide along her shapely curves until they reach the twin mounds of her perky breasts, which you cup and squeeze lightly. After feeling up your female friend for a moment, much to her delight, next you take hold of the shirt and pull it off, unveiling the full beauty of her figure. Then it's time for the shorts, which you slide down Erica's long runner's legs, stroking over their silky smooth skin as you go. Now your breathtakingly attractive friend is almost naked before you and a very interestedly watching David, just wearing a skimpy white tanga already showing a little damp spot at the front.";
	say "     Running your hands over her body, you pull Erica in for another quick kiss, then softly push her backwards against the bed right beside David's and make her lie down on it. As you stroke over the thin fabric of her panties with your fingers, she moans needily, raising her hips a bit to prolong the contact as you pull away again. Looks like your sexy friend is about ready... so you slowly pull the last wisp of fabric off her body, revealing a ready pussy with open, glistening lips. Turning to David, whose looks are just roaming over Erica's naked body and her moist opening, you ask if he'd like to show your friend a good time. Explaining that she's just waiting for David's cock, you emphasize your point by stroking Erica's sensitive pussy lips, making her moan loudly.";
	WaitLineBreak;
	say "     You can see a wide-eyed David lick her lips and swallow, then he breaks through the hesitation and steps up to the bed, taking your place between Erica's legs. He brings his hands forward, stroking the young woman's open nether lips and the little bump of her clit, getting rewarded by a pleased moan by the naked redhead. Emboldened by that, the soldier lowers his head and starts licking Erica's pussy, first sticking his tongue deep in the opening of her pussy and wiggling it about, then teasing her sensitive little nub with the tip of his tongue. Standing beside the bed, you watch your two friends have oral sex, with David doing an admirable job of licking and fondling Erica, bringing her to a higher and higher state of arousal. Soon the attractive student's moans and gasps reach a new level of urgency, one you recognize as the urgent need to get fucked.";
	say "     Stepping up behind David, you whisper to him that Erica is ready and she should take her now, after which you grab the edge of his shirt and pull it over his head. Then you reach around him to undo the handsome soldier's pants, freeing his raging boner as you pull them down to his knees. Giving the young man a soft push and a playful slap on the bare ass, you get him moving forwards, climbing up on the bed between Erica's spread legs. As his gaze meets the needily and welcoming look of lust in her eyes, David then does what comes natural to a man who finds himself naked on top of a beautiful woman - he sinks his manhood deep into Erica's warm folds, covering the slender athlete's body with his. Their shared moans get a bit muffled after that as they make out with each other hungrily.";
	WaitLineBreak;
	say "     Not wanting to get between those two in their first time together, you just watch the soldier and college athlete wrestle each other's tongues, then start fucking in earnest. David proves to be well versed in pleasing women - thrusting deep into Erica just as she likes it, adjusting his angle each time to hit just the right spots and knowing when it's best just to rest his shaft inside her pussy and lean in for a kiss. You stroke your own [if player is male]cock[else if player is female]cunt[else]body[end if] excitedly as you watch their hot coupling, thoughts already wandering to possible future threesomes.";
	say "     With the... enthusiasm those two show for fucking each other, it doesn't surprise you that not much later, Erica's gasps rise to lust-filled screams as she announces 'Ah. Ah! I'm... *gasp* ...coming!' With that, she throws her head back, eyes closed and tightly clutches on to David to ride out her orgasm. The young soldier stops for a while to give Erica a moment to catch her breath, then kisses her deeply while his hips grind against the young woman's crotch in a need-filled burst for the finish line. With a grunt, he suddenly stops with his shaft buried deep inside Erica's pussy, then gives a series of half-panted moans. Bending down to look, you can see the young man's balls twitch as they deliver burst after burst of his cum deep into Erica's womb.";
	WaitLineBreak;
	say "     What a hot show. You leave the two of them alone to lie together on the bed, kissing and still connected by David's slowly softening cock...";
	now lust of Erica is 4;

to say EricaSex7: [threesome with David+Erica]
	say "     Running a hand through Erica's red hair, you give her a deep kiss, after which you ask if he'd like to mix things up a bit this time. Smiling at the young woman's curious expression, you run a finger along Erica's jawline, turning her head a bit so she looks towards the far side of the room. There, David is sitting on one of the unused beds with his back to you, reading a book. A naughty grin spreads over Erica's face as she nods, then pulls her shirt up over her head and throws it on the nearest bunk, revealing her very nice and shapely breasts. Your eyes are instantly drawn to those perky mounds, perfectly shaped, firm and without any need for support from a bra... captivating you so much that the young woman gives a giggle at your single-minded stare.";
	say "     Very pleased with the attention, Erica then demonstratively pushes her chest out while putting both hands on the smooth curves of her perky breasts and giving them very enticing little squeezes. You're more than tempted to move closer and touch her sexy body yourself, but it's clear from her expression that the athletic student wants to put on a show for you right now. After kicking off her shoes, Erica's shorts follow the t-shirt, leaving her standing before you in only a small black tanga. Then even that is slid down her long runner's legs - albeit slower, and with somewhat exaggerated movements of her hips, presenting all the shapely bits of her lithe figure to you. Finally stepping up to you, she strokes your [skin of player] skin and proceeds to strip you too, sensuously caressing your body while removing any clothing you might have. When the two of you are naked, Erica raises a finger to her lips, then quietly walks over to where David is sitting. With her taking care to stay behind the soldier, out of sight, David doesn't notice anything until the beautiful redhead climbs on the bed behind him.";
	WaitLineBreak;
	say "     Feeling the mattress give a bit, David looks over his shoulder and starts saying, 'Hey Erica -' Then words fail him as his eyes wander lower, taking in the female athlete's nakedness and perfectly shaped body. Erica doesn't really give David any time to recover his wits, immediately moving beside him and going in for a deep kiss. Finding himself in a surprise makeout session, the book in the soldier's hands is instantly forgotten, just tumbling to the ground as his fingers loosen their grip and soon after cup Erica's shapely breasts. Swinging a leg on David's other side, Erica straddles his hips and proceeds to take hold of David's t-shirt, peeling it off his muscled body with a quick and eager move. Pushing against the young man's naked chest, Erica next makes him lay back on the bed, then leans forward herself for even more playful kissing.";
	say "     Getting pretty aroused by watching your two friends go at it, you decide it's time to join in. Stepping up to the bed, you kneel between David's legs and start rubbing his crotch through the tented fabric of his pants. Wow, he's really got a full-on hardon going there, leaking precum to create a damp spot on the trousers. Happy to lend a helping hand, you undo the button and zipper of David's pants, pulling them open to free his raging boner. Taking hold of the long shaft, you stroke it a few times, then rub it against Erica's soft skin before finally positioning its tip between the naked student's wet and swollen pussy lips. As he feels the familiar sensations of a ready female, David gives a lust-filled moan and follows the age-old instincts of any young man, thrusting upward with everything he has and burying his cock deep inside Erica's body. After that, all out fucking ensures, with Erica riding the hard shaft inside her pussy and David grinding up against her.";
	WaitLineBreak;
	if player is male:
		say "     [EricaSex7_1_Male]";
	else:
		say "     [EricaSex7_2_Fondling]";

to say EricaSex7_1_Male: [Erica, male/herm player]
	say "     What do you want to do now with your two human partners? Get into Erica's vagina in a double-penetration [link](1)[as]1[end link], fuck Erica's ass [link](2)[as]2[end link], fuck David's ass [link](3)[as]3[end link] or maybe fondle David's hole as he fucks Erica [link](4)[as]4[end link]?";
	now calcnumber is 0;
	while calcnumber < 1 or calcnumber > 4:
		say "Choice? (1-4)>[run paragraph on]";
		get a number;
		if calcnumber is 1 or calcnumber is 2 or calcnumber is 3 or calcnumber is 4:
			break;
		else:
			say "Invalid choice. Type [link]1[end link] to double-penetrate Erica's vagina, [link]2[end link] to fuck Erica in the ass, [link]3[end link] to fuck David in the ass or [link]4[end link] to finger-fuck David's hole.";
	if calcnumber is 1: [double vaginal]
		say "     Standing up from between David's legs, your hard [cock of player] cock bumps against Erica's bottom, sliding against her smooth skin and tempting you to just take her instantly. But no, you resist the temptation (for now), instead leaning over Erica and running your hands up along her sides, then planting a line of kisses on her spine. Soon, you're holding her from behind, your arms around the young woman's chest, each hand cupping a perfect, perky breast. With your cock resting hotly against her back, you ask Erica if you can do a double penetration with David, promising to be gentle, but he's too blissed out from getting fucked to even notice your words. Only when you playfully lick and nibble her earlobe does she really listen to your repeated question. Between her moans, she answers, 'Go ahead. *pant* I trust you, you're my rescuing hero, remember?'";
		say "     Taking hold of your shaft with one hand, you aim your erection a bit lower, then slowly push into the red-headed athlete's pussy beside David. All three of you gasp and moan at the incredible sensations of two men entering Erica's pussy at the same time, with David's and your cocks rubbing up against each other and both of them stretching her out wider than before. You wait a second to get used to the feeling, then start thrusting in and out, reveling in the tightness of Erica's hole. When David resumes thrusting too, your cocks slide against each other, giving another amazing bit of extra stimulation.";
		WaitLineBreak;
		say "     Fucking each other in a wild threesome, the arousal of everyone involved soon mounts higher and higher, with everyone getting quite close to orgasm before much longer. David is the first one to pass the point of no return, suddenly stiffening under Erica, with his cock pulsing against yours as spurt after spurt of his seed is shot deep into the young woman's pussy. Getting bred by the handsome soldier, her body being filled with fertile cum, drives Erica to climax just a moment later and she gasps in lust, fingers tightly gripping his broad shoulders as the orgasm makes her writhe in pleasure. Eager to join your panting partners, you speed up your own thrusts into Erica's stretched hole, now wet and slippery with her femcum and David's load as it is pumped into her. It feels absolutely amazing, warm and slippery, and... something about having another man's cum squelch inside a woman around your shaft just makes your body go into overdrive. Maybe it is the urge to send your own seed into the race to impregnate her, who knows. No matter what, after just a few more deep thrusts, you come hard, pumping your seed into Erica's body to join and mingle with David's.";
		say "     Exhausted by the hot fuck, you rest for a moment against Erica's back, your slowly softening shaft still inside her. David moves his head to the side a bit to look at you over Erica's shoulder, then gives a satisfied chuckle and says 'Man, you two are quite something,' followed by a long kiss on Erica's lips and her addressing you with, 'Come on, join us on the bed.' After you step back a bit to give them room to move, David lies down lengthwise on the bed, with Erica on top of him and enough room for you next to them. You eagerly join them, alternating in making out with both. Soon, this leads over to all of you cuddling in post-coital contentment.";
	else if calcnumber is 2: [fuck Erica's ass]
		say "     Standing up from between David's legs, your hard [cock of player] cock bumps against Erica's bottom, sliding against her smooth skin and tempting you to just take her right then and there... which is exactly what you planned to do. Taking hold of your manhood with one hand, you aim it up a bit, then slowly push forward against the beautiful redhead's pucker. After only a short moment's resistance, the quivering muscle yields to your invading member, allowing you to slide inside her warm inner passage. Phew - that's one tight and gripping hole your friend has there, giving you an incredible feeling and making the two of you moan in unison as you sink deeper and deeper. Then suddenly, you feel movement bump and rub against your cock - that must be David, his erection pumping in and out of Erica's other hole. So hot, to be able to feel him through Erica's inner walls.";
		WaitLineBreak;
		say "     With the two of you fucking Erica together - from the front and back, and David alternating his thrusts with yours so there's always someone's hard cock inside her, the arousal of everyone involved quickly mounts higher and higher. Eventually, David is the first one to pass the point of no return, suddenly stiffening under Erica, with his cock pulsing as spurt after spurt of his seed is shot deep into the young woman's pussy. Getting bred by the handsome soldier, her body being filled with fertile cum, drives Erica to climax just a moment later and she gasps in lust, fingers tightly gripping his broad shoulders as the orgasm makes her writhe in pleasure. Meanwhile, you speed up your own thrusts into Erica's asshole, your body going into overdrive. Maybe it is some inner urge to send your own seed into the race to impregnate her, even though you're in the wrong hole for that - but who knows. No matter what, after just a few more deep thrusts, you come hard, pumping your seed into Erica's back passage.";
		WaitLineBreak;
		say "     Exhausted by the hot fuck, you rest for a moment against Erica's back, your slowly softening shaft still inside her. David moves his head to the side a bit to look at you over Erica's shoulder, then gives a satisfied chuckle and says 'Man, you two are quite something,' followed by a long kiss on Erica's lips and her addressing you with, 'Come on, join us on the bed.' After you step back a bit to give them room to move, David lies down lengthwise on the bed, with Erica on top of him and enough room for you next to them. You eagerly join them, alternating in making out with both. Soon, this leads over to all of you cuddling in post-coital contentment.";
		increase EricAnalCounter by 1;
	else if calcnumber is 3: [fuck David's ass]
		if lust of David is 0: [anal virgin]
			say "     After pulling off his shoes and socks you reach for David's hips, grabbing the sides of his open pants, then pull them down over his legs. Now both your sexy female friend as well as the handsome soldier are completely naked, presenting you with an enticing view that has your manhood twitch in anticipation. As you stand up from crouching between David's legs, your hard [cock of player] cock bumps against Erica's bottom, drawing a breathless moan from you with the sensation of her warm, smooth skin against your manhood. Ooh, tapping that would be quite something too, but your true target lies somewhere else. Raising David's legs, you spread them and bend your knees a little bit, allowing your hard [cock of player] cock to touch his virgin bottom for the first time.";
			say "     This is such a nice opportunity to break him in for some good fucking that you only just manage to hold back from plunging right in. Leaning forward to look at David over Erica's shoulder, you ask him if you can fuck his ass. He doesn't really look at you, lying back on the mattress and moaning in lust as Erica gyrates her hips in just that moment - but he does nod and reach down to take over holding his legs up. Perfect. Grabbing hold of your shaft with one hand, you aim it a bit lower, then push in against the muscled soldier's pucker. David gasps as his hole is spread for the first time by your invading member, but soon starts moaning even louder than before as you sink yourself deeper and deeper, rubbing against his prostate as you do so.";
			now lust of David is 1; [anally de-virginized]
		else:
			say "     After pulling off his shoes and socks you reach for David's hips, grabbing the sides of his open pants, then pull them down over his legs. Now both your sexy female friend as well as the handsome soldier are completely naked, presenting you with an enticing view that has your manhood twitch in anticipation. As you stand up from crouching between David's legs, your hard [cock of player] cock bumps against Erica's bottom, drawing a breathless moan from you with the sensation of her warm, smooth skin against your manhood. Ooh, tapping that would be quite something too, but your true target lies somewhere else. Raising David's legs, you spread them and bend your knees a little bit, allowing your hard [cock of player] cock to touch his shapely behind.";
			say "     You can barely wait to get back into this nice and tight soldier ass. Grabbing hold of your shaft with one hand, you aim it a bit lower, then push in against the muscled soldier's pucker. David gasps as his hole is spread wide by your invading member, but soon starts moaning even louder than before as you sink yourself deeper and deeper, rubbing against his prostate as you do so.";
		WaitLineBreak;
		say "     Pounding David's ass with deep thrusts, you revel in the moans, gasps and slapping noises of your hips against his ass filling the whole bunker. Who'd have thought that post-apocalyptic survival would be like this? Fucking the tight hole of a handsome man while your seriously cute female friend rides his cock - hell yeah, you'd pick this any day against your 'normal' life before. But moving your thoughts back to the thing at hand - or rather the hole your cock is balls-deep in - you decide to change your rhythm of thrusts to match Erica's sliding up and down.";
		say "     Being penetrated at the same time as sliding into a pussy with his own cock has David pretty hot and bothered, and before too much longer, he moans, 'I'm gonna... cummMMM!' The young soldier grabs Erica's hips to pull her tight against his crotch a fraction of a second before his whole body starts to shudder when spurt after spurt of his seed is shot deep into the young woman's pussy. Getting bred by the handsome soldier, her body being filled with fertile cum, drives Erica to climax just a moment later and she gasps in lust, fingers tightly gripping his broad shoulders as the orgasm makes her writhe in pleasure. Meanwhile, you speed up your own thrusts into David's asshole as his anal muscles twitch and flex with each blast of his seed, quickly giving you the last bit of stimulation you needed yourself. Shoving your cock in all the way as you feel the need to cum rise inside your balls, a massive load of cum blasts through your shaft and into David's hole.";
		WaitLineBreak;
		say "     Exhausted by the hot fuck, you rest for a moment against Erica's back, your slowly softening shaft still inside David. The soldier moves his head to the side a bit to look at you over Erica's shoulder, then gives a satisfied chuckle and says 'Man, you two are quite something,' followed by a long kiss on Erica's lips and her addressing you with, 'Come on, join us on the bed.' After you step back a bit to give them room to move, David lies down lengthwise on the bed, with Erica on top of him and enough room for you next to them. You eagerly join them, alternating in making out with both. Soon, this leads over to all of you cuddling in post-coital contentment.";
	else: [fondle David's ass]
		say "     [EricaSex7_2_Fondling]";

to say EricaSex7_2_Fondling:
	WaitLineBreak;
	if player is male: [male player]
		say "     You decide to give your soldier-boy a little bit of anal attention. After pulling off David's shoes and socks you reach for his hips, grabbing the sides of her open pants, then pull them down over her legs. Now both your sexy female friend as well as the handsome soldier are completely naked, presenting you with an enticing view that makes you start jerking your erect manhood. Looking up at Erica sliding herself up and down on David's hard shaft, you stroke the soldier's inner thighs, then move your fingers up to his asshole. Rubbing lightly at first, then pushing in against it, your finger soon penetrates David's rear entrance, causing him to gasp in between his moans at fucking Erica.";
		WaitLineBreak;
		say "     Slowly fingering the young man, you wait till you hear Erica's pants come faster and faster, showing she's getting close, then push deeper and caress David's prostate. With you carefully giving him some extra stimulation, you manage to push David over the edge to orgasm just as Erica reaches her climax too, making them come at the same time. Satisfied, you cup David's balls with your other hand, feeling them pulse and twitch as they deliver his fertile seed deep into Erica's body. Ooh, that's so hot - pumping your fingers up and down over the hard shaft of your cock, you soon reach the point of no return yourself, spraying long strings of cum on the ground.";
		say "     After David finishes cumming in the beautiful athlete and has time to catch his breath, he gives a satisfied chuckle and says 'Man, you two are quite something,' followed by a long kiss on Erica's lips and her addressing you with, 'Come on, join us on the bed.' After you step back a bit to give them room to move, David lies down lengthwise on the bed, with Erica on top of him and enough room for you next to them. You eagerly join them, alternating in making out with both. Soon, this leads over to all of you cuddling in post-coital contentment.";
	else if player is female: [female player]
		say "     You decide to give your soldier-boy a little bit of anal attention. After pulling off David's shoes and socks you reach for his hips, grabbing the sides of her open pants, then pull them down over her legs. Now both your sexy female friend as well as the handsome soldier are completely naked, presenting you with an enticing view that makes you start fingering yourself. Looking up at Erica sliding herself up and down on David's hard shaft, you stroke the soldier's inner thighs, then move your fingers up to his asshole. Rubbing lightly at first, then pushing in against it, your finger soon penetrates David's rear entrance, causing him to gasp in between his moans at fucking Erica.";
		WaitLineBreak;
		say "     Slowly fingering the young man, you wait till you hear Erica's pants come faster and faster, showing she's getting close, then push deeper and caress David's prostate. With you carefully giving him some extra stimulation, you manage to push David over the edge to orgasm just as Erica reaches her climax too, making them come at the same time. Satisfied, you cup David's balls with your other hand, feeling them pulse and twitch as they deliver his fertile seed deep into Erica's body. Ooh, that's so hot - you wish it was you with David's cock inside you. Pumping your caressing fingers in and out of your own cunt, you soon orgasm, imagining you're feeling David's shaft move inside you.";
		say "     After David finishes cumming in the beautiful athlete and has time to catch his breath, he gives a satisfied chuckle and says 'Man, you two are quite something,' followed by a long kiss on Erica's lips and her addressing you with, 'Come on, join us on the bed.' After you step back a bit to give them room to move, David lies down lengthwise on the bed, with Erica on top of him and enough room for you next to them. You eagerly join them, alternating in making out with both. Soon, this leads over to all of you cuddling in post-coital contentment.";
	else: [neuter player]
		say "     You decide to give your soldier-boy a little bit of anal attention. After pulling off David's shoes and socks you reach for his hips, grabbing the sides of her open pants, then pull them down over her legs. Now both your sexy female friend as well as the handsome soldier are completely naked, presenting you with a very enticing view. Looking up at Erica sliding herself up and down on David's hard shaft, you stroke the soldier's inner thighs, then move your fingers up to his asshole. Rubbing lightly at first, then pushing in against it, your finger soon penetrates David's rear entrance, causing him to gasp in between his moans at fucking Erica.";
		WaitLineBreak;
		say "     Slowly fingering the young man, you wait till you hear Erica's pants come faster and faster, showing she's getting close, then push deeper and caress David's prostate. With you carefully giving him some extra stimulation, you manage to push David over the edge to orgasm just as Erica reaches her climax too, making them come at the same time. Satisfied, you cup David's balls with your other hand, feeling them pulse and twitch as they deliver his fertile seed deep into Erica's body.";
		say "     After David finishes cumming in the beautiful athlete and has time to catch his breath, he gives a satisfied chuckle and says 'Man, you two are quite something,' followed by a long kiss on Erica's lips and her addressing you with, 'Come on, join us on the bed.' After you step back a bit to give them room to move, David lies down lengthwise on the bed, with Erica on top of him and enough room for you next to them. You eagerly join them, alternating in making out with both. Soon, this leads over to all of you cuddling in post-coital contentment.";

to say EricaSex8: [threesome with Felinoid+Erica]
	say "     Running a hand through Erica's red hair, you give her a deep kiss, after which you ask if he'd like to mix things up a bit this time. Smiling at the young woman's curious expression, you run a finger along Erica's jawline, turning her head a bit so she looks towards the far side of the room. There, Klauz is lounging on his side on one of the unused beds, his golden eyes opening from time to time to look around, then closing again as he goes back to dozing peacefully.";
	say "     A naughty grin spreads over Erica's face as she nods, then pulls her shirt up over her head and throws it on the nearest bunk, revealing her very nice and shapely breasts. Your eyes are instantly drawn to those perky mounds, perfectly shaped, firm and without any need for support from a bra... captivating you so much that the young woman gives a giggle at your single-minded stare. Very pleased with the attention, Erica then demonstratively pushes her chest out while putting both hands on the smooth curves of her perky breasts and giving them very enticing little squeezes. You're more than tempted to move closer and touch her sexy body yourself, but it's clear from her expression that the athletic student wants to put on a show for you right now. After kicking off her shoes, Erica's shorts follow the t-shirt, leaving her standing before you in only a small black tanga. Then even that is slid down her long runner's legs - albeit slower, and with somewhat exaggerated movements of her hips, presenting all the shapely bits of her lithe figure to you. Finally stepping up to you, she strokes your [skin of player] skin and proceeds to strip you too, sensuously caressing your body while removing any clothing you might have. When the two of you are naked, Erica raises a finger to her lips, then quietly walks over to where the felinoid is lying.";
	WaitLineBreak;
	say "     Crouching down beside the bed Klauz is stretched out on, Erica starts rubbing the big cat's belly fur, which quickly is answered by a resounding purr from the big beast. The young woman slowly moves one of her stroking hands lower and lower until she reaches the felinoid's crotch, then cups the feline's furry balls, gently massaging them. By now, the large cat has raised his head to look down on Erica and you've moved in to scratch him behind the ears and on his chin. Soon, Klauz's barbed cock starts poking out of its sheath, quickly hardening to its full glory. Erica goes on to grab the great cat's shaft and jerks on it while her other hand moves to her own crotch to rub an increasingly wet and dripping pussy. You notice the felinoid's entrancing musk starting to fill the air - not that she needs it this time, with two willing partners coming to him on their own.";
	say "     With Klauz all relaxed from the stroking and scritching, perfectly willing to let you two continue pleasing him, he just keeps on purring loudly as you take a muscular foreleg and Erica one of the hind legs and pull on them. It's pretty easy to roll the big feline over on his back, putting him in a stretched-out position on the bed, legs spread and his manhood standing proudly erect. Giving you a wide smile, Erica climbs on top of the felinoid, then braces herself against the cat's muscular underside as she lowers her hips towards his crotch. The beautiful athlete gives a lust-filled pant as she feels Klauz's cock start to spread her pussy lips apart slowly, followed by a loud gasp as the big beast thrusts his hips up a bit with a growl and sinks himself halfway into the human.";
	WaitLineBreak;
	say "     After getting in that first thrust, the felinoid relaxes again, content in letting the horny woman on top of him fuck herself on his stiff pole. Which Erica does, with a lot of enthusiasm. Bouncing up and down on the feline shaft, your friend moans loudly and runs her hands through the large animal's belly fur, soon totally lost in the sensations he gives her.";
	LineBreak;
	say "     Getting pretty aroused by watching your two friends go at it yourself, you decide it's time to join in.";
	if player is male:
		say "     [EricaSex8_1_Male]";
	else:
		say "     [EricaSex8_2_Female]";

to say EricaSex8_1_Male: [male player]
	LineBreak;
	say "     What shall it be you want to do with your female and felinoid friends? Fuck Erica's ass [link](1)[as]1[end link], or rather Klauz's ass [link](2)[as]2[end link], maybe get a blowjob from Erica [link](3)[as]3[end link] or present your manhood to Klauz to have him lick it [link](4)[as]4[end link]?";
	now calcnumber is 0;
	while calcnumber < 1 or calcnumber > 4:
		say "Choice? (1-4)>[run paragraph on]";
		get a number;
		if calcnumber is 1 or calcnumber is 2 or calcnumber is 3 or calcnumber is 4:
			break;
		else:
			say "Invalid choice. Type [link]1[end link] to fuck Erica's ass, [link]2[end link] to fuck Klauz in the ass, [link]3[end link] to get a blowjob from Erica or [link]4[end link] to have Klauz lick your cock.";
	LineBreak;
	if calcnumber is 1: [fuck Erica]
		say "     Getting on the bed between Klauz's legs, you snake your arms around Erica from behind, caressing the firm pair of breasts she teased you so much with earlier. As the red-headed beauty eagerly leans into your touch, you plant a line of little kisses from her neck up to her right earlobe, playfully nibbling at it before you whisper that you want to fuck her in the ass. The young woman looks back and gives you a smile over her shoulder, then leans forward, stretching her upper body out over the felinoid's furry belly while raising her ass a bit. Who could resist such an alluring display? You're almost twitching with the need and desire to fuck your handsome friend when you take hold of your manhood and line it up with her butt. Moving forward, you press the cockhead against her pucker, first lightly, then a bit harder until it finally yields to your invading member.";
		WaitLineBreak;
		say "     Grunting in satisfaction, you thrust deeper into your human friend, reveling in the sensations of her insides gripping your shaft tightly. You keep still a while longer, just resting your cock inside her to give Erica a time to get used to it - then suddenly she starts rocking back and forth, fucking herself on your and Klauz's cocks at the same time. Looks like she had enough of waiting. As she moves, you feel movement bump and rub against your cock - that must be the felinoid, his erection pumping in and out of Erica's other hole. So hot, to be able to feel him through the walls of Erica's insides.";
		say "     With the two of you balls deep inside Erica as she fucks herself on your cocks, the arousal of everyone involved soon mounts higher and higher. Klauz is the first one to pass the point of no return, suddenly stiffening under Erica and giving a satisfied roar, with his cock pulsing as spurt after spurt of his seed is shot deep into Erica's pussy. Getting bred by the large beast, her body being filled with fertile cum, drives Erica to climax just a moment later. She gasps in lust, holding on to the felinoid's soft belly fur as the orgasm makes her writhe in pleasure. You speed up your own thrusts into Erica's asshole, eager to fill her with another load of cum. After just a few more thrusts you come, a huge load boiling up from your balls and shooting into Erica's body.";
		WaitLineBreak;
		say "     Exhausted by the hot fuck, you rest for a moment against Erica's back, your slowly softening shaft still inside her. Klauz meanwhile just leans his head back in total relaxation, and you can literally feel his resounding purr through Erica lying on the feline's chest. Erica gives a satisfied sigh, then says 'Man, you two are quite something,' while reaching back and stroking your side lovingly. After a while longer in this position, gently touching each other, an exhausted Erica sinks off the felinoid to the side, coming to a rest against the large cat's flank, pressed against his warm fur and with an arm and a leg still draped over him. Sadly, there isn't any more room on the bed, with the large shape of Klauz and your attractive female friend already on it, so you leave them to cuddle and rest and go to collect your clothes.";
		increase EricAnalCounter by 1;
	else if calcnumber is 2: [fuck felinoid]
		say "     Getting on the bed between Klauz's legs, you snake your arms around Erica from behind, caressing the firm pair of breasts she teased you so much with earlier. As the red-headed beauty eagerly leans into your touch, you plant a line of little kisses from her neck up to her right earlobe, playfully nibbling at it before you whisper that you want to fuck the felinoid in the ass and she should distract the big kitty a bit. The young woman looks back and gives you a knowing smile over her shoulder, then leans forward, stretching her upper body out over Klauz's furry chest while stroking him with her hands and pumping her own hips rapidly up and down on the big cat's hard shaft. At the same time, you take hold of your own cock and line it up with the tight hole under the felinoid's tail. Moving forward, you press the cockhead against his pucker, first lightly, then a bit harder until it finally yields to your erect member.";
		WaitLineBreak;
		say "     Before he realizes what's happening and can do much more than start a surprised rumble in his throat, you're balls-deep in Klauz's ass, hitting sensitive spots that make him purr even louder than before. Grunting in satisfaction, you thrust deeper into your feline friend, reveling in the sensations of his insides gripping your shaft tightly. You start sliding in and out of his hole while putting your hands on the big cat's muscular hind legs. Holding on to them as you pound the felinoid's ass, you find a rhythm with Erica, slamming into his furry butt just as Erica pulls up and vice versa. It's an amazing feeling to be moving in concert with your two companions, all of you in a lust-filled haze.";
		say "     With you fucking Klauz's ass while Erica fucks fucks herself on his cock, the arousal of everyone involved soon mounts higher and higher. The felinoid is the first one to pass the point of no return, suddenly stiffening under Erica and giving a satisfied roar, with his cock pulsing as spurt after spurt of his seed is shot deep into Erica's pussy. Getting bred by the large beast, her body being filled with fertile cum, drives Erica to climax just a moment later. She gasps in lust, holding on to Klauz's soft belly-fur as the orgasm makes her writhe in pleasure. Meanwhile, you speed up your own thrusts into the big cat's asshole, eager to fill him with your own load of cum. After just a few more thrusts you come, a huge load boiling up from your balls and shooting deep into the felinoid's body.";
		WaitLineBreak;
		say "     Exhausted by the hot fuck, you rest for a moment against Erica's back, your slowly softening shaft still inside the big feline under her. Klauz meanwhile just leans his head back in total relaxation, and you can literally feel his resounding purr through Erica lying on the great beast's chest. Erica gives a satisfied sigh, then says 'Man, you two are quite something,' while reaching back and stroking your side lovingly. After a while longer in this position, gently touching each other, an exhausted Erica sinks off the felinoid to the side, coming to a rest against the large cat's flank, pressed against his warm fur and with an arm and a leg still draped over him. Sadly, there isn't any more room on the bed, with the large shape of Klauz and your attractive female friend already on it, so you leave them to cuddle and rest and go to collect your clothes.";
	else if calcnumber is 3: [BJ from Erica]
		say "     Stepping up to stand on the bed, your feet left and right of Klauz's body, you smile down at Erica and hold out your hard [cock of player] shaft to her. She stops her movements on top of the large cat for a moment, sitting still with the large spined shaft deep in her pussy while she reaches out to grasp your cock and fondle your balls. Your eager friend licks her lips, then gets to work sucking you off, taking the tip of your member into her mouth and running her tongue over it. After going down on your shaft all the way a few times, she starts sliding up and down on the felinoid's erection once again, timing it with bobbing her head towards you.";
		WaitLineBreak;
		say "     Taking Klauz's shaft deep in her pussy while she sucks you off, with its small spines rubbing her inner walls and causing incredible sensations, it doesn't take too much longer until Erica's arousal peaks. With her lips tightly wrapped around your [cock of player] shaft, the female athlete gives a somewhat muffled but still loud moan from her throat, a shudder running through her whole body as she comes. Femcum trickling down the felinoid's shaft and Erica's inner muscles gripping her cock like a vise make sure that only moments later, the big cat lets out a satisfied roar and his cock starts pulsing with spurt after spurt of his seed shooting into Erica's pussy. The young woman lowers her hand to the height of her belly button, reveling in the feeling of being bred by the large feline creature.";
		say "     With her breathing deeply and still in the grip of her own orgasm, you take hold of your erect manhood and jerk it, eager to join your two partners in climax. It's not much longer before your frantic movements push you over the edge to your release and you come, blasting your load all over Erica's face, neck and chest. The now pretty splattered human gives you a broad smile, then reaches up to pull you down to her level and kiss her, after which you proceed to gently rub your load all over her chest, cupping those shapely breasts and sucking on their nipples as you do so.";
		WaitLineBreak;
		say "     Keeping her position for a while longer, straddling Klauz's hips with the beast's softening shaft inside her, Erica eventually slides off the felinoid to the side, coming to rest against the large cat's flank. There she rests, pressed against the loudly purring feline's warm body and with an arm and a leg still draped over him. Sadly, there isn't any more room on the bed, with the large shape of Klauz and your attractive female friend already on it, so you leave them to cuddle and rest and go to collect your clothes.";
	else if calcnumber is 4: [BJ from felinoid]
		say "     Stepping up to stand against the head end of the bed, you give Klauz's chin an affectionate scratch, then hold out your hard [cock of player] shaft to him. The large cat looks at you with his golden eyes, then down at Erica riding his shaft and back at you. Finally giving an amicable growl, he nuzzles upwards into your groin, teasing your [cock size desc of player] [cock of player] shaft. A rough tongue flicks out across sensitive flesh, taking special care to carefully lap over your balls and tease the underside of your shaft.";
		WaitLineBreak;
		say "     While you're getting head from the large beast, Erica rides his spined cock with unabated vigor, moaning and gasping loudly at the sensations it gives her. With how much she enjoys riding the big cat, it doesn't take too much longer until Erica's arousal peaks. Panting unintelligible sounds in her lust, the female athlete rises up and slams herself down on the hard erection under her, a shudder running through her whole body as she comes. As femcum trickles down the felinoid's shaft, Erica's inner muscles grip his cock like a vise, making sure that only moments later, the big cat lets out a satisfied roar himself and his cock starts pulsing with spurt after spurt of fertile seed shooting into Erica's pussy. The young woman lowers her hand to the height of her belly button, reveling in the feeling of being bred by the large feline creature.";
		say "     With her breathing deeply and still in the grip of her own orgasm, you take hold of your erect manhood and jerk it, eager to join your two partners in climax. It's not much longer before your frantic movements push you over the edge to your release and you come, blasting your load all over Klauz's furry face, with a few shots landing in his open muzzle. The big cat gives a pleased mrowl at the taste of your seed, using his long tongue to lick up any that landed in the fur around his muzzle. Smiling at that, you help out by wiping up any that he can't reach with your fingers and holding them out for him to lick your cum off. Then you step closer to Erica, leaning forward to give her a deep kiss.";
		WaitLineBreak;
		say "     One kiss follows another and Erica keeps her position for a while longer as you make out, straddling the felinoid's hips with the beast's softening shaft inside her, before eventually sliding off Klauz to the side, coming to rest against the large cat's flank. There she rests, pressed against the loudly purring feline's warm body and with an arm and a leg still draped over him. Sadly, there isn't any more room on the bed, with the large shape of the felinoid and your attractive female friend already on it, so you leave them to cuddle and rest and go to collect your clothes.";

to say EricaSex8_2_Female: [Erica]
	say "     Your pussy is almost dripping with arousal and you're ready to have someone lick it - though who shall it be? Erica ([link]Y[as]y[end link]) or Klauz ([link]N[as]n[end link])?";
	if player consents: [BJ from Erica]
		LineBreak;
		say "     Stepping up to stand on the bed, your feet left and right of Klauz's body, you smile down at Erica and demonstratively rub over your pussy lips, holding them apart for her. She stops her movements on top of the large cat for a moment, sitting still with the large spined shaft deep in her pussy while she reaches out to touch your privates, softly brushing against your clit. Your eager friend licks her lips, then gets to work eating you out, taking great care in teasing your most sensitive spots. After a moment of giving you her full attention, she starts sliding up and down on the felinoid's erection once again, timing it with licking you.";
		WaitLineBreak;
		say "     Taking Klauz's shaft deep in her pussy while she gives oral to you, with its small spines rubbing her inner walls and causing incredible sensations, it doesn't take too much longer until Erica's arousal peaks. After another lick that makes you shudder with need, the female athlete gives a loud moan from her throat, a shudder running through her whole body as she comes. As femcum trickles down the felinoid's shaft, Erica's inner muscles grip his cock like a vise, making sure that only moments later, the big cat lets out a satisfied roar himself and his cock starts pulsing with spurt after spurt of fertile seed shooting into Erica's pussy. The young woman lowers her hand to the height of her belly button, reveling in the feeling of being bred by the large feline creature.";
		say "     With her breathing deeply and still in the grip of her own orgasm, you put your fingers to work on your own pussy in earnest, eager to join your two partners in climax. It's not much longer before your frantic movements push you over the edge to your release and you come, a squirt of femcum hitting Erica in the chest to run down over her smooth skin and more of it dripping down on Klauz's belly-fur. Your human friend gives you a broad smile, then reaches up to pull you down to her level and kiss her.";
		WaitLineBreak;
		say "     One kiss follows another and Erica keeps her position for a while longer as you make out, straddling the felinoid's hips with the beast's softening shaft inside her, before eventually sliding off Klauz to the side, coming to rest against the large cat's flank. There she rests, pressed against the loudly purring feline's warm body and with an arm and a leg still draped over him. Sadly, there isn't any more room on the bed, with the large shape of the felinoid and your attractive female friend already on it, so you leave them to cuddle and rest and go to collect your clothes.";
	else: [BJ from felinoid]
		LineBreak;
		say "     Stepping up to stand against the head end of the bed, you give Klauz's chin an affectionate scratch, then get on the bed to kneel over his head. His long whiskers tickle against your legs as the large cat nuzzles upwards into your groin, sniffing your moist and ready pussy. Then he starts to lick you, his rough tongue carefully lapping over sensitive flesh and seeking out your clit.";
		WaitLineBreak;
		say "     While you're getting oral attention from the large beast, Erica rides his spined cock with unabated vigor, moaning and gasping loudly at the sensations it gives her. With how much she enjoys riding the big cat, it doesn't take too much longer until Erica's arousal peaks. Panting unintelligible sounds in her lust, the female athlete rises up and slams herself down on the hard erection under her, a shudder running through her whole body as she comes. As femcum trickles down the felinoid's shaft, Erica's inner muscles grip his cock like a vise, making sure that only moments later, the big cat lets out a satisfied roar himself and his cock starts pulsing with spurt after spurt of fertile seed shooting into Erica's pussy. The young woman lowers her hand to the height of her belly button, reveling in the feeling of being bred by the large feline creature.";
		say "     With Klauz busy savoring her own orgasm, you put your fingers to work on your own pussy in earnest, eager to join your two partners in climax. It's not much longer before your frantic movements push you over the edge to your release and you come, a squirt of femcum hitting the felinoid's muzzle and more of it dripping down on the fur on his neck. The big cat gives a pleased rumble, licking it off her muzzle and lapping at your crotch a few times to get a bit more of a taste.";
		WaitLineBreak;
		say "     Erica keeps her position for a while longer, straddling Klauz's hips with the beast's softening shaft inside her, before eventually sliding off the felinoid to the side, coming to rest against the large cat's flank. There she rests, pressed against the loudly purring feline's warm body and with an arm and a leg still draped over him. Sadly, there isn't any more room on the bed, with the large shape of Klauz and your attractive female friend already on it, so you leave them to cuddle and rest and go to collect your clothes.";

Section 4 - Events

instead of navigating Grey Abbey Library while (level of Erica is 0 and Felinoid Companion is tamed and (HP of Erica is 1) and (lastfuck of Erica - turns) > 12):
	say "[NavCheck Grey Abbey Library]";
	if NavCheckReturn is false, stop the action;
	move player to Grey Abbey Library;
	if debugactive is 1:
		say "     DEBUG: ERICA FIRST FELINOID SEX WALKIN [line break]";
	say "     As you enter the library, you see Erica walk in between two of the long shelves, intently scanning over the titles of the books. Now that you think of it, she's been spending quite a bit of her time up here lately, picking out books and reading. Well, it's something interesting to do at least. Just as you start turning away to leave her to her reading, you see the large shape of Klauz silently stalk after Erica. Knowing the large cat's libido-driven behavior, you see where this might lead...";
	LineBreak;
	say "     Do you want to go after them to see what happens and maybe do something about it ([link]Y[as]y[end link]), or do you just leave them to it and turn your attention to other things ([link]N[as]n[end link])?";
	if player consents: [follow]
		LineBreak;
		say "     Walking into the same space between the bookshelves that you saw your two companions go into, you spot Erica some distance ahead of you, still checking out books and being totally oblivious to the felinoid stalking her. Then the large cat catches up with her, rubbing his flank against the human athlete's hips and making a resounding purring sound in his throat. Erica is easily taken in by Klauz's affectionate demeanor, petting the large creature as he circles her, rubbing up against Erica's body and flirting his long tail in front of the human's face.";
		say "     Soon Erica crouches down, her hands busy rubbing the felinoid's belly fur and behind his ears in something of a trance. She brushes her cheek against the large cat's soft fur and breathes in deep, now completely succumbing to his pheromone-laden scent. A low and throaty sound comes from Klauz, almost a feline chuckle, and he spends a moment nuzzling against the twin mounds of Erica's perky breasts before he bumps her with his shoulder, making the young woman fall forward on all fours.";
		LineBreak;
		say "     Do you want to watch Klauz mount Erica ([link]Y[as]y[end link]) or will you step in and snap her out of the trance ([link]N[as]n[end link])?";
		if player consents:
			LineBreak;
			say "     With the young athlete just dazedly resting on all fours, Klauz uses his large paws to pat at her pants, soon managing to hook a claw under the band of the shorts pulling it down, revealing that Erica went commando today. The large cat gives his entranced human a deep sniff, then starts to lick between the legs, lapping away at Erica's open pussy lips. After a moment of making the red-headed beauty pant and moan, the felinoid then gives her a lick over the small of her back, before finally moving to stand completely over the smaller human, nuzzling at her neck while bumping against her butt with a hard and erect spined cock.";
			say "     Lowering his hips and doing small probing thrusts, Klauz soon finds the opening of Erica's moist and ready pussy and plunges in. With a satisfied roar, he sinks all of her manhood inside, then starts fucking her with powerful and deep thrusts. Moans, pants and growls of lust fill the library and you move a bit closer to get a better view.";
			WaitLineBreak;
			say "     The animalistic coupling of the felinoid and his entranced partner is quite a show, driving your arousal to new heights as you watch. With the stamina of a wild beast, Klauz drives his cock into Erica's pussy relentlessly, until finally the beautiful redhead's moans and noises rise up to a climactic shout, announcing her orgasm to anyone in hearing range. Visibly satisfied in making her come, the felinoid isn't far behind, burying his hard cock all the way in the young human's pussy and then holding still, only his balls pulsing as they fill her up with his seed. When he finishes cumming, the big cat throws himself on the floor to lounge in satisfaction, taking Erica with her, still impaled on the feline's shaft and soon held against his soft belly fur with a muscular forelimb.";
			now level of Erica is 3;
			now lastfuck of Erica is turns;
		else:
			LineBreak;
			say "     Deciding that this has gone far enough, you dash forward, grabbing Erica by the shoulder and pulling her up to stand. With your hand on the young woman's arm, you walk her a few steps away from the musky cloud of scent around Klauz and softly slap her cheeks several times as she breathes in fresh air. Finally shaking out of it, her eyes focus on you after the last slap and she says 'Hey, what are you doing? I was just... looking for books and... then... I -'";
			say "     Erica's brows draw together as she mentally puzzles together the last five minutes of time and turns in confusion to you. While you explain about the felinoid's charm and the effects of his musk, the two of you hear a disappointed growl from the large cat, who gives Erica a last look before stalking off, trying to act as if he hadn't planned to do anything with the human after all.";
			now level of Erica is 99;
	else: [leave it]
		LineBreak;
		say "     Oh well, it would happen at some point no matter what you do. It's not like you've got the time to constantly watch over what Klauz is doing anyways. Some short time later, you hear lust-filled growls and pants sound from somewhere between the bookshelves, culminating in a satisfied roar not long after.";
		now level of Erica is 1;
		now lastfuck of Erica is turns;

instead of navigating Grey Abbey Library while (Felinoid Companion is tamed and level of Erica is 4 and HP of Erica is 1 and (lastfuck of Erica - turns) > 12 and a random chance of 1 in 3 succeeds):
	say "[NavCheck Grey Abbey Library]";
	if NavCheckReturn is false, stop the action;
	move player to Grey Abbey Library;
	if debugactive is 1:
		say "     DEBUG: ERICA FELINOID SEX REPEAT WALKIN [line break]";
	say "     As you enter the library, you hear moaning and lust-filled growls coming from somewhere behind one of the back shelves. Curious who's doing whom, you go to check it out. Walking over until you see the space behind the long bookshelf, you spot Erica - with Klauz on top of her, mounting the smaller human and rapidly thrusting his hips at her. Seems like the big cat managed to put your friend under his influence again - though it seems this time Erica went to seek the feline out - after all, the young athlete is on her hands and knees on one of the mattresses from the cots in the bunker below, which she must have dragged up here for just this purpose...";
	LineBreak;
	say "     The animalistic coupling of the felinoid and his entranced partner is quite a show - between seeing the curves of Erica's shapely breasts swing with each new thrust and the play of trained muscles on their naked bodies, it drives your arousal to new heights as you watch. With the stamina of a wild beast, Klauz drives his cock into Erica's pussy relentlessly, until finally the beautiful redhead's moans and noises rise up to a climactic shout, announcing her orgasm to anyone in hearing range. Visibly satisfied in making her come, the felinoid isn't far behind, burying his hard cock all the way in the young human's pussy and then holding still, only his balls pulsing as they fill her up with his seed. When he finishes cumming, the big cat throws himself on the mattress to lounge in satisfaction, taking Erica with her, still impaled on the hard shaft inside her and soon held against his soft belly fur with a muscular forelimb.";
	now lastfuck of Erica is turns;

instead of going down from Grey Abbey Library while (Level of Erica > 0 and Level of Erica < 4 and Erica is in Bunker and HP of Erica < 99):
	move player to Bunker;
	if debugactive is 1:
		say "     DEBUG: ERICA POST-FELINOID-SEX WALKIN [line break]";
	say "     As you come down the stairs into the bunker, Erica almost jumps up from where she was sitting on her cot and rushes over to you, her cheeks red with embarrassment. Before you can so much as ask what's wrong, she gushes forth with 'I'm sorry. I- I had sex with Klauz. Something just came over me and I let him mount and fuck me! Can you ever forgive me for this?' her somewhat teary eyes seek out yours and take on a hopeful look as she realizes how calmly you're taking this (you did already know and didn't stop the felinoid from fucking her after all).";
	say "     So, what do you tell her? That there's no shame in having some fun, even without you and with... exotic partners ([link]Y[as]y[end link])? Or do you just console her and tell her to avoid Klauz in the future ([link]N[as]n[end link])?";
	if player consents: [more felinoid scenes]
		LineBreak;
		say "     Putting your arms around Erica and holding her, you console the young woman with calm words, explaining that you're not angry or anything. After all, it's a whole new world with the nanites and everything going on, so why should people be restrained by the morals of the old one. The young athlete's eyes get wide in realization as you remind her that you brought Klauz home with you, even after knowing his lusty character. Pulling her close again, you squeeze Erica's tight ass and whisper in her ear that [if Level of Erica is 1 or Level of Erica is 2]you saw the felinoid follow her in the library and were okay with it[else]you were there and did watch the hot little scene of the felinoid mounting her[end if]. A visibly relieved Erica stutters 'So you did... you let... he did...', then takes a deep breath before admitting 'He felt so good - so right - inside me, having his hard cock fuck me, that soft belly-fur against my back...' Her breathing becomes quicker as she relives her experience with Klauz in memory, clearly getting aroused by it.";
		LineBreak;
		say "     Do you want to seize the moment for some hot action between the sheets with Erica ([link]Y[as]y[end link]), or do you just leave her to dwell on those lusty thoughts ([link]N[as]n[end link])?";
		now Level of Erica is 4;
		if player consents:
			say "     [EricaSexMenu]";
		else:
			LineBreak;
			say "     Smiling at Erica and encouraging her to have some more fun with Klauz whenever she wants, you chat with her a short while, then turn to other things. The by now pretty wound up young athlete meanwhile makes a beeline for her bunk, no doubt to rub herself deal with the built-up lust.";
	else: [no further felinoid scenes]
		LineBreak;
		say "     Putting your arms around Erica and holding her, you console the young woman with calm words, explaining to her that you're not angry or anything. After all, it's partly your fault for bringing Klauz here with you (and letting him fuck Erica, but she doesn't need to know that). Telling Erica just not to fall for the felinoid's charms and arousing musk again, you give the visibly relieved athlete a kiss on the cheek and leave her to get back to her bunk.";
		now Level of Erica is 99;

instead of navigating Grey Abbey Library while (XP of Erica is 0 and Fang is in Grey Abbey Library and (HP of Erica is 1) and (lastfuck of Erica - turns) > 12):
	say "[NavCheck Grey Abbey Library]";
	if NavCheckReturn is false, stop the action;
	move player to Grey Abbey Library;
	if debugactive is 1:
		say "     DEBUG: ERICA FIRST FANG SEX WALKIN [line break]";
	say "     As you enter the library, you see Erica walk in between two of the long shelves, intently scanning over the titles of the books. Now that you think of it, she's been spending quite a bit of her time up here lately, picking out books and reading. Well, it's something interesting to do at least. Just as you start turning away to leave her to her reading, you see Fang's furred shape silently stalk after Erica. Knowing that he's a wild and horny beast, you see where this might lead...";
	LineBreak;
	say "     ([link]Y[as]y[end link]) - Go after them to see what happens and maybe do something about it.";
	say "     ([link]N[as]n[end link]) - Leave them to it and turn your attention to other things.";
	if player consents: [follow]
		LineBreak;
		say "     Walking into the same space between the bookshelves that you saw your two companions go into, you spot Erica some distance ahead of you, crouched down in front of a shelf and still checking out books, totally oblivious to Fang stalking her. Then the dark-furred wolf catches up to the young woman and pounces, hitting her with both front paws in the back and making her fall over on all fours, with the books she was holding tumbling on the floor. 'Hey, what are you doing,' the college athlete starts to exclaim - only to fall silent with a frightened 'Eeep' when she turns her head to face her attacker and finds herself face to face with a snarling and dominantly growling Fang. With Erica frozen motionless from seeing the wolf's sharp fangs bared at her, the feral beast raises a paw and pushes down on her shoulders, successfully managing to make her lower her front some more, now looking up at him in a classically submissive pose.";
		say "     Then, giving a commanding growl that you think might mean 'stay', the wolf pads around his prey, sticking his nose in between her legs from behind and taking a deep sniff. It's obvious that Fang likes the young woman's scent quite a bit - as his knotted shaft starts to push out from its sheath and he gives aroused growls and pants. A moment later, the feral wolf nips at Erica, catching her shorts between his teeth and giving them a tug downwards, baring her shapely behind and the white panties that form the last barrier between him and this young woman's pussy. Interestingly, you notice that the silky material of Erica's underwear is rather damp at the front - almost as if she can't help but be aroused from the situation she now finds herself in.";
		LineBreak;
		if HP of Fang < 3: [Beta Fang can be stopped]
			say "     The sound of ripping cloth as Fang takes Erica's panties between his teeth and wrenches them off her body breaks you out of the stasis in which you watched what has been going on. If you want to stop Fang, now would be the time to do it!";
			LineBreak;
			say "     ([link]Y[as]y[end link]) - Pull the wolf off Erica right now.";
			say "     ([link]N[as]n[end link]) - Just let things happen...";
			if player consents: [stop beta Fang]
				LineBreak;
				say "     Rushing forward, you grab Fang by the scruff of his neck just as he rears up to mount the young woman. The feral beast's head twists towards you as he starts a frustrated snarl at being cock-blocked... only to end in a whimper as he realizes he bared his teeth at the pack Alpha. You give the now submissively whining wolf a rough shake to remind him who's the boss, then tell him to keep his paws off Erica in the future. As you let go of Fang afterwards, he hesitates for just a second, looking with longing at Erica's bared pussy, then turns around and scurries off, tail between his legs.";
				WaitLineBreak;
				say "     Now that the wolf is gone, Erica quickly stands up and turns around, throwing her arms around you as she almost bubbles over with saying, 'Oh thank you. Thank you. I was so afraid. He was gonna -' The reassuring hug you decide to give her at this moment leads over into a moment of shocked silence... as pulling Erica closer to yourself brings the small trickle of female juices down her inner thighs into contact with your skin for a second. Both your eyes move downwards, looking at the pair of shorts still pushed down to her knees... and the swollen and dripping nether lips they're doing nothing to hide. Face flushing a deep red in embarrassment, the young woman doesn't quite manage to suppress a little moan escaping her lips, then takes a deep breath and continues, '- he was going to fuck me. And... and I didn't even try to get away. I - I didn't want to, because... I just got so horny and wet even thinking about it. Oh god! What's wrong with me? I -'";
				say "     Pulling Erica close again, you stop her agitated babbling by bringing your lips to hers, just holding and kissing the young woman until she calms down a little bit. Then you gently tell her that it's nothing to worry about too much... the nanites may make people forget their inhibitions and do crazy things in the heat of the moment, but as long as you stay true to yourself and don't succumb to such thoughts afterwards, it's just temporary. And clearly, she's not affected if she worries about it now. Erica nods slowly, though even as she accepts your reasoning, you can almost see that the thoughts in her head are still circling about what she almost willingly let a feral animal do to her. Maybe you should distract her a bit so she doesn't worry about Fang anymore - nothing happened after all and you can't hang after 'what if's' all day.";
				LineBreak;
				say "     [bold type]What do you want to do?[roman type]";
				say "     ([link]Y[as]y[end link]) - Sit with her on a comfortable sofa, cuddle and read one of the books she picked together.";
				say "     ([link]N[as]n[end link]) - Have sex with her yourself - she's still pretty aroused and it'd certainly make her think of someone else than your wolf pet...";
				if player consents: [calm Erica down]
					LineBreak;
					say "     Giving Erica another quick kiss on the lips, you bend down and pick up the books Fang made her drop, guide the young woman over to the next reading group, where you sit down comfortably together with her. Leaning back with your arm around her shoulders, you then open up a book and hold it so you can both see it, then start reading aloud from it. Between the two of you taking turns, you make it quite a few chapters into the interesting piece of literature that Erica picked out, more than long enough for her residual anxiousness about Fang to fade. In fact, you like exploring the story of the book together with your female friend so much that you almost have to force yourself to get up, sighing about having to get back to ensuring your survival in this chaotic city.";
				else: [fuck her]
					LineBreak;
					say "     Giving Erica another quick kiss on the lips, you sneak a hand under her T-shirt, moving up to cup her perfectly shaped left breast and giving it a gentle squeeze that has the young woman sighing with arousal. As wound up as she is from her earlier encounter with Fang, the beautiful redhead just melts into your arms, readily letting herself be guided over to the next reading group, where she kneels on a softly cushioned sofa. Then the college athlete pulls her shirt over her head in a quick move, baring her well-trained body and shapely breasts fully for you to enjoy. A moment later, she automatically lowers herself down to all fours, legs spread widely to bare her wet and ready pussy in a typical doggie-style position. Seems like the encounter with Fang did leave some interesting effects after all...";
					if player is male:
						say "     Finding yourself confronted with such a very enticing display of Erica's naked body, you almost rip your clothes and gear off, just flinging it to the ground as you step towards the sofa. With your raging libido in control now, you quickly climb on it behind the young woman, grunting in lust as your rock-hard cock brushes against her soft skin an eye-blink later. Erica gives a needy, almost pleading sigh and rocks back a little bit - which makes her dripping wet nether lips engulf the tip of your shaft. As you feel the warm and tight grip of her inner passage around your manhood, you can't help but thrust into her deeply, only stopping when your crotch is flush against her behind and your cock balls-deep inside the beautiful college athlete.";
						WaitLineBreak;
						say "     'Yes. Please fuck me!' comes Erica's high-pitched moan as she starts up rocking her body back and forth to fuck herself on your shaft, quickly drawing you out of the trance of simply enjoying being inside her. You don't think you could have refused anything at all that she might have asked from you right now - and you're more than happy to take hold of the young woman's hips to really thrust deep and keep going after that, pounding into her pussy with audible slaps each time your hips meet. The sounds of sex fill the aisles of the library - moans, grunts and loud panting echoing between the bookshelves as the two of you fuck each other eagerly. A smile creeps over your lips as you think about how this situation would have played out before the nanite apocalypse... yourself and a breathtaking woman like Erica, totally naked and humping like bunnies - right here in a public library.";
						say "     The image of a gray-haired librarian coming to investigate and shockedly looking over the rim of her glasses at the fucking couple she'd have found draws a chuckle from you - and gives you a naughty little idea. After your next deep thrust, you lean forward on top of Erica's back and wrap your arms around her chest, then whisper into her ear, 'Sssh. Quiet, this is a library.' It's funny to hear her give a shocked gasp and try to stifle her moans - unsuccessfully, as you cup her shapely breasts with both hands and start playing with her nipples - until she eventually pants out, 'Wait - what? The library is closed. There's no one here but -' The rest of her protest is replaced by a deep moan as you choose that very moment to pull out almost all the way and hammer your cock back into Erica's wet pussy, then continue to fuck her with unabated intensity.";
						WaitLineBreak;
						say "     You and your sexy friend go at it for some more time, until the relentless rubbing of your hard shaft against all the right spots inside her drive Erica to a very vocal orgasm. Hands digging into the fabric of the sofa, the young woman almost screams in lust while her pussy starts to squirt and drip femcum, as well as giving you quite nice sensations yourself with the trembling and twitching of its inner muscles. It only takes a few more deep thrusts before you reach your own climax and your manhood starts to pulse as it delivers spurt after spurt of your fertile load deep into Erica's pussy.";
						say "     Breathing heavily, you eventually pull your cock out of the college athlete's trained body, then move to lie on the sofa with her, holding each other in post-coital bliss. Exhausted as she is from the scare with Fang and you wearing her out afterwards, Erica gives you a soft kiss on the lips, murmuring, 'I love you,' and then dozes off. You kiss her forehead and wish you could stay like this forever, your arms around her as you rest in peace on the sofa. With a last thought you imagine your cum exploring her womb for an egg to create life with, then fall asleep yourself.";
					else if player is female:
						say "     Finding yourself confronted with such a very enticing display of Erica's naked body, you almost rip your clothes and gear off, just flinging it to the ground as you step towards the sofa. With your raging libido in control now, you quickly sink to your knees beside it, sighing softly as you see the beautiful flower-like shape of her sex. Then you lean forward and give the little nub of her clit a teasing lick - which makes Erica give a needy, almost pleading sigh, then rock back a little bit to prolong your contact as you pull away again. Such a nice little pair of nether lips she presents to you - swollen and spread, with a glittering sheen of femcum. Your hands move almost on their own to touch them, rubbing over her folds before dipping inside, entering the warm cave of her sex and feeling to find the right spots to draw ever louder moans and pants from Erica. Meanwhile, your other hand brushes down your own body and starts to fondle your pussy in sync with Erica's, driving both your libidos higher and higher.";
						WaitLineBreak;
						say "     'Yes. Stroke me! Faster!' come Erica's high-pitched moans as she starts rocking her body back and forth to fuck herself on your fingers. You don't think you could have refused anything at all that she might have asked from you right now - and you're more than happy to intensify your manual stimulation of the young woman's pussy. The sounds of sex fill the aisles of the library - moans, grunts and loud panting echoing between the bookshelves. A smile creeps over your lips as you think about how this situation would have played out before the nanite apocalypse... yourself and a breathtaking woman like Erica, totally naked and oh so wet and aroused - right here in a public library.";
						say "     The image of a gray-haired librarian coming to investigate and shockedly looking over the rim of her glasses at the fucking couple she'd have found draws a chuckle from you - and gives you a naughty little idea. Gently pulling your hand away from her crotch, you stand up and then lean over Erica's back, wrapping your arms around her chest and then whispering, 'Sssh. Quiet, this is a library.' It's funny to hear her give a shocked gasp and try to stifle her moans - unsuccessfully, as you cup her shapely breasts with both hands and start playing with her nipples - until she eventually pants out, 'Wait - what? The library is closed. There's no one here but -' The rest of her protest is replaced by a deep moan as you choose that very moment to brush over her clit again, rubbing the little nub while sticking the fingers of your other hand between her pussy lips.";
						WaitLineBreak;
						say "     You and your sexy friend go at it for some more time, until the relentless rubbing of your talented fingers against all the right spots inside her drive Erica to a very vocal orgasm. Hands digging into the fabric of the sofa, the young woman almost screams in lust while her pussy starts to squirt and drip femcum, soon trickling down over your hand and arm. It only takes a few more moments of frantic rubbing before you reach your own climax and start to squirt your female juices all over the carpet next to the sofa.";
						say "     Breathing heavily, you eventually get up from where you were leaning against the sofa and Erica's right leg, then move to lie on the sofa with her, holding each other in post-coital bliss. Exhausted as she is from the scare with Fang and you wearing her out afterwards, Erica gives you a soft kiss on the lips, murmuring, 'I love you,' and then dozes off. You kiss her forehead and wish you could stay like this forever, your arms around her as you rest in peace on the sofa. With a last thought you imagine sharing a 69 in which you both lick each other, then fall asleep yourself.";
					else:
						say "     Finding yourself confronted with such a very enticing display of Erica's naked body, you almost rip your clothes and gear off, just flinging it to the ground as you step towards the sofa. With your raging libido in control now, you quickly sink to your knees beside it, sighing softly as you see the beautiful flower-like shape of her sex. Then you lean forward and give the little nub of her clit a teasing lick - which makes Erica give a needy, almost pleading sigh, then rock back a little bit to prolong your contact as you pull away again. Such a nice little pair of nether lips she presents to you - swollen and spread, with a glittering sheen of femcum. Your hands move almost on their own to touch them, rubbing over her folds before dipping inside, entering the warm cave of her sex and feeling to find the right spots to draw ever louder moans and pants from Erica. Meanwhile, your other hand brushes down your own body and starts to fondle the smooth and sexless, but nevertheless quite sensitive area of your crotch in sync with Erica's pussy, driving both your libidos higher and higher.";
						WaitLineBreak;
						say "     'Yes. Stroke me! Faster!' come Erica's high-pitched moans as she starts rocking her body back and forth to fuck herself on your fingers. You don't think you could have refused anything at all that she might have asked from you right now - and you're more than happy to intensify your manual stimulation of the young woman's pussy. The sounds of sex fill the aisles of the library - moans, grunts and loud panting echoing between the bookshelves. A smile creeps over your lips as you think about how this situation would have played out before the nanite apocalypse... yourself and a breathtaking woman like Erica, totally naked and oh so wet and aroused - right here in a public library.";
						say "     The image of a gray-haired librarian coming to investigate and shockedly looking over the rim of her glasses at the fucking couple she'd have found draws a chuckle from you - and gives you a naughty little idea. Gently pulling your hand away from her crotch, you stand up and then lean over Erica's back, wrapping your arms around her chest and then whispering, 'Sssh. Quiet, this is a library.' It's funny to hear her give a shocked gasp and try to stifle her moans - unsuccessfully, as you cup her shapely breasts with both hands and start playing with her nipples - until she eventually pants out, 'Wait - what? The library is closed. There's no one here but -' The rest of her protest is replaced by a deep moan as you choose that very moment to brush over her clit again, rubbing the little nub while sticking the fingers of your other hand between her pussy lips.";
						WaitLineBreak;
						say "     You and your sexy friend go at it for some more time, until the relentless rubbing of your talented fingers against all the right spots inside her drive Erica to a very vocal orgasm. Hands digging into the fabric of the sofa, the young woman almost screams in lust while her pussy starts to squirt and drip femcum, soon trickling down over your hand and arm. It only takes a few more moments of frantic rubbing before you reach your own climax tremble all over as an amazing orgasm rocks your body.";
						say "     Breathing heavily, you eventually get up from where you were leaning against the sofa and Erica's right leg, then move to lie on the sofa with her, holding each other in post-coital bliss. Exhausted as she is from the scare with Fang and you wearing her out afterwards, Erica gives you a soft kiss on the lips, murmuring, 'I love you,' and then dozes off. You kiss her forehead and wish you could stay like this forever, your arms around her as you rest in peace on the sofa. With a last thought you imagine sharing a 69 in which you both lick each other, then fall asleep yourself.";
				now XP of Erica is 99;
				now lastfuck of Erica is turns;
			else: [not stopping Beta Fang]
				LineBreak;
				say "     Silently watching, you just stay where you are and watch as your pet wolf rears up and sinks his canine cock into Erica's waiting pussy, sinking his maleness deep with a lusty growl. It's oddly exciting to see the wild animal mounting the pale-skinned human woman under him, his tail raised proudly as she gasps in arousal and need. Clearly Erica is getting off more than just a little bit from being pounded by the wolf's pointy, canine shaft. As for yourself - you do suddenly realize that your left hand is down by your crotch, rubbing it to satisfy your building arousal at the sexy show. An interesting little thought bubbles up in your mind, telling you that ready the acceptance of all this - bestiality, interspecies sex and just going along with almost anything sexual once the actual act starts - must be inherent in nearly all nanite strain's mental package. And then, the realization is gone again, forgotten as your fingers open the front of your pants, baring the [if player is male]half-hard erection you're already sporting and giving it a few slow jerks[else if player is female]wet and swollen pussy between your legs and allowing you to rub gently over its clit[else]smooth and sexless area of your crotch and allowing you to rub gently over its sensitive skin[end if].";
				WaitLineBreak;
				say "     Under your watching eyes, Fang makes Erica his bitch, pounding into her with an animal's boundless ferocity and soon even lightly nipping at her neck to hold on to her and show his dominance. The college athlete gives high-pitched moans as she is penetrated deeply again and again - enjoying being humped so much that she even rocks backward to meet his thrusts and get more of that wolf shaft inside her. Quite a hot little show you're getting here - and in such an interesting locale. You can't help but giggle at what would have happened if this was going on before the nanite apocalypse in a public library... a young, naked woman being mounted by a wolf, filling the room with all kinds of squelchy noises while the animal's master is standing nearby and touching [if player is male]himself[else if player is female]herself[else]himself[end if].";
				say "     As the unequal couple's mating continues though quite a while more of hot and heavy fucking, Fang eventually gives one especially deep thrust that pops his knot inside Erica's pussy. Then the wolf simply holds still, giving pants that somehow seem very self-satisfied - while at the same time, a large fleshy bulge at the base of his cock expands, tying their bodies together. With his knot firmly in place, ensuring that he's got all the time in the world to flood her womb with burst after burst of canine seed, Fang now nuzzles Erica's neck and the side of her head, much more amicable now that he's claimed her as one of his bitches. Getting bred by the feral beast is the last straw for Erica herself - her body shudders as she orgasms, giving lust-filled moans and shouts.";
				WaitLineBreak;
				say "     With the fuck-show now being over and nothing to see except a wolf balls-deep inside a well-built naked woman, you... stay a while yet, looking at Erica's enticing body while continuing to stroke yourself. It doesn't take long before the familiar sensations of an imminent orgasm build up inside you. Quickly dodging around the corner of the nearest bookshelf, you get out of sight before your rising moans draw Erica's attention, then [if player is male]blast your load all over a meter-wide section of world literature[else if player is female]squirt more than a little femcum to drip and soak into the carpet on the library floor[else]tremble and twitch as a breathtaking climax rocks your world[end if].";
				now XP of Erica is 3;
		else: [Alpha Fang does what he want]
			LineBreak;
			say "     The sound of ripping cloth as Fang takes Erica's panties between his teeth and wrenches them off her body breaks you out of the stasis in which you watched what has been going on. The quick thought of maybe stopping him rushes through your mind, but... no, it doesn't matter if you want to or not, you don't dare approach the dominant wolf right now. And then... the whole concept of intervening becomes moot anyways, as the mighty wolf just rears up and thrusts into the young woman, mounting your friend with a loud and dominant growl that makes clear that the alpha wolf has claimed another bitch for himself. You can't help but be reminded of when he fucked you the last time, driving you to a heightened state of arousal as you imagine being the one under his furry body right now.";
			say "     Silently watching, you just stay where you are and watch as your alpha wolf rears up and sinks his canine cock into Erica's waiting pussy, sinking his maleness deep with a lusty growl. It's oddly exciting to see the wild animal mounting the pale-skinned human woman under him, his tail raised proudly as she gasps in arousal and need. Clearly Erica is getting off more than just a little bit from being pounded by the wolf's pointy, canine shaft. As for yourself - you do suddenly realize that your left hand is down by your crotch, rubbing it to satisfy your building arousal at the sexy show. An interesting little thought bubbles up in your mind, telling you that ready the acceptance of all this - bestiality, interspecies sex and just going along with almost anything sexual once the actual act starts - must be inherent in nearly all nanite strain's mental package. And then, the realization is gone again, forgotten as your fingers open the front of your pants, baring the [if player is male]half-hard erection you're already sporting and giving it a few slow jerks[else if player is female]wet and swollen pussy between your legs and allowing you to rub gently over its clit[else]smooth and sexless area of your crotch and allowing you to rub gently over its sensitive skin[end if].";
			WaitLineBreak;
			say "     Under your watching eyes, Fang makes Erica his bitch, pounding into her with an animal's boundless ferocity and soon even lightly nipping at her neck to hold on to her and show his dominance. The college athlete gives high-pitched moans as she is penetrated deeply again and again - enjoying being humped so much that she even rocks backward to meet his thrusts and get more of that wolf shaft inside her. Quite a hot little show you're getting here - and in such an interesting locale. You can't help but giggle at what would have happened if this was going on before the nanite apocalypse in a public library... a young, naked woman being mounted by a wolf, filling the room with all kinds of squelchy noises while another of the mighty animal's submissive partner's is standing nearby and touching [if player is male]himself[else if player is female]herself[else]himself[end if].";
			say "     As the unequal couple's mating continues though quite a while more of hot and heavy fucking, Fang eventually gives one especially deep thrust that pops his knot inside Erica's pussy. Then the wolf simply holds still, giving pants that somehow seem very self-satisfied - while at the same time, a large fleshy bulge at the base of his cock expands, tying their bodies together. With his knot firmly in place, ensuring that he's got all the time in the world to flood her womb with burst after burst of canine seed, Fang now nuzzles Erica's neck and the side of her head, much more amicable now that he's claimed her as one of his bitches. Getting bred by the feral beast is the last straw for Erica herself - her body shudders as she orgasms, giving lust-filled moans and shouts.";
			WaitLineBreak;
			say "     With the fuck-show now being over and nothing to see except a wolf balls-deep inside a well-built naked woman, you... stay a while yet, looking at Erica's enticing body while continuing to stroke yourself. It doesn't take long before the familiar sensations of an imminent orgasm build up inside you. Quickly dodging around the corner of the nearest bookshelf, you get out of sight before your rising moans draw Erica's attention, then [if player is male]blast your load all over a meter-wide section of world literature[else if player is female]squirt more than a little femcum to drip and soak into the carpet on the library floor[else]tremble and twitch as a breathtaking climax rocks your world[end if].";
	else:
		LineBreak;
		say "     Oh well, it would happen at some point no matter what you do. It's not like you've got the time to constantly watch over what Fang is doing anyways. Some short time later, you hear lust-filled growls and pants sound from somewhere between the bookshelves, culminating in a satisfied howl not long after.";
		now XP of Erica is 1;
		now lastfuck of Erica is turns;

[ CarlEricInteraction                                                ]
[   0: not met                                                       ]
[   1: ran into each other in the library                            ]
[   2: Jogged together & Talked                                      ]
[   3: Talked about being a dog & being a former male                ]
[   4: Did sit-ups together                                          ]
[   5: Carl got the go-ahead from the player for a move on Erica     ]
[   6: Carl fucked Erica                                             ]
[  50: player told Carl to stop pursuing Erica                       ]

instead of going up from Bunker while (Erica is in Bunker and Carl is in Grey Abbey 2F and CarlEricInteraction is 0):
	move player to Grey Abbey Library;
	if debugactive is 1:
		say "     DEBUG: Erica MEETS CARL - CHAT - CarlEricInteraction: [CarlEricInteraction]";
	say "[EricaMeetsCarl]";

instead of navigating Grey Abbey Library while (Erica is in Bunker and Carl is in Grey Abbey 2F and CarlEricInteraction is 0):
	say "[NavCheck Grey Abbey Library]";
	if NavCheckReturn is false, stop the action;
	move player to Grey Abbey Library;
	if debugactive is 1:
		say "     DEBUG: Erica MEETS CARL - CHAT - CarlEricInteraction: [CarlEricInteraction]";
	say "[EricaMeetsCarl]";

to say EricaMeetsCarl:
	say "     Coming into the library, you're just in time to see Carl and Erica meet each other. Having jogged his usual circuit through the outermost rows of bookshelves, the anthro husky comes out behind a shelf with 'true crime' stories and turns the corner - only to slow down as he sees Erica sit cross-legged on a sofa just a few steps ahead of him. Human and canine eyes meet as the two of them look at each other and Carl immediately breaks out his friendliest smile, stepping up as he says, 'Hey there, nice to meet you.' The soldier offers Erica his paw-hand to shake, introducing himself as Erica accepts it. Soon, the two of them are sitting on the sofa together and are having a friendly conversation. They seem to understand one another fairly well, two young guys (or former guys) in the midst of all this chaos.";
	now CarlEricInteraction is 1;
	now lastCarlEricInteraction is turns;

instead of going up from Bunker while (Erica is in Bunker and Carl is in Grey Abbey 2F and CarlEricInteraction > 0 and CarlEricInteraction < 5  and (lastCarlEricInteraction - turns > 6)):
	move player to Grey Abbey Library;
	if CarlEricInteraction is 1:
		if debugactive is 1:
			say "     DEBUG: Erica & CARL SPEND TIME TOGETHER 1 - CarlEricInteraction: [CarlEricInteraction]";
		say "[EricaCarlScene1]";
	else if CarlEricInteraction is 2:
		if debugactive is 1:
			say "     DEBUG: Erica & CARL SPEND TIME TOGETHER 2 - CarlEricInteraction: [CarlEricInteraction]";
		say "[EricaCarlScene2]";
	else if CarlEricInteraction is 3:
		if debugactive is 1:
			say "     DEBUG: Erica & CARL SPEND TIME TOGETHER 3 - CarlEricInteraction: [CarlEricInteraction]";
		say "[EricaCarlScene3]";
	else if CarlEricInteraction is 4:
		if debugactive is 1:
			say "     DEBUG: Erica & CARL SPEND TIME TOGETHER 3 - CarlEricInteraction: [CarlEricInteraction]";
		say "[EricaCarlScene4]";

instead of navigating Grey Abbey Library while (Erica is in Bunker and Carl is in Grey Abbey 2F and CarlEricInteraction > 0 and CarlEricInteraction < 5 and (lastCarlEricInteraction - turns > 6)):
	say "[NavCheck Grey Abbey Library]";
	if NavCheckReturn is false, stop the action;
	move player to Grey Abbey Library;
	if CarlEricInteraction is 1:
		if debugactive is 1:
			say "     DEBUG: Erica & CARL SPEND TIME TOGETHER 1 - CarlEricInteraction: [CarlEricInteraction]";
		say "[EricaCarlScene1]";
	else if CarlEricInteraction is 2:
		if debugactive is 1:
			say "     DEBUG: Erica & CARL SPEND TIME TOGETHER 2 - CarlEricInteraction: [CarlEricInteraction]";
		say "[EricaCarlScene2]";
	else if CarlEricInteraction is 3:
		if debugactive is 1:
			say "     DEBUG: Erica & CARL SPEND TIME TOGETHER 3 - CarlEricInteraction: [CarlEricInteraction]";
		say "[EricaCarlScene3]";
	else if CarlEricInteraction is 4:
		if debugactive is 1:
			say "     DEBUG: Erica & CARL SPEND TIME TOGETHER 4 - CarlEricInteraction: [CarlEricInteraction]";
		say "[EricaCarlScene4]";

instead of navigating Grey Abbey Library while (Erica is in Bunker and Carl is in Grey Abbey 2F and CarlEricInteraction > 4 and CarlEricInteraction < 50 and (lastCarlEricInteraction - turns > 6) and HP of Erica > 0 and HP of Erica < 21 and a random chance of 1 in 4 succeeds):
	say "[NavCheck Grey Abbey Library]";
	if NavCheckReturn is false, stop the action;
	move player to Grey Abbey Library;
	if CarlEricInteraction is 5: [first time]
		if debugactive is 1:
			say "     DEBUG: Erica & CARL FUCK - FIRST TIME - CarlEricInteraction: [CarlEricInteraction]";
		say "[EricaCarlScene5]";
	else if CarlEricInteraction is 6: [repeats]
		if debugactive is 1:
			say "     DEBUG: Erica & CARL FUCK - REPEAT - CarlEricInteraction: [CarlEricInteraction]";
		say "[EricaCarlScene6]";

to say EricaCarlScene1:
	say "     Coming into the library, you see Erica and Carl finish up a round of jogging together, both of them a bit sweaty as they sprint the last few meters and Erica beats the husky soldier to the end of the bookshelf - barely, but still ahead. Carl pants visibly with his tongue hanging out as any canine is wont to do and Erica pats him on the shoulder in a friendly way. 'Good run. It's great to have someone to train with again,' the college student tells her companion, who wags his tail exuberantly and gives a happy bark. 'Right back at ya, Erica. But you have to tell me - where did you learn to run like that? I mean - being in the army, I'm no slouch, but you really gave me a run for my money... and won, in the end.' As he says that, the muscular soldier looks Erica up and down and gives her an acknowledging nod.";
	say "     Erica is far from the same strength as him, but you can clearly see how her leaner, less bulky frame would be a boon in sprinting. The young woman blushes a bit at the praise and rubs the back of her neck. 'Well, I've always liked running and got into college on a track scholarship. And then there's Sirocco of course,' Erica explains, causing Carl to give her a questioning look with a raised eyebrow. 'Ah, Sirocco is my dog back home. He's a Saluki. You should see him run! I always loved having larger dogs, ever since I was a kid. Anyways, taking him out for a walk always ended up being a sprint, after a while. And so here I am - promising track-runner, college student... and just as lost as anyone here is, with those nanites spread through the whole city.'";
	say "     Having closed the gap between them while Erica talked of her dog, Carl puts an arm around her shoulder and gives the young woman a gentle squeeze. 'Don't worry, things will work out in the end. Trust in the army, by now there even are immunity boosters against the infection. I bet once there's enough of those stockpiled or the recipe has been perfected, the cavalry will move in to sort it all out.' The two of then walk off after that, still in friendly conversation...";
	now CarlEricInteraction is 2;
	now lastCarlEricInteraction is turns;

to say EricaCarlScene2:
	say "     Coming into the library, you see Carl and Erica sitting on one of the bigger sofas, hanging out together. They seem pretty comfortable with one another, having spent a bit of time here in the library by now. As you unobtrusively stroll closer to hear what they're talking about, Erica clears her throat and asks, 'So... what's it like being a dog?' Carl looks at her and opens his mouth to pant demonstratively, then licks the side of his muzzle with his long tongue before giving an amused snort. 'Oh, the funny thing is that you don't really feel all that different for the most part. Or maybe the nanites adjusted my memories - make everything seem like it has always been like that. You know... like when you decide to wiggle your ears and then you just do? It's like that, just with some different shapes...'";
	say "     The husky flicks a pointed ear, then stands up and steps pretty close in front of Erica, turning to present his rear. 'The tail was the hardest thing to master,' he explains. 'It is on something like an autopilot, reacting and doing its own thing. But if I concentrate, I can do something like THIS.' And with that, Carl grins over his shoulder, stretching his swishing appendage to tickle Erica's nose. The young woman calls out, 'Hey' and catches Carl's tail in both her hands. 'Hah, you got me,' the husky soldier tells her and ceases movement with his appendage, then gives a happy grin to his female friend. 'Overall, I like it. Not the transformation back when - that was... unpleasant. But being as I am right now... that's fine and dandy.'";
	WaitLineBreak;
	say "     Then Carl asks, 'So - how about yourself? Can't have been easy to find yourself playing for the other team so suddenly.' Shocked at the direction of this sudden question, Erica goes white in the face and flinches back a bit - though with her hands reflexively tightening their grip on Carl's tail, that just leads to her pulling the husky with her, falling on top of the student with a pained whine. 'Ouch!', 'Sorry,' 'Oh shit, no I'M sorry,' the two of them exchange words as they're in a tangle of limbs on the sofa, until Carl pushes himself up to half-lean over Erica and puts a hand on the young woman's shoulder. 'Hey, hey - calm down. I'm sorry. Really didn't mean to bring up bad memories. Me and my big mouth - damn,' the soldier brings out apologetically and Erica actually relaxes somewhat.";
	if CarlEricaInteraction is 1: [Carl knew Eric]
		say "     The young woman takes a deep breath and raises a hand to pat Carl's muscled arm lightly while saying, 'It's not that, really. Nothing raped me to... become like this, and it didn't hurt or anything. Just... I thought I could leave it behind. Be this new me - Erica, with no one the wiser that I... was a guy before.' She looks down over her body, as if frightful that she might see her pre-transformation shape - a flat, male chest instead of the nice curves of her breasts bulging out the front of her shirt - but there's nothing like that, just the lean body of a young female athlete. Carl replies, somewhat sheepishly, 'Um... well, you're pretty perfect as a woman. No worries about your looks. The thing is though - one of these is hard to fool...' With that said, the canine soldier strokes the side of his long muzzle, then pats his nose at the tip with a finger. 'I'm sorry to tell you this, but you do have a little bit of masculine scent still in the mix. The conflicting composition does make you quite interesting to anyone with more acute senses than a human...' Erica's eyes go wide at the revelation and she lets out a 'Well, fuck!' Then she slumps down on the sofa defeatedly.";
	else:
		say "     The young woman takes a deep breath and raises a hand to pat Carl's muscled arm lightly while saying, 'It's not that, really. Nothing raped me to... become like this, and it didn't hurt or anything. Just... how do you KNOW? That I... was a guy before.' She looks down over her body, as if frightful that she might see her pre-transformation shape - a flat, male chest instead of the nice curves of her breasts bulging out the front of her shirt - but there's nothing like that, just the lean body of a young female athlete. Carl replies, somewhat sheepishly, 'Um... well, you're pretty perfect as a woman. No worries about your looks. The thing is though - one of these is hard to fool...' With that said, the canine soldier strokes the side of his long muzzle, then pats his nose at the tip with a finger. 'I'm sorry to tell you this, but you do have a little bit of masculine scent still in the mix. The conflicting composition does make you quite interesting to anyone with more acute senses than a human...' Erica's eyes go wide at the revelation and she lets out a 'Well, fuck!' Then she slumps down on the sofa defeatedly.";
	WaitLineBreak;
	say "     Carl sits down on the sofa next to his human friend and pats her on the shoulder supportively. 'Come on, it's not that bad. Sure, you've changed... as have most people in this city, but you're still - you know, human. I feel great about being a husky, but who knows how dicey things will be when we get out of here eventually? Imagine the stupid dog-jokes and whatnot else that are in store for me and the other canines. And I won't even mention the... weirder body shapes out there.' Lifting the arm thrown over her face, Erica looks up at Carl with a thoughtful expression, then gives a slow nod. 'Um, yeah. I - I hadn't thought about that,' she says in an apologetic tone, then turns her head to look down over herself. Carl leans over to catch the young woman's gaze again, wanting to keep her from clamming up.";
	say "     The canine soldier says, 'No worries, it's natural to think of oneself first. But really - look at it from another perspective. You're an insanely pretty woman with all the looks. And as for what you were before - it's your decision to hide it, or accept it - and you can tell anyone who disses you about it to fuck off. Plus... I think the whole gender thing is gonna get blown wide open anyways, you're far from the only one who experienced something like this. You should see how many herms are running around in the streets out there.' It is clear from her expression that Carl got through to Erica, as the student runs a hand over her face and rubs her eyes, then takes a deep breath as she sits up. 'Okay okay - you're right,' the young woman finally admits. After a few more moments of silence, Carl starts to ask her about college basketball, wanting to put the sensitive topic to rest for now.";
	now CarlEricInteraction is 3;
	now lastCarlEricInteraction is turns;

to say EricaCarlScene3:
	say "     Coming into the library, you see Carl and Erica on the ground together, with the husky soldier holding the young woman's shins tightly as Erica does sit-ups. 'Come on! Give me 5 more. Thirty-one, -two, three, four, and five. You made it!' the anthro husky cheers on his friend, clapping a hand on Erica's shoulder and giving it a squeeze. The red-headed college athlete just smiles back at him, panting a little. 'We'll keep at it and have you fill out a bit in no time, I'm sure. Running isn't everything, and if you build up your upper body like those legs of yours, you'll be able to hold off anything with that bat you keep handy. Okay, my turn now!' Carl says, then switches positions with Erica and gets on his back. As the young woman grasps his legs just above the paws, the soldier starts doing sit-ups, one after another.";
	say "     Looks like the two of them really hit things off and have become fast friends since they met each other. Sometimes adversity can lead to good things too. After watching a few moments, you decide to leave them to their training and turn your attention to other things again.";
	now CarlEricInteraction is 4;
	now lastCarlEricInteraction is turns;

to say EricaCarlScene4:
	say "     Coming into the library, you see Carl and Erica do another stint of jogging together, coming out of the long rows of shelves side by side in casual conversation as they go along. Seeing you as they reach the end of their run, the human and husky wave in greeting, then Carl tells his friend with a smile, 'Nice workout. I'm so glad to have someone to hang out with.' Erica gives him a beaming grin and replies, 'Right back at you. Always a pleasure Carl.' And with that, the young woman says she wants to cool down a bit and read, then starts walking to the bunker entrance door. The canine soldier gives you a sidelong glance that tells you he wants to talk, but you notice his eyes barely leave Erica's backside. He is checking the young woman out as she walks away, tail wagging excitedly as he clearly likes what he sees.";
	if HP of Carl < 11: [regular Carl]
		say "     By the time you've walked over to Carl, Erica is through the bunker door and on her way down, leaving your resident soldier to turn to you. 'She's quite something, isn't she?' Carl says distractedly with a last glance at the door as it closes slowly on its own. It is clear that he doesn't really expect an answer, and he shakes off whatever thought was in his mind a second later, then turns his whole attention to you. 'Hey there, I wanted to ask you something. With you kinda being the landlord here, giving me a place to stay in all this chaos... would you be okay with it if I had some fun with... someone? Just hypothetically, you know. Don't worry, I don't plan to build a husky harem.'";
		LineBreak;
		say "     It is fairly clear who he's alluding to. What's your reply?";
		say "     ([link]Y[as]y[end link]) - Of course you're okay with it. It's not like you're a demanding overseer who wants to control every last thing that goes on in here.";
		say "     ([link]N[as]n[end link]) - Yes, actually. He really should focus on holding watch from his window above and keep his dick in his pants.";
		if player consents:
			LineBreak;
			say "     Giving a friendly punch to the muscular soldier's shoulder, you tell Carl that it's all fine by you. A bit of friendly fun-time will help keep everyone's spirits up. Still, he should watch out for anything that seems a bit 'too wild' - you don't want to lose anyone to the mental effects of the nanite infection. The anthro husky gives you a nod and a smile, then walks off towards the stairs to the upper level, his tail wagging behind him all the time. Seems like he's definitively looking forward to something now...";
			now CarlEricInteraction is 5;
		else:
			LineBreak;
			say "     Reaching out to give the muscular soldier's shoulder a firm squeeze, you put on a serious expression and tell him that he should focus on his duty. Some of the people in the city are hanging on to their humanity by the barest thread, and it'd be bad to have someone succumb right here in the library. It is easily visible how disappointed the man his - from his drooping tail and flopping-down ears to a little grimace on his muzzle, but he accepts your decision nonetheless. With a nod, he trots off towards the stairs and makes his way to the upper story of the library.";
			now CarlEricInteraction is 50;
	else if HP of Carl is 30: [subby Carl]
		say "     By the time you've walked over to Carl, Erica is through the bunker door and on his way down, leaving your resident soldier to turn to you. 'She's quite something, isn't she?' Carl says distractedly with a last glance at the door as it closes slowly on its own. Then a visible change goes through Carl as he remembers your status over him - lowering his head submissively, the anthro husky turns to you. 'Alpha, I wanted to ask you something. With you giving me a place to stay in all this chaos and being my pack-leader... would you be okay with it if I had some fun with... someone? Just hypothetically, you know.'";
		LineBreak;
		say "     It is fairly clear who he's eluding to. What's your reply?";
		say "     ([link]Y[as]y[end link]) - Of course you're okay with it. It's not like you're a demanding overseer who wants to control every last thing that goes on in here.";
		say "     ([link]N[as]n[end link]) - Yes, actually. He really should focus on holding watch from his window above and keep his dick in his pants.";
		if player consents:
			LineBreak;
			say "     Reaching out to raise Carl's muzzle so he can look you in the eye, you tell him it's all fine by you. A bit of friendly fun-time will help keep everyone's spirits up. Still, he should watch out for anything that seems a bit 'too wild' and remember his place. The anthro husky gives you a nod and a smile, then walks off towards the stairs to the upper level, his tail wagging behind him all the time. Seems like he's definitively looking forward to something now...";
			now CarlEricInteraction is 5;
		else:
			LineBreak;
			say "     Reaching out to raise Carl's muzzle so he can look you in the eye, you give a definite shake of your head and tell him to forget about it. You're his alpha, so it is his job to obey you - and you don't want him humping Erica right now. It is easily visible how disappointed the man his - from his drooping tail and flopping-down ears to a little grimace on his muzzle, but he accepts your decision nonetheless. With a nod, he trots off towards the stairs and makes his way to the upper story of the library.";
			now CarlEricInteraction is 50;
	else:
		say "     ERROR - Carl isn't in the state he should be in. Please report this on the FS forum and quote the HP of Carl: [HP of Carl]";
	now lastCarlEricInteraction is turns;

to say EricaCarlScene5:
	say "     Coming into the library, you see Carl and Erica sitting together on one of the bigger sofas, hanging out together. The canine soldier is just telling a story with some enthusiasm, loud enough for you to overhear, '...so there I was in the all night diner at 3 AM, and she was leaning forward over the table, showing off quite a rack. So when the question came what I wanted, I looked around the totally empty place and gave her a wink, asking for the house special. One of the hottest blowjobs I ever got.' Erica chuckles at the rapid wagging of Carl's tail, then nods to the soldier's crotch, where a quite obvious bulge is tenting out his pants. 'Must have been quite a waitress, if you're that boned up from just remembering her.' Carl gives a confirming grunt, then glances over at Erica and licks the side of his muzzle with his long tongue. 'You know, she was smoking hot - and we were right there at a glass-fronted diner, but... there's another reason for THIS,' Carl replies, rubbing a hand over his bulge. 'We've been trading naughty stories for a bit now, and... I can tell how wet you are.'";
	say "     Erica's eyes go wide and she opens her mouth as if to say something, but Carl just pushes ahead, leaning in towards his friend. You can see the husky's nostrils flare as he sniffs the air close to Erica and smiles. Then Carl says in a warm and charming voice, 'Don't worry, it's alright - you just gotta remember there's no hiding things from a canine. Makes things much easier, don't you think? I know you're horny, you know I am too, obviously. So... wanna show me just - how much - you like big dogs?' The anthro husky underlines his offer by getting a bit closer still, with the tip of his muzzle brushing against the side of Erica's neck lightly and him giving the young woman a friendly lick. The college athlete gives a little moan and runs her hand up to Carl's neck, burying her fingers in the husky's luxuriously thick fur as she pants out, 'Yes. I want it. Want you.'";
	LineBreak;
	say "     Looks like the two of them will get it on right there in the library. Do you want to watch?";
	if player consents:
		LineBreak;
		say "     Carl leans in a little and meets Erica's lips with his muzzle, exploring his partner's mouth with his long tongue as the young woman sucks on his questing appendage. The doggy kiss goes on for a long moment as they share breaths and spit, then eventually the two of them part again. Panting and looking into the other's eyes, both of them pick that moment to strip as fast as they possibly can, pulling shirts over their heads and flinging them aside, then kicking off the shorts covering their lower bodies. Carl stands up and moves in front of Erica, his reddish canine shaft standing at full mast as he lets his eyes wander over the young woman. 'You're sexy as hell Erica,' the anthro husky pants in a lust-filled tone as he leans over the college athlete, then presses against Erica's chest with a soft touch, pushing her to lean back against the sofa cushions. As the human readily follows his guidance, Carl wags his tail wildly while he kneels down and brings his canine head between Erica's legs.";
		say "     The gasping sound of indrawn breath echoes through the usually so quiet halls of the library - Erica being unable to hold back as Carl laps over her sex, the husky's broad tongue swiping over it in his repeated licks. Burying his nose in the female athlete's moist folds and breathing in deeply, Carl gives a somewhat muffled, 'You smell amazing, and taste even better!' With that, the canine soldier pushes his long tongue in between Erica's nether lips, wiggling it left and right in his friend's vagina. Meanwhile, Carl's hands aren't idle either, with one of them stroking Erica's sensitive skin up and down on the inside of her thighs and the other reaching up to cup the lithe student's breasts. Playfully squeezing her breasts and pinching Erica's nipples, he then traces his finger down over her abs to the human student's crotch. It doesn't take long before he has his index-finger resting against the little button of Erica's clit, massaging it with circling movements that make the red-headed athlete tremble in arousal and tightly grip the sofa cushions.";
		WaitLineBreak;
		say "     Stimulating Erica with his tongue and fingers, Carl gives the college student his fullest attention, tirelessly pushing her to greater and greater arousal. His skillful ministrations draw ever louder and more urgent moans and gasps from Erica and before much longer, the young woman shouts out in lust as she reaches a breathtaking orgasm. Throwing her head back, Erica trembles all over and bucks her hips - pushing right against Carl's open muzzle as the husky soldier continues going down on her, hungrily slurping up all the femcum that is just leaking from Erica's pussy. Still panting loudly for several moments before she catches her breath, Erica looks down at the kneeling soldier and eventually says, 'Wow, that was just... wow.' Carl replies with a beaming grin, wagging his tail like a storm as he playfully quips, 'Woof! Was Carl a good doggie, master? Arwooo!'";
		say "     The naked college student on the sofa gives a chuckle at his friend's tone and sits up a bit, sliding her rear to the edge of the seat as she leans forward. Reaching out, the young woman puts a hand on Carl's fur behind his neck, gently pulling him up. Erica joins in on Carl's act of being her pet and tells the anthro husky, 'Such a good boy. Nice dog!' Then their muzzle and mouth meet again, and the two of them make out with obvious enthusiasm, soon finding themselves sprawled on the sofa together. Their kisses and licks, tongue-wrestling and petting go on and on, until Carl eventually draws back a tiny bit, finding the breath to say in a naughty tone, 'Being such a good pet and all, may this doggie bury his bone in his mistress's - ehem - garden? He knows just the right spot under a decorative little bush...' Heads are turned to look down between the two of them, where the canine soldier's erect shaft is pressed against Erica's pubic mound.";
		WaitLineBreak;
		say "     After a few seconds of silence in which Erica bites her lower lip, a single word escapes her - 'Yes.' At the same time, she spreads her legs a little more, preparing for the muscular husky on top of her and raising her hands to stroke them along the flanks of the canine soldier. Carl gives her another very affectionate kiss - with lots of tongue action - then slides down a tiny bit to line his cock up with the young athlete's pussy. The tapering tip of his canine shaft slides in easily between the wet, slightly parted lips of Erica's feminine folds. Accompanied by a moan shared between two voices, the husky humps his hips forwards and enters Erica for the first time. ";
		if EricVirginityTaken is 0:
			say "Knowing that the young athlete is a virgin (from having had his tongue wiggling against her hymen not too long before), Carl pulls his first thrust a bit, letting his erection come to rest against the thin barrier inside. He looks into Erica's eyes, the obvious question in his gaze, and his partner gives a slightly fearful but yet also so very eager nod. Leaning down, the canine soldier plants deep kiss on her lips while thrusting into Erica's body and taking her virginity. Sinking himself into the athletic student's pussy until the bulge of his knot brushes Erica's nether lips, Carl licks the human's face and grunts, 'Thanks for letting me be your first. You feel really amazing to be in.'";
			now EricVirginityTaken is 4; [by Carl]
		else:
			say "Sinking himself into the athletic student's pussy until the bulge of his knot brushes Erica's nether lips, Carl licks the human's face and grunts, 'One sexy thing you are. Feels really amazing to be inside you.'";
		say "     Erica is basically speechless under Carl, far too busy moaning and gasping in the grasp of her feelings at getting fucked than to say anything intelligible. It is quite obvious though that the young woman really enjoys being taken by the husky soldier, as she wraps her legs tightly around Carl's hips, pulling him in tighter against her crotch with every thrust. The college athlete's arms are also on Carl's body, dug into the canine's thick fur and holding on to him as the muscled male bucks into his human partner. You slowly drift closer, watching the two of them hump against each other on the sofa, right in the middle of the public library. These really are quite... interesting times, in which sexy scenes like the mating of an anthro canine and a beautiful young woman are right on par with what's happening all over the city, every day of the week.";
		WaitLineBreak;
		say "     Carl and Erica fuck each other with quite a bit of enthusiasm, not even noticing you as they kiss and enjoy the other's body. Movements quicken and moans get louder and louder as their arousal mounts rapidly - reaching a new screamed high as the husky eventually forces his bulging knot in between Erica's pussy lips with a hard thrust. 'I'm all the way in you baby,' the soldier grunts in a lusty tone, lapping the side of Erica's neck right after. 'Y-yeah,' comes the somewhat breathless and clearly very satisfied reply from his college athlete partner. 'Feels so full - and warm,' Erica continues, then hugs Carl close and presses her face against the warm fur of the husky's shoulder. The muscled anthro on top of her replies in kind, putting his arms around Erica and getting a good grip - to make sure she isn't wrenched along as Carl pops his knot back out of the student's stretched pussy, pulling further and further back until just his tapered cock-tip is inside Erica. And then he hammers his whole manhood into the young woman, growling possessively as he bumps Erica's cervix and his knot throbs against the walls of her pussy.";
		say "     Losing himself in the urges of his canine self for a moment, Carl fucks Erica like a wild man - or wild beast, rather - humping against the teenager's crotch with unrelenting energy. Gripping Carl tightly with both hands buried in thick fur, the red-headed athlete under him is along for the ride in total ecstasy, trembling and moaning as she is taken hard. It doesn't take all that long before the mating culminates in a howled-out orgasm by Carl, bucking his hips slightly as rope after rope of his potent seed splashes into the lithe woman's [if EricVirginityTaken is 0]receptive[end if] womb. Meanwhile the husky's already quite large knot swells even further, creating a noticeable bulge under Erica's wet and dripping nether lips as it locks the two of them together. Balls-deep inside the lithe college athlete he just introduced to his doggie cock, Carl pants with open muzzle in rhythm to his balls sending forth another and another blast of cum. Then he suddenly finds his head pulled down a bit by Erica's hand as the young woman catches his hanging-out tongue with her lips, sucking on the floppy organ and sharing her breath with Carl.";
		WaitLineBreak;
		say "     Their sexy little bout of making out continues all the way throughout the husky's prolonged orgasm, with Carl continuing to breed his human partner for a good ten minutes, the knot ensuring that he stays inside his mate until the very last drop of cum is deposited inside Erica. Eventually, as the throbs of semen slowly ebb off, the intensity of their shared kisses does so too, until Carl and Erica are just lying on the sofa together, gazing into each other's eyes. The husky puts a hand on his special friend's chest, gently playing with her perky breasts. 'That was fun, don't you think?' he adds with a satisfied sigh a moment later, earning a chuckle from Erica. 'Quite a bit,' the college athlete replies happily, then rubs Carl behind the ears, making him hum with pleasure.";
		say "     After Carl informs his friend that their intimate coupling will last some more time - until his knot goes down far enough, that is - the two of them settle down to chat and joke around. It is kinda funny to see - two friends hanging out together, recounting stories and talking to one another... as if one of them wasn't stuck with his swollen cock in the slightly cum-bulging pussy of the other. No matter what else may be going on between them, it is more than obvious that Carl and Erica have grown into good friends, enjoying each other's company - sex or no sex. As the main show is over, you drift away unobtrusively, leaving them to spend some quiet time together, and clean up eventually.";
	else:
		say "     Turning away from them as the first clothes are being pulled off, you busy yourself somewhere else in the library. The moans, barks and general sounds of sex that reach your ears still make it quite obvious what's going on. Eventually things calm down again and you wander back towards the open area near the library entrance. What awaits you there is the sight of Erica and Carl entwined naked on one of the sofas. As you walk near, Carl informs the college athlete that their intimate coupling will last some more time - until his knot goes down far enough, that is - the two of them settle down to chat and joke around. It is kinda funny to see - two friends hanging out together, recounting stories and talking to one another... as if one of them wasn't stuck with his swollen cock in the slightly cum-bulging pussy of the other. No matter what else may be going on between them, it is more than obvious that Carl and Erica have grown into good friends, enjoying each other's company - sex or no sex. Not wanting to break up their mood, you step away unobtrusively, leaving them to spend some quiet time together, and clean up eventually.";
		if EricVirginityTaken is 0: [virgin]
			now EricVirginityTaken is 4; [by Carl]
	now CarlEricInteraction is 6;
	now lastCarlEricInteraction is turns;

to say EricaCarlScene6:
	let randomnumber be a random number from 1 to 3;
	if randomnumber is:
		-- 1:
			say "     Coming into the library, you see Carl and Erica together on one of the bigger sofas - both of them naked, and with Erica on all fours. The anthro husky kneels behind her, his canine erection in hand as he lines it up with Erica's nether lips and then slides into the female college student with a lusty grunt. 'Your pussy feels really great,' Carl huffs out as he pushes deeper, arms wrapping around Erica's chest as he laps at the young woman's left earlobe. 'As does your cock! Fuck me, doggie!' the college athlete under him replies with a playful laugh, reaching back with one arm to rub Carl's furred side. 'Woof! You asked for it...' comes another quick bark from the eager husky, then he humps his muscled body against Erica, driving the knot at the base of his shaft between Erica's feminine folds and popping inside with a shared gasp.";
			LineBreak;
			say "     Do you want to watch them go at it?";
			if player consents:
				LineBreak;
				say "     The husky and human couple proceed to fuck each other eagerly - and openly - filling the library with moans, barks, grunts and howls as they move against one another. It is almost impossible not to watch the sexy show of the lithe college student being topped by his canine friend. Yet as heated as their mating is, it doesn't take all that long before arousal builds beyond anything they are able to control. With a lust-filled bark, Carl grinds his crotch against Erica, holding on tight as his knot swells and locks them together, giving his furred balls all the time in the world to send forth a huge load of virile seed. The husky holds on to Erica tightly as he reaches his climax, giving somewhat possessive growls and licking the human's neck in eager affection. A moment later, while his cock still throbs with more and more cum being deposited into the young woman, Carl remembers to give his friend attention too and puts a paw-hand on Erica's crotch.";
				WaitLineBreak;
				say "     Stimulating the female athlete's sensitive button of a clit, Carl gets Erica to pant almost as much as he himself is, deep in the grip of sky-rocketing arousal. Then Erica suddenly bucks against his hand, giving a long moan as an orgasm crashes over her, drowning her in pleasure. Carl makes sure to keep going, rubbing the college athlete's female parts with steady circling movements and doing his best to prolong Erica's high as long as possible. The smile on his open muzzle makes it clear that he loves seeing his partner in ecstasy - as well as that Erica's inner muscles must be squeezing his dick in quite enjoyable ways as the lithe student trembles in completion. Then he suddenly finds his head pulled down a bit by Erica's hand as the young woman gives him a deep kiss. She even catches the canine soldier's hanging-out tongue with her lips, sucking on the floppy organ and sharing her breath with Carl.";
				say "     Their sexy little bout of making out continues all the way throughout the husky's prolonged orgasm, with Carl continuing to breed his human partner for a good ten minutes, the knot ensuring that he stays inside his mate until the very last drop of cum is deposited inside Erica. Eventually, as the throbs of semen slowly ebb off, the intensity of their shared kisses does so too, until Carl and Erica are just lying on the sofa together, gazing into each other's eyes. The husky puts a hand on his special friend's chest, gently playing with her perky breasts and stroking Erica. 'That was fun, don't you think?' he adds with a satisfied sigh a moment later, earning a chuckle from her. 'Quite a bit,' the college athlete replies happily, then rubs Carl behind the ears, making him hum with pleasure.";
				WaitLineBreak;
				say "     After Carl informs his friend that their intimate coupling will last some more time - until his knot goes down far enough, that is - the two of them settle down to chat and joke around. It is kinda funny to see - two friends hanging out together, recounting stories and talking to one another... as if one of them wasn't stuck with his swollen cock in the slightly cum-bulging pussy of the other. No matter what else may be going on between them, it is more than obvious that Carl and Erica have grown into good friends, enjoying each other's company - sex or no sex. As the main show is over, you drift away unobtrusively, leaving them to spend some quiet time together, and clean up eventually.";
			else:
				say "     You casually turn away from the scene and busy yourself with other things, trying to ignore the sexual noises the two of them make.";
		-- 2:
			say "     Coming into the library, you see Carl and Erica together on one of the bigger sofas - both of them naked, and with Erica straddling the husky soldier's chest, looking towards her friend's crotch. The anthro husky's muzzle is between her legs, with his wet nose pressed against Erica's nether lips and his long canine tongue licking the young woman. 'Love the taste of your pussy,' the anthro husky says in a somewhat muffled tone, then pokes his tongue in between Erica's slightly parted folds, exploring the college athlete's insides. Meanwhile, Erica gasps in pleasure and leans forward, bracing herself on Carl's hips and then letting her hands wander to the canine's bulgy cock, fully hard and erect outside its furry sheath. Taking hold of the reddish member, Erica strokes her friend first slowly, then with increasing speed and enthusiasm, eventually even leaning forward to suck its pointy tip. While she slurps Carl's pre-cum, the husky eats her pussy expertly, winding the two of them up in mutual pleasure.";
			LineBreak;
			say "     Do you want to watch them go at it?";
			if player consents:
				LineBreak;
				say "     Eventually, Erica pulls off the cock in her mouth with a little pop, then clears her throat and looks back over her shoulder. 'Carl?' she asks hesitantly, making the husky raise his muzzle from between her legs, looking up at the shy teenager and replying in a friendly tone, 'What's up?' Erica blushes just a little bit, then slowly says, 'I - I think I want to... fuck now. Ride your cock. Is that okay?' Carl gives out a little laugh at his friend's shyness, despite them having already fucked and now spent some time in a very pleasurable 69, then he strokes the outsides of Erica's thighs and answers, 'Of course it is. I'm all yours babe. You can ride me like a rodeo bull if you want.' With that said, Carl buries his muzzle back between Erica's legs, giving her a very enthusiastic tongue-lashing before the young woman hesitantly climbs off him and gets into position for straddling the husky's crotch.";
				WaitLineBreak;
				say "     Looking down at Carl - who gives her a supporting nod while thumping the sofa with his excitedly wagging tail - Erica smiles shyly, then reaches down to take hold of the large canine erection she sucked off till just a moment ago. The red-skinned shaft glistens with the young athlete's spit as she lines it up with her own nether lips. Then she lowers herself, holding her breath as her nether lips sink down over the erection's tip and it nudges her folds apart, sliding into Erica's body. The lithe student lets out a happy sigh as she feels the familiar cock inside her, then lowers herself further, taking more and more till eventually, just the knot at the base is outside, resting against her opening. 'Your pussy feels really great,' Carl huffs out as he gives a little hump of his hips, grinding against Erica's crotch. The soldier's strong arms reach up to wrap around his friend's body, pulling her in for a squeeze and lapping at her left earlobe in deep affection. 'As does your cock! This feels amazing, doggie!' the college athlete under him replies with a playful laugh, reaching back with one arm to rub Carl's furred side. 'Woof! Wait till you have it all in...' comes another quick bark from the eager husky, then he humps his muscled body up against Erica, driving the knot at the base of his shaft between Erica's feminine folds and popping inside with a shared gasp.";
				say "     The husky and human couple proceed to fuck each other eagerly - and openly - filling the library with moans, barks, grunts and howls as they move against one another. It is almost impossible not to watch the sexy show of the lithe college student riding the pointy shaft of her canine friend. Yet as heated as their mating is, it doesn't take all that long before arousal builds beyond anything they are able to control. With a lust-filled bark, Carl grinds his crotch against Erica, holding on tight as his knot swells and locks them together, giving his furred balls all the time in the world to send forth a huge load of virile seed. The husky holds on to Erica tightly as he reaches his climax, giving somewhat possessive growls and licking the human's face in eager affection. A moment later, while his cock still throbs with more and more cum being deposited into the young woman, Carl remembers to give his friend attention too and puts a paw-hand on Erica's crotch.";
				WaitLineBreak;
				say "     Stimulating the female athlete's sensitive button of a clit, Carl gets Erica to pant almost as much as he himself is, deep in the grip of sky-rocketing arousal. Then Erica suddenly bucks against his hand, giving a long moan as an orgasm crashes over her, drowning her in pleasure. Carl makes sure to keep going, rubbing the college athlete's female parts with steady circling movements and doing his best to prolong Erica's high as long as possible. The smile on his open muzzle makes it clear that he loves seeing his partner in ecstasy - as well as that Erica's inner muscles must be squeezing his dick in quite enjoyable ways as the college athlete trembles in completion. Then he suddenly finds his head pulled up a bit by Erica's hand as the young woman gives him a deep kiss. She even catches the canine soldier's hanging-out tongue with her lips, sucking on the floppy organ and sharing her breath with Carl.";
				say "     Their sexy little bout of making out continues all the way throughout the husky's prolonged orgasm, with Carl continuing to breed his human partner for a good ten minutes, the knot ensuring that he stays inside his mate until the very last drop of cum is deposited inside Erica. Eventually, as the throbs of semen slowly ebb off, the intensity of their shared kisses does so too, until Carl and Erica are just lying on the sofa together, Erica lying on top of the furred canine as they gaze into each other's eyes. The husky puts a hand on his special friend's chest, gently playing with her breasts and stroking Erica. 'That was fun, don't you think?' he adds with a satisfied sigh a moment later, earning a chuckle from Erica. 'Quite a bit,' the college athlete replies happily, then rubs Carl behind the ears, making him hum with pleasure.";
				WaitLineBreak;
				say "     After Carl informs his friend that their intimate coupling will last some more time - until his knot goes down far enough, that is - the two of them settle down to chat and joke around. It is kinda funny to see - two friends hanging out together, recounting stories and talking to one another... as if one of them wasn't stuck with his swollen cock in the slightly cum-bulging pussy of the other. No matter what else may be going on between them, it is more than obvious that Carl and Erica have grown into good friends, enjoying each other's company - sex or no sex. As the main show is over, you drift away unobtrusively, leaving them to spend some quiet time together, and clean up eventually.";
			else:
				say "     You casually turn away from the scene and busy yourself with other things, trying to ignore the sexual noises the two of them make.";
		-- 3:
			say "     Coming into the library, you're just in time to hear an aroused groan echo in the main room. A quick look around reveals that it came from Carl, who is having quite a good time apparently. The canine soldier lies on his back, sprawled out on one of the bigger sofas further back in the library, gripping the upholstery tightly with both hands as someone is going down on his cock. The backrest of the sofa blocks your view at who that might be at first, but as you casually stroll closer a flash of red hair comes into view, bobbing up and down. Ah, looks like Erica is having fun with her anthro friend!";
			say "     Erica is certainly busy with sucking dick and Carl hasn't seen you yet either - his head is lolling around just over the edge of the sofa, panting in lust and with his eyes closed. [bold type]You might just leave the two of them to have fun on their own ([link]Y[as]y[end link]) - or do you want to step up and have a closer look ([link]N[as]n[end link])?[roman type][line break]";
			if player consents: [don't watch]
				LineBreak;
				say "     With a smile on your lips about the transformed soldier and female teen having become such good friends - very much with benefits too - you stroll back towards the reception desk of the library. The sounds of slurping, moans and pants that fill the library over the next little while eventually culminate in a series of louder grunts, followed by the murmur of friendly banter between the two of them.";
			else: [watch]
				LineBreak;
				say "     Moving closer and around, you finally get a good view of both of them - not only Carl lying lengthwise on the sofa at its end but also Erica, who is on all fours between the husky's legs. Just like the soldier, Erica is completely naked with his clothes and running shoes in a small pile on the ground. The rear end of his lithe form is raised high as he has his head down over Carl's crotch, as well as his lips wrapped around the husky's erect shaft. Bobbing up and down quickly, Erica is eagerly giving his fuck-buddy a blowjob.";
				say "     [bold type]Do you just want to watch ([link]Y[as]y[end link]) or would you like to participate yourself ([link]N[as]n[end link])?[roman type][line break]";
				if player consents: [watch the Erica on Carl BJ and Carl transferring his cum into Erica]
					LineBreak;
					say "     Quietly taking up a position behind a nearby bookshelf that promises full view of things going on, you're just in time before Carl raises his head and looks at Erica with a huge grin on his face. 'Yeah baby! Lick that head some more,' he pants loudly, prompting the red-headed student to pull off his shaft and reply teasingly, 'You mean like this?' That said, she slowly runs her tongue up the underside of Carl's erection until soon reaching its pointy head, then circles Carl's glans with the tip of her tongue. 'Nnnnghh!' the anthro canine grunts in clear arousal and puts a hand on his friend's head, affectionately tousling her hair a little before pulling Erica back down on his cock - taking all of it down to the base.";
					say "     The two of them continue to fill the library with moans and grunts, mostly from Carl as there is little time that Erica's lips aren't wrapped around the husky's pole of man-meat, giving you an amazing show of a horny husky and human having fun. Soon, Carl basically pants nonstop with his long tongue hanging out - a clear sign of the canine running hot. 'Getting real close now baby,' the canine soldier barks out moments later, tapping Erica's shoulder with some urgency - and the pale-skinned student pulls her head back barely in time, lips stretching wide around Carl's rapidly swelling knot, then pulls off the bulge with a loud pop.";
					WaitLineBreak;
					say "     Panting a little as she looks upon Carl's erection and watches the knot reach its full size in seconds, Erica's eyes go wide as the first blast of canine cum erupts from the pointy cockhead and hits her. With her forehead and red hair now marked by a white streak, the female student quickly reacts by plunging her mouth back down towards Carl's twitching manhood. The next spurt shoots out right as she is starting to open wide and paints Erica's lips and tongue with creamy cum. After that, the athletic student is back to sucking on the canine dick of her fuck-buddy - catching further eruptions of canine seed with her mouth while jerking Carl with one hand.";
					say "     The muscular soldier bucks on the sofa and reflexively thrusts his hips up towards Erica as he orgasms, grunting loudly with each new shot until he eventually sinks back in exhaustion. 'Phew,' he pants after a few moments of just lying there in post-orgasmic bliss. 'That was something else! You're getting good at this,' Carl says after raising his head to look at Erica - who still is gently suckling at his cockhead. The soldier smiles broadly as their eyes meet, then he hooks a hand behind Erica's neck and sits up, guiding the lithe teen into making out. Tail wagging in a rapid beat against the sofa (now that he's no longer lying on top of it), Carl slips Erica his tongue in a deep French kiss. As they eventually pull apart, strings of frothy cum stretch between their lips for a second. Looks like the husky slurped quite a bit of his own cum from Erica's mouth.";
					WaitLineBreak;
					say "     'Payback time,' Carl says with a grin in a bit of a mumble (from having a load of cum in his mouth), then executes what could almost be a wrestling move - getting his legs under him and bowling Erica over on the sofa to fall back on the soft upholstery. In a quick follow-up move, the canine soldier gets a grip on his human friend's legs and hikes them up over his own furred shoulders. This leaves Erica in almost a headstand, with Carl's muzzle just inches from her crotch. Brushing his nose against the glisteningly wet folds of Erica's feminine sex, the husky takes a deep huff of air and lets out an aroused rumble from deep in his throat. 'Fucking sexy,' he compliments Erica out of mostly closed lips, then uses his fingers to part the college athlete's nether lips.";
					say "     Carl rubs his wet nose against the opening of Erica's even wetter pussy, reveling in the scent of his sexy friend, then opens his muzzle. As the anthro canine sticks his long tongue into the young woman's vagina, the frothy mixture of cum and spit he held in his mouth slides down over the twitching muscle and right into Erica's depths, who moans loudly at the treatment her friend is giving her. 'You like that, don't you?' the soldier teases his friend, then uses a finger to stroke over Erica's clit just as she opens her mouth, making her reply nothing more but a drawn-out moan.";
					WaitLineBreak;
					say "     Inserting two fingers into the lithe teen's pussy, Carl continues to push his cum deeper into Erica, all the while keeping his thumb on the human student's clit and rubbing it with circling movements. The sensations of being touched in this way drive Erica wild and she begins panting faster and faster, letting out moans in rising urgency. When Carl then switches to not only fingering but also lapping at Erica's clit with his tongue, this drives the athletic student over the edge. She orgasms with a climactic shout, legs twitching as they cross over Carl's back and pull the husky even tighter against his friend's crotch. Of course, Carl knows Erica quite well by now and is prepared for that - he just keeps lapping at his friend's crotch and slurps up the femcum that starts to leak from her folds.";
					say "     Eventually sliding Erica's legs from over his shoulders and allowing the young student to stretch out fully on the sofa, Carl straightens up and looks down at his naked friend. A broad smile is on his face as he feasts his eyes on the lithe teenager, his tail wagging up a storm at the same time. 'Rrr-woof! Was Carl a good doggie?' the soldier asks in a playful tone as he lowers himself into a push-up position on top of Erica, lapping at her sweaty chest and perky breasts to work his way up to coming face to face with Erica. 'You're definitively taking the 'man's best friend' bit to new levels Carl,' comes a happy reply, together with Erica running her hand through the thick fur on the anthro husky's neck and pulling him into another bout of making out.";
					LineBreak;
					say "     As the main action seems to be over now, you quietly move away from your spot and leave the two of them to lie on the sofa together. From the snippet of conversation you catch as you walk off, they start to talk about their favorite songs next. The effortless switch to typical talk between friends after having just gotten their rocks off with each other puts a smile on your face. Erica and Carl are definitively an interesting pair - seems like something just clicked between the two after meeting not so long ago.";
				else: [join in]
					LineBreak;
					say "     As you walk up to the human-husky couple and softly clear your throat, Erica pushes herself up from Carl's crotch in an eye-blink, creating a loud pop as she pulls her lips off the erect canine shaft she was sucking. The college athlete flushes in embarrassment almost instantly - her pale skin becoming bright red in the face as she opens and closes her mouth in shock. 'Uhm... I... we were... just... eh...' Erica stammers, then Carl pushes himself up on his elbows and takes over, 'She was just giving me an amazingly good blowjob. No reason to be ashamed of it, baby.' Gulping visibly, Erica looks at the husky, then over to you and back at Carl again as the soldier puts a paw-hand on her shoulder, gently stroking her.";
					say "     'Yes, but... uhm...' Erica starts to say, only to fall silent as she is engaged in a French kiss by her canine fuck-buddy, ending in Carl looking deep into her eyes and saying, 'Shhh... it's okay. We're all friends here.' Rubbing his muzzle against the side of Erica's neck and licking her, the muscled soldier then nods towards you, 'And I think I know why [if player is female]she[else]he[end if] came over right now. You wanna take part, don't you?' As you grin and nod, Erica's eyes go wide, then a happy smile starts spreading over her still a bit flushed cheeks.";
					WaitLineBreak;
					say "[EricaCarlThreesome Sex Menu]";
	if CarlEricInteraction < 6:
		now CarlEricInteraction is 6;
	now lastCarlEricInteraction is turns;

to say EricaCarlThreesome Sex Menu:
	LineBreak;
	say "What exactly do you want to do with the two of them?";
	now sextablerun is 0;
	blank out the whole of table of fucking options;
	[]
	if player is male:
		choose a blank row in table of fucking options;
		now title entry is "Fuck Erica's pussy from behind while she sucks Carl";
		now sortorder entry is 1;
		now description entry is "Go doggy style on the college athlete";
	[]
	if player is male:
		choose a blank row in table of fucking options;
		now title entry is "Fuck Erica's ass from behind while she sucks Carl";
		now sortorder entry is 2;
		now description entry is "Go doggy style on the college athlete";
	[]
	if player is male:
		choose a blank row in table of fucking options;
		now title entry is "Fuck Carl's muzzle while Erica blows his cock";
		now sortorder entry is 3;
		now description entry is "Make it a face-fuck chain";
	[]
	if player is male:
		choose a blank row in table of fucking options;
		now title entry is "Fuck Carl's ass while he eats Erica's pussy";
		now sortorder entry is 4;
		now description entry is "Go doggy style on the husky";
	[]
	if player is male:
		choose a blank row in table of fucking options;
		now title entry is "Get a blowjob from Carl while he hammers Erica's pussy";
		now sortorder entry is 5;
		now description entry is "Let Carl blow you";
	[]
	if player is male:
		choose a blank row in table of fucking options;
		now title entry is "Get a blowjob from Erica while she straddles Carl's face";
		now sortorder entry is 6;
		now description entry is "Let Erica blow you";
	[]
	if player is female:
		choose a blank row in table of fucking options;
		now title entry is "Grind your pussy against Carl's muzzle while Erica blows him";
		now sortorder entry is 7;
		now description entry is "Make it a face-fuck chain";
	[
	choose a blank row in table of fucking options;
	now title entry is "Ride Carl's cock while his face is straddled by Erica";
	now sortorder entry is 8;
	now description entry is "Double-team Carl on both ends";
	]
	sort the table of fucking options in sortorder order;
	repeat with y running from 1 to number of filled rows in table of fucking options:
		choose row y from the table of fucking options;
		say "[link][y] - [title entry][as][y][end link][line break]";
	say "[link]0 - Nevermind[as]0[end link][line break]";
	while sextablerun is 0:
		say "Pick the corresponding number> [run paragraph on]";
		get a number;
		if calcnumber > 0 and calcnumber <= the number of filled rows in table of fucking options:
			now current menu selection is calcnumber;
			choose row calcnumber in table of fucking options;
			say "[title entry]: [description entry]?";
			if player consents:
				let nam be title entry;
				now sextablerun is 1;
				if (nam is "Fuck Erica's pussy from behind while she sucks Carl"):
					say "[EricaCarlThreesome1]";
				if (nam is "Fuck Erica's ass from behind while she sucks Carl"):
					say "[EricaCarlThreesome2]";
				if (nam is "Fuck Carl's muzzle while Erica blows his cock"):
					say "[EricaCarlThreesome3]";
				if (nam is "Fuck Carl's ass while he eats Erica's pussy"):
					say "[EricaCarlThreesome4]";
				if (nam is "Get a blowjob from Carl while he hammers Erica's pussy"):
					say "[EricaCarlThreesome5]";
				if (nam is "Get a blowjob from Erica while she straddles Carl's face"):
					say "[EricaCarlThreesome6]";
				if (nam is "Grind your pussy against Carl's muzzle while Erica blows him"):
					say "[EricaCarlThreesome7]";
				if (nam is "Ride Carl's cock while his face is straddled by Erica"):
					say "[EricaCarlThreesome8]";
				wait for any key;
		else if calcnumber is 0:
			say "Break off the conversation?";
			if player consents:
				now sextablerun is 1;
				say "     You step back from the two of them, saying that you just remembered something important you absolutely have to do. They give you questioning looks, then shrug and look at each other. As you hurry off, the two of them start making out, apparently determined to have fun with or without you.";
				wait for any key;
			else:
				say "Pick between 1 and [the number of filled rows in the table of fucking options] or 0 to exit.";
		else:
			say "Invalid Option. Pick between 1 and [the number of filled rows in the table of fucking options].";
	clear the screen and hyperlink list;

to say EricaCarlThreesome1: [fuck Erica's pussy while she blows Carl]
	say "     Both the husky and human share eager looks as you tell them what you want to do, then quickly take their positions - Carl stretched out lengthwise on his back, with Erica on all fours between his legs. The canine soldier pushes his upper body up on his elbows and gives Erica a huge grin. 'Yeah baby! Lick that head good,' he pants in an aroused tone, prompting the red-headed student to bring her face close over his crotch and reply teasingly, 'You mean like this?' That said, Erica slowly runs her tongue up the underside of Carl's erection until soon reaching its pointy head, then circles Carl's glans with the tip of her tongue. 'Nnnnghh!' the anthro canine grunts in clear arousal and puts a hand on his friend's head, affectionately tousling her hair a little before pulling Erica down to engulf his cock - taking all of it down to the base.";
	say "     While the two of them start to fill the library with moans and grunts, you yourself get into position behind Erica - your erect cock leading the way. Kneeling behind the athletic woman, you stroke the [cock of player] shaft dangling between your legs and check out the sexy slit Erica is presenting for you in that pose. Reaching out to stroke over her nether lips, you find them wet and easily stretching around your fingers as you push them inside slowly. Yeah, she's so ready to be fucked! With a grin over to Carl as he is getting a nice blowjob, you line yourself up a moment later, then sink yourself into the young woman's depths. Erica hums pleasedly around the canine shaft in her mouth and rocks slightly back to meet your first deep thrust - making your crotch smack her ass as you bottom out.";
	WaitLineBreak;
	say "     The three of you fill the library with aroused moans, grunts and even barks as Erica gets dicked from two ends. Sawing your [cock of player] rod in and out of her tight pussy, you revel in the fact that the lithe student trembles in pleasure from being fucked and even gasps out things like, 'Fuck me. Fuck my pussy. Harder!', as she takes a breather or two from sucking dick. Meanwhile, Carl has his head thrown back and is giving an aroused and somewhat breathless commentary on how good Erica's mouth feels on his dick. Soon, the husky basically pants nonstop with his long tongue hanging out - a clear sign that he's becoming more and more wound up by the oral stimulation. 'Getting real close now baby,' the canine soldier barks out a few moments later, tapping Erica's shoulder with some urgency - and the pale-skinned student pulls her head back barely in time, lips stretching wide around Carl's rapidly swelling knot, then pulls off the bulge with a loud pop.";
	say "     Moaning loudly as her backwards movement makes Erica's pussy take your newest thrust with additional force, the young student's eyes are drawn to Carl's erection - watching its knot reach its full size in a few heartbeats. Then Erica's eyes go wide as the first blast of canine cum erupts from the pointy cockhead and hits her. With her forehead and red hair now marked by a white streak, the female student quickly reacts by plunging her mouth back down towards Carl's twitching manhood. The next spurt shoots out right as she is starting to open wide and paints Erica's lips and tongue with creamy cum. After that, the athletic student is back to sucking on the canine dick of her fuck-buddy - catching further eruptions of canine seed with her mouth while jerking Carl with one hand.";
	WaitLineBreak;
	say "     With Erica rocking back and forth on your thrusting shaft and her inner muscles flexing around your erection, you're getting quite close to coming yourself. With a lusty growl, you pull out of her most of the way, then hammer your dick back in, shouting in orgasmic release as you start filling her with your seed. Throb after throb, cum erupts into her depths, giving the college athlete a pleasantly full feeling. On Erica's other end, Carl bucks on the sofa and reflexively thrusts his hips upwards as he orgasms, grunting loudly with each new shot until he eventually sinks back in exhaustion. 'Phew,' he pants after a few moments of just lying there in post-orgasmic bliss. 'That was something else! You're getting good at this,' Carl says after raising his head to look at Erica - who still is gently suckling at his cockhead.";
	say "     The soldier smiles broadly as their eyes meet, then he hooks a hand behind Erica's neck and sits up, guiding the attractive teen into making out. Tail wagging in a rapid beat against the sofa (now that he's no longer lying on top of it), Carl slips Erica his tongue in a deep French kiss. As they eventually pull apart, strings of frothy cum stretch between their lips for a second. Looks like the husky slurped quite a bit of his own cum from Erica's mouth. Your own orgasm ebbed out with just a few more small spurts of cum while you were watching their antics, so you gently pull back from the lithe human's rear. As your softening prick slips from her pussy, you're pleased to see that none of your cum leaks out with it - you've planted it good and deep inside Erica's womb.";
	WaitLineBreak;
	say "     'Payback time,' Carl says with a grin in a bit of a mumble (from having a load of cum in his mouth), then executes what could almost be a wrestling move - getting his legs under him and pulling Erica up in his arms, then flipping her around to land on the sofa in a headstand, with her legs hooked over Carl's shoulders. This puts Carl's muzzle just inches from the young student's crotch. Brushing his nose against the glisteningly wet folds of Erica's feminine sex, the husky takes a deep huff of air and lets out an aroused rumble from deep in his throat. 'Fucking sexy,' he compliments Erica out of mostly closed lips, then uses his fingers to part the college athlete's nether lips.";
	say "     Carl rubs his wet nose against the opening of Erica's even wetter pussy, reveling in the scent of his sexy friend mixed with your own, then opens his muzzle. As the anthro canine sticks his long tongue into the young woman's vagina, the frothy mixture of cum and spit he held in his mouth slides down over the twitching muscle and right into Erica's depths, who moans loudly at the treatment her friend is giving her. 'You like that, don't you?' the soldier teases his friend, then uses a finger to stroke over Erica's clit just as she opens her mouth, making her reply nothing more but a drawn-out moan.";
	WaitLineBreak;
	say "     Inserting two fingers into the teenager's pussy, Carl continues to push his cum deeper into Erica to mingle with your own deposit, all the while keeping his thumb on the human student's clit and rubbing it with circling movements. The sensations of being touched in this way drive Erica wild and she begins panting faster and faster, letting out moans in rising urgency. When Carl then switches to not only fingering but also lapping at Erica's clit with his tongue, this drives the athletic student over the edge. She orgasms with a climactic shout, legs twitching as they cross over Carl's back and pull the husky even tighter against his friend's crotch. Of course, Carl knows Erica quite well by now and is prepared for that - he just keeps lapping at his friend's crotch and slurps up the femcum that starts to leak from her folds.";
	say "     Eventually sliding Erica's legs from over his shoulders and allowing the young student to stretch out fully on the sofa, Carl straightens up and looks down at his naked friend. A broad smile is on his face as he feasts his eyes on the lithe teenager, his tail wagging up a storm at the same time. 'Rrr-woof! Was Carl a good doggie?' the soldier asks in a playful tone as he looks over to you, getting a grin and thumbs-up in reply. Then Carl lowers himself into a push-up position on top of Erica, lapping at her sweaty chest and perky breasts to work his way up to coming face to face with Erica. 'You're definitively taking the 'man's best friend' bit to new levels Carl,' comes a happy comment, together with Erica running a hand through the thick fur on the anthro husky's neck and pulling him into another bout of making out.";
	LineBreak;
	say "     Worn out from fucking Erica, you bid your two friends farewell for now and grab your gear to clean up and get dressed afterwards. As you move away from the site of your steamy threesome, the two of them stay lying on the sofa together. From a snippet of conversation you catch as you walk off, they start to talk about their favorite songs next. The effortless switch to typical banter between friends after having just gotten their rocks off with each other puts a smile on your face. Erica and Carl are definitively an interesting pair - seems like something just clicked between the two of them after meeting not so long ago.";

to say EricaCarlThreesome2: [fuck Erica's ass while he blows Carl]
	say "     Both the husky and human share eager looks as you tell them what you want to do, then quickly take their positions - Carl stretched out lengthwise on his back, with Erica on all fours between his legs. The canine soldier pushes his upper body up on his elbows and gives Erica a huge grin. 'Yeah baby! Lick that head good,' he pants in an aroused tone, prompting the red-headed student to bring her face close over his crotch and reply teasingly, 'You mean like this?' That said, Erica slowly runs her tongue up the underside of Carl's erection until soon reaching its pointy head, then circles Carl's glans with the tip of her tongue. 'Nnnnghh!' the anthro canine grunts in clear arousal and puts a hand on his friend's head, affectionately tousling her hair a little before pulling Erica down to engulf his cock - taking all of it down to the base.";
	say "     While the two of them start to fill the library with moans and grunts, you yourself get into position behind Erica - your erect cock leading the way. Kneeling behind the attractive teen, you stroke the [cock of player] shaft dangling between your legs and check out the compact little ass Erica is raising so well for you in that pose. Reaching out to stroke over her rosy buttocks, you find them smooth and warm to the touch, with a tight pucker right between. Gently stroking over it makes Erica tense for a moment, then relax visibly as she opens herself up to being touched there. Slowly pressing the tip of your index finger against her rear entrance, you feel her muscle push back against you - Erica is trying to make penetrating her easier for both of you.";
	WaitLineBreak;
	say "     All that you're missing now is some lube... but not for long, as you quickly slide your hand between her legs, seeking out her dripping wet snatch. After burying two fingers between her nether lips and thrusting in and out a few times, you bring your slick digits back to the college athlete's pucker. Going slow at first, you penetrate the expectantly tight asshole of the slender human and feel around searchingly. It is quite obvious when you find Erica's prostate - she almost chokes on Carl's cock as you rub it, having to pull off in a hurry to let out a loud moan. 'Ooooh yes! That feels so good!' Erica groans as she rests her head against Carl's crotch, nose pressing into soft fur and with the canine's erection hotly against her cheek. She keeps panting and moaning like a bitch in heat while you finger her ass for a good long while, getting her ready for the real thing.";
	say "     Finally removing your fingers from Erica's ass, you smile at the enticing sight of her pink hole gaping open for a second, then pulling tight and opening again as searching for the digits that gave her such pleasure. 'More please,' Erica groans in a pleading tone and raises her butt a little more, then adds, 'Put [']em back in, I feel so empty!' You can't help but smile broadly at the perfect invitation from this cute redhead and line your erect shaft up with her ass. After another quick brush over her pussy to get more feminine juices and slicking up your cock, you press in against her pucker, stretching its readily expanding ring around your piece of man-meat. With a grin over to Carl as he strokes himself at the sight, you then sink yourself into the young athlete's depths. Erica hums pleasedly into Carl's fur and rocks slightly back to meet your first deep thrust - making your crotch smack her ass hard as you bottom out.";
	WaitLineBreak;
	say "     As you take on a steady rhythm of sawing in and out of Erica's tight ass, Carl gently lifts the lithe student's head and guides her back to nuzzling the tip of his shaft. Readily accepting the hint, the eager college girl slides her lips over Carl's manhood, slurping on it with obvious pleasure. The three of you fill the library with aroused moans, grunts and even barks as Erica gets dicked from two ends. As you bottom out in her again and again, you revel in the fact that the teenager trembles in pleasure from being fucked and even gasps out things like, 'Fuck me. Fuck my ass. Harder!', as she takes a breather or two from sucking dick. Meanwhile, Carl has his head thrown back and is giving an aroused and somewhat breathless commentary on how good Erica's mouth feels on his dick. Soon, the husky basically pants nonstop with his long tongue hanging out - a clear sign that he's becoming more and more wound up by the oral stimulation. 'Getting real close now baby,' the canine soldier barks out a few moments later, tapping Erica's shoulder with some urgency - and the pale-skinned student pulls her head back barely in time, lips stretching wide around Carl's rapidly swelling knot, then pulls off the bulge with a loud pop.";
	say "     Moaning loudly as her backwards movement makes Erica's rump meet your newest thrust with additional force, the young student's eyes are drawn to Carl's erection - watching its knot reach its full size in a few heartbeats. Then Erica's eyes go wide as the first blast of canine cum erupts from the pointy cockhead and hits her. With her forehead and red hair now marked by a white streak, the red-headed student quickly reacts by plunging her mouth back down towards Carl's twitching manhood. The next spurt shoots out right as she is starting to open wide and paints Erica's lips and tongue with creamy cum. After that, the athletic student is back to sucking on the canine dick of her fuck-buddy - catching further eruptions of canine seed with her mouth while jerking Carl with one hand.";
	WaitLineBreak;
	say "     With Erica rocking back and forth on your thrusting shaft and her inner muscles flexing around your erection, you're getting quite close to coming yourself. With a lusty growl, you pull out of her most of the way, then hammer your dick back in, shouting in orgasmic release as you start filling her with your seed. Throb after throb, cum erupts into her depths, giving the college athlete a pleasantly full feeling. On Erica's other end, Carl bucks on the sofa and reflexively thrusts his hips upwards as he orgasms, grunting loudly with each new shot until he eventually sinks back in exhaustion. 'Phew,' he pants after a few moments of just lying there in post-orgasmic bliss. 'That was something else! You're getting good at this,' Carl says after raising his head to look at Erica - who still is gently suckling at his cockhead.";
	say "     The soldier smiles broadly as their eyes meet, then he hooks a hand behind Erica's neck and sits up, guiding the attractive teen into making out. Tail wagging in a rapid beat against the sofa (now that he's no longer lying on top of it), Carl slips Erica his tongue in a deep French kiss. As they eventually pull apart, strings of frothy cum stretch between their lips for a second. Looks like the husky slurped quite a bit of his own cum from Erica's mouth. Your own orgasm ebbed out with just a few more small spurts of cum while you were watching their antics, so you gently pull back from the lithe human's rear. As your softening prick slips from her pucker, you're pleased to see that none of your cum leaks out before her muscle irises shut - you've planted it good and deep inside Erica's back passage.";
	WaitLineBreak;
	say "     'Payback time,' Carl says with a grin in a bit of a mumble (from having a load of cum in his mouth), then executes what could almost be a wrestling move - getting his legs under him and pulling Erica up in his arms, then flipping her around to land on the sofa in a headstand, with her legs hooked over Carl's shoulders. This puts Carl's muzzle just inches from the young student's crotch. Brushing his nose against the glisteningly wet folds of Erica's feminine sex, the husky takes a deep huff of air and lets out an aroused rumble from deep in his throat. 'Fucking sexy,' he compliments Erica out of mostly closed lips, then uses his fingers to part the college athlete's nether lips.";
	say "     Carl rubs his wet nose against the opening of Erica's even wetter pussy, reveling in the scent of his sexy friend mixed with your own, then opens his muzzle. As the anthro canine sticks his long tongue into the young woman's vagina, the frothy mixture of cum and spit he held in his mouth slides down over the twitching muscle and right into Erica's depths, who moans loudly at the treatment her friend is giving her. 'You like that, don't you?' the soldier teases his friend, then uses a finger to stroke over Erica's clit just as she opens her mouth, making her reply nothing more but a drawn-out moan.";
	WaitLineBreak;
	say "     Inserting two fingers into the teenager's pussy, Carl continues to push his cum deeper into Erica to make sure she's well-filled in both holes, all the while keeping his thumb on the human student's clit and rubbing it with circling movements. The sensations of being touched in this way drive Erica wild and she begins panting faster and faster, letting out moans in rising urgency. When Carl then switches to not only fingering but also lapping at Erica's clit with his tongue, this drives the athletic student over the edge. She orgasms with a climactic shout, legs twitching as they cross over Carl's back and pull the husky even tighter against his friend's crotch. Of course, Carl knows Erica quite well by now and is prepared for that - he just keeps lapping at his friend's crotch and slurps up the femcum that starts to leak from her folds.";
	say "     Eventually sliding Erica's legs from over his shoulders and allowing the young student to stretch out fully on the sofa, Carl straightens up and looks down at his naked friend. A broad smile is on his face as he feasts his eyes on the lithe teenager, his tail wagging up a storm at the same time. 'Rrr-woof! Was Carl a good doggie?' the soldier asks in a playful tone as he looks over to you, getting a grin and thumbs-up in reply. Then Carl lowers himself into a push-up position on top of Erica, lapping at her sweaty chest and perky breasts to work his way up to coming face to face with Erica. 'You're definitively taking the 'man's best friend' bit to new levels Carl,' comes a happy comment, together with Erica running a hand through the thick fur on the anthro husky's neck and pulling him into another bout of making out.";
	LineBreak;
	say "     Worn out from fucking Erica, you bid your two friends farewell for now and grab your gear to clean up and get dressed afterwards. As you move away from the site of your steamy threesome, the two of them stay lying on the sofa together. From a snippet of conversation you catch as you walk off, they start to talk about their favorite songs next. The effortless switch to typical banter between friends after having just gotten their rocks off with each other puts a smile on your face. Erica and Carl are definitively an interesting pair - seems like something just clicked between the two of them after meeting not so long ago.";
	increase EricAnalCounter by 1;

to say EricaCarlThreesome3: [fuck Carl's muzzle while Erica blows him]
	say "     Both the husky and human share eager looks as you tell them what you want to do, then quickly take their positions - Carl stretched out lengthwise on his back, with Erica on all fours between his legs. The canine soldier pushes his upper body up on his elbows and gives Erica a huge grin. 'Yeah baby! Lick that head good,' he pants in an aroused tone, prompting the red-headed student to bring her face close over his crotch and reply teasingly, 'You mean like this?' That said, Erica slowly runs her tongue up the underside of Carl's erection until soon reaching its pointy head, then circles Carl's glans with the tip of her tongue. 'Nnnnghh!' the anthro canine grunts in clear arousal and puts a hand on his friend's head, affectionately tousling her hair a little before pulling Erica down to engulf his cock - taking all of it down to the base.";
	say "     After Erica starts to bob up and down on Carl's shaft, filling the library with slurps and moans from the aroused husky, you yourself step up to the end of the sofa. Standing behind the stretched-out canine, you reach around Carl to run a hand over his soft-furred chest, feeling his abs and pecs. After caressing his nipples for a moment, finding and lightly pinching them, your fingers then move on to petting the transformed soldier's neck. As you keep stroking him, Carl leans his head back further and further, looking up at you with a pleased smile - followed by a grin as the erect [cock of player] shaft between your legs comes into his line of sight. The anthro husky's nostrils widen as he takes in the scent of your arousal - also shown by a glistening drop of pre forming at the cum-slit of your hard prick. You smile at the eager wag of Carl's tail-tip (which is all that is looking out from under his lying form) and the swiftness with which he lays back fully, head stretched out over the edge of the upholstery.";
	WaitLineBreak;
	say "     Bending your legs a little, you bring your cock close to the furry soldier's muzzle and earn an immediate lick from the aroused canine. His long and wet tongue feels amazing as it plays over your cock and you get the sensation of his nose pressing against your balls. You enjoy some moments of cock worship by Carl, with him huffing the musky scent of your cock and balls and lapping you, then eventually pull back a little, running a hand down the muzzle of the muscled man. Carl licks your fingers and allows you to pull open his maw, holding the slobbering tongue up with your thumb as you line yourself up and slide your prick into his open mouth. It feels great to rub your shaft along the broad length of his tongue and start thrusting in and out, face-fucking the horny guy.";
	say "     Carl is more than happy to be part of a blowjob-chain, enjoying the eager attention of Erica while himself is being face-fucked. The three of you continue to fill the library with moans and grunts for quite a while, although the sounds are rather muffled on the part of your friends, both of them with dicks in their mouths. Soon, you do notice Carl's breath coming faster and him panting around your hard cock - a clear sign of the canine running hot. Then suddenly, he pushes against your crotch in a gentle but determined manner, letting go of your cock and raising his head to look down at Erica. 'Getting real close now baby,' the canine soldier barks breathlessly, tapping Erica's shoulder with some urgency - and the pale-skinned student pulls her head back barely in time, lips stretching wide around Carl's rapidly swelling knot, then pulls off the bulge with a loud pop.";
	WaitLineBreak;
	say "     Panting a little as she looks upon Carl's erection and watches the knot reach its full size in seconds, Erica's eyes go wide as the first blast of canine cum erupts from the pointy cockhead and hits her. With her forehead and red hair now marked by a white streak, the red-headed student quickly reacts by plunging her mouth back down towards Carl's twitching manhood. The next spurt shoots out right as she is starting to open wide and paints Erica's lips and tongue with creamy cum. After that, the athletic student is back to sucking on the canine dick of her fuck-buddy - catching further eruptions of canine seed with her mouth while jerking Carl with one hand.";
	say "     The muscular soldier bucks on the sofa and reflexively thrusts his hips up towards Erica as he orgasms, grunting loudly with each new shot until he eventually sinks back in exhaustion. 'Phew,' he pants after a few moments of just lying there in post-orgasmic bliss. 'That was something else! You're getting good at this,' Carl says after raising his head to look at Erica - who still is gently suckling at his cockhead. The soldier smiles broadly as their eyes meet, then he hooks a hand behind Erica's neck and sits up, guiding the attractive teen into making out. Tail wagging in a rapid beat against the sofa (now that he's no longer lying on top of it), Carl slips Erica his tongue in a deep French kiss. As they eventually pull apart, strings of frothy cum stretch between their lips for a second. Looks like the husky slurped quite a bit of his own cum from Erica's mouth.";
	WaitLineBreak;
	say "     Looking over his shoulder, Carl gives you a questioning look with one raised eyebrow, as if asking if he should get back to being face-fucked - but you just give him a knowing smile and a nod towards Erica. His tail wags wildly as he winks at you, then the husky soldier says, 'Payback time.' After those half-mumbled words (from having a load of cum in his mouth) he executes what could almost be a wrestling move - getting his legs under him and bowling Erica over on the sofa to fall back on the soft upholstery. In a quick follow-up move, the anthro canine gets a grip on his human friend's legs and hikes them up over his own furred shoulders. This leaves Erica in almost a headstand, with Carl's muzzle just inches from her crotch. Brushing his nose against the glisteningly wet folds of Erica's feminine sex, the husky takes a deep huff of air and lets out an aroused rumble from deep in his throat. 'Fucking sexy,' he compliments Erica out of mostly closed lips, then uses his fingers to part the college athlete's nether lips.";
	say "     Carl rubs his wet nose against the opening of Erica's even wetter pussy, reveling in the scent of his sexy friend, then opens his muzzle. As the anthro canine sticks his long tongue into the young woman's vagina, the frothy mixture of cum and spit he held in his mouth slides down over the twitching muscle and right into Erica's depths, who moans loudly at the treatment her friend is giving her. 'You like that, don't you?' the soldier teases his friend, then uses a finger to stroke over Erica's clit just as she opens her mouth, making her reply nothing more but a drawn-out moan. Meanwhile having stepped up on the sofa yourself, erect [cock of player] shaft leading the way to get you standing over the upside-down Erica, your erection being right at eye-level for Carl and over the teenager's crotch too.";
	WaitLineBreak;
	say "     Jerking off at the sexy sight of both Erica's cum-smeared pussy as well as Carl's wide-open muzzle with its tongue stretched out in anticipation of your load, it doesn't take long before you get closer and closer to your own climax. With one hand tightly wrapped around your erection, the other stroking the inside of Erica's legs, the tingly feeling of impending release builds up to a boiling point just moments later and you start blasting away with hot seed. The first splash of it draws a white line across Carl's tongue, followed by another, then you aim lower and cream Erica's spread-open nether lips. Intense as the blast is, this causes cum splatter to land all over her crotch, and yours, as well as Carl's muzzle. The next eruption then hits Erica's hole exactly as you aim steeper down and most of it vanishes into the depths of her vagina.";
	say "     Standing like that, you continue to come onto Erica and fill the depression between her nether lips with creamy cum. The sight of such a sweet, naked teen covered in your load sends a pleasant shiver down your back. You can't help yourself but set a capstone on top of the pleasure you had together - by pressing your still pretty hard erection in against her pussy and pushing the cum deeper. Having already licked cum off his muzzle and swallowed it eagerly, Carl looks up at you and gives a playfully pleading whine, so after withdrawing from Erica you hold your dick out for him to clean. A few moments of happy lapping later, your [cock of player] shaft is clean of cum (if rather wet with dog slobber) and Carl turns his attention towards Erica.";
	WaitLineBreak;
	say "     Turned on by the sight of more cum around Erica's pussy lips, Carl runs his fingers through the sticky fluid and pushes it towards the opening, then inserts two fingers into the athletic student. Barking happily, Carl continues to push your cum deeper into Erica, mixing with his own deposit, all the while keeping his thumb on the human student's clit. As he continually rubs the 'magic button' of the teenager with circling movements, Erica trembles in pleasure under Carl's touch, then gasps, 'Yessss...! That feels great!' The sensations of being touched in this way drive Erica wild and she begins panting faster and faster, letting out moans in rising urgency. When Carl then switches to not only fingering but also lapping at Erica's clit with his tongue, this drives the athletic student over the edge. She orgasms with a climactic shout, legs twitching as they cross over Carl's back and pull the husky even tighter against his friend's crotch. Of course, Carl knows Erica quite well by now and is prepared for that - he just keeps lapping at his friend's crotch and slurps up the femcum that starts to leak from her folds.";
	say "     Eventually sliding Erica's legs from over his shoulders and allowing the young student to stretch out fully on the sofa, Carl straightens up and looks down at his naked friend. A broad smile is on his face as he feasts his eyes on the lithe teenager, his tail wagging up a storm at the same time. 'Rrr-woof! Was Carl a good doggie?' the soldier asks in a playful tone as he lowers himself into a push-up position on top of Erica, lapping at her sweaty chest and perky breasts to work his way up to coming face to face with Erica. 'You're definitively taking the 'man's best friend' bit to new levels Carl,' comes a happy reply, together with Erica running a hand through the thick fur on the anthro husky's neck and pulling him into another bout of making out.";
	LineBreak;
	say "     Worn out from fucking Erica, you bid your two friends farewell for now and grab your gear to clean up and get dressed afterwards. As you move away from the site of your steamy threesome, the two of them stay lying on the sofa together. From a snippet of conversation you catch as you walk off, they start to talk about their favorite songs next. The effortless switch to typical banter between friends after having just gotten their rocks off with each other puts a smile on your face. Erica and Carl are definitively an interesting pair - seems like something just clicked between the two of them after meeting not so long ago.";

to say EricaCarlThreesome4: [Player fucks Carl's ass while he eats Erica's pussy]
	say "     Both the husky and human share eager looks as you tell them what you want to do, then quickly take their positions - Carl kneeling at the end of the sofa, his paws hanging over the edge and Erica stretched out lengthwise in front of him. As the canine soldier then leans forward to lower his muzzle to his transgendered friend's pussy, his ass sticks out very invitingly. The excitedly wagging tail of your husky companion tells you that he's looking forward to what you'll do next. 'Nnnghhh! Yes! Oooh that feels good,' Erica gasps as Carl takes a first lap at her crotch, playing his long floppy tongue over the young woman's folds. As he starts licking in earnest, you yourself step up behind him, jerking your erect [cock of player] shaft.";
	say "     Catching the husky's tail with one hand, you stroke over its soft fur and pull the appendage aside, then line your dickhead up with Carl's pucker. Gently brushing against it with your erection makes Carl tense for a moment, then relax visibly as he prepares himself to being fucked. As you press forward a little, you feel his muscle pushing back against you - he is trying to make penetrating him easier for both of you. Still, some lube might be needed... and thankfully you got a handy source for it, right between Carl's legs. Reaching down, you slide a hand over his furry balls and give them a quick fondle, then move further down to stroke his canine shaft. After just a little bit of rubbing his pointy cockhead, you manage to gather a copious amount of pre-cum in the palm of your hand - a clear sign just how horny this situation is making Carl.";
	WaitLineBreak;
	say "     Looking over at Erica as she is lying on the sofa, moaning loudly thanks to Carl's ministrations, you slide your hand up and down your [cock of player] shaft and make sure it is well-lubed with the canine soldier's own pre-cum. Then it is time to line the glistening head of your shaft up with his rear entrance and to push inside. Grunting in satisfaction as you penetrate after an initial moment of resistance, you feel Carl's inner walls stretch tightly around your shaft. Going slow at first, you slide deeper into the muscular soldier's asshole, enjoying every moment of feeling his hot, tight hole gripping your prick. It is quite obvious when you find Carl's prostate a moment later - as the husky's whole body trembles in lust and he gives a pleased yip, somewhat muffled as he has his nose buried in Erica's pubes, with his tongue wiggling inside the young woman's pussy.";
	say "     You run your hands down Carl's back, enjoying the feel of his soft fur under your hands as you just stay still for a moment, dickhead pressed right against his magic spot. Best to give him a little bit of time to get used to your cock in his ass and feel your rapid heartbeat through the throb of that [cock of player] shaft. The pause comes to a stop as you put your hands on his hips, digging their fingers into his luxurious fur and gripping on to Carl tightly - then sink the rest of your cock into him with a sudden thrust. A shared moan and bark echoes through the library, followed my more noises of excitement and lust as you start fucking Carl in earnest, hammering into his furry ass mercilessly. In turn, the anthro canine goes wild on Erica's pussy, grinding his wet nose against the teenager's clit while slurping and licking at her.";
	WaitLineBreak;
	say "     As your [cock of player] dick keeps sawing in and out of Carl's ass with a fast-paced rhythm, you can feel him get more and more aroused by this treatment - though the twitches and flexing of his anal muscles as well as the ever faster beat of his wagging tail against the side of your hips. He is too busy eating Erica out to do much more than grunt and growl in pleasure, until he suddenly pushes himself up with both arms and twists his upper body to look at you. 'This feels SO FUCKING GOOD!' the husky barks out in a lusty tone, then pulls your head close to share a sloppy kiss. When he turns back to Erica, a broad grin spreads over his muzzle. Leaning forward, Carl slides his strong hands under both of the teenager's spread legs, then growls, 'Erica - I'm gonna pound you like a bitch!'";
	say "     With that, the muscular soldier gives a sudden heave and pulls Erica closer, ramming his canine shaft home between her pussy lips in one move. Almost as if in slow-motion, you see the red-headed student's eyes go wide and her mouth open to let out a loud aroused moan, then time catches up with the action again and Erica wraps her arms and legs around Carl to hold on for dear life. The husky pounds into his pale-skinned friend like a wild animal, humping her hard and lapping at his naked mate, tongue slurping the sweaty skin of Erica's neck and pecs. In turn, he fucks himself on your shaft too, the ring of his pucker sliding up and down your length as he thrusts again and again. Of course, this doesn't mean that you stop your own movements, and Erica's moans rise to new heights each time the thrusts line up - Carl into her and yourself into Carl, driving the canine cock even deeper.";
	WaitLineBreak;
	say "     Such no holds barred fucking pushes Erica past her limits in short notice, and with a satisfied scream, she digs her fingers into Carl's back fur, trembling wildly as an orgasm breaks over her like a tsunami. The almost out of control husky growls in satisfaction at getting off the eager bitch he is mating and grinds himself even harder against Erica, joining the athletic student in completion just moments later. With the knot on his nonhuman cock swelling up in mere heartbeats and locking the two of them together tightly, his furry balls start pulsing with blast after blast of canine seed that erupts into Erica's vagina, then even straight into her womb as Carl thrusts deeper and penetrates her cervix with just the pointy tip of his shaft.";
	say "     Meanwhile, you yourself feel Carl's inner muscles tense around your erection with each new spurt of his cum into Erica. It is almost as if he is jerking you off inside his ass - which was already nice and snug around your dick. As a result, you join your two friends in orgasm pretty soon, painting Carl's insides white with cum. Overwhelmed by the first eruption of your load into him, you hold on to the soldier to stay on your feet, then lean and brace against him, head resting on his muscled back. While your shaft keeps throbbing with spurt after spurt of more cum, your nose is pressed into Carl's fur, huffing the musky scent of a horny, sweaty husky.";
	WaitLineBreak;
	say "     Eventually coming down from your respective orgasmic highs, the three of you stay in an entwined tangle for a little while longer yet as you catch your breaths. When you gently pull out of Carl, a little gush of cum seeps out of him with your dick, immediately soaking into the fur below. Looking down upon the pink ring muscle pulling tight to keep the rest of your load inside him, as well as the cum-matted fur, you can't help but smile. Patting the canine soldier's back, you tell him you had a lot of fun, then slide your hand under one of Erica's and give her a squeeze too. Both of them reply in kind, Erica flushing a little as she says that she really enjoyed the sex while Carl just confidently adds that he's looking forward to the next time.";
	say "     As you start getting dressed, the husky and human kiss deeply, then Carl pushes himself up on his elbows and looks down between their bodies to where they are pressed together at the hip, his erection still tied to Erica's pussy. 'Guess you're pretty used to this from college, eh? Going to the library to bone up really good. And getting help from your friends when you get tied in - well, with - a knot, hah.' Erica gapes at her friend for a second, amazed that Carl switched instantly from sex to silly puns. Then she can't help but laugh at the friendly husky with the wagging tail on top of her and pulls him in for another sloppy kiss. As she lets go of Carl a moment later, allowing the soldier to pull away, Erica gives him a naughty grin and replies, 'Sure thing. And I'm also used to my dog getting really excited about burying his bone in one specific spot. Putting it in, and out, in and out. Creatures of habit, those canines...'";
	WaitLineBreak;
	say "     As the two unlikely friends continue with little jokes and puns, in between caressing and kissing while they wait for Carl's knot to go down, you finish putting on your clothes and gear, then quietly walk back to the front desk of the library. Funny thing, just how good a friend those two found in one another, in the midst of all the chaos going on in this city. Sure, they fuck one another as do most creatures out on the streets, but there is definitively something more to their relationship. Something just clicked there, and you think they would have become best friends no matter what if they had met one another outside these circumstances.";

to say EricaCarlThreesome5: [player gets a BJ from Carl while he hammers Erica's pussy]
	say "     Both the husky and human share eager looks as you tell them what you want to do, then quickly take their positions - Erica stretched out lengthwise on the sofa, with Carl kneeling between her spread legs. The canine soldier leans over his human friend and gives her an eager kiss on the lips, playfully wrestling tongues for a moment, then pulls back a little. 'You're such a sexy guy Erica,' Carl tells him in a husky tone, panting a little in his heavy arousal. As the muscular anthro takes hold of his erect cock and gently brushes its tip against Erica's nether lips, the teenager lets out a loud sigh and replies, 'Yesss... ooh, that feels just... god, Carl!' Wrapping her arms around the chest of her furry companion, Erica pulls Carl down on himself and kisses him deeply - and the horny soldier slides into Erica's waiting pussy at the same time.";
	say "     You watch the two of them make out ecstatically as Carl sinks his bone deeper and deeper into Erica. He enters his friend with the long red-skinned shaft dangling between his legs until just the yet un-swollen little bulge of his knot is outside - then gives a sharp thrust and bottoms out with a satisfied grunt. For a moment, movement between them stops and they just hold on to one another, then a panting Erica plants a soft peck on Carl's muzzle and gasps out, 'Fuck me, please!' Sinking back on the sofa cushions and digging his hands in to get a secure grip, the college athlete gives himself fully to the strong soldier on top of her, ready for Carl to go wild. The anthro husky takes things slow at first, leaning in to lick from Erica's nipples over her neck to lightly nip at her earlobe. 'You're in for a wild ride with this doggie,' he says teasingly, then pulls most of his shaft out of Erica and hammers it home again, and again - starting to fuck the young woman in earnest now.";
	WaitLineBreak;
	say "     Observing the sight of a steaming hot coupling between an anthro furry and human, you almost could stay where you are and keep watching - but then the throbbing shaft between your legs demands that you get some action yourself. Never taking eyes of the gyrations of Erica and Carl as they move against one another on the sofa, you step up on the cushions yourself, coming to stand above Erica with your legs planted a little to the left and right of her head. This puts Carl's canine muzzle quite close to your crotch, and when you put a hand on the furred soldier's head, he looks up to take in your naked form and grins widely. It is just a matter of bending your legs a little to put your hard [cock of player] shaft directly in front of his muzzle, where it is subject to a welcoming lick right away.";
	say "     Slowing the rhythm of pounding Erica down to a gentler - but quite deep - grind of his canine cock into the college girl's pussy, Carl lets his long tongue play over your cock for a moment. Then he proceeds to press his wet nose against your balls, lapping away at them with flicks of his floppy canine tongue. You enjoy a little while of ball worship by Carl, with him huffing the musky scent of your crotch and lapping away at you, then eventually pull back a little, running a hand down the muzzle of the muscled man. Carl licks your fingers and allows you to pull open his maw, your thumb sliding over the soft slobbering tongue as you line yourself up. Easily sliding your prick into his open mouth, it feels great to rub its shaft along the broad length of his tongue and start thrusting in and out, face-fucking the horny soldier.";
	WaitLineBreak;
	say "     Carl is more than happy to service you while still fucking Erica in a steady rhythm, enjoying the soft moans that his human friend makes while she takes the canine's cock. The three of you continue to fill the library with moans and grunts for quite a while, although the sounds are rather muffled on the part of Carl, with a dick in his mouth. Soon, you do notice Carl's breath coming faster and him panting around your hard cock - a clear sign of the canine running hot. Then suddenly, he pushes against your crotch in a gentle but determined manner, letting go of your cock and lowering his head to look down at Erica. 'Getting real close now baby,' the canine soldier barks breathlessly, flicking an ear at Erica in a questioning gesture. The slender teen looks up into his eyes, then lets out an aroused sigh of, 'Do it - knot me, Carl!'";
	say "     With a lusty growl, Carl thrusts forward against Erica's crotch with renewed force, really humping her and even pushing Erica a little bit along the cushions before he gets a more secure grip. From your standing point over the two of them, you have a very good view of Carl's body going stiff as he lets out a satisfied growl and starts flooding Erica's womb with his canine seed. Rapidly swelling up in little more than a few heartbeats, the bulging knot at the base of the soldier's cock locks the two of them together - all in a bid to ensure that he can impregnate the human bitch he just mated. The sensation of getting bred winds Erica up more than just a little bit, with the knot and throb of Carl's shaft against her inner walls, and she joins her friend in orgasm almost instantly, writhing on the sofa as Carl covers her with his larger furred body.";
	WaitLineBreak;
	say "     You are quite close to getting off yourself after the pretty neat time with Carl's muzzle and watching your two companions come. So much so that you decide that you won't wait for Carl to get back to sucking - he's still twitching in orgasm and holding on to his knotted mate, after all. Gripping your glistening wet [cock of player] erection, you move your hand up and down along its shaft and jerk off - which quickly serves to drive your arousal past the point of no return. Grunting in lust, you grip your manhood tightly and feel the twin orbs of your balls pull up a bit, sending forth a first long spurt of cum that leaves a white streak over Carl's back and the base of his tail. Another and another blast of your seed follows, the third one splashing the inside of Erica's spread legs and everything after that finding its target in the increasingly sticky fur of the big canine under you.";
	say "     Carl takes being creamed by you in stride, looking up for a second and grinning, then wiping up some of the wetness on the small of his back and demonstratively licks his hand clean with a swipe of that canine tongue of his. Wagging his tail, the husky opens his muzzle to say something - but a slender arm suddenly slides around his neck and pulls him back down to Erica for a kiss. 'That was amazing,' the college student says in a happy tone as they come back up for air, earning her a deep kiss from Carl in reply. Patting the canine soldier's back, you tell him you had a lot of fun, then slide your hand under one of Erica's and give her a squeeze too. Both of them reply in kind, Erica flushing a little as she says that she really enjoyed the sex while Carl just confidently adds that he's looking forward to the next time.";
	WaitLineBreak;
	say "     As you start getting dressed, the husky and human keep making out for a moment, then Carl pushes himself up on his elbows and looks down between their bodies to where they are pressed together at the hip, his erection still tied to Erica's pussy. 'Guess you're pretty used to this from college, eh? Going to the library to bone up really good. And getting help from your friends when you get tied in - well, with - a knot, hah.' Erica gapes at her friend for a second, amazed that Carl switched instantly from sex to silly puns. Then she can't help but laugh at the friendly husky with the wagging tail on top of her and pulls him in for another sloppy kiss. As she lets go of Carl a moment later, allowing the soldier to pull away, Erica gives him a naughty grin and replies, 'Sure thing. And I'm also used to my dog getting really excited about burying his bone in one specific spot. Putting it in, and out, in and out. Creatures of habit, those canines...'";
	say "     As the two unlikely friends continue with little jokes and puns, in between caressing and kissing while they wait for Carl's knot to go down, you finish putting on your clothes and gear, then quietly walk back to the front desk of the library. Funny thing, just how good a friend those two found in one another, in the midst of all the chaos going on in this city. Sure, they fuck one another as do most creatures out on the streets, but there is definitively something more to their relationship. Something just clicked there, and you think they would have become best friends no matter what if they had met one another outside these circumstances.";

to say EricaCarlThreesome6: [player gets BJ from Erica while he straddles Carl's face]
	say "     Both the husky and human share eager looks as you tell them what you want to do, then quickly take their positions - Carl stretched out lengthwise on his back, with Erica straddling his muscled chest. The canine soldier starts stroking his cock while grinning up at his human friend, then raises his head and gives the college athlete a first lick over her nether lips. 'Oooh yes, Carl! That feels so good!' Erica pants in a lust-filled tone, stroking her furry friend's head and rubbing behind his ears. 'Have I ever told you that you taste amazing,' Carl says in between licks, then buries his muzzle in Erica's trimmed pubes and huffs deeply. 'And the scent could drive a guy wild, you sexy beast,' he adds after that, then attacks Erica's clit, sucking on it with pursed lips.";
	say "     'OH GOD!' comes a loud scream of lust from your female friend and Erica sways a little as her knees get weak. Head thrown back and with her mouth open in almost constant moaning, the slender student starts to lean backwards just a little too much - so much so that you have to grab her by the hand so she doesn't fall over on top of Carl. The look of his blushing face at losing control of herself so easily makes you laugh, then console her that it is alright... you've got her now. Typical of her shy nature, Erica replies with a happy smile and the start of a 'Thank you' - which leads over into a breathless moan as Carl plays his tongue over just the right spot.";
	WaitLineBreak;
	say "     Keeping hold of Erica's hand to keep her steady, you move up on the sofa at the same time, coming to stand over Carl and his human friend, feet planted a bit to the left and right of Carl's head. Then you guide Erica's hands to your hips, giving her something new to hold onto and freeing your hands to do something else. Like gently pulling Erica's head towards your erect [cock of player] shaft for example. It takes no effort at all to get the young woman to lick at your cock, then slide her sweet lips over its head to go down on you. Erica eagerly gives you a pretty good blowjob while having Carl pleasure her in turn.";
	say "     The three of you fill the library with moans, pants and even the odd bark and growl from Carl, everyone enjoying the sensations of shared arousal immensely. The situation heats up more and more with every moment of touching, licking, caressing and sucking - until soon, Carl draws everyone's attention down towards him with an urgent bark. Panting audibly, his tongue hanging out and sometimes touching Erica's crotch as he moves a little, Carl says, 'Getting kinda close here and... I want to feel you around my dick as I come, Erica. You ready for some doggie loving, baby?' You can just imagine how wildly Erica's tail would beat if she was a canine like Carl, so clear is her joy at the not at all innocent question from her friend. With an eager expression, she replies in a very straightforward, 'Take me!'";
	WaitLineBreak;
	say "     Carl is quick to shimmy his body along the sofa cushions, getting into position with now his crotch right under Erica's straddling hips. The anthro husky's canine shaft is almost painfully erect, glistening with precum smeared all over its length from when he was jerking it. Reaching out to rub Erica's clit a little with his thumb, Carl guides the college athlete's hips further down slowly - proving an impressive level of restraint in the very, very horny male. Still, there is a limit just how well even Carl can control himself... and as the tip of his shaft nudges apart Erica's dripping pussy lips, that point is reached. With a growl more akin to a wolf than a dog, the husky thrusts his hips up forcefully, driving all of himself - including the already half-swollen knot - into Erica!";
	say "     The sudden deep penetration and wild thrusts from the desperately aroused soldier rock Erica to her core and you have to step up to hold her up once more. Their coupling is quite intense and given how close he already was, it doesn't take long until Carl bucks into Erica's pussy while grunting deeply, flooding the college girl with his seed. Knotted and being bred by her canine friend, Erica follows Carl in orgasm just moments later, sighing prettily in arousal as she reaches her climax. Trembling and caressing one another, the two of them ride out their lust together - which just leaves you the odd one out, proudly erect but not having gotten off yet.";
	WaitLineBreak;
	say "     As Erica is till panting breathlessly and holding on to you for support, a blowjob is out and you can't just step away - so you decide to jerk off right where you are. With your trusty hand wrapped around the shaft of your [cock of player] erection and a sexy naked human-husky duo to look at, it takes mere moments before you feel a tingly sensation build in your balls, then blow a creamy load all over Erica, splashing her slender chest and perky breasts with streaks of cum. By the time your own orgasm runs its course, Erica has gotten her breath back and smiles up at you. 'Glad to see that everyone enjoyed themselves,' the college student says happily, then wipes a little of your seed off her chest and licks it off her finger playfully. Patting Erica's shoulder, you tell her you had a lot of fun, then step off the sofa and stroke Carl's side, giving his arm a friendly squeeze. Both of them reply in kind, Erica flushing a little as she says that she really enjoyed the sex while Carl just confidently adds that he's looking forward to the next time.";
	say "     While you start getting dressed, the husky and human start making out for a moment, then Carl pushes himself up on his elbows and looks down between their bodies to where they are pressed together at the hip, his erection still tied to Erica's pussy. 'Guess you're pretty used to this from college, eh? Going to the library to bone up really good. And getting help from your friends when you get tied in - well, with - a knot, hah.' Erica gapes at her friend for a second, amazed that Carl switched instantly from sex to silly puns. Then she can't help but laugh at the friendly husky with the wagging tail on top of her and pulls him in for another sloppy kiss. As she lets go of Carl a moment later, allowing the soldier to pull away, Erica gives him a naughty grin and replies, 'Sure thing. And I'm also used to my dog getting really excited about burying his bone in one specific spot. Putting it in, and out, in and out. Creatures of habit, those canines...'";
	WaitLineBreak;
	say "     As the two unlikely friends continue with little jokes and puns, in between caressing and kissing while they wait for Carl's knot to go down, you finish putting on your clothes and gear, then quietly walk back to the front desk of the library. Funny thing, just how good a friend those two found in one another, in the midst of all the chaos going on in this city. Sure, they fuck one another as do most creatures out on the streets, but there is definitively something more to their relationship. Something just clicked there, and you think they would have become best friends no matter what if they had met one another outside these circumstances.";

to say EricaCarlThreesome7: [player grinds their pussy against Carl's muzzle while Erica blows him]
	say "     Both the husky and human share eager looks as you tell them what you want to do, then quickly take their positions - Carl stretched out lengthwise on his back, with Erica on all fours between his legs. The canine soldier pushes his upper body up on his elbows and gives Erica a huge grin. 'Yeah baby! Lick that head good,' he pants in an aroused tone, prompting the red-headed student to bring her face close over his crotch and reply teasingly, 'You mean like this?' That said, Erica slowly runs her tongue up the underside of Carl's erection until soon reaching its pointy head, then circles Carl's glans with the tip of her tongue. 'Nnnnghh!' the anthro canine grunts in clear arousal and puts a hand on his friend's head, affectionately tousling her hair a little before pulling Erica down to engulf his cock - taking all of it down to the base.";
	say "     After Erica starts to bob up and down on Carl's shaft, filling the library with slurps and moans from the aroused husky, you yourself step up to the end of the sofa. Standing behind the stretched-out canine, you reach around Carl to run a hand over his soft-furred chest, feeling his abs and pecs. After caressing his nipples for a moment, finding and lightly pinching them, your fingers then move on to petting the transformed soldier's neck. As you keep stroking him, Carl leans his head back further and further, looking up at you with a pleased smile - followed by a grin as the moist pussy between your legs comes into his line of sight. The anthro husky's nostrils widen as he takes in the scent of your arousal and he licks his lips in anticipation. You smile at the eager wag of Carl's tail-tip (which is all that is looking out from under his lying form) and the swiftness with which he lays back fully, head stretched out over the edge of the upholstery.";
	WaitLineBreak;
	say "     Bending your legs a little, you bring your crotch close to the furry soldier's muzzle and earn an immediate lick from the aroused canine. His long and wet tongue feels amazing as it plays over your nether lips and you get the sensation of his nose pressing against your skin. You enjoy some moments of pussy worship by Carl, with him huffing the musky scent of your crotch and lapping you, then eventually pull back a little, running a hand down the muzzle of the muscled man. Carl licks your fingers and allows you to pull open his maw, holding the slobbering tongue up with your thumb and getting your fingers nice and wet with spit. Telling the husky to tongue-fuck your pussy, you grind your hips forward against him - and Carl is more than eager to comply, wagging his tongue in just the right way. It feels great to rub your sensitive clit with two slick fingers while slowly humping the furry male's face.";
	say "     Carl happily serves as the middle of an oral sex chain, enjoying the eager attention of Erica while himself is tongue-deep in your pussy. The three of you continue to fill the library with moans and grunts for quite a while, although the sounds are rather muffled on the part of your friends, both of them with dicks in their mouths. Soon, you do notice Carl's breath coming faster and him panting hotly against your fingers as they gyrate against your magic button - a clear sign of the canine running hot. Then suddenly, he pushes against your crotch in a gentle but determined manner, slurping in the tongue and raising his head to look down at Erica. 'Getting real close now baby,' the canine soldier barks breathlessly, tapping Erica's shoulder with some urgency - and the pale-skinned student pulls her head back barely in time, lips stretching wide around Carl's rapidly swelling knot, then pulls off the bulge with a loud pop.";
	WaitLineBreak;
	say "     Panting a little as she looks upon Carl's erection and watches the knot reach its full size in seconds, Erica's eyes go wide as the first blast of canine cum erupts from the pointy cockhead and hits her. With her forehead and red hair now marked by a white streak, the red-headed student quickly reacts by plunging her mouth back down towards Carl's twitching manhood. The next spurt shoots out right as she is starting to open wide and paints Erica's lips and tongue with creamy cum. After that, the athletic student is back to sucking on the canine dick of her fuck-buddy - catching further eruptions of canine seed with her mouth while jerking Carl with one hand.";
	say "     The muscular soldier bucks on the sofa and reflexively thrusts his hips up towards Erica as he orgasms, grunting loudly with each new shot until he eventually sinks back in exhaustion. 'Phew,' he pants after a few moments of just lying there in post-orgasmic bliss. 'That was something else! You're getting good at this,' Carl says after raising his head to look at Erica - who still is gently suckling at his cockhead. The soldier smiles broadly as their eyes meet, then he hooks a hand behind Erica's neck and sits up, guiding the attractive teen into making out. Tail wagging in a rapid beat against the sofa (now that he's no longer lying on top of it), Carl slips Erica his tongue in a deep French kiss. As they eventually pull apart, strings of frothy cum stretch between their lips for a second. Looks like the husky slurped quite a bit of his own cum from Erica's mouth.";
	WaitLineBreak;
	say "     Looking over his shoulder, Carl gives you a questioning look with one raised eyebrow, as if asking if he should get back to tonguing your pussy - but you just give him a knowing smile and a nod towards Erica. His tail wags wildly as he winks at you, then the husky soldier says, 'Payback time.' After those half-mumbled words (from having a load of cum in his mouth) he executes what could almost be a wrestling move - getting his legs under him and bowling Erica over on the sofa to fall back on the soft upholstery. In a quick follow-up move, the anthro canine gets a grip on his human friend's legs and hikes them up over his own furred shoulders. This leaves Erica in almost a headstand, with Carl's muzzle just inches from her crotch. Brushing his nose against the glisteningly wet folds of Erica's feminine sex, the husky takes a deep huff of air and lets out an aroused rumble from deep in his throat. 'Fucking sexy,' he compliments Erica out of mostly closed lips, then uses his fingers to part the college athlete's nether lips.";
	say "     Carl rubs his wet nose against the opening of Erica's even wetter pussy, reveling in the scent of his sexy friend, then opens his muzzle. As the anthro canine sticks his long tongue into the young woman's vagina, the frothy mixture of cum and spit he held in his mouth slides down over the twitching muscle and right into Erica's depths, who moans loudly at the treatment her friend is giving her. 'You like that, don't you?' the soldier teases his friend, then uses a finger to stroke over Erica's clit just as she opens her mouth, making her reply nothing more but a drawn-out moan. Meanwhile having stepped up on the sofa yourself, your needy pussy is in everyone's view as you come to stand standing over the upside-down Erica, putting your crotch right at eye-level for Carl.";
	WaitLineBreak;
	say "     The panting husky stretches his neck and laps between your legs, drawing a number of pleased moans from you as he goes on for a while - but eventually, you pat his furry head and gently push him away. Carl is about to ask why he shouldn't get you off, but before he can say anything, you start grinding your crotch against Erica's - clit rubbing against clit, bringing great pleasure to both of you. The usually so quiet teenager gasps, 'Yessss...! Nghh! That feels great!' and goes through little muscle twitches as her body becomes awash with even greater arousal. One of those reflexive movements in her legs pulls Carl closer with a sudden wrench, making the husky bump into your pubes with his wet nose - and the sly dog quickly reacts by starting to lap again, both at Erica's pussy lips as well as your own sensitive skin.";
	say "     Between the rubbing and getting licked by a very eager anthro dog, both Erica and yourself are rapidly driven to orgasm, barreling past the point of no return like rocket-ships. Two voices fill the library with orgasmic shouts at the same time, with both you and Erica swaying a little from the sensations. Thankfully, Carl serves dutifully as a brace for both of you, holding Erica up with the teenager's legs hooked over his shoulders, as well as yourself through two strong arms wrapping around your hips and lower back. Of course, this doesn't mean that he stops lapping at your crotches - no, the canine happily keeps slurping up the femcum that starts to leak from his two excited friends.";
	WaitLineBreak;
	say "     Eventually you manage to catch your breath and gently slip out of Carl's grip, stepping down from the sofa. Meanwhile, Carl's arms slide Erica's legs from over his shoulders and allow the young student to stretch out fully on the sofa, with the husky straightening up to look down at his naked friend. A broad smile is on his face as he feasts his eyes on the lithe teenager, his tail wagging up a storm at the same time. 'Rrr-woof! Was Carl a good doggie?' the soldier asks in a playful tone as he lowers himself into a push-up position on top of Erica, lapping at her sweaty chest and perky breasts to work his way up to coming face to face with Erica. 'You're definitively taking the 'man's best friend' bit to new levels Carl,' comes a happy reply, together with Erica running a hand through the thick fur on the anthro husky's neck and pulling him into another bout of making out.";
	LineBreak;
	say "     Worn out from your own orgasm, you bid your two friends farewell for now and grab your gear to clean up and get dressed afterwards. As you move away from the site of your steamy threesome, the two of them stay lying on the sofa together. From a snippet of conversation you catch as you walk off, they start to talk about their favorite songs next. The effortless switch to typical banter between friends after having just gotten their rocks off with each other puts a smile on your face. Erica and Carl are definitively an interesting pair - seems like something just clicked between the two of them after meeting not so long ago.";

to say EricaCarlThreesome8: [player rides Carl's cock while Eric straddles his face]
	say "     <This scene is WIP, please have some patience for the next update>";

[
instead of navigating Grey Abbey Library while (Fang Companion is tamed and XP of Erica is 4 and HP of Erica is 1 and (lastfuck of Erica - turns) > 12 and a random chance of 1 in 3 succeeds):
	say "[NavCheck Grey Abbey Library]";
	if NavCheckReturn is false, stop the action;
	move player to Grey Abbey Library;
	if debugactive is 1:
		say "     DEBUG: ERICA Fang SEX REPEAT WALKIN [line break]";
	say "     As you enter the library, you hear moaning and lust-filled growls coming from somewhere behind one of the back shelves. Curious who's doing whom, you go to check it out. Walking over until you see the space behind the long bookshelf, you spot Erica - with your Fang companion on top of her, mounting the smaller human and rapidly thrusting his hips at her. Seems like the big cat managed to put your friend under his influence again - though it seems this time Erica went to seek the feline out - after all, the young athlete is on her hands and knees on one of the mattresses from the cots in the bunker below, which she must have dragged up here for just this purpose...";
	LineBreak;
	say "     The animalistic coupling of Fang and his entranced partner is quite a show - between seeing the curves of Erica's shapely breasts swing with each new thrust and the play of trained muscles on their naked bodies, it drives your arousal to new heights as you watch. With the stamina of a wild beast, Fang drives his cock into Erica's pussy relentlessly, until finally the beautiful redhead's moans and noises rise up to a climactic shout, announcing her orgasm to anyone in hearing range. Visibly satisfied in making her come, Fang isn't far behind, burying his hard cock all the way in the young human's pussy and then holding still, only his balls pulsing as they fill her up with his seed. When he finishes cumming, the big cat throws himself on the mattress to lounge in satisfaction, taking Erica with her, still impaled on the hard shaft inside her and soon held against his soft belly fur with a muscular forelimb.";
	now lastfuck of Erica is turns;

instead of going down from Grey Abbey Library while (XP of Erica > 0 and XP of Erica < 4 and Erica is in Bunker and HP of Erica < 99):
	move player to Bunker;
	if debugactive is 1:
		say "     DEBUG: ERICA POST-Fang-SEX WALKIN [line break]";
	say "     As you come down the stairs into the bunker, Erica almost jumps up from where she was sitting on her cot and rushes over to you, her cheeks red with embarrassment. Before you can so much as ask what's wrong, she gushes forth with 'I'm sorry. I- I had sex with your Fang companion. Something just came over me and I let him mount and fuck me! Can you ever forgive me for this?' her somewhat teary eyes seek out yours and take on a hopeful look as she realizes how calmly you're taking this (you did already know and didn't stop Fang from fucking her after all).";
	say "     So, what do you tell her? That there's no shame in having some fun, even without you and with... exotic partners ([link]Y[as]y[end link])? Or do you just console her and tell her to avoid Fang in the future ([link]N[as]n[end link])?";
	if player consents: [more Fang scenes]
		LineBreak;
		say "     Putting your arms around Erica and holding her, you console the young woman with calm words, explaining that you're not angry or anything. After all, it's a whole new world with the nanites and everything going on, so why should people be restrained by the morals of the old one. The young athlete's eyes get wide in realization as you remind her that you brought Fang home with you, even after knowing his lusty character. Pulling her close again, you squeeze Erica's tight ass and whisper in her ear that [if XP of Erica is 1 or XP of Erica is 2]you saw Fang follow her in the library and were okay with it[else]you were there and did watch the hot little scene of Fang mounting her[end if]. A visibly relieved Erica stutters 'So you did... you let... he did...', then takes a deep breath before admitting 'He felt so good - so right - inside me, having his hard cock fuck me, that soft belly-fur against my back...' Her breathing becomes quicker as she relives her experience with Fang in memory, clearly getting aroused by it.";
		LineBreak;
		say "     Do you want to seize the moment for some hot action between the sheets with Erica ([link]Y[as]y[end link]), or do you just leave her to dwell on those lusty thoughts ([link]N[as]n[end link])?";
		now XP of Erica is 4;
		if player consents:
			say "     [EricaSexMenu]";
		else:
			LineBreak;
			say "     Smiling at Erica and encouraging her to have some more fun with Fang whenever she wants, you chat with her a short while, then turn to other things. The by now pretty wound up young athlete meanwhile makes a beeline for her bunk, no doubt to rub herself deal with the built-up lust.";
	else: [no further Fang scenes]
		LineBreak;
		say "     Putting your arms around Erica and holding her, you console the young woman with calm words, explaining to her that you're not angry or anything. After all, it's partly your fault for bringing Fang here with you (and letting him fuck Erica, but she doesn't need to know that). Telling Erica just not to fall for Fang's charms and arousing musk again, you give the visibly relieved athlete a kiss on the cheek and leave her to get back to her bunk.";
		now XP of Erica is 99;
]

Section 5 - Endings
[
when play ends:
	if (HP of Erica is 0):
		say "     A";
	else:
		say "     B";
]

Erica ends here.
