Version 5 of Eric by Wahn begins here.
[Version 5: encounter with the felinoid]

"Adds an NPC named Eric to the Flexible Survival game, with impreg chance"

[ HP states of Eric                                                  ]
[   0: Holed up in the lockerroom                                    ]
[   1: Cuntboy virgin, in the Bunker                                 ]
[  10: Accepted being a cuntboy, in the Bunker                       ]
[  11: Accepted being a cuntboy, had sex with player, in the Bunker  ]
[  12: Accepted being a cuntboy, Rane took his virginity             ]
[  13: Accepted being a cuntboy, had sex with Rane and the player    ]
[  14: Accepted being a cuntboy, catch-all for non virgin            ]
[  15: Accepted being a cuntboy, non virgin + player sex             ]
[  20: Hoping for a cure, virgin, in the Bunker                      ]
[  21: now with horsecock, virgin, in the Bunker                     ]
[  22: now with horsecock, had sex with player, in the Bunker        ]
[  31: now with satyrcock, virgin, in the Bunker                     ]
[  32: now with satyrcock, had sex with player, in the Bunker        ]
[  99: Taken advantage of -> submissive cuntboy, in the Bunker       ]
[ 100: Stacy's girlfriend now, pregnant (no longer available)        ]
[ 200: Transformed into Erica                                        ]

[ Thirst states of Eric (for the smell)                              ]
[   0: Smells male & something the player can't identify             ]
[   1: Smells male + fertile pussy                                   ]
[  11: Smells male + pregnant pussy                                  ]
[  21: Smells male + horse musk                                      ]
[  31: Smells male + satyr musk                                      ]

[ Libido states of Eric (for reactions against a player furling)     ]
[   0: Eric has never seen the player in Furling shape               ]
[   1: Eric has seen the player in Furling shape - is not frightened ]

[ Lust states of Eric (for sex with David)                           ]
[   0: starting state                                                ]
[   1: talked with David about Eric                                  ]
[   2: David talked with Eric / sub Eric's opinion doesn't matter    ]
[   3: ready for sex with David                                      ]
[   4: had sex with David                                            ]

[ Level states of Eric (for sex with the Felinoid)                   ]
[   0: starting state                                                ]
[   1: Felinoid fucked him (unseen by the player)                    ]
[   2: Felinoid fucked him (unseen by the player, but he told them)  ]
[   3: Felinoid fucked him (seen by the player)                      ]
[   4: Player told him that they're okay with it                     ]
[  99: the player stopped the Felinoid from fucking him              ]

[ Dexterity states of Eric (interaction with Rane)                   ]
[   0: starting state                                                ]
[   1: talked with the player about Rane                             ]
[   2: Rane followed him and fucked him in the shower                ]
[   3: Eric told the player he's afraid                              ]
[   4: player ignored Eric                                           ]
[   5: Rane fucked Eric's ass in the library                         ]
[   6: Eric ran off                                                  ]
[   7: Eric got rescued by Rane and the player                       ]
[   8: Rane and Eric talked and had make-up sex                      ]
[   9: Rane chatted with the player about Eric                       ]
[  10: Eric chatted with the player about Rane                       ]
[  11: Rane and Eric chatted with the player about each other        ]
[  40: Eric avoids Rane                                              ]
[  50: Player stepped in and stopped the shower fuck (end chain)     ]
[  51: Player told Rane to stop after Eric complained                ]
[  99: Eric lost outside                                             ]

[ EricVirginityTaken                                                 ]
[   0: virgin                                                        ]
[   1: by the player                                                 ]
[   2: by Rane                                                       ]
[   3: by the felinoid                                               ]
[   4: by Carl                                                       ]
[   5: by Urik                                                       ]
[   6: by Fang                                                       ]
[   7: by the monster under the bed                                  ]
[   8: by Ryousei                                                    ]

[ CarlEricInteraction                                                ]
[   0: not met                                                       ]
[   1: ran into each other in the library                            ]
[   2: Carl made a move - successfully                               ]
[  50: player interceded when Carl made a move                       ]

[ AlexandraEricInteraction                                           ]
[   0: not met                                                       ]
[   1: ran into each other in the library                            ]
[   2: Alexandra made him eat her pussy                              ]
[  50: player interceded when Alexandra made a move                  ]

[ UrikEricInteraction                                                ]
[   0: not met                                                       ]
[   1: Eric and Urik met                                             ]
[   2: Eric had orc cum                                              ]
[   3: Urik fed Eric orc cum                                         ]
[   4: Urik and Eric had a 69                                        ]
[   5: Urik and Eric talked                                          ]
[   6: Urik fucked Eric's pussy                                      ]
[  50: player interceded when Urik wanted to fuck Eric's pussy       ]
[  99: player told Eric to avoid the orc                             ]

[ RyouseiEricInteraction                                             ]
[   0: not met                                                       ]
[   1: Eric and Ryo met                                              ]
[   2: Eric listened to stories by Ryo                               ]

EricVirginityTaken is a number that varies.
EricAnalCounter is a number that varies.
CarlEricInteraction is a number that varies.
lastCarlEricInteraction is a number that varies.
AlexandraEricInteraction is a number that varies.
UrikEricInteraction is a number that varies.
lastUrikEricInteraction is a number that varies.
RyouseiEricInteraction is a number that varies.
lastRyouseiEricInteraction is a number that varies.
ConfSvenEricInteraction is a number that varies.
lastConfSvenEricInteraction is a number that varies.
lastRaneEricInteraction is a number that varies.

Section 1 - Meeting Event

Barricaded Lockerroom is a situation. The level of Barricaded Lockerroom is 8.
The sarea of Barricaded Lockerroom is "Campus".
when play begins:
	add Barricaded Lockerroom to badspots of hermaphrodite; [cuntboy, later a fight against a hulking cheerleader]

Instead of resolving a Barricaded Lockerroom:
	say "     While exploring the sports arena on the campus, you come upon the closed door to the men's locker room, looking rather battered with lots of claw scratches on it. When you try the door-handle, it opens only a crack before bumping into something heavy - accompanied by a loud clanking noise. A man's voice can be heard from inside a moment later: 'Stay away you crazy critters! I'm warning you - I've got a baseball bat and am willing to use it. You're not getting another bite out of me!'";
	LineBreak;
	say "     Do you want to try to talk the guy into letting you in? (Y/N)";
	if the player consents:
		let bonus be (( charisma of player minus 10 ) divided by 2);
		let dice be a random number from 1 to 20;
		say "You roll 1d20([dice])+[bonus] vs 15 and score [dice plus bonus]:[line break]";
		if dice + bonus >= 15:
			if bodyname of player is "Furling":
				say "     After some quick talking, you almost had him convinced, but then he opens the door a bit more and peeks outside. After a short gasp from behind the door, it gets slammed shut again, with noises of something heavy pushed against it for good measure. 'Ah, you're one of them - go away, creature!'";
				say "     Hm, sounds like he really doesn't like your current looks. Maybe you should try this again in a different shape...";
			else:
				say "     After some quick talking, you manage to convince the person inside the lockerroom that you're another survivor and not just a feral infectee. You hear some scraping noises from the other side of the door, then it opens and a young man hurriedly waves you inside. He pushes one of the heavy 3-locker units in front of the door to make sure you're not followed.";
				say "     'Hi, I'm Eric,' the man says, shaking your hand. 'Nice to see not everyone has gone totally bonkers in this city. I couldn't believe the stuff going on out there at first... saw my roommate transform into a big furry thing right in front of my eyes. There wasn't anything human left in him - he even bit me!' He shows you his bandaged arm.";
				move player to Sports Arena Lockerroom;
				change southeast exit of Athletic Street to Sports Arena Lockerroom;
				change northwest exit of Sports Arena Lockerroom to Athletic Street;
				Now Barricaded Lockerroom is resolved;
		else:
			say "     As you're trying to explain, the person behind the door shouts 'I don't believe you. You're just one of those strange creatures who wants to trick me!' Then the door is pushed closed from the other side.";
	else:
		say "     Deciding not to bother with the crazed fellow further, you head off before anything else notices you poking around.";
		now Barricaded Lockerroom is resolved;

Sports Arena Lockerroom is a room. It is fasttravel. It is private.
The description of Sports Arena Lockerroom is "[lroomdesc]".

instead of sniffing Sports Arena Lockerroom:
	say "You don't smell anything noteworthy. With a nanite virus apocalypse going on right outside the door, there haven't been any large numbers of sweaty athletes in here for some time now.";

to say lroomdesc:
	if (HP of Eric is 0): [Starting state]
		say "     This is the men's lockerroom of the sports arena in the Tenvale campus. Looks like someone has made camp here - you see an improvised bed out of lots and lots of towels and empty bottles and wrappers of energy drinks and bars. Not a bad defensive spot either - the few existing windows are high up on the walls and the row of lockers pulled in front of the door should keep out all but the most determined intruders.";
		LineBreak;
		say "     Eric has sat down on one of the benches in the room and is looking over to you attentively.";
	else if (HP of Eric > 0) and (HP of Eric < 100): [Eric was brought to the bunker after a quick stop here, something followed the scent]
		say "     This is the men's lockerroom of the sports arena in the Tenvale campus. Eric's former camp has been ransacked, the towels of the improvised bed strewn about among empty bottles, energy bar wrappers and ripped clothing. Looks like something followed the scent trail left when you brought Eric back from his encounter with Stacy and was a bit annoyed that he wasn't still here.";
	else if (HP of Eric is 100): [Eric never came back from Stacy's dorm]
		say "     This is the men's lockerroom of the sports arena in the Tenvale campus. Looks like someone has made camp here - you see an improvised bed out of lots and lots of towels and empty bottles and wrappers of energy drinks and bars. Not a bad defensive spot either - the few existing windows are high up on the walls and pushing one of the lockers in front of the door should keep out all but the most determined intruders.";

instead of going down from the Grey Abbey Library while (libido of Eric is 0 and bodyname of player is "Furling"):
	move player to Bunker;
	if debugactive is 1:
		say "     DEBUG: ERIC FURLING FRIGHT WALKIN [line break]";
	say "     As you enter the bunker and come into Eric's sight he gets pale, saying 'Aaah! It's one of - wait a minute, it's you isn't it? Don't frighten me like that - you look like one of my buddies at the college after they transformed.'";
	now libido of Eric is 1;

instead of navigating Sports Arena Lockerroom while (libido of Eric is 0 and bodyname of player is "Furling"):
	say "[NavCheck Sports Arena Lockerroom]";
	if NavCheckReturn is false, stop the action;
	move player to Sports Arena Lockerroom;
	if debugactive is 1:
		say "     DEBUG: ERIC FURLING FRIGHT WALKIN [line break]";
	say "     As you enter the lockerroom and come into Eric's sight he gets pale, saying 'Aaah! It's one of - wait a minute, it's you isn't it? Don't frighten me like that - you look like one of my buddies in the dorm after they transformed.'";
	now libido of Eric is 1;

Section 2 - Eric the Cuntboy Athlete

[Smells, Description, Conversation and NPC Interaction]

Eric is a man. Eric is in Sports Arena Lockerroom. The HP of Eric is normally 0.
The description of Eric is "[EricDesc]".
The conversation of Eric is { "Mew!" }.
EricFleeingCountdown is a number that varies.

instead of sniffing Eric:
	if thirst of Eric is 0: [Starting state]
		say "Eric has a pretty nice, masculine smell. Although there's a slight undertone of something else.";
	if (thirst of Eric is 1): [pussy revealed]
		say "Eric has a pretty nice, masculine smell. Underlying that, there's a slight hint of the state of his female genitalia - fertile and ready.";
	if (thirst of Eric is 11): [pregnant]
		say "Eric has a pretty nice, masculine smell. Underlying that, there's a slight hint of the state of his female genitalia - it's notably different than when you first met him. Could it be he's expecting?";
	if (thirst of Eric is 21): [now with a horse-cock]
		say "Eric has a pretty nice, masculine smell. Underlying that, there's a hint of animal-like musk, a bit like a horse.";
	if (thirst of Eric is 31): [now with a satyr-cock]
		say "Eric has a pretty nice, masculine smell. Underlying that, there's a hint of a stronger, satyr-like musk.";

to say EricDesc:
	if debugactive is 1:
		say "DEBUG -> HP: [HP of Eric], THIRST: [thirst of Eric], LIBIDO: [libido of Eric], LUST: [lust of Eric], LEVEL: [level of Eric], EricVirginityTaken: [EricVirginityTaken], EricAnalCounter [EricAnalCounter], CarlEricInteraction: [CarlEricInteraction], lastCarlEricInteraction [lastCarlEricInteraction], AlexandraEricInteraction: [AlexandraEricInteraction], UrikEricInteraction: [UrikEricInteraction], lastUrikEricInteraction: [lastUrikEricInteraction], RyouseiEricInteraction: [RyouseiEricInteraction], lastRyouseiEricInteraction: [lastRyouseiEricInteraction], lastRaneEricInteraction: [lastRaneEricInteraction] <- DEBUG[line break]";
	if (HP of Eric is 0): [starting state]
		project the figure of Eric_clothed_icon;
		say "     Eric is a college age young man with ginger hair, light skin and quite a few freckles. His unlined face has a boyish charm to it and he often smiles while talking. He's wearing a clearly over-sized t-shirt bearing the number 69 and cut-off jeans. While the clothes seem to have been looted from the surrounding lockers and put on in a haste, they certainly show off his runner's build nicely - muscled legs and upper body, while still being lithe and lean overall. His left underarm is bandaged.";
		LineBreak;
		say "     At the moment, he's sitting on one of the benches of the lockerroom in the Tenvale campus sports arena, watching you attentively. His gaze moves over to the barricaded door from time to time, just to check it's still secure.";
	else if ((HP of Eric is 1) or (HP of Eric is 20)): [pussy revealed, in the bunker, virgin]
		project the figure of Eric_sofa_icon;
		say "     Eric is a college age young man with ginger hair, light skin and quite a few freckles. Or at least he looks like it - you know better that he's got a pussy hidden away under his shorts. His unlined face has a boyish charm to it and he often smiles while talking. He's wearing a grey t-shirt bearing the words 'Tenvale College' and tight green shorts, showing his runner's build - nicely muscled legs and upper body, while still being lithe and lean overall. His left underarm is bandaged.";
		say "     [line break]";
		say "     At the moment, he's sitting on a camp bed in the bunker, watching you a bit apprehensively. Looks like he feels uncomfortable at you knowing his gender state.";
	else if (HP of Eric is 10 or HP of Eric is 12 or HP of Eric is 14): [pussy accepted, in the bunker]
		project the figure of Eric_sofa_icon;
		say "     Eric is a college age young man with ginger hair, light skin and quite a few freckles. Or at least he looks like it - you know better that he's got a pussy hidden away under his shorts. His unlined face has a boyish charm to it and he often smiles while talking. He's wearing a grey t-shirt bearing the words 'Tenvale College' and tight green shorts, showing his runner's build - nicely muscled legs and upper body, while still being lithe and lean overall. His left underarm shows a thin oval line of redness - a fading scar from the bite that started his initial transformation. [if UrikEricInteraction > 6]Eric also bears two small healed puncture marks just above his collarbone on the right - an affectionate mark of being Urik's honorary orc breeder slut.[end if]";
		LineBreak;
		say "     He's lived himself in at the bunker by now, and it looks like he has gone out and brought some more of his stuff in here in the meantime. Beside his camp bed there are several sports bags full of clothing and supplies, and a baseball bat rests against it for when he goes outside. You often see him stretching and working out - like right now for example, as you stop and watch him move his inviting lithe body. Eric notices you standing there, and gives you a shy smile, then goes on with his exercises.";
	else if (HP of Eric is 11 or HP of Eric is 13 or HP of Eric is 15): [pussy accepted, in the bunker, had sex with the player]
		project the figure of Eric_sofa_icon;
		say "     Eric is a college age young man with ginger hair, light skin and quite a few freckles. Or at least he looks like it - you know better that he's got a pussy hidden away under his shorts. His unlined face has a boyish charm to it and he often smiles while talking. He's wearing a grey t-shirt bearing the words 'Tenvale College' and tight green shorts, showing his runner's build - nicely muscled legs and upper body, while still being lithe and lean overall. His left underarm shows a thin oval line of redness - a fading scar from the bite that started his initial transformation. [if UrikEricInteraction > 6]Eric also bears two small healed puncture marks just above his collarbone on the right - an affectionate mark of being Urik's honorary orc breeder slut.[end if]";
		LineBreak;
		say "     He's lived himself in in the bunker by now, and it looks like he has gone out and brought some more of his stuff in here in the meantime. Beside his camp bed there are several sports bags full of clothing and supplies, and a baseball bat rests against it for when he goes outside. You often see him stretching and working out - like right now for example, as you stop and watch him move his inviting lithe body. Eric notices you standing there, and gives you a seductive smile, doing some suggestive stretches before he goes on with his exercises.";
	else if HP of Eric is 21 or HP of Eric is 31: [now with horsecock/satyrcock, in the bunker]
		project the figure of Eric_sofa_icon;
		say "     Eric is a college age young man with ginger hair, light skin and quite a few freckles. He looks fully human, but you know that he's packing a [if HP of Eric is 21]horse's[else if HP of Eric is 31]satyr's[end if] cock and balls inside his shorts. His unlined face has a boyish charm to it and he often smiles while talking. He's wearing a grey t-shirt bearing the words 'Tenvale College' and tight green shorts, showing his runner's build - nicely muscled legs and upper body, while still being lithe and lean overall. His left underarm is bandaged.";
		LineBreak;
		say "     He's lived himself in in the bunker by now, and it looks like he has gone out and brought some more of his stuff in here in the meantime. Beside his camp bed there are several sports bags full of clothing and supplies, and a baseball bat rests against it for when he goes outside. You often see him stretching and working out - like right now for example, as you stop and watch him move his inviting lithe body. Eric notices you standing there, and gives you a shy smile, then goes on with his exercises.";
	else if HP of Eric is 22 or HP of Eric is 32: [now with horsecock/satyrcock, in the bunker, had sex with the player]
		project the figure of Eric_sofa_icon;
		say "     Eric is a college age young man with ginger hair, light skin and quite a few freckles. He looks fully human, but you know that he's packing a [if HP of Eric is 22]horse's[else if HP of Eric is 32]satyr's[end if] cock and balls inside his shorts. His unlined face has a boyish charm to it and he often smiles while talking. He's wearing a grey t-shirt bearing the words 'Tenvale College' and tight green shorts, showing his runner's build - nicely muscled legs and upper body, while still being lithe and lean overall. His left underarm is bandaged.";
		LineBreak;
		say "     He's lived himself in in the bunker by now, and it looks like he has gone out and brought some more of his stuff in here in the meantime. Beside his camp bed there are several sports bags full of clothing and supplies, and a baseball bat rests against it for when he goes outside. You often see him stretching and working out - like right now for example, as you stop and watch him move his inviting lithe body. Eric notices you standing there, and gives you a wink and a smile smile, rubbing the bulge in his pants suggestively before going on with his exercises.";
	else if (HP of Eric is 99): [pussy revealed, in the bunker, fucked]
		say "     Eric is a college age young man with ginger hair, light skin and quite a few freckles. Or at least he looks like it - you know better that he's got a pussy hidden away under his shorts. His unlined face has a bit of a wary expression on it, as he watches you and wonders when he'll be fucked next. He's wearing a grey t-shirt bearing the words 'Tenvale College' and tight green shorts, showing his runner's build - nicely muscled legs and upper body, while still being lithe and lean overall. His left underarm is bandaged.";
		LineBreak;
		say "     He's taken the camp bed farthest from yours in the bunker and does his best not to attract your attention.";
	else if (HP of Eric is 100):
		say "ERROR-Eric-100A: He should be being impregnated by his hulk girlfriend by now! Please report what you did to see this.";

instead of conversing the Eric:
	if (HP of Eric is 0): [starting state]
		say "     Eric tells you what happened to him when the plague hit - with people shifting all around and his best friend taking a bite out of his arm, he moved in here and barricaded himself in. Since then, he's only left a few times, sneaking outside at night when most creatures are sleeping to gather some supplies. You in turn tell him of all the things you've seen and witnessed out in the city, making him go pale as he listens.";
		say "     When you finish, Eric asks you 'You're a pretty resilient person from your stories... could you maybe help me save Stacy, my girlfriend? Well, ex-girlfriend I guess - she broke up with me a day before the plague hit... but that doesn't matter now. I've tried to find her and bring her here, but there was a massive green creature moving around her dorm building every time I checked. I just couldn't fight something that big, so I sneaked away before it noticed me. Please, help me save her from there!'";
		if the player consents: [going on a rescue mission]
			say "     Eric arms himself with a baseball bat and you move out together, mostly staying behind buildings and sneaking through the bushes. It goes pretty well, until you arrive at one of the main thoroughfare of the campus and have to step onto a large open area to move on. You almost make it, then hear a female voice behind you. Turning around, you see a succubus and incubus stand there, eying you like pieces of meat.";
			say "     'It's just like you promised Aidan - a whole campus of pretty young things ripe for the plucking. How about you take that one,' she says with a nod to you, '- and I ride the redhead.'";
			challenge "Incubus";
			if fightoutcome >= 20 and fightoutcome <= 29: [lost]
				say "     The incubus leaves you lying on the ground as he struts off with his demonic partner. You collect your strewn-about belongings and are joined by Eric a moment later, who got pulled behind a bush and is looking a bit disheveled. He says 'Let's get out of here.' and leads on towards your goal.";
			else if fightoutcome >= 30: [fled]
				say "     Running as fast as you can, you lead the incubus for a chase over the campus grounds until you finally manage to shake him. Finally coming back to the scene of your confrontation, you find Eric crawling out of a bush, looking a bit disheveled. He says 'Let's get out of here.' and leads on towards your goal.";
			else if fightoutcome >= 10 and fightoutcome <= 19: [won]
				say "     Having beaten the incubus, you look around where the succubus and Eric are. There's some movement in the bushes in one direction, so you rush over there and find Eric half-dressed with the succubus running her hands all over him. She whirls around as she notices you, hissing at the distraction. As she comes closer, you ready yourself for an attack - and then Eric hits her with his bat from behind, ending the fight early. He says 'Let's get out of here.' and leads on towards your goal.";
				increase score by 10;
			LineBreak;
			say "     Arriving at a large dorm building, Eric guides you to the back entrance. You quietly make your way into the building, passing lots of empty rooms - and one with two naked bunny jocks in it, completely absorbed in stroking each other's cocks as they make out. Moving on, you arrive at a stairwell and go up two stories, then enter the hallway with Stacy's room in it. Finally you get to it, and Eric excitedly storms in - only to find it empty. He shouts 'Stacy? Where are you? Call out if you can hear me!', then throws open the door to the small bathroom in the back of the room. His frantic searching has you distracted for a moment, so that you notice the hulking presence behind you too late. A large green humanoid steps through the entrance door into the room behind you, giving you a backhanded slap that throws you across the room and into a wall.";
			say "     The hulking green figure has recognizably female features and a pair of ample breasts. The rest of her - or him rather, as you can see a thick cock dangling between her legs from where you lie groggily on the ground - isn't quite as feminine. She's at least nine feet tall, her bulging muscles stretching a white crop top tightly over her large frame. Around her hips, you see a very short skirt that does almost nothing to hide her crotch and the male equipment there.";
			say "     'Well well - here comes the cheating boyfriend and his newest little buddy.' She looks down at you in contempt. 'S-Stacy? Is that you? I told you, I didn't cheat on you - Diana kissed me just as you came in, not the other way around! I didn't do anything wrong!'";
			say "     A scowl on her face, the former Stacy steps over your prone body and grabs Eric by the neck, holding him up in front of her face. 'Now listen you little - I know exactly...' suddenly she stops and sniffs the air, then lowers her head to Eric's crotch. 'Wait a minute - what's this? You're a girl now? Then I do know a way you can make it up to me - I'll take your virginity and forget about you and that bitch.' You see her cock lengthen and fill out a bit from below. Laying Eric down on the bed, Stacy just rips off his clothing, revealing his lean physique - and a pussy where his cock and balls should be. She holds him down with one hand, the other rubbing his pussy lips, making him moan at the unfamiliar sensations.";
			WaitLineBreak;
			say "     Your head clears a bit and the stars in front of your eyes vanish. With Stacy the cheerleader hulk distracted, now would be a good time to take her on and save Eric from the tender mercies of the girlfriend he intended to rescue. Or you could just stay right here and watch - on the floor right behind Stacy, you got a ringside seat for the action. Her cock is long enough that you could reach out and touch it, and you got a nice sight of Eric's pussy at the edge of the bed from here. (Y = save him; N = watch them) ";
			if the player consents: [save him]
				say "     You wait a moment longer, watching Stacy as she fingers Eric's pussy, making him gasp and moan and open his legs wide as new instincts take over. She continues to rub and stroke him until she's pretty wet, putting her fingers in her mouth to taste his female juices. 'Yes, you're ready. Now I'll show you what it means to be a woman!' she says, stroking her cock and moving closer to Eric. Then, as she's completely distracted, holding up her long erection close to Eric's folds, you rush at her and attack.";
				if CheerleaderFirstEncounter is 0:
					now CheerleaderFirstEncounter is 2;
					challenge "Hulking Cheerleader";
					now CheerleaderFirstEncounter is 0;
				else:
					now CheerleaderFirstEncounter is 2;
					challenge "Hulking Cheerleader";
					now CheerleaderFirstEncounter is 1;
				if fightoutcome >= 20 and fightoutcome <= 29: [lost]
					say "     With another hard slap, the hulking cheerleader sends you flying against the wall of the room, putting you in a world of hurt. You can only lie there and hold your aching body when she turns back to Eric.";
					say "     Stacy pushes her massive erection against her ex-boyfriends folds, groaning as they spread and she sinks inside. You see her stop for a moment, presumably at his hymen, and say 'Ssh, hold still. It'll be over soon.' to him. There is a small pained yelp from Eric as she breaks through, but soon his lustful moans start up again as her hard shaft rubs against his insides. Going slow at first, then faster and faster, the gender-switched cheerleader starts fucking him in earnest, giving satisfied grunts each time she bottoms out in Eric's pussy. ";
					say "     Not much later, Eric gasps as he has his first female orgasm, and you see his pussy juices glistening on Stacy's thrusting cock. She stops for a moment and looks down at the writhing cuntboy, then starts up again, harder and faster than before.";
					say "     In between wild fucking, Stacy stops several times to pace herself and manages to last almost forty minutes, driving Eric to multiple more orgasms. As he is in the throes of another, she asks 'Do you like my cock inside you? Does it make you feel good?', and getting a moaned 'Yes' as an answer from him. She continues, 'Will you stay with me from now on? And let me fuck you anytime I want? And bear my children?', thrusting deep after each question and making Eric moan 'Yes, yes, yes.'";
					say "     Thrusting in deep several more times, she then gives a satisfied grunt and you see her balls twitch and pulse as she blows her load into Eric's womb. As she fills her ex-boyfriend-now-girlfriend with fertile seed, Stacy leans down, holding him tight and gives him a deep kiss.";
					WaitLineBreak;
					say "     You crawl out of the room and make your escape while she's still busy with Eric, having no choice but to concede him to her. With him having accepted being her girlfriend and likely already pregnant from her, there won't be any reason to come back here.";
					now HP of Eric is 100;
					remove Eric from play;
				else if fightoutcome >= 30: [fled]
					say "     Taking your legs under your arms, you just run, though as you dash along the corridor you notice Stacy isn't following you. Judging from the loud moans audible from her room, she's too busy fucking Eric... you're pretty sure you lost him for good and won't be seeing the handsome athlete again.";
					now HP of Eric is 100;
					remove Eric from play;
				else if fightoutcome >= 10 and fightoutcome <= 19: [won]
					say "     A moment later, the transformed woman collapses on the ground, leaving you the only person standing in her by now totally trashed room. You look over at Eric, who's been reduced to lying on the bed moaning, completely lost in the feelings his changed body is giving him. Seeing him there, legs spread and one hand rubbing the lips of his pussy, two possible choices come to mind. You could just take his virginity now while you can, or do the right thing and bring him to safety in the bunker under the library. (Y = fuck him, N = save him) ";
					if the player consents: [take advantage and take him to the bunker]
						LineBreak;
						say "     This is an opportunity you don't want to miss - the cuntboy is hot and ready, lying there on the bed with spread legs and just waiting for it...";
						if (cocks of player > 0):
							say "     Your cock springs to attention as you step closer, then kneel on the bed between Eric's legs. Running your hands over his muscular legs, you arrive at his drippingly wet pussy and push two fingers inside, making him moan as you wiggle them. Inside, you feel the soft flesh of his hymen under your fingers - nice, he really is a virgin. The thought of taking his cherry on the bed of his former girlfriend makes your cock twitch in anticipation. You aim your manhood at his moist folds, rubbing its tip against his pussy lips, then push forward, sinking your shaft into his body until you reach his maidenhead and stop for a moment.";
							say "     Running your hands over Eric's flat chest you play with his nipples, distracting him for the moment you pull back and then thrust in deep, piercing his hymen in one go. He whimpers at your forceful intrusion in his innermost being, but soon the pleasure able feelings of your hard member rubbing his insides outweigh the pain and he starts moaning again with lust. Holding his legs up with your hands you thrust in and out, revelling in his tight embrace around your shaft as you make a real woman - or rather cuntboy - out of him.";
							say "     Not much later, Eric gasps as he has his first female orgasm, his pussy getting really wet around your thrusting cock. You stop for a moment and look down at the writhing cuntboy you're inside of, then start up again, harder and faster than before.";
							say "     Pacing yourself, you manage to last another half hour, giving Eric another orgasm, before you feel your balls tightening with your impending climax. With one last thrust as deep as you can go inside him, you reach your goal, shooting burst after burst of your seed deep inside his womb.";
							WaitLineBreak;
							say "     Such a nice little cuntboy, you decide to take Eric along to the bunker to have some fun with again later. After having a quick look around, you pick up a bathrobe that's only a little too small for Eric. You bundle him up in it, then lead him by the arm out of the building, still rather out of it and dripping your cum and female juices on the floor. This time you manage to avoid any creatures as you make your way back to the sports arena. Well, mostly - at one point a male German Shepherd began sniffing the ground some way behind you and picked up the trail, but a passing incubus took an interest in him...";
						else:
							say "     A quick search through Stacy's dresser reveals a long pink dildo - and a vibrating one too. You take it and climb on the bed with Eric, rubbing his moist pussy lips slowly with your fingers, then spreading them to have a look. Ah, perfect - he really is a virgin. The thought of taking his cherry on the bed of his former girlfriend makes you grin in anticipation. You rub the dildo's tip against his pussy lips for a moment, then push forward, sinking it slowly into his body until you reach his maidenhead.";
							say "     Running your hands over Eric's flat chest you play with his nipples, distracting him for the moment you pull back and then thrust in deep, piercing his hymen in one go. He whimpers at your forceful intrusion in his innermost being, but as you flip the switch and move the vibrating dildo in and out of him, pleasure able feelings soon outweigh the pain and he starts moaning again with lust. Running a hand over his lithe body as you fuck him with the dildo, you revel in his pants and gasps as you make a real woman - or rather cuntboy - out of him.";
							say "     Not much later, Eric gasps as he has his first female orgasm, his pussy getting really wet around the dildo and leaking female juices on the mattress. You stop for a moment and look down at the writhing cuntboy you're made cum, then start up again, harder and faster than before.";
							say "     Taking your time, you keep going with the dildo for another forty minutes, giving Eric two more screaming orgasms. Then a groggy groan from the cheerleader hulk on the floor reminds you that you sadly don't have all the time in the world and should leave before she fully wakes up or something else comes along.";
							WaitLineBreak;
							say "     Such a nice little cuntboy, you decide to take Eric along to the bunker to have some fun with again later. After having a quick look around, you pick up a bathrobe that's only a little too small for Eric. You bundle him up in it, then lead him by the arm out of the building, still rather out of it and dripping female juices on the floor. This time you manage to avoid any creatures as you make your way back to the sports arena. Well, mostly - at one point a male German Shepherd began sniffing the ground some way behind you and picked up the trail, but a passing incubus took an interest in him...";
						say "     The howls of your almost-encounter as he's being fucked by the demon remind you that many creatures out here will be able to follow Eric's trail easily. You soon reach the lockerroom and give Eric some time to come down from his highly aroused state, then tell him to get dressed and that you're taking him to your bunker. Ten minutes later, he steps out from behind a row of lockers, dressed in shorts and a t-shirt and hefting a backpack with his most important gear and supplies. Departing towards the bunker, Eric walks with you but a step apart, silently thinking about what you did to him.";
						now HP of Eric is 99;
						now thirst of Eric is 1;
						move Eric to bunker;
						move player to bunker;
					else: [really save him]
						LineBreak;
						say "     After having a quick look around, you pick up a bathrobe that's only a little too small for Eric. You bundle him up in it, then lead him by the arm out of the building, still rather out of it and dripping female juices on the floor. This time you manage to avoid any creatures as you make your way back to the sports arena. Well, mostly - at one point a male German Shepherd began sniffing the ground some way behind you and picked up the trail, but a passing incubus took an interest in him...";
						say "     The howls of your almost-encounter as he's being fucked by the demon remind you that many creatures out here will be able to follow Eric's trail easily. The lockerroom won't be safe much longer. You give him some time to come down from his highly aroused state, then tell him to get dressed and that you're taking him to your bunker. Eric thanks you, at the same time getting very red in the face as he realizes you saw... all of him. Twenty minutes later, he steps out from behind a row of lockers, dressed in shorts and a t-shirt and hefting a backpack with his most important gear and supplies. Soon you depart towards the bunker, Eric still rather silent beside you as he thinks about what happened to him.";
						now HP of Eric is 1;
						now thirst of Eric is 1;
						move Eric to bunker;
						move player to bunker;
			else: [watch them fuck]
				say "     Having been hit by her once already, you decide you want to avoid that from happening again - and have some fun in the meantime. You silently crawl a bit closer and sit on the floor from where you have a nice view.";
				WaitLineBreak;
				say "     Stacy pushes her massive erection against her ex-boyfriends folds, groaning as they spread and she sinks inside. You see her stop for a moment, presumably at his hymen, and say 'Ssh, hold still. It'll be over soon.' to him. There is a small pained yelp from Eric as she breaks through, but soon his lustful moans start up again as her hard shaft rubs against his insides. Going slow at first, then faster and faster, the gender-switched cheerleader starts fucking him in earnest, giving satisfied grunts each time she bottoms out in Eric's pussy. ";
				say "     Not much later, Eric gasps as he has his first female orgasm, and you see his pussy juices glistening on Stacy's thrusting cock. She stops for a moment and looks down at the writhing cuntboy, then starts up again, harder and faster than before.";
				say "     In between wild fucking, Stacy stops several times to pace herself and manages to last almost forty minutes, driving Eric to multiple more orgasms. As he is in the throes of another, she asks 'Do you like my cock inside you? Does it make you feel good?', and getting a moaned 'Yes' as an answer from him. She continues, 'Will you stay with me from now on? And let me fuck you anytime I want? And bear my children?', thrusting deep after each question and making Eric moan 'Yes, yes, yes.'";
				say "     Thrusting in deep several more times, she then gives a satisfied grunt and you see her balls twitch and pulse as she blows her load into Eric's womb. As she fills her ex-boyfriend-now-girlfriend with fertile seed, Stacy leans down, holding him tight and gives him a deep kiss.";
				WaitLineBreak;
				say "     You crawl out of the room and make your escape while she's still busy with Eric, having no choice but to concede him to her. With him having accepted being her girlfriend and likely already pregnant from her, there won't be any reason to come back here.";
				now HP of Eric is 100;
				remove Eric from play;
		else: [try it later]
			say "     Eric looks visibly deflated as you decline. 'Oh... if you change your mind, I'll be here. But we really should hurry - who knows what's happening to Stacy...'";
	else if (HP of Eric is 1): [virgin in the bunker]
		project the figure of Eric_face_icon;
		say "     You sit down beside Eric on a camp bed and talk to him, trying to get him to open up about his... gender issues. He's very embarrassed about it all, rubbing his bandaged arm absentmindedly as he stockingly says 'After Danny bit me and nothing strange happened, I first thought I was immune to whatever is doing all this. But then later, as I was running away from him and through the chaos out in the campus, there was a wrenching feeling inside me and I fell down as my cock vanished and a vagina and womb formed.'";
		say "     'I hid in the lockerroom and tried to ignore it, hoping something could be done if the military or someone came - but with what happened with Stacy - I'm not sure if I can do that any longer. The feelings I had were... strange and amazing, and I couldn't do anything to resist them. If you hadn't pulled her off me in time...";
		say "     He takes a deep breath, then looks at you and shyly asks 'Do you think something can be done to change me back?' Wondering which answer he hopes for, you think for a moment what to answer:[line break]";
		say "     ([link]Y[as]y[end link]) - You'll search a cure. There surely should be something that makes him male again - somewhere out in the city.";
		say "     ([link]N[as]n[end link]) - He should accept his new self. Denial hasn't helped anyone, ever.";
		if player consents: [search for a cure]
			LineBreak;
			say "     You tell Eric that you'll have an eye out for a way to make him a man again. Maybe the cum of some creature that's fully male and still somewhat human would do the trick... and there surely will be centaurs or satyrs or something of the like in this city by now.";
			now HP of Eric is 20;
		else: [make him accept his pussy]
			LineBreak;
			say "     Putting a hand on Eric's arm, you tell him to accept what happened to him and be grateful that he's still human. You remind him how good he felt when Stacy rubbed his pussy, so maybe he could try it with someone he trusts...";
			now HP of Eric is 10;
	else:
		say "[EricTalkMenu]";

to say EricTalkMenu:
	LineBreak;
	if HP of Eric < 99:
		project the figure of Eric_face_icon;
	say "What do you want to talk with Eric about?";
	now sextablerun is 0;
	blank out the whole of table of fucking options;
	[]
	choose a blank row in table of fucking options;
	now title entry is "Just chat a bit";
	now sortorder entry is 1;
	now description entry is "Talk about what comes to mind";
	[]
	if HP of Eric is 99 and lust of Eric is 2:
		choose a blank row in table of fucking options;
		now title entry is "Implement your plan to get him fucked by David";
		now sortorder entry is 2;
		now description entry is "Push Eric to put out for David";
	[]
	if (HP of Eric is 11 or HP of Eric is 13 or HP of Eric is 15 or HP of Eric is 22 or HP of Eric is 32) and lust of Eric is 2:
		choose a blank row in table of fucking options;
		now title entry is "Get him interested in David (sexually)";
		now sortorder entry is 3;
		now description entry is "Convince Eric to have sex with your soldier friend";
	[]
	if HP of Eric is 20:
		choose a blank row in table of fucking options;
		now title entry is "'Curing' his gender troubles";
		now sortorder entry is 4;
		now description entry is "Talk about restoring his manhood";
	[]
	if HP of David is 4:
		choose a blank row in table of fucking options;
		now title entry is "David";
		now sortorder entry is 5;
		now description entry is "Talk about David with Eric";
	[]
	if HP of Eric > 9 and HP of Eric < 20 and UrikEricInteraction < 99 and UrikEricInteraction > 1: [cboy Eric, ate orc cum before]
		choose a blank row in table of fucking options;
		now title entry is "Urik";
		now sortorder entry is 6;
		now description entry is "Talk about Urik with Eric";
	[]
	if HP of Eric > 9 and HP of Eric < 99 and TomeFound > 0:
		choose a blank row in table of fucking options;
		now title entry is "The old book";
		now sortorder entry is 7;
		now description entry is "Talk about the strange tome Eric found";
	[]
	sort the table of fucking options in sortorder order;
	repeat with y running from 1 to number of filled rows in table of fucking options:
		choose row y from the table of fucking options;
		say "[link][y] - [title entry][as][y][end link][line break]";
	say "[link]100 - Nevermind[as]100[end link][line break]";
	while sextablerun is 0:
		say "Pick the corresponding number> [run paragraph on]";
		get a number;
		if calcnumber > 0 and calcnumber <= the number of filled rows in table of fucking options:
			now current menu selection is calcnumber;
			choose row calcnumber in table of fucking options;
			say "[title entry]: [description entry]?";
			if player consents:
				let nam be title entry;
				now sextablerun is 1;
				if (nam is "Just chat a bit"):
					say "[EricTalk1]";
				if (nam is "Implement your plan to get him fucked by David"):
					say "[EricTalk2]";
				if (nam is "Get him interested in David (sexually)"):
					say "[EricTalk3]";
				if (nam is "'Curing' his gender troubles"):
					say "[EricTalk4]";
				if (nam is "David"):
					say "[EricTalk5]";
				if (nam is "Urik"):
					say "[EricTalk6]";
				if (nam is "The old book"):
					say "[EricTalk7]";
				wait for any key;
		else if calcnumber is 100:
			say "Break off the conversation?";
			if the player consents:
				now sextablerun is 1;
				say "     You step back from the young man, shaking your head slightly as he gives a questioning look.";
				wait for any key;
			else:
				say "Pick between 1 and [the number of filled rows in the table of fucking options] or 100 to exit.";
		else:
			say "Invalid Option. Pick between 1 and [the number of filled rows in the table of fucking options].";
	clear the screen and hyperlink list;

to say EricTalk1:
	if (HP of Eric is 10 or HP of Eric is 12 or HP of Eric is 14): [accepted his pussy, might have been fucked by Rane, but not the player]
		say "     He says, 'Having a pussy still feels strange to me. Since that thing with Stacy, it keeps getting moist and swollen all the time.'";
	else if (HP of Eric is 11 or HP of Eric is 13 or HP of Eric is 15): [accepted his pussy, had sex with player]
		say "     He says, 'Being part woman is better than I expected. Thank you for helping me accept this new me,' then steps closer, running a hand over your arm and whispers in your ear 'I can barely wait for our next round in bed. I love being with you.'";
	else if HP of Eric is 20: [hoping for a cure]
		say "[EricTalk4]";
	else if HP of Eric is 21 or HP of Eric is 31: [now with a horsecock/satyrcock]
		say "     He says, 'Man, this cock is something else. A bit strange that it's not human, but it's thicker and longer than my old one was. Thank you for this. Would you maybe want to try it out with me?'";
	else if HP of Eric is 22 or HP of Eric is 32: [now with a horsecock/satyrcock, had sex with the player]
		say "     He smiles, giving you an embrace and a quick kiss on the lips. 'How about another round in bed? I still can't get over this amazing cock you got me.'";
	else if HP of Eric is 99: [sex slave Eric]
		say "     He looks at you with a resigned expression, saying, [one of]'I won't struggle if you fuck me - just please don't throw me out on the street.'[or]'I should hate you for what you did to me - but it felt so good. My traitor body constantly sends me urges to be fucked.'[at random]";
	else if (HP of Eric is 100): [lost to cheerleader girlfriend]
		say "ERROR-Eric-100B: He shouldn't be available to talk any longer! Please report how you got to this message.";
	else:
		say "ERROR - please report this on the forum, quoting Eric's HP: [HP of Eric] value for easier bug-fixing.";

to say EricTalk2: [push sex slave Eric to have sex with David]
	say "     You pull Eric close and kiss him aggressively. Then you tell him that it's time that he starts putting out for your friends too. David for example. Eric looks flustered, and tries to pull away, but you hold him tight. 'But - I thought it'd be only you, for letting me stay here.' Informing him that he thought wrong, you say that bitches like him are meant to be fucked by everyone - and that he can't say he doesn't like getting fucked, with how loud he moans each time. With that, you put your hand in his shorts and stick two fingers in Eric's already moist pussy. Pushing them in and out of Eric's hole and stroking his inner passage, you watch him bite his lip, then give up on that and openly moan in lust, closing his eyes as he gives in to the feelings.";
	LineBreak;
	say "     Fondling Eric, you drive his arousal higher and higher until he's close to orgasm, then... stop. The cuntboy's eyes find yours and give you a pleading look as he begs, 'Please, get me off. I need it!' Having him right where you wanted now, you ask him if he'll obey and let David fuck him too. When Eric quickly nods, you resume your manual stimulation of his pussy and soon drive the hot little cuntboy over the edge to orgasm, with his femcum running down over your fingers.";
	say "     Bringing your wet hand up to Eric's mouth to have him lick off his own juices, you explain your plan to him. As David might have some hangups about fucking him, you'll put him on a bed, blindfold him and get him all hot and ready - and then Eric will come over and mount his shaft. Eric finishes cleaning your hand, then nods submissively.";
	now lust of Eric is 3;

to say EricTalk3:
	if (HP of Eric is 11 or HP of Eric is 13 or HP of Eric is 15): [accepted his pussy, had sex with player]
		say "     You hug Eric close to you and give him a kiss. Then you ask him what he thinks of David, if he finds him attractive. 'Sure, he's handsome, but I already have you.' Eric answers and gives you a peck on the lips. Smiling, you run a hand down Eric's flat chest, pushing it under the band of his shorts. As you start to fondle Eric's sensitive pussy lips, you explain that David is a really good friend of yours and... - you push a finger into Eric's vagina, making him gasp in lust - ...that you'd really like the three of you to have some fun together.";
		say "     With that, you add another finger, pushing them in and out of Eric's hole and stroking his inner passage. Making out with him as you fondle Eric, you drive his arousal higher and higher, ask if he'd like to have some fun with David too, speeding up your manual stimulation of his pussy even more as you do so. 'Yes. Yes. YESSS.' your hot little cuntboy gasps as you drive him over the edge to orgasm, his femcum running down over your fingers. After catching his breath a moment later, Eric says 'Yes. Whatever you want. That soldier friend of yours really is quite a looker, now that I think of it...'";
	else if HP of Eric is 22 or HP of Eric is 32: [now with a horsecock/satyrcock, had sex with the player]
		say "     You hug Eric close to you and give him a kiss. Then you ask him what he thinks of David, if he finds him attractive. 'Sure, he's handsome, but I already have you.' Eric answers and gives you a peck on the lips. Smiling, you run a hand down Eric's flat chest, pushing it under the band of his shorts. As you start to fondle Eric's manhood, you explain that David is a really good friend of yours and... - Eric's cock by now has filled out a bit and come from its sheath, allowing you to grab it and jerk your hand up and down its length - ...that you'd really like the three of you to have some fun together.";
		say "     With that, you speed up jerking him a bit, and move your other hand to stroke his balls. Making out with him as you fondle Eric, you drive his arousal higher and higher, then ask if he'd like to have some fun with David too, speeding up your manual stimulation even more as you do so. 'Yes. Yes. YESSS.' your [if HP of Eric is 22]horse[else if HP of Eric is 32]satyr[end if]-hung athlete gasps as you drive him over the edge to orgasm and he shoots long strings of cum down the left leg of his shorts. After catching his breath a moment later, Eric says 'Yes. Whatever you want. That soldier friend of yours really is quite a looker, now that I think of it...'";
	else:
		say "ERROR - please report this on the forum, quoting Eric's HP: [HP of Eric] and Dexterity: [Dexterity of Eric] values for easier bug-fixing.";
	now lust of Eric is 3;

to say EricTalk4:
	if centaur cum is not owned and Satyr Wine is not owned:
		say "     He says 'Do you think you'll have something to cure me soon? You said something about centaurs and satyrs the last time. Please hurry, I don't know how long I can hold out any more. Since that thing with Stacy, my pussy keeps getting moist and swollen all the time.'";
	else if centaur cum is owned and Satyr Wine is owned:
		say "     Remembering that you have found some centaur cum and some satyr wine, either of which might provide a possible cure for Eric's condition, shall you offer one of them to him? If so, which - the [link]centaur cum (1)[as]1[end link], the [link]satyr wine (2)[as]2[end link] or [link]neither (0)[as]0[end link]?";
		now calcnumber is -1;
		while calcnumber < 0 or calcnumber > 2:
			say "Choice? (0-2)>[run paragraph on]";
			get a number;
		if calcnumber is 1:
			say "[centaurcum_Eric]";
		else if calcnumber is 2:
			say "[satyrwine_Eric]";
		else if calcnumber is 0:
			say "     Undecided about trying out some infected substance, you let him know that you're still looking. He seems a little disappointed, but nods and tells you to keep looking. If you're not certain about giving him one of them, you muse on instead just helping him to accept his new form.";
	else if centaur cum is owned:
		say "     Remembering that you have found some centaur cum which might provide a possible cure for Eric's condition, shall you offer it to him?";
		if the player consents:
			say "[centaurcum_Eric]";
		else:
			say "     Uncertain about trying out some infected substance, you let him know that you're still looking. He seems a little disappointed, but nods and tells you to keep looking. You recall considering finding some satyrs as well. Perhaps they might have something. Though if you're not certain about giving him one of them, you muse on instead just helping him to accept his new form.";
	else if Satyr Wine is owned:
		say "     Remembering that you have found some satyr wine which might provide a possible cure for Eric's condition, shall you offer it to him?";
		if the player consents:
			say "[satyrwine_Eric]";
		else:
			say "     Uncertain about trying out some infected substance, you let him know that you're still looking. He seems a little disappointed, but nods and tells you to keep looking. You recall considering finding some centaurs as well. Perhaps they might have something. Though if you're not certain about giving him one of them, you muse on instead just helping him to accept his new form.";

to say EricTalk5:
	if lust of Eric is 0: [starting state]
		if (HP of Eric > 9 and HP of Eric < 99):
			say "     Eric says, 'I've talked a bit with David. He's a pretty nice guy, glad you brought him here too.'";
		else if HP of Eric is 99: [sex slave Eric]
			say "     Eric says, 'I've talked a bit with David. He's a pretty nice guy.' A low whisper follows, somewhat sullenly, 'I don't know how he can stand to be with someone like you...'";
	else if lust of Eric is 1: [talked with David about Eric]
		say "     Eric blushes deeply as you bring up David, looking around as if to run away. As you put a hand on his shoulder and say to calm down, he finally takes a deep breath and says, 'I - he - he saw me. All... of me. I'm soo embarrassed. Who knows what he'll think of me now!'";
	else if lust of Eric is 2: [David talked with Eric, or not - for sex slave Eric]
		if HP of Eric < 99:
			say "     Eric says, 'I'm so glad David's such a cool guy about... you know.' He casually indicates his crotch. 'It's fun to hang out with him.'";
		else if HP of Eric is 99: [sex slave Eric]
			say "     Eric blushes deeply as you bring up David, looking around as if to run away. As you put a hand on his shoulder and say to calm down, he finally takes a deep breath and says, 'I - he - he saw me. All... of me. I'm soo embarrassed. Who knows what he'll think of me now!'";
	else if lust of Eric is 3: [ready for sex]
		if HP of Eric < 99:
			say "     Eric says, 'So, er... you still wanna have fun with him? David, you and me? I - I think I'd like that. He's a nice guy and... I got to admit, I like how his t-shirt stretches over those muscles.'";
		else if HP of Eric is 99: [sex slave Eric]
			say "     Eric looks down at his feet, pressing his lips together before he replies, 'I - I'm ready to do what you said. With him... with David. Be the 'bitch' you want.' He adds in almost a whisper, 'At least I know David will be gentle.'";
	else if lust of Eric is 4: [had sex with David]
		if (HP of Eric > 9 and HP of Eric < 20): [accepted his pussy]
			say "     Eric smiles at you as he say, 'I sure had a nice time with David. Thank you so much for being there for him and me and allowing us to meet. I - wouldn't mind doing that again. And soon...'";
		else if HP of Eric is 99: [sex slave Eric]
			say "     Eric looks down at his feet, pressing his lips together before he replies, 'I - it was actually nice. With him. And...' He falls silent for a long moment and you turn away, thinking that he's done talking. Then a low whisper reaches your ear, 'I don't know how he can stand to be with someone like you...'";

to say EricTalk6:
	say "     As you bring up the topic of Urik, your college student friend blushes a little, remembering his last sexual encounter with the orc. He clears his throat, then says, 'He's nice. I mean... in a gruff orc way, you know. Taking care of my... er, me since you gave him that talking to. I like spending time with Urik.' Unconsciously, the cuntboy athlete licked his lips as he said that last sentence, showing signs that he is hungry for more orc cum.";
	say "     [bold type]Will you tell Eric that the former orc warrior's cum is habit-forming ([link]Y[as]y[end link]), or do you want to tell him that you're happy he's got someone to hang out with and have fun with ([link]N[as]n[end link])?[roman type][line break]";
	if player consents: [stop Eric/Urik scenes]
		LineBreak;
		say "     Putting on a serious expression, you have a quiet word to Eric about the dangers of swallowing orc cum. He goes a bit pale as you detail the facts that it makes people drunk and takes away their inhibitions, leading to willing acceptance of serving orc masters. Urik may be your slave, but that doesn't mean his cum won't have the usual effect if someone... indulges in it a little too much. This frightens Eric more than a little bit, and so he tells you that he'll stay away from the orc for good from now on.";
		now UrikEricInteraction is 99; [no more scenes between them]
	else: [let em continue]
		LineBreak;
		say "     Patting the shy young guy on the shoulder, you tell Eric that you're glad that he and Urik understand one another. This way he has someone to hang out with and... have fun with, in the safety of the library. With a sigh of relief, he visibly relaxes and you chat a little bit more about how strong and imposing Urik is before turning back to other things.";

to say EricTalk7:
	if TomeFound is 1: [Eric has the book]
		say "     Eric nods and smiles as you bring up the book he found. 'Interesting stuff one can dig up in old storerooms, eh? I can't wait to have a look at it and learn what the book is about.' He glances over to his bed, where you see the thick leather-bound volume lie halfway under his pillow. That's... an odd choice for bedside literature, you can't help but think. Maybe you should take the book for now and have a closer look yourself first. Eric seems oddly interested in the thing.";
		say "     [bold type]Do you want to convince Eric to hand the old tome over to you?[roman type][line break]";
		LineBreak;
		say "     ([link]Y[as]y[end link]) - Yeah, better confiscate that thing for now.";
		say "     ([link]N[as]n[end link]) - Nah, let him have his fun with it.";
		if player consents:
			LineBreak;
			say "     Doing your best to be as convincing as you can be, you talk Eric into letting you have the book. He goes over to grab it, then holds it out for you... although he only lets go several seconds after you already have your hands on it. As soon as it leaves his grasp and you pack the book away, the young guy blinks a few times and shakes his head as if to clear away some mental cobwebs, then is his usual friendly self again and proceeds to chat a little while longer with you.";
			increase carried of ancient tome by 1;
			say "(You gain an ancient tome.)";
			now TomeFound is 100; [player took the book right at the start]
			now lastTomeInteraction is turns;
		else:
			LineBreak;
			say "     You let the matter go with a shrug and tell Eric that he can let you know what he learns later on.";
	else if TomeFound is 2: [Eric is reading]
		say "     Eric nods and smiles as you bring up the book he found. 'It is a really interesting read. I mean... I can't really understand the symbols, but... somehow it feels like I'm really close. And the pictures in there are something else entirely.' He glances over to his bed, where you see the thick leather-bound volume lie halfway under his pillow. That's... an odd choice for bedside literature, you can't help but think. Maybe you should take the book for now and have a closer look yourself first. Eric seems oddly interested in the thing.";
		say "     [bold type]Do you want to convince Eric to hand the old tome over to you?[roman type][line break]";
		LineBreak;
		say "     ([link]Y[as]y[end link]) - Yeah, better confiscate that thing for now.";
		say "     ([link]N[as]n[end link]) - Nah, let him have his fun with it.";
		if player consents:
			LineBreak;
			say "     Clearing your throat, you ask Eric if you can have the book - and he doesn't react to that at all, almost as if he hadn't heard a word you said. After waiting a moment or two, you finally decide to just take it. Walking over to his bed, you pull the book out from under Eric's pillow and tugging the tome under your arm. 'Hey!' Eric reacts with a slight delay, coming after you. 'I was reading that, give it back!' the red-headed college student complains, but you tell him in a friendly, but firm, tone that you'll have to check this thing out for yourself first. He reaches out in a bid to snatch the book back, but you keep it out of his reach. Finally he crosses his arms and sighs, then adds, 'Fine. I'll get something else to read then.' With a somewhat sullen expression on his face, Eric walks off towards the stairwell.";
			increase carried of ancient tome by 1;
			say "(You gain an ancient tome.)";
			now TomeFound is 99; [player took the book after Eric had a read]
			now lastTomeInteraction is turns;
		else:
			LineBreak;
			say "     You let the matter go with a shrug and tell Eric that he can let you know what he learns later on.";
	else if TomeFound is 3: [after a tentacle fucking that the player didn't see]
 		say "     Eric nods and smiles as you bring up the book he found. 'It is a really interesting read. I mean... I can't really understand the symbols, but... somehow it feels like I'm really close. And the pictures in there are something else entirely. I've even been having dreams about them... Really intense dreams.' With a somewhat far-away expression, he glances over to his bed, where you see the thick leather-bound volume lie halfway under his pillow. That's... an odd choice for bedside literature, you can't help but think. Maybe you should take the book for now and have a closer look yourself first. Eric seems oddly interested in the thing.";
		say "     [bold type]Do you want to convince Eric to hand the old tome over to you?[roman type][line break]";
		LineBreak;
		say "     ([link]Y[as]y[end link]) - Yeah, better confiscate that thing for now.";
		say "     ([link]N[as]n[end link]) - Nah, let him have his fun with it.";
		if player consents:
			LineBreak;
			say "     Clearing your throat, you ask Eric if you can have the book - and he doesn't react to that at all, almost as if he hadn't heard a word you said. After waiting a moment or two, you finally decide to just take it. Walking over to his bed, you pull the book out from under Eric's pillow and tugging the tome under your arm. 'Hey!' Eric reacts with a slight delay, coming after you. 'I was reading that, give it back!' the red-headed college student complains with determination, but you tell him in a friendly, but firm, tone that you'll have to check this thing out for yourself first. He reaches out in a bid to snatch the book back, but you keep it out of his hands even as he tries to wrestle it from your grasp. Finally he crosses his arms and sighs, then adds, 'Fine. I'll get something else to read then.' With a somewhat sullen expression on his face, Eric walks off towards the stairwell.";
			increase carried of ancient tome by 1;
			say "(You gain an ancient tome.)";
			now TomeFound is 98; [player took the book after Eric was tentacle-fucked (without the player knowing about it)]
			now lastTomeInteraction is turns;
		else:
			LineBreak;
			say "     You let the matter go with a shrug and tell Eric that he can let you know what he learns later on.";
	else if TomeFound is 4: [player took the book after watching Eric be tentacle-fucked]
 		say "     Eric's eyebrows draw together in thought and he asks, 'Have you seen my book, actually? I know I had it not too long ago, but not it isn't here. The last time I saw it was before I had...' He blushes prettily and is silent for a few seconds, then adds silently, '...uhm, you know. A sex dream. I can't remember it really, but... it was really amazing and I think there even was something in it from the illustrations in the book...'";
		say "     [bold type]Do you want to tell Eric about the things that happened to him while he was asleep?[roman type][line break]";
		LineBreak;
		say "     ([link]Y[as]y[end link]) - Yeah, he should know.";
		say "     ([link]N[as]n[end link]) - Nah, that would really freak him out. Better just let things lie if he doesn't remember.";
		if player consents:
			LineBreak;
			say "     Reaching out to grasp Eric by the shoulder, you tell him in an earnest tone that he should sit down. He is a bit baffled at first, then readily lets you guide him to a nearby bed and sits next to you. 'Err... what's up?' he asks after a nervous swallow. You tell him what you saw in detail and that you... couldn't stop things from getting out of hand. With every new sentence, the college student gets a little paler in the face. Tension winds tighter and tighter in him as you explain things, and when you come to an end, it eventually explodes out in a sobbed, 'WHAT?! Fuck. Fuck! FUUUCK! It - it was just a book. Isn't anything safe in this damned world anymore?!'";
			say "     Doing your best to calm Eric down again, you tell him that he is safe now. You took the tome and will make sure that it can't have any further effect on him. He throws his arms around you with a sob, holding on as if you were a life-preserver. Gently patting his back, you just stay like that for a while, providing much needed support for the young man. Somehow he just seems to attract all the crazy things in this city with an almost unavoidable pull. Good thing you're here to watch out over him...";
			now TomeFound is 23; [player told Eric the truth about him being tentacle-fucked]
			now lastTomeInteraction is turns;
		else:
			LineBreak;
			say "     You shake your head and tell Eric that you haven't seen the book. He looks disappointed, then shrugs and says, 'It'll turn up eventually, I'm sure.'";
			now TomeFound is 24; [player told tentacle fucked Eric he doesn't have the book]
			now lastTomeInteraction is turns;
	else if TomeFound is 20: [player took the book after Eric was almost tentacle-fucked]
 		say "     Eric's eyebrows draw together in thought and he asks, 'Have you seen my book, actually? I know I had it not too long ago, but not it isn't here. The last time I saw it was before I had...' He blushes prettily and is silent for a few seconds, then adds silently, '...uhm, you know. A sex dream. I can't remember it really, but... it was pretty good for a while and I think there even was something in it from the illustrations in the book...'";
		say "     [bold type]Do you want to tell Eric about the things that happened to him while he was asleep?[roman type][line break]";
		LineBreak;
		say "     ([link]Y[as]y[end link]) - Yeah, he should know.";
		say "     ([link]N[as]n[end link]) - Nah, that would really freak him out. Better just let things lie if he doesn't remember.";
		if player consents:
			LineBreak;
			say "     Reaching out to grasp Eric by the shoulder, you tell him in an earnest tone that he should sit down. He is a bit baffled at first, then readily lets you guide him to a nearby bed and sits next to you. 'Err... what's up?' he asks after a nervous swallow. You tell him what you saw in detail and that you stepped in to stop it before things got really out of hand. With every new sentence, the college student gets a little paler in the face. Tension winds tighter and tighter in him as you explain things, and when you come to an end, it eventually explodes out in a sobbed, 'WHAT?! Fuck. Fuck FUUUCK! It - it was just a book. Isn't anything safe in this damned world anymore?!'";
			say "     Doing your best to calm Eric down again, you tell him that he is safe now. You took the tome and will make sure that it can't have any further effect on him. He throws his arms around you with a sob, holding on as if you were a life-preserver. Gently patting his back, you just stay like that for a while, providing much needed support for the young man. Somehow he just seems to attract all the crazy things in this city with an almost unavoidable pull. Good thing you're here to watch out over him...";
			now TomeFound is 21; [player told Eric the truth about him being almost tentacle-fucked]
			now lastTomeInteraction is turns;
		else:
			LineBreak;
			say "     You shake your head and tell Eric that you haven't seen the book. He looks disappointed, then shrugs and says, 'It'll turn up eventually, I'm sure.'";
			now TomeFound is 22; [player told Eric he doesn't have the book]
			now lastTomeInteraction is turns;
	else if TomeFound is 21 or TomeFound is 23 or TomeFound is 101: [player told Eric the truth about him being almost/successfully tentacle-fucked]
		say "     Eric goes pale as you bring up the old tome he found. 'I - I'm sorry. Can we not talk about that... thing please? I don't even want to know. I wish I could forget all about it,' he sobs, then slowly calms down again as you put a supportive hand on his shoulder.";
	else if TomeFound is 22: [player told Eric he doesn't have the book]
		say "     Eric looks interested as you bring up the old tome. 'Oh? Have you found it? I'm really curious what it all means and want to read more in the book!' The college student's gaze has a bit of a far off quality as he says this. Seems like he's still feeling the aftereffects of the tome's influence.";
		if carried of ancient tome > 0:
			say "     [bold type]You do still have the book in your backpack. Do you want to give it back to Eric?[roman type][line break]";
			LineBreak;
			say "     ([link]Y[as]y[end link]) - Give it to him.";
			say "     ([link]N[as]n[end link]) - Nope! He's better off without having that demonic tome.";
			if player consents:
				LineBreak;
				say "     Pulling your backpack off, you dig around in it and find the thick tome. As you pull it out, Eric's eyes seem to have an inner glow for a heartbeat or two and he steps up close to you, holding out his hands with a hungry expression. Snatching the book from your grasp, he pulls it tightly to his chest and thanks you, then walks off with a thoughtful expression on his face.";
				decrease carried of ancient tome by 1;
				now TomeFound is 97; [player gave Eric the book back after he got almost tentacle-fucked]
			else:
				LineBreak;
				say "     Shaking your head slowly, you get a disappointed sigh from Eric. 'Aww... thanks anyways. I think I'll have another search for it then. It has to be somewhere!' With that, he just wanders off, looking under beds, pillows, mattresses and wherever else he imagines the book could have ended up at.";
	else if TomeFound is 24: [player told Eric he doesn't have the book (after tentacle sex)]
		say "     Eric looks interested as you bring up the old tome. 'Oh? Have you found it? I need... err, want that book back. It's such an interesting read!' The college student's gaze has a bit of a far off quality as he says this. Seems like he's still feeling the aftereffects of the tome's influence. Apparently this includes a fair bit of arousal, as one of his hands wanders down to the college student's crotch and casually strokes between his legs. You don't think he's even fully aware that he is doing that.";
		if carried of ancient tome > 0:
			say "     [bold type]You do still have the book in your backpack. Do you want to give it back to Eric?[roman type][line break]";
			LineBreak;
			say "     ([link]Y[as]y[end link]) - Give it to him.";
			say "     ([link]N[as]n[end link]) - Nope! He's better off without having that demonic tome.";
			if player consents:
				LineBreak;
				say "     Pulling your backpack off, you dig around in it and find the thick tome. As you pull it out, Eric's eyes seem to have an inner glow for a heartbeat or two and he steps up close to you, holding out his hands with a hungry expression. Snatching the book from your grasp, he pulls it tightly to his chest and thanks you, then walks off with a thoughtful expression on his face.";
				decrease carried of ancient tome by 1;
				now TomeFound is 96; [player gave Eric the book back after he got tentacle-fucked]
			else:
				LineBreak;
				say "     Shaking your head slowly, you get a disappointed scowl from Eric. He grumbles, 'Damn! I think I'll have another search for it then. It has to be somewhere!' With that, he just wanders off, looking under beds, pillows, mattresses and wherever else he imagines the book could have ended up at.";
	else if TomeFound is 96: [Eric was given the book back, got tentacle fucked before]
		say "     Eric nods and smiles as you bring up the book he found. 'It is an amazing read. Thank you so much for bringing it back to me! I feel like I'm really close to understanding parts of it. And the pictures in there are... something else entirely. I even dream of them.' Seems like he's well under the tome's influence by now. Apparently this includes a fair bit of arousal, as one of his hands wanders down to the college student's crotch and casually strokes between his legs. You don't think he's even fully aware that he is doing that.";
		say "     [bold type]Do you want to convince Eric to hand the old tome over to you?[roman type][line break]";
		LineBreak;
		say "     ([link]Y[as]y[end link]) - Yeah, better confiscate that thing for now.";
		say "     ([link]N[as]n[end link]) - Nah, let him have his fun with it.";
		if player consents:
			LineBreak;
			say "     Clearing your throat, you ask Eric if you can have the book - and he doesn't react to that at all, almost as if he hadn't heard a word you said. After waiting a moment or two, you finally decide to just take it. Walking over to his bed, look for the book - under his pillow, then even under the mattress. Nothing. You're about to start going through Eric's other possessions when he clears his throat behind you. 'Are you looking for something?' he asks in an uncharacteristically dangerous tone, his eyes glowing a little from the inside. Swallowing at that sight, you slowly stand up from your crouch and shake your head - which instantly returns Eric to his normal, cheery self. He shakes his head a little to clear it, then smiles and says, 'Great! Where were we...' The conversation that follows is a little bit eerie, with Eric seemingly having forgotten about the whole episode about the book as soon as it was finished.";
			now lastTomeInteraction is turns;
		else:
			LineBreak;
			say "     You let the matter go with a shrug and tell Eric that he can let you know what he learns later on.";
	else if TomeFound is 97: [Eric was given the book back, got almost-fucked before]
		say "     Eric nods and smiles as you bring up the book he found. 'It is a really interesting read. I mean... I can't really understand the symbols, but... somehow it feels like I'm really close. And the pictures in there are something else entirely. And... I sometimes dream of them too.' He glances over to his bed, where you see the thick leather-bound volume lie halfway under his pillow. Remembering what happened last time, you wonder if it was such a good idea to hand that thing back to him.";
		say "     [bold type]Do you want to convince Eric to hand the old tome over to you?[roman type][line break]";
		LineBreak;
		say "     ([link]Y[as]y[end link]) - Yeah, better confiscate that thing for now.";
		say "     ([link]N[as]n[end link]) - Nah, let him have his fun with it.";
		if player consents:
			LineBreak;
			say "     Clearing your throat, you ask Eric if you can have the book - and he doesn't react to that at all, almost as if he hadn't heard a word you said. After waiting a moment or two, you finally decide to just take it. Walking over to his bed, you pull the book out from under Eric's pillow and tugging the tome under your arm. 'Hey!' Eric reacts with a slight delay, coming after you. 'I was reading that, give it back!' the red-headed college student complains, but you tell him in a friendly, but firm, tone that you'll have to check this thing out for yourself first. He reaches out in a bid to snatch the book back, but you keep it out of his reach. Finally he crosses his arms and sighs, then adds, 'Fine. I'll get something else to read then.' With a somewhat sullen expression on his face, Eric walks off towards the stairwell.";
			increase carried of ancient tome by 1;
			say "(You gain an ancient tome.)";
			now TomeFound is 99; [player took the book after Eric had a read]
			now lastTomeInteraction is turns;
		else:
			LineBreak;
			say "     You let the matter go with a shrug and tell Eric that he can let you know what he learns later on.";
	else if TomeFound is 98: [player took the book after Eric was tentacle fucked (unknown to the player) ]
		say "     Eric looks very interested as you bring up the old tome. 'Oh? Are... are you done with it now? I'd like to have it back!' The college student's gaze has a bit of a far off quality as he says this. Seems like he's still feeling the after-effects of the tome's influence. Apparently this includes a fair bit of arousal, as one of his hands wanders down to the college student's crotch and casually strokes between his legs. You don't think he's even fully aware that he is doing that.";
		if carried of ancient tome > 0:
			say "     [bold type]You do still have the book in your backpack. Do you want to give it back to Eric?[roman type][line break]";
			LineBreak;
			say "     ([link]Y[as]y[end link]) - Give it to him.";
			say "     ([link]N[as]n[end link]) - Nope! He's better off without having that demonic tome.";
			if player consents:
				LineBreak;
				say "     Pulling your backpack off, you dig around in it and find the thick tome. As you pull it out, Eric's eyes seem to have an inner glow for a heartbeat or two and he steps up close to you, holding out his hands with a hungry expression. Snatching the book from your grasp, he pulls it tightly to his chest and thanks you, then walks off with a thoughtful expression on his face.";
				decrease carried of ancient tome by 1;
				now TomeFound is 3; [player gave Eric the book back after he got almost tentacle-fucked, so same state as never having taken the book at all]
			else:
				LineBreak;
				say "     Shaking your head slowly, you get a disappointed sigh from Eric. 'Aww... thanks anyways. I think I'll have another search for it then. It has to be somewhere!' With that, he just wanders off, looking under beds, pillows, mattresses and wherever else he imagines the book could have ended up at.";
	else if TomeFound is 99: [player took the book after Eric started reading               ]
		say "     Eric looks interested as you bring up the old tome. 'Oh? Are you done with it? I'm really curious what it all means and want to read more in the book!' The college student's gaze has a bit of a far off quality as he says this.";
		if carried of ancient tome > 0:
			say "     [bold type]You do still have the book in your backpack. Do you want to give it back to Eric?[roman type][line break]";
			LineBreak;
			say "     ([link]Y[as]y[end link]) - Give it to him.";
			say "     ([link]N[as]n[end link]) - Nope! He's better off without having that demonic tome.";
			if player consents:
				LineBreak;
				say "     Pulling your backpack off, you dig around in it and find the thick tome. As you pull it out, Eric's eyes seem to have an inner glow for a heartbeat or two and he steps up close to you, holding out his hands with a hungry expression. Snatching the book from your grasp, he pulls it tightly to his chest and thanks you, then walks off with a thoughtful expression on his face.";
				decrease carried of ancient tome by 1;
				now TomeFound is 2; [Eric is back to reading the tome]
			else:
				LineBreak;
				say "     Shaking your head slowly, you get a disappointed sigh from Eric. 'Aww... thanks anyways. I hope you'll give it back to me when you're done, alright?' You tell him that you'll have to see when that is and he accepts that somewhat impatiently, then talks to you about other things for a little while.";
	else if TomeFound is 100: [Eric never opened the book before]
		say "     Eric looks interested as you bring up the old tome. 'Oh? Are you done with it? I still wanna have a look at it sometime.'";
		if carried of ancient tome > 0:
			say "     [bold type]You do still have the book in your backpack. Do you want to give it back to Eric?[roman type][line break]";
			LineBreak;
			say "     ([link]Y[as]y[end link]) - Give it to him.";
			say "     ([link]N[as]n[end link]) - Nope! He's better off without it.";
			if player consents:
				LineBreak;
				say "     Pulling your backpack off, you dig around in it and find the thick tome. As you pull it out, Eric steps up and thanks you as he accepts the book. He exchanges some more words in friendly conversation with you, then walks off with the book held tightly to his chest.";
				decrease carried of ancient tome by 1;
				now TomeFound is 1; [Eric got the book now]
			else:
				LineBreak;
				say "     Shaking your head slowly, you get a disappointed sigh from Eric. 'Aww... thanks anyways. I hope you'll give it to me when you're done, alright?' You tell him that you'll have to see when that is and he accepts that, then talks to you about other things for a little while.";

[ TomeFound  - Tracking variable for interaction with Eric                             ]
[   0: not found                                                                       ]
[   1: Eric got the book                                                               ]
[   2: Eric is reading the book                                                        ]
[   3: Eric is was tentacle-fucked, player saw nothing                                 ]
[   4: Eric is was tentacle-fucked, player watched                                     ]
[  20: player took the book after Eric was almost tentacle-fucked                      ]
[  21: player told Eric the truth about him being almost tentacle-fucked               ]
[  22: player told Eric he doesn't have the book                                       ]
[  23: player told Eric the truth about him being tentacle fucked                      ]
[  24: player told Eric he doesn't have the book (after tentacle fucking)              ]
[  97: player gave Eric the book back after he got almost tentacle-fucked              ]
[  98: player took the book after Eric was tentacle fucked (unknown to the player)     ]
[  99: player took the book after Eric had a read                                      ]
[ 100: player took the book right from the start                                       ]
[ 101: Eric is afraid of the book and was offered it back before                       ]

to say centaurcum_Eric:
	say "     You hand your bottle of centaur stallion cum to Eric, who puts it to his lips after a nod of encouragement from you and takes a deep pull. You wait several minutes, during which his hopeful expression slowly begins to wane as nothing happens - until suddenly, he's wracked by a convulsion. You hold Eric tightly so he doesn't fall off his camp bed until he relaxes a short time later. Looking down at the new bulge in his shorts, it's clear at least something happened.";
	say "     Opening the zipper of his shorts, you pull them down to reveal his crotch - now pussy-less, but with a new blunt-tipped horse's cock and large balls. To help Eric accept being an - almost human - male again, you grab his erect newly grown member with both hands and pump them up and down on it. Encouraged by his lustful moans, you keep jerking him off and play with his balls with one hand. Pretty soon, his thick shaft pulses in your hand, and large globs of white seed blast out of the tip of his horsecock and all over Eric's chest. As he lies back on his bed, you hear him pant 'Thank you.'";
	delete centaur cum;
	now HP of Eric is 21;
	now thirst of Eric is 21;

to say satyrwine_Eric:
	say "     You hand your bottle of satyr wine to Eric, who puts it to his lips after a nod of encouragement from you and takes a deep pull. You wait several minutes, during which his hopeful expression slowly begins to wane as nothing happens - until suddenly, he's wracked by a convulsion. You hold Eric tightly so he doesn't fall off his camp bed until he relaxes a short time later. Looking down at the new bulge in his shorts, it's clear at least something happened.";
	say "     Opening the zipper of his shorts, you pull them down to reveal his crotch - now pussy-less, but with a new capric, goat-like cock and large balls. To help Eric accept being an - almost human - male again, you grab his erect newly grown member with both hands and pump them up and down on it. Encouraged by his lustful moans, you keep jerking him off and play with his balls with one hand. Pretty soon, his thick shaft pulses in your hand, and large globs of white seed blast out of the tip of his satyrcock and all over Eric's chest. As he lies back on his bed, you hear him pant 'Thank you.'";
	delete Satyr Wine;
	now HP of Eric is 31;
	now thirst of Eric is 31;


instead of trading the pomegranate seed when the current action involves the Eric:
	if Dexterity of Erica is not 4:
		say "     Error E1: Something went wrong, Eric's variables are not correctly set. Please report how you saw this.";
	else:
		say "     Handing Eric the small seed, you recount what you had to go through to get it, which prompts the young man to give you a hug while he thanks you again and again. 'You're just... the best,' he continues, then looks down at the divine artifact in his hand. 'I guess this is the time then. I'm so excited.' With a beaming smile at you, he then brings the seed to his mouth and puts it on his tongue - which is when the college student's eyes widen in delight. 'Mmmm, tashtes amashing,' he hums to you with half-closed lips, lost in a little food-gasm in his mouth before he swallows Hera's gift down. As he does so, a golden shimmer fills the air around him and his form shifts in just an eye-blink or three.";
		say "     It begins at the face, which softens a bit and takes on feminine features with oh so kissable lips, and suddenly is framed in shoulder-length red curls. The wave of change then runs down over his body, making the black t-shirt Eric is wearing fill out at the front, with the curve of perky B-cup breasts making you eager for a chance to see them laid bare. What follows next are many more big and small changes - the proportions of arms and legs, hands and feet, a slight widening of the hips to ease future pregnancies, his skin smoothing out and becoming naturally hairless. Even simple things like the way he stands or holds his upper body. When the transformation finishes a moment later, you're almost stunned by the sight of this beautiful woman you helped bring into the world. Your friend is no longer Eric, no he - now she - is Erica.";
		WaitLineBreak;
		say "     After Erica looks down over herself and gives a delighted little giggle at her new body, she rushes forward to embrace you tightly - which brings her perky breasts into contact with your chest, pressing softly against you. 'Wow, this feels even better than I...' This is as far as she gets, before noticing the sensations of brushing her nipples against someone with only a thin shirt in between. 'Oh - ooh,' she sighs softly, pulling back slightly, then continues, 'That feels amazing. I - thank you so much, but... I think I've got to experiment a bit with this. Though if you want me to give you a reward for all your hard work... I'd be more than willing to have some fun later, you know.'";
		decrease carried of pomegranate seed by 1;
		now Dexterity of Erica is 5;
		now HP of Eric is 200;
		move Erica to Bunker;
		remove Eric from play;
		if CarlEricInteraction > 0: [Carl knows Eric]
			now CarlEricaInteraction is 1; [Carl knew Erica as Eric]
		if David is in bunker:
			now lust of Erica is 50;

Section 3 - Fucking Eric

Instead of fucking the Eric:
	say "[BasicEricSex]";

to say BasicEricSex:
	if HP of Eric is 21 or HP of Eric is 22:
		setmonster "Centaur Stallion";
		choose row monster from the table of random critters;
	else if HP of Eric is 31 or HP of Eric is 32:
		setmonster "Satyr";
		choose row monster from the table of random critters;
	if (HP of Eric is 0): [virgin - in the lockerroom]
		if (cocks of player > 0):
			say "     As you approach Eric and ask him if he wants some fun, his gaze drops down to your crotch and he hesitates. Swallowing hard and turning rather red in the face, he then shakes his head, saying 'I - I can't - I mean - I'm not gay. But thanks for the offer.'";
		else if (cunts of player > 0):
			say "     Eric approaches you smiling as you make him an offer for some good time together. But then suddenly, he remembers something and his face turns red in embarrassment. Stuttering 'I - I'm sorry, I'm not in the mood.' he steps back, turning away from you.";
	else if (HP of Eric is 1): [virgin in the bunker]
		say "     Eric is rather evasive as you offer to take him to bed, his face getting red in embarrassment about his situation. Maybe you should talk to him about it a bit first.";
	else if (HP of Eric is 10 or HP of Eric is 12 or HP of Eric is 14): [virgin, accepted being a cuntboy, or been fucked by Rane, or been fucked by another NPC]
		if (cocks of player > 0):
			say "     Stepping up to Eric, you embrace him and give him a deep kiss. When you come back up for air, you look deep into his eyes and ask him if he wants to have sex with you[if HP of Eric is 10], let you take his virginity[end if]. There's only a short moment of hesitation, then Eric nods and leans his head forward to kiss you back.";
			say "     You two make out for a moment, holding on to each other. In between playful tongue-wrestling, you let your hands wander all over him, feeling up his slender but muscled body and giving the nice firm buns of his ass a slight squeeze. No matter what he may be packing inside his shorts, Eric still has the build of a young male athlete. Eager to get get to know him more intimately, you grab him by the hand and lead him to your bunk.";
			say "     Eric quickly takes off his shoes and socks, then pulls off his shirt and throws it aside, revealing a nicely defined chest. You follow suit, rapidly sliding off your own clothing, then step close to your waiting partner. Running your hands over his chest, you make him gasp for a second as you brush over his nipples. Seems like your handsome cuntboy has gotten quite sensitive there. With a smile on your face you lean down and run your tongue over his chest, then circle each of his nipples with its tip and finally suck on them. Making Eric pant in lust is a lot of fun, and with your nose pressed against his warm skin you also take a deep breath of his masculine scent with its underlying female note.";
			WaitLineBreak;
			say "     Feeling Eric's readiness to move on, you soon push him back softly to make him sit, then lie on your camp bed. Then you move your hands to the band of his shorts, pulling them down over his long runner's legs as he raises his ass a bit to let the fabric slide over it. Under them, a flimsy white tanga comes into view, making Eric show a moment of embarrassment again as he says 'My old briefs were too... roomy... in the front.' You lean in for a quick kiss, telling him 'You look really hot in them.' and then slide the thin underwear off him too.";
			say "     Now fully naked, Eric looks up from the bed to you, his yes inevitably drawn to your by now rock-hard cock. With an inviting smile he spreads his legs for you, the lips of his slightly swollen pussy glistening with his female juices. Eagerly, you climb on the bed with him, stroking his smooth legs as you kneel between them. Eric gasps as your dick touches his pussy the first time, followed by rapid panting as you rub up and down against its folds. Then you put your cock-head against his opening and slowly push forward, moaning in lust yourself as his nether lips spread for you, enveloping your shaft in a warm tight embrace.";
			if HP of Eric is 10: [virgin]
				say "     Sliding deeper into him, your progress soon meets resistance as your cock pushes against a soft flexible barrier inside him - Eric's hymen. You lean down and put your arms around him then find his lips with yours and give him a deep kiss. While distracting him with some playful tongue-wrestling, you push forward with your hips, increasing the pressure until you break through the thin flesh and make a real woman - or rather cuntboy - out of him.";
			WaitLineBreak;
			say "     You rest your hard shaft inside Eric for a moment to allow him to get used to it, then start moving in and out, moaning in unison with your handsome athlete. His legs wrap around your hips and pull you tight against him with each of your thrusts. Fucking this tight pussy has you incredibly aroused and you have to control yourself pretty hard to last a bit longer. And you're not the only one - soon Eric's moans and groans rise to a pretty noisy climax and you feel the femcum in his pussy around your cock. He pulls you down on top of him, going for a breathtaking kiss, then whispers 'Finish it - come inside me.'";
			say "     Giving him another quick kiss on the lips, you eagerly follow his request and pump your hips up and down rapidly, thrusting hard and deep into his body. With your cock already primed and ready to go, it takes just a few more thrusts for the cum to boil up from your balls and pulse through your cock in spurt after spurt. You fill Eric's pussy with your fertile seed, feeling a deep satisfaction as you imagine the millions of little swimmers invading his womb in search of an egg.";
			say "     Your cock still inside him, the two of you move to lie on your sides on the bed, holding each other and reveling in post-coital bliss. Lying there, Eric softly strokes your side and says 'That was amazing - thank you.'";
			if HP of Eric is 12: [Rane fucked him first]
				now HP of Eric is 13; [player fucked him - after Rane was there already]
			else if HP of Eric is 14: [another NPC fucked him first]
				now HP of Eric is 15;
			else: [virgin]
				now HP of Eric is 11; [player fucked him and took his virginity]
				now EricVirginityTaken is 1; [player did the deed]
			now thirst of Eric is 11;
			now lastfuck of Eric is turns;
		else:
			say "     Stepping up to Eric, you embrace him and give him a deep kiss. He practically melts into your arms as you hold him, eagerly returning your attentions with more kisses while his hands roam over your body. Looks like he's ready and willing to [if HP of Eric is 10]lose his virginity now[else]be fucked now[end if] - too bad you don't have the right 'equipment' for that at the moment... better try again later once you've gotten a cock to fuck him with.";
	else if (HP of Eric is 11 or HP of Eric is 13 or HP of Eric is 15): [cuntboy repeat sex]
		if (lastfuck of Eric - turns < 6):
			say "     As you approach Eric, he immediately sees the lust-filled twinkle in your eyes. Running a hand up the side of your arm and stroking your cheek, he says 'I love you baby, but I need some rest in between. Can we play another time?' He gives you a soft kiss on the lips as you nod, already thinking about what you want to do with him later.";
		else:
			say "     You walk over to Eric, who immediately starts smiling as he sees the lust-filled twinkle in your eyes. Throwing his arms around you, his lips find yours for a quick kiss, then he suggestively nods over to his bunk.";
			wait for any key;
			say "[EricSexMenu]";
	else if (HP of Eric is 20): [virgin, hoping for a cure]
		say "     Eric is rather evasive as you offer to take him to bed, his face getting red in embarrassment about his situation. 'I- I thought you were going to get me a cure? Or did you check and there no way to fix this? I worry I might get stuck like this if I - you know - use it...'";
		say "     Do you want to tell Eric to hold out a little longer and that you'll find him something to make him a man again? Or should he learn to accept his new shape? (Y = hold out; N = accept the pussy)";
		if player consents: [search for a cure]
			say "     You exchange some calming words with Eric, telling him that you'll of course find a cure for him. He nods to you then goes back to his camp bed to lie down, still looking a bit worried.";
		else: [make him accept being a cuntboy]
			say "     You calmly tell Eric that there is no sure way back for him and that it might be best to accept what he's become. His face falls as you say that, his expression showing disappointment and fear. To cheer him up a bit again, you remind him how good he felt when Stacy rubbed his pussy, to which he reluctantly agrees. Best to give him some time to think about it - maybe he'll be ready for some fun later.";
			now HP of Eric is 10;
	else if (HP of Eric is 21): [male with virgin horse-cock]
		say "     Stepping up to Eric, you lower your hand to the front of his shorts and rub against the bulge in its fabric, feeling his balls and flaccid cock. It doesn't stay that way for long though, growing into a truly impressive trouser snake as his body reacts to your touch.";
		say "     'Why don't we take this bad boy for a little spin - make you a real man again,' you tell him as you slide your hand under the band of his shorts and grab grab hold of his thick cock. Eric can only pant and nod eagerly as you fondle the organ where all the blood for his brain went. With a big smile on your face you lead him to his bed and peel all clothing off Eric's athletic human body.";
		say "     Well, mostly human - the cock between his legs looks like it belongs to a horse... it's pretty long, with an animalistic pattern of black and white and shows a band of skin around the lower third that must be Eric's equine sheath. The tip flares outwards proudly at the end, making you wonder how it will compare to a human manhood. Two massive black balls hang below it, looking ready to deliver a deluge of cum.";
		WaitLineBreak;
		say "     Eager to take the virginity of Eric's new equipment, you softly push him down to lie on the bed and grab hold of his horsecock with both hands. It's an impressive piece of anatomy, firm and warm in your hands as you stroke up and down on it. Not wanting to wait any longer, you quickly remove your clothes, then climb up on the bed with Eric.";
		if cocks of player > 0 and cunts of player > 0: [herms may choose]
			say "     Kneeling over him with your legs both sides of his hips, you feel the warmth radiating off his proudly erect cock. What do you want to use to deflower Eric? (Y = pussy, N = ass)";
			if player consents:
				say "     You grab hold of his thick shaft and hold it up so the flared head strokes your nether lips and slowly lower yourself on it, gasping as he enters your body. It's just amazing to feel his animalistic member slide up against your insides, which has both of you moaning and panting in lust. Then, as he bottoms out and you feel his massive balls against your skin, you lean down and give him a deep kiss.";
				say "     Sitting back up, you moan 'Let's ride, horseboy.' and start sliding up and down on Eric's long shaft. With its inhuman shape and the length and girth his horsecock has, you get rubbed in spots you barely know you had and have a very pleasant sensation of fullness. Below you, Eric is panting and moaning deeply, obviously overwhelmed by the novel experience of fucking with a horsecock. He grabs your hips, pulling you down harder against himself with each slide down and meeting your hips with an upwards thrust of his own.";
				WaitLineBreak;
				say "     After a pleasant time riding his cock, Eric pulls you to a stop with his cock buried all the way inside you and asks you to get on all fours on the bunk. Looks like he's inherited some urges from the centaur donor of his 'cure'. With a satisfied grunt, Eric mounts your pussy from behind, just as his body is telling him it's supposed to go. He puts his arms around you, feeling up your chest and kissing your neck as he bottoms out inside you. Then he starts all-out rutting, his shaft sliding in and out of your pussy hard and deep. You climax from this animalistic fuck, having a mind-blowing orgasm that leaves your pussy dripping with female juices. Not too long after, Eric follows suit, filling your womb with a massive load of his fertile seed.[fimpregchance]";
				say "     With the thick shaft of his cock still pulsing softly inside you as it spurts more cum, Eric pulls you down to lie on your sides on the bed together. In between panting for breath, he gives you another kiss on the neck and says 'That was... wow. Thank you so much for helping me fix this.' followed by a last little thrust of his manhood into you.";
			else:
				say "     You grab hold of his thick shaft and hold it up so the flared head strokes against your asshole and slowly lower yourself on it, gasping as he enters your body. It's just amazing to feel his animalistic member slide up against your insides, which has both of you moaning and panting in lust. Then, as he bottoms out and you feel his massive balls against your skin, you lean down and give him a deep kiss.";
				say "     Sitting back up, you moan 'Let's ride, horseboy.' and start sliding up and down on Eric's long shaft. With its inhuman shape and the length and girth his horsecock has, you get rubbed in spots you barely know you had and have a very pleasant sensation of fullness. Below you, Eric is panting and moaning deeply, obviously overwhelmed by the novel experience of fucking with a horsecock. He grabs your hips, pulling you down harder against himself with each slide down and meeting your hips with an upwards thrust of his own.";
				WaitLineBreak;
				say "     After a pleasant time riding his cock, Eric pulls you to a stop with his cock buried all the way inside you and asks you to get on all fours on the bunk. Looks like he's inherited some urges from the centaur donor of his 'cure'. With a satisfied grunt, Eric mounts your ass from behind, just as his body is telling him it's supposed to go. He puts his arms around you, feeling up your chest and kissing your neck as he bottoms out inside you. Then he starts all-out rutting, his shaft sliding in and out of your tight hole in hard and deep moves. You quickly climax from this animalistic fuck, having a mind-blowing orgasm that makes you spray your load all over the sheets of the bunk. Not too long after, Eric follows suit, filling your hole with a massive load of his fertile seed.[mimpregchance]";
				say "     With the thick shaft of his cock still pulsing softly inside you as it spurts more cum, Eric pulls you down to lie on your sides on the bed together. In between panting for breath, he gives you another kiss on the neck and says 'That was... wow. Thank you so much for helping me fix this.' followed by a last little thrust of his manhood into you.";
		else if cocks of player > 0: [male]
			say "     You grab hold of his thick shaft and hold it up so the flared head strokes against your asshole and slowly lower yourself on it, gasping as he enters your body. It's just amazing to feel his animalistic member slide up against your insides, which has both of you moaning and panting in lust. Then, as he bottoms out and you feel his massive balls against your skin, you lean down and give him a deep kiss.";
			say "     Sitting back up, you moan 'Let's ride, horseboy.' and start sliding up and down on Eric's long shaft. With its inhuman shape and the length and girth his horsecock has, you get rubbed in spots you barely know you had and have a very pleasant sensation of fullness. Below you, Eric is panting and moaning deeply, obviously overwhelmed by the novel experience of fucking with a horsecock. He grabs your hips, pulling you down harder against himself with each slide down and meeting your hips with an upwards thrust of his own.";
			WaitLineBreak;
			say "     After a pleasant time riding his cock, Eric pulls you to a stop with his cock buried all the way inside you and asks you to get on all fours on the bunk. Looks like he's inherited some urges from the centaur donor of his 'cure'. With a satisfied grunt, Eric mounts your ass from behind, just as his body is telling him it's supposed to go. He puts his arms around you, feeling up your chest and kissing your neck as he bottoms out inside you. Then he starts all-out rutting, his shaft sliding in and out of your tight hole in hard and deep moves. You quickly climax from this animalistic fuck, having a mind-blowing orgasm that makes you spray your load all over the sheets of the bunk. Not too long after, Eric follows suit, filling your hole with a massive load of his fertile seed.[mimpregchance]";
			say "     With the thick shaft of his cock still pulsing softly inside you as it spurts more cum, Eric pulls you down to lie on your sides on the bed together. In between panting for breath, he gives you another kiss on the neck and says 'That was... wow. Thank you so much for helping me fix this.' followed by a last little thrust of his manhood into you.";
		else if cunts of player > 0: [female]
			say "     You grab hold of his thick shaft and hold it up so the flared head strokes your nether lips and slowly lower yourself on it, gasping as he enters your body. It's just amazing to feel his animalistic member slide up against your insides, which has both of you moaning and panting in lust. Then, as he bottoms out and you feel his massive balls against your skin, you lean down and give him a deep kiss.";
			say "     Sitting back up, you moan 'Let's ride, horseboy.' and start sliding up and down on Eric's long shaft. With its inhuman shape and the length and girth his horsecock has, you get rubbed in spots you barely know you had and have a very pleasant sensation of fullness. Below you, Eric is panting and moaning deeply, obviously overwhelmed by the novel experience of fucking with a horsecock. He grabs your hips, pulling you down harder against himself with each slide down and meeting your hips with an upwards thrust of his own.";
			WaitLineBreak;
			say "     After a pleasant time riding his cock, Eric pulls you to a stop with his cock buried all the way inside you and asks you to get on all fours on the bunk. Looks like he's inherited some urges from the centaur donor of his 'cure'. With a satisfied grunt, Eric mounts your pussy from behind, just as his body is telling him it's supposed to go. He puts his arms around you, feeling up your chest and kissing your neck as he bottoms out inside you. Then he starts all-out rutting, his shaft sliding in and out of your pussy hard and deep. You climax from this animalistic fuck, having a mind-blowing orgasm that leaves your pussy dripping with female juices. Not too long after, Eric follows suit, filling your womb with a massive load of his fertile seed.[fimpregchance]";
			say "     With the thick shaft of his cock still pulsing softly inside you as it spurts more cum, Eric pulls you down to lie on your sides on the bed together. In between panting for breath, he gives you another kiss on the neck and says 'That was... wow. Thank you so much for helping me fix this.' followed by a last little thrust of his manhood into you.";
		else: [neuter]
			say "     You grab hold of his thick shaft and hold it up so the flared head strokes against your asshole and slowly lower yourself on it, gasping as he enters your body. It's just amazing to feel his animalistic member slide up against your insides, which has both of you moaning and panting in lust. Then, as he bottoms out and you feel his massive balls against your skin, you lean down and give him a deep kiss.";
			say "     Sitting back up, you moan 'Let's ride, horseboy.' and start sliding up and down on Eric's long shaft. With its inhuman shape and the length and girth his horsecock has, you get rubbed in spots you barely know you had and have a very pleasant sensation of fullness. Below you, Eric is panting and moaning deeply, obviously overwhelmed by the novel experience of fucking with a horsecock. He grabs your hips, pulling you down harder against himself with each slide down and meeting your hips with an upwards thrust of his own.";
			WaitLineBreak;
			say "     After a pleasant time riding his cock, Eric pulls you to a stop with his cock buried all the way inside you and asks you to get on all fours on the bunk. Looks like he's inherited some urges from the centaur donor of his 'cure'. With a satisfied grunt, Eric mounts your ass from behind, just as his body is telling him it's supposed to go. He puts his arms around you, feeling up your chest and kissing your neck as he bottoms out inside you. Then he starts all-out rutting, his shaft sliding in and out of your tight hole in hard and deep moves. You quickly climax from this animalistic fuck, your body shaking from the pleasant sensations. Not too long after, Eric follows suit, filling your hole with a massive load of his fertile seed.";
			say "     With the thick shaft of his cock still pulsing softly inside you as it spurts more cum, Eric pulls you down to lie on your sides on the bed together. In between panting for breath, he gives you another kiss on the neck and says 'That was... wow. Thank you so much for helping me fix this.' followed by a last little thrust of his manhood into you.";
		now HP of Eric is 22;
	else if (HP of Eric is 22): [male with horse-cock repeats]
		if (lastfuck of Eric - turns < 6):
			say "     As you approach Eric, he immediately sees the lust-filled twinkle in your eyes. Pulling you close against his body, he gives you a deep kiss, playfully wrestling your tongue with his. But then as you lower your hands to stroke the bulge in his shorts, he pulls away, taking your hand in his and giving you an apologetic look. 'I'd love to, baby... but honestly, I need a break. With the size of this bad boy you've gotten me, I get a bit woozy if I use it too many hours a day. There's only so much blood to go around in a man, you know...'";
		else:
			say "     You walk over to Eric, who immediately starts smiling as he sees the lust-filled twinkle in your eyes. Throwing his arms around you, his lips find yours for a quick kiss, then he suggestively nods over to his bunk.";
			wait for any key;
			say "[EricSexMenu]";
	else if (HP of Eric is 31): [male with virgin satyr-cock]
		say "     Stepping up to Eric, you lower your hand to the front of his shorts and rub against the bulge in its fabric, feeling his balls and flaccid cock. It doesn't stay that way for long though, growing into a truly impressive trouser snake as his body reacts to your touch.";
		say "     'Why don't we take this bad boy for a little spin - make you a real man again,' you tell him as you slide your hand under the band of his shorts and grab grab hold of his thick cock. Eric can only pant and nod eagerly as you fondle the organ where all the blood for his brain went. With a big smile on your face you lead him to his bed and peel all clothing off Eric's athletic human body.";
		say "     Well, mostly human - the cock between his legs looks like it belongs to a satyr... it's pretty long, with an animalistic shape and scent, and shows a bundle of red-furred skin around the lower third that must be Eric's goat-like sheath. The tip comes to a bit of a point, jutting forwards proudly at the end, making you wonder how it will compare to a human manhood. Two massive balls, also covered in red fur, hang below it, looking ready to deliver a deluge of cum.";
		WaitLineBreak;
		say "     Eager to take the virginity of Eric's new equipment, you softly push him down to lie on the bed and grab hold of his satyrcock with both hands. It's an impressive piece of anatomy, firm and warm in your hands as you stroke up and down on it. Not wanting to wait any longer, you quickly remove your clothes, then climb up on the bed with Eric.";
		if cocks of player > 0 and cunts of player > 0: [herms may choose]
			say "     Kneeling over him with your legs both sides of his hips, you feel the warmth radiating off his proudly erect cock. What do you want to use to deflower Eric? (Y = pussy, N = ass)";
			if player consents:
				say "     You grab hold of his thick shaft and hold it up so the leaking head strokes your nether lips and slowly lower yourself on it, gasping as he enters your body. It's just amazing to feel his animalistic member slide up against your insides, which has both of you moaning and panting in lust. Then, as he bottoms out and you feel his massive balls against your skin, you lean down and give him a deep kiss.";
				say "     Sitting back up, you moan 'Give it to me, satyrboy.' and start sliding up and down on Eric's long shaft. With its inhuman shape and the added length his satyrcock has, you get rubbed in spots you barely know you had and have a very pleasant sensation of fullness. Below you, Eric is panting and moaning deeply, obviously overwhelmed by the novel experience of fucking with a goat cock. He grabs your hips, pulling you down harder against himself with each slide down and meeting your hips with an upwards thrust of his own.";
				WaitLineBreak;
				say "     After a pleasant time riding his cock, Eric pulls you to a stop with his cock buried all the way inside you and asks you to get on all fours on the bunk. Looks like he's inherited some added virility from the satyr wine. With a satisfied grunt, Eric mounts your pussy from behind, just as his body is telling him it's supposed to go. He puts his arms around you, feeling up your chest and kissing your neck as he bottoms out inside you. Then he starts all-out rutting, his shaft sliding in and out of your pussy hard and deep. You climax from this animalistic fuck, having a mind-blowing orgasm that leaves your pussy dripping with female juices. Not too long after, Eric follows suit, filling your womb with a massive load of his fertile seed.[fimpregchance]";
				say "     With the thick shaft of his cock still pulsing softly inside you as it spurts more cum, Eric pulls you down to lie on your sides on the bed together. In between panting for breath, he gives you another kiss on the neck and says 'That was... wow. Thank you so much for helping me fix this.' followed by a last little thrust of his manhood into you.";
			else:
				say "     You grab hold of his thick shaft and hold it up so the leaking head strokes against your asshole and slowly lower yourself on it, gasping as he enters your body. It's just amazing to feel his animalistic member slide up against your insides, which has both of you moaning and panting in lust. Then, as he bottoms out and you feel his massive balls against your skin, you lean down and give him a deep kiss.";
				say "     Sitting back up, you moan 'Give it to me, satyrboy.' and start sliding up and down on Eric's long shaft. With its inhuman shape and the added length his satyrcock has, you get rubbed in spots you barely know you had and have a very pleasant sensation of fullness. Below you, Eric is panting and moaning deeply, obviously overwhelmed by the novel experience of fucking with a goat cock. He grabs your hips, pulling you down harder against himself with each slide down and meeting your hips with an upwards thrust of his own.";
				WaitLineBreak;
				say "     After a pleasant time riding his cock, Eric pulls you to a stop with his cock buried all the way inside you and asks you to get on all fours on the bunk. Looks like he's inherited some added virility from the satyr wine. With a satisfied grunt, Eric mounts your ass from behind, just as his body is telling him it's supposed to go. He puts his arms around you, feeling up your chest and kissing your neck as he bottoms out inside you. Then he starts all-out rutting, his shaft sliding in and out of your tight hole in hard and deep moves. You quickly climax from this animalistic fuck, having a mind-blowing orgasm that makes you spray your load all over the sheets of the bunk. Not too long after, Eric follows suit, filling your hole with a massive load of his fertile seed.[mimpregchance]";
				say "     With the thick shaft of his cock still pulsing softly inside you as it spurts more cum, Eric pulls you down to lie on your sides on the bed together. In between panting for breath, he gives you another kiss on the neck and says 'That was... wow. Thank you so much for helping me fix this.' followed by a last little thrust of his manhood into you.";
		else if cocks of player > 0: [male]
			say "     You grab hold of his thick shaft and hold it up so the leaking head strokes against your asshole and slowly lower yourself on it, gasping as he enters your body. It's just amazing to feel his animalistic member slide up against your insides, which has both of you moaning and panting in lust. Then, as he bottoms out and you feel his massive balls against your skin, you lean down and give him a deep kiss.";
			say "     Sitting back up, you moan 'Give it to me, satyrboy.' and start sliding up and down on Eric's long shaft. With its inhuman shape and the added length his satyrcock has, you get rubbed in spots you barely know you had and have a very pleasant sensation of fullness. Below you, Eric is panting and moaning deeply, obviously overwhelmed by the novel experience of fucking with a goat cock. He grabs your hips, pulling you down harder against himself with each slide down and meeting your hips with an upwards thrust of his own.";
			WaitLineBreak;
			say "     After a pleasant time riding his cock, Eric pulls you to a stop with his cock buried all the way inside you and asks you to get on all fours on the bunk. Looks like he's inherited some added virility from the satyr wine. With a satisfied grunt, Eric mounts your ass from behind, just as his body is telling him it's supposed to go. He puts his arms around you, feeling up your chest and kissing your neck as he bottoms out inside you. Then he starts all-out rutting, his shaft sliding in and out of your tight hole in hard and deep moves. You quickly climax from this animalistic fuck, having a mind-blowing orgasm that makes you spray your load all over the sheets of the bunk. Not too long after, Eric follows suit, filling your hole with a massive load of his fertile seed.[mimpregchance]";
			say "     With the thick shaft of his cock still pulsing softly inside you as it spurts more cum, Eric pulls you down to lie on your sides on the bed together. In between panting for breath, he gives you another kiss on the neck and says 'That was... wow. Thank you so much for helping me fix this.' followed by a last little thrust of his manhood into you.";
		else if cunts of player > 0: [female]
			say "     You grab hold of his thick shaft and hold it up so the leaking head strokes your nether lips and slowly lower yourself on it, gasping as he enters your body. It's just amazing to feel his animalistic member slide up against your insides, which has both of you moaning and panting in lust. Then, as he bottoms out and you feel his massive balls against your skin, you lean down and give him a deep kiss.";
			say "     Sitting back up, you moan 'Give it to me, satyrboy.' and start sliding up and down on Eric's long shaft. With its inhuman shape and the added length his satyrcock has, you get rubbed in spots you barely know you had and have a very pleasant sensation of fullness. Below you, Eric is panting and moaning deeply, obviously overwhelmed by the novel experience of fucking with a goat cock. He grabs your hips, pulling you down harder against himself with each slide down and meeting your hips with an upwards thrust of his own.";
			WaitLineBreak;
			say "     After a pleasant time riding his cock, Eric pulls you to a stop with his cock buried all the way inside you and asks you to get on all fours on the bunk. Looks like he's inherited some added virility from the satyr wine. With a satisfied grunt, Eric mounts your pussy from behind, just as his body is telling him it's supposed to go. He puts his arms around you, feeling up your chest and kissing your neck as he bottoms out inside you. Then he starts all-out rutting, his shaft sliding in and out of your pussy hard and deep. You climax from this animalistic fuck, having a mind-blowing orgasm that leaves your pussy dripping with female juices. Not too long after, Eric follows suit, filling your womb with a massive load of his fertile seed.[fimpregchance]";
			say "     With the thick shaft of his cock still pulsing softly inside you as it spurts more cum, Eric pulls you down to lie on your sides on the bed together. In between panting for breath, he gives you another kiss on the neck and says 'That was... wow. Thank you so much for helping me fix this.' followed by a last little thrust of his manhood into you.";
		else: [neuter]
			say "     You grab hold of his thick shaft and hold it up so the leaking head strokes against your asshole and slowly lower yourself on it, gasping as he enters your body. It's just amazing to feel his animalistic member slide up against your insides, which has both of you moaning and panting in lust. Then, as he bottoms out and you feel his massive balls against your skin, you lean down and give him a deep kiss.";
			say "     Sitting back up, you moan 'Give it to me, satyrboy.' and start sliding up and down on Eric's long shaft. With its inhuman shape and the added length his satyrcock has, you get rubbed in spots you barely know you had and have a very pleasant sensation of fullness. Below you, Eric is panting and moaning deeply, obviously overwhelmed by the novel experience of fucking with a goat cock. He grabs your hips, pulling you down harder against himself with each slide down and meeting your hips with an upwards thrust of his own.";
			WaitLineBreak;
			say "     After a pleasant time riding his cock, Eric pulls you to a stop with his cock buried all the way inside you and asks you to get on all fours on the bunk. Looks like he's inherited some added virility from the satyr wine. With a satisfied grunt, Eric mounts your ass from behind, just as his body is telling him it's supposed to go. He puts his arms around you, feeling up your chest and kissing your neck as he bottoms out inside you. Then he starts all-out rutting, his shaft sliding in and out of your tight hole in hard and deep moves. You quickly climax from this animalistic fuck, your body shaking from the pleasant sensations. Not too long after, Eric follows suit, filling your hole with a massive load of his fertile seed.[mimpregchance]";
			say "     With the thick shaft of his cock still pulsing softly inside you as it spurts more cum, Eric pulls you down to lie on your sides on the bed together. In between panting for breath, he gives you another kiss on the neck and says 'That was... wow. Thank you so much for helping me fix this.' followed by a last little thrust of his manhood into you.";
		now HP of Eric is 32;
	else if HP of Eric is 32: [male with satyr-cock repeats]
		if lastfuck of Eric - turns < 6:
			say "     As you approach Eric, he immediately sees the lust-filled twinkle in your eyes. Pulling you close against his body, he gives you a deep kiss, playfully wrestling your tongue with his. But then as you lower your hands to stroke the bulge in his shorts, he pulls away, taking your hand in his and giving you an apologetic look. 'I'd love to, baby... but honestly, I should take a break. While this thing is really randy, it might be trouble if I keep fucking over and over. It feels like I just might never want to stop the party if I go too often, you know...'";
		else:
			say "     You walk over to Eric, who immediately starts smiling as he sees the lust-filled twinkle in your eyes. Throwing his arms around you, his lips find yours for a quick kiss, then he suggestively nods over to his bunk.";
			say "[EricSexMenu]";
	else if (HP of Eric is 99): [sex slave cuntboy repeats]
		if (lastfuck of Eric - turns < 3):
			say "     As you approach Eric, he immediately sees the lust-filled twinkle in your eyes and takes a step back, an annoyed look on his face. 'Again? Can't you at least let me have some breaks? I'm not a blow-up-doll you can use any time you like, you know...' He stomps off to his bed to sulk.";
		else:
			say "     'Time to have sex with your personal gender-switched freak again?' Eric says, looking at you in disdain. 'I should hate you for making me do this - but my pussy gets wet just thinking about it...' With a sigh, he strips off his clothing and looks to you, waiting for orders.";
			say "[EricSexMenu]";

to say EricSexMenu:
	if HP of Eric is 21 or HP of Eric is 22:
		setmonster "Centaur Stallion";
		choose row monster from the table of random critters;
	else if HP of Eric is 31 or HP of Eric is 32:
		setmonster "Satyr";
		choose row monster from the table of random critters;
	if HP of Eric > 19 and HP of Eric < 30:
		project the Figure of Eric_naked_icon;
	now sextablerun is 0;
	blank out the whole of table of fucking options;
	[]
	if (cocks of player > 0):
		choose a blank row in table of fucking options;
		now title entry is "Have him blow your cock";
		now sortorder entry is 1;
		now description entry is "Put your [if HP of Eric is 22 or HP of Eric is 32]horny friend's[else]pussyboy's[end if] mouth to good use";
	[]
	if HP of Eric is 22 or HP of Eric is 32:
		choose a blank row in table of fucking options;
		now title entry is "Suck Eric's cock";
		now sortorder entry is 2;
		now description entry is "Put Eric's [if HP of Eric is 22]long horsecock[else if HP of Eric is 32]musky satyrcock[end if] in your mouth";
	[]
	if (cunts of player > 0):
		choose a blank row in table of fucking options;
		now title entry is "Have him lick your pussy";
		now sortorder entry is 3;
		now description entry is "Put his mouth to good use";
	[]
	if (HP of Eric is 11 or HP of Eric is 13 or HP of Eric is 15 or HP of Eric is 99):
		choose a blank row in table of fucking options;
		now title entry is "Finger his pussy";
		now sortorder entry is 4;
		now description entry is "Finger-fuck Eric's pussy to make him cum";
	[]
	if ((HP of Eric is 11 or HP of Eric is 13 or HP of Eric is 15 or HP of Eric is 99) and cocks of player > 0):
		choose a blank row in table of fucking options;
		now title entry is "Fuck his pussy";
		now sortorder entry is 5;
		now description entry is "Fill the pussyboy with your cock";
	[]
	if (HP of Eric is 22 or HP of Eric is 32) and cunts of player > 0:
		choose a blank row in table of fucking options;
		now title entry is "Let him fuck your pussy";
		now sortorder entry is 6;
		now description entry is "Ride Eric's [if HP of Eric is 22]long horsecock[else if HP of Eric is 32]virile satyrcock[end if]";
	[]
	if (cocks of player > 0):
		choose a blank row in table of fucking options;
		now title entry is "Take Eric's ass";
		now sortorder entry is 7;
		now description entry is "Fill your [if HP of Eric is 22 or HP of Eric is 32]horny friend's[else]pussyboy's[end if] ass with your cock";
	[]
	if HP of Eric is 22 or HP of Eric is 32:
		choose a blank row in table of fucking options;
		now title entry is "Let him fuck your ass";
		now sortorder entry is 8;
		now description entry is "Ride Eric's long cock";
	[]
	if lust of Eric is 3 and HP of Eric is 99 and HP of David is 4 and lastfuck of David - turns >= 6: [Eric ready for sex with David, sex-slave cuntboy, David in the bunker and ready]
		choose a blank row in table of fucking options;
		now title entry is "Trick David into fucking Eric";
		now sortorder entry is 9;
		now description entry is "Make the cuntboy ride David's cock";
	[]
	if lust of Eric is 3 and (HP of Eric is 22 or HP of Eric is 32) and HP of David is 4 and lastfuck of David - turns >= 6 and lust of David > 0: [Eric ready for sex with David, non-virgin male, David in the bunker and ready, David ass fucked before]
		choose a blank row in table of fucking options;
		now title entry is "Have Eric fuck David";
		now sortorder entry is 10;
		now description entry is "Make the soldier boy ride Eric's [if HP of Eric is 22]horsecock[else if HP of Eric is 32]satyr cock[end if].";
	[]
	if lust of Eric is 3 and (HP of Eric is 11 or HP of Eric is 13 or HP of Eric is 15) and HP of David is 4 and lastfuck of David - turns >= 6: [Eric ready for sex with David, non-virgin cuntboy, David in the bunker and ready]
		choose a blank row in table of fucking options;
		now title entry is "Have David fuck Eric's pussy";
		now sortorder entry is 11;
		now description entry is "Make the soldier boy fuck Eric";
	[]
	if lust of Eric is 4 and HP of David is 4 and lastfuck of David - turns >= 6: [David+Eric had sex, David in the bunker and ready]
		choose a blank row in table of fucking options;
		now title entry is "Threesome with David and Eric";
		now sortorder entry is 12;
		now description entry is "Have some fun with both of them together";
	[]
	if (Level of Eric is 4 or (Level of Eric > 0 and Level of Eric < 99 and HP of Eric is 99) and cocks of player > 0 or cunts of player > 0): [either talked with Eric about the felinoid fucking him and having approved, or cuntboy slave Eric]
		choose a blank row in table of fucking options;
		now title entry is "Threesome with the felinoid and Eric";
		now sortorder entry is 13;
		now description entry is "Have some fun with both of them together";
	[]
	if ((HP of Eric is 11 or HP of Eric is 13 or HP of Eric is 15) and (CarlEricInteraction > 5 and CarlEricInteraction < 50)): [cboy repeat sex]
		choose a blank row in table of fucking options;
		now title entry is "Threesome with Carl and Eric";
		now sortorder entry is 14;
		now description entry is "Have some fun with both of them together";
	[]
	sort the table of fucking options in sortorder order;
	repeat with y running from 1 to number of filled rows in table of fucking options:
		choose row y from the table of fucking options;
		say "[link][y] - [title entry][as][y][end link][line break]";
	say "[link]100 - Nevermind[as]100[end link][line break]";
	while sextablerun is 0:
		say "Pick the corresponding number> [run paragraph on]";
		get a number;
		if calcnumber > 0 and calcnumber <= the number of filled rows in table of fucking options:
			now current menu selection is calcnumber;
			choose row calcnumber in table of fucking options;
			say "[title entry]: [description entry]?";
			if player consents:
				let nam be title entry;
				now sextablerun is 1;
				if (nam is "Have him blow your cock"):
					say "[EricSex1]";
				else if (nam is "Suck Eric's cock"):
					say "[EricSex2]";
				else if (nam is "Have him lick your pussy"):
					say "[EricSex3]";
				else if (nam is "Finger his pussy"):
					say "[EricSex4]";
				else if (nam is "Fuck his pussy"):
					say "[EricSex5]";
				else if (nam is "Let him fuck your pussy"):
					say "[EricSex6]";
				else if (nam is "Take Eric's ass"):
					say "[EricSex7]";
				else if (nam is "Let him fuck your ass"):
					say "[EricSex8]";
				else if (nam is "Trick David into fucking Eric"):
					say "[EricSex9]";
				else if (nam is "Have Eric fuck David"):
					say "[EricSex10]";
				else if (nam is "Have David fuck Eric's pussy"):
					say "[EricSex11]";
				else if (nam is "Threesome with David and Eric"):
					say "[EricSex12]";
				else if (nam is "Threesome with the felinoid and Eric"):
					say "[EricSex13]";
				else if (nam is "Threesome with Carl and Eric"):
					say "[EricSex14]";
				now lastfuck of Eric is turns;
				wait for any key;
		else if calcnumber is 100:
			say "Break off the conversation?";
			if the player consents:
				now sextablerun is 1;
				say "     You step back from the young man, shaking your head slightly as he gives a questioning look.";
				wait for any key;
			else:
				say "Pick between 1 and [the number of filled rows in the table of fucking options] or 100 to exit.";
		else:
			say "Invalid Option. Pick between 1 and [the number of filled rows in the table of fucking options].";
	clear the screen and hyperlink list;

to say EricSex1: [cock sucked by Eric]
	if (HP of Eric > 10 and HP of Eric < 16): [cuntboy repeat sex]
		say "     Staying right where you are, you give Eric's shoulders a soft push to make him crouch down before you. Pulling down your rapidly hardening cock, you stroke it a few times and then hold it out for him.";
		say "     Eric licks it, then takes it into his mouth without any hesitation, clearly eager to satisfy your lust. Him looking up at you adoringly with your manhood sliding in and out of his mouth is quite a sight. You stroke his neck, then run your hand through his red hair and grab hold of his head. Pulling his mouth deeper onto your shaft, you start fucking his face, going slow at first for him to get used to it, then speed up and go deeper and deeper.";
		say "			[WaitLineBreak]";
		say "     His soft lips and warm mouth around your cock give you an amazing feeling, making you moan in lust. He might be new to sucking cocks, but having been a male himself not too long ago, he clearly knows how to please you orally. And he's very eager and willing to learn, even going for a few deep throat moments after taking deep breaths.";
		say "     With such a handsome cuntboy eager to please, it doesn't take long until your balls tighten and your cock pulses with burst after burst of cum it's depositing onto Eric's tongue. He sticks it out for a moment for you to see your white load, then closes his mouth and swallows it all down. Standing up, he puts his arms around you and gives you a quick kiss, leaving you with a warm feeling and the taste of cum on your lips.";
	else if HP of Eric is 32 and cockname of player is "Satyr": [satyr-cock Eric + satyr-cock player]
		say "     Even as you're guiding Eric down towards your crotch, he starts to sniff, catching the scent of your musky cock, which excites something in him. Face to face with your throbbing satyr maleness, he licks his lips. 'Oh, is this for me?' he asks with a growing smile on his face.";
		say "     Taking it in hand, he rubs his other hand over your balls and starts sliding his slick tongue across your glans. You don't think he had any gay encounters before all this, but with everything else that happened to him and now a satyr cock much like his own in front of him, he doesn't hesitate to throw himself into sucking you off. Him looking up at you adoringly with your manhood sliding in and out of his mouth is quite a sight. You stroke his neck, then run your hand through his red hair and grab hold of his head. Pulling his mouth deeper onto your shaft, you start fucking his face, going slow at first for him to get used to it, then speed up and go deeper and deeper.";
		say "			[WaitLineBreak]";
		say "     His soft lips and warm mouth around your cock give you an amazing feeling, making you moan in lust. He might be new to sucking cocks, but he clearly knows how to please a man orally from his own experiences as the receiver. And he's very eager and willing to learn doing it himself, even going for a few deep throat moments after taking deep breaths.";
		say "     With such a handsome guy eager to please, it doesn't take long until your balls tighten and your cock pulses with burst after burst of cum it's depositing onto Eric's tongue. He sticks it out for a moment for you to see your white load, then closes his mouth and swallows it all down. 'Mmm... almost as good as a fine wine,' he says with a laugh as he stands up. He puts his arms around you and gives you a quick kiss, leaving you with a warm feeling and the taste of cum on your lips.";
	else if HP of Eric is 22 or HP of Eric is 32: [male with horse-cock/satyr-cock repeats]
		say "     Staying right where you are, you give Eric's shoulders a soft push to make him crouch down before you. Pulling down your rapidly hardening cock, you stroke it a few times and then hold it out for him.";
		say "     He looks at it for a second, then takes it into his hand and slowly runs his tongue over the head. You don't think he had any gay encounters before all this, but with being a woman in between and you saving his bacon, he's clearly willing to try anything with you now. After getting over the first moment of restraint, he jumps right into the action, licking your shaft and then taking it into his mouth. Him looking up at you adoringly with your manhood sliding in and out of his mouth is quite a sight. You stroke his neck, then run your hand through his red hair and grab hold of his head. Pulling his mouth deeper onto your shaft, you start fucking his face, going slow at first for him to get used to it, then speed up and go deeper and deeper.";
		say "			[WaitLineBreak]";
		say "     His soft lips and warm mouth around your cock give you an amazing feeling, making you moan in lust. He might be new to sucking cocks, but he clearly knows how to please a man orally from his own experiences as the receiver. And he's very eager and willing to learn doing it himself, even going for a few deep throat moments after taking deep breaths.";
		say "     With such a handsome guy eager to please, it doesn't take long until your balls tighten and your cock pulses with burst after burst of cum it's depositing onto Eric's tongue. He sticks it out for a moment for you to see your white load, then closes his mouth and swallows it all down. Standing up, he puts his arms around you and gives you a quick kiss, leaving you with a warm feeling and the taste of cum on your lips.";
	else if (HP of Eric is 99): [sex slave cuntboy]
		say "     Staying right where you are, you push down on Eric's shoulders and make him kneel in front of you. Pulling down your rapidly hardening cock, you stroke it a few times and then hold it out for him.";
		say "     He looks hesitantly at it until you reach out and grab his head, pulling him towards your crotch. You push against his lips with the tip of your cock, then hear a soft sigh as he opens his mouth and takes you in. You don't think he had any gay encounters before all this and you have to remind him not to touch your rod with his teeth, but soon you got him sucking on your cock correctly. Seeing your manhood sliding in and out of his mouth gives you a sense of power that fuels your rising lust, making you grab his head tightly with both your hands and start face-fucking him. Pulling his mouth deeper onto your shaft, there is a moment or two in which he gags for air, but soon he gets used to it and you can slide deep inside his throat.";
		say "			[WaitLineBreak]";
		say "     His soft lips and warm mouth around your cock give you an amazing feeling, making you moan in lust. He might be new to sucking cocks, but he'll learn over time and you get off on making him do it.";
		say "     It doesn't take long until your balls tighten and your cock pulses with burst after burst of cum it's depositing onto Eric's tongue. He starts turning his head to spit it out, but you grab him and order him to swallow it all. After having him stick out his tongue so you can check it's all gone, you give him a pat on his head, saying 'Good boy. I'll teach you to behave properly yet.'";
	else:
		say "ERROR-Eric-[HP of Eric]C: He isn't in one of the states he should be in! Please report how you got to this message.";

to say EricSex2: [sucking Eric's cock]
	if HP of Eric is 22: [male with horse-cock repeats]
		say "     Pulling him into a tight embrace, your then let your hand wander down his body until it reaches his crotch. You stroke his already quite large bulge through the fabric for a moment, then push your hands under his shirt and pull it over his head. Hooking your hands over the bands of his shorts and briefs, you pull them down in one go. Now fully naked, Eric looks delicious to your eyes, with his lithe human body and large equine cock and balls.";
		say "     Eagerly you kneel down, taking his manhood in both hands and lick over its wide flared head. He throws his head back and moans 'Yes! Suck it please - I need it.' Grinning, you give him a few more slow strokes up and down his long shaft until he's almost shaking with arousal, then slide your lips over his horsecock. Sucking on his erect member, you get a taste of his pre-cum and smell the animal-like musk of his crotch. It makes you want more, and you go faster and faster, soon bobbing rapidly up and down on his cock.";
		say "			[WaitLineBreak]";
		say "     At some point, Eric takes over and holds your head while face-fucking his cock in and out of you - but you don't really care, totally concentrated on the feeling of him sliding in and out of your throat and the taste of him. You reach up, taking hold of his large balls with your hands and massage them softly, making Eric grunt in pleasure. After a short while and a bit of oral attention more, you feel the balls pulse in your hands as Eric blows his load deep into your mouth, the first blast going right down your throat into your stomach. Then he pulls back a bit and shoots thick ropes of cum onto your tongue, filling your mouth with its animalistic taste.";
		say "     You softly suck on him and run your tongue over his cock as it shoots more cum, then pull off it when he stops and stand up. Running a hand through Eric's red hair, you pull him close and start making out with him. His eyes widen a bit when you push some of his cum into his mouth with your tongue, but he takes it in stride, continuing your kissing and wrestling your tongue with his own. As you pull back for some air, he smiles at you, pushing out his cum-covered tongue then demonstratively swallows what you gave him. Looks like he likes the taste himself.";
	else if HP of Eric is 32 and facename of player is "Greek Nymph": [satyr-cock Eric + satyr+cock player]
		say "     Pulling him into a tight embrace, your then let your hand wander down his body until it reaches his crotch. As you're stroking the growing bulge through the fabric for a moment, he pulls you into a wild, passionate kiss, his tongue diving into your mouth and his hands reaching down to grab your ass. 'Oh, you have such a pretty face,' he says when the kiss is finally broken. Grinning, you respond that it'll look even prettier with his cock between your lips, which has him laugh. Having divested him of his shorts and briefs during the long kiss, you eye his satyr cock with a growing hunger and lust, wanting to taste that throbbing goat meat and suck those hefty, red-furred balls of his dry.";
		say "     Eagerly you kneel down, taking his manhood in both hands and lick over its dribbling head, lusting after the taste of it. He throws his head back and moans 'Oh yes!  Suck it please - I want those beautiful lips aroooohhh yeah!'  Unable to hold back any longer, you're stuffing it into your mouth even before he's had a chance to finish talking. Sucking on his erect member, you get a taste of his pre-cum and smell the virile musk of his crotch. Thirsty for more and wanting the even richer finish you know is coming, you go faster and faster, soon bobbing rapidly up and down on his cock.";
		say "			[WaitLineBreak]";
		say "     At some point, Eric takes over and holds your head with one hand so he can increase the pace while face-fucking his cock in and out of you. His other hand runs lightly over your lovely, nymph-like face and through your long, flowing hair. Wildly excited by the taste and feel of his cock sliding in and out of your mouth and throat, you reach up and take hold of his large balls with both hands. Massaging them softly and reaching back to rub at his taint, you draw a long moan of pleasure out of Eric. After a short while and a bit of oral attention more, you feel the balls pulse in your hands as Eric blows his load deep into your mouth, the first blast going right down your throat into your stomach. He then pulls back a bit and shoots thick ropes of cum onto your tongue, filling your mouth with its musky taste[if cunts of player > 0 or cocks of player > 0]. This sends one of your hands down between your legs so you can masturbate yourself to a moaning orgasm just as he's about to finish up, exciting a few extra spurts out of him[end if].";
		say "     You make sure to lick his cock clean of every drop of that strong, virile cum of his, finding its taste incredibly exciting to your palate. Only once you've gotten it all do you reluctantly release it and stand up. Running a hand over Eric's chest, [if a random chance of 1 in 2 succeeds]you move in to kiss him again, but then turn away at the last moment on an impulse and dash away giggling[else]you are surprised when Eric grabs you and presses your body and lips to his, kissing your beautiful, nymph face with another, wild and untamed kiss. When he releases you, you giggle softly and he chuckles, giving your ass a swat as you go[end if].";
	else if HP of Eric is 32: [male with satyr-cock repeats]
		say "     Pulling him into a tight embrace, your then let your hand wander down his body until it reaches his crotch. You stroke his already growing bulge through the fabric for a moment, then push your hands under his shirt and pull it over his head. Hooking your hands over the bands of his shorts and briefs, you pull them down in one go. Now fully naked, Eric looks delicious to your eyes, with his lithe human body and throbbing satyr cock to go with his hefty, red-furred balls.";
		say "     Eagerly you kneel down, taking his manhood in both hands and lick over its dribbling head. He throws his head back and moans 'Yes! Suck it please - I need it.' Grinning, you give him a few more slow strokes up and down his throbbing shaft until he's almost shaking with arousal, then slide your lips over his satyrcock. Sucking on his erect member, you get a taste of his pre-cum and smell the virile musk of his crotch. It makes you want more, and you go faster and faster, soon bobbing rapidly up and down on his cock.";
		say "			[WaitLineBreak]";
		say "     At some point, Eric takes over and holds your head while face-fucking his cock in and out of you - but you don't really care, totally concentrated on the feeling of him sliding in and out of your throat and the taste of him. You reach up, taking hold of his large balls with your hands and massage them softly, making Eric grunt in pleasure. After a short while and a bit of oral attention more, you feel the balls pulse in your hands as Eric blows his load deep into your mouth, the first blast going right down your throat into your stomach. Then he pulls back a bit and shoots thick ropes of cum onto your tongue, filling your mouth with its musky taste.";
		say "     You softly suck on him and run your tongue over his cock as it shoots more cum, then pull off it when he stops and stand up. Running a hand through Eric's red hair, you pull him close and start making out with him. His eyes widen a bit when you push some of his cum into his mouth with your tongue, but he takes it in stride, continuing your kissing and wrestling your tongue with his own. As you pull back for some air, he smiles at you, pushing out his cum-covered tongue then demonstratively swallows what you gave him. Looks like he likes the taste himself.";
	else:
		say "ERROR-Eric-[HP of Eric]D: He shouldn't have a cock right now! Please report how you got to this message.";

to say EricSex3: [cunt licked by Eric]
	if (HP of Eric > 10 and HP of Eric < 16): [cuntboy repeat sex]
		say "     Strolling towards the bed you slide off your clothing, then lie down on it and spread your legs, telling Eric to give you pleasure with his tongue. He kneels down in front of the bed and moves one hand forward to spread your nether lips, then licks over them. 'Stacy always said I'm good at oral sex. And I... practiced a bit with my own...'";
		say "     And it's true - your eager cuntboy licks and fondles your sex expertly, making you moan in rising arousal. Looks like becoming a woman has given him an insight on the whole matter. After a quite pleasurable time where he rubs erogenous zones inside your pussy you barely knew existed, you moan loudly and orgasm, dripping female juices over his fingers. Eric keeps going, fondling your lips as you shiver in pleasure and slurps up your femcum. Finally he stands up again, giving you a kiss tasting of your own pussy juice.";
	else if HP of Eric is 32 and cockname of player is "Greek Nymph": [satyr-cock Eric + nymph-cunt player]
		say "     Strolling towards the bed you slide off your clothing, then lie down on it and spread your legs, telling Eric to give you pleasure with his tongue. He kneels down in front of the bed and moves one hand forward to spread your nether lips, moaning softly in anticipation as he takes in your scent, something about it is particularly exciting for him. Without further delay, he dives in, licking at your pussy wildly, though with considerable skill as well.";
		say "     Your eager runner licks and fondles your sex with excessive zeal, making you moan in rising arousal at his performance. It's clear he's had plenty of practice at this as is quite good, as that shines through even given his wild enthusiasm for eating you out. Between his clear lust for your juices and his personal experience by having a pussy of his own for a while, you find yourself having several powerful, crashing orgasms as he licks, kisses, rubs, nibbles and a startling array of other sensual touches up your erogenous zones. By the time you can take no more, your thighs and his face are soaked in your juices and he's stroked himself to orgasm twice as well. You have to push him away for him to finally stop, though he makes a show of licking your femcum from his lips.";
	else if HP of Eric is 22 or HP of Eric is 32: [male with horse-cock/satyr-cock repeats]
		say "     Strolling towards the bed you slide off your clothing, then lie down on it and spread your legs, telling Eric to give you pleasure with his tongue. He kneels down in front of the bed and moves one hand forward to spread your nether lips, then expertly licks over them. 'Stacy always said I'm good at oral sex. And I... practiced a bit before you made me a man again.";
		say "     And it's true - your eager runner licks and fondles your sex expertly, making you moan in rising arousal. Looks like his short stint as a woman has given him an insight on the whole matter. After a quite pleasurable time where he rubs erogenous zones inside your pussy you barely knew existed, you moan loudly and orgasm, dripping female juices over his fingers. Eric keeps going, fondling your lips as you shiver in pleasure and slurps up your femcum. Finally he stands up again, giving you a kiss tasting of your own pussy juice.";
	else if (HP of Eric is 99): [sex slave cuntboy]
		say "     Strolling towards the bed you slide off your clothing, then lie down on it and spread your legs, ordering Eric to come over and get licking. He reluctantly kneels down in front of the bed, looking at your pussy. Not wanting for him to make up his mind, you just grab his head, pushing him down to your crotch and holding him there until he opens up and starts licking your folds.";
		say "     Despite the slow start, he gets more into servicing you pretty soon, licking and fondling your female sex. And he's rather good at it too - looks like becoming a woman has given him an insight on the whole matter. After a quite pleasurable time where he rubs erogenous zones inside your pussy you barely knew existed, you moan loudly and orgasm, dripping female juices over his fingers. Eric keeps going, fondling your lips as you shiver in pleasure and slurps up your femcum. You look down at him kneeling in front of you, then run a hand over your cunt and rub in the female juices all over Eric's face. 'Just admit to yourself that you like it.'";
	else:
		say "ERROR-Eric-[HP of Eric]C: He isn't in one of the states he should be in! Please report how you got to this message.";

to say EricSex4: [Eric's cunt licked/fingered]
	if (HP of Eric > 10 and HP of Eric < 16): [cuntboy repeat sex]
		say "     Taking Eric by the hand, you lead him over to his bed and push your hands under his shirt. Feeling up his firm chest muscles for a moment, next you take hold of the shirt and pull it off him. Then it's time for his shorts, which you slide down his long runner's legs, stroking over his skin as you go. Now your handsome athlete is almost naked before you, just wearing a skimpy white tanga already showing a little damp spot at the front.";
		say "     Running your hands over his body, you pull Eric in for another quick kiss, then softly push him backwards against the bed and make him lie down on it. You stroke over the thin fabric of his panties with your fingers, making him moan needily. Looks like your cuntboy is about ready... you pull the panties off his body, revealing his swollen pussy with its open, glistening lips.";
		say "			[WaitLineBreak]";
		say "     Kneeling down, you give him a careful lick and taste his juices, then really go to town on him - licking and fondling his female bits until he's panting and squirming in arousal, his hands grabbing the sheets tightly. You keep going for quite a bit until suddenly he gives a lustful scream and orgasms, dripping femcum from his spread pussy. You sit beside him on the camp bed, softly stroking his body as he rides out the sexual high. When he finally comes down to normal a while later, he pulls you down to lie beside him and gives you a kiss. 'If I had known it'd be like this, I'd have jumped you the moment you came to me. Who wouldn't want to be a woman with you...'";
	else if HP of Eric is 22 or HP of Eric is 32: [male with horse-cock/satyr-cock repeats]
		say "ERROR-Eric-1D: This option shouldn't be available since he has no cunt in the current form. Please report how you got to this message.";
	else if (HP of Eric is 99): [sex slave cuntboy]
		say "     Deciding your cuntboy needs a bit of help accepting his womanhood, you pull him along to the bed and fondle his body, playing with his sensitive nipples. Then you push him backwards so he falls down onto the bed on his back and tell him to spread his legs.";
		say "     Between them, his pussy comes into sight, moisture glistening between its swollen lips. Looks like your cuntboy is about ready...";
		say "			[WaitLineBreak]";
		say "     Kneeling down, you give him a lick and taste his juices, then really go to town on him - licking and fondling his female bits until he's panting and squirming in arousal, his hands grabbing the sheets tightly. You keep going for quite a bit until suddenly he gives a lustful scream and orgasms, dripping femcum from his spread pussy. You sit beside him on the camp bed, fondling his lithe body as he rides out the sexual high. When he finally comes down to normal a while later, he says 'Damn, it shouldn't feel so good when you use me like this. I can't believe I came like that.'";
	else:
		say "ERROR-Eric-[HP of Eric]C: He isn't in one of the states he should be in! Please report how you got to this message.";

to say EricSex5: [Eric's pussy fucked by player]
	if (HP of Eric > 10 and HP of Eric < 16): [cuntboy repeat sex]
		say "     Taking Eric by the hand, you lead him over to his bed and push your hands under his shirt. Feeling up his firm chest muscles for a moment, next you take hold of the shirt and pull it off him. Then it's time for his shorts, which you slide down his long runner's legs, stroking over his skin as you go. Now your handsome athlete is almost naked before you, just wearing a skimpy white tanga already showing a little damp spot at the front.";
		say "     Running your hands over his body, you pull Eric in for another quick kiss, then softly push him backwards against the bed and make him lie down on it. You stroke over the thin fabric of his panties with your fingers, making him moan needily. Looks like your cuntboy is about ready... you pull the panties off his body, revealing his swollen pussy with its open, glistening lips.";
		say "			[WaitLineBreak]";
		say "     Quickly stripping off your own clothing, you climb on the bed with him and kneel between his spread legs. He just looks so delicious, lying before you with his athletic body and that eager expression on his face. You barely manage to control the impulse to just plunge in and take him then and there, instead going slow and rubbing the tip of your cock up and down over his pussy lips, making him pant in need. After pushing softly against his opening several times, then going back to more rubbing, Eric moans 'Please - I need you in me.'";
		say "     Following your handsome cuntboy's needful request, you aim your shaft and push forward, giving both your bodies the unity they craved for. As you sink deeper inside him, you lean down and make out with Eric, moaning into each other's mouth when you bottom out inside him. With the warm, tight hole around your cock, all restraint is soon forgotten and you start fucking him hard and deep. Eric gives lustful grunts to accompany the sound of your hips slapping against his crotch and wraps his arms and legs around you in an intimate embrace.";
		say "			[WaitLineBreak]";
		say "     You fuck each other like sex-starved bunnies for at least an hour, only stopping for a moment when you cum inside him and fill his womb with your fertile seed, then make out a bit until you're ready to go on. It's a wild ride, but finally - after him and you coming three times - you come to lie on the bed together in each other's arms. Eric gives you a soft kiss on the lips, murmuring 'I love you.' before dozing off. You kiss his forehead and wish you could stay like this forever, your arms around him and your softening cock still inside his cum-filled pussy. With a last thought you imagine your cum exploring his womb for an egg to create life with, then fall asleep yourself.";
	else if HP of Eric is 22 or HP of Eric is 32: [male with horse-cock/satyr-cock repeats]
		say "ERROR-Eric-[HP of Eric]D: This option shouldn't be available since he has no cunt in the current form. Please report how you got to this message.";
	else if (HP of Eric is 99): [sex slave cuntboy repeats]
		say "     Deciding it's time to fuck your cuntboy, you pull him along to the bed and fondle his body, playing with his sensitive nipples. Then you push him backwards so he falls down onto the bed on his back and tell him to spread his legs. Between them, his pussy comes into sight, moisture glistening between its swollen lips. Looks like your cuntboy is about ready to be used...";
		say "     Quickly stripping off your own clothing, you climb on the bed with him and kneel between his spread legs. He just looks so delicious, lying before you with his athletic body and that inviting pussy open to you. A thought of going slow quickly evaporates before your boiling lust and you aim your shaft and then plunge into Eric's body in one go, making him groan as your cock suddenly spreads his pussy lips. He whimpers a bit as you slide deeper, but soon starts to moan in lust as you bottom out and start going in and out, rubbing against his inner walls.";
		say "			[WaitLineBreak]";
		say "     You fuck each other like sex-starved bunnies for at least an hour, only stopping for a moment when you cum inside him and fill his womb with your fertile seed, then rest a moment on top of him until you're ready to go on. It's a wild ride, but finally - after him and you coming three times - you come to lie on the bed side by side, your softening erection still inside him. Eric murmurs to himself 'I can't believe how much this gets me off. Three times he's made me cum and filled me. What does he want to do - use me as a breeding bitch?' before dozing off. Not a bad idea, you think for yourself before sleep claims you too.";
	else:
		say "ERROR-Eric-[HP of Eric]C: He isn't in one of the states he should be in! Please report how you got to this message.";

to say EricSex6: [player's pussy fucked by Eric]
	if (HP of Eric is 22): [male with horse-cock repeats]
		say "     Pulling him into a tight embrace, your then let your hand wander down his body until it reaches his crotch. You stroke his already quite large bulge through the fabric for a moment, then push your hands under his shirt and pull it over his head. Hooking your hands over the bands of his shorts and briefs, you pull them down in one go. Now fully naked, Eric looks delicious to your eyes, with his lithe human body and large equine cock and balls.";
		say "     Taking him by the hand, you lead him to your bed and quickly strip off your own clothing, then lie back on the bed and spread your legs invitingly. Not having to be asked twice, Eric eagerly joins you on the bed, kneeling between your legs. He takes his massive horsecock in one hand, guiding it towards your nether lips and rubs the flared head of his cock against them. Encouraged by your lustful moans, he aims right at your pussy and pushes forward, your folds stretching wide around his thick blunt-tipped maleness.";
		say "			[WaitLineBreak]";
		say "     It's just amazing how good he makes you feel with his long and thick inhumanly shaped cock. He fucks you with regular strokes, plunging deep inside you while his hands stroke your body. Then, after a while he leans down to make out with you, his cock all the way inside as he wrestles your tongue with his. Coming up for air, he moans 'Get on all fours please - I want to fuck you from behind.'";
		say "     Looks like he's inherited some urges from the centaur donor of his 'cure'... but hey, it's been amazing fucking him so far, so you readily roll over and get on all fours when he pulls out of you. With a satisfied grunt, Eric mounts your ass from behind, just as his body is telling him it's supposed to go. He puts his arms around you, feeling up your chest and kissing your neck as he sinks his shaft all the way inside. Then he starts all-out rutting, the thick horsecock sliding in and out of your tight hole in hard and deep moves. You quickly climax from this animalistic fuck, your body shaking from the pleasant sensations. Not too long after, Eric follows suit, filling your hole with a massive load of his fertile seed.[fimpregchance]";
		say "			[WaitLineBreak]";
		say "     With the thick shaft of his cock still pulsing softly inside you as it spurts more cum, Eric pulls you down to lie on your sides on the bed together. In between panting for breath, he gives you another kiss on the neck and says 'Wow. You're the best.' followed by a last little thrust of his manhood into you.";
	else if HP of Eric is 32 and bodyname of player is "Greek Nymph": [satyr-cock Eric + nymph-body player]
		say "     With Eric in your tight embrace, his hands roam over your nymph body. With a quick glance into each others['] eyes, you rush to pull off the others['] clothes, both of you lusting for the same thing and unable to get naked fast enough. His shirt, shorts and briefs all come off quickly, baring his lithe human body and throbbing satyr cock with its hefty, red-furred balls. Just the sight of it makes you wet between the legs.";
		say "     Unable to suppress a nymph-like giggle, you take his hand in your and lead him quickly to your bed with an almost dance-like grace. Laughing a little at your excitement, he pulls you into a kiss, dropping you both onto the bed as he lustfully gropes you while rolling into position. Breaking the wild kiss for a moment, he smiles down at you as he guides his throbbing satyrcock towards your nether lips and rubs the dribbling head of his cock against them. Not wanting to wait any longer, you grab his hips with your delicate hands and pull him eagerly forward. Certainly not lacking eagerness of his own, he thrusts forward into you, your folds spreading open for his long, capric maleness.";
		say "			[WaitLineBreak]";
		say "     It's just amazing how good he makes you feel with his long, inhumanly-shaped cock. He fucks you with wild passion while his hands roam over your nymph-like body. They run over your lithe, beautiful form, groping and squeezing you in such exciting ways while you grip him tightly. Between several long kisses with his tongue in your mouth, he also kisses and licks along your neck and shoulders. Giggling and moaning in delight beneath your virile young lover, you grab that runner's ass of his, squeezing its firm buttocks, feeling those strong muscles tense each time he thrusts into you again.";
		say "     It seems he's inherited some added virility from the satyr wine, as you both go at it for a long time. His first orgasm only stops him for a short while before his flagging cock is growing hard again and he's pounding into your creamy pussy once more. He rolls over onto his back and lets you ride in his lap, his eyes leeringly looking over your shapely form as you ride him to another climax. The feel of a fresh load of his satyr cum pumping into you from those large balls of his has you moaning loudly, your pussy quivering and flowing with femcum as you orgasm again.[fimpregchance]";
		say "			[WaitLineBreak]";
		say "     With the thick shaft of his cock still pulsing softly inside you as it spurts more cum, Eric pulls you down to lie on your sides on the bed together. In between panting for breath, he gives you quick kiss before pulling out and stepping away. 'That was wonderful, but I... I should go, before go at it again. If I keep at it, it feels like I might never want to stop.'  A little disappointed that your snuggling with him has to be cut short, you nod and smile, telling him that you'll be looking forward to the next time he's ready for more.";
	else if HP of Eric is 32: [male with satyr-cock repeats]
		say "     Pulling him into a tight embrace, you then let your hand wander down his body until it reaches his crotch. You stroke his already growing bulge through the fabric for a moment, then push your hands under his shirt and pull it over his head. Hooking your hands over the bands of his shorts and briefs, you pull them down in one go. Now fully naked, Eric looks delicious to your eyes, with his lithe human body and throbbing satyr cock to go with his hefty, red-furred balls.";
		say "     Taking him by the hand, you lead him to your bed and quickly strip off your own clothing, then lie back on the bed and spread your legs invitingly. Not having to be asked twice, Eric eagerly joins you on the bed, kneeling between your legs. He takes his throbbing satyrcock in one hand, guiding it towards your nether lips and rubs the dribbling head of his cock against them. Encouraged by your lustful moans, he aims right at your pussy and pushes forward, your folds stretching wide around his long, capric maleness.";
		say "			[WaitLineBreak]";
		say "     It's just amazing how good he makes you feel with his long, inhumanly-shaped cock. He fucks you with regular strokes, plunging deep inside you while his hands stroke your body. Then, after a while he leans down to make out with you, his cock all the way inside as he wrestles your tongue with his. Coming up for air, he moans 'Get on all fours please - I want to fuck you from behind.'";
		say "     Looks like he's inherited some added virility from the satyr wine... but hey, it's been amazing fucking him so far, so you readily roll over and get on all fours when he pulls out of you. With a satisfied grunt, Eric mounts your ass from behind, just as his body is telling him it's supposed to go. He puts his arms around you, feeling up your chest and kissing your neck as he sinks his shaft all the way inside. Then he starts all-out rutting, the pulsing satyrcock sliding in and out of your tight hole in hard and deep moves. You quickly climax from this animalistic fuck, your body shaking from the pleasant sensations. Not too long after, Eric follows suit, filling your hole with a massive load of his fertile seed.[fimpregchance]";
		say "			[WaitLineBreak]";
		say "     With the thick shaft of his cock still pulsing softly inside you as it spurts more cum, Eric pulls you down to lie on your sides on the bed together. In between panting for breath, he gives you another kiss on the neck and says 'Wow. You're the best.' followed by a last little thrust of his manhood into you.";
	else:
		say "ERROR-Eric-[HP of Eric]D: He shouldn't have a cock right now! Please report how you got to this message.";

to say EricSex7: [fucking Eric's ass]
	if (HP of Eric > 10 and HP of Eric < 16): [cuntboy repeat sex]
		say "     Taking Eric by the hand, you lead him over to his bed and push your hands under his shirt. Feeling up his firm chest muscles for a moment, next you take hold of the shirt and pull it off him. Then it's time for his shorts, which you slide down his long runner's legs, stroking over his skin as you go. Now your handsome athlete is almost naked before you, just wearing a skimpy white tanga already showing a little damp spot at the front.";
		say "     Running your hands over his body, you pull Eric in for another quick kiss, then softly push him backwards against the bed and make him lie down on it. You stroke over the thin fabric of his panties with your fingers, making him moan needily. Looks like your cuntboy is about ready... you pull the panties off his body, revealing his swollen pussy with its open, glistening lips - and below that, his tight pucker, winking invitingly from between his butt-cheeks.";
		say "			[WaitLineBreak]";
		say "     Quickly stripping off your own clothing, you climb on the bed with him and kneel between his spread legs. He just looks so delicious, lying before you with his athletic body and that eager expression on his face. You barely manage to control the impulse to just plunge in and take him then and there, instead going slow and rubbing the tip of your cock up and down over his pussy lips and down the crack of his ass, making him pant in need.";
		if EricAnalCounter < 2:
			say "     When you start pushing softly against his rear opening, Eric's eyes looking up at you get very round for a second. You don't think he had any gay encounters with anal sex before all this, but with becoming a woman his readiness to take cocks into his body increased a lot and he's willing to try anything with you. After the moment of hesitation, he smiles up at you, indicating to go on.";
		else:
			say "     When you start pushing softly against his rear opening, Eric lets out a pleased sigh, anticipating your entry into his tight passage. While he may not have had any gay encounters before this whole mess with the nanites started, his recent encounters have shown the athletic student that his asshole can be a source of great pleasure. Well, and with accepting the role of being the female partner in a good fuck, his readiness to take cocks into his body increased a lot too of course. You're pretty sure he'd be willing to try anything with you. Smiling impishly up at you, he indicates to go on.";
		say "     With your handsome cuntboy now ready for it, you aim your shaft and push forward, giving both your bodies the unity they crave for. As you sink deeper inside him, you lean down and make out with Eric, moaning into each other's mouth when you bottom out inside his tight ass. With the warm hole around your cock, all restraint is soon forgotten and you start fucking him hard and deep. Eric gives lustful grunts to accompany the sound of your hips slapping against his and wraps his arms and legs around you in an intimate embrace.";
		say "			[WaitLineBreak]";
		say "     You fuck each other like sex-starved bunnies for at least an hour, only stopping for a moment when you cum inside him and fill his ass with your fertile seed, then make out a bit until you're ready to go on. It's a wild ride, but finally - after him and you coming three times - you come to lie on the bed together in each other's arms. Eric gives you a soft kiss on the lips, murmuring 'I love you.' before dozing off. You kiss his forehead and wish you could stay like this forever, your arms around him and your softening cock still inside his cum-filled hole. Then you too fall asleep.";
	else if HP of Eric is 32 and cockname of player is "Satyr": [satyr-cock Eric + satyr-cock player]
		say "     Taking Eric by the hand, you lead him over to his bed with barely restrained excitement. Quite hard at the prospect of fucking the sexy guy, you run your hands over the firm muscles of his chest before quickly reaching lower to yank down his shorts and briefs before pushing him down onto the bed. With his athletic ass on display, your satyr cock throbs and pulses, spurting precum across it as you climb onto the bunk behind him. Laughing a little, he moves into position, bracing his legs and offering up his rear end before he even quite knows what he's doing. The sight of it with his ponderous, red-furred balls and the tip of his hard, satyr shaft showing behind them is a delightful sight.";
		say "     Wasting little time, you move a little closer and line your throbbing shaft up with his tight pucker. Realizing what's coming, he moans softly and chews at his lip, nodding. While you don't think he had any gay encounters with anal sex before all this, between his transitory gender confusion, your having saved his bacon and the lustful needs of his satyr cock, he's more than willing to go ahead with it now. After letting a few more spurts of precum get your satyrboy ready, you grab his muscled buttocks in both hands and spread them while pushing forward firmly.";
		say "     With your handsome, athletic friend ready for it, you aim your shaft and push forward, giving both your bodies what they crave. As you sink deeper inside him, you lean down and put your arms around Eric, running your hands over his strong, still-clothed chest and kiss at his neck, moaning about what a good, tight fuck he is. He blushes at this, but smiles and grinds back against you all the harder. And speaking of hard, when you reach under him and take a hold of his satyr cock, it is rigid and throbbing, leaking precum in spurts with every thrust into his sexy bottom. With the warm hole around your capric cock, all restraint is soon forgotten and you start fucking him hard and deep. Eric gives lustful grunts to accompany the sound of your hips slapping against his while you stroke his own pulsing meat.";
		say "			[WaitLineBreak]";
		say "     You fuck each other like wild, lustful creatures for at least an hour, only stopping for a moment when you cum inside him and fill his ass with your fertile seed, then make out a bit until you're ready to go on. It's a wild ride, but finally - after he and you have come three times - you come to lie on the bed together in each other's arms. Eric gives you a lustful kiss while his hands run over your body and down to the throbbing cock that's given him such pleasure. 'That... that was... I'd never have believed something like that could feel so good before all of this started. I love you,' he adds before dozing off. Grabbing his creamy ass, you hold him tight and feel your cock twitch a little. You drift off looking forward to the next time you can do this again with him.";
	else if HP of Eric is 22 or HP of Eric is 32: [male with horse-cock/satyr-cock repeats]
		say "     Taking Eric by the hand, you lead him over to his bed and push your hands under his shirt. Feeling up his firm chest muscles for a moment, next you take hold of the shirt and pull it off him. Then it's time for his shorts, which you slide down his long runner's legs, stroking over his skin as you go. Now your handsome athlete is almost naked before you, just wearing white briefs, bulging at the front with his cock and balls.";
		if HP of Eric is 22: [horsecock]
			say "     Running your hands over his body, you pull Eric in for another quick kiss, then softly push him backwards against the bed and make him lie down on it. You stroke over the thin fabric of his briefs with your fingers, making him moan needily and the bulge grow a bit. Looks like your horseboy is about ready... you pull the briefs off his body, freeing the long horsecock and his large round balls - and below that, revealing his tight pucker, winking invitingly from between his butt-cheeks.";
		else if HP of Eric is 32: [satyrcock]
			say "     Running your hands over his body, you pull Eric in for another quick kiss, then softly push him backwards against the bed and make him lie down on it. You stroke over the thin fabric of his briefs with your fingers, making him moan needily and the bulge grow a bit. Looks like your satyrboy is about ready... you pull the briefs off his body, freeing the erect satyrcock and his large, red-furred balls - and below that, revealing his tight pucker, winking invitingly from between his butt-cheeks.";
		say "			[WaitLineBreak]";
		say "     Quickly stripping off your own clothing, you climb on the bed with him and kneel between his spread legs. He just looks so delicious, lying before you with his athletic body and that eager expression on his face. You barely manage to control the impulse to just plunge in and take him then and there, instead going slow and rubbing the tip of your cock up and down the crack of his ass.";
		say "     When you start pushing softly against his rear opening, Eric's eyes looking up at you get very round for a second. You don't think he had any gay encounters with anal sex before all this, but with the temporary gender confusion, his readiness to take cocks into his body increased a lot and he's willing to try anything with you now for saving his bacon. After the moment of hesitation, he smiles up at you, indicating to go on.";
		say "     With your handsome athlete ready for it, you aim your shaft and push forward, giving both your bodies what they crave for. As you sink deeper inside him, you lean down and make out with Eric, moaning into each other's mouth when you bottom out inside his tight ass. With the warm hole around your cock, all restraint is soon forgotten and you start fucking him hard and deep. Eric gives lustful grunts to accompany the sound of your hips slapping against his and wraps his arms and legs around you in an intimate embrace.";
		say "			[WaitLineBreak]";
		say "     You fuck each other like sex-starved bunnies for at least an hour, only stopping for a moment when you cum inside him and fill his ass with your fertile seed, then make out a bit until you're ready to go on. It's a wild ride, but finally - after him and you coming three times - you come to lie on the bed together in each other's arms. Eric gives you a soft kiss on the lips, murmuring 'I love you.' before dozing off. You kiss his forehead and wish you could stay like this forever, your arms around him and your softening cock still inside his cum-filled hole. Then you too fall asleep.";
	else if (HP of Eric is 99): [sex slave cuntboy repeats]
		say "     Deciding it's time to fuck your cuntboy, you pull him along to the bed and fondle his body, playing with his sensitive nipples. Then you push him backwards so he falls down onto the bed on his back and tell him to spread his legs. Between them, his pussy comes into sight, moisture glistening between its swollen lips - and below, a tight pucker winks invitingly at you. Looks like your cuntboy is about ready to be used...";
		say "     Quickly stripping off your own clothing, you climb on the bed with him and kneel between his spread legs. He just looks so delicious, lying before you with his athletic body and that tight ass ready for you. A thought of going slow quickly evaporates before your boiling lust and you aim your shaft and then plunge into Eric's body in one go, making him groan as your cock suddenly pops through his pucker and invades his asshole. He whimpers a bit as you slide deeper, but soon starts to moan in lust as you bottom out and start going in and out, rubbing against his inner walls.";
		say "			[WaitLineBreak]";
		say "     You fuck each other like sex-starved bunnies for at least an hour, only stopping for a moment when you cum inside him and fill his ass with your seed, then rest a moment on top of him until you're ready to go on. It's a wild ride, but finally - after him and you coming three times - you come to lie on the bed side by side, your softening erection still inside him. Eric murmurs to himself 'I can't believe how much this gets me off. Three times he's made me cum.' before dozing off. You grind your hips against his one last time, then fall asleep yourself soon afterwards.";
	else:
		say "ERROR-Eric-[HP of Eric]C: He isn't in one of the states he should be in! Please report how you got to this message.";
	increase EricAnalCounter by 1;

to say EricSex8: [player's ass fucked by Eric]
	if HP of Eric is 22: [male with horse-cock repeats]
		say "     Giving him a smile, you move over to his camp bed and do a little strip-show, pulling off your clothes and doing some poses. Then you climb on the bed, resting on all fours and wiggle your ass at Eric invitingly. 'Want a ride, horseboy?'";
		say "			[WaitLineBreak]";
		say "     He looks a bit dumbstruck at you for a second, then has to bend over to take the strain off his rapidly growing erection trapped inside his shorts. You don't think he had any gay encounters before all this, but after the temporary gender confusion and new urges to mount anyone from behind he inherited from the centaur donor of his 'cure', it seems his body is ready for it. And with the fun you're having together and him being incredibly thankful for saving him, you're sure he'll get over his last hangups soon too. After getting over the first moment of restraint, he almost rips his shirt off, then slides down his shorts and undies to free the massive erection dangling between his legs.";
		say "     Turning you over a bit so your butt is right at the edge of the bed, he stands behind you and rubs his horsecock up and down your crack. Taking hold of his shaft, he then aims the flared tip at your opening and pushes against it slow and steady until it opens up and he pops inside. You gasp as he enters your body, then quickly start moaning as the pain of the initial penetration fades against the feelings of his thick cock rubbing against your inner walls as he slides deeper. Holding on to your hips with both hands, Eric sinks himself into you, holding still a moment as he bottoms out. Then he starts fucking in and out of you - first slowly, then faster and faster as his arousal rises.";
		say "     Grunting in satisfaction of mounting someone from behind, he puts his arms around you, feeling up your chest and kissing your neck as he sinks his shaft all the way inside. Then he starts all-out rutting, the thick horsecock sliding in and out of your tight hole in hard and deep moves. You quickly climax from this animalistic fuck, your body shaking as you [if cocks of player > 0]shoot spurt after spurt of cum onto the sheets[else if cunts of player > 0]drip a copious amount of femcum onto the sheets[else]have an orgasm[end if]. Not too long after, Eric follows suit, filling your hole with a massive load of his fertile seed from his large horse balls.[mimpregchance]";
		say "			[WaitLineBreak]";
		say "     With the thick shaft of his cock still pulsing softly inside you as it spurts more cum, Eric pulls you down to lie on your sides on the bed together. In between panting for breath, he gives you another kiss on the neck and says 'Wow. You're the best.' followed by a last little thrust of his manhood into you.";
	else if HP of Eric is 32 and bodyname of player is "Satyr": [satyr-cock Eric + satyr-body player]
		say "     Feeling an rush of eager, wild excitement running through you, you strip quickly in front of him, putting your satyr-like body on display for him. Seeing the growing bulge in his shorts, you grin and climb onto his cot, waving your ass invitingly at him. 'Climb on, satyrboy?' you ask with a laugh.";
		say "			[WaitLineBreak]";
		say "     Hardly aware of what he's doing at first, he yanks down his shorts and briefs to free his hard, satyr cock. While you don't think he had any gay encounters before all this, between everything that's been happening to him and all you've done for him (including giving him that hard, throbbing cock that you now so clearly desire), he hardly hesitates as realizes what's being offered. His restraint only lasting a moment, he reaches out runs his hands over your satyr body as he gets you to back that ass up to the edge of the cot.";
		say "     Groping your ass, he stands behind you and rubs his satyr cock up and down your crack, letting his precum leak out and get you slick. Taking hold of his shaft, he then aims the dribbling tip at your opening and pushes against it slow and steady until it opens up and he pops inside. You gasp as he enters your body, soon moaning in pleasure and pushing back for more as the initial discomfort fades very quickly, your satyr body lusting for his satyr cock within it. The feel of his virile cock rubbing against your inner walls as he slides deeper is exciting, intoxicating even, and you grip the cot and tell him to fuck you harder. Needing little encouragement in this regard, the athletic young man sets himself to pounding into you with both hands gripping your ass tightly.";
		say "     Grunting in satisfaction of mounting someone from behind, he puts his arms around you, feeling up your chest and kissing your neck as he pounds away at you with wild abandon. During this all-out rutting, the throbbing satyr cock slides in and out of your tight hole in hard and deep moves. You quickly climax from this animalistic fuck, your body shaking as you [if cocks of player > 0]shoot spurt after spurt of cum onto the sheets[else if cunts of player > 0]drip a copious amount of femcum onto the sheets[else]have an orgasm of full-bodied pleasure[end if]. Not too long after, Eric follows suit, filling your hole with a massive load of his fertile seed from his large goat balls. Holding his cock deep inside you, he pauses for a few breaths while his cum trickles deeper inside you before starting up again. Soon enough, he's going at you full tilt again and you're moaning and laughing lustfully beneath him as he does. It's only after another heavy load of satyr cum in your ass that he pulls out, yanking out quickly and pumping his throbbing cock to spray the rest of his semen across your well-used ass.[mimpregchance]";
		say "			[WaitLineBreak]";
		say "     With his hand sliding along your sexy body, he moves around in front of you. In between panting for breath, he gives you quick kiss before patting your sticky ass lightly and stepping away. 'That was wonderful, but I... I should go, before go at it again. If I keep at it, it feels like I might never want to stop.'  A little disappointed that your snuggling with him has to be cut short, you nod and smile, telling him that you'll be looking forward to the next time he's ready for more.";
	else if HP of Eric is 32: [satyr Eric repeats]
		say "     Giving him a smile, you move over to his camp bed and do a little strip-show, pulling off your clothes and doing some poses. Then you climb on the bed, resting on all fours and wiggle your ass at Eric invitingly. 'Climb on, satyrboy?'";
		say "			[WaitLineBreak]";
		say "     He looks a bit dumbstruck at you for a second, then has to bend over to take the strain off his rapidly growing erection trapped inside his shorts. You don't think he had any gay encounters before all this, but after the temporary gender confusion and new urges to mount anyone from behind he inherited from his satyr cock, it seems his body is ready for it. And with the fun you're having together and him being incredibly thankful for saving him, you're sure he'll get over his last hangups soon too. After getting over the first moment of restraint, he almost rips his shirt off, then slides down his shorts and undies to free the massive erection dangling between his legs.";
		say "     Turning you over a bit so your butt is right at the edge of the bed, he stands behind you and rubs his satyrcock up and down your crack. Taking hold of his shaft, he then aims the dribbling tip at your opening and pushes against it slow and steady until it opens up and he pops inside. You gasp as he enters your body, then quickly start moaning as the pain of the initial penetration fades against the feelings of his thick cock rubbing against your inner walls as he slides deeper. Holding on to your hips with both hands, Eric sinks himself into you, holding still a moment as he bottoms out. Then he starts fucking in and out of you - first slowly, then faster and faster as his arousal rises.";
		say "     Grunting in satisfaction of mounting someone from behind, he puts his arms around you, feeling up your chest and kissing your neck as he sinks his shaft all the way inside. Then he starts all-out rutting, the throbbing satyrcock sliding in and out of your tight hole in hard and deep moves. You quickly climax from this animalistic fuck, your body shaking as you [if cocks of player > 0]shoot spurt after spurt of cum onto the sheets[else if cunts of player > 0]drip a copious amount of femcum onto the sheets[else]have an orgasm of full-bodied pleasure[end if]. Not too long after, Eric follows suit, filling your hole with a massive load of his fertile seed from his large goat balls.[mimpregchance]";
		say "			[WaitLineBreak]";
		say "     With the thick shaft of his cock still pulsing softly inside you as it spurts more cum, Eric pulls you down to lie on your sides on the bed together. In between panting for breath, he gives you another kiss on the neck and says 'Wow. You're the best.' followed by a last little thrust of his manhood into you.";
	else:
		say "ERROR-Eric-[HP of Eric]D: He shouldn't have a cock right now! Please report how you got to this message.";

to say EricSex9: [trick David into fucking submissive Eric]
	if (HP of Eric is 99): [sex-slave cuntboy]
		say "     Deciding it's the right time for your little switch & fuck plan, you meet Eric's eyes with a meaningful glance and nod over to David. The submissive cuntboy gives a sigh, then lowers a hand to his crotch to play with himself and get ready for a fuck. Good - you make a last stop to pick up the ribbons of soft fabric you cut a shawl from library lost and found into, then walk over to David.";
		say "			[WaitLineBreak]";
		say "     Stepping up close to the young soldier, you put your arms around him and pull him in for a deep kiss, then let your hands wander down to his crotch. Through the fabric you feel his manhood already filling out, as his body reacts to you kiss and touch. As you make out with him some more, you slide your hands under his shirt and feel your way up his hard-muscled chest, then pull the fabric up and over his head. Leaning down a bit you run your tongue over his nipples, playfully sucking on first one, then the other. From David's lustful moans, he's ready and itching to get going.";
		say "     Opening up the zipper of his pants and letting them drop down, you free his raging hard-on, standing proudly erect in your direction. Guiding the naked man to a nearby cot, you push him to sit down on it, then take in hand your ribbons. With a grin, you tell him that you want to play a bit this time and stroke the ribbon softly over his skin before you put it around his eyes as a blindfold. Then you push the smiling man back to lie on the cot and bind first his legs, then his arms raised over his head to its frame. Stroking his body, slowly and sensually, you keep him aroused - without ever touching his cock.";
		say "			[WaitLineBreak]";
		say "     Going on like that, you keep him all hot and bothered for five, six, seven minutes until he starts pleading, then begging for a jerk-off, blow-job, or someone riding his dick. Grinning, you lean over him and give him a kiss, then reach out and grab his hard shaft. As you start turning around to look over to Eric's camp bed, you notice he's already standing just two steps behind you, naked. Letting your eyes wander over him, you check out his slender frame, nicely defined chest, long legs, and of course he slightly swollen and pretty moist pussy. Perfect.";
		say "     As you guide Eric onto the bed and he moves to kneel over the soldier, you tell David to get ready for an amazing fuck. Then Eric is in position, ready pussy poised directly over Eric's hard shaft, biting his lip and looking at you. As you nod to him and motion him downwards, he takes a deep breath, then sinks himself onto David's manhood. The soldier gives a satisfied gasp, then moans as Eric sinks deeper and deeper until finally all of David's length is inside him. Then he pulls up a bit again before thrusting down, fucking himself on the hard cock.";
		say "			[WaitLineBreak]";
		say "     You let them continue for a bit, watching their coupling and stroking yourself. When it looks like David's getting close, you kneel beside the cot and ask him if he likes fucking this hole. 'Amazing - you're so ho... wait a minute! What's... who is... what is going on here?' David sputters, as he realizes you can't talk to him from the side while you're on top of him. As he starts pulling on his bindings, you tell him to keep still and loosen his blindfold. David's eyes widen as he sees Eric on top of him, still grinding their hips together and moaning in lust.";
		say "     Getting on the bed, you pull Eric's head to yours and kiss him deeply. Demonstratively stroking the cuntboy's chest and playing with his nipples, you explain to David that Eric has urgent needs for someone to fuck him regularly and that he just look at how much he enjoys it. The cuntboy just keeps moans loudly through this, lost in a sexual buzz. Looking down, you see David thrust up against Eric, trying to get his cock deeper in his pussy. Seems like you've successfully made him forget those silly notions about not taking advantage of your submissive cuntboy...";
		say "			[WaitLineBreak]";
		say "     With David now eagerly thrusting into Eric, it doesn't take much longer until the additional stimulation drives the young athlete over the edge. Gasping and moaning, he holds onto you as his whole body shudders in lust, and you see quite a bit of femcum run down over David's thrusting cock. Bending down a bit, you grab David's balls and start fondling them, meanwhile egging him on to fill Eric's pussy with his seed, just as it was meant to be.";
		say "     Whether it was your command or maybe the stroking of his balls, something gave the young soldier the final push. With a lust-filled shout, he starts shooting his cum into Eric's vagina, his balls pulsing under your finger with each squirt. When Eric pulls off and flops down on the cot to cuddle up against David, you loosening the bindings, freeing the soldier. Looks like your plan worked perfectly - having fucked him once, David should be ready for more fun with Eric. But for now, you leave them lying together on the cot to rest.";
		now lust of Eric is 4;
	else:
		say "ERROR-Eric-[HP of Eric]D: He shouldn't have a cock right now! Please report how you got to this message.";

to say EricSex10: [have Eric fuck David's ass - first time]
	if (HP of Eric is 21 or HP of Eric is 22): [horse-hung Eric]
		say "     You ask Eric if he's ready for some fun with David. He smiles, nodding before giving you a quick kiss on the lips. While groping his crotch through the fabric of his trousers, you tell him to come over and join the two of you when you got David ready. Then you saunter over to David's camp bed, where the soldier boy is just taking a nap.";
		say "     Carefully pulling the blanket from the bed, you reveal David's sleeping body, clad in just a t-shirt and some boxer briefs. He looks pretty hot, lying there peacefully. Sitting next to him on the bed, you softly stroke his arm, then tuck up the shirt a bit and reveal his well-defined abs. David stirs a bit, maybe from the colder air touching him, then calms down again, still asleep. Moving your hand down, you stroke the inside of his legs, then softly fondle his cock and balls through his undies. A small moan escapes from the sleeping man and you feel his cock getting noticeably harder under your fingers. You'd bet that you just put an interesting turn in whatever he is dreaming about...";
		say "			[WaitLineBreak]";
		say "     As nice as playing with David's body and giving him sexy dreams is, you got bigger plans, so you lean down over your sleeping beauty and give him a deep kiss. Just like in a fairytale, his eyes open almost immediately and after David sees it's you, he returns your kiss with one of his own. Meanwhile, you reach down and push your hand under the band of his undies, cupping his cock and balls. Giving a pant at feeling you touch him there, David says 'I just had an amazing dream. The last thing I remember is being out in a snowy forest, and suddenly someone appeared from behind a tree and...' *he blushes a bit* '...had his way with me.'";
		say "     Smiling at David, you tell him that you'll make his dreams come true and pull the t-shirt up and over his head. Running your hands down over his chest, you then move on to his underwear, sliding it down his legs to leave the soldier naked on the bed. You grab his erect cock and jerk it slowly, with your other hand playing with his hole, teasing it and pushing a finger inside. In no time at all, you have David panting and moaning at your ministrations, his anal muscles almost hungrily gripping your finger. Then you ask if he ever thought about... getting fucked by someone else. Eric, for example - to which David replies 'I wouldn't cheat on you, but - yes. He is pretty cute, and that dick of his...' *you unobtrusively wave Eric over* '...is quite something. Why do you - oh!' David says as the college athlete steps into his sight, naked and with his horsecock dangling fully erect between his legs.";
		say "			[WaitLineBreak]";
		say "     Telling them to have some fun together, you then take Eric by the hand and guide him to the bottom of the bunk. His looks wander up along David's legs, puckering hole and erect manhood, his defined chest and handsome face. Then their eyes meet, and you can almost feel a spark of sexual tension jumping over. With no further words necessary, you watch Eric climb onto the bed and start kissing David's lips, his body on top of the soldier's larger one. Quite a nice show, with them hungrily making out as their cocks rub against each other.";
		say "     Soon, Eric slides back a bit and pulls David's legs up, then guides his thick horsecock to the young man's waiting hole. Slowly pressing forward, his cock's flared head pops inside David. Waiting for a moment so the soldier can get used to it, Eric leans back forward to give him another kiss, then continues sinking his shaft deeper and deeper into the tight hole it's in. A few minutes of slow penetration finally results in their hips meeting, with both of the men gasping from the feelings they give each other. Then they start to fuck, with Eric's long cock thrusting deep into David and the slapping noises of his large horse's balls hitting the soldier's cheeks.";
		say "			[WaitLineBreak]";
		say "     Not wanting to get between those two in their first time together, you decide to just watch the soldier and college kid for now. Stroking your own [if cocks of player > 0]cock[else if cunts of player > 0]cunt[else]body[end if] excitedly as you watch their hot coupling, your thoughts already fly to being on the bed with them the next time.";
		say "     With the... enthusiasm those two show for fucking each other, it doesn't surprise you that not much later, Eric's gasps rise to lust-filled screams as he announces 'I'm... *gasp* ...coming!' With that, he throws his head back, hands gripping David's legs as his balls unload one of his typical huge loads into the soldier's ass. The thick shaft inside him pulsing with bursts of cum drives the young soldier over the edge too just moments later, cum shooting from his human cock to splat down on his muscled chest. After a moment where they catch their breath, your two friends resume hugging and kissing each other.";
		say "			[WaitLineBreak]";
		say "     What a hot show. You leave the two of them alone to lie together on the bed, kissing and still connected by Eric's slowly softening cock...";
		now lust of Eric is 4;
	else if HP of Eric is 31 or HP of Eric is 32: [satyr-hung Eric]
		say "     You ask Eric if he's ready for some fun with David. He smiles, nodding before giving you a quick kiss on the lips. While groping his crotch through the fabric of his trousers, you tell him to come over and join the two of you when you got David ready. You then saunter over to David's camp bed, where the soldier boy is just taking a nap.";
		say "     Carefully pulling the blanket from the bed, you reveal David's sleeping body, clad in just a t-shirt and some boxer briefs. He looks pretty hot, lying there peacefully. Sitting next to him on the bed, you softly stroke his arm, then tuck up the shirt a bit and reveal his well-defined abs. David stirs a bit, maybe from the colder air touching him, then calms down again, still asleep. Moving your hand down, you stroke the inside of his legs, then softly fondle his cock and balls through his undies. A small moan escapes from the sleeping man and you feel his cock getting noticeably harder under your fingers. You'd bet that you just put an interesting turn in whatever he is dreaming about...";
		say "			[WaitLineBreak]";
		say "     As nice as playing with David's body and giving him sexy dreams is, you got bigger plans, so you lean down over your sleeping beauty and give him a deep kiss. Just like in a fairytale, his eyes open almost immediately and after David sees it's you, he returns your kiss with one of his own. Meanwhile, you reach down and push your hand under the band of his undies, cupping his cock and balls. Giving a pant at feeling you touch him there, David says 'I just had an amazing dream. The last thing I remember is being out in a snowy forest, and suddenly someone appeared from behind a tree and...' *he blushes a bit* '...had his way with me.'";
		say "     Smiling at David, you tell him that you'll make his dreams come true and pull the t-shirt up and over his head. Running your hands down over his chest, you then move on to his underwear, sliding it down his legs to leave the soldier naked on the bed. You grab his erect cock and jerk it slowly, with your other hand playing with his hole, teasing it and pushing a finger inside. In no time at all, you have David panting and moaning at your ministrations, his anal muscles almost hungrily gripping your finger. Then you ask if he ever thought about... getting fucked by someone else. Eric, for example - to which David replies 'I wouldn't cheat on you, but - yes. He is pretty cute, and that dick of his...' *you unobtrusively wave Eric over* '...is quite something. Why do you - oh!' David says as the college athlete steps into his sight, naked and with his satyrcock jutting fully erect in front of him.";
		say "			[WaitLineBreak]";
		say "     Telling them to have some fun together, you then take Eric by the hand and guide him to the bottom of the bunk. His looks wander up along David's legs, puckering hole and erect manhood, his defined chest and handsome face. Then their eyes meet, and you can almost feel a spark of sexual tension jumping over. With no further words necessary, you watch Eric climb onto the bed and start kissing David's lips, his body on top of the soldier's larger one. Quite a nice show, with them hungrily making out as their cocks rub against each other.";
		say "     Soon, Eric slides back a bit and pulls David's legs up, then guides his throbbing satyrcock to the young man's waiting hole. Slowly pressing forward, his tapered head pops inside David. Waiting for a moment so the soldier can get used to it, Eric leans back forward to give him another kiss, then continues sinking his shaft deeper and deeper into the tight hole it's in. When the slow penetration finally results in their hips meeting, both of the men gasp from the feelings they give each other. Then they start to fuck, with Eric's long cock thrusting deep into David and the slapping noises of his heavy goat balls hitting the soldier's cheeks.";
		say "			[WaitLineBreak]";
		say "     Not wanting to get between those two in their first time together, you decide to just watch the soldier and college kid for now. Stroking your own [if cocks of player > 0]cock[else if cunts of player > 0]cunt[else]body[end if] excitedly as you watch their hot coupling, your thoughts already fly to being on the bed with them the next time.";
		say "     With the... enthusiasm those two show for fucking each other, it doesn't surprise you that not much later, Eric's gasps rise to lust-filled screams as he announces 'I'm... *gasp* ...coming!' With that, he throws his head back, hands gripping David's legs as his balls unload one of his typical huge loads into the soldier's ass. The capric shaft inside him pulsing with bursts of cum drives the young soldier over the edge too just moments later, cum shooting from his human cock to splat down on his muscled chest. After a moment where they catch their breath, your two friends resume hugging and kissing each other.";
		say "			[WaitLineBreak]";
		say "     What a hot show. You leave the two of them alone to lie together on the bed, kissing and still connected by Eric's slowly softening cock...";
		now lust of Eric is 4;
	else:
		say "ERROR-Eric-[HP of Eric]C: He isn't in one of the states he should be in! Please report how you got to this message.";

to say EricSex11: [have David fuck Eric's pussy - first time]
	if (HP of Eric > 10 and HP of Eric < 16): [cuntboy repeat sex]
		say "     You ask Eric if he's ready for some fun with David. He smiles, nodding before giving you another quick kiss on the lips. Taking Eric by the hand, you lead him over to David's camp bed and push your hands under his shirt. After feeling up his firm chest muscles for a moment, next you take hold of the shirt and pull it off him. Then it's time for the shorts, which you slide down his long runner's legs, stroking over his soft skin as you go. Now your handsome athlete is almost naked before you and an interestedly watching David, just wearing a skimpy white tanga already showing a little damp spot at the front.";
		say "     Running your hands over his body, you pull Eric in for another quick kiss, then softly push him backwards against the bed and make him lie down on it. You stroke over the thin fabric of his panties with your fingers, making him moan needily. Looks like your cuntboy is about ready... you pull the wisp of fabric off his body, revealing a ready pussy with open, glistening lips. Turning to David, whose looks are just roaming over Eric's naked body and his moist opening, you ask if he'd like to show your friend a good time. Explaining that he's just waiting for David's cock, you emphasize it by stroking Eric's sensitive pussy lips, making him moan loudly.";
		say "			[WaitLineBreak]";
		say "     You can see a wide-eyed David moisten his lips and swallow, then he breaks through the hesitation and steps up, taking your place between Eric's legs. He brings his hands forward, stroking Eric's lips, and is rewarded by a pleased moan by the young athlete. Emboldened by that, the soldier lowers his head and starts licking Eric's pussy. Standing beside the bed, you watch your two friends have oral sex, with David doing an admirable job of licking and fondling Eric, bringing him to a higher and higher state of arousal. Soon the handsome cuntboy's moans and gasps reach a new level of urgency, one you recognize as the need to get fucked.";
		say "     Stepping up behind David, you whisper to him that Eric is ready and he should take him now, after which you pull his shirt up and over his head. Then you reach around him to undo his pants, freeing his raging boner as you pull them down to his knees. Giving the young man a soft push and a playful slap on the bare ass, you start him moving forwards, climbing up on the bed between Eric's spread legs. With a swift and sure move, he does what comes natural next, sinking his manhood deep into Eric's warm folds and covering the slender athlete's body with his. Their moans get a bit muffled after that as they make out with each other hungrily.";
		say "			[WaitLineBreak]";
		say "     Not wanting to get between those two in their first time together, you just watch the soldier and college athlete wrestle each other's tongues, then start fucking in earnest. David proves to be well versed in pleasing women... or cuntboys - thrusting deep into Eric, adjusting his angle to hit just the right spots and knowing when it's best just to rest his shaft inside his pussy and lean in for a kiss. You stroke your own [if cocks of player > 0]cock[else if cunts of player > 0]cunt[else]body[end if] excitedly as you watch their hot coupling, thoughts already wandering to possible future threesomes.";
		say "     With the... enthusiasm those two show for fucking each other, it doesn't surprise you that not much later, Eric's gasps rise to lust-filled screams as he announces 'Ah. Ah! I'm... *gasp* ...coming!' With that, he throws his head back, eyes closed and tightly clutches on to David to ride out his orgasm. The young soldier stops for a while to give Eric a moment to catch his breath, then kisses him deeply while his hips grind against the cuntboy's crotch in a need-filled burst for the finish line. With a grunt, he suddenly stops with his shaft buried deep inside Eric's pussy, and bending down to look, you can see his balls twitch as they deliver burst after burst of his cum deep into Eric's womb.";
		say "			[WaitLineBreak]";
		say "     What a hot show. You leave the two of them alone to lie together on the bed, kissing and still connected by David's slowly softening cock...";
		now lust of Eric is 4;
	else:
		say "ERROR-Eric-[HP of Eric]C: He isn't in one of the states he should be in! Please report how you got to this message.";

to say EricSex12: [threesome with David+Eric]
	if (HP of Eric > 10 and HP of Eric < 16): [cuntboy repeat sex]
		say "     Running a hand through Eric's red hair, you give him a deep kiss, after which you ask if he'd like to mix things up a bit this time. Smiling at his curious expression, you run a finger along Eric's jawline, turning his head a bit so he looks towards the far side of the room. There, David is sitting on one of the unused beds with his back to you, reading a book.";
		say "     A boyish grin spreads over Eric's face as he nods, then pulls his shirt over his head and throws it over to his bunk. After kicking off his shoes, Eric's shorts follow the t-shirt, leaving him standing before you in only a small black tanga. Then even that is slid down his long runner's legs - albeit slower, to give you a bit of a show. Stepping up to you, he strokes your [skin of player] skin and proceeds to strip you too, sensuously caressing your body while removing any clothing you might have. When the two of you are naked, Eric raises a finger to his lips, then quietly walks over to where David is sitting. He takes care to stay behind the soldier, out of sight, and David doesn't notice anything until the cuntboy climbs on the bed behind him.";
		say "			[WaitLineBreak]";
		say "     Feeling the mattress give a bit, David looks over his shoulder. He starts saying 'Hey Eric -' until words fail him as his eyes wander lower, taking in the cuntboy athlete's nakedness. Eric doesn't really give David any time to recover his wits, moving beside him and going in for a deep kiss. Finding himself in a surprise make-out session, the book in the soldier's hands just gets dropped on the ground beside the bed, instantly forgotten as he reaches out to touch Eric's body. Swinging a leg on David's other side, Eric straddles his hips, then takes hold of the edge of David's t-shirt and peels it off him. Pushing against the young man's naked chest, Eric makes him lay back on the bed, then leans forward too for even more playful kissing.";
		say "     Getting pretty aroused by watching your two friends go at it, you decide it's time to join in. Stepping up to the bed, you kneel between David's legs and start rubbing his crotch through the tented fabric of his pants. Wow, he's really got a hard-on going there, leaking precum to create a damp spot on the trousers. Happy to lend a helping hand, you undo the button and zipper of David's pants, pulling them open to free his raging boner. Taking hold of the long shaft, you stroke it a few times, then rub it against Eric's soft skin before you finally position the tip between the cuntboy's dripping pussy lips. Following an instinct as old as the human race, David thrusts upward with a lust-filled moan, burying his cock deep inside Eric's body. After that, all out fucking ensures, with Eric riding the hard shaft inside his pussy and David grinding up against him.";
		say "			[WaitLineBreak]";
		if cocks of player > 0:
			say "     [EricSex12_12_Male]";
		else:
			say "     [EricSex12_12_Fondling]";
	else if HP of Eric is 22 or HP of Eric is 32: [male Eric]
		say "     Running a hand through Eric's red hair, you give him a deep kiss, after which you ask if he'd like to mix things up a bit this time. Smiling at his curious expression, you run a finger along Eric's jawline, turning his head a bit so he looks towards the far side of the room. There, David is sitting on one of the unused beds with his back to you, reading a book.";
		say "     A boyish grin spreads over Eric's face as he nods, then pulls his shirt over his head and throws it over to his bunk. After kicking off his shoes, Eric's shorts follow the t-shirt, leaving him standing before you in only a pair of black briefs, bulging at the front. Then even those are slid down his long runner's legs - albeit slower, to give you a bit of a show - revealing his already pretty hard [if HP of Eric is 22]horsecock[else if HP of Eric is 32]satyrcock[end if] and his large balls. Stepping up to you, he strokes your [skin of player] skin and proceeds to strip you too, sensuously caressing your body while removing any clothing you might have. When the two of you are naked, Eric raises a finger to his lips, then quietly walks over to where David is sitting. He takes care to stay behind the soldier, out of sight, and David doesn't notice anything until the college athlete climbs on the bed behind him.";
		say "			[WaitLineBreak]";
		say "     Feeling the mattress give a bit, David looks over his shoulder. He starts saying 'Hey Eric -' until words fail him as his eyes wander lower, taking in the young man's nakedness. Eric doesn't really give David any time to recover his wits, moving beside him and going in for a deep kiss. Finding himself in a surprise make-out session, the book in the soldier's hands just gets dropped on the ground beside the bed, instantly forgotten as he reaches out to touch Eric's body. Swinging a leg on David's other side, Eric straddles his hips, then takes hold of the edge of David's t-shirt and peels it off him. Pushing against the young man's naked chest, Eric makes him lay back on the bed, then leans forward too for even more playful kissing.";
		say "     Getting pretty aroused by watching your two friends go at it, you decide it's time to join in. Stepping up to the bed, you kneel between David's legs and start rubbing his crotch through the tented fabric of his pants. Wow, he's really got a hard-on going there, leaking precum to create a damp spot on the trousers. Happy to lend a helping hand, you undo the button and zipper of David's pants, pulling them open to free his raging boner. After quickly removing his shoes and socks, you slide off his pants the rest of the way, leaving the soldier boy in delicious nakedness. Spreading his legs a bit further, you lean forward, bringing your face to his bubble butt, and start licking and teasing David's hole with your tongue. Soon he's pretty wet and relaxed, ready to be fucked.";
		if cocks of player > 0:
			say "     [EricSex12_22_32_Male]";
		else:
			say "     [EricSex12_22_32_Female]";
	else if HP of Eric is 99: [sex slave cuntboy Eric]
		say "     Moving a hand down to Eric's crotch, you stroke your fingers over his sensitive pussy lips, making him moan before he can stop himself. Pushing two fingers inside, you fondle him a bit. Soon Eric is panting in lust, his female parts ready and dripping. Then... you just stop. Pushing aside his hand trying to touch his pussy softly, but firmly, you leave him wait for a moment, a pleading look in his eyes. Good, that should do it. Running a finger along Eric's jawline, you turn his head a bit so he looks towards the far side of the room. There, David is sitting on one of the unused beds with his back to you, reading a book. Whispering to Eric to go offer himself to him, you step back to watch.";
		say "     There's a moment of hesitation with Eric biting his lip, then the need to get fucked wins out inside him and he walks over towards David. The young soldier gets wide eyes as a naked Eric steps into his line of sight, then sits on his lap and says '...I need someone inside me. Please - fuck me.' As David opens his mouth to say something, Eric moves in to kiss him. Hungrily making out with the young soldier, he swings around his leg to straddle his lap, Eric's crotch rubbing up against David's quickly growing bulge. You step closer, taking David's hand and putting it on Eric's tight ass-cheek. You egg him on a little to give the cuntboy what he needs, just like last time...";
		say "			[WaitLineBreak]";
		say "     Looks like the little push you gave him made David's arousal finally win out against his remaining restraint - he puts his other hand on the needy cuntboy's ass too, squeezing his cute bubble butt. Following another deep kiss between them, David pulls off his t-shirt, then moves his hands down to his crotch, opening his pants. Freeing his cock from its confinement, he rubs it over Eric's pussy lips, then guides the college athlete's hips down to sink himself onto the hard shaft. Watching your soldier friend start to fuck the submissive little cuntboy, your own arousal reaches a whole new level - time to join in.";
		if cocks of player > 0:
			say "     [EricSex12_99_Male]";
		else:
			say "     [EricSex12_99_Fondling]";
	else:
		say "ERROR-Eric-[HP of Eric]C: He isn't in one of the states he should be in! Please report how you got to this message.";

to say EricSex12_12_Male: [cuntboy Eric, male/herm player]
	say "     What shall it be you want to do with your two boys? Get into Eric's vagina in a double-penetration [link](1)[as]1[end link], fuck Eric's ass [link](2)[as]2[end link], fuck David's ass [link](3)[as]3[end link] or maybe fondle David's hole as he fucks Eric [link](4)[as]4[end link]?";
	now calcnumber is 0;
	while calcnumber < 1 or calcnumber > 4:
		say "Choice? (1-4)>[run paragraph on]";
		get a number;
		if calcnumber is 1 or calcnumber is 2 or calcnumber is 3 or calcnumber is 4:
			break;
		else:
			say "Invalid choice. Type [link]1[end link] to double-penetrate Eric's vagina, [link]2[end link] to fuck Eric in the ass, [link]3[end link] to fuck David in the ass or [link]4[end link] to finger-fuck David's hole.";
	if calcnumber is 1: [double vaginal]
		say "     Standing up from between David's legs, your hard [cock of player] cock bumps against Eric's bottom. Resisting the urge to just take him then and there, you lean over Eric, running your hands up along his sides and planting a line of kisses on his spine. Finally you're holding him from behind, your arms around his chest and your cock resting hotly against his back. You ask Eric if you can do a double penetration with David, but he's too blissed out from getting fucked to even notice your words. Only when you playfully lick and nibble his earlobe does he really listen to your repeated question. Between his moans, he answers 'Go ahead. *pant* I trust you, you're my rescuing hero, remember?'";
		say "     Taking hold of your shaft with one hand, you aim your erection a bit lower, then slowly push into the cuntboy's pussy beside David. All three of you gasp and moan at the incredible sensations of the double penetration course through your bodies, with David's and your cocks rubbing up against each other and both of them stretching out Eric's pussy. You give them a moment to get used to the feeling, then start thrusting in and out, reveling in the tightness of Eric's hole. When David resumes thrusting too, your cocks rub against each other, giving another bit of extra stimulation.";
		say "			[WaitLineBreak]";
		say "     With the three of you fucking each other in a wild threesome, the arousal of everyone involved soon mounts higher and higher. David is the first one to pass the point of no return, suddenly stiffening under Eric, with his cock pulsing against yours as spurt after spurt of his seed is shot deep into Eric's pussy. Getting bred by the young man, his body being filled with fertile cum, drives Eric to climax just a moment later. He gasps in lust, holding on to David's chest as the orgasm makes him writhe in pleasure. You speed up your own thrusts into Eric's stretched hole, now wet and slippery with his femcum and David's load. The thought of your soldier friend's cum lubing your cock as it pounds into the cuntboy athlete's hole makes your lust go into overdrive. After just a few more thrusts you come, pumping your seed into Eric's body to join and mingle with David's.";
		say "			[WaitLineBreak]";
		say "     Exhausted by the hot fuck, you rest for a moment against Eric's back, your slowly softening shaft still inside him. David moves his head to the side a bit to look at you over Eric's shoulder, then gives a satisfied chuckle and says 'Man, you two are quite something.' followed by a long kiss on Eric's lips and him addressing you with 'Come on, join us on the bed.' After you step back a bit to give them room to move, David lies down lengthwise on the bed, with Eric on top of him and enough room for you next to them. You eagerly join them, alternating in making out with both. Soon, this leads over to all of you cuddling in post-coital contentment.";
	else if calcnumber is 2: [fuck Eric's ass]
		say "     Standing up from between David's legs, your hard [cock of player] cock bumps against Eric's bottom. Taking hold of it with one hand, you aim your erection up a bit, then slowly push forward against the cuntboy's pucker. After a moment's resistance, it yields to your invading member, allowing you to slide inside his warm inner passage. Eric's hole stretched tight around your shaft gives you an incredible feeling, and the two of you moan in unison as you sink deeper and deeper. Suddenly you feel movement bump and rub against your cock - that must be David, his erection pumping in and out of Eric's other hole. So hot, to be able to feel him through the walls of Eric's insides.";
		say "			[WaitLineBreak]";
		say "     With the two of you fucking the Eric front and back, the arousal of everyone involved soon mounts higher and higher. David is the first one to pass the point of no return, suddenly stiffening under Eric, with his cock pulsing as spurt after spurt of his seed is shot deep into Eric's pussy. Getting bred by the young man, his body being filled with fertile cum, drives Eric to climax just a moment later. He gasps in lust, holding on to David's chest as the orgasm makes him writhe in pleasure. You speed up your own thrusts into Eric's asshole, eager to fill him with another load of cum. After just a few more thrusts you come, a huge load boiling up from your balls and shooting into Eric's body.";
		say "			[WaitLineBreak]";
		say "     Exhausted by the hot fuck, you rest for a moment against Eric's back, your slowly softening shaft still inside him. David moves his head to the side a bit to look at you over Eric's shoulder, then gives a satisfied chuckle and says 'Man, you two are quite something.' followed by a long kiss on Eric's lips and him addressing you with 'Come on, join us on the bed.' After you step back a bit to give them room to move, David lies down lengthwise on the bed, with Eric on top of him and enough room for you next to them. You eagerly join them, alternating in making out with both. Soon, this leads over to all of you cuddling in post-coital contentment.";
		increase EricAnalCounter by 1;
	else if calcnumber is 3: [fuck David's ass]
		if lust of David is 0: [anal virgin]
			say "     After pulling off his shoes and socks you reach for David's hips, grabbing the sides of his open pants, then pull them down over his legs. Now both your cuntboy and soldier friend are completely naked. Standing up from between David's legs, your hard [cock of player] cock bumps against Eric's bottom. Seductive too, but your true target lies somewhere else. Raising David's legs, you spread them and bend your knees a little bit, rubbing your hard [cock of player] cock against his virgin bottom.";
			say "     This is such a nice opportunity to break him in for some good fucking that you only just manage to hold back from plunging right in. Leaning forward to look at David around Eric's body on top of him, you ask him if you can fuck his ass. He doesn't really look at you, lying back on the mattress and moaning in lust - but he does nod and reach down to hold his legs up. Perfect. Taking hold of your shaft with one hand, you aim it a bit lower, then push in against his pucker. David gasps as his hole is spread for the first time by your invading member, but soon starts moaning even louder than before as you sink yourself deeper and deeper, rubbing against his prostate.";
			now lust of David is 1; [anally de-virginized]
		else:
			say "     After pulling off his shoes and socks you reach for David's hips, grabbing the sides of his open pants, then pull them down over his legs. Now both your cuntboy and soldier friend are completely naked. Standing up from between David's legs, your hard [cock of player] cock bumps against Eric's bottom. Seductive too, but your true target lies somewhere else. Raising David's legs, you spread them and bend your knees a little bit, rubbing your hard [cock of player] cock against his bottom.";
			say "     You can't wait to get back into this nice and tight soldier ass. Taking hold of your shaft with one hand, you aim it a bit lower, then push in against his pucker. David gasps in lust as his hole is spread by your invading member, then starts moaning even louder than before as you sink yourself deeper and deeper, rubbing against his prostate.";
		say "			[WaitLineBreak]";
		say "     Pounding David's ass with deep thrusts, you revel in the moans, gasps and slapping noises of your hips against his ass filling the whole bunker. Who'd have thought that post-apocalyptic survival would be like this? Fucking the tight hole of a handsome man while your cute cuntboy friend rides his cock - hell yeah, you'd pick this any day against your 'normal' life before. But moving your thoughts back to the thing at hand - or rather the hole you're balls deep in - you decide to change your rhythm of thrusts to match Eric's sliding up and down.";
		say "     Being penetrated at the same time as sliding into a pussy with his own cock has David pretty hot and bothered, and before too much longer, he moans 'I'm gonna... cummMMM!' He grabs Eric's hips to pull him tight against his crotch as his whole body shudders when spurt after spurt of cum shoot out of his cock and into Eric's waiting pussy. Getting bred by the young man, his body being filled with fertile cum, drives Eric to climax just a moment later. He gasps in lust, holding on to David's chest as the orgasm makes him writhe in pleasure. Meanwhile, your thrusting member being gripped by David's twitching anal muscles gives you the last bit of stimulation you needed too. Shoving your cock in all the way as you feel the need to cum rise inside your balls, a massive load of cum blasts through your shaft and into David's hole.";
		say "			[WaitLineBreak]";
		say "     Exhausted by the hot fuck, you rest for a moment against Eric's back, your slowly softening shaft still inside David. The soldier moves his head to the side a bit to look at you over Eric's shoulder, then gives a satisfied chuckle and says 'Man, you two are quite something.' followed by a long kiss on Eric's lips and him addressing you with 'Come on, join us on the bed.' After you step back a bit to give them room to move, David lies down lengthwise on the bed, with Eric on top of him and enough room for you next to them. You eagerly join them, alternating in making out with both. Soon, this leads over to all of you cuddling in post-coital contentment.";
	else: [fondle David's ass]
		say "     [EricSex12_12_Fondling]";

to say EricSex12_12_Fondling: [cuntboy Eric]
	say "			[WaitLineBreak]";
	if cocks of player > 0: [male player]
		say "     You decide to give your soldier-boy a little bit of anal attention. After pulling off David's shoes and socks you reach for his hips, grabbing the sides of his open pants, then pull them down over his legs. Now both your cuntboy and soldier friend are completely naked, an arousing sight to which you start jerking your erect manhood. Looking up at Eric sliding himself up and down on David's hard shaft, you stroke the soldier's inner thighs, then move your fingers up to his asshole. Rubbing lightly at first, then pushing in against it, your finger penetrates David's rear entrance, causing him to gasp in between his moans at fucking Eric.";
		say "			[WaitLineBreak]";
		say "     Slowly fingering the young man, you wait till you hear Eric's pants come faster and faster, showing he's getting close, then push deeper and caress David's prostate. With you carefully giving him some extra stimulation, you manage to push David over the edge to orgasm just as Eric reaches his climax too, making them come at the same time. Satisfied, you cup David's balls with your other hand, feeling them pulse and twitch as they deliver his fertile seed deep into Eric's body. That's so hot - pumping your fingers up and down over the hard shaft of your cock, you soon reach the point of no return yourself, spraying long strings of cum on the ground.";
		say "     After David finishes cumming in the cuntboy athlete's vagina and has time to catch his breath, he gives a satisfied chuckle and says 'Man, you two are quite something.' followed by a long kiss on Eric's lips. Not wanting to leave you out, he then moves to lie lengthwise on the bed, with Eric lying on top of him and room for you next to them. You eagerly join them, alternating in making out with both. Soon, this leads over to all of you cuddling in post-coital contentment.";
	else if cunts of player > 0: [female player]
		say "     You decide to give your soldier-boy a little bit of anal attention. After pulling off David's shoes and socks you reach for his hips, grabbing the sides of his open pants, then pull them down over his legs. Now both your cuntboy and soldier friend are completely naked, an arousing sight to which you start fingering yourself. Looking up at Eric sliding himself up and down on David's manhood, you stroke the soldier's inner thighs, then move your fingers up to his asshole. Rubbing lightly at first, then pushing in against it, your finger penetrates David's rear entrance, causing him to gasp in between his moans at fucking Eric.";
		say "			[WaitLineBreak]";
		say "     Slowly fingering the young man, you wait till you hear Eric's pants come faster and faster, showing he's getting close, then push deeper and caress David's prostate. With you carefully giving him some extra stimulation, you manage to push David over the edge to orgasm just as Eric reaches his climax too, making them come at the same time. Satisfied, you cup David's balls with your other hand, feeling them pulse and twitch as they deliver his fertile seed deep into Eric's body. That's so hot - you wish it was you with David's cock inside you. Pumping your caressing fingers in and out of your own cunt, you soon orgasm, imagining you're feeling David's shaft move inside you.";
		say "     After David finishes cumming in the cuntboy athlete's vagina and has time to catch his breath, he gives a satisfied chuckle and says 'Man, you two are quite something.' followed by a long kiss on Eric's lips. Not wanting to leave you out, he then moves to lie fully on the bed, with Eric lying on top of him and room for you next to them. You eagerly join them, alternating in making out with both. Soon, this leads over to all of you cuddling in post-coital contentment.";
	else: [neuter player]
		say "     You decide to give your soldier-boy a little bit of anal attention. After pulling off his shoes and socks you reach for his hips, grabbing the sides of his open pants, then pull them down over his legs. Now both your cuntboy and soldier friend are completely naked. Looking up at Eric sliding himself up and down on David's manhood, you stroke the soldier's inner thighs, then move your fingers up to his asshole. Rubbing lightly at first, then pushing in against it, your finger penetrates David's rear entrance, causing him to gasp in between his moans at fucking Eric.";
		say "			[WaitLineBreak]";
		say "     Slowly fingering the young man, you wait till you hear Eric's pants come faster and faster, showing he's getting close, then push deeper and caress David's prostate. With you carefully giving him some extra stimulation, you manage to push David over the edge to orgasm just as Eric reaches his climax too, making them come at the same time. Satisfied, you cup David's balls with your other hand, feeling them pulse and twitch as they deliver his fertile seed deep into Eric's body.";
		say "     After David finishes cumming in the cuntboy athlete's vagina and has time to catch his breath, he gives a satisfied chuckle and says 'Man, you two are quite something.' followed by a long kiss on Eric's lips. Not wanting to leave you out, he then moves to lie fully on the bed, with Eric lying on top of him and room for you next to them. You eagerly join them, alternating in making out with both. Soon, this leads over to all of you cuddling in post-coital contentment.";

to say EricSex12_22_32_Male: [horse-hung Eric, male/herm player]
	say "     So who shall be the lucky guy plunging his manhood into David's tight hole? Do you want to do it ([link]Y[as]y[end link]), or do you offer Eric the privilege ([link]N[as]n[end link])?";
	if player consents: [player fucks David]
		say "     Standing up from between David's legs, your hard [cock of player] cock bumps against Eric's bottom. Seductive too, but your true target lies somewhere else. Raising David's legs, you spread them and bend your knees a little bit, rubbing your hard [cock of player] cock against his ready bottom. You can't wait any longer to get back into this nice and tight soldier ass. Taking hold of your shaft with one hand, you aim it a bit lower, then push in against his pucker. David gasps in lust as his hole is spread by your invading member, then starts moaning loudly as you sink yourself deeper and deeper, rubbing against his prostate.";
		say "			[WaitLineBreak]";
		say "     As you start pounding David's ass with deep thrusts, Eric raises his upper body, then moves over to kneel on the bed beside David. Watching you fuck the soldier boy for a moment, he runs both his hands over his long [if HP of Eric is 22]horsecock[else if HP of Eric is 32]satyrcock[end if], taking up the drop of precum glistening at its tip and licking it off his finger. Then he leans forward, stealing a quick kiss from you before saying 'You look really hot, fucking him. Would we make it a chain thing? I'd love to give you a ride on my little pony too, you know...'";
		LineBreak;
		say "     Do you want him to fuck your ass while you do David ([link]Y[as]y[end link]), or would you rather see the two of them 69 ([link]N[as]n[end link])? ";
		if player consents: [Eric fucks player, who fucks David]
			say "     As you give him your ok, a lustful gleam begins to full Eric's eyes. Smiling, the gives you another peck on the lips, then jumps off the bed to move behind you. As you fuck David, you can feel Eric's hands on your cheeks, softly squeezing and spreading them, then rubbing the flared head of his cock up and down your crack. Using the copious amounts of precum leaking from his cock-head, he lubes your hole, then presses his shaft against your ready pucker and slides into your body. The large head and impressive length of the cock makes you moan and scream in lust, all restraint lost in the pleasure at fucking and being fucked at the same time.";
			say "			[WaitLineBreak]";
			say "     Being the center of a fuck sandwich quickly has you pretty hot and bothered, and before too much longer, you moan 'I'm gonna... cummMMM!' Grabbing David's hips, you grind your crotch against his ass, plunging your manhood as deep into the soldier boy as you can as the first spurt of your seed starts filling his hole. With your whole body shuddering in the grip of orgasm and twitching anal muscles flexing around Eric's shaft, it's not much of a surprise that the college athlete soon follows you to the point of no return. Giving a need-filled grunt as his large balls start churning out spurt after spurt of cum, Eric wraps his arms around you from behind and holds you tight.[mimpregchance]";
			say "			[WaitLineBreak]";
			say "     Keeping your position for a moment, you two ride out your orgasms, filling David's and your asshole with quite a bit of cum. After the last blasts of cum are shot and you've had time to catch your breaths, the three of you disengage. With David the odd man out, still sporting a furiously hard cock, Eric and you decide to take care of him - together. Moving the young soldier to the center of the bed, you kneel down left and right of him lick his shaft with both your tongues. As wound up as David already is, it doesn't take much more of this until he suddenly gasps and long strings of cum blast from his erection, splattering Eric's and your face, plus David's crotch with white fluid. After licking up the cum off each other and making out a bit more, all of you end up cuddling on the bed in post-coital contentment.";
		else: [player fucks David, David + Eric 69]
			say "     Not in the mood to get fucked right now, you distract Eric by taking his hand and putting it on David's hard cock, then ask him to give your friend a little attention instead and that David would surely want to suck you off in turn. Then you thrust into him again hard, making his answer a gasped moan. 'Sur- AH - aaah *pant* -sure.' With that, Eric moves to kneel over David's head, his long [if HP of Eric is 22]horsecock[else if HP of Eric is 32]satyrcock[end if] dangling into the soldier's face who grabs it with both hands, jerking its shaft and licking the flared head. A satisfied grin on his face, Eric then leans forward to rest on all fours above David's body and takes the other man's shaft into his own mouth, bobbing up and down on it.";
			say "			[WaitLineBreak]";
			say "     Being fucked and sucked off at the same time, it doesn't take too much longer until David's arousal peaks. With his lips tightly wrapped around Eric's [if HP of Eric is 22]equine[else if HP of Eric is 32]caprine[end if] shaft, David gives a somewhat muffled but still loud moan from his throat, a shudder running through his whole body as he comes. Looking down, you can see the soldier's balls twitch as they deliver blast after blast to paint Eric's tonsils white. Before you know it, looking at the hot little scene while David's anal muscles twitch and flex around your invading member drives you over the cliff to orgasm yourself. Holding on to David's legs tightly, you throw back your head in a lustful gasp, the first spurt of cum already shooting deep inside your friend's ass. Then a second shot follows, and a third, fourth... filling the young man with your seed.";
			say "			[WaitLineBreak]";
			say "     Keeping your position for a moment, you two ride out your orgasms, the last little spurts of cum splashing into Eric's mouth and David's ass. After you've had time to catch your breaths, the David and you turn to Eric, the odd man out, still sporting a furiously hard cock. Deciding to take care of him together, you have him get on his back in the center of the bed, then kneel down left and right of him lick his shaft with both your tongues. As wound up as Eric already is, it doesn't take much more of this until he suddenly gasps and long strings of cum blast from the flared head of his [if HP of Eric is 22]equine[else if HP of Eric is 32]caprine[end if] shaft, splattering David's and your face, plus Eric's crotch with white fluid. After licking up the cum off each other and making out a bit more, all of you end up cuddling on the bed in post-coital contentment.";
	else: [Eric fucks David]
		say "     Standing up from between David's legs, your hard [cock of player] cock bumps against Eric's bottom. Seductive too, but let's not get ahead of things. Leaning over your handsome college athlete, you plant a line of small kisses up his back, then whisper in his ear that David's ass is ready for his cock. Eric nods at you over his shoulder, then turns back to David and asks 'Can I fuck you? It was soo good last time.' Giving a slight moan as he thinks back to their first fuck, David sighs 'Sure. Ride me with your big cock.'";
		say "     You readily step back and make room for Eric to get up from the bed and take your place between David's legs. Cupping his large balls with one hand, he grabs his long [if HP of Eric is 22]equine[else if HP of Eric is 32]caprine[end if] shaft with the other and guides it to David's hole. With a deep moan from both of them, the flared head of the [if HP of Eric is 22]horsecock[else if HP of Eric is 32]satyrcock[end if] pushes through the young soldier's pucker, then slides deeper into his body. It leaves you almost spellbound to watch Eric's nonhuman shaft pushing further inside David's tight passage, stretching it tightly around his girth. Then, after he bottoms out and his balls touch David's ass, Eric pulls back most of the way and thrusts back in, fucking your friend with deep strokes.";
		LineBreak;
		say "     Though you could almost just stand back and watch them go at it, your own erection demands some attention. What do you want to do now? Fuck Eric while he shafts David ([link]Y[as]y[end link]), or rather get into some nice 69 action with David ([link]N[as]n[end link])? ";
		if player consents: [player fucks Eric, who fucks David]
			say "     Moving up behind Eric, you put your hands on his firm ass, softly squeezing his cheeks and spreading them, then rub the head of your [cock of player] cock up and down his crack. With all the precum you're leaking from the cock-head, it's easy to lube up his hole, then press forward against the college athlete's ready pucker and slid into his body. Your shaft spreading his passage tight around its girth makes your handsome friend moan and scream in lust, all restraint lost in the pleasure at fucking and being fucked at the same time.";
			say "			[WaitLineBreak]";
			say "     Being the center of a fuck sandwich quickly has Eric pretty hot and bothered, and before too much longer, he moans 'I'm gonna... cummMMM!' Grabbing David's hips, he grinds his crotch against the soldier boy's ass, plunging his manhood as deep as he can. His whole body twitches with each burst of cum spraying into David's back passage. Even the muscles inside of his ass flex rhythmically with his orgasm, gripping tightly around your shaft and driving your arousal up to and over the point of no return. Giving a lust-filled grunt, your balls start churning out spurt after spurt of cum to fill up Eric's asshole.";
			say "			[WaitLineBreak]";
			say "     Keeping your position for a moment, you two ride out your orgasms, filling David's and Eric's holes with quite a bit of cum. After the last blasts are shot and you've had time to catch your breaths, the three of you disengage. With David the odd man out, still sporting a furiously hard cock, Eric and you decide to take care of him - together. Moving the young soldier to the center of the bed, you kneel down left and right of him lick his shaft with both your tongues. As wound up as David already is, it doesn't take much more of this until he suddenly gasps and long strings of cum blast from his erection, splattering Eric's and your face, plus David's crotch with white fluid. After licking up the cum off each other and making out a bit more, all of you end up cuddling on the bed in post-coital contentment.";
			increase EricAnalCounter by 1;
		else: [Eric fucks David, player+David 69]
			say "     In the mood for some nice oral action, you move to kneel over David's head, leaving your [cock of player] dangling into the soldier's face. He happily takes hold of it, stroking your shaft and licking over the tip. A satisfied grin on your face, you lean forward to rest on all fours above David's body and take the young man's shaft into your own mouth, bobbing up and down on it.";
			say "			[WaitLineBreak]";
			say "     Being fucked and sucked off at the same time, it doesn't take too much longer until David's arousal peaks. With his lips tightly wrapped around your [cock of player] shaft, David gives a somewhat muffled but still loud moan from his throat, a shudder running through his whole body as he comes. You can see the soldier's balls twitch as the first blast of cum shoots into your mouth, then again and again. Eagerly swallowing your friend's seed, you move a hand to cup is balls and feel them twitch as he continues cumming. Hearing a gasped 'I'm coming.' from above, you see Eric grind his hips against David's ass, his cock doing slight jerks as cum blasts through it and into David. As he continues shooting for quite a bit, Eric starts up slow thrusts again, his shaft coming out of the soldier's hole covered in white cum.";
			say "			[WaitLineBreak]";
			say "     Keeping their position for a moment, the two of them ride out their orgasms, the last little spurts of cum splashing into David's ass and your mouth. After they've had time to catch their breaths, David and Eric turn to you, the odd man out, still sporting a furiously hard cock. Deciding to take care of you together, they have you get on his back in the center of the bed, then kneel down left and right of lick your shaft with both their tongues. As wound up as you already are, it doesn't take much more of this until you feel a tingling feeling rise in your balls and long strings of cum blast from your cock, splattering David and Eric's faces and your crotch. After licking up the cum off each other and making out a bit more, all of you end up cuddling on the bed in post-coital contentment.";

to say EricSex12_22_32_Female: [male Eric, female player]
	say "     Standing up from between David's legs, your ogle Eric's tight bottom for a moment, then shake out of it - it's time for fucking. Leaning over your handsome college athlete, you plant a line of small kisses up his back, then whisper in his ear that David's ass is ready for his cock. Eric nods at you over his shoulder, then turns back to David and asks 'Can I fuck you? It was soo good last time.' Giving a slight moan as he thinks back to their first fuck, David sighs 'Sure. Ride me with your big cock.'";
	if HP of Eric is 22: [horse-hung]
		say "     You readily step back and make room for Eric to get up from the bed and take your place between David's legs. Cupping his large balls with one hand, he grabs his long [if HP of Eric is 22]equine[else if HP of Eric is 32]caprine[end if] shaft with the other and guides it to David's hole. With a deep moan from both of them, the flared head of the [if HP of Eric is 22]horsecock[else if HP of Eric is 32]satyrcock[end if] pushes through the young soldier's pucker, then slides deeper into his body. It leaves you almost spellbound to watch Eric's nonhuman shaft pushing further inside David's tight passage, stretching it tightly around his girth. Then, after he bottoms out and his balls touch David's ass, Eric pulls back most of the way and thrusts back in, fucking your friend with deep strokes.";
	else if HP of Eric is 32: [satyr-hung]
		say "     You readily step back and make room for Eric to get up from the bed and take your place between David's legs. Cupping his large balls with one hand, he grabs his erect shaft with the other and guides it to David's hole. With a deep moan from both of them, the head of the satyr cock pushes through the young soldier's pucker, then slides deeper into his body. It leaves you almost spellbound to watch Eric's nonhuman shaft pushing further inside David's tight passage, stretching it tightly around his girth. Then, after he bottoms out and his balls touch David's ass, Eric pulls back most of the way and thrusts back in, fucking your friend with deep strokes.";
	LineBreak;
	say "     Though you could almost just stand back and watch them go at it, your own aroused body demands some attention. What do you want to do now? Climb on David's shaft and ride it with your pussy ([link]Y[as]y[end link]), or rather get into some nice 69 action with David ([link]N[as]n[end link])? ";
	if player consents: [Eric fucks David, David fucks player pussy]
		setmonster "human";
		choose row monster from the table of random critters;
		say "     Feeling a deep need to be filled with a hard cock, you get on the bed and straddle David's hips, sinking your pussy over his hard shaft. It feels great to have him inside you, his penis rubbing against your sensitive inner walls. Breathing deeply, you start sliding up and down, slow at first, then getting faster and faster as you fuck yourself on his erection.";
		say "			[WaitLineBreak]";
		say "     Being fucked in the ass and taking your pussy at the same time, it doesn't take too much longer until David's arousal peaks. Moaning loudly, he grips your hips tightly, pulling them down against his hips just as his cock erupts with a huge load, sending burst after burst of cum deep into your body. [fimpregchance] With David's body shaking with each spurt of cum, his anal muscles flexing around Eric's [if HP of Eric is 22]horsecock[else if HP of Eric is 32]satyrcock[end if], he does take the college athlete right with him over the edge. Hearing a gasped 'I'm coming.' from behind, you feel Eric wrap his arms around you to hold on to something as he grinds his hips against David's ass and fills the young soldier with his seed.";
		say "			[WaitLineBreak]";
		say "     Keeping their position for a moment, the two of them ride out their orgasms, the last little spurts of cum splashing into David's ass and your vagina. After they've had time to catch their breaths, David and Eric turn to you, the odd woman out, still furiously aroused. Deciding to take care of you together, they have you get on his back in the center of the bed, then kneel down left and right and alternate licking your pussy. As wound up as you already are, it doesn't take much more of this until you orgasm, squirting a fair bit of femcum your two boys eagerly lap up. After making out a bit more, all of you end up cuddling on the bed in post-coital contentment.";
	else: [Eric fucks David, David + player 69]
		say "     In the mood for some nice oral action, you move to kneel over David's head, leaving your moist pussy just above his face. He happily starts licking you, playing with your clit with his tongue and fingers. A satisfied grin on your face, you lean forward to rest on all fours above David's body and take the young man's shaft into your own mouth, bobbing up and down on it.";
		say "			[WaitLineBreak]";
		say "     Being fucked and sucked off at the same time, it doesn't take too much longer until David's arousal peaks. With his lips pressed against your pussy and his tongue wriggling in your vagina, David gives a somewhat muffled but still loud moan from his throat, a shudder running through his whole body as he comes. You can see the soldier's balls twitch as the first blast of cum shoots into your mouth, then again and again. Eagerly swallowing your friend's seed, you move a hand to cup is balls and feel them twitch as he continues cumming. Hearing a gasped 'I'm coming.' from above, you see Eric grind his hips against David's ass, his cock doing slight jerks as cum blasts through it and into David. As he continues shooting for quite a bit, Eric starts up slow thrusts again, his shaft coming out of the soldier's hole covered in white cum.";
		say "			[WaitLineBreak]";
		say "     Keeping their position for a moment, the two of them ride out their orgasms, the last little spurts of cum splashing into David's ass and your mouth. After they've had time to catch their breaths, David and Eric turn to you, the odd woman out, still furiously aroused. Deciding to take care of you together, they have you get on his back in the center of the bed, then kneel down left and right and alternate licking your pussy. As wound up as you already are, it doesn't take much more of this until you orgasm, squirting a fair bit of femcum your two boys eagerly lap up. After making out a bit more, all of you end up cuddling on the bed in post-coital contentment.";

to say EricSex12_99_Male: [sex slave Eric, male/herm player]
	say "     What shall it be you want to do with your two boys? Get into Eric's vagina in a double-penetration [link](1)[as]1[end link], fuck Eric's ass [link](2)[as]2[end link], fuck David's ass [link](3)[as]3[end link] or maybe fondle David's hole as he fucks Eric [link](4)[as]4[end link]?";
	now calcnumber is 0;
	while calcnumber < 1 or calcnumber > 4:
		say "Choice? (1-4)>[run paragraph on]";
		get a number;
		if calcnumber is 1 or calcnumber is 2 or calcnumber is 3 or calcnumber is 4:
			break;
		else:
			say "Invalid choice. Type [link]1[end link] to double-penetrate Eric's vagina, [link]2[end link] to fuck Eric in the ass, [link]3[end link] to fuck David in the ass or [link]4[end link] to finger-fuck David's hole.";
	if calcnumber is 1: [double vaginal]
		say "     Quickly stripping off your clothes, you step up to them. Putting a hand on Eric's back, you push his upper body forward until he's lying on top of David's chest. As the boys start kissing, you move a bit closer and stand between David's legs, your hard [cock of player] cock bumping against Eric's bottom. Taking hold of it with one hand, you aim your erection a bit lower, then push into the cuntboy's pussy beside David. All three of you gasp and moan at the incredible sensations of the double penetration course through your bodies, with David's and your cocks rubbing up against each other and both of them stretching out Eric's pussy. You give them a moment to get used to the feeling, then start thrusting in and out, reveling in the tightness of Eric's hole. When David resumes thrusting too, your cocks rub against each other, giving another bit of extra stimulation.";
		say "			[WaitLineBreak]";
		say "     With the three of you fucking each other in a wild threesome, the arousal of everyone involved soon mounts higher and higher. David is the first one to pass the point of no return, suddenly stiffening under Eric, with his cock pulsing against yours as spurt after spurt of his seed is shot deep into Eric's pussy. Getting bred by the young man, his body being filled with fertile cum, drives Eric to climax just a moment later. He gasps in lust, holding on to David's chest as the orgasm makes him writhe in pleasure. You speed up your own thrusts into Eric's stretched hole, now wet and slippery with his femcum and David's load. The thought of your soldier friend's cum lubing your cock as it pounds into the cuntboy's hole makes your lust go into overdrive. After just a few more thrusts you come, pumping your seed into Eric's body to join and mingle with David's.";
		say "			[WaitLineBreak]";
		say "     Exhausted by the hot fuck, you rest for a moment against Eric's back, your slowly softening shaft still inside him. After catching your breath, you pull out and give your pet cuntboy a playful slap on the ass, then go to freshen up a bit. David meanwhile stands up with his arms around Eric, holding him, and carries him over to his nearby bed where they lie down together to cuddle and rest in post-coital contentment.";
	else if calcnumber is 2: [fuck Eric's ass]
		say "     Quickly stripping off your clothes, you step up to them. Putting a hand on Eric's back, you push his upper body forward until he's lying on top of David's chest. As the boys start kissing, you move a bit closer and stand between David's legs, your hard [cock of player] cock bumping against Eric's bottom. Taking hold of it with one hand, you aim your erection up a bit, then push forward against the cuntboy's pucker. After a moment's resistance, it yields to your invading member, allowing you to slide inside his warm inner passage. Eric's hole stretched tight around your shaft gives you an incredible feeling, and the two of you moan in unison as you sink deeper and deeper. Suddenly you feel movement bump and rub against your cock - that must be David, his erection pumping in and out of Eric's other hole. So hot, to be able to feel him through the walls of the cuntboy's insides.";
		say "			[WaitLineBreak]";
		say "     With the two of you fucking the Eric front and back, the arousal of everyone involved soon mounts higher and higher. David is the first one to pass the point of no return, suddenly stiffening under Eric, with his cock pulsing as spurt after spurt of his seed is shot deep into Eric's pussy. Getting bred by the young man, his body being filled with fertile cum, drives Eric to climax just a moment later. He gasps in lust, holding on to David's chest as the orgasm makes him writhe in pleasure. You speed up your own thrusts into Eric's asshole, eager to fill him with another load of cum. After just a few more thrusts you come, pumping your seed into Eric's body.";
		say "			[WaitLineBreak]";
		say "     Exhausted by the hot fuck, you rest for a moment against Eric's back, your slowly softening shaft still inside him. After catching your breath, you pull out and give your pet cuntboy a playful slap on the ass, then go to freshen up a bit. David meanwhile stands up with his arms around Eric, holding him, and carries him over to his nearby bed where they lie down together to cuddle and rest in post-coital contentment.";
		increase EricAnalCounter by 1;
	else if calcnumber is 3: [fuck David's ass]
		say "     Quickly stripping off your clothes, you step up to them and kneel between David's legs. After pulling off his shoes and socks you reach for his hips, grabbing the sides of his open pants, then pull them down over his legs. Now both your cuntboy and soldier friend are completely naked, an arousing sight to which you start jerking your erect manhood.";
		if lust of David is 0: [anal virgin]
			say "     Putting your other hand on Eric's back, you push his upper body forward until he's lying on top of David's chest. As the boys start kissing, you move a bit closer and raise David's legs, spreading them as your hard [cock of player] cock bumps against his virgin bottom. This is such a nice opportunity to break him in for some good fucking that you just can't wait to get into him. Taking hold of your shaft with one hand, you aim it a bit lower, then push in against his pucker. David gasps as his hole is spread for the first time by your invading member, but soon starts moaning even louder than before as you sink yourself deeper and deeper, rubbing against his prostate.";
			now lust of David is 1; [anally de-virginized]
		else:
			say "     Putting your other hand on Eric's back, you push his upper body forward until he's lying on top of David's chest. As the boys start kissing, you move a bit closer and raise David's legs, spreading them as your hard [cock of player] cock bumps against his bottom. You can't wait to get back into his nice and tight soldier ass. Taking hold of your shaft with one hand, you aim it a bit lower, then push in against his pucker. David gasps in lust as his hole is spread by your invading member, then starts moaning even louder than before as you sink yourself deeper and deeper, rubbing against his prostate.";
		say "			[WaitLineBreak]";
		say "     Pounding David's ass with deep thrusts, you revel in the moans, gasps and slapping noises of your hips against his ass filling the whole bunker. Who'd have thought that post-apocalyptic survival would be like this? Fucking the tight hole of a handsome man as your submissive cuntboy rides his cock - hell yeah, you'd pick this any day against your 'normal' life before. But moving your thoughts back to the thing at hand - or rather the hole you're balls deep in - you decide to change your rhythm of thrusts to match Eric's sliding up and down.";
		say "     Being penetrated at the same time as sliding into a pussy with his own cock has David pretty hot and bothered, and before too much longer, he moans 'I'm gonna... cummMMM!' He grabs Eric's hips to pull him tight against his crotch as his whole body shudders when spurt after spurt of cum shoot out of his cock and into Eric's waiting pussy. Getting bred by the young man, his body being filled with fertile cum, drives Eric to climax just a moment later. He gasps in lust, holding on to David's chest as the orgasm makes him writhe in pleasure. Meanwhile, your thrusting member being gripped by David's twitching anal muscles gives you the last bit of stimulation you needed too. Shoving your cock in all the way as you feel the need to cum rise inside your balls, a massive load of cum blasts through your shaft and into David's hole.";
		say "			[WaitLineBreak]";
		say "     Exhausted by the hot fuck, you rest for a moment against Eric's back, your slowly softening shaft still inside David. After catching your breath, you pull out and give your pet cuntboy a playful slap on the ass, then go to freshen up a bit. David meanwhile stands up with his arms around Eric, holding him, and carries him over to his nearby bed where they lie down together to cuddle and rest in post-coital contentment.";
	else: [fondle David's ass]
		say "     [EricSex12_99_Fondling]";

to say EricSex12_99_Fondling: [sex slave Eric]
	if cocks of player > 0: [male player]
		say "     Quickly stripping off your clothes, you step up to them and kneel between David's legs. After pulling off his shoes and socks you reach for his hips, grabbing the sides of his open pants, then pull them down over his legs. Now both your cuntboy and soldier friend are completely naked, an arousing sight to which you start jerking your erect manhood. Looking up at Eric sliding himself up and down on David's hard shaft, you stroke the soldier's inner thighs, then move your fingers up to his asshole. Rubbing lightly at first, then pushing in against it, your finger penetrates David's rear entrance, causing him to gasp in between his moans at fucking Eric.";
		say "			[WaitLineBreak]";
		say "     Slowly fingering the young man, you wait till you hear Eric's pants come faster and faster, showing he's getting close, then push deeper and caress David's prostate. With you carefully giving him some extra stimulation, you manage to push David over the edge to orgasm just as Eric reaches his climax too, making them come at the same time. Satisfied, you cup David's balls with your other hand, feeling them pulse and twitch as they deliver his fertile seed deep into Eric's body. That's so hot - pumping your fingers up and down over the hard shaft of your cock, you soon reach the point of no return yourself, spraying long strings of cum on the ground.";
		say "     After David finishes cumming in the cuntboy's vagina and has time to catch his breath, he stands up with his arms around Eric, his shaft still deep inside the cuntboy. He carries him over to his nearby bed where they lie down together to cuddle and rest in post-coital contentment.";
	else if cunts of player > 0: [female player]
		say "     Quickly stripping off your clothes, you step up to them and kneel between David's legs. After pulling off his shoes and socks you reach for his hips, grabbing the sides of his open pants, then pull them down over his legs. Now both your cuntboy and soldier friend are completely naked, an arousing sight to which you start fingering yourself. Looking up at Eric sliding himself up and down on David's manhood, you stroke the soldier's inner thighs, then move your fingers up to his asshole. Rubbing lightly at first, then pushing in against it, your finger penetrates David's rear entrance, causing him to gasp in between his moans at fucking Eric.";
		say "			[WaitLineBreak]";
		say "     Slowly fingering the young man, you wait till you hear Eric's pants come faster and faster, showing he's getting close, then push deeper and caress David's prostate. With you carefully giving him some extra stimulation, you manage to push David over the edge to orgasm just as Eric reaches his climax too, making them come at the same time. Satisfied, you cup David's balls with your other hand, feeling them pulse and twitch as they deliver his fertile seed deep into Eric's body. That's so hot - you wish it was you with David's cock inside you. Pumping your caressing fingers in and out of your own cunt, you soon orgasm, imagining you're feeling David's shaft move inside you.";
		say "     After David finishes cumming in the cuntboy's vagina and has time to catch his breath, he stands up with his arms around Eric, his shaft still deep inside the cuntboy. He carries him over to his nearby bed where they lie down together to cuddle and rest in post-coital contentment.";
	else: [neuter player]
		say "     Quickly stripping off your clothes, you step up to them and kneel between David's legs. After pulling off his shoes and socks you reach for his hips, grabbing the sides of his open pants, then pull them down over his legs. Now both your cuntboy and soldier friend are completely naked. Looking up at Eric sliding himself up and down on David's manhood, you stroke the soldier's inner thighs, then move your fingers up to his asshole. Rubbing lightly at first, then pushing in against it, your finger penetrates David's rear entrance, causing him to gasp in between his moans at fucking Eric.";
		say "			[WaitLineBreak]";
		say "     Slowly fingering the young man, you wait till you hear Eric's pants come faster and faster, showing he's getting close, then push deeper and caress David's prostate. With you carefully giving him some extra stimulation, you manage to push David over the edge to orgasm just as Eric reaches his climax too, making them come at the same time. Satisfied, you cup David's balls with your other hand, feeling them pulse and twitch as they deliver his fertile seed deep into Eric's body. After he finishes cumming and has time to catch his breath, David stands up with his arms around Eric, his shaft still deep inside the cuntboy. He carries him over to his nearby bed where they lie down together.";

to say EricSex13: [threesome with Felinoid+Eric]
	if (HP of Eric > 10 and HP of Eric < 16): [cuntboy repeat sex]
		say "     Running a hand through Eric's red hair, you give him a deep kiss, after which you ask if he'd like to mix things up a bit this time. Smiling at his curious expression, you run a finger along Eric's jawline, turning his head a bit so he looks towards the far side of the room. There, your felinoid companion is lounging on his side on one of the unused beds, his golden eyes opening from time to time to look around, then closing again as he goes back to dozing peacefully.";
		say "     A boyish grin spreads over Eric's face as he nods, then pulls his shirt over his head and throws it over to his bunk. After kicking off his shoes, Eric's shorts follow the t-shirt, leaving him standing before you in only a small black tanga. Then even that is slid down his long runner's legs - albeit slower, to give you a bit of a show. Stepping up to you, he strokes your [skin of player] skin and proceeds to strip you too, sensuously caressing your body while removing any clothing you might have. When the two of you are naked, Eric raises a finger to his lips, then quietly walks over to where the felinoid is lying.";
		say "			[WaitLineBreak]";
		say "     Crouching down beside the bed the felinoid is lying on, Eric starts rubbing the big cat's belly fur, which quickly is answered by a resounding purr from the big beast. He slowly moves one of his stroking hands lower and lower until he reaches the felinoid's crotch, then cups the feline's furry balls, gently massaging them. By now, the large cat has raised his head to look down on Eric and you've moved in to scratch him behind the ears and on his chin. Soon, the felinoid's barbed cock starts poking out of its sheath, quickly hardening to its full glory. Eric goes on to grab the great cat's shaft and jerks on it while his other hand moves to his own crotch to rub an increasingly wet and dripping pussy. You notice the felinoid's entrancing musk starting to fill the air - not that he needs it this time, with two willing partners coming to him on their own.";
		say "     With the felinoid all relaxed from all the stroking and scritching, perfectly willing to let you two continue pleasing him, he just keeps on purring loudly as you take a muscular foreleg and Eric one of the hind legs and pull on them. It's pretty easy to roll the big feline over on his back, putting him in a stretched out position on the bed, legs spread and his manhood standing proudly erect. Giving you a wide smile, Eric climbs on top of the felinoid, bracing himself against the cat's muscular underside as he lowers himself down on its crotch. The cuntboy athlete gives a lust-filled pant as he feels the felinoid's cock start to spread his pussy lips, followed by a loud gasp as the big beast thrusts his hips up a bit with a growl and sinks himself halfway into the human.";
		say "			[WaitLineBreak]";
		say "     After getting in that first thrust, the felinoid relaxes again, content in letting the horny cuntboy on top of him fuck himself on his stiff pole. Which Eric does, with a lot of enthusiasm. Bouncing up and down on the feline shaft, your friend moans loudly and runs his hands through the large animal's belly fur, soon totally lost in the moment.";
		LineBreak;
		say "     Getting pretty aroused by watching your two friends go at it yourself, you decide it's time to join in.";
		if cocks of player > 0:
			say "     [EricSex13_12_Male]";
		else:
			say "     [EricSex13_12_Female]";
	else if HP of Eric is 22 or HP of Eric is 32: [male Eric]
		say "     Running a hand through Eric's red hair, you give him a deep kiss, after which you ask if he'd like to mix things up a bit this time. Smiling at his curious expression, you run a finger along Eric's jawline, turning his head a bit so he looks towards the far side of the room. There, your felinoid companion is lounging on his side on one of the unused beds, his golden eyes opening from time to time to look around, then closing again as he goes back to dozing peacefully.";
		say "     A boyish grin spreads over Eric's face as he nods, then pulls his shirt over his head and throws it over to his bunk. After kicking off his shoes, Eric's shorts follow the t-shirt, leaving him standing before you in only a pair of black briefs, bulging at the front. Then even those are slid down his long runner's legs - albeit slower, to give you a bit of a show - revealing his already pretty hard [if HP of Eric is 22]horsecock[else if HP of Eric is 32]satyrcock[end if] and his large balls. Stepping up to you, he strokes your [skin of player] skin and proceeds to strip you too, sensuously caressing your body while removing any clothing you might have. When the two of you are naked, Eric raises a finger to his lips, then quietly walks over to where the felinoid is lying.";
		say "			[WaitLineBreak]";
		say "     Trying hard not to make a noise, he starts rubbing the big cat's belly fur, which quickly is answered by a resounding purr from the big beast. He slowly moves one of his stroking hands lower and lower until he reaches the felinoid's crotch, then cups the feline's furry balls, gently massaging them. By now, the large cat has raised his head to look down on Eric and you've moved in to scratch him behind the ears and on his chin. Soon, the felinoid's barbed cock starts poking out of its sheath, quickly hardening to its full glory. Eric goes on to grab the great cat's shaft and jerks on it while his other hand moves to his own crotch to rub his hard [if HP of Eric is 22]horsecock[else if HP of Eric is 32]satyrcock[end if]. You notice the felinoid's entrancing musk starting to fill the air - not that he needs it this time, with two willing partners coming to him on their own.";
		say "     With the felinoid all relaxed from all the stroking and scritching, perfectly willing to let you two continue pleasing him, he just keeps on purring loudly as you take a muscular foreleg and Eric one of the hind legs and pull on them. It's pretty easy to roll the big feline over on his back, putting him in a stretched out position on the bed, legs spread and his manhood standing proudly erect. Giving you a wide smile, Eric climbs on top of the felinoid, bracing himself against the cat's muscular underside as he lowers himself down on its crotch. The college athlete gives a lust-filled pant as he feels the felinoid's precum-slick cock-head press against his pucker, followed by a loud gasp as the big beast thrusts his hips up a bit with a growl and sinks himself halfway into the human.";
		say "			[WaitLineBreak]";
		say "     After getting in that first thrust, the felinoid relaxes again, content in letting the horny athlete on top of him fuck himself on his stiff pole. Which Eric does, with a lot of enthusiasm. Bouncing up and down on the feline shaft, your friend moans loudly and runs his hands through the large animal's belly fur, soon totally lost in the moment.";
		LineBreak;
		say "     Getting pretty aroused by watching your two friends go at it yourself, you decide it's time to join in.";
		if cocks of player > 0:
			say "     [EricSex13_22_32_Male]";
		else:
			say "     [EricSex13_22_32_Female]";
		increase EricAnalCounter by 1;
	else if HP of Eric is 99: [sex slave cuntboy Eric]
		say "     Moving a hand down to Eric's crotch, you stroke your fingers over his sensitive pussy lips, making him moan before he can stop himself. Pushing two fingers inside, you fondle him a bit. Soon Eric is panting in lust, his female parts ready and dripping. Then... you just stop. Pushing aside his hand trying to touch his pussy softly, but firmly, you leave him wait for a moment, a pleading look in his eyes. Good, that should do it. Running a finger along Eric's jawline, you turn his head a bit so he looks towards the far side of the room. There, your felinoid companion is lounging on his side on one of the unused beds, his golden eyes opening from time to time to look around, then closing again as he goes back to dozing peacefully. Whispering to Eric to go offer himself to him, you step back to watch.";
		say "     There's a moment of hesitation with Eric biting his lip, then the need to get fucked wins out inside him and he quietly walks over to where the felinoid is lying. He starts rubbing the big cat's belly fur, which quickly is answered by a resounding purr from the big beast. Then he slowly moves one of his stroking hands lower and lower until he reaches the felinoid's crotch and cups the feline's furry balls, gently massaging them. Coming fully awake now, the large cat raises his head and looks down on Eric, then sniffs the air (no doubt full of the scent of the little slut's dripping pussy) and gives a pleased growl.";
		say "			[WaitLineBreak]";
		say "     Lying down on the bed beside the one the felinoid is on, Eric spreads his legs and fingers his own pussy, readying himself for what will come next. Starting to purr with a very satisfied note, the great cat rises from his perch and moves closer to the human cuntboy with feline grace. He lowers his large head to Eric's crotch and gives it a good sniff, then laps at it several times before moving further up on top of him. Lowering his hips and doing small probing thrusts, the felinoid soon finds the opening of Eric's moist and ready pussy and plunges in. With a satisfied roar, he sinks all of his manhood inside, then starts fucking him with powerful and deep thrusts. Moans, pants and growls of lust fill the bunker and you move a bit closer to get a better view.";
		LineBreak;
		say "     Getting pretty aroused after a while of watching your two companions go at it, you decide it's time to join in. ";
		if cocks of player > 0:
			say "     [EricSex13_99_Male]";
		else:
			say "     [EricSex13_99_Female]";
	else:
		say "ERROR-Eric-[HP of Eric]C: He isn't in one of the states he should be in! Please report how you got to this message.";

to say EricSex13_12_Male: [cuntboy Eric]
	LineBreak;
	say "     What shall it be you want to do with your cuntboy and felinoid friends? Fuck Eric's ass [link](1)[as]1[end link], or rather the felinoid's ass [link](2)[as]2[end link], maybe get a blow-job from Eric [link](3)[as]3[end link] or present your manhood to the felinoid to have him lick it [link](4)[as]4[end link]?";
	now calcnumber is 0;
	while calcnumber < 1 or calcnumber > 4:
		say "Choice? (1-4)>[run paragraph on]";
		get a number;
		if calcnumber is 1 or calcnumber is 2 or calcnumber is 3 or calcnumber is 4:
			break;
		else:
			say "Invalid choice. Type [link]1[end link] to fuck Eric's ass, [link]2[end link] to fuck the felinoid in the ass, [link]3[end link] to get a blow-job from Eric or [link]4[end link] to have the felinoid lick your cock.";
	LineBreak;
	if calcnumber is 1: [fuck Eric]
		say "     Getting on the bed between the felinoid's legs, you snake your arms around Eric from behind, caressing his smooth chest. As the cuntboy athlete eagerly leans into your touch, you plant a line of little kisses from his neck up to his right earlobe, playfully nibbling at it before you whisper that you want to fuck him in the ass. The young man looks back and gives you a smile over his shoulder, then leans forward, stretching his upper body out over the felinoid's furry belly while raising his ass a bit for you. Who could resist such an alluring display? You're almost twitching with the need and desire to fuck your handsome friend when you take hold of your manhood and line it up with his butt. Moving forward, you press the cock-head against his pucker, first lightly, then a bit harder until it finally yields to your invading member.";
		say "			[WaitLineBreak]";
		say "     Grunting in satisfaction, you thrust deeper into your human friend, revelling in the sensations of his insides gripping your shaft tightly. You keep still a while longer, just resting your cock inside him to give Eric a time to get used to it - then suddenly he starts rocking back and forth, fucking himself on your and the felinoid's cocks at the same time. As he moves, you feel movement bump and rub against your cock - that must be the felinoid, his erection pumping in and out of Eric's other hole. So hot, to be able to feel him through the walls of Eric's insides.";
		say "     With the two of you balls deep inside Eric as he fucks himself on your cocks, the arousal of everyone involved soon mounts higher and higher. The felinoid is the first one to pass the point of no return, suddenly stiffening under Eric and giving a satisfied roar, with his cock pulsing as spurt after spurt of his seed is shot deep into Eric's pussy. Getting bred by the large beast, his body being filled with fertile cum, drives Eric to climax just a moment later. He gasps in lust, holding on to the felinoid's soft belly fur as the orgasm makes him writhe in pleasure. You speed up your own thrusts into Eric's asshole, eager to fill him with another load of cum. After just a few more thrusts you come, a huge load boiling up from your balls and shooting into Eric's body.";
		say "			[WaitLineBreak]";
		say "     Exhausted by the hot fuck, you rest for a moment against Eric's back, your slowly softening shaft still inside him. The felinoid meanwhile just leans his head back in total relaxation, and you can literally feel his resounding purr through Eric lying on the feline's chest. Eric gives a satisfied sigh, then says 'Man, you two are quite something.' while reaching back and stroking your side lovingly. After a while longer in this position, gently touching each other, an exhausted Eric sinks off the felinoid to the side, coming to a rest against the large cat's flank, pressed against his warm fur and with an arm and a leg still draped over him. Sadly, there isn't any more room on the bed, with the large shape of the felinoid and your handsome cuntboy already on it, so you leave them to cuddle and rest and go to collect your clothes.";
		increase EricAnalCounter by 1;
	else if calcnumber is 2: [fuck felinoid]
		say "     Getting on the bed between the felinoid's legs, you snake your arms around Eric from behind, caressing his smooth chest. As the cuntboy athlete eagerly leans into your touch, you plant a line of little kisses from his neck up to his right earlobe, playfully nibbling at it before you whisper that you want to fuck the felinoid in the ass and he should distract the big kitty a bit. The young man looks back and gives you a smile over his shoulder, then leans forward, stretching his upper body out over the felinoid's furry chest while stroking him with his hands and pumping his own hips rapidly up and down on the big cat's hard shaft. At the same time, you take hold of your own cock and line it up with the tight hole under the felinoid's tail. Moving forward, you press the cock-head against his pucker, first lightly, then a bit harder until it finally yields to your erect member.";
		say "			[WaitLineBreak]";
		say "     Before he realizes what's happening and can do much more than start a surprised rumble in his throat, you're balls-deep in the felinoid's ass, hitting sensitive spots that make him purr even louder than before. Grunting in satisfaction, you thrust deeper into your feline friend, revelling in the sensations of his insides gripping your shaft tightly. You start sliding in and out of his hole while putting your hands on the big cat's muscular hind legs. Holding on to them as you pound the felinoid's ass, you find a rhythm with Eric, slamming into his furry butt just as Eric pulls up and vice versa. It's an amazing feeling to be moving in concert with your two companions, all of you in a lust-filled haze.";
		say "     With you fucking the felinoid's ass while Eric fucks fucks himself on his cock, the arousal of everyone involved soon mounts higher and higher. The felinoid is the first one to pass the point of no return, suddenly stiffening under Eric and giving a satisfied roar, with his cock pulsing as spurt after spurt of his seed is shot deep into Eric's pussy. Getting bred by the large beast, his body being filled with fertile cum, drives Eric to climax just a moment later. He gasps in lust, holding on to the felinoid's soft belly-fur as the orgasm makes him writhe in pleasure. Meanwhile, you speed up your own thrusts into the big cat's asshole, eager to fill him with your own load of cum. After just a few more thrusts you come, a huge load boiling up from your balls and shooting deep into the felinoid's body.";
		say "			[WaitLineBreak]";
		say "     Exhausted by the hot fuck, you rest for a moment against Eric's back, your slowly softening shaft still inside the big feline under him. The felinoid meanwhile just leans his head back in total relaxation, and you can literally feel his resounding purr through Eric lying on the great beast's chest. Eric gives a satisfied sigh, then says 'Man, you two are quite something.' while reaching back and stroking your side lovingly. After a while longer in this position, gently touching each other, an exhausted Eric sinks off the felinoid to the side, coming to a rest against the large cat's flank, pressed against his warm fur and with an arm and a leg still draped over him. Sadly, there isn't any more room on the bed, with the large shape of the felinoid and your handsome cuntboy already on it, so you leave them to cuddle and rest and go to collect your clothes.";
	else if calcnumber is 3: [BJ from Eric]
		say "     Stepping up to stand on the bed, your feet left and right of the felinoid's body, you smile down at Eric and hold out your hard [cock of player] shaft to him. He stops his movements on top of the large cat for a moment, sitting still with the large spined shaft deep in his pussy while he reaches out to grasp your cock and fondle your balls. Your eager cuntboy friend licks his lips, then gets to work sucking you off, taking the tip of your member into his mouth and running his tongue over it. After going down on your shaft all the way a few times, he starts sliding up and down on the felinoid's erection once again, timing it with bobbing his head towards you.";
		say "			[WaitLineBreak]";
		say "     Taking the felinoid's shaft deep in his pussy while he sucks you off, with its small spines rubbing his inner walls and causing incredible sensations, it doesn't take too much longer until Eric's arousal peaks. With his lips tightly wrapped around your [cock of player] shaft, the cuntboy athlete gives a somewhat muffled but still loud moan from his throat, a shudder running through his whole body as he comes. Femcum trickling down the felinoid's shaft and Eric's inner muscles gripping his cock like a vise make sure that it is only moments later that the big cat lets out a satisfied roar and his cock starts pulsing with spurt after spurt of his seed shooting into Eric's pussy. The handsome cuntboy lowers his hand to the height of his belly button, revelling in the feeling of being bred by the large feline creature.";
		say "     With him breathing deeply and still in the grip of his own orgasm, you take hold of your erect manhood and jerk it, eager to join your two partners in climax. It's not much longer before your frantic movements push you over the edge to your release and you come, blasting your load all over Eric's face, neck and chest. The now pretty splattered human gives you a broad smile, then reaches up to pull you down to his level and kiss him, after which you proceed to lick your own cum off him and share its taste while making out.";
		say "			[WaitLineBreak]";
		say "     Keeping his position for a while longer, straddling the felinoid's hips with the beast's softening shaft inside him, Eric eventually slides off the felinoid to the side, coming to rest against the large cat's flank. There he rests, pressed against the loudly purring feline's warm body and with an arm and a leg still draped over him. Sadly, there isn't any more room on the bed, with the large shape of the felinoid and your handsome cuntboy already on it, so you leave them to cuddle and rest and go to collect your clothes.";
	else if calcnumber is 4: [BJ from felinoid]
		say "     Stepping up to stand against the head end of the bed, you give the felinoid's chin an affectionate scratch, then hold out your hard [cock of player] shaft to him. The large cat looks at you with his golden eyes, then down at Eric riding his shaft and back at you. Finally giving an amicable growl, he nuzzles upwards into your groin, teasing your [cock size desc of player] [cock of player] shaft. A rough tongue flicks out across sensitive flesh, taking special care to carefully lap over your balls and tease the underside of your shaft.";
		say "			[WaitLineBreak]";
		say "     While you're getting head from the large beast, Eric rides his spined cock with unabated vigor moaning and gasping loudly at the sensations it gives him. With how much he enjoys riding the big cat, it doesn't take too much longer until Eric's arousal peaks. Panting unintelligible sounds in his lust, the cuntboy athlete rises up and slams himself down on the hard erection under him, a shudder running through his whole body as he comes. Femcum trickling down the felinoid's shaft and Eric's inner muscles gripping his cock like a vise make sure that it is only moments later that the big cat lets out a satisfied roar himself and his cock starts pulsing with spurt after spurt of his seed shooting into Eric's pussy. The handsome cuntboy lowers his hand to the height of his belly button, revelling in the feeling of being bred by the large feline creature.";
		say "     With him breathing deeply and still in the grip of his own orgasm, you take hold of your erect manhood and jerk it, eager to join your two partners in climax. It's not much longer before your frantic movements push you over the edge to your release and you come, blasting your load all over the felinoid's furry face, with a few shots landing in his open muzzle. The big cat gives a pleased mrowl at the taste of your seed, using his long tongue to lick up any that landed in the fur around his muzzle. Smiling at that, you help him out by wiping up any that he can't reach with your fingers and holding them out for him to lick your cum off. Then you step closer to Eric, leaning forward to give him a deep kiss.";
		say "			[WaitLineBreak]";
		say "     One kiss follows another and Eric keeps his position for a while longer, straddling the felinoid's hips with the beast's softening shaft inside him, before eventually sliding off the felinoid to the side, coming to rest against the large cat's flank. There he rests, pressed against the loudly purring feline's warm body and with an arm and a leg still draped over him. Sadly, there isn't any more room on the bed, with the large shape of the felinoid and your handsome cuntboy already on it, so you leave them to cuddle and rest and go to collect your clothes.";

to say EricSex13_12_Female: [cuntboy Eric]
	say "     Your pussy is almost dripping with arousal and you're ready to have someone lick it - though who shall it be? Eric ([link]Y[as]y[end link]) or the felinoid ([link]N[as]n[end link])?";
	if player consents: [BJ from Eric]
		LineBreak;
		say "     Stepping up to stand on the bed, your feet left and right of the felinoid's body, you smile down at Eric and demonstratively rub over your pussy lips, holding them apart for him. He stops his movements on top of the large cat for a moment, sitting still with the large spined shaft deep in his pussy while he reaches out to touch your privates, softly brushing against your clit. Your eager cuntboy friend licks his lips, then gets to work eating you out, taking great care in teasing your most sensitive spots. After a moment of giving you his full attention, he starts sliding up and down on the felinoid's erection once again, timing it with licking you.";
		say "			[WaitLineBreak]";
		say "     Taking the felinoid's shaft deep in his pussy while he gives oral to you, with its small spines rubbing his inner walls and causing incredible sensations, it doesn't take too much longer until Eric's arousal peaks. After another lick that makes you shudder with need, the cuntboy athlete gives a loud moan from his throat, a shudder running through his whole body as he comes. Femcum trickling down the felinoid's shaft and Eric's inner muscles gripping his cock like a vise make sure that it is only moments later that the big cat lets out a satisfied roar and his cock starts pulsing with spurt after spurt of his seed shooting into Eric's pussy. The handsome cuntboy lowers his hand to the height of his belly button, revelling in the feeling of being bred by the large feline creature.";
		say "     With him breathing deeply and still in the grip of his own orgasm, you put your fingers to work on your pussy in earnest, eager to join your two partners in climax. It's not much longer before your frantic movements push you over the edge to your release and you come, a squirt of femcum hitting Eric in the chest to run down over his smooth skin and more of it dripping down on the felinoid's belly-fur. Your human friend gives you a broad smile, then reaches up to pull you down to his level and kiss him.";
		say "			[WaitLineBreak]";
		say "     One kiss follows another and Eric keeps his position for a while longer, straddling the felinoid's hips with the beast's softening shaft inside him. He eventually slides off the felinoid to the side, coming to rest against the large cat's flank. There he rests, pressed against the loudly purring feline's warm body and with an arm and a leg still draped over him. Sadly, there isn't any more room on the bed, with the large shape of the felinoid and your handsome cuntboy already on it, so you leave them to cuddle and rest and go to collect your clothes.";
	else: [BJ from felinoid]
		LineBreak;
		say "     Stepping up to stand against the head end of the bed, you give the felinoid's chin an affectionate scratch, then get on the bed to kneel over his head. His long whiskers tickle against your legs as the large cat nuzzles upwards into your groin, sniffing your moist and ready pussy. Then he starts to lick you, his rough tongue carefully lapping over sensitive flesh and seeking out your clit.";
		say "			[WaitLineBreak]";
		say "     While you're getting oral attention from the large beast, Eric rides his spined cock with unabated vigor moaning and gasping loudly at the sensations it gives him. With how much he enjoys riding the big cat, it doesn't take too much longer until Eric's arousal peaks. Panting unintelligible sounds in his lust, the cuntboy athlete rises up and slams himself down on the hard erection under him, a shudder running through his whole body as he comes. Femcum trickling down the felinoid's shaft and Eric's inner muscles gripping hiss cock like a vise make sure that it's only moments later that the big cat lets out a satisfied roar himself and his cock starts pulsing with spurt after spurt of his seed shooting into Eric's pussy. The handsome cuntboy lowers his hand to the height of his belly button, revelling in the feeling of being bred by the large feline creature.";
		say "     With the felinoid busy savouring his own orgasm, you put your fingers to work on your pussy in earnest, eager to join your two partners in climax. It's not much longer before your frantic movements push you over the edge to your release and you come, a squirt of femcum hitting the felinoid's muzzle and more of it dripping down on the fur on his neck. The big cat gives a pleased rumble, licking it off his muzzle and lapping at your crotch a few times to get a bit more of a taste.";
		say "			[WaitLineBreak]";
		say "     Eric keeps his position for a while longer, straddling the felinoid's hips with the beast's softening shaft inside him. He eventually slides off the felinoid to the side, coming to rest against the large cat's flank. There he rests, pressed against the loudly purring feline's warm body and with an arm and a leg still draped over him. Sadly, there isn't any more room on the bed, with the large shape of the felinoid and your handsome cuntboy already on it, so you leave them to cuddle and rest and go to collect your clothes.";

to say EricSex13_22_32_Male: [male Eric]
	LineBreak;
	say "     What shall it be you want to do with your cuntboy and felinoid friends? Get Eric's [if HP of Eric is 22]horsecock[else if HP of Eric is 32]satyrcock[end if] inside you [link](1)[as]1[end link], or rather fuck the felinoid's ass yourself [link](2)[as]2[end link], maybe get a blow-job from Eric [link](3)[as]3[end link] or present your manhood to the felinoid to have him lick it [link](4)[as]4[end link]?";
	now calcnumber is 0;
	while calcnumber < 1 or calcnumber > 4:
		say "Choice? (1-4)>[run paragraph on]";
		get a number;
		if calcnumber is 1 or calcnumber is 2 or calcnumber is 3 or calcnumber is 4:
			break;
		else:
			say "Invalid choice. Type [link]1[end link] to get fucked by Eric, [link]2[end link] to fuck the felinoid in the ass, [link]3[end link] to get a blow-job from Eric or [link]4[end link] to have the felinoid lick your cock.";
	LineBreak;
	if calcnumber is 1: [get fucked by Eric]
		say "     Getting on the bed, you climb on top of the felinoid, lying down lengthwise on him with your front on his belly. That puts you in direct contact with his warm, soft-furred and purr-rumbling chest, poking him in the belly with your hard cock, while your ass is just in the right height for Eric to enjoy. Your human friend runs his hands over your lower back and cups the globes of your ass, giving them an affectionate squeeze before he takes hold of your hips and pulls you towards him until you can feel the hot length of his [if HP of Eric is 22]equine[else if HP of Eric is 32]caprine[end if] erection against your crack. After rubbing it against you for a moment, Eric takes hold of his shaft and puts the precum-slick tip against your pucker, then slowly increases the pressure until he pops past the muscle, stretching your insides with his invading member.";
		say "			[WaitLineBreak]";
		say "     Panting in lust, your well-hung friend nevertheless takes his time as he sinks himself deeper into you, allowing you to relax and stretch to be able to take his big cock. Some time later, after he's finally made it all the way in and you have gotten used to the comfortable well-stuffed feeling, he pants 'I can't take much more of this. Are you ready for me to fuck you now?' Before you've done much more than start to nod, he's already pulling back out a bit, moaning as he impales his own ass on the felinoid's shaft in the same stroke, then thrusts deep into you. Eric gasps at the sensations of being the middle part of a fuck-sandwich, the rhythmic thrusts of his hips sliding his own hole up and down a hard cock while he's fucking you.";
		say "     With the Eric grinding against you and the felinoid, the arousal of everyone involved quickly mounts higher and higher and the bunker is filled with grunts, moans and pants. The felinoid is the first one to pass the point of no return, suddenly stiffening under Eric and giving a satisfied roar, with his cock pulsing as spurt after spurt of his seed is shot deep into Eric's asshole. Getting bred by the large beast, his body being filled with a big load of feline cum, drives Eric to climax just a moment later. He gasps in lust, holding on to your hips tightly as he explodes into you, spurt after spurt of his warm cum filling your hole to the brink. As close as all this hot action has brought you to your own orgasm, it takes only a moment of grinding your hips against the furry body under you before you come, squirting your seed into the felinoid's soon soaked fur.[mimpregchance]";
		say "			[WaitLineBreak]";
		say "     Exhausted by the hot fuck, you rest for a moment against the felinoid's chest, then get off of him and the wet patch of fur you were lying on. Eric stays sitting on the big cat's hips a bit longer, watching you get up with the feline's hard cock still inside him. Eric gives a satisfied sigh, then says 'Man, you two are quite something.' while reaching out to pull your lips to his for a kiss. After a while longer in this position, he too gets off your beastly companion, sinking down on the bed beside him and coming to a rest against the large cat's flank. Pressed against his warm fur and with an arm and a leg still draped over him, he dozes off in exhaustion.";
	else if calcnumber is 2: [fuck felinoid]
		say "     Getting on the bed between the felinoid's legs, you snake your arms around Eric from behind, caressing his smooth chest before sliding your hands down to his crotch. As you take hold of his big [if HP of Eric is 22]equine[else if HP of Eric is 32]caprine[end if] cock, you plant a line of little kisses from his neck up to his right earlobe, playfully nibbling at it before you whisper that you want to fuck the felinoid and he should distract the big kitty a bit. The young man looks back and gives you a smile over his shoulder, then leans forward, stretching his upper body out over the felinoid's furry chest while stroking him with his hands and pumping his own hips rapidly up and down on the big cat's hard shaft. At the same time, you take hold of your own cock and line it up with the tight hole under the felinoid's tail. Moving forward, you press the cock-head against his pucker, first lightly, then a bit harder until it finally yields to your erect member.";
		say "			[WaitLineBreak]";
		say "     Before he realizes what's happening and can do much more than start a surprised rumble in his throat, you're balls-deep in the felinoid's ass, hitting sensitive spots that make him purr even louder than before. Grunting in satisfaction, you thrust deeper into your feline friend, revelling in the sensations of his insides gripping your shaft tightly. You start sliding in and out of his hole while putting your hands on the big cat's muscular hind legs. Holding on to them as you pound the felinoid's ass, you find a rhythm with Eric, slamming into his furry butt just as Eric pulls up and vice versa. It's an amazing feeling to be moving in concert with your two companions, all of you in a lust-filled haze.";
		say "     With you fucking the felinoid's ass while Eric fucks fucks himself on his cock, the arousal of everyone involved soon mounts higher and higher. The felinoid is the first one to pass the point of no return, suddenly stiffening under Eric and giving a satisfied roar, with his cock pulsing as spurt after spurt of his seed is shot deep into Eric's asshole. Getting bred by the large beast, his body being filled with feline cum, drives Eric to climax just a moment later. He gasps in lust, gripping his erection tightly as it explodes with blasts of cum that splatter all over the felinoid's soft belly-fur. Meanwhile, you speed up your own thrusts into the big cat's asshole, eager to fill him with your own load of cum. After just a few more thrusts you come, a huge load boiling up from your balls and shooting deep into the felinoid's body.";
		say "			[WaitLineBreak]";
		say "     Exhausted by the hot fuck, you rest for a moment against Eric's back, your slowly softening shaft still inside the big feline under him. The felinoid meanwhile just leans his head back in total relaxation, and you can literally feel his resounding purr going through Eric and yourself. Your human friend gives a satisfied sigh, then says 'Man, you two are quite something.' while reaching back and stroking your side lovingly. After a while longer in this position, gently touching each other, an exhausted Eric sinks off the felinoid to the side, coming to a rest against the large cat's flank, pressed against his warm fur and with an arm and a leg still draped over him. Sadly, there isn't any more room on the bed, with the large shape of the felinoid and your handsome cuntboy already on it, so you leave them to cuddle and rest and go to collect your clothes.";
	else if calcnumber is 3: [BJ from Eric]
		say "     Stepping up to stand on the bed, your feet left and right of the felinoid's body, you smile down at Eric and hold out your hard [cock of player] shaft to him. He stops his movements on top of the large cat for a moment, sitting still with the large spined shaft deep in his asshole while he reaches out to grasp your cock and fondle your balls. Your eager friend licks his lips, then gets to work sucking you off, taking the tip of your member into his mouth and running his tongue over it. After going down on your shaft all the way a few times, he starts sliding up and down on the felinoid's erection once again, timing it with bobbing his head towards you.";
		say "			[WaitLineBreak]";
		say "     Taking the felinoid's shaft in his butt while he sucks you off, with its small spines rubbing his inner walls and causing incredible sensations, it doesn't take too much longer until Eric's arousal peaks. With his lips tightly wrapped around your [cock size desc of player] [cock of player] shaft, the young athlete gives a somewhat muffled but still loud moan from his throat, a shudder running through his whole body as he comes. Gripping his erection tightly as it explodes with blasts of cum that splatter all over the felinoid's soft belly-fur, Eric's inner muscles twitch with each spurt, which causes the felinoid to follow him into climax only moments later. The big cat lets out a satisfied roar and his cock starts pulsing with spurt after spurt of his seed shooting deep into Eric's asshole.";
		say "     With him breathing deeply and still in the grip of his own orgasm, you take hold of your erect manhood and jerk it, eager to join your two partners in climax. It's not much longer before your frantic movements push you over the edge to your release and you come, blasting your load all over Eric's face, neck and chest. The now pretty splattered human gives you a broad smile, then reaches up to pull you down to his level and kiss him, after which you proceed to lick your own cum off him and share its taste while making out.";
		say "			[WaitLineBreak]";
		say "     Keeping his position for a while longer, straddling the felinoid's hips with the beast's softening shaft inside him, Eric eventually slides off the felinoid to the side, coming to rest against the large cat's flank. There he rests, pressed against the loudly purring feline's warm body and with an arm and a leg still draped over him. Sadly, there isn't any more room on the bed, with the large shape of the felinoid and your handsome cuntboy already on it, so you leave them to cuddle and rest and go to collect your clothes.";
	else if calcnumber is 4: [BJ from felinoid]
		say "     Stepping up to stand against the head end of the bed, you give the felinoid's chin an affectionate scratch, then hold out your hard [cock of player] shaft to him. The large cat looks at you with his golden eyes, then down at Eric riding his shaft and back at you. Finally giving an amicable growl, he nuzzles upwards into your groin, teasing your [cock size desc of player] [cock of player] shaft. A rough tongue flicks out across sensitive flesh, taking special care to carefully lap over your balls and tease the underside of your shaft.";
		say "			[WaitLineBreak]";
		say "     While you're getting head from the large beast, Eric rides his spined cock with unabated vigor moaning and gasping loudly at the sensations it gives him. With how much he enjoys riding the big cat, it doesn't take too much longer until Eric's arousal peaks. Panting unintelligible sounds in his lust, the young athlete rises up and slams himself down on the hard erection under him, a shudder running through his whole body as he comes. Gripping his erection tightly as it explodes with blasts of cum that splatter all over the felinoid's soft belly-fur, Eric's inner muscles twitch with each spurt, which causes the felinoid to follow him into climax only moments later. The big cat lets out a satisfied roar and his cock starts pulsing with spurt after spurt of his seed shooting deep into Eric's asshole.";
		say "     With him breathing deeply and still in the grip of his own orgasm, you take hold of your erect manhood and jerk it, eager to join your two partners in climax. It's not much longer before your frantic movements push you over the edge to your release and you come, blasting your load all over the felinoid's furry face, with a few shots landing in his open muzzle. The big cat gives a pleased mrowl at the taste of your seed, using his long tongue to lick up any that landed in the fur around his muzzle. Smiling at that, you help him out by wiping up any that he can't reach with your fingers and holding them out for him to lick your cum off. Then you step closer to Eric, leaning forward to give him a deep kiss.";
		say "			[WaitLineBreak]";
		say "     One kiss follows another and Eric keeps his position for a while longer, straddling the felinoid's hips with the beast's softening shaft inside him, before eventually sliding off the felinoid to the side, coming to rest against the large cat's flank. There he rests, pressed against the loudly purring feline's warm body and with an arm and a leg still draped over him. Sadly, there isn't any more room on the bed, with the large shape of the felinoid and your handsome cuntboy already on it, so you leave them to cuddle and rest and go to collect your clothes.";

to say EricSex13_22_32_Female: [male Eric]
	LineBreak;
	say "     What shall it be you want to do with your cuntboy and felinoid friends? Get Eric's [if HP of Eric is 22]horsecock[else if HP of Eric is 32]satyrcock[end if] inside you [link](1)[as]1[end link], maybe get a bit of oral attention from Eric [link](23)[as]2[end link] or present your pussy to be licked by the felinoid [link](3)[as]3[end link]?";
	now calcnumber is 0;
	while calcnumber < 1 or calcnumber > 3:
		say "Choice? (1-4)>[run paragraph on]";
		get a number;
		if calcnumber is 1 or calcnumber is 2 or calcnumber is 3:
			break;
		else:
			say "Invalid choice. Type [link]1[end link] to get fucked by Eric, [link]2[end link] to get a some oral attention from Eric, or [link]3[end link] to have the felinoid lick your pussy.";
	LineBreak;
	if calcnumber is 1: [get fucked by Eric]
		say "     Getting on the bed, you climb on top of the felinoid, lying down lengthwise on him with your front on his belly. That puts you in direct contact with his warm, soft-furred and purr-rumbling chest, while your hips are just in the right height for Eric to enjoy. Your human friend runs his hands over your lower back and cups the globes of your ass, giving them an affectionate squeeze before he takes hold of your hips and pulls you towards him until you can feel the hot length of his [if HP of Eric is 22]equine[else if HP of Eric is 32]caprine[end if] erection against your crack. After rubbing it against you for a moment, Eric takes hold of his shaft and guides it down between your legs, brushing its precum-slick tip over your pussy lips before nudging them apart with his shaft and stretching your insides with his invading member.";
		say "			[WaitLineBreak]";
		say "     Panting in lust, your well-hung friend nevertheless takes his time as he sinks himself deeper into you, allowing you to relax and stretch to be able to take his big cock. Some time later, after he's finally made it all the way in and you have gotten used to the comfortable well-stuffed feeling, he pants 'I can't take much more of this. Are you ready for me to fuck you now?' Before you've done much more than start to nod, he's already pulling back out a bit, moaning as he impales his own ass on the felinoid's shaft in the same stroke, then thrusts deep into you. Eric gasps at the sensations of being the middle part of a fuck-sandwich, the rhythmic thrusts of his hips sliding his own hole up and down a hard cock while he's fucking you.";
		say "     With the Eric grinding against you and the felinoid, the arousal of everyone involved quickly mounts higher and higher and the bunker is filled with grunts, moans and pants. The felinoid is the first one to pass the point of no return, suddenly stiffening under Eric and giving a satisfied roar, with his cock pulsing as spurt after spurt of his seed is shot deep into Eric's asshole. Getting bred by the large beast, his body being filled with a big load of feline cum, drives Eric to climax just a moment later. He gasps in lust, holding on to your hips tightly as he explodes into you, spurt after spurt of his warm cum splashing into your womb. The feeling of this attractive male's fertile seed filling you, trying to impregnate you with his child, gives you the last little push you needed yourself. Panting as the orgasm hits you, you dig your hands into the felinoid's fur and grip him tightly as you writhe in pleasure.[fimpregchance]";
		say "			[WaitLineBreak]";
		say "     Exhausted by the hot fuck, you stay lying on top of the felinoid, resting against his broad and soft-furred chest. Eric stays sitting on the big cat's hips a bit longer, stroking his hands slowly over your lower back and hips with the feline's hard cock still inside him. Finally he gives a satisfied sigh, then says 'Man, you two are quite something.' and sinks down on the bed beside your beastly companion, coming to a rest against the large cat's flank. Pressed against its warm fur, he dozes off in exhaustion.";
	else if calcnumber is 2: [BJ from Eric]
		say "     Stepping up to stand on the bed, your feet left and right of the felinoid's body, you smile down at Eric and demonstratively rub over your pussy lips, holding them apart for him. He stops his movements on top of the large cat for a moment, sitting still with the large spined shaft deep in his asshole while he reaches out to touch your privates, softly brushing against your clit. Your eager friend licks his lips, then gets to work eating you out, taking great care in teasing your most sensitive spots. After a moment of giving you his full attention, he starts sliding up and down on the felinoid's erection once again, timing it with licking you.";
		say "			[WaitLineBreak]";
		say "     Taking the felinoid's shaft deep in his hole while he gives oral to you, with its small spines rubbing his inner walls and causing incredible sensations, it doesn't take too much longer until Eric's arousal peaks. After another lick that makes you shudder with need, the young athlete gives a loud moan from his throat, a shudder running through his whole body as he comes. Gripping his erection tightly as it explodes with blasts of cum that splatter all over the felinoid's soft belly-fur, Eric's inner muscles twitch with each spurt, which causes the felinoid to follow him into climax only moments later. The big cat lets out a satisfied roar and his cock starts pulsing with spurt after spurt of his seed shooting deep into Eric's asshole.";
		say "     With him breathing deeply and still in the grip of his own orgasm, you put your fingers to work on your pussy in earnest, eager to join your two partners in climax. It's not much longer before your frantic movements push you over the edge to your release and you come, a squirt of femcum hitting Eric in the chest to run down over his smooth skin and more of it dripping down on the felinoid's belly-fur. Your human friend gives you a broad smile, then reaches up to pull you down to his level and kiss him.";
		say "			[WaitLineBreak]";
		say "     One kiss follows another and Eric keeps his position for a while longer, straddling the felinoid's hips with the beast's softening shaft inside him. He eventually slides off the felinoid to the side, coming to rest against the large cat's flank. There he rests, pressed against the loudly purring feline's warm body and with an arm and a leg still draped over him. Sadly, there isn't any more room on the bed, with the large shape of the felinoid and your handsome cuntboy already on it, so you leave them to cuddle and rest and go to collect your clothes.";
	else if calcnumber is 3: [BJ from felinoid]
		say "     Stepping up to stand against the head end of the bed, you give the felinoid's chin an affectionate scratch, then get on the bed to kneel over his head. His long whiskers tickle against your legs as the large cat nuzzles upwards into your groin, sniffing your moist and ready pussy. Then he starts to lick you, his rough tongue carefully lapping over sensitive flesh and seeking out your clit.";
		say "			[WaitLineBreak]";
		say "     While you're getting oral attention from the large beast, Eric rides his spined cock with unabated vigor moaning and gasping loudly at the sensations it gives him. With how much he enjoys riding the big cat, it doesn't take too much longer until Eric's arousal peaks. Panting unintelligible sounds in his lust, the young athlete rises up and slams himself down on the hard erection under him one last time, a shudder running through his whole body as he comes. Gripping his erection tightly as it explodes with blasts of cum that splatter all over the felinoid's soft belly-fur, Eric's inner muscles twitch with each spurt, which causes the felinoid to follow him into climax only moments later. The big cat lets out a satisfied roar and his cock starts pulsing with spurt after spurt of his seed shooting deep into Eric's asshole.";
		say "     With the felinoid busy savouring his own orgasm, you put your fingers to work on your pussy in earnest, eager to join your two partners in climax. It's not much longer before your frantic movements push you over the edge to your release and you come, a squirt of femcum hitting the felinoid's muzzle and more of it dripping down on the fur on his neck. The big cat gives a pleased rumble, licking it off his muzzle and lapping at your crotch a few times to get a bit more of a taste.";
		say "			[WaitLineBreak]";
		say "     Eric keeps his position for a while longer, straddling the felinoid's hips with the beast's softening shaft inside him. He eventually slides off the felinoid to the side, coming to rest against the large cat's flank. There he rests, pressed against the loudly purring feline's warm body and with an arm and a leg still draped over him. Sadly, there isn't any more room on the bed, with the large shape of the felinoid and your handsome cuntboy already on it, so you leave them to cuddle and rest and go to collect your clothes.";

to say EricSex13_99_Male: [sex slave Eric]
	say "     Moving into position behind the felinoid, you run your hands through the soft fur on his lower back, then aim your erection at the tight hole under his tail. Grabbing the big cat's hips tightly, you slam forward, burying your cock to the hilt in his warm, tight cave. Roaring at the sudden anal intrusion, the felinoid stops thrusting into Eric for a moment, looking back over his shoulder with partly bared teeth. That doesn't last long, though - moving in and out of his hole, your shaft stimulates his sensitive prostate, and soon your big cat is purring in satisfaction and fucking your cuntboy slut again.";
	WaitLineBreak;
	say "     True to form for a cock-hungry cuntboy bitch, Eric is the first to cum, writhing under the felinoid as he gushes femcum to soak into the mattress between his legs. The human's pussy twitching around your feline companion's spined shaft is enough to take him over the edge right with him, making the felinoid roar in satisfaction as he blasts his fertile load into the cuntboy's womb. Eager to join the two of them in their release, you speed up your own thrusts into the felinoid's ass, slamming into him hard again and again until you soon climax, filling his butt with your cum.";
	say "     After a moment of just holding on to the large feline and catching your breath, you pull out and watch the felinoid's pink pucker snap shut before any of your seed can leak out. The big cat pulls out of Eric and gives his freshly bred pussy a sniff, then throws himself on top of the bed with him, coming to lie on his side with the cuntboy held against his belly with both front legs. Looks like he's trying to claim the little slut as his own now.";

to say EricSex13_99_Female: [sex slave Eric]
	say "     Stepping up to stand against the head end of the bed, you give the felinoid's chin an affectionate scratch, then spread your pussy lips and start rubbing yourself right in front of him. His long whiskers tickle against your legs as the large cat nuzzles upwards into your groin, sniffing your moist and ready pussy. Then he starts to lick you, his rough tongue carefully lapping over sensitive flesh and seeking out your clit.";
	say "			[WaitLineBreak]";
	say "     While you're getting some oral attention, Eric is fucked hard and deep by the felinoid, and true to form for a cock-hungry cuntboy bitch, the young athlete is the first to cum. Writhing under the felinoid as he gushes femcum to soak into the mattress between his legs, the human gasps and pants loudly, his hands rubbing the big cat's belly. The wet pussy twitching around your feline companion's spined shaft is enough to take him over the edge right with Eric, making the felinoid roar in satisfaction as he blasts his fertile load into the cuntboy's womb. Eager to join the two of them in their release, you put your fingers to work on your pussy in earnest. It's not much longer before your frantic movements push you over the edge and you come, a squirt of femcum hitting the felinoid's muzzle and more of it dripping down on the mattress of the bed. The big cat gives a pleased rumble, licking it off his muzzle and lapping at your crotch a few times to get a bit more of a taste.";

to say EricSex14: [threesome with Carl]
	say "     Keeping your hands on Eric's hips to keep him from moving away towards his bed, you instead lean in to him and whisper a suggestion about getting it on with Carl into his ear. The red-headed teen looks at you with big eyes, then gives a sweet little smile before he asks, 'You mean... him and you and me... together?' Nodding to Eric, you see him bite his lip in a cute sign of anticipation, after which he readily follows you up into the library to seek out the canine soldier. As it turns out, you don't have that far to go either - as the husky is down on the ground floor, jogging along between the long rows of bookshelves.";
	say "     With Carl's tail already wagging happily as you wave him over, it goes wild as you let the friendly soldier know what you've got in mind. 'This is gonna be so much fun,' he says in a husky tone and gives Eric's arm a friendly squeeze. With a broad grin on his canine muzzle, Carl then nods over to a nearby seating group with a large sofa and saunters over to it, casually stripping off and dropping articles of clothes as he walks. Giggling about just how quickly the soldier got buck naked, your teenage companion sprints over to join Carl and starts stripping himself. A few moments later, during which the anthro husky kneeled down to 'help' Eric pull off his panties, they're both naked and visibly excited.";
	wait for any key;
	say "[EricCarlThreesome Sex Menu]";

Section 4 - Events

instead of navigating Grey Abbey Library while (level of Eric is 0 and Felinoid Companion is tamed and (HP of Eric is 10 or HP of Eric is 11 or HP of Eric is 13 or HP of Eric is 15 or HP of Eric is 22 or HP of Eric is 32 or HP of Eric is 99) and (lastfuck of Eric - turns) > 12):
	say "[NavCheck Grey Abbey Library]";
	if NavCheckReturn is false, stop the action;
	move player to Grey Abbey Library;
	if debugactive is 1:
		say "     DEBUG: ERIC FIRST FELINOID SEX WALKIN [line break]";
	if HP of Eric is 10 or HP of Eric is 11 or HP of Eric is 13 or HP of Eric is 15 or HP of Eric is 22 or HP of Eric is 32: [had sex with the player or cboy virgin]
		say "     As you enter the library, you see Eric walk in between two of the long shelves, intently scanning over the titles of the books. Now that you think of it, he's been spending quite a bit of his time up here lately, picking out books and reading. Well, it's something interesting to do at least. Just as you start turning away to leave him to his reading, you see the large shape of your felinoid companion silently stalk after Eric. Knowing the large cat's libido-driven behaviour, you see where this might lead...";
		LineBreak;
		say "     Do you want to go after them to see what happens and maybe do something about it ([link]Y[as]y[end link]), or do you just leave them to it and turn to other things ([link]N[as]n[end link])?";
		if player consents: [follow]
			LineBreak;
			say "     Walking into the same space between the bookshelves that you saw your two companions go into, you spot Eric some distance ahead of you, still checking out books and being totally oblivious to the felinoid stalking him. Then the large cat catches up with him, rubbing his flank against the human athlete's hips and making a resounding purring sound in his throat. Eric is easily taken in by the felinoid's affectionate behaviour, petting the large creature as he circles him, rubbing up against Eric's body and flirting his long tail in front of the human's face.";
			say "     Soon Eric crouches down, his hands busy rubbing the felinoid's belly fur and behind his ears in something of a trance. He brushes his cheek against the large cat's soft fur and breathes in deep, now completely succumbing to his pheromone-laden scent. A low and throaty sound comes from the felinoid, almost a feline chuckle, then he bumps Eric with his shoulder, making him fall forward on all fours.";
			LineBreak;
			say "     Do you want to watch the felinoid mount Eric ([link]Y[as]y[end link]) or will you step in and snap him out of the trance ([link]N[as]n[end link])?";
			if player consents:
				LineBreak;
				if HP of Eric is 10: [virgin]
					say "     With the young athlete just dazedly resting on all fours, the felinoid uses large paws to pat at his pants, soon managing to hook a paw behind the shorts belt-line and pulling it down, revealing that Eric went commando today. The large cat gives his entranced human a deep sniff, then starts to lick between the legs, lapping away at Eric's open pussy lips. After a moment of making the cuntboy pant and moan, the felinoid then gives him a lick over the small of his back before finally moving to stand completely over the smaller human, nuzzling at his neck while bumping against his butt with a hard and erect spined cock.";
					say "     Lowering his hips and doing small probing thrusts, the felinoid soon finds the opening of Eric's moist and ready pussy and plunges in. With a satisfied roar, he sinks all of his manhood inside, drawing a pained whimper from Eric as his virginity is taken - and by a large feral cat too. Balls-deep inside the smaller human, the felinoid holds still for a long moment and shows his affection for his newest conquest by purring and lapping at Eric's upper back and neck. Then he continues with his fun and starts fucking him with powerful and deep thrusts. Moans, pants and growls of lust fill the library and you move a bit closer to get a better view.";
					WaitLineBreak;
					say "     The animalistic coupling of the felinoid and his entranced partner is quite a show, driving your arousal to new heights as you watch. With the stamina of a wild beast, the felinoid drives his cock into Eric's pussy relentlessly, until finally the cuntboy's moans and noises rise up to a climactic shout, announcing his orgasm to anyone in hearing range. Visibly satisfied in making him come, the felinoid isn't far behind, burying his hard cock all the way in the young human's pussy and holding still, only his balls pulsing as they fill Eric's womb with his potent seed. When he finishes cumming, the big cat throws himself on the floor right at that spot to lounge in satisfaction, taking Eric with him, still impaled on the feline's shaft and soon held against his soft belly fur with a muscular forelimb.";
					now EricVirginityTaken is 3; [the felinoid took his virginity and knocked Eric up]
					now HP of Eric is 14;
				else if HP of Eric is 11 or HP of Eric is 12 or HP of Eric is 13 or HP of Eric is 14 or HP of Eric is 15: [had sex before]
					say "     With the young athlete just dazedly resting on all fours, the felinoid uses large paws to pat at his pants, soon managing to hook a paw under the shorts band and pull it down, revealing that Eric went commando today. The large cat gives his entranced human a deep sniff, then starts to lick between the legs, lapping away at Eric's open pussy lips. After a moment of making the cuntboy pant and moan, the felinoid then gives him a lick over the small of his back before finally moving to stand completely over the smaller human, nuzzling at his neck while bumping against his butt with a hard and erect spined cock.";
					say "     Lowering his hips and doing small probing thrusts, the felinoid soon finds the opening of Eric's moist and ready pussy and plunges in. With a satisfied roar, he sinks all of his manhood inside, then starts fucking him with powerful and deep thrusts. Moans, pants and growls of lust fill the library and you move a bit closer to get a better view.";
					WaitLineBreak;
					say "     The animalistic coupling of the felinoid and his entranced partner is quite a show, driving your arousal to new heights as you watch. With the stamina of a wild beast, the felinoid drives his cock into Eric's pussy relentlessly, until finally the cuntboy's moans and noises rise up to a climactic shout, announcing his orgasm to anyone in hearing range. Visibly satisfied in making him come, the felinoid isn't far behind, burying his hard cock all the way in the young human's pussy and holding still, only his balls pulsing as they fill him up with his seed. When he finishes cumming, the big cat throws himself on the floor right at that spot to lounge in satisfaction, taking Eric with him, still impaled on the feline's shaft and soon held against his soft belly fur with a muscular forelimb.";
				else if HP of Eric is 22:
					say "     With the young athlete just dazedly resting on all fours, the felinoid uses large paws to pat at his pants, soon managing to hook a paw under the shorts band and pull it down, revealing that Eric went commando today. The large cat gives his entranced human a deep sniff, then starts to lick between the legs, lapping away at Eric's big equine balls. After a moment of making the young man pant and moan, the felinoid then moves on to lick over his pucker for a while before finally moving to stand completely over the smaller human, nuzzling at his neck while bumping against his butt with a hard and erect spined cock.";
					say "     Lowering his hips slightly and doing small probing thrusts, the felinoid soon locates Eric's pucker and presses in against it, entering without much problem as the human is pretty relaxed all over in his trance. With a satisfied roar, he sinks all of his manhood inside, then starts fucking Eric with powerful and deep thrusts. Moans, pants and growls of lust fill the library and you move a bit closer to get a better view.";
					WaitLineBreak;
					say "     The animalistic coupling of the felinoid and his entranced partner is quite a show, driving your arousal to new heights as you watch. With the stamina of a wild beast, the felinoid drives his cock into Eric's asshole relentlessly, until finally the young athlete's moans and pants rise up to a climactic shout and his horsecock starts blasting heavy squirts of cum all over the floor under him. Visibly satisfied in making his partner come, the felinoid isn't far behind, burying his hard cock all the way in his human partner's butt and holding still, only his balls pulsing as they fill him up with his seed. When he finishes cumming, the big cat throws himself on the floor right at that spot to lounge in satisfaction, taking Eric with him, still impaled on the feline's shaft and soon held against his soft belly fur with a muscular forelimb.";
				else if HP of Eric is 32:
					say "     With the young athlete just dazedly resting on all fours, the felinoid uses large paws to pat at his pants, soon managing to hook a paw under the shorts band and pull it down, revealing that Eric went commando today. The large cat gives his entranced human a deep sniff, then starts to lick between the legs, lapping away at Eric's furry balls. After a moment of making the young man pant and moan, the felinoid then moves on to lick over his pucker for a while before finally moving to stand completely over the smaller human, nuzzling at his neck while bumping against his butt with a hard and erect spined cock.";
					say "     Lowering his hips slightly and doing small probing thrusts, the felinoid soon locates Eric's pucker and presses in against it, entering without much problem as the human is pretty relaxed all over in his trance. With a satisfied roar, he sinks all of his manhood inside, then starts fucking Eric with powerful and deep thrusts. Moans, pants and growls of lust fill the library and you move a bit closer to get a better view.";
					WaitLineBreak;
					say "     The animalistic coupling of the felinoid and his entranced partner is quite a show, driving your arousal to new heights as you watch. With the stamina of a wild beast, the felinoid drives his cock into Eric's asshole relentlessly, until finally the young athlete's moans and pants rise up to a climactic shout and his satyr cock starts blasting heavy squirts of cum all over the floor under him. Visibly satisfied in making his partner come, the felinoid isn't far behind, burying his hard cock all the way in his human partner's butt and holding still, only his balls pulsing as they fill him up with his seed. When he finishes cumming, the big cat throws himself on the floor right at that spot to lounge in satisfaction, taking Eric with him, still impaled on the feline's shaft and soon held against his soft belly fur with a muscular forelimb.";
				now level of Eric is 3;
				now lastfuck of Eric is turns;
			else:
				LineBreak;
				say "     Deciding that this has gone far enough, you dash forward, grabbing Eric by the shoulder and pulling him up to stand. With your hand on the young man's arm, you walk him a few steps away from the musky cloud of scent around the felinoid and softly slap his cheeks several times as he breathes in fresh air. Finally shaking out of it, his eyes focus on you after the last slap and he says 'Hey, what are you doing? I was just... looking for books and... then... I -'";
				say "     Eric's brows draw together as he mentally puzzles together the last five minutes of time and turns in confusion to you. While you explain about the felinoid's charm and the effects of his musk, the two of you hear a disappointed growl from the large cat, who gives Eric a last look before stalking off, trying to act as if he hadn't planned to do anything with the human.";
				now level of Eric is 99;
		else: [leave it]
			LineBreak;
			say "     Oh well, it would happen at some point no matter what you do. It's not like you've got the time to constantly watch over what the felinoid is doing anyways. Some short time later, you hear lust-filled growls and pants sound from somewhere between the bookshelves, culminating in a satisfied roar not long after.";
			now level of Eric is 1;
			now lastfuck of Eric is turns;
	else if HP of Eric is 99: [sex slave cuntboy]
		say "     As you enter the library, you see Eric walk in between two of the long shelves, furtively looking over his shoulder towards the bunker entrance without noticing you in the other direction. Now that you think of it, he seems to be up here quite a bit. You guess that he's trying to avoid getting noticed (and fucked) by you, reading in the quiet corners of the library instead.";
		say "     While you're still debating the thought of going after him and fucking him right now in your own mind, you see the large shape of your felinoid companion silently stalk after Eric. Knowing the large cat's libido-driven behaviour, you see where this might lead...";
		LineBreak;
		say "     Do you want to go after them to see what happens and maybe do something about it ([link]Y[as]y[end link]), or do you just leave them to it and turn to other things ([link]N[as]n[end link])?";
		if player consents: [follow]
			LineBreak;
			say "     Walking into the same space between the bookshelves that you saw your two companions go into, you spot Eric some distance ahead of you, still checking out books and being totally oblivious to the felinoid stalking him. Then the large cat catches up with him, rubbing his flank against the human athlete's hips and making a resounding purring sound in his throat. Eric is easily taken in by the felinoid's affectionate behaviour, petting the large creature as he circles him, rubbing up against Eric's body and flirting his long tail in front of the human's face.";
			say "     Soon Eric crouches down, his hands busy rubbing the felinoid's belly fur and behind his ears in something of a trance. He brushes his cheek against the large cat's soft fur and breathes in deep, now completely succumbing to his pheromone-laden scent. A low and throaty sound comes from the felinoid, almost a feline chuckle, then he bumps Eric with his shoulder, making him fall forward on all fours.";
			LineBreak;
			say "     Do you want to watch the felinoid mount Eric ([link]Y[as]y[end link]) or will you step in before he makes his move ([link]N[as]n[end link])?";
			if player consents:
				LineBreak;
				say "     With the young athlete just dazedly resting on all fours, the felinoid uses large paws to pat at his pants, soon managing to hook a paw under the shorts band and pull it down, revealing that Eric went commando today. The large cat gives his entranced human a deep sniff, then starts to lick between the legs, lapping away at Eric's open pussy lips. After a moment of making the cuntboy pant and moan, the felinoid then gives him a lick over the small of his back before finally moving to stand completely over the smaller human, nuzzling at his neck while bumping against his butt with a hard and erect spined cock.";
				say "     Lowering his hips and doing small probing thrusts, the felinoid soon finds the opening of Eric's moist and ready pussy and plunges in. With a satisfied roar, he sinks all of his manhood inside, then starts fucking him with powerful and deep thrusts. Moans, pants and growls of lust fill the library and you move a bit closer to get a better view.";
				WaitLineBreak;
				say "     The animalistic coupling of the felinoid and his entranced partner is quite a show, driving your arousal to new heights as you watch. With the stamina of a wild beast, the felinoid drives his cock into Eric's pussy relentlessly, until finally the cuntboy's moans and noises rise up to a climactic shout, announcing his orgasm to anyone in hearing range. Visibly satisfied in making him come, the felinoid isn't far behind, burying his hard cock all the way in the young human's pussy and holding still, only his balls pulsing as they fill him up with his seed. When he finishes cumming, the big cat throws himself on the floor right at that spot to lounge in satisfaction, taking Eric with him, still impaled on the feline's shaft and soon held against his soft belly fur with a muscular forelimb.";
				now level of Eric is 3;
				now lastfuck of Eric is turns;
			else:
				LineBreak;
				say "     Deciding that this has gone far enough, you dash forward, stepping between the felinoid and Eric, blocking the large cat's access to his new fuck-toy. It takes some effort to shoo the insistent felinoid away, but you finally manage it after a while. With a disappointed growl, the large animal gives Eric a last look before stalking off, trying to act as if he hadn't planned to do anything with the human.";
				now level of Eric is 99;
				if cocks of player > 0:
					LineBreak;
					say "     You're left standing over a still pretty dazed Eric and the felinoid's pheromone-laden musk still hanging in the air here has you pretty wound up, your cock hard as rock. Do you want to take the opportunity of fucking the cuntboy yourself right now?";
					if player consents:
						LineBreak;
						say "     Quickly stripping off your own clothing, you kneel behind him and pull down Eric's shorts. Ah, he went commando today - maybe some part of him is learning to keep himself ready and accessible for you. He just looks so delicious, on all fours before you with his athletic body and a moist and swollen pussy open to you. A thought of going slow quickly evaporates before your boiling lust, causing you to aim your shaft and then plunge into Eric's body in one go, making him groan as your cock suddenly spreads his pussy lips. He whimpers a bit as you slide deeper, but soon starts to moan in lust as you bottom out and start thrusting, rubbing against his inner walls with your shaft.";
						say "     You fuck the little cuntboy bitch for quite a while, only stopping for a moment when you cum inside him and fill his womb with your fertile seed, then rest on top of him until you're ready to go on. It's a wild ride, but finally - after him and you coming three times - your stamina is spent and you pull your softening erection out with a wet slurp. While you move around to grab your clothes, Eric sinks to the ground, lying on his side with your cum oozing out of his pussy. He murmurs to himself 'I can't believe how much this gets me off. I should hate this - and him! Three times he's made me cum and filled me. What does he want to do - use me as a breeding bitch?' before dozing off. Not a bad idea, you think for yourself as you walk back out between the shelves.";
						now lastfuck of Eric is turns;
					else:
						say "     Nah, it's more fun to dominate the little bitch when he's not zonked out and realizes what's happening to him. You just walk off and leave him to recover on his own.";
		else: [leave it]
			LineBreak;
			say "     Oh well, it would happen at some point no matter what you do. Let the big kitty have some fun with your little cuntboy bitch too. Some short time later, you hear lust-filled growls and pants sound from somewhere between the bookshelves, culminating in a satisfied roar not long after.";
			now level of Eric is 1;
			now lastfuck of Eric is turns;

instead of navigating Grey Abbey Library while (Felinoid Companion is tamed and ((level of Eric is 4 and (HP of Eric is 11 or HP of Eric is 12 or HP of Eric is 13 or HP of Eric is 14 or HP of Eric is 15 or HP of Eric is 22 or HP of Eric is 32) or (level of Eric > 0 and level of Eric < 99 and HP of Eric is 99))) and (lastfuck of Eric - turns) > 12 and a random chance of 1 in 3 succeeds):
	say "[NavCheck Grey Abbey Library]";
	if NavCheckReturn is false, stop the action;
	move player to Grey Abbey Library;
	if debugactive is 1:
		say "     DEBUG: ERIC FELINOID SEX REPEAT WALKIN [line break]";
	if HP of Eric is 11 or HP of Eric is 12 or HP of Eric is 13 or HP of Eric is 14 or HP of Eric is 15: [cuntboy Eric, had sex before]
		say "     As you enter the library, you hear moaning and lust-filled growls coming from somewhere behind one of the back shelves. Curious who's doing whom, you go to check it out. Walking over until you see the space behind the long bookshelf, you spot Eric - with your felinoid companion on top of him, mounting the smaller human and rapidly thrusting his hips at him. Seems like the big cat managed to put your friend under his influence again - though maybe this time Eric went to seek the feline out - after all, the young athlete is on his hands and knees on one of the mattresses from the cots in the bunker below, which he must have dragged up here for just this purpose...";
		LineBreak;
		say "     The animalistic coupling of the felinoid and his entranced partner is quite a show, driving your arousal to new heights as you watch. With the stamina of a wild beast, the felinoid drives his cock into Eric's pussy relentlessly, until finally the cuntboy's moans and noises rise up to a climactic shout, announcing his orgasm to anyone in hearing range. Visibly satisfied in making him come, the felinoid isn't far behind, burying his hard cock all the way in the young human's pussy and holding still, only his balls pulsing as they fill him up with his seed. When he finishes cumming, the big cat throws himself on the mattress to lounge in satisfaction, taking Eric with him, still impaled on the feline's shaft and soon held against his soft belly fur with a muscular forelimb.";
	if HP of Eric is 22:
		say "     As you enter the library, you hear moaning and lust-filled growls coming from somewhere behind one of the back shelves. Curious who's doing whom, you go to check it out. Walking over until you see the space behind the long bookshelf, you spot Eric - with your felinoid companion on top of him, mounting the smaller human and rapidly thrusting his hips at him. Seems like the big cat managed to put your friend under his influence again - though maybe this time Eric went to seek the feline out - after all, the young athlete is on his hands and knees on one of the mattresses from the cots in the bunker below, which he must have dragged up here for just this purpose...";
		LineBreak;
		say "     The animalistic coupling of the felinoid and his entranced partner is quite a show, driving your arousal to new heights as you watch. With the stamina of a wild beast, the felinoid drives his cock into Eric's asshole relentlessly, until finally the young athlete's moans and pants rise up to a climactic shout and his horsecock starts blasting heavy squirts of cum all over the mattress under him. Visibly satisfied in making his partner come, the felinoid isn't far behind, burying his hard cock all the way in his human partner's butt and holding still, only his balls pulsing as they fill him up with his seed. When he finishes cumming, the big cat throws himself on the mattress to lounge in satisfaction, taking Eric with him, still impaled on the feline's shaft and soon held against his soft belly fur with a muscular forelimb.";
	else if HP of Eric is 32:
		say "     As you enter the library, you hear moaning and lust-filled growls coming from somewhere behind one of the back shelves. Curious who's doing whom, you go to check it out. Walking over until you see the space behind the long bookshelf, you spot Eric - with your felinoid companion on top of him, mounting the smaller human and rapidly thrusting his hips at him. Seems like the big cat managed to put your friend under his influence again - though maybe this time Eric went to seek the feline out - after all, the young athlete is on his hands and knees on one of the mattresses from the cots in the bunker below, which he must have dragged up here for just this purpose...";
		LineBreak;
		say "     The animalistic coupling of the felinoid and his entranced partner is quite a show, driving your arousal to new heights as you watch. With the stamina of a wild beast, the felinoid drives his cock into Eric's asshole relentlessly, until finally the young athlete's moans and pants rise up to a climactic shout and his satyr cock starts blasting heavy squirts of cum all over the floor under him. Visibly satisfied in making his partner come, the felinoid isn't far behind, burying his hard cock all the way in his human partner's butt and holding still, only his balls pulsing as they fill him up with his seed. When he finishes cumming, the big cat throws himself on the floor right at that spot to lounge in satisfaction, taking Eric with him, still impaled on the feline's shaft and soon held against his soft belly fur with a muscular forelimb.";
	else if HP of Eric is 99: [sex slave cuntboy]
		say "     As you enter the library, you hear moaning and lust-filled growls coming from somewhere behind one of the back shelves. Curious, you go to check it out. Walking over until you see the space behind the long bookshelf, you spot Eric - with your felinoid companion on top of him, mounting the smaller human and rapidly thrusting his hips at him. Seems like the big cat managed to catch your little cuntboy getting books again and took advantage of the situation. And just like the slut he is, Eric succumbed to the felinoid's influence and let the feline mount him.";
		LineBreak;
		say "     The animalistic coupling of the felinoid and his entranced partner is quite a show, driving your arousal to new heights as you watch. With the stamina of a wild beast, the felinoid drives his cock into Eric's pussy relentlessly, until finally the cuntboy's moans and noises rise up to a climactic shout, announcing his orgasm to anyone in hearing range. Visibly satisfied in making him come, the felinoid isn't far behind, burying his hard cock all the way in the young human's pussy and holding still, only his balls pulsing as they fill him up with his seed. When he finishes cumming, the big cat throws himself on the floor right at that spot to lounge in satisfaction, taking Eric with him, still impaled on the feline's shaft and soon held against his soft belly fur with a muscular forelimb.";
	now lastfuck of Eric is turns;

instead of going inside from Grey Abbey Library while (Level of Eric > 0 and Level of Eric < 4 and Eric is in Bunker and HP of Eric < 99):
	move player to Bunker;
	if debugactive is 1:
		say "     DEBUG: ERIC POST-FELINOID-SEX WALKIN [line break]";
	if HP of Eric < 99:
		project the figure of Eric_face_icon;
	say "     As you come down the stairs into the bunker, Eric almost jumps up from where he was sitting on his cot and rushes over to you, his cheeks red with embarrassment. Before you can so much as ask what's wrong, he gushes forth with 'I'm sorry. I- I had sex with your felinoid pet. Something just came over me and I let him mount and fuck me! Can you ever forgive me for this?' His somewhat teary eyes seek out yours and take on a hopeful look as he realizes how calmly you're taking this (you did already know and didn't stop the felinoid from fucking him after all).";
	say "     So, what do you tell him? That there's no shame in having some fun, even without you and with... exotic partners ([link]Y[as]y[end link])? Or do you just console him and tell him to avoid the felinoid in the future ([link]N[as]n[end link])?";
	if player consents: [more felinoid scenes]
		LineBreak;
		say "     Putting your arms around Eric and holding him, you console him with calm words, explaining to him that you're not angry or anything. After all, it's a whole new world with the nanites and all, so why should anyone be restrained by the morals of the old one. The young athlete's eyes get wide in realization as you remind him that you brought the felinoid home with you, even after knowing its lusty character. Pulling him close again, you squeeze Eric's tight ass and whisper in his ear that [if Level of Eric is 1 or Level of Eric is 2]you saw the felinoid follow him in the library and were okay with it[else]you were there and did watch the hot little scene of the felinoid mounting him[end if]. A visibly relieved Eric stutters 'So you did... you let... he did...', then takes a deep breath before admitting 'He felt so good - so right - inside me, having his hard cock fuck me, the soft fur of his belly against my back...' His breathing becomes quicker as he relives his experience with the felinoid in memory, clearly getting aroused by it.";
		LineBreak;
		say "     Do you want to seize the moment for some hot action between the sheets with Eric ([link]Y[as]y[end link]), or do you just leave him to dwell on his lusty thoughts ([link]N[as]n[end link])?";
		now Level of Eric is 4;
		if player consents:
			say "     [BasicEricSex]";
		else:
			LineBreak;
			say "     Smiling at Eric and encouraging him to have some more fun with the felinoid whenever he wants, you chat with him a short while, then turn to other things. The by now pretty wound up young athlete meanwhile makes a beeline for his bunk, no doubt to stroke himself and deal with his built-up lust.";
	else: [no further felinoid scenes]
		LineBreak;
		say "     Putting your arms around Eric and holding him, you console him with calm words, explaining to him that you're not angry or anything. After all, it's partly your fault for bringing the felinoid here with you (and letting him fuck Eric, but he doesn't need to know that). Telling Eric just not to fall for the felinoid's charms and arousing musk again, you give the visibly relieved athlete a kiss on the cheek and leave him to get back to his bunk.";
		now Level of Eric is 99;

instead of going inside from Grey Abbey Library while (Level of Eric is 4 and Eric is in Bunker and HP of Eric > 9 and HP of Eric < 20 and (lastfuck of Eric - turns) > 12 and a random chance of 1 in 3 succeeds):
	move player to Bunker;
	if debugactive is 1:
		say "     DEBUG: ERIC BUNKER-FELINOID-SEX WALKIN (CBOY ERIC ONLY SO FAR)[line break]";
	say "     As you come down the stairs into the bunker, you hear gasped moans and loud purring growls come from somewhere over in the rows of beds. Letting your gaze wander over the large room, it is easy to spot where the noise is coming from, as the pale-skinned form of Eric with his bright red hair is hard to miss. Looks like he's really taken to the felinoid after your encouragement for him to do so - the young trans-male has spread out several blankets on the floor beside his own bed for the big cat. Currently, the felinoid is lying on that comfy pile, sprawled out on his back and purring like an idling motor as Eric rubs his belly-fur while bouncing his hips against the big cat's crotch. Clearly, he's got the feral beast's feline shaft deep in his pussy, stimulating his inner walls with the many nubby spines along the shaft of the felinoid's erection.";
	say "     The animalistic coupling of the felinoid and his eager and willing partner is quite a show, driving your arousal to new heights as you watch. Mostly content to let Eric ride his cock, the felinoid nevertheless sometimes humps his crotch up without warning and shafts Eric deeply, drawing ecstatic howls from the young man. Eventually, the student athlete's moans and pants rise up to a climactic shout, announcing his orgasm far and wide. Purring even louder in obvious satisfaction at having made Eric come, the felinoid isn't far behind, burying his hard cock all the way in the young human's pussy and holding still, only his balls pulsing as they fill him up with his seed. When he finishes cumming, the big cat rolls over on his side to lounge in satisfaction, taking Eric with him, still impaled on his shaft and soon held against soft belly fur with a muscular forelimb.";
	now lastfuck of Eric is turns;

instead of going down from the Grey Abbey Library while (Eric is in Bunker and HP of Eric < 99 and Rane is in Sitting Area and Dexterity of Eric is 0):
	move player to Bunker;
	if debugactive is 1:
		say "     DEBUG: ERIC RANE TALK EVENT [line break]";
	if HP of Eric < 99:
		project the figure of Eric_face_icon;
	say "     As you come down the stairway and walk into the main room of the bunker, you find that Eric is already waiting for you. He gets moving from where he was leaning against a wall nearby and approaches with some hint urgency in his step. 'Welcome back,' he greets you, putting a hand on your arm, then bites his lip for a second before he continues to say, 'I - I wanted to ask you about... the demon. The blue one, up there.' The young man waves a hand to the ceiling, indicating the library building above your heads. He's talking about Rane, you realize, and so you tell your red-headed friend about him, and that he's very different than the rampaging demon brutes[if demon brute is tamed and DBCaptureQuestVar > 5] like Brutus once was[else if demon brute is tamed] like Brutus[end if]. Eric calmly listens to your explanation and at least some of the tension leaves his body, expelled as the student takes a deep breath and lets it out again. You also realize that up till now, he had been making sidelong glances at the bunker entrance, almost as if he expected for Rane to suddenly burst through it.";
	say "     'So - he's an oni. Called Rane,' Eric says toughtfully, then asks, 'And you're sure he's... safe, to be around? Hm, you must have - otherwise you wouldn't have brought him, right? Guess I should learn not to judge people by their looks. It is just... he looks pretty fierce. So tall, and muscle-packed, plus there's the horns too.' The young man gives a little helpless shrug, and you can feel that he can't help but hold some reservation still - not after his previous encounters with some of the bigger and fiercer infected, like the furling that bit him, or his ex-girlfriend now being a cheerleader hulk with a massive dick between her legs. You spend a few more minutes trying to calm Eric further, explaining in a soft voice that Rane just isn't the type to get violent about sexual matters. Eventually, the college athlete gives a relieved sigh, then says, 'Okay, thanks. I'll get some jogging done between the rows of bookshelves in the library then. Gotta stay in shape, and I've hidden down here for long enough.' A moment later, he's gone after giving a friendly smile, leaving you standing in the room on your own.";
	now Dexterity of Eric is 1;

instead of going down from the Grey Abbey Library while (Eric is in Bunker and (HP of Eric is 10 or HP of Eric is 11 or HP of Eric is 14 or HP of Eric is 15) and Dexterity of Eric is 1 and Rane is in Sitting Area and findwires is 2 and fixedgens is 2):
	move player to Bunker;
	if debugactive is 1:
		say "     DEBUG: ERIC RANE SHOWER EVENT - DEXTERITY OF ERIC: [Dexterity of Eric][line break]";
	say "     As you come down the stairway and walk into the main room of the bunker, you spot Eric as he digs around in his sports bag, pulling out a clean t-shirt and shorts, then takes a towel from where it lies on his bed. The young man smiles at you as he looks up and makes a few steps in your direction to greet you. 'Hey there, nice to see you down here again. I wanted to tell you - Thanks. I really wouldn't know where I'd have ended if you hadn't saved me from the campus, brought me here and... helped me accept how things went.' He makes an airy gesture towards his crotch, clearly indicating his peculiar gender state. There is a small pause as he bites his lip, then shakes it off and continues with a smile, 'Hey, you even got the power back on and now we got running showers. Pure luxury during the nanite apocalypse. Too bad we can't drink it, not with those ancient lead pipes and all, but still... just feeling clean again is awesome. And speaking of it - I'm gonna take a shower now. See ya in a bit.' The young college athlete pats your arm and plants a peck on your cheek, then strolls off towards the door leading to the shower room.";
	say "     Before Eric is more than halfway there, you hear the door to the bunker stairwell open again behind you, and the tall blue shape of Rane steps into your line of sight. 'Just got back,' the oni says as you greet him, then chuckles as your nostrils flare when his scent reaches them - mostly sweat that just makes him seem more masculine in a strangely enticing way. Looking closer, you see the small droplets of perspiration glisten on his ripped abs and chiseled thighs, perfectly accentuating his musculature. Your eyes are drawn into following each sexy curve, bump and ridge, until Rane snaps you out of it by saying, 'Hah, sorry for being a bit ripe - had my usual four mile run through the surrounding blocks and some moronic critter tried to jump me. Well, at least it helped me keep my edge.' The powerful fighter makes a fist, looking at the crimson splotches on his hand-wraps, then cracks his knuckles and shrugs. 'Time for I shower, I guess.' Nodding towards the shower room doors, he notes Eric stepping through them, then starts walking after the young man with a slight smile on his face.";
	LineBreak;
	say "     Hm, you think there was a flash of... interest in Rane's eyes as he looked at Eric, and now he's following the college athlete into the showers. Maybe it'd be a good idea to follow them - to make sure there aren't any problems. Or possibly just to watch...";
	say "     Will you follow Eric and Rane into the shower area? (Y/N)";
	if player consents:
		LineBreak;
		say "     Walking after the human and oni after a short moment of hesitation, you pull open the door of the locker-room and look inside. As it turns out, Rane is standing just a few steps ahead of you, silently observing Eric as he undresses. Since the young man has his back turned, the blue oni is free to stare at him in impunity, even leaning his head down a little go get a good look as Eric bends over to step out of his undies. Seems like seeing a pussy between the red-headed student's legs aroused Rane more than just a little, and the tall demon nods appreciatively as he adjusts the bulge under the cloth wrap around his hips. Meanwhile, Eric puts his towel around himself, hiding his shapely ass and peculiar gender from sight again, then moves on to the actual shower room. He still hasn't seen Rane or yourself - and that's how it remains for a moment longer, as the oni follows without making even the slightest sound, proving that he's not only strong, but stealthy too.";
		say "     Curiosity drives you onwards and you enter the locker-room yourself to keep Rane in sight, allowing you to see him move in closer and closer behind Eric. When he's almost near enough to bump against him, the oni says, 'Hey there. Eric, right? Saw you in the building a few times but we never talked. So I wanna introduce myself now.' The sudden realization that he isn't alone makes the young man flinch and whirl around, giving him an eyeful of the rippling muscles on the blue demon's chest. Then he looks up to meet the gaze of the much taller male, still pretty wide-eyed while Rane just gives him a beaming grin. 'Name's Rane,' the oni says and makes one more little step towards Eric, encroaching into the student's comfort zone even more.";
		WaitLineBreak;
		say "     With a gulp, the young man replies, 'I - um. Eric. I'm Eric. But - you know that already,' stumbling over his words as he tries to come to grips with finding himself here, with this virile male towering over himself. What composure he managed to gather is shattered a moment later when Rane says, 'Sorry, didn't mean to scare you. Or drop this.' And with that, the oni bends down to pick up the towel that had slid from around Eric's hips earlier. Realizing he's completely naked, showing off all of his lithe body and... female assets, Eric's hands fly to cover his crotch and he blushes almost as bright as a lobster. Rane offers the college athlete the towel back, then nonchalantly steps over to the nearest wall to hang it up on a hook as Eric proves too frozen in embarrassment to be able to take it.";
		say "     'No need to be ashamed,' Rane cheerfully tells his naked companion as he moves closer again, 'you're really quite an attractive guy. Hm, maybe it is just the feeling of being the only one who's got nothing on?' Even while Eric starts to shake his head, the oni undoes the belt holding up the garment around his hips. With one quick pull, he's got the fabric in his hand, then throws it casually aside, leaving his already half-hard pole to swing freely, pointing right at Eric. 'There, isn't that better?' Rane asks, looking down at Eric with a piercing gaze, pointedly waiting for an answer. Staring wide-eyed at the oni's increasingly erect manhood, Eric inches backwards step by step and chokes out, 'Errr... Yes? But I think - you... I... should -' Then he gives a frightened little yelp as his back bumps against the cold tiles of the back wall, surprising him with their cold surface. Eric's now literally with his back to the wall, and the clearly aroused Rane followed him all the way, only getting closer instead of farther away. Then he puts his arm against the wall over Eric's head, leaning in on the young man.";
		WaitLineBreak;
		say "     With the relentless sexual appetite the oni has already more than proven, you have little doubt that Rane will keep pushing Eric, and before long, that hard blue cock will be balls-deep inside the young man. Do you want to step in and stop this ([link]Y[as]y[end link]), or just continue to watch ([link]N[as]n[end link])?";
		if player consents:
			LineBreak;
			say "     Not wasting a second, you hurry into the room and loudly clear your throat, drawing the attention of both the oni and human. Rane's expression goes from surprise to a playful grin, nodding to you and then to Eric - offering to double-team the cuntboy between you, from your guess. But no, you're here to rescue Eric, so you shake your head, then calmly tell Rane that you want to talk with him outside. It is obvious that he isn't all that pleased about this, and Rane's muscles ripple as he tenses, only to relax again as he shrugs. The oni leans in even closer to Eric and takes in a deep breath of the college athlete's smell, then says, 'See you later, sweet-cheeks.' And with that, he moves to casually pick up his discarded clothes and walks out with you. Left behind, Eric slumps against the wall in relief, panting as he works to regain his composure. Part of which means taking a cold shower, so he pulls a lever on the wall all the way to one side and steps under the spray.";
			say "     Leaving the student alone in the shower area, you and Rane step out and as soon as you can hear the water running from behind you, the oni whirls to confront you, 'What the hell? Why did you cock-block me? He wanted it - I mean, go in there and take a sniff if you don't believe me. His body is screaming that he's ripe for the picking!' Reaching down to grab his hard shaft and wag it towards you, the oni then smacks the wall beside himself in frustration, cracking one of the tiles into several pieces. 'Damn it - cute and sexy, the perfect little cuntboy and you... oh. You got dibs on him, am I right[if Dexterity of Eric is 11]? Took that pussy for a ride, claimed him[else if Dexterity of Eric is 10]? Got something planned to pop his cherry in a special occasion[end if]?' The oni's slitted eyes flash at you, just for a second, hinting at his inner demon's rage at not being unleashed on the young man he had already thought his. There is jealousy there, and lust without bounds. But then, the impression is gone, with Rane smoothing out his expression to a grudging smile. With about the same tone as a frat guy lamenting over a friend taking the last beer, he then says, 'Aww man - you're one lucky dog. Can't you share him? No? Fine.' Rane deflates a bit as you shake your head, then makes a fist and tugs his hand-wraps into position before leaving. Something about that tells you that even though he may have given in now, the matter is far from resolved for him. And that you definitively wouldn't want to be whatever he finds first outside and takes his frustration out on...";
			now Dexterity of Eric is 50;
		else:
			LineBreak;
			say "     Lowering his horned head to the level of Eric's blushing face, Rane takes a deep breath, then tells the young man with a grin, 'You smell nice. Real nice.' Eric gulps before replying, 'But - I'm all sweaty,' and Rane chuckles, 'So am I. Can be hell of a sexy thing - shows what's inside a guy... or gal. The natural way of telling others about yourself. Pheromones and stuff.' Reaching down, he gently cradles Eric's head in his hand, then pulls the college athlete closer, his nose almost bumping Rane's chest. 'So tell me, what does my scent tell you about me?' the oni questions with a sly grin, nodding as Eric breathes in deep. The young man's next words come in between panting quickly, 'You're... oh wow, that's...' He stops talking, drawn into action instead - by taking one hand off covering himself and now touching Rane's muscled chest. 'That's all because of you, Eric. You're one cute guy,' Rane rumbles to the student and nibbles on his earlobe, then moves his large hand to pull Eric's other arm down to his crotch.";
			say "     Eric's eyes go wide as his fingers encounter the hot shaft of Rane's cock for the first time. He can't help but want to wrap his hand around it - and he does, if barely, because of the blue shaft's sheer size and thickness. 'Yeah, feel how hard you made me,' Rane rumbles to Eric, his voice more guttural than just moments before. Seems like the oni's civilized behaviour is starting to slip, now that his rampaging sexuality is in the progress of taking over. A strong, blue hand slips between Eric's legs next, gripping his lithe and muscled runner's thighs, then sliding up to his crotch. Rane flicks the tip of a finger over his partner's nether lips, laughing at the moan that draws from Eric. He runs the digit down over Eric's swollen pussy right after, teasingly nudging the folds apart and - almost - sticking his finger in, then he brings the hand up in front of the student's face, showing off the glistening sheen of wetness on his index finger.";
			WaitLineBreak;
			say "     'Look how moist you are for me,' the oni grunts, wagging his finger before licking some of Eric's femcum off and smacking his lips. 'Mmmmh, tasty!' he adds with a chuckle, then pushes the digit towards Eric, sticking it into his mouth as the young man opens his lips for another moan. 'Yeah, suck your pussy juice off! You wanna get fucked, don't you? You need a hard cock in that cuntboy snatch!' As he talks to Eric, Rane continues to keep his finger in the student's mouth and at the same time starts to fondle him with the other hand - meaning that all the answer he gets is an aroused moan. Just what he wanted to hear, as it turns out. Ducking his head, Rane brings his lips against Eric's as he withdraws his finger, pulling the redhead into a long, breathless kiss just overloaded with lust.";
			say "     While still snogging the young college athlete with furious intensity, Rane's hands now both run down the cuntboy's body and slide around to cup his ass - then the oni lifts the smaller human up, allowing him to stand upright as they make out, with Eric pressed against the shower wall. Having now given in to the arousal that Rane woke in him, the college athlete eagerly responds to each kiss and lick by the blue giant, his arms clutching on to the shoulders of the strong arms holding him. Not one to wait long once he's got a partner itching to be fucked, Rane takes his hard prick in one hand and aims it right between Eric's nether lips, then presses forward, grunting in satisfaction as the cock-head slides into the tight embrace of the student's pussy. 'Mmmmhhh... sexy... tight... cuntboy,' Rane rumbles in between kisses, then sinks himself deeper into Eric, ";
			if HP of Eric is 10: [virgin]
				say "drawing a breathless squeak from Eric as the thick blue shaft bumps his hymen.";
				WaitLineBreak;
				say "     'Oh fuck yeah!' Rane calls out with a laugh, looking down over the slender body of the young trans-guy in his arms. 'You're cherry! What a prize - a cute, sexy, cuntboy virgin. Just waiting for me to fuck! Gonna show you what it means to take a dick!' With that said, he leans in to draw Eric into a deep kiss, then bucks upward with a sudden jerk, sinking about a third of his erection into the young guy. There is a short scream from Eric as his hymen is broken by such a large piece of meat, somewhat muffled by Rane's open mouth. 'Had to be done, baby. Sorry. But you'll like what comes next,' the oni grunts, his hand moving to rub Eric's clit. Then he proceeds to push deeper, making the student moan as his inside stretch around the thick blue shaft.";
				now HP of Eric is 12; [Rane took his virginity]
				now EricVirginityTaken is 2;
			else: [not a virgin]
				say "making him moan as his insides stretch around the thick blue shaft.";
				if HP of Eric is 14:
					now HP of Eric is 15; [Eric got fucked by another npc and the player and Rane]
				else:
					now HP of Eric is 13; [Eric got fucked by both the player and Rane]
			WaitLineBreak;
			say "     Craning your neck a little, you direct your gaze down to where their hips meet. It really is quite an amazing sight to see the blue devil fuck Eric - a seven foot tall muscled oni, manhandling the lean teenager and pushing him down on his thick twelve-inch erection. You can literally make out where his dick is at any given moment, as the bulge of Rane's cock shows under Eric's flat abs. Relentless, the blue giant pushes deeper and deeper - all the while watching Eric's face with a grin as the young man trembles and moans at the sensations. Then finally, Rane bottoms out with a last thrust, grunting gutturally as his balls slap Eric's crotch.";
			say "     'Man you're tight. Like a warm glove on my cock,' Rane says, grinding his hips against Eric and drawing a long moan. 'Yeah, that's it, whimper for me you little bitch - you wanna get fucked hard, don't you?' As overwhelmed as Eric is with taking the monstrously big, throbbing shaft inside him, the young man isn't really able to get out any intelligible words - but then, Rane doesn't really expect him to either, as he rubs the cuntboy's clit with his thumb, pushing him from moaning into groaning and screaming in lust. 'That's what I thought,' the oni grunts with a chuckle, then lifts Eric a little, sliding most of his cock out to thrust it back in with a hard jab, creating a very audible slap as their two bodies meet. He waits a second, then does so again, and again, each new thrust slightly faster and harder than the before.";
			WaitLineBreak;
			say "     As Rane pounds into Eric, making the college athlete pant and moan, he continues to talk dirty to him, growling and sometimes even shouting things like 'Yeah, take it! I'm gonna fuck you till you can't stand straight!', 'You like that, little bitch, don't you?' and 'Can't get enough of your little fuck-hole.' The onslaught is nearly too much to bear for Eric - with Rane's long, thick and warm pillar of a cock moving swiftly in and out of his pussy, the little bumps and bulging veins of the cock rub against his tautly stretched inner walls, constantly pushing his arousal to an all-time high. One orgasm just flows over into the next, and you can see the young man's hands tightly gripping Rane's arms as he holds on for dear life, taking slam after pistoning slam of those strong hips against his rear...";
			say "     The sounds of sex the shower room - pants, groans, moans, slapping noises and even a whimper or two - created by the oni's preference of pretty rough and hard sex. Still, even though he may be playing hard, fucking hard - that's as far as it goes. Even as Rane lets out his inner beast - the true 'blue devil' who delights in taking Eric right to the brink of what he can take - he nevertheless makes sure his human partner enjoys the ride. Watching closely, you notice several moments in which he changes the angle of his thrusts to give Eric more pleasure, and also when he goes slow just a second when the teen really needed it. Lusty and wild as he may be - with a mouth that would make hardened prostitutes blush - Rane is also caring. He obviously makes quite sure that he doesn't actually hurt Eric, no matter how rough things get otherwise.";
			WaitLineBreak;
			say "     Rane pounding Eric against the shower wall seems to go on and on, as the oni seems to have a bottomless well of endurance at first, but eventually, you sense that things might be drawing to a close. He seems to have reached a limit to how fast he intends to thrust, which is plenty fast enough, and Rane's breathing is becoming just a bit ragged. The deep grunts get louder by the moment, in addition to his voice becoming just a bit hoarse. Then finally, the limit is reached. Rane's voice builds up and echoes out into a screaming roar, his body slamming against Eric one final hard time as his head snaps back in bliss. With the massive oni cock pulsing in his tightly stretched pussy, Eric gives a prolonged whimper, and you can see his belly tremble with each heavy spurt of cum Rane blasts into him.";
			say "     Worn out by the long fuck and a breathtaking orgasm, Rane's body sinks forward to lean against the wall with one shoulder, and he trembles and twitches, each time delivering another torrent of warmth inside to fill Eric's womb. That sensation in and of itself is enough to give the young man one final climax, and his hands tremble as he rides out the high. Wow - that was quite a show, you think to yourself as you watch the exhausted duo stand there, gasping for breath. Soon, you spot a trickle of cum dripping to the floor between Rane's feet - overflow from Eric's pussy, as the monstrous load is too big to be contained by the small human. After a long moment of just panting being heard in the room, Rane moves again - pulling Eric off his shaft with a wet slurp, followed by the splash of more cum on the ground as his erection swings free and quite a bit gushes out of the uncorked pussyboy.";
			WaitLineBreak;
			say "     Lowering Eric to his feet, then helping him stand on shaky legs, Rane leans down to kiss the human's cheek and remarks, 'You're quite a nice fuck, boy. Been a while since I took a pussy for a ride - but yours was among the best I've had yet.' With that said, Rane reaches down between Eric's legs and digs a finger in between his nether lips, drawing a new gasp from the young man and chuckling. 'Very snug and tight - well, until I shoved my dick in anyways. But you train your muscles a bit and you'll more than make up for a little stretching, hah. And there's another option to check out too, next time...' Pulling his cum-slick finger out of Eric again, Rane reaches further down and brushes it over Eric's pucker, making the student tense for a moment until Rane withdraws.";
			say "     After being man-handled and fucked by the big oni, Eric stands rather timidly in front of Rane, but you can see that he's looking a bit defensive, now that the nanite-enhanced arousal and lust doesn't dominate his actions anymore. Even the blue giant notices it after a moment, and he looks down to say, 'You're a quiet sort, hm Eric? Not that you didn't scream beautifully when you came again and again. Come on, talk to me... you liked getting fucked, didn't you? I know you did.' Eric looks up at him, gazing into the expectant oni's eyes, then after a long moment says, '...Yes. I - I couldn't stop feeling sexy and aroused by that monster cock of yours.' The implied statement that maybe he wanted it to stop goes right past Rane, who just smiles and pats Eric on the shoulder. 'Let's get cleaned up. We were here for a shower, after all.' And with that, he shepherds the smaller human over to the nearest shower-head just a few steps over, then turns on the warm spray and starts soaping the two of them up - not without groping Eric as he does so.";
			WaitLineBreak;
			say "     With the action over, you quietly retreat before either of them spots you. Well, that certainly was one hot show...";
			now Dexterity of Eric is 2;
	else:
		LineBreak;
		say "     Nah, it'll be alright. Rane isn't a bad guy. And anyways, you can't babysit Eric all the time. With a shrug, you turn your attention to other matters.";
		now Dexterity of Eric is 2;

instead of going down from the Grey Abbey Library while (Eric is in Bunker and (HP of Eric is 12 or HP of Eric is 13 or HP of Eric is 14 or HP of Eric is 15) and Dexterity of Eric is 2):
	move player to Bunker;
	if debugactive is 1:
		say "     DEBUG: ERIC RANE AFTERMATH TALK - DEXTERITY OF ERIC: [Dexterity of Eric][line break]";
	say "     As you come down the stairway and walk into the main room of the bunker, you spot Eric sitting on his bed, legs drawn up tight to his chest and holding a book in his hands. His head twitches up in a jerky motion as he realizes someone is coming, and you can see his hands go white as he reflexively grips tight, then relaxes when he sees it is you. The young man gives you a little nod and shy smile, then turns his attention inwards again, back to what he was reading. Even so, the tension in his whole being is more than evident, and you wonder if you should go over and see what is up.";
	LineBreak;
	say "     Do you do so? ";
	if player consents:
		LineBreak;
		say "     Directing your steps towards Eric, you say hello to the student and watch as he puts down the book, then gives you a somewhat washed-out smile, hugging his legs as he does so. As you ask him what's wrong, Eric takes a shuddering breath and says, 'I - I went to take a shower, and... the blue demon followed me. He... I... he did things. Fucked me.' The last words are almost a whisper, and Eric trembles a little as he says them, prompting you to ask if Rane hurt or forced him. 'No,' Eric breathes out, then elaborates, 'That's just it. He took me hard, it wasn't painful, but... I feel... I should have said no. I wanted to say no, but... the words didn't come. Something inside just told me to let it happen, enjoy the feelings. And I did. It felt really really good, at the time.'";
		say "     He waves his hand in a helpless gesture, then gives a quiet sigh. 'I know these things - the nanites - mess with all of us, but I hadn't realized so clearly that they can make you do things. Or not do things. Or maybe it's not them, but something in me. That I wanted it like that. Or the d- or Rane has some demonic powers. I just... DON'T KNOW!' With that outburst, the young man jumps up and rushes out of the room, running to the nearby restroom. You can hear the click of its lock from where you're standing, right after he slams the door shut after him.";
		now Dexterity of Eric is 3;
	else:
		LineBreak;
		say "     Nah, he'll be alright on his own. Eric can get his act together and deal with stuff, no need to involve yourself. No need at all. With a shrug, you turn your attention elsewhere.";
		now Dexterity of Eric is 4;

instead of navigating Grey Abbey Library while (Eric is in Bunker and (HP of Eric is 12 or HP of Eric is 13 or HP of Eric is 14 or HP of Eric is 15) and (Dexterity of Eric is 3 or Dexterity of Eric is 4) and Rane is in Sitting Area):
	say "[NavCheck Grey Abbey Library]";
	if NavCheckReturn is false, stop the action;
	move player to Grey Abbey Library;
	if debugactive is 1:
		say "     DEBUG: ERIC RANE FUCK WALKIN - DEXTERITY OF ERIC: [Dexterity of Eric][line break]";
	say "     Coming back into the library, you instantly hear that something is up - as moans, grunts and the slapping noises of flesh on flesh echo through the large main chamber. Someone is having sex - and a real pounding too, from the sounds of it. A moment later, the question of who's doing the fucking is answered, as you can hear Rane bellow, 'Yeah! That's one sweet boy-pussy you got here. Take my dick, you little slut!' A loud slap, coupled with a lust-filled groan follows - doubtlessly the blue oni hammered his shaft in again right then.";
	say "     Do you want to go and check out what's going on with your own eyes? ";
	if player consents:
		if a random chance of 1 in 2 succeeds: [Eric Butt-Fucked]
			LineBreak;
			say "     Walking along one of the slightly wider corridors between row after row of bookshelves, you move towards the source of the fucking noises and soon spot the blue form of Rane through the gaps above the countless books. A few steps further and getting right up close to the right-hand shelf, you've got a perfect view of the little reading area on the other side and the action going on there. The tall blue oni is fully naked, standing with his legs bent a bit to put his crotch at just the right height to fuck Eric's ass with deep thrusts, as the young man stands bent forward over the backrest of a comfortable-looking sofa. Eric is just holding on for dear life as the thick shaft pounds into his ass, gripping the sofa cover with white-knuckled intensity. But even though Rane's more than a little bit rough with him, leaving the young man's ass somewhat reddened from the relentless pounding, you can see from the flush on Eric's face and the tremble of his voice as he gasps in lust that the teenager does indeed enjoy being fucked.";
			say "     'I'm still not decided which hole is better. You're feeling pretty well around my dick on both ends. Guess I'll have to try both out a few more times,' Rane calls with a chuckle, without slowing down even a little. The only reply from Eric is another urgent moan as Rane bottoms out again. Hidden from view behind the bookshelves, you watch as the muscled oni fucks Eric good - with a furious intensity and all the while going on with dirty talking about how good his 'sexy little bitch, slut, cuntboy, fuck-hole or stud' feels to be in. Eventually, the blue-skinned giant's breaths become hoarse and come out in ragged growls and he manages to blurt out 'OH FUCK! I'M GOING TO CUM', racing to a tempo of pistoning his hips against Eric's gyrating ass with inhuman speed. Finally he gives a hoarse bellowing roar and drives himself all the way into Eric with one last thrust, then holds the young man tight by the hips as is asshole is flooded with Rane's virile load, the blue demon's leg and ass muscles tensing and flexing with each massive spurt of cum.";
			WaitLineBreak;
			say "     Rane stays balls-deep inside Eric for several long moments, bent over the young man and catching his breath as he rests. Then he eventually straightens again, looking down on the smaller human and stroking down his back. 'I'm so glad I came here. Who'd have thought a library would hold such pleasurable delights as your sexy ass. And pussy...' With that, the oni pulls his thick cock out of Eric, accompanied by a little gush of cum that only stops when his pucker closes in a hurry. Before Rane's erection can go down, he rubs it up against Eric's nether lips, making the young student gasp in lust once more. 'Hah, you're so very wet, Eric. I could almost just slide in right now and keep fucking you for a second round,' Rane remarks, but then shrugs and steps back from the sofa. 'But no - I got a five mile run to start. Can't go soft, even if there's such a sexy cuntboy as yourself to fuck. Later then, okay? And your pussy definitively has a date with my shaft.'";
			say "     Eric only mutely nods, then gets his hair ruffled by the well-satisfied oni before he strides off and soon vanishes from sight. Sinking down into a crouch after pushing himself up from his position bent over the sofa, Eric clenches his eyes shut and wipes a hand over his face slowly, then takes a deep breath. As his eyes open again, they are immediately drawn to where he was bent over the sofa and fucked for all he was worth. A mid-sized wet spot there bears witness to where his pussy was pressed against the fabric and shows that he had more than one orgasm while being fucked. The student's reaction as he sees it does strike you a bit odd - there is no real acknowledgement of a nice time, only a little sigh and his murmur of, 'Oh fuck.' Then Eric starts looking around to hunt for his clothes, and you decide that moving on might be better than being caught peeping.";
			increase EricAnalCounter by 1;
		else: [Eric pussy-fucked]
			LineBreak;
			say "     Walking along one of the slightly wider corridors between row after row of bookshelves, you move towards the source of the fucking noises and soon spot the blue form of Rane through the gaps above the countless books. A few steps further and getting right up close to the right-hand shelf, you've got a perfect view of the little reading area on the other side and the action going on there. The tall blue oni is fully naked, kneeling in front of one of the sofas, putting his crotch at just the right height to fuck Eric's pussy with deep thrusts, as the young trans-man lies stretched-out on the comfortable-looking sofa. Eric is holding on for dear life, hands grasping the cushions with white-knuckled intensity as the thick shaft pounds into his tight pussy. But even though Rane's more than a little bit rough with him, leaving the young man's crotch somewhat reddened from the relentless pounding, you can see from the flush on Eric's face and the tremble of his voice as he gasps in lust that the teenager does indeed enjoy being fucked.";
			say "     'I'm still not decided which hole is better. You're feeling pretty well around my dick on both ends. Guess I'll have to try both out a few more times,' Rane calls with a chuckle, without slowing down even a little. The only reply from Eric is another urgent moan as Rane bottoms out again. Hidden from view behind the bookshelves, you watch as the muscled oni fucks Eric good - with a furious intensity and all the while going on with dirty talking about how good his 'sexy little bitch, slut, cuntboy, fuck-hole or stud' feels to be in. Eventually, the blue-skinned giant's breaths become hoarse and come out in ragged growls and he manages to blurt out 'OH FUCK! I'M GOING TO CUM', racing to a tempo of pistoning his hips against Eric's gyrating crotch with inhuman speed. Finally he gives a hoarse bellowing roar and drives himself all the way into Eric with one last thrust, then holds the young man tight by the hips as is womb is flooded with Rane's virile load, the blue demon's leg and ass muscles tensing and flexing with each massive spurt of cum.";
			WaitLineBreak;
			say "     Rane stays balls-deep inside Eric for several long moments, bent over the young man and catching his breath as he rests. Then he eventually straightens again, looking down on the smaller human and stroking down his slender front. 'I'm so glad I came here. Who'd have thought a library would hold such pleasurable delights as your pussy. And that sexy ass...' With that, the oni pulls his thick cock out of Eric, accompanied by a gush of cum from between his gaping nether lips. Before Rane's erection can go down, he rubs it up against Eric's bared pucker, making the young student gasp in lust once more. 'Hah, with my cum trickling down over that sexy hole, your ass sure looks inviting too Eric. I could almost just slide in right now and keep fucking you for a second round,' Rane remarks, but then shrugs and gets up to stand in front of the sofa. 'But no - I got a five mile run to start. Can't go soft, even if there's such a sexy cuntboy as yourself to fuck. Later then, okay? And your ass definitively has a date with my shaft.'";
			say "     Eric only mutely nods, then gets his hair ruffled by the well-satisfied oni before he strides off and soon vanishes from sight. Some tension seems to be leaving Eric as he starts to relax a little, then clenches his eyes shut and wipes a hand over his face slowly and takes a deep breath. As his eyes open again and the young trans-man pushes himself up on his elbows, they are immediately drawn to his crotch, still leaking Rane's seed to form a growing wet patch on the sofa. The student's reaction as he sees it does strike you a bit odd - there is no real acknowledgement of a nice time, only a little sigh and his murmur of, 'Oh fuck.' Then Eric starts looking around to hunt for his clothes, and you decide that moving on might be better than being caught peeping.";
	else:
		LineBreak;
		say "     Nah, sounds like they're having fun and you don't wanna butt in. Also, you got other things you really should be doing...";
	now Dexterity of Eric is 5;
	now EricFleeingCountdown is turns; [12 turns from now, he'll have run off, leaving a note]

instead of going down from the Grey Abbey Library while (Eric is in Bunker and (HP of Eric is 12 or HP of Eric is 13 or HP of Eric is 14 or HP of Eric is 15) and Dexterity of Eric is 5 and EricFleeingCountdown - turns < 13):
	move player to Bunker;
	if debugactive is 1:
		say "     DEBUG: ERIC FLEEING FROM RANE - DEXTERITY OF ERIC: [Dexterity of Eric][line break]";
	say "     As you come down into the bunker, you see Eric standing hunched over at his bunk, busy stuffing clothes and gear into his sports bag. Curious about what's going on, you move closer - only to have the young man visibly flinch and whirl around as he becomes aware of a presence behind him. 'Oh. Hey - it's just you,' the college athlete says, some of the tension leaving his body - but he still barely meets your eyes before looking down again and pressing his lips together. Something is definitively not alright here - there's a certain redness to his eyes and you think you can make out a tear in the corner of one. Silence hangs between you for several seconds, then Eric swallows noticeably and clears his throat. He looks just past you, his gaze resting on another bed as he avoids facing you directly, then says, 'I - I was gonna leave a note. But if you're here, it'll be... better like this. I'm... leaving. I can't thank you enough for everything that you've done for me, but your friend... he... Rane just...'";
	say "     Eric's breathing becomes quick and shallow as he clearly gets more and more agitated, then bursts out with, 'He comes on to me all the time. And then we fuck! I - I can't stop him. Couldn't. Didn't even try to!' He claws at the air in an gesture of pure frustration, then makes a fist and hits the side of his head lightly. 'With everything that happened to me, I don't even really know how to feel about all this! And, and... then I go along with it all. Is that me? Is it those fucking machines messing with my head? I CAN'T TELL ANYMORE. But it must be! I have to get out of here. I just have to get away from HIM. Anything is better than losing myself and ending as just another fuck-hole for a demon!' Shouting the last few words, Eric snatches up his packed bag and runs past you, not giving you even a second to reply. He's inside the stairwell leading out of the bunker before you can get over your shocked surprise at the outburst.";
	now Dexterity of Eric is 6; [Eric's gone!]
	remove Eric from play;

instead of going down from the Grey Abbey Library while (Eric is in Bunker and (HP of Eric is 12 or HP of Eric is 13 or HP of Eric is 14 or HP of Eric is 15) and Dexterity of Eric is 5 and EricFleeingCountdown - turns > 12):
	move player to Bunker;
	if debugactive is 1:
		say "     DEBUG: ERIC FLED FROM RANE - DEXTERITY OF ERIC: [Dexterity of Eric][line break]";
	say "     As you come down into the bunker, you notice that something is... off. Wondering what it might be, you let your gaze wander through the room, along the walls with their simple lights, the entrances of the restroom and shower, row after row of simple beds. There! Your eyes get drawn to one of them - neatly made and standing empty, not showing any trace that it is in use. Was in use, by Eric, whose sports bag and supplies are also conspicuously gone. A folded piece of paper lies on the drab green blanket, beckoning you to pick it up. As you do so, you see that it is a short goodbye-letter, addressed to you. In it, Eric explains that Rane started fucking him when he wanted, without really asking - something that brought discomfort to the student, still unsure about his trans body and feelings about it all. Worse, Eric writes that he couldn't even start to resist Rane, couldn't bring himself to do it - something he suspects is caused the nanites messing with his head. Since he didn't want to just be the 'available fuck-hole' for a demon and 'lose himself to being a mindless slut', the young man ends with the words that he had to go, leaving the bunker to be 'safe'.";
	now Dexterity of Eric is 6; [Eric's gone!]
	remove Eric from play;

instead of going down from the Grey Abbey Library while (Eric is in Bunker and (HP of Eric is 12 or HP of Eric is 13 or HP of Eric is 14 or HP of Eric is 15) and Dexterity of Eric is 7 and EricFleeingCountdown - turns > 12):
	move player to Bunker;
	if debugactive is 1:
		say "     DEBUG: ERIC RESCUED AFTERMATH - DEXTERITY OF ERIC: [Dexterity of Eric][line break]";
	if HP of Eric < 99:
		project the figure of Eric_face_icon;
	say "     As you come down into the bunker, you see Eric sitting cross-legged on his bed, bent over a book in his lap and looking pretty content and happy - must be a good read. But then, as you walk closer and he spots movement from the corner of his eye, the young man's head whips up in a second and his whole body tenses, only to relax again as he sees it's you. He's still pretty jumpy and nervous it seems, though not quite as much as before he ran off. 'Hey there,' the college athlete says, then gives you a shy smile as you step up next to his bed and continues, 'I guess I should apologize. I never really thanked you for coming after me. Rescuing me again.' Patting his shoulder and giving it a friendly squeeze, you tell him that you didn't do it alone and he should also tell that to Rane. After all, it is highly doubtful that you could have found him in time without the blue oni's help - or fought off a whole pack of hellhounds when you did.";
	say "     'Um,' Eric replies, then bites his lower lip and looks down, eyes wandering over the folds of his crumpled blanket as he thinks. A moment later, he sighs and quietly says, 'I - I guess you're right. He did save me. But before that, he...' The young man falls silent and rubs his arm with one hand nervously, then looks up to you and asks, '...do you - can you - really trust him? He's a demon. Totally wild... with his dick out. I've barely seen him at all since, you know, the hellhounds. But - but he just took me. Before.' With a sigh, you calmly state that while Rane is a very sexual being, he's not really a bad guy - quite civilized compared to most of the non-humans now populating the city. He's got a code of not using violence to compel people for his enjoyment, only coming on to those to return his interest. Admittedly with a furious intensity that springs from his boundless sexual energy, but still - he'd never just hold someone down and violate them.";
	WaitLineBreak;
	say "     Eric's eyes widen a little at your explanation, and he blinks several times. Then a little blush stairs to rise over his fair cheeks, prompting you to pose the question if he did say or do anything that gave Rane the wrong impression. 'I only wanted to take a shower. I was in there with just a towel on, then Rane came in and... introduced himself,' he says, then quietly murmurs, 'Only looked at him a little bit. And he... took off his clothes. Not that he wears much clothing, I mean, that loincloth of his barely covers his dick regardless.' By now, Eric's face is fairly red in embarrassment, and he presses his lips together while his head frantically searches for a way out of this conversation.";
	LineBreak;
	say "     Do you allow Eric an out ([link]Y[as]y[end link]), or do you press the matter, making him talk things out ([link]N[as]n[end link])?";
	if player consents:
		LineBreak;
		say "     Eyes dropping down to the book lying forgotten in the young man's lap, you lift the cover a bit to peek at the title, then chat a bit with him about it. With a thankful sigh, Eric recounts the story of the book so far - a quite exciting adventure story about a group of teenagers trapped in a mysterious, shifting labyrinth filled with monsters. You keep chatting for a while longer, then eventually say your goodbyes and let him get back to reading.";
		say "     [bold type]Something tells you that the topic of Rane is now settled for good in Eric's mind. He'll likely avoid the oni from now on.[roman type]";
		now Dexterity of Eric is 40; [avoids Rane in the future]
	else:
		LineBreak;
		say "     As you calmly tell him to go on, Eric hesitates for a moment longer then gulps visibly and says, 'I admit, I was dumbstruck by pretty much all of him. Standing so close to me. So big. So blue. Like a man, but... demonic too, with those horns. But his face could have passed as a model's, with that long hair of his too. And his muscles. I could work out for a hundred years and not be as built. The look in his eyes was really intense too, taking me in - and then he told me I had dropped my towel.' Cheeks flushed almost as red as his hair, Eric's hands twitch as if to cover himself, and he murmurs, 'Things went so fast after that. He was... so direct, really pressed my buttons. I couldn't - didn't - try to stop him.' Looking into the eyes of the young man and hearing his breath come in a rapid pace, you ask him if he actually wanted to stop Rane. To be honest to himself about whatever he may be feeling, deep inside.";
		say "     A moment of silence stretches out between you, then eventually the young man gives a small nod. 'I guess... yeah, he's attractive and I was - am - interested in him. And the sex was something else. His... his dick actually slid in so well, without much pain, and I could feel those thick veins and bumps on it... I felt so full,' Eric says, but draws a slight grimace as he murmurs, 'If he'd just asked, then...' At that moment, he stops with a gasp and looks past you. Turning around, you see Rane's blue shape standing in the entrance doorway, and then the oni walking towards the two of you. Eric watches in what looks like awe, or fear, or perhaps both, but it's clear his eyes are darting all over Rane's musculature, watching intently as his impressive thigh muscles subtly expand with each mere step. There is a surprisingly thoughtful look on the oni's face, and a glint of remorse in his eyes. Soon getting close, the oni clears his throat and asks, 'May I have a word in private with you, Eric?' It certainly takes you by surprise to hear Rane speak in such a 'formally polite' tone.";
		WaitLineBreak;
		say "     The student goes rather pale and you can see him tense, as if to run away - or at least refuse out of hand. But before he can do so, you put a calming hand on his arm and say that they should talk to each other and that you'll stay close and keep an eye out if that's what he needs from you. 'Thank you,' Eric says with a smile, then looks up at the towering oni who nods to the other side of the room. In silence, they walk over there, then Rane crouches down, putting their heads eye to eye in an attempt to make Eric more comfortable. The two of them talk in hushed tones, but even so you can make out some of the oni's word, his deep voice carrying over. There's something about him wanting to 'make things fair', and Eric feeling safe, him being happy. Eventually, Rane gives the human a playful wink and stands up again, then saunters off towards the entrance and goes back up into the library.";
		say "     Curious how things went, you move over and ask Eric if he's okay. Still looking at the door through which Rane left, lost in thought, he blinks and focuses on you. 'Um - yeah. I think it'll be alright actually. He's...' The young man blushes again, then smiles a little and says, 'I need some air to clear my head. Gonna go for a walk. But thanks for asking.' And with that said, the college athlete moves to the bunker exit with a moderately paced jog, then walks up the stairs.";
		LineBreak;
		say "     Hmm... you can't help but feel there's something Eric didn't tell you. Do you want to go after him and find out what that might be? ";
		if player consents:
			LineBreak;
			say "     Okay, since you're nothing if not curious about the things going on with your trans friend, you walk after Eric. Getting to the stairwell only a few moments after he walked in, you find no trace of Eric - he must have rushed upstairs. As you wouldn't want to appear too nosy - as running after him would look like - you make your way up to the library quickly but slow down at the access door and peek out through the narrow vertical bar of a window in it. No Eric in sight, so you step through and look around for where he might have gone. A quick walk past the many rows of bookshelves yields no sign of him standing between them. Then you go upstairs, thinking he might have gone to talk with Rane some more, but neither of them is there. Hm, maybe outside?";
			say "     Walking to the main library doors, you take a few steps outside, down the flight of stairs to the street level - but the surrounding area lies silent and empty before you. With an annoyed sigh at having lost the trail, you make your way back into the library. You're almost at the bunker access door when suddenly, a deep rumbling groan and a high-pitched moan reaches your ear. You recognize the voices - it's Rane and Eric! Did the oni break his word after all and snatch your friend up to ravage him again? In a quick dash, you move towards where the noise is coming from - the right back corner of the library. The demonic groaning and human moaning continue in a slow tempo guiding you further towards the source - a side room adjoining the corner of the library hall. The sign on the door says, 'Maintenance'. Pulling the leaned-to door open, you look inside and see that things aren't quite as you thought they were.";
			WaitLineBreak;
			say "     What you see in the maintenance room is one of the big couches like in the reading areas throughout the library, and on it Rane and Eric. Both of them are naked and they're intimately engaged - with Eric straddling the big demon, facing him and slowly rocking up and down, while Rane is sitting back into the couch, knees apart and breathing deeply, teeth clenched. A large stain of what guess is coffee explains what the couch is doing in there - but the harder question is why your two friends are fucking on it. Some moaned words that come from Rane a moment later answer it for you. 'See, you're in control now. Feels good, doesn't it?' Eyes focusing on the blue oni, you realize he's leaning back passively, clawed hands gripping the sofa pillows. All the moving is being done by Eric. 'Yeah!' the cuntboy gasps in ecstasy, grinding down on Rane's shaft again, then bracing himself against the big male's chest as he raises himself and slams back down on the hard pole.";
			say "     'Nnnnggh! Fuck! Just a little deeper and I'll be completely inside you. Come on, you can do it little buddy!' Rane grunts, sizzling hot arousal plainly audible in his voice. Eric laughs happily as the large demon cheers him on, then takes a deep breath and lets it out slowly. Using the strength in his legs, Eric raises his hips until the massive cock-head of Rane's thick penis just about pops out, then the college athlete then slams himself down on the blue shaft, letting out a victorious shout as the oni's balls touch his crotch. 'So full,' the young man gasps in satisfaction, running one hand down his belly - perhaps feeling a bit of the demon penis through him - before he starts moving up and down again. Each downward hilt of his body elicits a respective moan from both of them. As the inexperienced Eric tries to get a good rhythm going, Rane keeps prodding his human partner on and on with grunted-out words, complimenting the young man for his tight holes and hot little body, in between some rather crude exclamations like, 'Fuck yeah! Ride me, cuntboy!'";
			project the figure of EricRidingRane_icon;
			say "     As Eric lets himself go more and more, the young man's usual shyness melting away quickly with each new thrust down his hips make, he gets a lore more adventurous and even tries to emulate Rane's dirty talking a bit. 'Your... your cock is so big and feels really good inside. Really... er... fucking good. Damn, you're one fucking hot fucker,' he gasps out as he grinds against Rane's crotch, then gives a loud moan as the oni's shaft nudges an especially sensitive spot. Focusing on the blue demon's face when he can think straight again a few heartbeats later, Eric gives a hopeful smile, as if to ask if he did alright - and Rane gives him a beaming grin and a nod, followed by tousling the young man's hair. It's obvious - at least to you - that he's humoring Eric, even if the cuntboy went a bit overboard in trying out swearwords.";
			say "     The young man's exploration of new things to do sexually doesn't stop at naughty words though - and he sets his hand to explore Rane's body, running them over each muscled bulge and groping him where it counts, worshiping the large oni's flawless physique. He leans forward to kiss Rane's washboard abs, licking over the salty skin and running his tongue up the ridge in the middle, then even goes so far as to pinch his demonic partner's nipples, drawing an aroused grunt from Rane. A happy little gasp from Eric tells you that Rane's cock must have throbbed - hard - inside him at the same time, and the look of bottomless desire in the oni's eyes makes it obvious that he'd really like to pound Eric like a jackhammer right now.";
			WaitLineBreak;
			say "     'Could you ride a little faster, Lil' buddy?' Rane grunts out in between gushing breaths of air, 'Your playing around is fun, and I promised you'd be the boss and on top - but come on! A man's got needs... I want that hot pussy sliding up and down my prick!' You hear the low sound of ripping cloth and realize that Rane's fingers are digging their claw-tips into the sofa cushions - but other than that and a certain tension visible in his arm muscles, the oni still stays passive under Eric. Being such an active sexual being, it really must take a lot of self-control for him to grant Eric dominance in such a moment. Really shows how serious the oni takes his code, and the promises he makes.";
			say "     Meanwhile, Eric stops his movements completely for a second and looks down at Rane, a naughty smirk on his face. With a playful swat on the blue oni's muscled pec, he says, 'Could it be that you don't really like someone else dictating your body and senses? Maybe like a certain someone fucking me in the shower without asking?' The young man punctuates his point by raising his hips, revealing Rane's glistening shaft as he pulls his pussy up its length with an achingly slow move. Eventually, only the cock-head of Rane's erection is inside him, and you can see Eric's nether lips flare out slightly as the young man teasingly pulls against its wider girth. And then - he suddenly plunges down balls deep on the blue rod, gasping in lust and making Rane throw his head back in an aroused roar.";
			WaitLineBreak;
			say "     Panting loudly, Rane looks deep into Eric's eyes, then grudgingly nods. 'I admit that not having a say about your own body can be quite torturous. Look, as I told you - I'm really sorry. Honestly.' His last word his more grunted then said, as Eric slides his tight cunt up his shaft in a quick move that ends with the cock pulled out completely in a wet slurp. As Rane's erection wags back and forth from the sudden pull, finally coming to stand still and proudly erect over his crotch in all its wet and glistening glory, Eric continues leaning forward and forward, bracing himself on the blue oni's muscled pecs, then surprises Rane with a kiss on his lips. After the first quick peck on the demon's lips, Eric somewhat awkwardly sticks his tongue out and pushes it forward, to be received gladly when Rane gets over his shock. With things escalating into a full-on moment of making out, the two of them meet each other's lips again and again, tongues wrestling against each other and eyes meeting as they share their breaths.";
			say "     Eventually, as Eric draws back and both of them catch their breaths, Rane raises an arm and strokes the young man's neck for a second in an uncharacteristically tender gesture. 'That was very sweet, little buddy. I take it I'm forgiven - right, Eric?' Eric smiles innocently and says, 'Maybe' with a teasing tone in his voice, then gives Rane another peck and shimmies down his body again. Looking back over his shoulder, the young man puts a hand on the thick pole of Rane's cock and strokes up and down its length affectionately, then pushes it forward a little to allow him to sink down on it more easily. A satisfied moan in two voices fills their love-nest as Rane's cock-head nudges against the cuntboy's nether lips, then slides in between them. Rane clears his throat and gives Eric a lewd grin, then says, 'Now then - could you go a little faster this time? My balls are just aching for a good nut in such a sexy little cuntboy as yourself. I so wanna fill you up!'";
			WaitLineBreak;
			say "     Now that he and Rane 'made up' properly, Eric is more than agreeable for fulfilling the oni's request and tries to fuck himself faster on the blue rod - but it shows that he's still relatively new to getting fucked in his pussy. He slams himself down hard on the oni's erection again and again, but the good feelings that creates do overwhelm him more often than not - resulting in him slumping forward to pant against Rane's abs or throwing his head back and shouting out moans... both of which result in him slowing down as he comes to grips with feeling a hard cock inside himself. It's clear that Rane gets more than a little frustrated with this, as he doesn't get the hip-slapping pounding he wants even with Eric now agreeable to it - and he actually lets go of his death-grip on the sofa, raising his hands towards Eric's hips.";
			say "     'Hey, no hands!' Eric pants out, still not quite wanting to give up the control he had. 'Fine. As you want little buddy,' Rane replies, a wicked glint in his eye - and with that said, Eric's hips are met by the oni's rising crotch. As the young man gives a needy groan and goes through a forceful bounce up and down on Rane's shaft, the blue demon's hips already move to meet him for another and another in rapid succession. Gasping and moaning, Eric looks left and right, then over his shoulder - realizing with surprise that Rane's hands are still on the sofa. It is the demon's long and powerful legs that are moving as he flexes them, doing ankle raises. On a human those wouldn't give that much action - but given the size and power difference between the two unlikely lovers, it's more than enough to make a wild ride out of Eric's halting grind. 'You said nothing about my legs!' Rane grunts in a lusty, guttural tone, then roars, 'Oh yeah! That's hitting the spot now!'";
			WaitLineBreak;
			say "     The two of them build up to a feverish pace of fucking - making moans, grunts and shouts fill the little room as their sweaty bodies grind against each other. Soon, the massive buildup of sexual energy between the powerful oni and his small but athletic human partner reaches its climax, and in a mutual cry, they reach orgasm at the same time, with Rane's arms now shooting up to hug Eric tight against himself as his cock gushes its virile seed deep into the young man's body. The cuntboy himself is completely lost in the intensity of his climax, just trembling and twitching in Rane's grasp as he rides out the wave of pleasure flooding through his whole being.";
			say "     Before much longer, the groans and moans give way to rapid panting as they catch their breaths, then Eric eventually raises his head from resting on Rane's chest, looking at the blue oni's face. He tries to push himself up to kiss the larger male, but Rane just keeps holding him tight against his body, still impaled on the thick shaft between his legs, instead bending his upper body to meet Eric's lips. They share a long kiss, then Eric gives the oni a happy smile and says, 'Thank you. I really liked riding you. A whole lot. And it's so good to know that I don't have to fear you.' Rane gives the human a little squeeze, then ruffles his hair and replies, 'Just doing what any good man would have. I got to thank you - for making me face that I was out of line before. And of course this breathtaking fuck! This definitely ranks among some of my best cums.'";
			WaitLineBreak;
			say "     Eric laughs as he hears Rane talk, then says, 'You're terrible! So lewd!' Rane retorts, 'Me? I*'m not the one strutting around in those tight pants, swinging that lithe body and bubble butt around, so very inviting. And your scent, it is really sweet...' Eric just rolls his eyes and hits back with, 'What about you, huh? That loincloth is barely covering anything, why wear it at all? And you're the one who is showing off his super muscled body everywhere you go... wait - was that about my scent?' The young man lifts his arm a little and sniffs, then says with a chuckle, 'Man, we're both really sweaty - and reek of sex.' Rane warmly smiles, 'That only makes it even more noticeable. But really - your scent, it's sweet, a nice mingling of feminine roses and masculine spice. Always is, even with you all wrapped up in clothing. You're always in my mind - and nose - when you're up in the library. Laying down the pheromones all over the place.'";
			say "     Tapping his nose with a large finger, Rane winks at Eric, then continues, 'As for my loincloth, it's just right not to burden me in a fight - and well, if you got it, flaunt it. Hah - shows just the right amount of skin while leaving enough to the imagination, and also easy to get in and out of. I do have a great body, isn't that right? Ah, why ask - I know you couldn't keep your hands off it.' Pushing his upper body up from Rane's chest and bracing himself against the oni's pecs, Eric puts on a mock-outraged expression and says, 'Hey! I'm not mister grabby-hands who preys on boys in the shower. You offered!' They keep on with a bit of playful bickering, until they're eventually interrupted by Rane's cock softening far enough to slip out of Eric's hole as the cuntboy is tickled by his oni friend - and a whole lot of cum and female juices gushes out of the trans teen's pussy, splashing all over Rane's crotch, then running between his legs and soaking into the couch.";
			WaitLineBreak;
			say "     Eric looks down in awe at the mess between their bodies, with still more cum dripping out between his still pretty stretched pussy lips. 'Wow. All of that was in me? You're really a beast when it comes to sex.' Rane just gives him a dashing grin, together with a playful growl. 'Oh dear, I think the couch is ruined. No way to clean all that up,' Eric adds a moment later as he checks out the full extent of the cum-stain they created. Letting out a long laugh, Rane gets up, gently helping Eric to his feet as they both survey the 'damage' to the furniture. 'I wouldn't say it's ruined - it's just marked. A memento of the first time my little buddy was in the driver's seat. It's a sturdy couch, perfect to fuck on. This can be 'our spot' for the next time.'";
			say "     The college athlete looks at his oni friend, hands on his hips as he remarks, 'You sound mighty sure that there will be a 'next time'. Rane leans down a bit, pulling Eric close and looking him in the eye, then says, 'Look, I am what I am. I love to fuck. I live to fuck. Simple as that. I admit I got carried away with you the first time...' Eric quickly amends that it was twice. 'Yeah, ok, I messed up those times. But with us making up right here and now - on 'our spot', things are fine between us, right? Why stop with a good thing?' Eric gapes for a second at the boundless self-assurance and trust in his ability to charm Antone's clothes off - then gives a smiling sigh and gives in, caressing Rane's muscled side. The oni grins broadly, 'Hah, third time's the charm, right?'";
			WaitLineBreak;
			say "     Eric looks lost in thought for a bit, while Rane patiently waits for what he'll say. Finally Eric replies, 'If I'm being honest, then all three times felt great. But it was all so new, I mean, first this...' Eric motions down towards his genitals, 'just happened, and I used to have a penis there, and now it's like a girls and I've not used it much. So it felt weird at first when you... 'took me' the first time and you're really big, so it almost kinda hurt. Then I was just worried that you were going to make me one of those - things - outside where all I'd be doing is being your slave. I don't want to be like that. And well, this last time, it felt real good. It's just been so very confusing, with this...' He motions to his genitals. '...and being stalked by monsters and then you. And now - I mean, what are we?'";
			say "     Rane holds up a hand to stop him, 'You're rambling too much. Speak plainly and simple. It works for me.' Eric takes a moment to compose himself and starts, 'So what does this make me? Your boyfriend... uh... girlfriend?' Rane laughs hard, then ruffles Eric's hair and points out, 'Don't take this the wrong way, but I'm not the type. That implies going steady, and well, sorry, that's just not my thing. Besides, I got a feeling about you, I don't think you're the steady type yourself. I'm sure there's a few other guys around whom you'd like to take for a ride too, eh? [if HP of David is 4]Like that military stud? [end if][if Carl is in Grey Abbey 2F]Maybe the soldier doggie? [end if][if Hayato is in Darkened Alcove]My oddly shy big red oni counterpart possibly? He just sits and meditates all day and could definitively use some action to take a load off. I've seen you trying to peek in on him. [end if]";
			WaitLineBreak;
			say "     Eric blushes asks, 'So... we can - you want to do this again? Just like we today? I mean, you won't force me to right?' Rane nods and says, 'Nope... won't have to.' The blue demon winks at Eric and pats him on the head affectionately. 'Like I said, you can ride me anytime, or if you're in the mood for something a bit more 'aggressive' just say the word. Or touch me, that's as good a sign as any if you're too 'tongue-tied'. As Rane picks up his loincloth and is about the tie it around his body with the metal belt, he notices Eric still looking at him. Smiling playfully Rane asks, 'Guess I shouldn't wrap up yet, eh? Want me to pose a little for you?' Eric blushes again, demurely stating that Rane has a really great looking body. 'You mean cock, little buddy. I see what you're peeking at. Hell, don't be ashamed - it's quite an eyeful and you're free to look - and touch. Eric giggles for a second, then bites his lip and stares at Rane's cock.";
			say "     He mumbles, 'I can't believe that whole thing was inside me. I mean... it's soft now, but still looks so imposingly big.' Rane beams at the compliment, moving closer to Eric and closing a hand around his 'little' blue devil, demonstratively jerking it. He takes note that Eric subtly licks his lips - might have been just subconscious, but the oni jumps at it and asks, 'Seems you want a taste?' This snaps Eric out of standing there and giving the big cock a deer in the headlights stare. He politely declines, stating, 'I couldn't! There's no way I could open my mouth wide enough.' The young man blushes brightly as Rane remarks, 'Oh? So you've been giving it some thought already?' Before Eric can get too wide-eyed at his non-admission, Rane lets him off the hook by saying, 'Hate to say it, but you really did drain my balls good. Wasn't kidding about that being one of the best cums I've ever had, usually would have to go at least twice if I was wanting to really bust my whole nut.'";
			WaitLineBreak;
			say "     Both sets of eyes turn back towards the mess on the furniture with Rane sporting a pleased look while Eric looking in wonder likely still trying to figure out how he was able to fit it all inside him. 'And, I'd say we've something to look forward to.' Startling Eric by again quickly doing something to throw him off guard, he leans down and gives the redhead a chaste kiss on the cheek, before quickly throwing on his loincloth and leaving the room. He does so too quickly for you to get to any hiding spot, so the oni passes by your position, simply giving you a knowing smile as he walks off. Eric lingers in the room a bit longer, lost in thought before pulling on his own clothes and also departing the room. With him, you're fast enough to dodge behind a nearby shelf, leaving him blissfully unaware that you watched their coupling.";
		else:
			LineBreak;
			say "     Nah, you let him have some privacy for once and turn your attention to other things.";
		now Dexterity of Eric is 8; [Eric and Rane Talked]
	now lastRaneEricInteraction is turns;

instead of going down from the Grey Abbey Library while (Eric is in Bunker and (HP of Eric is 12 or HP of Eric is 13 or HP of Eric is 14 or HP of Eric is 15) and (Dexterity of Eric is 8 or Dexterity of Eric is 9)):
	move player to Bunker;
	if debugactive is 1:
		say "     DEBUG: ERIC POST MAKE-UP SEX WITH RANE - CHAT - DEXTERITY OF ERIC: [Dexterity of Eric][line break]";
	if HP of Eric < 99:
		project the figure of Eric_face_icon;
	say "     As you come down into the bunker, you see Eric sitting cross-legged on a nearby bunk, a book in hand. He looks up, having noticed your arrival, and with a smile on his face the young man sets down his reading and walks up to you. 'Hey there and welcome back,' the red-headed student says, then puts a hand on your shoulder and gives you a friendly squeeze. 'I wanted to say again how thankful I am for everything you've done for me. Letting me stay with you down here and... other things. Never really knew quite how rough the city now is - before running into those hellhounds.' You chat a little and Eric clearly shows pretty good spirits, as well as newfound enthusiasm at the living arrangements and mixed company in the bunker and library.";
	say "     Wanting to hear how things now stand between him and Rane, you ask - and the young man blushes slightly before answering. 'Rane - um. He's... we've come to an understanding, things are alright now.' Becoming tongue-tied and shy about the matter, you focus your gaze on Eric - but you can't detect any sense of fear or sadness in him, as he was when he ran off. ";
	let bonus be (( the Perception of the player minus 10 ) divided by 2);
	let diceroll be a random number from 1 to 20;
	increase diceroll by bonus;
	if diceroll > 10:
		LineBreak;
		say "     (Perception-Check Success) Instead, the college athlete shows faint hints of arousal - the slight quickening of his breathing, a blush on his cheeks, even his hand unconsciously rubbing against the side of his hip. Looks like Eric's taken a shine to the blue demon. Interested as you are in such matters, you grin and ask for more details. Eric only hesitates for a slight moment and bites his lip, then says, 'Okay, I guess if there's anyone I can talk about it with it's you, hah. I - we - had sex. Not like before, you know - I decided I wanted to... spend some time with him. Rane told me earnestly that he was sorry, you see. He promised he'd never push me so hard and... well, he said there should be 'payback'. With me having all the control.'";
		WaitLineBreak;
		say "     Eric blushes and a shy smile spreads on his lips, then he explains, 'I just wanted to know... had to know... if it was just the nanites messing with my head, putting thoughts of submitting to sex in there each time Rane fucked me. If the good feelings were all a lie, made up. I thought so after he took me, at first. But... he's really good-looking, isn't he?' The young man waves his hands a little, miming at bulging muscles over his arms and towards his own abs - well-defined, but a bare shadow beside Rane's ripped chest. 'Being honest with myself, I had to admit that his giant blue penis felt really good inside me, so I took the chance when he offered. Went after him.'";
		say "     Taking a deep breath, Eric suddenly bursts out with, 'It's all true... he held his word, let me be the top. And I liked it! It was amazing!' Then his brow scrunches up a little and the young man asks, 'Oh wait - is that the right term?' He mimes a hole being penetrated with his hands, then explains, 'I don't mean I fucked him. I obviously don't have... you know... anymore. But... he let me sit in his lab and I just... moved... up and down... and it felt really good... and I didn't want it to stop, ever. Through it all, he controlled himself, didn't lay a hand on me - but you should have heard the sounds Rane was making. Kinda scary... but it was kinda hot too... that I was almost in control of this big demon's pleasure... and then he screamed loudly and I felt his load fill me up so much. I - I don't think I've ever come so hard as I did right then. It was insanely hot sex - and then we just talked a bit after that.'";
		WaitLineBreak;
		say "     Almost as if coming out of a trance, Eric lets the last words of the lurid story he confessed ring out, blushing almost as red as his hair as he realizes that he laid it all bare to you. Quickly, before he clamps up again, you ruffle his hair and give him a pat in camaraderie on the back, then tell him he should never be ashamed about himself - if he likes having sex with Rane, he should own it and be proud. Be 'the man who topped the blue demon' - something various other people will be envious about. After all, Rane showed he can be trusted, so all Eric has to fear... is being sore from being fucked so very hard.";
		say "     The young man chuckles at your words, then clears his throat and adds, 'Yeah... I actually was having a little trouble walking after the last time. I never imagined I could have taken something so big inside me...' he trails off again, lost in thought, then regains his composure a short while later and continues, 'It's funny but, I thought I would miss... being a guy... more, and I did at first. But now... I'm not sure. What I felt with Rane was the biggest pleasure of my life.' A smile on your face, you tell the trans-gender teen that he'll have many more opportunities like that. With Rane and others - he just has to be open for it. The two of you chat for a little while longer, then you eventually leave him to go back to his bed, lying down with the book - but not really reading, instead daydreaming about a large blue-skinned hunk taking him for a ride on his thick pole.";
	else:
		say "Seems like things smoothed out nicely and the problem he had with Rane is over. You exchange some more words, then let him get back to his book.";
	if Dexterity of Eric is 8:
		now Dexterity of Eric is 10;
	else if Dexterity of Eric is 9:
		now Dexterity of Eric is 11;
	now lastRaneEricInteraction is turns;

instead of navigating Grey Abbey Library while (Eric is in Bunker and (HP of Eric is 12 or HP of Eric is 13 or HP of Eric is 14 or HP of Eric is 15) and (Dexterity of Eric > 7 and Dexterity of Eric < 40) and Rane is in Sitting Area and lastRaneEricInteraction - turns > 8 and a random chance of 1 in 4 succeeds):
	say "[NavCheck Grey Abbey Library]";
	if NavCheckReturn is false, stop the action;
	move player to Grey Abbey Library;
	if debugactive is 1:
		say "     DEBUG: ERIC RANE FUCK WALKIN - DEXTERITY OF ERIC: [Dexterity of Eric][line break]";
	say "     Coming back into the library, you instantly hear that something is up - as moans, grunts and the slapping noises of flesh on flesh echo through the large main chamber - a bit muffled, but still audible. Someone is having sex - and a real pounding too, from the sounds of it. A moment later, the question of who's doing the fucking is answered, as you can hear Rane bellow, 'Yeah! That's one sweet boy-pussy you got here. Take my dick!' A loud slap, coupled with a lust-filled groan follows - doubtlessly the blue oni hammered his shaft in again right then.";
	say "     Do you want to go and check out what's going on with your own eyes? ";
	if player consents:
		if a random chance of 1 in 2 succeeds: [Eric Butt-Fucked]
			LineBreak;
			say "     Following the noise, your steps lead you to a side room adjoining the corner of the library hall. The sign on the door says, 'Maintenance'. Pulling the leaned-to door open quietly, you look inside and are treated to full-on view of the oni and transgender teen, both of them naked and engaged in making use of one of the big couches like out in the reading areas throughout the library. Seems like it was brought here after acquiring a large coffee stain from a careless library visitor and has since has become Eric and Rane's 'spot' for sexy times - as indicated by the quite large cum-stain on it too. The tall blue oni is standing with his legs bent a bit to put his crotch at just the right height to fuck Eric's ass with deep thrusts, as the young man stands bent forward over the backrest of the sofa. Eric is holding on for dear life as the thick shaft pounds into his ass, gripping the sofa cover with white-knuckled intensity as he moans loudly, whimpering in arousal with each thrust into his back passage.";
			say "     Then suddenly, Rane slows down his gyrations and grabs the transgendered teenager by the hair - pulling him up to lick the side of his neck, which draws a pleased sigh from Eric. 'You like my hard cock, don't you? Tell me!' the blue-skinned demon says to his partner in a husky tone, to be immediately answered by an almost screamed, 'YES! You feel so good in my ass! Please, keep fucking me! More!' Now that they're not moving so much, you see that the young man's ass somewhat reddened from the relentless pounding, but it is clear that he likes being treated a bit roughly by the muscled oni. Laughing out loud, Rane starts grinding against Eric once more and says, 'I'm still not decided which hole is better. You're feeling pretty well around my dick on both ends. Guess I'll have to try both out a few more times.' The only reply from Eric is a very enthusiastic and urgent moan as Rane bottoms out again, followed by more gasps and aroused grunts.";
			WaitLineBreak;
			say "     Still standing where you are at the door, you watch as the muscled oni fucks Eric good - with a furious intensity and all the while going on with dirty talking about how good his 'sexy little bitch, slut, cuntboy, fuck-hole or stud' feels to be in. Over time, the blue-skinned giant's breaths become hoarse and come out in ragged growls and he manages to blurt out 'OH FUCK! I'M GOING TO CUM', racing to a tempo of pistoning his hips against Eric's gyrating ass with inhuman speed. Finally he gives a hoarse bellowing roar and drives himself all the way into Eric with one last thrust, then holds the young man tight by the hips as is asshole is flooded with Rane's virile load, the blue demon's leg and ass muscles tensing and flexing with each massive spurt of cum.";
			say "     Rane stays balls-deep inside Eric for several long moments, bent over the young man and catching his breath as he rests. Then he eventually straightens again, looking down on the smaller human and stroking down his back. 'I'm so glad I came here. Who'd have thought a library would hold such pleasurable delights as your sexy ass. And pussy...' With that, the oni pulls his thick cock out of Eric, accompanied by a little gush of cum that only stops when his pucker closes in a hurry. Before Rane's erection can go down, he rubs it up against Eric's nether lips, making the young student gasp in lust once more. 'Hah, you're so very wet, Eric. I could almost just slide in right now and keep fucking you for a second round,' Rane remarks, but then shrugs and steps back from the sofa. 'But no - don't wanna fuck you sore, eh? So - how about a nice shower next? Come on, let's go downstairs...'";
			WaitLineBreak;
			say "     With that said, Rane starts to walk towards the only exit out of the room, his belt and loincloth in hand and with the half-hard cock between his legs dangling from side to side, still dripping cum. As he does so, the oni spots you and his eyes flash in amusement, a grin spreading over his face at having been watched. Meanwhile, Eric remains unaware of your presence and you can see him blanch a little at the thought of just wandering through the public library naked, sweaty and cum-splattered - as Rane is about to do. 'I - em, I'll catch up,' the young man says in a hurry, then snatches up a towel and some wet-wipes and begins to make himself presentable at least a little bit. Rane turns to watch the athletic student bend over and licks his lips at the sexy sight, then says, 'Sure thing, I'll make sure to save some hot water for you. See ya in a bit, sweet-cheeks.' Ducking out of sight before Eric can spot you after all, you direct your attention to the hunk of an oni, feasting your eyes on his nakedness as he moves to the bunker access door. A few minutes later, Eric follows, still rather sweaty but dressed now - one could think he did some exercise instead of a sex session with a demon hunk.";
			increase EricAnalCounter by 1;
		else: [Eric pussy-fucked]
			LineBreak;
			say "     Following the noise, your steps lead you to a side room adjoining the corner of the library hall. The sign on the door says, 'Maintenance'. Pulling the leaned-to door open quietly, you look inside and are treated to full-on view of the oni and transgender teen, both of them naked and engaged in making use of one of the big couches like out in the reading areas throughout the library. Seems like it was brought here after acquiring a large coffee stain from a careless library visitor and has since has become Eric and Rane's 'spot' for sexy times - as indicated by the quite large cum-stain on it too. The tall blue oni is fully naked and kneeling down, putting his crotch at just the right height to fuck Eric's pussy with deep thrusts, as the young trans-man lies stretched-out on the comfortable-looking sofa. Eric is holding on for dear life, hands grasping the cushions with white-knuckled intensity as the thick shaft pounds into his tight pussy, whimpering in arousal with each new thrust.";
			say "     Then suddenly, Rane slows down his gyrations and grabs the transgendered teenager by the back of his neck - pulling him up to give him a demanding kiss. As their lips part again, the blue-skinned demon says to his partner in a husky tone, 'You like my hard cock, don't you? Tell me!' Almost immediately, Eric calls out his reply, 'YES! You feel so good in my pussy! Please, keep fucking me! More!' Now that they're not moving so much, you see that the young man's crotch somewhat reddened from the relentless pounding, but it is clear that he likes being treated a bit roughly by the muscled oni. Laughing out loud, Rane starts grinding against Eric once more and says, 'I'm still not decided which hole is better. You're feeling pretty well around my dick on both ends. Guess I'll have to try both out a few more times.' The only reply from Eric is a very enthusiastic and urgent moan as Rane bottoms out again, followed by more gasps and aroused grunts.";
			WaitLineBreak;
			say "     Still standing where you are at the door, you watch as the muscled oni fucks Eric good - with a furious intensity and all the while going on with dirty talking about how good his 'sexy little bitch, slut, cuntboy, fuck-hole or stud' feels to be in. Over time, the blue-skinned giant's breaths become hoarse and come out in ragged growls and he manages to blurt out 'OH FUCK! I'M GOING TO CUM', racing to a tempo of pistoning his hips against Eric's gyrating crotch with inhuman speed. Finally he gives a hoarse bellowing roar and drives himself all the way into Eric with one last thrust, then holds the young man tight by the hips as is womb is flooded with Rane's virile load, the blue demon's leg and ass muscles tensing and flexing with each massive spurt of cum.";
			say "     Rane stays balls-deep inside Eric for several long moments, bent over the young man and catching his breath as he rests. Then he eventually straightens again, looking down on the smaller human and stroking down his slender front. 'I'm so glad I came here. Who'd have thought a library would hold such pleasurable delights as your pussy. And that sexy ass...' With that, the oni pulls his thick cock out of Eric, accompanied by a gush of cum from between his gaping nether lips. Before Rane's erection can go down, he rubs it up against Eric's bared pucker, making the young student gasp in lust once more. 'Hah, with my cum trickling down over that sexy hole, your ass sure looks inviting too Eric. I could almost just slide in right now and keep fucking you for a second round,' Rane remarks, but then shrugs and gets up to stand in front of the sofa. 'But no - don't wanna fuck you sore, eh? So - how about a nice shower next? Come on, let's go downstairs...'";
			WaitLineBreak;
			say "     With that said, Rane starts to walk towards the only exit out of the room, his belt and loincloth in hand and with the half-hard cock between his legs dangling from side to side, still dripping cum. As he does so, the oni spots you and his eyes flash in amusement, a grin spreading over his face at having been watched. Meanwhile, Eric remains unaware of your presence and you can see him blanch a little at the thought of just wandering through the public library naked, sweaty and cum-splattered - as Rane is about to do. 'I - em, I'll catch up,' the young man says in a hurry, then snatches up a towel and some wet-wipes and begins to make himself presentable at least a little bit. Rane turns to watch the athletic student bend over and licks his lips at the sexy sight, then says, 'Sure thing, I'll make sure to save some hot water for you. See ya in a bit, sweet-cheeks.' Ducking out of sight before Eric can spot you after all, you direct your attention to the hunk of an oni, feasting your eyes on his nakedness as he moves to the bunker access door. A few minutes later, Eric follows, still rather sweaty but dressed now - one could think he did some exercise instead of a sex session with a demon hunk.";
	else:
		LineBreak;
		say "     Nah, sounds like they're having fun and you don't wanna butt in. Also, you got other things you really should be doing...";
	now lastRaneEricInteraction is turns;

[ CarlEricInteraction                                                ]
[   0: not met                                                       ]
[   1: ran into each other in the library                            ]
[   2: Jogged together & Talked                                      ]
[   3: Talked about being a dog & being a cboy (if Eric is one)      ]
[   4: Did sit-ups together                                          ]
[   5: Carl got the go-ahead from the player for a move on Eric      ]
[   6: Carl fucked Eric                                              ]
[  50: player told Carl to stop pursuing Eric                        ]

instead of going up from Bunker while (Eric is in Bunker and Carl is in Grey Abbey 2F and CarlEricInteraction is 0):
	move player to Grey Abbey Library;
	if debugactive is 1:
		say "     DEBUG: ERIC MEETS CARL - CHAT - CarlEricInteraction: [CarlEricInteraction]";
	say "[EricMeetsCarl]";

instead of navigating Grey Abbey Library while (Eric is in Bunker and Carl is in Grey Abbey 2F and CarlEricInteraction is 0):
	say "[NavCheck Grey Abbey Library]";
	if NavCheckReturn is false, stop the action;
	move player to Grey Abbey Library;
	if debugactive is 1:
		say "     DEBUG: ERIC MEETS CARL - CHAT - CarlEricInteraction: [CarlEricInteraction]";
	say "[EricMeetsCarl]";

to say EricMeetsCarl:
	say "     Coming into the library, you're just in time to see Carl and Eric meet each other. Having jogged his usual circuit through the outermost rows of bookshelves, the anthro husky comes out behind a shelf with 'true crime' stories and turns the corner - only to slow down as he sees Eric sit cross-legged on a sofa just a few steps ahead of him. Human and canine eyes meet as the two of them look at each other and Carl immediately breaks out his friendliest smile, stepping up as he says, 'Hey there, nice to meet you.' The soldier offers Eric his paw-hand to shake, introducing himself as Eric accepts it. Soon, the two of them are sitting on the sofa together and are having a friendly conversation. They seem to understand one another fairly well, two young guys in the midst of all this chaos.";
	now CarlEricInteraction is 1;
	now lastCarlEricInteraction is turns;

instead of going up from Bunker while (Eric is in Bunker and Carl is in Grey Abbey 2F and CarlEricInteraction > 0 and CarlEricInteraction < 5  and (lastCarlEricInteraction - turns > 6)):
	move player to Grey Abbey Library;
	if CarlEricInteraction is 1:
		if debugactive is 1:
			say "     DEBUG: ERIC & CARL SPEND TIME TOGETHER 1 - CarlEricInteraction: [CarlEricInteraction]";
		say "[EricCarlScene1]";
	else if CarlEricInteraction is 2:
		if debugactive is 1:
			say "     DEBUG: ERIC & CARL SPEND TIME TOGETHER 2 - CarlEricInteraction: [CarlEricInteraction]";
		say "[EricCarlScene2]";
	else if CarlEricInteraction is 3:
		if debugactive is 1:
			say "     DEBUG: ERIC & CARL SPEND TIME TOGETHER 3 - CarlEricInteraction: [CarlEricInteraction]";
		say "[EricCarlScene3]";
	else if CarlEricInteraction is 4:
		if debugactive is 1:
			say "     DEBUG: ERIC & CARL SPEND TIME TOGETHER 3 - CarlEricInteraction: [CarlEricInteraction]";
		say "[EricCarlScene4]";

instead of navigating Grey Abbey Library while (Eric is in Bunker and Carl is in Grey Abbey 2F and CarlEricInteraction > 0 and CarlEricInteraction < 5 and (lastCarlEricInteraction - turns > 6)):
	say "[NavCheck Grey Abbey Library]";
	if NavCheckReturn is false, stop the action;
	move player to Grey Abbey Library;
	if CarlEricInteraction is 1:
		if debugactive is 1:
			say "     DEBUG: ERIC & CARL SPEND TIME TOGETHER 1 - CarlEricInteraction: [CarlEricInteraction]";
		say "[EricCarlScene1]";
	else if CarlEricInteraction is 2:
		if debugactive is 1:
			say "     DEBUG: ERIC & CARL SPEND TIME TOGETHER 2 - CarlEricInteraction: [CarlEricInteraction]";
		say "[EricCarlScene2]";
	else if CarlEricInteraction is 3:
		if debugactive is 1:
			say "     DEBUG: ERIC & CARL SPEND TIME TOGETHER 3 - CarlEricInteraction: [CarlEricInteraction]";
		say "[EricCarlScene3]";
	else if CarlEricInteraction is 4:
		if debugactive is 1:
			say "     DEBUG: ERIC & CARL SPEND TIME TOGETHER 4 - CarlEricInteraction: [CarlEricInteraction]";
		say "[EricCarlScene4]";

instead of navigating Grey Abbey Library while (Eric is in Bunker and Carl is in Grey Abbey 2F and CarlEricInteraction > 4 and CarlEricInteraction < 50 and (lastfuck of Carl - turns) > 4 and (lastCarlEricInteraction - turns > 6) and HP of Eric > 0 and HP of Eric < 21 and a random chance of 1 in 4 succeeds):
	say "[NavCheck Grey Abbey Library]";
	if NavCheckReturn is false, stop the action;
	move player to Grey Abbey Library;
	if CarlEricInteraction is 5: [first time]
		if debugactive is 1:
			say "     DEBUG: ERIC & CARL FUCK - FIRST TIME - CarlEricInteraction: [CarlEricInteraction]";
		say "[EricCarlScene5]";
	else if CarlEricInteraction is 6: [repeats]
		if debugactive is 1:
			say "     DEBUG: ERIC & CARL FUCK - REPEAT - CarlEricInteraction: [CarlEricInteraction]";
		say "[EricCarlScene6]";

to say EricCarlScene1:
	say "     Coming into the library, you see Eric and Carl finish up a round of jogging together, both of them a bit sweaty as they sprint the last few meters and Eric beats the husky soldier to the end of the bookshelf - barely, but still ahead. Carl pants visibly with his tongue hanging out as any canine is wont to do and Eric pats him on the shoulder in a friendly way. 'Good run. It's great to have someone to train with again,' the college student tells his companion, who wags his tail exuberantly and gives a happy bark. 'Right back at ya, Eric. But you have to tell me - where did you learn to run like that? I mean - being in the army, I'm no slouch, but you really gave me a run for my money... and won, in the end.' As he says that, the muscular soldier looks Eric up and down and gives him an acknowledging nod.";
	say "     Eric is far from the same strength as him, but you can clearly see how his leaner, less bulky frame would be a boon in sprinting. The young man blushes a bit at the praise and rubs the back of his neck. 'Well, I've always liked running and got into college on a track scholarship. And then there's Sirocco of course,' Eric explains, causing Carl to give him a questioning look with a raised eyebrow. 'Ah, Sirocco is my dog back home. He's a Saluki. You should see him run! I always loved having larger dogs, ever since I was a kid. Anyways, taking him out for a walk always ended up being a sprint, after a while. And so here I am - promising track-runner, college student... and just as lost as anyone here is, with those nanites spread through the whole city.'";
	say "     Having closed the gap between them while Eric talked of his dog, Carl puts an arm around his shoulder and gives the young man a gentle squeeze. 'Don't worry, things will work out in the end. Trust in the army, by now there even are immunity boosters against the infection. I bet once there's enough of those stockpiled or the recipe has been perfected, the cavalry will move in to sort it all out.' The two of then walk off after that, still in friendly conversation...";
	now CarlEricInteraction is 2;
	now lastCarlEricInteraction is turns;

to say EricCarlScene2:
	say "     Coming into the library, you see Carl and Eric sitting on one of the bigger sofas, hanging out together. They seem pretty comfortable with one another, having spent a bit of time here in the library by now. As you unobtrusively stroll closer to hear what they're talking about, Eric clears his throat and asks, 'So... what's it like being a dog?' Carl looks at him and opens his mouth to pant demonstratively, then licks the side of his muzzle with his long tongue before giving an amused snort. 'Oh, the funny thing is that you don't really feel all that different for the most part. Or maybe the nanites adjusted my memories - make everything seem like it has always been like that. You know... like when you decide to wiggle your ears and then you just do? It's like that, just with some different shapes...'";
	say "     The husky flicks a pointed ear, then stands up and steps pretty close in front of Eric, turning to present his rear. 'The tail was the hardest thing to master,' he explains. 'It is on something like an autopilot, reacting and doing its own thing. But if I concentrate, I can do something like THIS.' And with that, Carl grins over his shoulder, stretching his swishing appendage to tickle Eric's nose. The young man calls out, 'Hey' and catches Carl's tail in both his hands. 'Hah, you got me,' the husky soldier tells him and ceases movement with his appendage, then gives a happy grin to his buddy. 'Overall, I like it. Not the transformation back when - that was... unpleasant. But being as I am right now... that's fine and dandy.'";
	WaitLineBreak;
	if HP of Eric > 0 and HP of Eric < 21: [cboy Eric - either committed to it or still hoping for a 'cure']
		say "     Then Carl asks, 'So - how about yourself? Can't have been easy to find yourself playing for the other team so suddenly.' Shocked at the direction of this sudden question, Eric goes white in the face and flinches back a bit - though with his hands reflexively tightening their grip on Carl's tail, that just leads to him pulling the husky with him, falling on top of the student with a pained whine. 'Ouch!', 'Sorry,' 'Oh shit, no I'M sorry,' the two of them exchange words as they're in a tangle of limbs on the sofa, until Carl pushes himself up to half-lean over Eric and puts a hand on the young man's shoulder. 'Hey, hey - calm down. I'm sorry. Really didn't mean to bring up bad memories. Me and my big mouth - damn,' the soldier brings out apologetically and Eric actually relaxes somewhat.";
		say "     The young man takes a deep breath and raises a hand to pat Carl's muscled arm lightly while saying, 'It's not that, really. Nothing raped me to... become like this, and it didn't hurt or anything. Just... how do you KNOW? I'm a guy. And look like a guy...' He looks down over his body, as if frightful that he might see womanly curves and to big breasts pushing out from under his chest - but there's nothing like that, just the lean body of a male athlete. Carl replies, somewhat sheepishly, 'Um... you do, yes. No worries about your looks. The thing is though - one of these is hard to fool...' With that said, the canine soldier strokes the side of his long muzzle, then pats his nose at the tip with a finger. 'I'm sorry to tell you this, if you wanted to... keep things under wraps, but... people with more acute senses than a normal human will gonna know. There's a trace of your scent, but more masculine, on your clothes, but you yourself smell like a young woman.' Eric's eyes go wide at the revelation and he lets out a 'Well, fuck!' Then he slumps down on the sofa defeatedly.";
		WaitLineBreak;
		say "     Carl sits down on the sofa next to his human friend and pats him on the shoulder supportively. 'Come on, it's not that bad. Sure, you've changed as have most people in this city, but you're still - you know, human. I feel great about being a husky, but who knows how dicey things will be when we get out of here eventually? Imagine the stupid dog-jokes and whatnot else that are in store for me and the other canines. And I won't even mention the... weirder body shapes out there.' Lifting the arm thrown over his face, Eric looks up at Carl with a thoughtful expression, then gives a slow nod. 'Um, yeah. I - I hadn't thought about that,' he says in an apologetic tone, then turns his head to look down over himself. Carl leans over to catch the young man's gaze again, wanting to keep him from clamming up.";
		say "     The canine soldier says, 'No worries, it's natural to think of oneself first. But really - look at it from another perspective. You're still a quite handsome dude with normal looks. And as for what's in your pants - it's your decision to hide it, or accept it - and you can tell anyone who disses you about it to fuck off. Plus... I think the whole gender thing is gonna get blown wide open anyways, you're far from the only one who experienced something like this. You should see how many herms are running around in the streets out there.' It is clear from his expression that Carl got through to Eric, as the student runs a hand over his face and rubs his eyes, then takes a deep breath as he sits up. 'Okay okay - you're right,' the young man finally admits. After a few more moments of silence, Carl starts to ask him about college basketball, wanting to put the sensitive topic to rest for now.";
	now CarlEricInteraction is 3;
	now lastCarlEricInteraction is turns;

to say EricCarlScene3:
	project the figure of Carl_Eric_training_icon;
	say "     Coming into the library, you see Carl and Eric on the ground together, with the husky soldier holding the young man's shins tightly as Eric does sit-ups. 'Come on! Give me 5 more. Thirty-one, -two, three, four, and five. You made it, tiger!' the anthro husky cheers on his friend, clapping a hand on Eric's shoulder and giving it a squeeze. The red-headed college athlete just smiles back at him, panting a little. 'We'll keep at it and have you fill out a bit in no time, I'm sure. Running isn't everything, and if you build up your upper body like those legs of yours, you'll be able to hold off anything with that bat you keep handy. Okay, my turn now!' Carl says, then switches positions with Eric and gets on his back. As the young man grasps his legs just above the paws, the soldier starts doing sit-ups, one after another.";
	say "     Looks like the two of them really hit things off and have become fast friends since they met each other. Sometimes adversity can lead to good things too. After watching a few moments, you decide to leave them to their training and turn your attention to other things again.";
	now CarlEricInteraction is 4;
	now lastCarlEricInteraction is turns;

to say EricCarlScene4:
	say "     Coming into the library, you see Carl and Eric do another stint of jogging together, coming out of the long rows of shelves side by side in casual conversation as they go along. Seeing you as they reach the end of their run, the human and husky wave in greeting, then Carl tells his friend with a smile, 'Nice workout. I'm so glad to have someone to hang out with.' Eric gives him a beaming grin and replies, 'Right back at you. Always a pleasure Carl.' And with that, the young man says he wants to cool down a bit and read, then starts walking to the bunker entrance door. The canine soldier gives you a sidelong glance that tells you he wants to talk, but you notice his eyes barely leave Eric's backside. He is checking the young man out as he walks away, tail wagging excitedly as he clearly likes what he sees.";
	project the figure of Carl_face_icon;
	if HP of Carl < 11: [regular Carl]
		say "     By the time you've walked over to Carl, Eric is through the bunker door and on his way down, leaving your resident soldier to turn to you. 'He's quite something, isn't he?' Carl says distractedly with a last glance at the door as it closes slowly on its own. It is clear that he doesn't really expect an answer, and he shakes off whatever thought was in his mind a second later, then turns his whole attention to you. 'Hey there, I wanted to ask you something. With you kinda being the landlord here, giving me a place to stay in all this chaos... would you be okay with it if I had some fun with... someone? Just hypothetically, you know. Don't worry, I don't plan to build a husky harem.'";
		LineBreak;
		say "     It is fairly clear who he's eluding to. What's your reply?";
		say "     ([link]Y[as]y[end link]) - Of course you're okay with it. It's not like you're a demanding overseer who wants to control every last thing that goes on in here.";
		say "     ([link]N[as]n[end link]) - Yes, actually. He really should focus on holding watch from his window above and keep his dick in his pants.";
		if player consents:
			LineBreak;
			say "     Giving a friendly punch to the muscular soldier's shoulder, you tell Carl that it's all fine by you. A bit of friendly fun-time will help keep everyone's spirits up. Still, he should watch out for anything that seems a bit 'too wild' - you don't want to lose anyone to the mental effects of the nanite infection. The anthro husky gives you a nod and a smile, then walks off towards the stairs to the upper level, his tail wagging behind him all the time. Seems like he's definitively looking forward to something now...";
			now CarlEricInteraction is 5;
		else:
			LineBreak;
			say "     Reaching out to give the muscular soldier's shoulder a firm squeeze, you put on a serious expression and tell him that he should focus on his duty. Some of the people in the city are hanging on to their humanity by the barest thread, and it'd be bad to have someone succumb right here in the library. It is easily visible how disappointed the man his - from his drooping tail and flopping-down ears to a little grimace on his muzzle, but he accepts your decision nonetheless. With a nod, he trots off towards the stairs and makes his way to the upper story of the library.";
			now CarlEricInteraction is 50;
	else if HP of Carl is 30: [subby Carl]
		say "     By the time you've walked over to Carl, Eric is through the bunker door and on his way down, leaving your resident soldier to turn to you. 'He's quite something, isn't he?' Carl says distractedly with a last glance at the door as it closes slowly on its own. Then a visible change goes through Carl as he remembers your status over him - lowering his head submissively, the anthro husky turns to you. 'Alpha, I wanted to ask you something. With you giving me a place to stay in all this chaos and being my pack-leader... would you be okay with it if I had some fun with... someone? Just hypothetically, you know.'";
		LineBreak;
		say "     It is fairly clear who he's eluding to. What's your reply?";
		say "     ([link]Y[as]y[end link]) - Of course you're okay with it. It's not like you're a demanding overseer who wants to control every last thing that goes on in here.";
		say "     ([link]N[as]n[end link]) - Yes, actually. He really should focus on holding watch from his window above and keep his dick in his pants.";
		if player consents:
			LineBreak;
			say "     Reaching out to raise Carl's muzzle so he can look you in the eye, you tell him it's all fine by you. A bit of friendly fun-time will help keep everyone's spirits up. Still, he should watch out for anything that seems a bit 'too wild' and remember his place. The anthro husky gives you a nod and a smile, then walks off towards the stairs to the upper level, his tail wagging behind him all the time. Seems like he's definitively looking forward to something now...";
			now CarlEricInteraction is 5;
		else:
			LineBreak;
			say "     Reaching out to raise Carl's muzzle so he can look you in the eye, you give a definite shake of your head and tell him to forget about it. You're his alpha, so it is his job to obey you - and you don't want him humping Eric right now. It is easily visible how disappointed the man his - from his drooping tail and flopping-down ears to a little grimace on his muzzle, but he accepts your decision nonetheless. With a nod, he trots off towards the stairs and makes his way to the upper story of the library.";
			now CarlEricInteraction is 50;
	else:
		say "     ERROR - Carl isn't in the state he should be in. Please report this on the FS forum and quote the HP of Carl: [HP of Carl]";
	now lastCarlEricInteraction is turns;

to say EricCarlScene5:
	say "     Coming into the library, you see Carl and Eric sitting together on one of the bigger sofas, hanging out together. The canine soldier is just telling a story with some enthusiasm, loud enough for you to overhear, '...so there I was in the all night diner at 3 AM, and she was leaning forward over the table, showing off quite a rack. So when the question came what I wanted, I looked around the totally empty place and gave her a wink, asking for the house special. One of the hottest blowjobs I ever got.' Eric chuckles at the rapid wagging of Carl's tail, then nods to the soldier's crotch, where a quite obvious bulge is tenting out his pants. 'Must have been quite a waitress, if you're that boned up from just remembering her.' Carl gives a confirming grunt, then glances over at Eric and licks the side of his muzzle with his long tongue. 'You know, she was smoking hot - and we were right there at a glass-fronted diner, but... there's another reason for THIS,' Carl replies, rubbing a hand over his bulge. 'We've been trading naughty stories for a bit now, and... I can tell how wet you are.'";
	say "     Eric's eyes go wide and he opens his mouth as if to say something, but Carl just pushes ahead, leaning in towards his friend. You can see the husky's nostrils flare as he sniffs the air close to Eric and smiles. Then Carl says in a warm and charming voice, 'Don't worry, it's alright - you just gotta remember there's no hiding things from a canine. Makes things much easier, don't you think? I know you're horny, you know I am too, obviously. So... wanna show me just - how much - you like big dogs?' The anthro husky underlines his offer by getting a bit closer still, with the tip of his muzzle brushing against the side of Eric's neck lightly and him giving the young man a friendly lick. The college athlete gives a little moan and runs his hand up to Carl's neck, burying his fingers in the husky's luxuriously thick fur as he pants out, 'Yes. I want it. Want you.'";
	LineBreak;
	say "     Looks like the two of them will get it on right there in the library. Do you want to watch?";
	if player consents:
		LineBreak;
		say "     Carl leans in a little and meets Eric's lips with his muzzle, exploring his partner's mouth with his long tongue as the young man sucks on his questing appendage. The doggy kiss goes on for a long moment as they share breaths and spit, then eventually the two of them part again. Panting and looking into the other's eyes, both of them pick that moment to strip as fast as they possibly can, pulling shirts over their heads and flinging them aside, then kicking off the shorts covering their lower bodies. Carl stands up and moves in front of Eric, his reddish canine shaft standing at full mast as he lets his eyes wander over the young trans-man. 'You're one sexy guy Eric,' the anthro husky pants in a lust-filled tone as he leans over the college athlete, then presses against Eric's chest with a soft touch, pushing him to lean back against the sofa cushions. As the human readily follows his guidance, Carl wags his tail wildly while he kneels down and brings his canine head between Eric's legs.";
		say "     The gasping sound of indrawn breath echoes through the usually so quiet halls of the library - Eric being unable to hold back as Carl laps over his sex, the husky's broad tongue swiping over it in his repeated licks. Burying his nose in the cuntboy's moist folds and breathing in deeply, Carl gives a somewhat muffled, 'You smell amazing, and taste even better!' With that, the canine soldier pushes his long tongue in between Eric's nether lips, wiggling it left and right in his friend's vagina. Meanwhile, Carl's hands aren't idle either, with one of them stroking Eric's sensitive skin up and down on the inside of his thighs and the other feeling the lithe athlete's abs. Dipping in to playfully wiggle Eric's belly button, the husky's fingers soon find the little treasure-trail of hair starting right below and follow it down, towards the human student's crotch. It doesn't take long before he has his index-finger resting against the little button of Eric's clit, massaging it with circling movements that make the red-headed athlete tremble in arousal and tightly grip the sofa cushions.";
		WaitLineBreak;
		say "     Stimulating Eric with his tongue and fingers, Carl gives the college student his fullest attention, tirelessly pushing him to greater and greater arousal. His skillful ministrations draw ever louder and more urgent moans and gasps from Eric and before much longer, the young trans-man shouts out in lust as he reaches a breathtaking orgasm. Throwing his head back, Eric trembles all over and bucks his hips - pushing right against Carl's open muzzle as the husky soldier continues going down on him, hungrily slurping up all the femcum that is just leaking from Eric's pussy. Still panting loudly for several moments before he catches his breath, Eric looks down at the kneeling soldier and eventually says, 'Wow, that was just... wow.' Carl replies with a beaming grin, wagging his tail like a storm as he playfully quips, 'Woof! Was Carl a good doggie, master? Arwooo!'";
		say "     The naked college student on the sofa gives a chuckle at his friend's tone and sits up a bit, sliding his rear to the edge of the seat as he leans forward. Reaching out, the young man puts a hand on Carl's fur behind his neck, gently pulling him up. Eric joins in on Carl's act of being his pet and tells the anthro husky, 'Such a good boy. Nice dog!' Then their muzzle and mouth meet again, and the two guys make out with obvious enthusiasm, soon finding themselves sprawled on the sofa together. Their kisses and licks, tongue-wrestling and petting go on and on, until Carl eventually draws back a tiny bit, finding the breath to say in a naughty tone, 'Being such a good pet and all, may this doggie bury his bone in master's - ehem - garden? He knows just the right spot under a decorative little bush...' Heads are turned to look down between the two of them, where the canine soldier's erect shaft is pressed against Eric's pubic mound.";
		project the figure of Carl_Eric_sofa_fuck_1_icon;
		WaitLineBreak;
		say "     After a few seconds of silence in which Eric bites his lower lip, a single word escapes him - 'Yes.' At the same time, he spreads his legs a little more, preparing for the muscular husky on top of him and raising his hands to stroke them along the flanks of the canine soldier. Carl gives him another very affectionate kiss - with lots of tongue action - then slides down a tiny bit to line his cock up with the young athlete's pussy. The tapering tip of his canine shaft slides in easily between the wet, slightly parted lips of Eric's feminine folds. Accompanied by a moan shared between two voices, the husky humps his hips forwards and enters Eric for the first time. ";
		if EricVirginityTaken is 0:
			say "Knowing that the transgendered athlete is a virgin (from having had his tongue wiggling against it not too long before), Carl pulls his first thrust a bit, letting his erection come to rest against the thin barrier inside. He looks into Eric's eyes, the obvious question in his gaze, and his partner gives a slightly fearful but yet also so very eager nod. Leaning down, the canine soldier plants deep kiss on his lips while thrusting into Eric's body and taking his virginity. Sinking himself into the athletic student's pussy until the bulge of his knot brushes Eric's nether lips, Carl licks the human's face and grunts, 'Thanks for letting me be your first. You feel really amazing to be in.'";
			if HP of Eric is 10: [virgin Eric]
				now HP of Eric is 14; [an NPC fucked Eric first and took his virginity]
			now EricVirginityTaken is 4; [by Carl]
		else:
			say "Sinking himself into the athletic student's pussy until the bulge of his knot brushes Eric's nether lips, Carl licks the human's face and grunts, 'One sexy thing you are. Feels really amazing to be inside you.'";
		say "     Eric is basically speechless under Carl, far too busy moaning and gasping in the grasp of his feelings at getting fucked than to say anything intelligible. It is quite obvious though that the young man really enjoys being taken by the husky soldier, as he wraps his legs tightly around Carl's hips, pulling him in tighter against his crotch with every thrust. The college athlete's arms are also on Carl's body, dug into the canine's thick fur and holding on to him as the muscled male bucks into his human partner. You slowly drift closer, watching the two of them hump against each other on the sofa, right in the middle of the public library. These really are quite... interesting times, in which sexy scenes like the mating of an anthro canine and a trans-gendered young man are right on par with what's happening all over the city, every day of the week.";
		WaitLineBreak;
		say "     Carl and Eric fuck each other with quite a bit of enthusiasm, not even noticing you as they kiss and enjoy the other's body. Movements quicken and moans get louder and louder as the two guy's arousal mounts rapidly - reaching a new screamed high as the husky eventually forces his bulging knot in between Eric's pussy lips with a hard thrust. 'I'm all the way in you baby,' the soldier grunts in a lusty tone, lapping the side of Eric's neck right after. 'Y-yeah,' comes the somewhat breathless and clearly very satisfied reply from his college athlete partner. 'Feels so full - and warm,' Eric continues, then hugs Carl close and presses his face against the warm fur of the husky's shoulder. The muscled anthro on top of him replies in kind, putting his arms around Eric and getting a good grip - to make sure he isn't wrenched along as Carl pops his knot back out of the trans-man's stretched pussy, pulling further and further back until just his tapered cock-tip is inside Eric. And then he hammers his whole manhood into the young man, growling possessively as he bumps Eric's cervix and his knot throbs against the walls of his pussy.";
		say "     Losing himself in the urges of his canine self for a moment, Carl fucks Eric like a wild man - or wild beast, rather - humping against the teenager's crotch with unrelenting energy. Gripping Carl tightly with both hands buried in thick fur, the red-headed athlete under him is along for the ride in total ecstasy, trembling and moaning as he is taken hard. It doesn't take all that long before the mating culminates in a howled-out orgasm by Carl, bucking his hips slightly as rope after rope of his potent seed splashes into the cuntboy's [if EricVirginityTaken is 0]receptive[end if] womb. Meanwhile the husky's already quite large knot swells even further, creating a noticeable bulge under Eric's wet and dripping nether lips as it locks the two of them together. Balls-deep inside the lithe college athlete he just introduced to his doggie cock, Carl pants with open muzzle in rhythm to his balls sending forth another and another blast of cum. Then he suddenly finds his head pulled down a bit by Eric's hand as the young man catches his hanging-out tongue with his lips, sucking on the floppy organ and sharing his breath with Carl.";
		project the figure of Carl_Eric_sofa_fuck_2_icon;
		WaitLineBreak;
		say "     Their sexy little bout of making out continues all the way throughout the husky's prolonged orgasm, with Carl continuing to breed his human partner for a good ten minutes, the knot ensuring that he stays inside his mate until the very last drop of cum is deposited inside Eric. Eventually, as the throbs of semen slowly ebb off, the intensity of their shared kisses does so too, until Carl and Eric are just lying on the sofa together, gazing into each other's eyes. The husky puts a hand on his special friend's chest, gently stroking his skin and feeling the beat of Eric's heart. 'That was fun, don't you think?' he adds with a satisfied sigh a moment later, earning a chuckle from Eric. 'Quite a bit,' the college athlete replies happily, then rubs Carl behind the ears, making him hum with pleasure.";
		say "     After Carl informs his friend that their intimate coupling will last some more time - until his knot goes down far enough, that is - the two of them settle down to chat and joke around. It is kinda funny to see - two guy-friends hanging out together, recounting stories and talking to one another... as if one of them wasn't stuck with his swollen cock in the slightly cum-bulging pussy of the other. No matter what else may be going on between them, it is more than obvious that Carl and Eric have grown into good friends, enjoying each other's company - sex or no sex. As the main show is over, you drift away unobtrusively, leaving them to spend some quiet time together, and clean up eventually.";
	else:
		say "     Turning away from them as the first clothes are being pulled off, you busy yourself somewhere else in the library. The moans, barks and general sounds of sex that reach your ears still make it quite obvious what's going on. Eventually things calm down again and you wander back towards the open area near the library entrance. What awaits you there is the sight of Eric and Carl entwined naked on one of the sofas. As you walk near, Carl informs the college athlete that their intimate coupling will last some more time - until his knot goes down far enough, that is - the two of them settle down to chat and joke around. It is kinda funny to see - two guy-friends hanging out together, recounting stories and talking to one another... as if one of them wasn't stuck with his swollen cock in the slightly cum-bulging pussy of the other. No matter what else may be going on between them, it is more than obvious that Carl and Eric have grown into good friends, enjoying each other's company - sex or no sex. Not wanting to break up their mood, you step away unobtrusively, leaving them to spend some quiet time together, and clean up eventually.";
		if HP of Eric is 10: [virgin Eric]
			now HP of Eric is 14; [an NPC fucked Eric first and took his virginity]
		if EricVirginityTaken is 0: [virgin]
			now EricVirginityTaken is 4; [by Carl]
	now CarlEricInteraction is 6;
	now lastCarlEricInteraction is turns;

to say EricCarlScene6:
	let randomnumber be a random number from 1 to 3;
	if randomnumber is:
		-- 1:
			say "     Coming into the library, you see Carl and Eric together on one of the bigger sofas - both of them naked, and with Eric on all fours. The anthro husky kneels behind him, his canine erection in hand as he lines it up with Eric's nether lips and then slides into the transgendered college student with a lusty grunt. 'Your pussy feels really great dude,' Carl huffs out as he pushes deeper, arms wrapping around Eric's chest as he laps at the young man's left earlobe. 'As does your cock! Fuck me, doggie!' the college athlete under him replies with a playful laugh, reaching back with one arm to rub Carl's furred side. 'Woof! You asked for it...' comes another quick bark from the eager husky, then he humps his muscled body against Eric, driving the knot at the base of his shaft between Eric's feminine folds and popping inside with a shared gasp.";
			LineBreak;
			say "     Do you want to watch them go at it?";
			if player consents:
				LineBreak;
				say "     The husky and human couple proceed to fuck each other eagerly - and openly - filling the library with moans, barks, grunts and howls as they move against one another. It is almost impossible not to watch the sexy show of the lithe college student being topped by his canine friend. Yet as heated as their mating is, it doesn't take all that long before arousal builds beyond anything they are able to control. With a lust-filled bark, Carl grinds his crotch against Eric, holding on tight as his knot swells and locks them together, giving his furred balls all the time in the world to send forth a huge load of virile seed. The husky holds on to Eric tightly as he reaches his climax, giving somewhat possessive growls and licking the human's neck in eager affection. A moment later, while his cock still throbs with more and more cum being deposited into the young trans-man, Carl remembers to give his friend attention too and puts a paw-hand on Eric's crotch.";
				WaitLineBreak;
				say "     Stimulating the cuntboy's sensitive button of a clit, Carl gets Eric to pant almost as much as he himself is, deep in the grip of sky-rocketing arousal. Then Eric suddenly bucks against his hand, giving a long moan as an orgasm crashes over him, drowning him in pleasure. Carl makes sure to keep going, rubbing the college athlete's female parts with steady circling movements and doing his best to prolong Eric's high as long as possible. The smile on his open muzzle makes it clear that he loves seeing his partner in ecstasy - as well as that Eric's inner muscles must be squeezing his dick in quite enjoyable ways as the cuntboy trembles in completion. Then he suddenly finds his head pulled down a bit by Eric's hand as the young man gives him a deep kiss. He even catches the canine soldier's hanging-out tongue with his lips, sucking on the floppy organ and sharing his breath with Carl.";
				say "     Their sexy little bout of making out continues all the way throughout the husky's prolonged orgasm, with Carl continuing to breed his human partner for a good ten minutes, the knot ensuring that he stays inside his mate until the very last drop of cum is deposited inside Eric. Eventually, as the throbs of semen slowly ebb off, the intensity of their shared kisses does so too, until Carl and Eric are just lying on the sofa together, gazing into each other's eyes. The husky puts a hand on his special friend's chest, gently stroking his skin and feeling the beat of Eric's heart. 'That was fun, don't you think?' he adds with a satisfied sigh a moment later, earning a chuckle from Eric. 'Quite a bit,' the college athlete replies happily, then rubs Carl behind the ears, making him hum with pleasure.";
				WaitLineBreak;
				say "     After Carl informs his friend that their intimate coupling will last some more time - until his knot goes down far enough, that is - the two of them settle down to chat and joke around. It is kinda funny to see - two guy-friends hanging out together, recounting stories and talking to one another... as if one of them wasn't stuck with his swollen cock in the slightly cum-bulging pussy of the other. No matter what else may be going on between them, it is more than obvious that Carl and Eric have grown into good friends, enjoying each other's company - sex or no sex. As the main show is over, you drift away unobtrusively, leaving them to spend some quiet time together, and clean up eventually.";
			else:
				say "     You casually turn away from the scene and busy yourself with other things, trying to ignore the sexual noises the two of them make.";
		-- 2:
			say "     Coming into the library, you see Carl and Eric together on one of the bigger sofas - both of them naked, and with Eric straddling the husky soldier's chest, looking towards his friend's crotch. The anthro husky's muzzle is between his legs, with his wet nose pressed against Eric's nether lips and his long canine tongue licking the young trans-man. 'Love the taste of your pussy dude,' the anthro husky says in a somewhat muffled tone, then pokes his tongue in between Eric's slightly parted folds, exploring the young man's insides. Meanwhile, Eric gasps in pleasure and leans forward, bracing himself on Carl's hips and then letting his hands wander to the canine's bulgy cock, fully hard and erect outside its furry sheath. Taking hold of the reddish member, Eric strokes his friend first slowly, then with increasing speed and enthusiasm, then even leaning forward to suck its pointy tip. While he slurps Carl's pre-cum, the husky eats his pussy expertly, winding the two of them up in mutual pleasure.";
			LineBreak;
			say "     Do you want to watch them go at it?";
			if player consents:
				LineBreak;
				say "     Eventually, Eric pulls off the cock in his mouth with a little pop, then clears his throat and looks back over his shoulder. 'Carl?' he asks hesitantly, making the husky raise his muzzle from between his legs, looking up at the shy teenager and replying in a friendly tone, 'What's up buddy?' Eric blushes just a little bit, then slowly says, 'I - I think I want to... fuck now. Ride your cock. Is that okay?' Carl gives out a little laugh at his friend's shyness, despite them having already fucked and now spent some time in a very pleasurable 69, then he strokes the outsides of Eric's thighs and answers, 'Of course it is. I'm all yours babe. You can ride me like a rodeo bull if you want.' With that said, Carl buries his muzzle back between Eric's legs, giving him a very enthusiastic tongue-lashing before the young man hesitantly climbs off him and gets into position for straddling the husky's crotch.";
				WaitLineBreak;
				say "     Looking down at Carl - who gives him a supporting nod while thumping the sofa with his excitedly wagging tail - Eric smiles shyly, then reaches down to take hold of the large canine erection he sucked off till just a moment ago. The red-skinned shaft glistens with the young trans-man's spit as he lines it up with his own nether lips. Then he lowers himself, holding his breath as his nether lips sink down over the erection's tip and it nudges his folds apart, sliding into Eric's body. The transgendered student lets out a happy sigh as he feels the familiar cock inside him, then lowers himself further, taking more and more till eventually, just the knot at the base is outside, resting against his opening. 'Your pussy feels really great dude,' Carl huffs out as he gives a little hump of his hips, grinding against Eric's crotch. The soldier's strong arms reach up to wrap around his friend's body, pulling him in for a squeeze and lapping at his left earlobe in deep affection. 'As does your cock! This feels amazing, doggie!' the college athlete under him replies with a playful laugh, reaching back with one arm to rub Carl's furred side. 'Woof! Wait till you have it all in...' comes another quick bark from the eager husky, then he humps his muscled body up against Eric, driving the knot at the base of his shaft between Eric's feminine folds and popping inside with a shared gasp.";
				say "     The husky and human couple proceed to fuck each other eagerly - and openly - filling the library with moans, barks, grunts and howls as they move against one another. It is almost impossible not to watch the sexy show of the lithe college student riding the pointy shaft of his canine friend. Yet as heated as their mating is, it doesn't take all that long before arousal builds beyond anything they are able to control. With a lust-filled bark, Carl grinds his crotch against Eric, holding on tight as his knot swells and locks them together, giving his furred balls all the time in the world to send forth a huge load of virile seed. The husky holds on to Eric tightly as he reaches his climax, giving somewhat possessive growls and licking the human's face in eager affection. A moment later, while his cock still throbs with more and more cum being deposited into the young trans-man, Carl remembers to give his friend attention too and puts a paw-hand on Eric's crotch.";
				WaitLineBreak;
				say "     Stimulating the cuntboy's sensitive button of a clit, Carl gets Eric to pant almost as much as he himself is, deep in the grip of sky-rocketing arousal. Then Eric suddenly bucks against his hand, giving a long moan as an orgasm crashes over him, drowning him in pleasure. Carl makes sure to keep going, rubbing the college athlete's female parts with steady circling movements and doing his best to prolong Eric's high as long as possible. The smile on his open muzzle makes it clear that he loves seeing his partner in ecstasy - as well as that Eric's inner muscles must be squeezing his dick in quite enjoyable ways as the cuntboy trembles in completion. Then he suddenly finds his head pulled up a bit by Eric's hand as the young man gives him a deep kiss. He even catches the canine soldier's hanging-out tongue with his lips, sucking on the floppy organ and sharing his breath with Carl.";
				say "     Their sexy little bout of making out continues all the way throughout the husky's prolonged orgasm, with Carl continuing to breed his human partner for a good ten minutes, the knot ensuring that he stays inside his mate until the very last drop of cum is deposited inside Eric. Eventually, as the throbs of semen slowly ebb off, the intensity of their shared kisses does so too, until Carl and Eric are just lying on the sofa together, Eric lying on top of the furred canine as they gaze into each other's eyes. The husky puts a hand on his special friend's chest, gently stroking his skin and feeling the beat of Eric's heart. 'That was fun, don't you think?' he adds with a satisfied sigh a moment later, earning a chuckle from Eric. 'Quite a bit,' the college athlete replies happily, then rubs Carl behind the ears, making him hum with pleasure.";
				WaitLineBreak;
				say "     After Carl informs his friend that their intimate coupling will last some more time - until his knot goes down far enough, that is - the two of them settle down to chat and joke around. It is kinda funny to see - two guy-friends hanging out together, recounting stories and talking to one another... as if one of them wasn't stuck with his swollen cock in the slightly cum-bulging pussy of the other. No matter what else may be going on between them, it is more than obvious that Carl and Eric have grown into good friends, enjoying each other's company - sex or no sex. As the main show is over, you drift away unobtrusively, leaving them to spend some quiet time together, and clean up eventually.";
			else:
				say "     You casually turn away from the scene and busy yourself with other things, trying to ignore the sexual noises the two of them make.";
		-- 3:
			say "     Coming into the library, you're just in time to hear an aroused groan echo in the main room. A quick look around reveals that it came from Carl, who is having quite a good time apparently. The canine soldier lies on his back, sprawled out on one of the bigger sofas further back in the library, gripping the upholstery tightly with both hands as someone is going down on his cock. The backrest of the sofa blocks your view at who that might be at first, but as you casually stroll closer a flash of red hair comes into view, bobbing up and down. Ah, looks like Eric is having fun with his anthro friend!";
			say "     Eric is certainly busy with sucking dick and Carl hasn't seen you yet either - his head is lolling around just over the edge of the sofa, panting in lust and with his eyes closed. [bold type]You might just leave the two of them to have fun on their own ([link]Y[as]y[end link]) - or do you want to step up and have a closer look ([link]N[as]n[end link])?[roman type][line break]";
			if player consents:
				LineBreak;
				say "     Moving closer and around, you finally get a good view of both of them - not only Carl lying lengthwise on the sofa at its end but also Eric, who is on all fours between the husky's legs. Just like the soldier, Eric is completely naked with his clothes and running shoes in a small pile on the ground. The rear end of his lithe form is raised high as he has his head down over Carl's crotch, as well as his lips wrapped around the husky's erect shaft. Bobbing up and down quickly, Eric is eagerly giving his fuck-buddy a blow-job.";
				say "     [bold type]Do you just want to watch ([link]Y[as]y[end link]) or would you like to participate yourself ([link]N[as]n[end link])?[roman type][line break]";
				if player consents: [watch the Eric on Carl BJ and Carl transferring his cum into Eric]
					LineBreak;
					say "     Quietly taking up a position behind a nearby bookshelf that promises full view of things going on, you're just in time before Carl raises his head and looks at Eric with a huge grin on his face. 'Yeah baby! Lick that head some more,' he pants loudly, prompting the red-headed student to pull off his shaft and reply teasingly, 'You mean like this?' That said, he slowly runs his tongue up the underside of Carl's erection until soon reaching its pointy head, then circles Carl's glans with the tip of his tongue. 'Nnnnghh!' the anthro canine grunts in clear arousal and puts a hand on his friend's head, affectionately tousling his hair a little before pulling Eric back down on his cock - taking all of it down to the base.";
					say "     The two of them continue to fill the library with moans and grunts, mostly from Carl as there is little time that Eric's lips aren't wrapped around the husky's pole of man-meat, giving you an amazing show of two horny guys having fun. Soon, Carl basically pants nonstop with his long tongue hanging out - a clear sign of the canine running hot. 'Getting real close now buddy,' the canine soldier barks out moments later, tapping Eric's shoulder with some urgency - and the pale-skinned student pulls his head back barely in time, lips stretching wide around Carl's rapidly swelling knot, then pulls off the bulge with a loud pop.";
					WaitLineBreak;
					say "     Panting a little as he looks upon Carl's erection and watches the knot reach its full size in seconds, Eric's eyes go wide as the first blast of canine cum erupts from the pointy cock-head and hits him. With his forehead and red hair now marked by a white streak, the transgendered student quickly reacts by plunging his mouth back down towards Carl's twitching manhood. The next spurt shoots out right as he is starting to open wide and paints Eric's lips and tongue with creamy cum. After that, the athletic student is back to sucking on the canine dick of his fuck-buddy - catching further eruptions of canine seed with his mouth while jerking Carl with one hand.";
					say "     The muscular soldier bucks on the sofa and reflexively thrusts his hips up towards Eric as he orgasms, grunting loudly with each new shot until he eventually sinks back in exhaustion. 'Phew,' he pants after a few moments of just lying there in post-orgasmic bliss. 'That was something else! You're getting good at this,' Carl says after raising his head to look at Eric - who still is gently suckling at his cock-head. The soldier smiles broadly as their eyes meet, then he hooks a hand behind Eric's neck and sits up, guiding the transgendered teen into making out. Tail wagging in a rapid beat against the sofa (now that he's no longer lying on top of it), Carl slips Eric his tongue in a deep french kiss. As they eventually pull apart, strings of frothy cum stretch between their lips for a second. Looks like the husky slurped quite a bit of his own cum from Eric's mouth.";
					WaitLineBreak;
					say "     'Payback time,' Carl says with a grin in a bit of a mumble (from having a load of cum in his mouth), then executes what could almost be a wrestling move - getting his legs under him and bowling Eric over on the sofa to fall back on the soft upholstery. In a quick follow-up move, the canine soldier gets a grip on his human friend's legs and hikes them up over his own furred shoulders. This leaves Eric in almost a headstand, with Carl's muzzle just inches from his crotch. Brushing his nose against the glisteningly wet folds of Eric's feminine sex, the husky takes a deep huff of air and lets out an aroused rumble from deep in his throat. 'Fucking sexy,' he compliments Eric out of mostly closed lips, then uses his fingers to part the college athlete's nether lips.";
					say "     Carl rubs his wet nose against the opening of Eric's even wetter pussy, reveling in the scent of his sexy friend, then opens his muzzle. As the anthro canine sticks his long tongue into the cuntboy's vagina, the frothy mixture of cum and spit he held in his mouth slides down over the twitching muscle and right into Eric's depths, who moans loudly at the treatment his friend is giving him. 'You like that, don't you?' the soldier teases his friend, then uses a finger to stroke over Eric's clit just as he opens his mouth, making his reply nothing more but a drawn-out moan.";
					WaitLineBreak;
					say "     Inserting two fingers into the trans teen's pussy, Carl continues to push his cum deeper into Eric, all the while keeping his thumb on the human student's clit and rubbing it with circling movements. The sensations of being touched in this way drive Eric wild and he begins panting faster and faster, letting out moans in rising urgency. When Carl then switches to not only fingering but also lapping at Eric's clit with his tongue, this drives the athletic student over the edge. He orgasms with a climactic shout, legs twitching as they cross over Carl's back and pull the husky even tighter against his friend's crotch. Of course, Carl knows Eric quite well by now and is prepared for that - he just keeps lapping at his friend's crotch and slurps up the femcum that starts to leak from his folds.";
					say "     Eventually sliding Eric's legs from over his shoulders and allowing the young student to stretch out fully on the sofa, Carl straightens up and looks down at his naked friend. A broad smile is on his face as he feasts his eyes on the lithe teenager, his tail wagging up a storm at the same time. 'Rrr-woof! Was Carl a good doggie?' the soldier asks in a playful tone as he lowers himself into a push-up position on top of Eric, lapping at his hairless and sweaty chest to work his way up to coming face to face with Eric. 'You're definitively taking the 'man's best friend' bit to new levels Carl,' comes a happy reply, together with Eric running his hand through the thick fur on the anthro husky's neck and pulling him into another bout of making out.";
					LineBreak;
					say "     As the main action seems to be over now, you quietly move away from your spot and leave the two of them to lie on the sofa together. From the snippet of conversation you catch as you walk off, they start to talk about their favorite songs next. The effortless switch to typical guy-talk between friends after having just gotten their rocks off with each other puts a smile on your face. Eric and Carl are definitively an interesting pair - seems like something just clicked between the two young men after meeting not so long ago.";
				else: [join in]
					LineBreak;
					say "     As you walk up to the human-husky couple and softly clear your throat, Eric pushes himself up from Carl's crotch in an eye-blink, creating a loud pop as he pulls his lips off the erect canine shaft he was sucking. The college athlete flushes in embarrassment almost instantly - his pale skin becoming bright red in the face as he opens and closes his mouth in shock. 'Uhm... I... we were... just... eh...' Eric stammers, then Carl pushes himself up on his elbows and takes over, 'He was just giving me an amazingly good blow-job. No reason to be ashamed of it, buddy.' Gulping visibly, Eric looks at the husky, then over to you and back at Carl again as the soldier puts a paw-hand on his shoulder, gently stroking him.";
					say "     'Yes, but... uhm...' Eric starts to say, only to fall silent as he is engaged in a french kiss by his canine fuck-buddy, ending in Carl looking deep into his eyes and saying, 'Shhh... it's okay. We're all friends here.' Rubbing his muzzle against the side of Eric's neck and licking him, the muscled soldier then nods towards you, 'And I think I know why [if player is female]she[else]he[end if] came over right now. You wanna take part, don't you?' As you grin and nod, Eric's eyes go wide, then a happy smile starts spreading over his still a bit flushed cheeks.";
					WaitLineBreak;
					say "[EricCarlThreesome Sex Menu]";
			else: [don't watch]
				LineBreak;
				say "     With a smile on your lips about the transformed soldier and transgendered teen having become such good friends - very much with benefits too - you stroll back towards the reception desk of the library. The sounds of slurping, moans and pants that fill the library over the next little while eventually culminate in a series of louder grunts, followed by the murmur of friendly banter between the two young guys.";
	if CarlEricInteraction < 6:
		now CarlEricInteraction is 6;
	now lastCarlEricInteraction is turns;

to say EricCarlThreesome Sex Menu:
	LineBreak;
	say "What exactly do you want to do with the two of them?";
	now sextablerun is 0;
	blank out the whole of table of fucking options;
	[]
	if cocks of player > 0:
		choose a blank row in table of fucking options;
		now title entry is "Fuck Eric's pussy from behind while he sucks Carl";
		now sortorder entry is 1;
		now description entry is "Go doggy-style on the college athlete";
	[]
	if cocks of player > 0:
		choose a blank row in table of fucking options;
		now title entry is "Fuck Eric's ass from behind while he sucks Carl";
		now sortorder entry is 2;
		now description entry is "Go doggy-style on the college athlete";
	[]
	if cocks of player > 0:
		choose a blank row in table of fucking options;
		now title entry is "Fuck Carl's muzzle while Eric blows his cock";
		now sortorder entry is 3;
		now description entry is "Make it a face-fuck chain";
	[]
	if cocks of player > 0:
		choose a blank row in table of fucking options;
		now title entry is "Fuck Carl's ass while he eats Eric's pussy";
		now sortorder entry is 4;
		now description entry is "Go doggy-style on the husky";
	[]
	if cocks of player > 0:
		choose a blank row in table of fucking options;
		now title entry is "Get a blow-job from Carl while he hammers Eric's pussy";
		now sortorder entry is 5;
		now description entry is "Let Carl blow you";
	[]
	if cocks of player > 0:
		choose a blank row in table of fucking options;
		now title entry is "Get a blow-job from Eric while he straddles Carl's face";
		now sortorder entry is 6;
		now description entry is "Let Eric blow you";
	[]
	if cunts of player > 0:
		choose a blank row in table of fucking options;
		now title entry is "Grind your pussy against Carl's muzzle while Eric blows him";
		now sortorder entry is 7;
		now description entry is "Make it a face-fuck chain";
	[
	choose a blank row in table of fucking options;
	now title entry is "Ride Carl's cock while his face is straddled by Eric";
	now sortorder entry is 8;
	now description entry is "Double-team Carl on both ends";
	]
	sort the table of fucking options in sortorder order;
	repeat with y running from 1 to number of filled rows in table of fucking options:
		choose row y from the table of fucking options;
		say "[link][y] - [title entry][as][y][end link][line break]";
	say "[link]100 - Nevermind[as]100[end link][line break]";
	while sextablerun is 0:
		say "Pick the corresponding number> [run paragraph on]";
		get a number;
		if calcnumber > 0 and calcnumber <= the number of filled rows in table of fucking options:
			now current menu selection is calcnumber;
			choose row calcnumber in table of fucking options;
			say "[title entry]: [description entry]?";
			if player consents:
				let nam be title entry;
				now sextablerun is 1;
				if (nam is "Fuck Eric's pussy from behind while he sucks Carl"):
					say "[EricCarlThreesome1]";
				if (nam is "Fuck Eric's ass from behind while he sucks Carl"):
					say "[EricCarlThreesome2]";
				if (nam is "Fuck Carl's muzzle while Eric blows his cock"):
					say "[EricCarlThreesome3]";
				if (nam is "Fuck Carl's ass while he eats Eric's pussy"):
					say "[EricCarlThreesome4]";
				if (nam is "Get a blow-job from Carl while he hammers Eric's pussy"):
					say "[EricCarlThreesome5]";
				if (nam is "Get a blow-job from Eric while he straddles Carl's face"):
					say "[EricCarlThreesome6]";
				if (nam is "Grind your pussy against Carl's muzzle while Eric blows him"):
					say "[EricCarlThreesome7]";
				if (nam is "Ride Carl's cock while his face is straddled by Eric"):
					say "[EricCarlThreesome8]";
				wait for any key;
		else if calcnumber is 100:
			say "Break off the conversation?";
			if the player consents:
				now sextablerun is 1;
				say "     You step back from the two of them, saying that you just remembered something important you absolutely have to do. They give you questioning looks, then shrug and look at each other. As you hurry off, the two of them start making out, apparently determined to have fun with or without you.";
				wait for any key;
			else:
				say "Pick between 1 and [the number of filled rows in the table of fucking options] or 100 to exit.";
		else:
			say "Invalid Option. Pick between 1 and [the number of filled rows in the table of fucking options].";
	clear the screen and hyperlink list;

to say EricCarlThreesome1: [fuck Eric's pussy while he blows Carl]
	say "     Both the husky and human share eager looks as you tell them what you want to do, then quickly take their positions - Carl stretched out lengthwise on his back, with Eric on all fours between his legs. The canine soldier pushes his upper body up on his elbows and gives Eric a huge grin. 'Yeah baby! Lick that head good,' he pants in an aroused tone, prompting the red-headed student to bring his face close over his crotch and reply teasingly, 'You mean like this?' That said, Eric slowly runs his tongue up the underside of Carl's erection until soon reaching its pointy head, then circles Carl's glans with the tip of his tongue. 'Nnnnghh!' the anthro canine grunts in clear arousal and puts a hand on his friend's head, affectionately tousling his hair a little before pulling Eric down to engulf his cock - taking all of it down to the base.";
	say "     While the two of them start to fill the library with moans and grunts, you yourself get into position behind Eric - your erect cock leading the way. Kneeling behind the transgendered teen, you stroke the [cock of player] shaft dangling between your legs and check out the sexy slit Eric is presenting for you in that pose. Reaching out to stroke over his nether lips, you find them wet and easily stretching around your fingers as you push them inside slowly. Yeah, he's so ready to be fucked! With a grin over to Carl as he is getting a nice blow-job, you line yourself up a moment later, then sink yourself into the cuntboy's depths. Eric hums pleasedly around the canine shaft in his mouth and rocks slightly back to meet your first deep thrust - making your crotch smack his ass as you bottom out.";
	WaitLineBreak;
	say "     The three of you fill the library with aroused moans, grunts and even barks as Eric gets dicked from two ends. Sawing your [cock of player] rod in and out of his tight pussy, you revel in the fact that the lithe student trembles in pleasure from being fucked and even gasps out things like, 'Fuck me. Fuck my pussy. Harder!', as he takes a breather or two from sucking dick. Meanwhile, Carl has his head thrown back and is giving an aroused and somewhat breathless commentary on how good Eric's mouth feels on his dick. Soon, the husky basically pants nonstop with his long tongue hanging out - a clear sign that he's becoming more and more wound up by the oral stimulation. 'Getting real close now buddy,' the canine soldier barks out a few moments later, tapping Eric's shoulder with some urgency - and the pale-skinned student pulls his head back barely in time, lips stretching wide around Carl's rapidly swelling knot, then pulls off the bulge with a loud pop.";
	say "     Moaning loudly as his backwards movement makes Eric's pussy take your newest thrust with additional force, the young student's eyes are drawn to Carl's erection - watching its knot reach its full size in a few heartbeats. Then Eric's eyes go wide as the first blast of canine cum erupts from the pointy cock-head and hits him. With his forehead and red hair now marked by a white streak, the transgendered student quickly reacts by plunging his mouth back down towards Carl's twitching manhood. The next spurt shoots out right as he is starting to open wide and paints Eric's lips and tongue with creamy cum. After that, the athletic student is back to sucking on the canine dick of his fuck-buddy - catching further eruptions of canine seed with his mouth while jerking Carl with one hand.";
	WaitLineBreak;
	say "     With Eric rocking back and forth on your thrusting shaft and his inner muscles flexing around your erection, you're getting quite close to coming yourself. With a lusty growl, you pull out of him most of the way, then hammer your dick back in, shouting in orgasmic release as you start filling him with your seed. Throb after throb, cum erupts into his depths, giving the college athlete a pleasantly full feeling. On Eric's other end, Carl bucks on the sofa and reflexively thrusts his hips upwards as he orgasms, grunting loudly with each new shot until he eventually sinks back in exhaustion. 'Phew,' he pants after a few moments of just lying there in post-orgasmic bliss. 'That was something else! You're getting good at this,' Carl says after raising his head to look at Eric - who still is gently suckling at his cock-head.";
	say "     The soldier smiles broadly as their eyes meet, then he hooks a hand behind Eric's neck and sits up, guiding the transgendered teen into making out. Tail wagging in a rapid beat against the sofa (now that he's no longer lying on top of it), Carl slips Eric his tongue in a deep french kiss. As they eventually pull apart, strings of frothy cum stretch between their lips for a second. Looks like the husky slurped quite a bit of his own cum from Eric's mouth. Your own orgasm ebbed out with just a few more small spurts of cum while you were watching their antics, so you gently pull back from the lithe human's rear. As your softening prick slips from his pussy, you're pleased to see that none of your cum leaks out with it - you've planted it good and deep inside Eric's womb.";
	WaitLineBreak;
	say "     'Payback time,' Carl says with a grin in a bit of a mumble (from having a load of cum in his mouth), then executes what could almost be a wrestling move - getting his legs under him and pulling Eric up in his arms, then flipping him around to land on the sofa in a headstand, with his legs hooked over Carl's shoulders. This puts Carl's muzzle just inches from the young student's crotch. Brushing his nose against the glisteningly wet folds of Eric's feminine sex, the husky takes a deep huff of air and lets out an aroused rumble from deep in his throat. 'Fucking sexy,' he compliments Eric out of mostly closed lips, then uses his fingers to part the college athlete's nether lips.";
	say "     Carl rubs his wet nose against the opening of Eric's even wetter pussy, reveling in the scent of his sexy friend mixed with your own, then opens his muzzle. As the anthro canine sticks his long tongue into the cuntboy's vagina, the frothy mixture of cum and spit he held in his mouth slides down over the twitching muscle and right into Eric's depths, who moans loudly at the treatment his friend is giving him. 'You like that, don't you?' the soldier teases his friend, then uses a finger to stroke over Eric's clit just as he opens his mouth, making his reply nothing more but a drawn-out moan.";
	WaitLineBreak;
	say "     Inserting two fingers into the trans teen's pussy, Carl continues to push his cum deeper into Eric to mingle with your own deposit, all the while keeping his thumb on the human student's clit and rubbing it with circling movements. The sensations of being touched in this way drive Eric wild and he begins panting faster and faster, letting out moans in rising urgency. When Carl then switches to not only fingering but also lapping at Eric's clit with his tongue, this drives the athletic student over the edge. He orgasms with a climactic shout, legs twitching as they cross over Carl's back and pull the husky even tighter against his friend's crotch. Of course, Carl knows Eric quite well by now and is prepared for that - he just keeps lapping at his friend's crotch and slurps up the femcum that starts to leak from his folds.";
	say "     Eventually sliding Eric's legs from over his shoulders and allowing the young student to stretch out fully on the sofa, Carl straightens up and looks down at his naked friend. A broad smile is on his face as he feasts his eyes on the lithe teenager, his tail wagging up a storm at the same time. 'Rrr-woof! Was Carl a good doggie?' the soldier asks in a playful tone as he looks over to you, getting a grin and thumbs-up in reply. Then Carl lowers himself into a push-up position on top of Eric, lapping at his hairless and sweaty chest to work his way up to coming face to face with Eric. 'You're definitively taking the 'man's best friend' bit to new levels Carl,' comes a happy comment, together with Eric running his hand through the thick fur on the anthro husky's neck and pulling him into another bout of making out.";
	LineBreak;
	say "     Worn out from fucking Eric, you bid your two friends farewell for now and grab your gear to clean up and get dressed afterwards. As you move away from the site of your steamy threesome, the two of them stay lying on the sofa together. From a snippet of conversation you catch as you walk off, they start to talk about their favorite songs next. The effortless switch to typical guy-talk between friends after having just gotten their rocks off with each other puts a smile on your face. Eric and Carl are definitively an interesting pair - seems like something just clicked between the two young men after meeting not so long ago.";

to say EricCarlThreesome2: [fuck Eric's ass while he blows Carl]
	say "     Both the husky and human share eager looks as you tell them what you want to do, then quickly take their positions - Carl stretched out lengthwise on his back, with Eric on all fours between his legs. The canine soldier pushes his upper body up on his elbows and gives Eric a huge grin. 'Yeah baby! Lick that head good,' he pants in an aroused tone, prompting the red-headed student to bring his face close over his crotch and reply teasingly, 'You mean like this?' That said, Eric slowly runs his tongue up the underside of Carl's erection until soon reaching its pointy head, then circles Carl's glans with the tip of his tongue. 'Nnnnghh!' the anthro canine grunts in clear arousal and puts a hand on his friend's head, affectionately tousling his hair a little before pulling Eric down to engulf his cock - taking all of it down to the base.";
	say "     While the two of them start to fill the library with moans and grunts, you yourself get into position behind Eric - your erect cock leading the way. Kneeling behind the transgendered teen, you stroke the [cock of player] shaft dangling between your legs and check out the compact little ass Eric is raising so well for you in that pose. Reaching out to stroke over his rosy buttocks, you find them smooth and warm to the touch, with a tight pucker right between. Gently stroking over it makes Eric tense for a moment, then relax visibly as he opens himself to being touched there. Slowly pressing the tip of your index finger against his rear entrance, you feel his muscle push back against you - Eric is trying to make penetrating him easier for both of you.";
	WaitLineBreak;
	say "     All that you're missing now is some lube... but not for long, as you quickly slide your hand between his legs, seeking out his drippingly wet snatch. After burying two fingers between his nether lips and thrusting in and out a few times, you bring your slick digits back to the college athlete's pucker. Going slow at first, you penetrate the expectantly tight asshole of the slender human and feel around searchingly. It is quite obvious when you find Eric's prostate - he almost chokes on Carl's cock as you rub it, having to pull off in a hurry to let out a loud moan. 'Ooooh yes! That feels so good!' Eric groans as he rests his head against Carl's crotch, nose pressing into soft fur and with the canine's erection hotly against his cheek. He keeps panting and moaning like a bitch in heat while you finger his ass for a good long while, getting him ready for the real thing.";
	say "     Finally removing your fingers from Eric's ass after a final rub against his prostate, you smile at the enticing sight of his pink hole gaping open for a second, then pulling tight and opening again as searching for the digits that gave him such pleasure. 'More please,' Eric groans in a pleading tone and raises his butt a little more, then adds, 'Put em back in, I feel so empty!' You can't help but smile broadly at the perfect invitation from this cute redhead and line your erect shaft up with his ass. After another quick brush over his pussy to get more feminine juices and slicking up your cock, you press in against his pucker, stretching its readily expanding ring around your piece of man-meat. With a grin over to Carl as he strokes himself at the sight, you then sink yourself into the cuntboy's depths. Eric hums pleasedly into Carl's fur and rocks slightly back to meet your first deep thrust - making your crotch smack his ass hard as you bottom out.";
	WaitLineBreak;
	say "     As you take on a steady rhythm of sawing in and out of Eric's tight ass, Carl gently lifts the lithe student's head and guides him back to nuzzling the tip of his shaft. Readily accepting the hint, the young trans-man slides his lips over Carl's manhood, slurping on it with obvious pleasure. The three of you fill the library with aroused moans, grunts and even barks as Eric gets dicked from two ends. As you bottom out in him again and again, you revel in the fact that the trans teen trembles in pleasure from being fucked and even gasps out things like, 'Fuck me. Fuck my ass. Harder!', as he takes a breather or two from sucking dick. Meanwhile, Carl has his head thrown back and is giving an aroused and somewhat breathless commentary on how good Eric's mouth feels on his dick. Soon, the husky basically pants nonstop with his long tongue hanging out - a clear sign that he's becoming more and more wound up by the oral stimulation. 'Getting real close now buddy,' the canine soldier barks out a few moments later, tapping Eric's shoulder with some urgency - and the pale-skinned student pulls his head back barely in time, lips stretching wide around Carl's rapidly swelling knot, then pulls off the bulge with a loud pop.";
	say "     Moaning loudly as his backwards movement makes Eric's rump meet your newest thrust with additional force, the young student's eyes are drawn to Carl's erection - watching its knot reach its full size in a few heartbeats. Then Eric's eyes go wide as the first blast of canine cum erupts from the pointy cock-head and hits him. With his forehead and red hair now marked by a white streak, the transgendered student quickly reacts by plunging his mouth back down towards Carl's twitching manhood. The next spurt shoots out right as he is starting to open wide and paints Eric's lips and tongue with creamy cum. After that, the athletic student is back to sucking on the canine dick of his fuck-buddy - catching further eruptions of canine seed with his mouth while jerking Carl with one hand.";
	WaitLineBreak;
	say "     With Eric rocking back and forth on your thrusting shaft and his inner muscles flexing around your erection, you're getting quite close to coming yourself. With a lusty growl, you pull out of him most of the way, then hammer your dick back in, shouting in orgasmic release as you start filling him with your seed. Throb after throb, cum erupts into his depths, giving the college athlete a pleasantly full feeling. On Eric's other end, Carl bucks on the sofa and reflexively thrusts his hips upwards as he orgasms, grunting loudly with each new shot until he eventually sinks back in exhaustion. 'Phew,' he pants after a few moments of just lying there in post-orgasmic bliss. 'That was something else! You're getting good at this,' Carl says after raising his head to look at Eric - who still is gently suckling at his cock-head.";
	say "     The soldier smiles broadly as their eyes meet, then he hooks a hand behind Eric's neck and sits up, guiding the transgendered teen into making out. Tail wagging in a rapid beat against the sofa (now that he's no longer lying on top of it), Carl slips Eric his tongue in a deep french kiss. As they eventually pull apart, strings of frothy cum stretch between their lips for a second. Looks like the husky slurped quite a bit of his own cum from Eric's mouth. Your own orgasm ebbed out with just a few more small spurts of cum while you were watching their antics, so you gently pull back from the lithe human's rear. As your softening prick slips from his pucker, you're pleased to see that none of your cum leaks out before his muscle irises shut - you've planted it good and deep inside Eric's back passage.";
	WaitLineBreak;
	say "     'Payback time,' Carl says with a grin in a bit of a mumble (from having a load of cum in his mouth), then executes what could almost be a wrestling move - getting his legs under him and pulling Eric up in his arms, then flipping him around to land on the sofa in a headstand, with his legs hooked over Carl's shoulders. This puts Carl's muzzle just inches from the young student's crotch. Brushing his nose against the glisteningly wet folds of Eric's feminine sex, the husky takes a deep huff of air and lets out an aroused rumble from deep in his throat. 'Fucking sexy,' he compliments Eric out of mostly closed lips, then uses his fingers to part the college athlete's nether lips.";
	say "     Carl rubs his wet nose against the opening of Eric's even wetter pussy, reveling in the scent of his sexy friend mixed with your own, then opens his muzzle. As the anthro canine sticks his long tongue into the cuntboy's vagina, the frothy mixture of cum and spit he held in his mouth slides down over the twitching muscle and right into Eric's depths, who moans loudly at the treatment his friend is giving him. 'You like that, don't you?' the soldier teases his friend, then uses a finger to stroke over Eric's clit just as he opens his mouth, making his reply nothing more but a drawn-out moan.";
	WaitLineBreak;
	say "     Inserting two fingers into the trans teen's pussy, Carl continues to push his cum deeper into Eric to make sure he's well-filled in both holes, all the while keeping his thumb on the human student's clit and rubbing it with circling movements. The sensations of being touched in this way drive Eric wild and he begins panting faster and faster, letting out moans in rising urgency. When Carl then switches to not only fingering but also lapping at Eric's clit with his tongue, this drives the athletic student over the edge. He orgasms with a climactic shout, legs twitching as they cross over Carl's back and pull the husky even tighter against his friend's crotch. Of course, Carl knows Eric quite well by now and is prepared for that - he just keeps lapping at his friend's crotch and slurps up the femcum that starts to leak from his folds.";
	say "     Eventually sliding Eric's legs from over his shoulders and allowing the young student to stretch out fully on the sofa, Carl straightens up and looks down at his naked friend. A broad smile is on his face as he feasts his eyes on the lithe teenager, his tail wagging up a storm at the same time. 'Rrr-woof! Was Carl a good doggie?' the soldier asks in a playful tone as he looks over to you, getting a grin and thumbs-up in reply. Then Carl lowers himself into a push-up position on top of Eric, lapping at his hairless and sweaty chest to work his way up to coming face to face with Eric. 'You're definitively taking the 'man's best friend' bit to new levels Carl,' comes a happy comment, together with Eric running his hand through the thick fur on the anthro husky's neck and pulling him into another bout of making out.";
	LineBreak;
	say "     Worn out from fucking Eric, you bid your two friends farewell for now and grab your gear to clean up and get dressed afterwards. As you move away from the site of your steamy threesome, the two of them stay lying on the sofa together. From a snippet of conversation you catch as you walk off, they start to talk about their favorite songs next. The effortless switch to typical guy-talk between friends after having just gotten their rocks off with each other puts a smile on your face. Eric and Carl are definitively an interesting pair - seems like something just clicked between the two young men after meeting not so long ago.";
	increase EricAnalCounter by 1;

to say EricCarlThreesome3: [fuck Carl's muzzle while Eric blows him]
	say "     Both the husky and human share eager looks as you tell them what you want to do, then quickly take their positions - Carl stretched out lengthwise on his back, with Eric on all fours between his legs. The canine soldier pushes his upper body up on his elbows and gives Eric a huge grin. 'Yeah baby! Lick that head good,' he pants in an aroused tone, prompting the red-headed student to bring his face close over his crotch and reply teasingly, 'You mean like this?' That said, Eric slowly runs his tongue up the underside of Carl's erection until soon reaching its pointy head, then circles Carl's glans with the tip of his tongue. 'Nnnnghh!' the anthro canine grunts in clear arousal and puts a hand on his friend's head, affectionately tousling his hair a little before pulling Eric down to engulf his cock - taking all of it down to the base.";
	say "     After Eric starts to bob up and down on Carl's shaft, filling the library with slurps and moans from the aroused husky, you yourself step up to the end of the sofa. Standing behind the stretched-out canine, you reach around Carl to run a hand over his soft-furred chest, feeling his abs and pecs. After caressing his nipples for a moment, finding and lightly pinching them, your fingers then move on to petting the transformed soldier's neck. As you keep stroking him, Carl leans his head back further and further, looking up at you with a pleased smile - followed by a grin as the erect [cock of player] shaft between your legs comes into his line of sight. The anthro husky's nostrils widen as he takes in the scent of your arousal - also shown by a glistening drop of pre forming at the cum-slit of your hard prick. You smile at the eager wag of Carl's tail-tip (which is all that is looking out from under his lying form) and the swiftness with which he lays back fully, head stretched out over the edge of the upholstery.";
	WaitLineBreak;
	say "     Bending your legs a little, you bring your cock close to the furry soldier's muzzle and earn an immediate lick from the aroused canine. His long and wet tongue feels amazing as it plays over your cock and you get the sensation of his nose pressing against your balls. You enjoy some moments of cock worship by Carl, with him huffing the musky scent of your cock and balls and lapping you, then eventually pull back a little, running a hand down the muzzle of the muscled man. Carl licks your fingers and allows you to pull open his maw, holding the slobbering tongue up with your thumb as you line yourself up and slide your prick into his open mouth. It feels great to rub your shaft along the broad length of his tongue and start thrusting in and out, face-fucking the horny guy.";
	say "     Carl is more than happy to be part of a blow-job-chain, enjoying the eager attention of Eric while himself is being face-fucked. The three of you continue to fill the library with moans and grunts for quite a while, although the sounds are rather muffled on the part of your friends, both of them with dicks in their mouths. Soon, you do notice Carl's breath coming faster and him panting around your hard cock - a clear sign of the canine running hot. Then suddenly, he pushes against your crotch in a gentle but determined manner, letting go of your cock and raising his head to look down at Eric. 'Getting real close now buddy,' the canine soldier barks breathlessly, tapping Eric's shoulder with some urgency - and the pale-skinned student pulls his head back barely in time, lips stretching wide around Carl's rapidly swelling knot, then pulls off the bulge with a loud pop.";
	WaitLineBreak;
	say "     Panting a little as he looks upon Carl's erection and watches the knot reach its full size in seconds, Eric's eyes go wide as the first blast of canine cum erupts from the pointy cock-head and hits him. With his forehead and red hair now marked by a white streak, the transgendered student quickly reacts by plunging his mouth back down towards Carl's twitching manhood. The next spurt shoots out right as he is starting to open wide and paints Eric's lips and tongue with creamy cum. After that, the athletic student is back to sucking on the canine dick of his fuck-buddy - catching further eruptions of canine seed with his mouth while jerking Carl with one hand.";
	say "     The muscular soldier bucks on the sofa and reflexively thrusts his hips up towards Eric as he orgasms, grunting loudly with each new shot until he eventually sinks back in exhaustion. 'Phew,' he pants after a few moments of just lying there in post-orgasmic bliss. 'That was something else! You're getting good at this,' Carl says after raising his head to look at Eric - who still is gently suckling at his cock-head. The soldier smiles broadly as their eyes meet, then he hooks a hand behind Eric's neck and sits up, guiding the transgendered teen into making out. Tail wagging in a rapid beat against the sofa (now that he's no longer lying on top of it), Carl slips Eric his tongue in a deep french kiss. As they eventually pull apart, strings of frothy cum stretch between their lips for a second. Looks like the husky slurped quite a bit of his own cum from Eric's mouth.";
	WaitLineBreak;
	say "     Looking over his shoulder, Carl gives you a questioning look with one raised eyebrow, as if asking if he should get back to being face-fucked - but you just give him a knowing smile and a nod towards Eric. His tail wags wildly as he winks at you, then the husky soldier says, 'Payback time.' After those half-mumbled words (from having a load of cum in his mouth) he executes what could almost be a wrestling move - getting his legs under him and bowling Eric over on the sofa to fall back on the soft upholstery. In a quick follow-up move, the anthro canine gets a grip on his human friend's legs and hikes them up over his own furred shoulders. This leaves Eric in almost a headstand, with Carl's muzzle just inches from his crotch. Brushing his nose against the glisteningly wet folds of Eric's feminine sex, the husky takes a deep huff of air and lets out an aroused rumble from deep in his throat. 'Fucking sexy,' he compliments Eric out of mostly closed lips, then uses his fingers to part the college athlete's nether lips.";
	say "     Carl rubs his wet nose against the opening of Eric's even wetter pussy, reveling in the scent of his sexy friend, then opens his muzzle. As the anthro canine sticks his long tongue into the cuntboy's vagina, the frothy mixture of cum and spit he held in his mouth slides down over the twitching muscle and right into Eric's depths, who moans loudly at the treatment his friend is giving him. 'You like that, don't you?' the soldier teases his friend, then uses a finger to stroke over Eric's clit just as he opens his mouth, making his reply nothing more but a drawn-out moan. Meanwhile having stepped up on the sofa yourself, erect [cock of player] shaft leading the way to get you standing over the upside-down Eric, your erection being right at eye-level for Carl and over the trans teen's crotch too.";
	WaitLineBreak;
	say "     Jerking off at the sexy sight of both Eric's cum-smeared pussy as well as Carl's wide-open muzzle with its tongue stretched out in anticipation of your load, it doesn't take long before you get closer and closer to your own climax. With one hand tightly wrapped around your erection, the other stroking the inside of Eric's legs, the tingly feeling of impending release builds up to a boiling point just moments later and you start blasting away with hot seed. The first splash of it draws a white line across Carl's tongue, followed by another, then you aim lower and cream Eric's spread-open nether lips. Intense as the blast is, this causes cum splatter to land all over his crotch, and yours, as well as Carl's muzzle. The next eruption then hits Eric's hole exactly as you aim steeper down and most of it vanishes into the depths of his vagina.";
	say "     Standing like that, you continue to come onto Eric and fill the depression between his nether lips with creamy cum. The sight of such a sweet, naked transgender teen covered in your load sends a pleasant shiver down your back. You can't help yourself but set a capstone on top of the pleasure you had together - by pressing your still pretty hard erection in against his pussy and pushing the cum deeper. Having already licked cum off his muzzle and swallowed it eagerly, Carl looks up at you and gives a playfully pleading whine, so after withdrawing from Eric you hold your dick out for him to clean. A few moments of happy lapping later, your [cock of player] shaft is clean of cum (if rather wet with dog slobber) and Carl turns his attention towards Eric.";
	WaitLineBreak;
	say "     Turned on by the sight of more cum around Eric's pussy lips, Carl runs his fingers through the sticky fluid and pushes it towards the opening, then inserts two fingers into the trans student. Barking happily, Carl continues to push your cum deeper into Eric, mixing with his own deposit, all the while keeping his thumb on the human student's clit. As he continually rubs the 'magic button' of the teenager with circling movements, Eric trembles in pleasure under Carl's touch, then gasps, 'Yessss...! That feels great!' The sensations of being touched in this way drive Eric wild and he begins panting faster and faster, letting out moans in rising urgency. When Carl then switches to not only fingering but also lapping at Eric's clit with his tongue, this drives the athletic student over the edge. He orgasms with a climactic shout, legs twitching as they cross over Carl's back and pull the husky even tighter against his friend's crotch. Of course, Carl knows Eric quite well by now and is prepared for that - he just keeps lapping at his friend's crotch and slurps up the femcum that starts to leak from his folds.";
	say "     Eventually sliding Eric's legs from over his shoulders and allowing the young student to stretch out fully on the sofa, Carl straightens up and looks down at his naked friend. A broad smile is on his face as he feasts his eyes on the lithe teenager, his tail wagging up a storm at the same time. 'Rrr-woof! Was Carl a good doggie?' the soldier asks in a playful tone as he lowers himself into a push-up position on top of Eric, lapping at his hairless and sweaty chest to work his way up to coming face to face with Eric. 'You're definitively taking the 'man's best friend' bit to new levels Carl,' comes a happy reply, together with Eric running his hand through the thick fur on the anthro husky's neck and pulling him into another bout of making out.";
	LineBreak;
	say "     Worn out from fucking Eric, you bid your two friends farewell for now and grab your gear to clean up and get dressed afterwards. As you move away from the site of your steamy threesome, the two of them stay lying on the sofa together. From a snippet of conversation you catch as you walk off, they start to talk about their favorite songs next. The effortless switch to typical guy-talk between friends after having just gotten their rocks off with each other puts a smile on your face. Eric and Carl are definitively an interesting pair - seems like something just clicked between the two young men after meeting not so long ago.";

to say EricCarlThreesome4: [Player fucks Carl's ass while he eats Eric's pussy]
	project the figure of Carl_Eric_sofa_fuck_3_icon;
	say "     Both the husky and human share eager looks as you tell them what you want to do, then quickly take their positions - Carl kneeling at the end of the sofa, his paws hanging over the edge and Eric stretched out lengthwise in front of him. As the canine soldier then leans forward to lower his muzzle to his transgendered friend's pussy, his ass sticks out very invitingly. The excitedly wagging tail of your husky companion tells you that he's looking forward to what you'll do next. 'Nnnghhh! Yes! Oooh that feels good,' Eric gasps as Carl takes a first lap at his crotch, playing his long floppy tongue over the cuntboy's folds. As he starts licking in earnest, you yourself step up behind him, jerking your erect [cock of player] shaft.";
	say "     Catching the husky's tail with one hand, you stroke over its soft fur and pull the appendage aside, then line your dickhead up with Carl's pucker. Gently brushing against it with your erection makes Carl tense for a moment, then relax visibly as he prepares himself to being fucked. As you press forward a little, you feel his muscle pushing back against you - he is trying to make penetrating him easier for both of you. Still, some lube might be needed... and thankfully you got a handy source for it, right between Carl's legs. Reaching down, you slide a hand over his furry balls and give them a quick fondle, then move further down to stroke his canine shaft. After just a little bit of rubbing his pointy cock-head, you manage to gather a copious amount of pre-cum in the palm of your hand - a clear sign just how horny this situation is making Carl.";
	WaitLineBreak;
	say "     Looking over at Eric as he is lying on the sofa, moaning loudly thanks to Carl's ministrations, you slide your hand up and down your [cock of player] shaft and make sure it is well-lubed with the canine soldier's own pre-cum. Then it is time to line the glistening head of your shaft up with his rear entrance and to push inside. Grunting in satisfaction as you penetrate after an initial moment of resistance, you feel Carl's inner walls stretch tightly around your shaft. Going slow at first, you slide deeper into the muscular soldier's asshole, enjoying every moment of feeling his hot, tight hole gripping your prick. It is quite obvious when you find Carl's prostate a moment later - as the husky's whole body trembles in lust and he gives a pleased yip, somewhat muffled as he has his nose buried in Eric's pubes, with his tongue wiggling inside the young guy's pussy.";
	say "     You run your hands down Carl's back, enjoying the feel of his soft fur under your hands as you just stay still for a moment, dickhead pressed right against his magic spot. Best to give him a little bit of time to get used to your cock in his ass and feel your rapid heartbeat through the throb of that [cock of player] shaft. The pause comes to a stop as you put your hands on his hips, digging their fingers into his luxurious fur and gripping on to Carl tightly - then sink the rest of your cock into him with a sudden thrust. A shared moan and bark echoes through the library, followed my more noises of excitement and lust as you start fucking Carl in earnest, hammering into his furry ass mercilessly. In turn, the anthro canine goes wild on Eric's pussy, grinding his wet nose against the trans teen's clit while slurping and licking at him.";
	WaitLineBreak;
	say "     As your [cock of player] dick keeps sawing in and out of Carl's ass with a fast-paced rhythm, you can feel him get more and more aroused by this treatment - though the twitches and flexing of his anal muscles as well as the ever faster beat of his wagging tail against the side of your hips. He is too busy eating Eric out to do much more than grunt and growl in pleasure, until he suddenly pushes himself up with both arms and twists his upper body to look at you. 'This feels SO FUCKING GOOD!' the husky barks out in a lusty tone, then pulls your head close to share a sloppy kiss. When he turns back to Eric, a broad grin spreads over his muzzle. Leaning forward, Carl slides his strong hands under both of the teenager's spread legs, then growls, 'Eric - I'm gonna pound you like a bitch!'";
	say "     With that, the muscular soldier gives a sudden heave and pulls Eric closer, ramming his canine shaft home between his pussy lips in one move. Almost as if in slow-motion, you see the red-headed student's eyes go wide and his mouth open to let out a loud aroused moan, then time catches up with the action again and Eric wraps his arms and legs around Carl to hold on for dear life. The husky pounds into his pale-skinned buddy like a wild animal, humping him hard and lapping at his naked mate, tongue slurping the sweaty skin of Eric's neck and pecs. In turn, he fucks himself on your shaft too, the ring of his pucker sliding up and down your length as he thrusts again and again. Of course, this doesn't mean that you stop your own movements, and Eric's moans rise to new heights each time the thrusts line up - Carl into him and yourself into Carl, driving the canine cock even deeper.";
	WaitLineBreak;
	say "     Such no holds barred fucking pushes Eric past his limits in short notice, and with a satisfied scream, he digs his fingers into Carl's back fur, trembling wildly as an orgasm breaks over him like a tsunami. The almost out of control husky growls in satisfaction at getting off the cuntboy bitch he is mating and grinds himself even harder against Eric, joining the athletic student in his completion just moments later. With the knot on his nonhuman cock swelling up in mere heartbeats and locking the two of them together tightly, his furry balls start pulsing with blast after blast of canine seed that erupts into Eric's vagina, then even straight into his womb as Carl thrusts deeper and penetrates his cervix with just the pointy tip of his shaft.";
	say "     Meanwhile, you yourself feel Carl's inner muscles tense around your erection with each new spurt of his cum into Eric. It is almost as if he is jerking you off inside his ass - which was already nice and snug around your dick. As a result, you join your two friends in orgasm pretty soon, painting Carl's insides white with cum. Overwhelmed by the first eruption of your load into him, you hold on to the soldier to stay on your feet, then lean and brace against him, head resting on his muscled back. While your shaft keeps throbbing with spurt after spurt of more cum, your nose is pressed into Carl's fur, huffing the musky scent of a horny, sweaty husky.";
	WaitLineBreak;
	say "     Eventually coming down from your respective orgasmic highs, the three of you stay in an entwined tangle for a little while longer yet as you catch your breaths. When you gently pull out of Carl, a little gush of cum seeps out of him with your dick, immediately soaking into the fur below. Looking down upon the pink ring muscle pulling tight to keep the rest of your load inside him, as well as the cum-matted fur, you can't help but smile. Patting the canine soldier's back, you tell him you had a lot of fun, then slide your hand under one of Eric's and give him a squeeze too. Both of them reply in kind, Eric flushing a little as he says that he really enjoyed the sex while Carl just confidently adds that he's looking forward to the next time.";
	say "     As you start getting dressed, the husky and human kiss deeply, then Carl pushes himself up on his elbows and looks down between their bodies to where they are pressed together at the hip, his erection still tied to Eric's pussy. 'Guess you're pretty used to this from college, eh? Going to the library to bone up really good. And getting help from your friends when you get tied in - well, with - a knot, hah.' Eric gapes at his friend for a second, amazed that Carl switched instantly from sex to silly puns. Then he can't help but laugh at the friendly husky with the wagging tail on top of him and pulls him in for another sloppy kiss. As he lets go of Carl a moment later, allowing the soldier to pull away, Eric gives him a naughty grin and replies, 'Sure thing. And I'm also used to my dog getting really excited about burying his bone in one specific spot. Putting it in, and out, in and out. Creatures of habit, those canines...'";
	WaitLineBreak;
	say "     As the two unlikely friends continue with little jokes and puns, in between caressing and kissing while they wait for Carl's knot to go down, you finish putting on your clothes and gear, then quietly walk back to the front desk of the library. Funny thing, just how good a friend those two found in one another, in the midst of all the chaos going on in this city. Sure, they fuck one another as do most creatures out on the streets, but there is definitively something more to their relationship. Something just clicked there, and you think they would have become best friends no matter what if they had met one another outside these circumstances.";

to say EricCarlThreesome5: [player gets a BJ from Carl while he hammers Eric's pussy]
	say "     Both the husky and human share eager looks as you tell them what you want to do, then quickly take their positions - Eric stretched out lengthwise on the sofa, with Carl kneeling between his spread legs. The canine soldier leans over his human friend and gives him an eager kiss on the lips, playfully wrestling tongues for a moment, then pulls back a little. 'You're such a sexy guy Eric,' Carl tells him in a husky tone, panting a little in his heavy arousal. As the muscular anthro takes hold of his erect cock and gently brushes its tip against Eric's nether lips, the teenager lets out a loud sigh and replies, 'Yesss... ooh, that feels just... god, Carl!' Wrapping his arms around the chest of his furry companion, Eric pulls Carl down on himself and kisses him deeply - and the horny soldier slides into Eric's waiting pussy at the same time.";
	say "     You watch the two of them make out ecstatically as Carl sinks his bone deeper and deeper into Eric. He enters his friend with the long red-skinned shaft dangling between his legs until just the yet un-swollen little bulge of his knot is outside - then gives a sharp thrust and bottoms out with a satisfied grunt. For a moment, movement between them stops and they just hold on to one another, then a panting Eric plants a soft peck on Carl's muzzle and gasps out, 'Fuck me, please!' Sinking back on the sofa cushions and digging his hands in to get a secure grip, the college athlete gives himself fully to the strong soldier on top of him, ready for Carl to go wild. The anthro husky takes things slow at first, leaning in to lick from Eric's nipples over his neck to lightly nip at his earlobe. 'You're in for a wild ride with this doggie,' he says teasingly, then pulls most of his shaft out of Eric and hammers it home again, and again - starting to fuck the young man in earnest now.";
	project the figure of Carl_Eric_sofa_fuck_3_icon;
	WaitLineBreak;
	say "     Observing the sight of a steaming hot coupling between an anthro furry and human, you almost could stay where you are and keep watching - but then the throbbing shaft between your legs demands that you get some action yourself. Never taking eyes of the gyrations of Eric and Carl as they move against one another on the sofa, you step up on the cushions yourself, coming to stand above Eric with your legs planted a little to the left and right of his head. This puts Carl's canine muzzle quite close to your crotch, and when you put a hand on the furred soldier's head, he looks up to take in your naked form and grins widely. It is just a matter of bending your legs a little to put your hard [cock of player] shaft directly in front of his muzzle, where it is subject to a welcoming lick right away.";
	say "     Slowing the rhythm of pounding Eric down to a gentler - but quite deep - grind of his canine cock into the cuntboy's pussy, Carl lets his long tongue play over your cock for a moment. Then he proceeds to press his wet nose against your balls, lapping away at them with flicks of his floppy canine tongue. You enjoy a little while of ball worship by Carl, with him huffing the musky scent of your crotch and lapping away at you, then eventually pull back a little, running a hand down the muzzle of the muscled man. Carl licks your fingers and allows you to pull open his maw, your thumb sliding over the soft slobbering tongue as you line yourself up. Easily sliding your prick into his open mouth, it feels great to rub its shaft along the broad length of his tongue and start thrusting in and out, face-fucking the horny soldier.";
	WaitLineBreak;
	say "     Carl is more than happy to service you while still fucking Eric in a steady rhythm, enjoying the soft moans that his trans friend makes while he takes the canine's cock. The three of you continue to fill the library with moans and grunts for quite a while, although the sounds are rather muffled on the part of Carl, with a dick in his mouth. Soon, you do notice Carl's breath coming faster and him panting around your hard cock - a clear sign of the canine running hot. Then suddenly, he pushes against your crotch in a gentle but determined manner, letting go of your cock and lowering his head to look down at Eric. 'Getting real close now buddy,' the canine soldier barks breathlessly, flicking an ear at Eric in a questioning gesture. The slender teen looks up into his eyes, then lets out an aroused sigh of, 'Do it - knot me, Carl!'";
	say "     With a lusty growl, Carl thrusts forward against Eric's crotch with renewed force, really humping him and even pushing Eric a little bit along the cushions before he gets a more secure grip. From your standing point over the two of them, you have a very good view of Carl's body going stiff as he lets out a satisfied growl and starts flooding Eric's womb with his canine seed. Rapidly swelling up in little more than a few heartbeats, the bulging knot at the base of the soldier's cock locks the two of them together - all in a bid to ensure that he can impregnate the human bitch he just mated. The sensation of getting bred winds Eric up more than just a little bit, with the knot and throb of Carl's shaft against his inner walls, and he joins his friend in orgasm almost instantly, writhing on the sofa as Carl covers him with his larger furred body.";
	WaitLineBreak;
	say "     You are quite close to getting off yourself after the pretty neat time with Carl's muzzle and watching your two companions come. So much so that you decide that you won't wait for Carl to get back to sucking - he's still twitching in orgasm and holding on to his knotted mate, after all. Gripping your glistening wet [cock of player] erection, you move your hand up and down along its shaft and jerk off - which quickly serves to drive your arousal past the point of no return. Grunting in lust, you grip your manhood tightly and feel the twin orbs of your balls pull up a bit, sending forth a first long spurt of cum that leaves a white streak over Carl's back and the base of his tail. Another and another blast of your seed follows, the third one splashing the inside of Eric's spread legs and everything after that finding its target in the increasingly sticky fur of the big canine under you.";
	say "     Carl takes being creamed by you in stride, looking up for a second and grinning, then wiping up some of the wetness on the small of his back and demonstratively licks his hand clean with a swipe of that canine tongue of his. Wagging his tail, the husky opens his muzzle to say something - but a slender arm suddenly slides around his neck and pulls him back down to Eric for a kiss. 'That was amazing,' the college student says in a happy tone as they come back up for air, earning him a deep kiss from Carl in reply. Patting the canine soldier's back, you tell him you had a lot of fun, then slide your hand under one of Eric's and give him a squeeze too. Both of them reply in kind, Eric flushing a little as he says that he really enjoyed the sex while Carl just confidently adds that he's looking forward to the next time.";
	WaitLineBreak;
	say "     As you start getting dressed, the husky and human keep making out for a moment, then Carl pushes himself up on his elbows and looks down between their bodies to where they are pressed together at the hip, his erection still tied to Eric's pussy. 'Guess you're pretty used to this from college, eh? Going to the library to bone up really good. And getting help from your friends when you get tied in - well, with - a knot, hah.' Eric gapes at his friend for a second, amazed that Carl switched instantly from sex to silly puns. Then he can't help but laugh at the friendly husky with the wagging tail on top of him and pulls him in for another sloppy kiss. As he lets go of Carl a moment later, allowing the soldier to pull away, Eric gives him a naughty grin and replies, 'Sure thing. And I'm also used to my dog getting really excited about burying his bone in one specific spot. Putting it in, and out, in and out. Creatures of habit, those canines...'";
	say "     As the two unlikely friends continue with little jokes and puns, in between caressing and kissing while they wait for Carl's knot to go down, you finish putting on your clothes and gear, then quietly walk back to the front desk of the library. Funny thing, just how good a friend those two found in one another, in the midst of all the chaos going on in this city. Sure, they fuck one another as do most creatures out on the streets, but there is definitively something more to their relationship. Something just clicked there, and you think they would have become best friends no matter what if they had met one another outside these circumstances.";

to say EricCarlThreesome6: [player gets BJ from Eric while he straddles Carl's face]
	say "     Both the husky and human share eager looks as you tell them what you want to do, then quickly take their positions - Carl stretched out lengthwise on his back, with Eric straddling his muscled chest. The canine soldier starts stroking his cock while grinning up at his human friend, then raises his head and gives the college athlete a first lick over his nether lips. 'Oooh yes, Carl! That feels so good!' Eric pants in a lust-filled tone, stroking his furry friend's head and rubbing behind his ears. 'Have I ever told you that you taste amazing,' Carl says in between licks, then buries his muzzle in Eric's trimmed pubes and huffs deeply. 'And the scent could drive a guy wild, you sexy beast,' he adds after that, then attacks Eric's clit, sucking on it with pursed lips.";
	say "     'OH GOD!' comes a loud scream of lust from your transgendered friend and Eric sways a little as his knees get weak. Head thrown back and with his mouth open in almost constant moaning, the slender student starts to lean backwards just a little too much - so much so that you have to grab him by the hand so he doesn't fall over on top of Carl. The look of his blushing face at losing control of himself so easily makes you laugh, then console him that it is alright... you've got him now. Typical of his shy nature, Eric replies with a happy smile and the start of a 'Thank you' - which leads over into a breathless moan as Carl plays his tongue over just the right spot.";
	WaitLineBreak;
	say "     Keeping hold of Eric's hand to keep him steady, you move up on the sofa at the same time, coming to stand over Carl and his human friend, feet planted a bit to the left and right of Carl's head. Then you guide Eric's hands to your hips, giving him something new to hold onto and freeing your hands to do something else. Like gently pulling Eric's head towards your erect [cock of player] shaft for example. It takes no effort at all to get the young man to lick at your cock, then slide his sweet lips over its head to go down on you. Eric eagerly gives you a pretty good blow-job while having Carl pleasure him in turn.";
	say "     The three of you fill the library with moans, pants and even the odd bark and growl from Carl, everyone enjoying the sensations of shared arousal immensely. The situation heats up more and more with every moment of touching, licking, caressing and sucking - until soon, Carl draws everyone's attention down towards him with an urgent bark. Panting audibly, his tongue hanging out and sometimes touching Eric's crotch as he moves a little, Carl says, 'Getting kinda close here and... I want to feel you around my dick as I come, Eric. You ready for some doggie loving, big guy?' You can just imagine how wildly Eric's tail would beat if he was a canine like Carl, so clear is his joy at the not at all innocent question from his friend. With an eager expression, he replies in a very straightforward, 'Take me!'";
	WaitLineBreak;
	say "     Carl is quick to shimmy his body along the sofa cushions, getting into position with now his crotch right under Eric's straddling hips. The anthro husky's canine shaft is almost painfully erect, glistening with precum smeared all over its length from when he was jerking it. Reaching out to rub Eric's clit a little with his thumb, Carl guides the college athlete's hips further down slowly - proving an impressive level of restraint in the very, very horny male. Still, there is a limit just how well even Carl can control himself... and as the tip of his shaft nudges apart Eric's dripping pussy lips, that point is reached. With a growl more akin to a wolf than a dog, the husky thrusts his hips up forcefully, driving all of himself - including the already half-swollen knot - into Eric!";
	say "     The sudden deep penetration and wild thrusts from the desperately aroused soldier rock Eric to his core and you have to step up to hold him up once more. Their coupling is quite intense and given how close he already was, it doesn't take long until Carl bucks into Eric's pussy while grunting deeply, flooding the transgendered human with his seed. Knotted and being bred by his canine friend, Eric follows Carl in orgasm just moments later, sighing prettily in arousal as he reaches his climax. Trembling and caressing one another, the two of them ride out their lust together - which just leaves you the odd one out, proudly erect but not having gotten off yet.";
	WaitLineBreak;
	say "     As Eric is till panting breathlessly and holding on to you for support, a blow-job is out and you can't just step away - so you decide to jerk off right where you are. With your trusty hand wrapped around the shaft of your [cock of player] erection and a sexy naked human-husky duo to look at, it takes mere moments before you feel a tingly sensation build in your balls, then blow a creamy load all over Eric, splashing his slender chest with streaks of cum. By the time your own orgasm runs its course, Eric has gotten his breath back and smiles up at you. 'Glad to see that everyone enjoyed themselves,' the college student says happily, then wipes a little of your seed off his chest and licks it off his finger playfully. Patting Eric's shoulder, you tell him you had a lot of fun, then step off the sofa and stroke Carl's side, giving his arm a friendly squeeze. Both of them reply in kind, Eric flushing a little as he says that he really enjoyed the sex while Carl just confidently adds that he's looking forward to the next time.";
	say "     While you start getting dressed, the husky and human start making out for a moment, then Carl pushes himself up on his elbows and looks down between their bodies to where they are pressed together at the hip, his erection still tied to Eric's pussy. 'Guess you're pretty used to this from college, eh? Going to the library to bone up really good. And getting help from your friends when you get tied in - well, with - a knot, hah.' Eric gapes at his friend for a second, amazed that Carl switched instantly from sex to silly puns. Then he can't help but laugh at the friendly husky with the wagging tail on top of him and pulls him in for another sloppy kiss. As he lets go of Carl a moment later, allowing the soldier to pull away, Eric gives him a naughty grin and replies, 'Sure thing. And I'm also used to my dog getting really excited about burying his bone in one specific spot. Putting it in, and out, in and out. Creatures of habit, those canines...'";
	WaitLineBreak;
	say "     As the two unlikely friends continue with little jokes and puns, in between caressing and kissing while they wait for Carl's knot to go down, you finish putting on your clothes and gear, then quietly walk back to the front desk of the library. Funny thing, just how good a friend those two found in one another, in the midst of all the chaos going on in this city. Sure, they fuck one another as do most creatures out on the streets, but there is definitively something more to their relationship. Something just clicked there, and you think they would have become best friends no matter what if they had met one another outside these circumstances.";

to say EricCarlThreesome7: [player grinds their pussy against Carl's muzzle while Eric blows him]
	say "     Both the husky and human share eager looks as you tell them what you want to do, then quickly take their positions - Carl stretched out lengthwise on his back, with Eric on all fours between his legs. The canine soldier pushes his upper body up on his elbows and gives Eric a huge grin. 'Yeah baby! Lick that head good,' he pants in an aroused tone, prompting the red-headed student to bring his face close over his crotch and reply teasingly, 'You mean like this?' That said, Eric slowly runs his tongue up the underside of Carl's erection until soon reaching its pointy head, then circles Carl's glans with the tip of his tongue. 'Nnnnghh!' the anthro canine grunts in clear arousal and puts a hand on his friend's head, affectionately tousling his hair a little before pulling Eric down to engulf his cock - taking all of it down to the base.";
	say "     After Eric starts to bob up and down on Carl's shaft, filling the library with slurps and moans from the aroused husky, you yourself step up to the end of the sofa. Standing behind the stretched-out canine, you reach around Carl to run a hand over his soft-furred chest, feeling his abs and pecs. After caressing his nipples for a moment, finding and lightly pinching them, your fingers then move on to petting the transformed soldier's neck. As you keep stroking him, Carl leans his head back further and further, looking up at you with a pleased smile - followed by a grin as the moist pussy between your legs comes into his line of sight. The anthro husky's nostrils widen as he takes in the scent of your arousal and he licks his lips in anticipation. You smile at the eager wag of Carl's tail-tip (which is all that is looking out from under his lying form) and the swiftness with which he lays back fully, head stretched out over the edge of the upholstery.";
	WaitLineBreak;
	say "     Bending your legs a little, you bring your crotch close to the furry soldier's muzzle and earn an immediate lick from the aroused canine. His long and wet tongue feels amazing as it plays over your nether lips and you get the sensation of his nose pressing against your skin. You enjoy some moments of pussy worship by Carl, with him huffing the musky scent of your crotch and lapping you, then eventually pull back a little, running a hand down the muzzle of the muscled man. Carl licks your fingers and allows you to pull open his maw, holding the slobbering tongue up with your thumb and getting your fingers nice and wet with spit. Telling the husky to tongue-fuck your pussy, you grind your hips forward against him - and Carl is more than eager to comply, wagging his tongue in just the right way. It feels great to rub your sensitive clit with two slick fingers while slowly humping the furry male's face.";
	say "     Carl happily serves as the middle of an oral sex chain, enjoying the eager attention of Eric while himself is tongue-deep in your pussy. The three of you continue to fill the library with moans and grunts for quite a while, although the sounds are rather muffled on the part of your friends, both of them with dicks in their mouths. Soon, you do notice Carl's breath coming faster and him panting hotly against your fingers as they gyrate against your magic button - a clear sign of the canine running hot. Then suddenly, he pushes against your crotch in a gentle but determined manner, slurping in the tongue and raising his head to look down at Eric. 'Getting real close now buddy,' the canine soldier barks breathlessly, tapping Eric's shoulder with some urgency - and the pale-skinned student pulls his head back barely in time, lips stretching wide around Carl's rapidly swelling knot, then pulls off the bulge with a loud pop.";
	WaitLineBreak;
	say "     Panting a little as he looks upon Carl's erection and watches the knot reach its full size in seconds, Eric's eyes go wide as the first blast of canine cum erupts from the pointy cock-head and hits him. With his forehead and red hair now marked by a white streak, the transgendered student quickly reacts by plunging his mouth back down towards Carl's twitching manhood. The next spurt shoots out right as he is starting to open wide and paints Eric's lips and tongue with creamy cum. After that, the athletic student is back to sucking on the canine dick of his fuck-buddy - catching further eruptions of canine seed with his mouth while jerking Carl with one hand.";
	say "     The muscular soldier bucks on the sofa and reflexively thrusts his hips up towards Eric as he orgasms, grunting loudly with each new shot until he eventually sinks back in exhaustion. 'Phew,' he pants after a few moments of just lying there in post-orgasmic bliss. 'That was something else! You're getting good at this,' Carl says after raising his head to look at Eric - who still is gently suckling at his cock-head. The soldier smiles broadly as their eyes meet, then he hooks a hand behind Eric's neck and sits up, guiding the transgendered teen into making out. Tail wagging in a rapid beat against the sofa (now that he's no longer lying on top of it), Carl slips Eric his tongue in a deep french kiss. As they eventually pull apart, strings of frothy cum stretch between their lips for a second. Looks like the husky slurped quite a bit of his own cum from Eric's mouth.";
	WaitLineBreak;
	say "     Looking over his shoulder, Carl gives you a questioning look with one raised eyebrow, as if asking if he should get back to tonguing your pussy - but you just give him a knowing smile and a nod towards Eric. His tail wags wildly as he winks at you, then the husky soldier says, 'Payback time.' After those half-mumbled words (from having a load of cum in his mouth) he executes what could almost be a wrestling move - getting his legs under him and bowling Eric over on the sofa to fall back on the soft upholstery. In a quick follow-up move, the anthro canine gets a grip on his human friend's legs and hikes them up over his own furred shoulders. This leaves Eric in almost a headstand, with Carl's muzzle just inches from his crotch. Brushing his nose against the glisteningly wet folds of Eric's feminine sex, the husky takes a deep huff of air and lets out an aroused rumble from deep in his throat. 'Fucking sexy,' he compliments Eric out of mostly closed lips, then uses his fingers to part the college athlete's nether lips.";
	say "     Carl rubs his wet nose against the opening of Eric's even wetter pussy, reveling in the scent of his sexy friend, then opens his muzzle. As the anthro canine sticks his long tongue into the cuntboy's vagina, the frothy mixture of cum and spit he held in his mouth slides down over the twitching muscle and right into Eric's depths, who moans loudly at the treatment his friend is giving him. 'You like that, don't you?' the soldier teases his friend, then uses a finger to stroke over Eric's clit just as he opens his mouth, making his reply nothing more but a drawn-out moan. Meanwhile having stepped up on the sofa yourself, your needy pussy is in everyone's view as you come to stand standing over the upside-down Eric, putting your crotch right at eye-level for Carl.";
	WaitLineBreak;
	say "     The panting husky stretches his neck and laps between your legs, drawing a number of pleased moans from you as he goes on for a while - but eventually, you pat his furry head and gently push him away. Carl is about to ask why he shouldn't get you off, but before he can say anything, you start grinding your crotch against Eric's - clit rubbing against clit, bringing great pleasure to both of you. The usually so quiet teenager gasps, 'Yessss...! Nghh! That feels great!' and goes through little muscle twitches as his body becomes awash with even greater arousal. One of those reflexive movements in his legs pulls Carl closer with a sudden wrench, making the husky bump into your pubes with his wet nose - and the sly dog quickly reacts by starting to lap again, both at Eric's pussy lips as well as your own sensitive skin.";
	say "     Between the rubbing and getting licked by a very eager anthro dog, both Eric and yourself are rapidly driven to orgasm, barreling past the point of no return like rocket-ships. Two voices fill the library with orgasmic shouts at the same time, with both you and Eric swaying a little from the sensations. Thankfully, Carl serves dutifully as a brace for both of you, holding Eric up with the teenager's legs hooked over his shoulders, as well as yourself through two strong arms wrapping around your hips and lower back. Of course, this doesn't mean that he stops lapping at your crotches - no, the canine happily keeps slurping up the femcum that starts to leak from his two excited friends.";
	WaitLineBreak;
	say "     Eventually you manage to catch your breath and gently slip out of Carl's grip, stepping down from the sofa. Meanwhile, Carl's arms slide Eric's legs from over his shoulders and allow the young student to stretch out fully on the sofa, with the husky straightening up to look down at his naked friend. A broad smile is on his face as he feasts his eyes on the lithe teenager, his tail wagging up a storm at the same time. 'Rrr-woof! Was Carl a good doggie?' the soldier asks in a playful tone as he lowers himself into a push-up position on top of Eric, lapping at his hairless and sweaty chest to work his way up to coming face to face with Eric. 'You're definitively taking the 'man's best friend' bit to new levels Carl,' comes a happy reply, together with Eric running his hand through the thick fur on the anthro husky's neck and pulling him into another bout of making out.";
	LineBreak;
	say "     Worn out from your own orgasm, you bid your two friends farewell for now and grab your gear to clean up and get dressed afterwards. As you move away from the site of your steamy threesome, the two of them stay lying on the sofa together. From a snippet of conversation you catch as you walk off, they start to talk about their favorite songs next. The effortless switch to typical guy-talk between friends after having just gotten their rocks off with each other puts a smile on your face. Eric and Carl are definitively an interesting pair - seems like something just clicked between the two young men after meeting not so long ago.";

to say EricCarlThreesome8: [player rides Carl's cock while Eric straddles his face]
	say "     <This scene is WIP, please have some patience for the next update>";


instead of going down from Grey Abbey 2F while (Eric is in Bunker and (HP of Eric > 9 and HP of Eric < 20) and Alexandra is in Grey Abbey Library and AlexandraEricInteraction is 0 and lust of Alexandra is 0):
	move player to Grey Abbey Library;
	if debugactive is 1:
		say "     DEBUG: ERIC MEETS ALEXANDRA - AlexandraEricInteraction: [AlexandraEricInteraction][line break]";
	say "[EricMeetsAlexandra]";

instead of going up from Bunker while (Eric is in Bunker and (HP of Eric > 9 and HP of Eric < 20) and Alexandra is in Grey Abbey Library and AlexandraEricInteraction is 0 and lust of Alexandra is 0):
	move player to Grey Abbey Library;
	if debugactive is 1:
		say "     DEBUG: ERIC MEETS ALEXANDRA - AlexandraEricInteraction: [AlexandraEricInteraction][line break]";
	say "[EricMeetsAlexandra]";

instead of navigating Grey Abbey Library while (Eric is in Bunker and (HP of Eric > 9 and HP of Eric < 20) and Alexandra is in Grey Abbey Library and AlexandraEricInteraction is 0 and lust of Alexandra is 0):
	say "[NavCheck Grey Abbey Library]";
	if NavCheckReturn is false, stop the action;
	move player to Grey Abbey Library;
	if debugactive is 1:
		say "     DEBUG: ERIC MEETS ALEXANDRA - AlexandraEricInteraction: [AlexandraEricInteraction][line break]";
	say "[EricMeetsAlexandra]";

to say EricMeetsAlexandra:
	say "     Entering the ground floor of the library, you see Eric walking along between two long rows of shelves, browsing the books and already carrying one that he picked out for himself. Yet as he reaches the end of the section, arriving at one of the many reading areas with sofas and chairs, the college athlete suddenly stops cold, rooted to the spot. He's staring at... something, in breathless intensity. Curious what your excitable young friend may have run into, you can't help but to stroll towards the scene, quietly approaching from an oblique angle. The enticing sight presenting itself for your eyes makes clear why Eric reacted the way he did - it's Alexandra, and she's sprawled out on a couch, openly masturbating.";
	say "     The bad dog dobie bitch you've tamed for yourself has her leather jacket wide open at the front, giving anyone looking quite an eyeful of her well-sized breasts and tough physique. She is naked from the hip downwards, her ripped jeans lying in a discarded heap in front of the sofa, allowing full access to her dripping pussy. ";
	if lastfuck of Alexandra - turns < 5:
		say "A smile passes over your face as you see that ";
		if lastdobiemess is 6: [boob fuck]
			say "the fur on her chest and breasts is still spiked and messy with your semen clinging to it. ";
		else if (lastdobiemess is 3 or lastdobiemess is 6 or lastdobiemess is 97): [oral sex with Alexandra, or a tit-fuck, or Fang + oral]
			say "the dobie's muzzle is streaked with dry patches of your cum that she's occasionally licks at. ";
		else if (lastdobiemess is 4 or lastdobiemess is 98): [pussy licked by Alexandra, or Fang + pussy]
			say "the dobie's muzzle fur is rough and sticky with the lingering traces of your feminine juices across it. ";
		else if lastdobiemess is 7: [69 with Alexandra]
			say "the dobie's muzzle fur is rough and sticky with the lingering traces of when you last had that muzzle between your legs. ";
		else if lastdobiemess is 1: [player fucked Alexandra's pussy]
			say "the dobie's crotch-fur is still matted and sticky with the remains of the last load you bred her with. ";
		else if lastdobiemess is 2: [player fucked Alexandra's ass]
			say "the visible fur between her buttocks is still matted and sticky with the remains of the last load you shot in her ass. ";
	say "Alexandra's hands are between her spread legs, three thrusting fingers buried between her nether lips and the other hand frigging hard against her clit. All in all a very enticing picture, and you can see why Eric would be spellbound by watching her go at it. Any young man would - no matter what may currently be between his legs.";
	WaitLineBreak;
	say "     Observing your doberwoman bitch stroking herself in front of Eric, you do realize something after a few moments - she may have her head leaned back and eyes mostly closed, but the anthro canine isn't unaware of her surroundings. Focusing your eyes away from those breathtaking jiggling breasts and her bared pussy, you see that her muzzle doesn't simply move in the throes of passion - no, she is sniffing around for something. Then a smile spreads over the dobie's face and Alexandra raises her head from the sofa, eyes opening to spear Eric with a pointed gaze. 'Enjoying the show I see,' the former cop calls out to the student in a teasing tone, making Eric drop the novel he was holding in shock and stammer, 'Uh, ehm... I...'";
	say "     As the young man blushes brightly and averts his eyes from the half-naked woman, then crouches down to pick up the book, Alexandra quickly jumps up from the sofa and strides towards him. Her approach makes Eric shoot back to his feet, looking left and right for a place to escape, but the doberwoman is already upon him, taking hold of his chin and making him look at her with a gentle but firm grip. 'I don't mind someone watching, or joining in even... especially not such a cute innocent pussyboy as you,' Alexandra tells him in a purring tone, causing Eric to pale and gulp. 'N-no, I - I'm not... h-how did you...?' he stammers, then is hushed by a finger on his lips, followed by Alexandra saying, 'I could smell how wet you are from all the way over there.' After that, she suddenly pushes a hand down the front of his shorts, followed by a gasp from the young trans male as she searches out his folds with her fingers and strokes them.";
	LineBreak;
	say "     [bold type]Looks like Eric is in for a wild ride as Alexandra has fun with him. Judging from the readiness with which he follows along as she leads him back to the sofa (still with a hand rubbing his pussy), he'd likely enjoy being dominated by her more than a little bit too. So do you want to let them have their fun ([link]Y[as]y[end link]), or will you bring your bitch to heel ([link]N[as]n[end link])?[roman type][line break]";
	if player consents: [let them fuck]
		LineBreak;
		say "     Do you want to watch?";
		if player consents:
			say "     After guiding Eric to the sofa, Alexandra leans in and plans a wet kiss on the college athlete, sliding a hand behind his head to hold him tight as she explores his mouth with her long tongue. While she strokes his pussy, the two of them make out until the doberwoman eventually pulls back, leaving both of them panting hard. 'You like my breasts, don't you?' Alexandra asks demandingly, pulling her hand from inside Eric's pants and circling the nipples of her well-sized boobs with wet fingers. The college student can do little more but gasp 'Yes' before she pushes his head down to them, enticing him suckle on the twin mounds and also guiding his hands to cup them. 'Good boy,' the doberwoman growls in a lusty tone, smooshing his face against her chest as he sucks eagerly.";
			say "     Your dobie bitch enjoys letting her new play-mate worship her breasts for a while longer, then she takes a grip of Eric's hair and pulls him into another kiss before growling demandingly, 'Enough play, time for you to get to work, little bitch!' With that, she basically throws Eric on the sofa and mounts his supine body with her crotch right over his head. Spreading both legs a bit more from where their knees are pressing into the sofa cushions, she lowers herself a little bit more until his nose brushes her nether lips and the young trans-guy gives in to her demands and starts lapping away. 'That's it! Yeah!' she howls in lust, grinding against his face as he does his best to orally please her. Sounds like Eric does have some skill in eating pussy - which could have something to do with him having one of his own now and thus knowing just how to treat a woman.";
			WaitLineBreak;
			say "     Enjoying her ride on Eric's face, the anthro canine rocks herself back and forth on top of the college student, then eventually leans forward and gets on all fours on top of him. She slides her eager hands under the belt-line of his shorts and then pushes them down to his knees, revealing the trans teen's drippingly wet pussy. 'I'm gonna show you that pleasing the alpha bitch has its own rewards,' Alexandra says in a lusty tone, then slides canine tongue along Eric's wet folds before pushing it into him. Teasing the young trans-man's passage with her long tongue, the doberwoman laps his inner walls and hungrily slurps up Eric's juices. Now in the typical 69 position, the two of them please one another orally, licking and being licked while Alexandra's tail beats like a storm.";
			say "     With how wound up they already are, it is no big wonder that soon, your dobie bitch and her cuntboy playmate get closer and closer to orgasming. As Alexandra feels herself getting close, she raises her head and barks out, 'That's it! Deeper you little slut, get that tongue really in there! Ah! Ah! Aaaaahhhhh!' Grinding her crotch hard against Eric's face, the former cop pants like a bitch in heat - literally - then comes with a howl, her pussy leaking copious amounts of precum all over Eric's still wiggling tongue and his face. Alexandra rides out her orgasm in obvious satisfaction, then eventually leans her head forward again and teasingly laps the inside of Eric's thighs. 'You've been a very, very good boy. Time to get you off too,' the dobie almost purrs in her post-orgasmic pleasant mood, then gets to work on Eric with her tongue as well as several fingers sliding into his quivering passage. In mere moments, this pushes Eric over the edge for his own sexual high, giving muffled shouts in completion from between Alexandra's legs.";
			WaitLineBreak;
			say "     After having both just come, Alexandra and Eric are pretty worn out from all the sex, and the next thing that the doberwoman does is half-rise from the sofa, then letting herself fall back onto it in the same orientation as Eric. Licking his sweaty skin in satisfied slowness the anthro bitch then says, 'You did good, girlie-boy.' Eric stiffens a little at this nickname, then replies, 'I'm... err - please call me Eric.' The doberwoman chuckles while letting her hand roam over his body and adds, 'Fine then, Eric. As long as you remember who the alpha bitch in this pack is and take care of her, I'll call you whatever you want.' With that said, she slumps down on the sofa, on arm still holding on to Eric in a somewhat possessive manner.";
			say "     You leave the two of them to catch their breaths and rest. Moving back to the entrance area of the library, you give them what time they need to recuperate.";
		else:
			say "     Grinning, you turn around and walk back towards the entrance of the library, leaving the two of them behind and hearing moans and happy barks echo through the building soon after.";
		now AlexandraEricInteraction is 1; [Eric and Alexandra had fun]
	else: [stop Alexandra]
		LineBreak;
		say "     Stepping forward and clearing your throat loudly, you draw the attention of Alexandra and Eric. While the young man gives you a shame-faced 'hand in the cookie jar' expression, the doberwoman grins broadly, wagging her tail as she gives Eric's clit another rub that makes him moan out loud. 'Hey boss,' she calls out to you, then licks the side of Eric's face playfully. Only after you flat out order her to leave the young trans man in peace does she stop groping and playing with Eric, giving a little huff as she lets go of him. 'Fine, fine, you're the boss,' the doberwoman half-growls, after which Eric pants out, 'I'm sorry for staring,' and runs off, snatching up his book as he goes along. 'Guess you brought that one here as a special pet, eh? Okay, I'll keep my hands off him, even if he is a cute lil bitch.' With that said, the anthro canine walks over to the sofa, bends forward to pick up her jeans in the most provocative way possible, her dripping pussy in full view. Clothing in hand, she walks off after that.";
		now AlexandraEricInteraction is 99; [Eric + Alexandra interaction stopped]

instead of going up from Bunker while (Eric is in Bunker and (HP of Eric > 9 and HP of Eric < 20) and Urik is in Sitting Area and UrikEricInteraction is 0):
	move player to Grey Abbey Library;
	if debugactive is 1:
		say "     DEBUG: ERIC MEETS URIK - UrikEricInteraction: [UrikEricInteraction][line break]";
	say "[EricMeetsUrik]";

instead of navigating Grey Abbey Library while (Eric is in Bunker and (HP of Eric > 9 and HP of Eric < 20) and Urik is in Sitting Area and UrikEricInteraction is 0):
	say "[NavCheck Grey Abbey Library]";
	if NavCheckReturn is false, stop the action;
	move player to Grey Abbey Library;
	if debugactive is 1:
		say "     DEBUG: ERIC MEETS URIK - UrikEricInteraction: [UrikEricInteraction][line break]";
	say "[EricMeetsUrik]";

to say EricMeetsUrik:
	say "     Entering the ground floor of the library, everything seems normal at first, but then the sound of someone's running steps draws your attention to the upper library floor. As you look up, a panicked Eric reaches the railing at a full sprint, catching himself on it and panting in exhaustion. He catches sight of you and calls out, 'Help! There's this huge green guy up here and he -' And that's how far he gets before a large green hand grips Eric by the back of the neck and pulls him out of sight, followed by the sound of a scuffle.";
	say "     Uh-oh. Looks like Urik doesn't really know how to play nice with others. You sprint up the stairs to the upper library floor to see the orc standing near the far wall, holding Eric by the throat. 'Guess having a *growl* master isn't so bad if he keeps his lair stocked with little snacks,' Urik grumbles, then feels up Eric's pecs and abs and sniffs the still weakly kicking young man. Then he continues, 'A bit bony and with a strange smell, but you'll do boy. I wanna take someone NOW!' With that said, the green-skinned brute wrenches down Eric's shorts, only to stop in confusion. 'The fuck?! Where's your dick?'";
	WaitLineBreak;
	say "     As the orc warrior turned breeder lets go of Eric and the half-naked teen stumbles a few steps away from him, you finally close up to them. The first thing you do is put an arm around Eric, helping to keep him from falling over as he pulls his clothes back on and asking if he's okay. The college athlete rubs the somewhat bruised back of his neck with a hand and replies, 'Give me a minute, but... yeah. Still, that orc is a menace - why did you bring him here?!' Relieved that the young trans male is okay (mostly anyways), you tell him that he'll see in a moment. And with that, you wheel around and hone in on Urik.";
	say "     The orc has wandered off a little, giving Eric sidelong looks in disapproval. Then you grab him by the arm and let the green-skinned brute have it - really putting him in his place and making it clear that HE is the lowest orc on the totem pole. Everyone in his tribe watched him lose his cherry and then you won his ass as your personal breeder! Sliding a hand under his loincloth and gripping his balls tightly, you look into his eyes with a steely gaze and raise an eyebrow, waiting. 'Fine,' the muscular hunk grumbles, 'I'm your breeder, master. To use when you see fit. And...' He stops with a scowl, then only continues after you give his hairy orbs a sharp squeeze, 'And anyone here in your lair is... above me. I - will - obey - them - too.'";
	WaitLineBreak;
	say "     Having pulled that grudging concession of obedience from the orc, you let go of his balls and take a deep breath. There, one difficult orc-slave-owner situation dealt with before it got any worse, and hopefully for good. After a casual command for Urik to finger his hole like the needy breeder he knows he is, you turn your attention back to Eric. The college student is somewhat nonplussed at what he just witnessed, looking back and forth between the two of you and observing wide-eyed that Urik does indeed fall to his knees, then sucks on his fingers to make them wet for his own asshole. As the orc's thick finger sinks into the gripping embrace of his pucker, Urik gives an aroused moan, breaking Eric from his shocked silence.";
	say "     'T-that guy is... your slave?' the young redhead asks unbelievingly, then says, 'But... but... why? How?!' With a smile at the green-skinned brute who is by now up to two fingers up his rear end, you explain to Eric that Urik more than deserves his fate, and that you did win him, fair and square, at a competition. Eric blinks as he takes in those facts, then asks, 'So... um, he won't try anything again then?' You just smile and point at the strong orc fingering himself, telling Eric that Urik may be big and strong, but that he now is a breeder a heart, living to take your commands and get his ass ridden hard. Eric bites his lip and looks at the orc in an all new light, eyes wandering over Urik's muscular physique.";
	LineBreak;
	say "     [bold type]It almost looks like your friend is interested in big, bad muscled guys. Do you suggest to Eric that he nevertheless should rather stay away from Urik ([link]Y[as]y[end link]), or do you want to involve the young trans-guy in some fun with your orcish slut ([link]N[as]n[end link])?[roman type][line break]";
	if player consents: [stop this scene line for good]
		say "     Pulling Eric aside a little bit, you tell him that obedience training with Urik may still be a little bit... hit and miss, so for the moment, it is advisable for him not to be spending any time close to the orc. Urik shouldn't try to grab him after the talking-to you gave the orc, but who knows what ideas the brute might come up with in the throes of passion. The college athlete gives a last sidelong glance at Urik's magnificently muscled body, then nods to you and turns away after thanking you again for saving him. A moment later, he walks over to the stairs and goes back down to the main library floor.";
		say "     Meanwhile, you move in closer and crouching down next to your private orc breeder, stroking over Urik's broad chest, then whisper some additional commands to him. This time, the former orc warrior is far too turned on to complain much, instead panting out the requested words of 'I'm yours master. Please let your slut get off!' With a satisfied grin on your face, you take hold of Urik's thick prick and stroke it with both hands, giving the orc his reward for being nice and submissive. As wound-up as he already is, it takes mere moments to drive the green-skinned hunk over the edge, humping his hips into the air rhythmically as his balls send forth a geyser's worth of cum - which you aim right at his own face. The first shot just leaves a creamy streak across his cheek, but the second hits Urik's open mouth and is eagerly swallowed, with the next and the ones after making quite a mess of your pet breeder's face, neck and chest.";
		now UrikEricInteraction is 99; [Eric steered away from Urik]
	else: [let things go on]
		project the Figure of Eric_Urik_naked_icon;
		say "     [bold type]Do you want to offer Eric a ride on the orc, suggesting it as a kind of 'turnabout's fair play' in which he gets his pussy eaten ([link]Y[as]y[end link]), or will you just let him have his fill in watching Urik ([link]N[as]n[end link])?[roman type][line break]";
		if player consents: [Eric gets licked]
			LineBreak;
			say "     Wanting to give Eric a nice show, you tell Urik to turn around and flex a bit, which the big orc does with little more than a slight grumble. This also reveals the very erect shaft of his manhood, barely covered by the loose fabric of his loincloth hanging over it. With a grin, you pull the thin cloth to the side and take hold of it, wagging the towering erection in the direction of the watching student. Before much longer, Urik is lying on his back, stretched out on the library floor, legs raised high as he fingers himself with eager fingers. The large orc moans loudly at the anal stimulation, leaking a copious amount of pre-cum, and you notice Eric's breaths coming more quickly as the college athlete unobtrusively rubs his own crotch.";
			say "     And that is when you step up behind your college student friend, sliding an arm around him and 'helping him' rub his pussy while you whisper enticing thoughts into his ear. After all, Urik did treat Eric rather roughly before - so the least your young friend deserves is paying the orc back by using him to get off. Aroused as he is and with you pushing him along to a decision, Eric soon gives in to his desires and nods to you over his shoulder, agreeing to using your green-skinned slave. With a broad smile on your face, you slide both hands under the belt-line of the young trans-man's shorts, then push them down to drop to the floor, followed by pulling Eric's sleeveless t-shirt off his body. With a light slap on his butt, you tell him to have fun, then stand back and watch him approach Urik.";
			WaitLineBreak;
			say "     'I - I want you to lick me,' the college athlete says shyly as he steps up to Urik, prompting the orc to focus on his naked form, then frown as he sees Eric's female parts again. 'Yeah right. You can-' the orc snorts derisively, only to fall silent as you clear your throat loudly. He grumbles something that might have been 'frigging pussy-boy', then looks at Eric expectantly. As the naked young guy bites his lip and hesitantly says, 'We could go like...' Urik impatiently grunts and reaches out, hooking a large hand around Eric's hip. With his muscular fingers gripping Eric's rounded buttocks, the orc pulls him down on top of himself quick move, then man-handles the transgendered youth to straddle his face. As the green-skinned brute starts to finger his ass once more, he also begins eating out Eric, sticking his tongue deep into the young man's pussy.";
			say "     'Ooooaaahhhh!' Eric gasps in pleasure from Urik's oral service, throwing back his head and grinding against the orc's face. With one arm stretching behind himself to brace against the firmly muscled chest of the super-sized orc breeder, Eric's other hand gets busy rubbing his clit. Meanwhile, Urik keeps fingering himself, leaking copious pre-cum from his proudly standing erection - and the muscled brute wipes up some of the clear fluid with his hand, then brings it to Eric's ass, smearing the college student's rear with orc pre and starting to play a finger over his pucker. Between Urik's tongue wiggling inside his pussy and the aphrodisiacs produced in an orc's balls being absorbed through his skin, Eric soon is in a sexual haze that has him trembling and moaning on top of his partner. He barely feels the sting as Urik's thick middle finger penetrates his ass with a sudden thrust, then starts moving in and out in the same fast rhythm that the orc uses on his own back door.";
			WaitLineBreak;
			say "     The orc and human cuntboy are a sight to behold - naked, moaning and panting as they are, right here in the open on the upper floor of the library. Despite the push you gave to make the orc service him, Eric has fallen back into a more familiar submissive role and seems pretty happy in that position. Although he is on top of the larger male, riding his face and grinding against it, Urik clearly calls the shots - stoking the college student's raging libido with one finger deep inside his ass and his tongue buried deep in Eric's pussy. This seems to have mollified him a bit to the task of having to service another and Urik goes at it with an almost eager readiness.";
			say "     After a short while of watching the two of them, you notice Eric's gasps getting more and more breathless and increasing in intensity, until he eventually lets out a satisfied shout and humps his hips into Urik's face hard. As the trans-male gasps in orgasm and his pussy starts leaking femcum all over the orc's mouth (to be eagerly slurped up), his back passage tenses and grips Urik's finger like a vise. Your orc slave proceeds to give some small tugs and thrusts with his hand, playfully prolonging Eric's climax with the varied sensations before the college athlete finally relaxes enough to slide out his invading digit.";
			WaitLineBreak;
			say "     Now gripping his own thick shaft with his large hand, the orc proceeds to jerk himself off while finger-fucking his ass, rapidly building up to an explosive eruption of cum from his towering pole, hitting Eric's back with a resounding splat, then again, and again, really creaming the young man and his own chest. The two of them sink back on the floor in a panting, sweaty heap, riding out their respective orgasms to the fullest and catching their breaths. Eventually, Eric starts to push himself up a little, wanting to get up and saying, 'Wow, that was awesome!' - but Urik suddenly pins him to his chest with one hand, wiping up a long swath of the white splatters on the redhead's back.";
			say "     'You haven't felt half of what it means to be taken by an orc yet, boy!' the orc calls out in a gruff tone, then starts licking his own seed off his hand with gusto, slurping off finger by finger. As soon as he is done, the big brute grips Eric's head by the young man's hair and gives him a deep french kiss. When the two of them pull apart again, you can see strings of spit and orc cum stretch between their lips and tongues, making it clear that Urik gave Eric a big snowball of cum to swallow. The orc chuckles as he sees Eric's eyes go round and a flush of renewed arousal spreads over the student's face - he's getting drunk on the orc's seed! You allow Urik to clean his sexual partner of the rest of his cum - with his tongue - then help Eric dress and guide him down to his bed to sleep off the buzz.";
			move player to bunker;
			now UrikEricInteraction is 2; [Eric got a taste of orc cum]
		else: [just watch]
			LineBreak;
			say "     Wanting to give Eric a nice show, you tell Urik to turn around and flex a bit, which the big orc does with little more than a slight grumble. This also reveals the very erect shaft of his manhood, barely covered by the loose fabric of his loincloth hanging over it. With a grin, you pull the thin cloth to the side and take hold of it, wagging the towering erection in the direction of the watching student. Before much longer, Urik is lying on his back, stretched out on the library floor, legs raised high as he fingers himself with eager fingers. The large orc moans loudly at the anal stimulation, leaking a copious amount of pre-cum, and you notice Eric's breaths coming more quickly as the college athlete unobtrusively rubs his own crotch.";
			say "     Crouching down next to your private orc breeder, you stroke over Urik's broad chest, then whisper some additional commands to him. This time, the former orc warrior is far too turned on to complain much, instead panting out the requested words of 'I'm yours master. Please let your slut get off!' Wiggling your eyebrows at the still closely watching Eric, you do take hold of Urik's thick prick and stroke it with both hands, giving the orc his reward for being nice and submissive. As wound-up as he already is, it takes mere moments to drive the green-skinned hunk over the edge, humping his hips into the air rhythmically as his balls send forth a geyser's worth of cum - which you aim right at his own face. The first shot just leaves a creamy streak across his cheek, but the second hits Urik's open mouth and is eagerly swallowed, with the next and the ones after making quite a mess of your pet breeder's face, neck and chest.";
			WaitLineBreak;
			say "     You keep a hold of Urik's erection and hose him down good, then eventually let go of the warm and throbbing shaft when he runs out of steam. Patting his hard abs now turned cum-gutters, you push the gooey globs of his load around a little in the ridges and valleys of hard muscle, then present your hand to the orc to be licked clean. Once he is done hungrily licking cum off your fingers, you tell him to clean himself up, then casually walk over to Eric, a wide grin on your face. 'You weren't kidding about him,' the young man says in a somewhat breathless tone, then hastily snatches away his hand as he realizes he is still rubbing himself with you right in front of him. 'I - I gotta take care of something. T-thanks for saving me - again,' Eric continues, then quickly moves towards the stairs down to the main floor.";
			now UrikEricInteraction is 1; [Eric got off on watching Urik]
	now lastUrikEricInteraction is turns;

[ (Eric is in Bunker and HP of Eric > 9 and HP of Eric < 20 and Urik is in Sitting Area and Urik is in Sitting Area and (UrikEricInteraction is 1 or UrikEricInteraction is 2) and ((lastUrikEricInteraction - turns) > 8)]

instead of going up from Grey Abbey Library while (Eric is in Bunker and HP of Eric > 9 and HP of Eric < 20 and Urik is in Sitting Area and (UrikEricInteraction is 1 or UrikEricInteraction is 2) and (lastUrikEricInteraction - turns) > 8):
	move player to Sitting Area;
	if debugactive is 1:
		say "     DEBUG: ERIC WATCHES URIK - UrikEricInteraction: [UrikEricInteraction][line break]";
	say "[EricWatchesUrik]";

to say EricWatchesUrik:
	say "     As you walk up the stairs to the upper floor of the library, you hear deep-voiced grunts and moans from somewhere ahead - which turn out to be coming from your personal breeder slave. Urik is lying on one of the sofas arranged between the rows of bookshelves, eyes closed as he makes aroused noises. The broad-shouldered hunk of an orc warrior (that got turned into a bottom bitch) is jerking himself while finger-fucking his own ass with three thick digits. Since being broken in as a butt-slut, his desire - or rather need - to be fucked has only grown. Interestingly, the orc isn't alone. You spot Eric standing nearby, eyes glued to the muscled physique of the green-skinned male while having one hand inside his shorts, making more than obvious rubbing movements. The college athlete is frigging himself while watching Urik!";
	say "     [bold type]Do you want to move closer and stealthily observe what happens between them next ([link]Y[as]y[end link]), or will you just let the two of them alone and turn your attention elsewhere ([link]N[as]n[end link])?[roman type][line break]";
	if player consents: [watch]
		LineBreak;
		project the figure of Urik_naked_icon;
		say "     Quietly moving forward, you take a close-by position to the orc, coming to stand hidden in the shadow of a long bookshelf. It looks like neither the orc nor your human friend noticed your approach - they're far too busy fingering themselves to do so. For a long moment, each of them is busy doing just that, Urik stretching his asshole with several fingers while jerking off and Eric rubbing himself. Then suddenly, Eric gives a little gasp, followed by a louder moan from having reached a mini-orgasm through his self-stimulation... and this draws Urik's attention. Opening his eyes, the orc looks to the side and sees Eric standing barely an arm's length beside him. With a slightly derisive snort, the green-skinned brute says, 'Hmph - just the boss's pussyboy. Getting off from seeing a real man, huh kid?'";
		say "     'Um, I -' Eric starts to stammer, and the orc chuckles gruffly, 'I'd tell you to beat it, but since the boss likes ya and you're supposed to be 'in charge' and all... I bet you lil fucker want me to get you off. Ain't that right?!' The red-headed young trans-guy swallows visibly, then nods while answering with a shy, 'Yes. Please.' Urik gives a somewhat amused huff, then murmurs, 'What a joke. If you want something, you should just take it. With this temperament you'd be better suited as a breeder, but you're not even that - you lil bitch don't even have a dick!' In protest, Eric bursts out with, 'Hey! That's not-' ...and this is exactly how far he gets before the orc lets go of his own cock and grabs hold of the college athlete's shorts, dragging Eric over to himself.";
		WaitLineBreak;
		project the Figure of Eric_Urik_naked_icon;
		say "     With a quick wrench, the fabric gets pulled down to Eric's ankles, leaving him naked except for his sleeveless t-shirt and tangling him up as Eric tries to get away - only to fall over and land next to Urik on the sofa. Rolling over and pouncing on his human target, the orc holds the weakly struggling Eric's chest down with one hand and frees his legs from the shorts for good, throwing the garment aside with a casual flick of his wrist. Then he spreads Eric's legs and glances down at the student's moist pussy and says, 'A real man just acts, hesitation is for pussies!' With that said, Urik forces himself to lose the frown at the unfamiliar set of genitalia and lowers his head between Eric's legs, taking a first lick at the young trans-man's pubic mound and drawing an aroused gasp from the student.";
		say "     Even though he clearly never had any interest in women or how to please them, Urik quickly learns how to make Eric squirm by sucking in the college athlete's clit between his lips and teasing it with the tip of his tongue. In between drawing breathless moans from Eric, who trembles and shivers in pleasure under his treatment, the muscular orc draws back a bit and explores his human partner's genitals with a critical eye. He spreads the trans-guy's nether lips and rubs this part or that, then eventually thrusts a thick finger into Eric's vagina, making the young student moan loudly at the sudden penetration. 'Like that, eh pussyboy?' the orc asks gruffly, then crooks his finger and feels around a bit, earning a half-shouted 'YeahhhhhhHHH!' from Eric, whose womanhood instantly becomes glistening wet from another mini-orgasm.";
		WaitLineBreak;
		say	"     Looking down at his femcum-dripping finger, Urik sniffs at it, then pops it in his mouth testingly, smacking his lips after sucking Eric's fluids off. 'Not bad, but orc cum's better,' the orc murmurs to himself, then looks down on the human lying before him, still riding the high of spiking arousal. 'Let's see how he likes this,' Urik continues, then runs his finger up and down between Eric's dripping folds and moves his finger down to the young athlete's crack. Slick as it is with the cuntboy's own juices, the big brute's finger finds some resistance from the pink pucker it is pressed in against, but soon nudges the muscle apart to sink inside, drawing a fresh gasp from Eric. Urik smiles at the way the young man writhes on the sofa a moment later, commenting with a chuckle, 'So you do still have a prostate too, little man. Good to know.'";
		say "     With a deep growl in his throat, the orc then proceeds to put his mouth back to work on Eric's pussy while at the same time finger-fucking his ass, an all-out assault that makes the half naked human's libido take off like a fireworks rocket. And with a similar progression, Eric's sounds of pleasure rise quickly, higher and higher in pitch and volume, until he literally screams out in orgasm, his toned runner's legs wrapping around Urik's head as he reaches his climax. A half-amused grumble comes from the orc, his face pressed firmly against Eric's crotch, and the big brute gives a little twitch of his shoulders, then slurps up and swallows the slick femcum leaking out of the human right in front of his mouth.";
		WaitLineBreak;
		say "     Eric's moaning and twitching slowly dies down and he settles back on the sofa, arms and legs relaxing to just lie slack while he sighs, 'That was so good!' Urik snorts at the exhausted tone of the student and murmurs, 'Someone's got to work on his stamina. But hey, if he's done, I can get back to my fun.' Straightening up, the orc takes hold of his thick shaft and starts jerking off, his other hand moving to finger his own asshole, thrusting in and out in a rapid pace. Given the furious tempo in which the horny orc goes at it, you're not surprised to hear him give a lust-filled grunt before much longer, with Urik thrusting his hips forward as his erection starts spurting long strings of white cum, splashing down upon Eric's stretched-out form and plastering the fabric of his sleeveless shirt to his slender chest.";
		if UrikEricInteraction is 1: [never had orc cum before]
			say "     Urik's balls pump out a copious amount of cum and the orc cheerfully aims his thick shaft to really cream Eric's front, covering the college student in creamy white goop. Exhausted as he is, the young trans-man opens his eyes and pushes himself up on an elbow, looking down over his soaking wet shirt and wiping up a handful of cum while groaning, 'Huh?' The orc quickly leans forward to grab Eric's forearm and guides his hand to his head, telling the college athlete, 'Eat it. Its good for you.' As Eric opens his mouth to reply, Urik pushes his cum-covered fingers inside, giving the cuntboy his first taste of his new favorite treat, after which Eric gladly proceeds to lick off the rest on his own. 'There you go,' the orc adds with a chuckle, then catches one of the only slowly ebbing spurts from his cock in a cupped hand and feeds it to the half-naked student.";
		else if UrikEricInteraction is 2: [Eric had a load of orc cum before]
			say "     Urik's balls pump out a copious amount of cum and the orc cheerfully aims his thick shaft to really cream Eric's front, covering the college student in creamy white goop. Exhausted as he is, the young trans-man opens his eyes and pushes himself up on an elbow, looking down over his soaking wet shirt and wiping up a handful of cum while groaning, 'Huh?' Then Eric realizes what the creamy substance sticking to his fingers really is - the tasty treat he got once before from the big orc - and after a few seconds of hesitation, he brings the hand to his mouth and sucks Urik's cum off it. The orc smiles broadly at the sight and says, 'That's it. We'll make a proper lil breeder out of you yet.' Then he catches one of the only slowly ebbing spurts from his cock in a cupped hand and also feeds it to the half-naked student.";
		WaitLineBreak;
		say "     After his orgasm runs its course, Urik starts to lick his own load off Eric's body, hungrily swallowing all but a little that he passes on to Eric in sloppy kisses, ensuring that both of them quite drunk on the potent fluid. As they sink down on the sofa in a tangle of limbs, you leave the orc and young human to sleep off their buzz.";
		now UrikEricInteraction is 3; [Eric got fed orc cum by Urik]
	else: [leave]
		LineBreak;
		say "     After the lesson you gave Urik last time, Eric really should have no problem with the orc treating him badly. With that thought in mind, you turn your back on the two of them, walking back down to the main floor of the library. Some of the brutish orc's deep moans echo after you from above, but you tune him out as you turn your attention elsewhere.";
		now UrikEricInteraction is 3; [Eric got fed orc cum by Urik]
	now lastUrikEricInteraction is turns;

instead of going up from Grey Abbey Library while (Eric is in Bunker and (HP of Eric > 9 and HP of Eric < 20) and Urik is in Sitting Area and (UrikEricInteraction is 3) and (lastUrikEricInteraction - turns) > 8):
	move player to Sitting Area;
	if debugactive is 1:
		say "     DEBUG: ERIC AND URIK 69 - UrikEricInteraction: [UrikEricInteraction][line break]";
	say "[EricUrik69]";

to say EricUrik69:
	say "     As you walk up the stairs to the upper floor of the library, you hear somewhat muffled grunts and moans from somewhere ahead - which turn out to be coming from one of the large sofas arranged for comfortable reading throughout the library. Moving towards it between the bookshelves, you see someone sit up, coming into sight from behind the backrest - it is Eric and he is naked, throwing his head back as he lets out a satisfied moan. Then a muscular green-skinned forearm with a large strong hand rises into view too, pushing the college athlete's chest down again, resulting in slurping sounds a second later. It is relatively obvious what's up, and even before you get to a position to get an unobstructed view, you know that Eric and your orc slave Urik are getting it on.";
	say "     From what you can see a moment later, the young cuntboy is straddling Urik's face and getting eaten out while at the same time suckling on the head of the orc's throbbing erection and playing with his balls. For a second, you wonder if Urik got grabby with your friend again, but the fact that Eric is on top and willingly participates does quell that fear quickly. Not that the orc isn't calling the shots in their coupling, as becomes obvious when he gropes around for Eric's arm and hand, pulling it lower to his buttocks and thus directing Eric to finger his asshole, which the shy college student starts doing right away.";
	LineBreak;
	say "     [bold type]Do you want to move even closer and watch them go at it ([link]Y[as]y[end link]), or will you just let them have their fun in peace and turn your attention elsewhere ([link]N[as]n[end link])?[roman type][line break]";
	if player consents: [watch]
		LineBreak;
		project the Figure of Eric_Urik_naked_icon;
		say "     Getting into position behind a nearby bookshelf, you do watch the two of them go at it over the tops of a row of books, unobtrusively spectating on the two unequal partners having sex. The orc's loincloth is lying on the ground near the sofa, as if casually thrown aside, while Eric's shirt and shorts are hanging over the armrest at the end of the sofa in a relatively orderly fashion. All of this gives another clear indication that this isn't the orc brute ravishing your friend, but rather a consentual pairing between the two of them. And from the looks of it, they're enjoying each other's company quite a bit. Urik's shaft is rock hard and sticking straight up, with veins along its length throbbing hard - especially when Eric thrusts into his muscular partner with several questing fingers, feeling around for the orc's prostate.";
		say "     Meanwhile, Urik has the trans college student's pussy under an almost constant assault of his tongue, licking over it from the clit to the nether lips, then darting its length between the folds and wiggling around a little inside. This keeps Eric in a highly aroused state, often having to stop suckling on Urik's cock-head to moan loudly, only to quickly get drawn back to worshiping the orc's cock by the irresistible trickle of pre running down Urik's prick from the tip. At some point, the orc grasps Eric's buttocks with both his hands, kneading the rounded orbs with strong fingers and spreading them. You can hear a lusty growl from the big brute as he lays his eyes on Eric's pink pucker, flexing and relaxing a little from the young guy's excitement. After one more little nibble at Eric's clit, the orc moves his head to eat out his ass too for a change, then switches back and forth, drawing ever more urgent gasps from the college athlete.";
		WaitLineBreak;
		say "     Eventually choosing to concentrate on Eric's asshole, Urik buries his nose in the college student's crack, tongue stretched out to reach as deep as it can while he rubs the cuntboy's clit with the thumb of one hand and having two fingers thrusting into his pussy. This double attack at multiple sensitive spots does push Eric over the edge in short notice, and he pulls off Urik's cock-head with a pop to gasp out a loud moan. Trembling and twitching as he is stretched out on top of the orc, the trans-male is rocked by an intense orgasm, dripping and squirting femcum all over Urik's hand. The orc keeps eating his ass and fingering Eric throughout his climax, teasing his partner to prolong his pleasure, then chuckles loudly as the panting human sinks down to lie in exhaustion on his orcish partner.";
		say "     'Liked that, didn't you?' the orc says in his usual gruff tone, then slides his hand out from under Eric, looking at the wetly glistening green skin and checking out how long strings of sticky femcum between the fingers can get as he moves them apart. Then he brings his large hand down to his own hips and starts jerking the towering pole of his erection, smearing it with a mixture of orcish pre and Eric's female juices. 'I'm sure you wanna show your appreciation for getting you off,' the orc says next, more of a statement than a question, then grips the base of his shaft and softly whacks it against the side of the college athlete's face. This mobilizes Eric to a bit of a push-up against Urik's broad hips, licking his way up the side of the orc's shaft as he goes along.";
		WaitLineBreak;
		say "     'And don't forget the best part,' the green-skinned brute adds as Eric takes his cock-head into his mouth, then brushes a finger over the young human's pucker. Taking the hint, Eric gets back to fingering Urik's ass right away, pushing his fingers in against the readily stretching opening of the orc's rear entrance. Suckling on the large green cock-head between his lips and stroking his much larger partner's prostate, Eric does his very best to service Urik, rapidly building up the orc's lust and arousal. Before much longer, the big male gives an urgent grunt of, 'Yeah, that feels great! Go deeper!'";
		say "     With that said, he grasps Eric's forearm and pushes it towards his own rear - with enough urgency to cause Eric's slender hand to slip completely past his pucker. 'God yes!' the orc growls urgently, bucking under Eric as the surprised young man testingly spreads his fingers and feels around. With this new level of stimulation, the green-skinned butt-slut reaches his point of no return just moments later, bellowing in lust as he humps his hips upward, making the whole of his cock-head pop into Eric's mouth. You can see the throb of the thick shaft as the grunting orc's load starts erupting into the cuntboy, to be swallowed with hungry eagerness.";
		WaitLineBreak;
		say "     By the time Urik's orgasm has run its course, Eric has swallowed quite a big load of his seed, not without losing some though when it just became too much. The creamy mess that squirted past his lips as they were stretched around the throbbing cock-head is coating Urik's prick in a white layer now and has started to pool around the only slowly softening shaft's base. Waiting a few seconds more after the last throb of Urik's balls, the cock-sucking human pulls off with a loud pop, then gives a little belch from all the cum in his stomach. One look at the blushing cheeks and dilated pupils tells you that Eric is totally buzzed on what he's consumed so far - but in his drunken and aroused state, that still isn't enough.";
		say "     After catching his breath for a few seconds, the athletic student immediately pounces on Urik's shaft again, slurping up the spilled cum - at least until Urik suddenly lifts the young human and spins him around. Eric finds himself face to face with the muscled brute, pulled into a deep kiss. Lips pressed together, Urik explores Eric's mouth with his tongue and steals part of the cum he still hadn't swallowed. You see the orc gulp it down with obvious pleasure, then sink back to rest on the sofa after getting his fix too. The two of them doze off like that, stretched out together with Eric lying on top of the orc.";
	else:
		LineBreak;
		say "     Smiling at the fact that Eric is getting out of his shell a bit and searched out your orc slave for some fun, you turn away from the two of them, leaving them to continue with their 69 in private.";
	now UrikEricInteraction is 4; [Urik and Eric had a 69]
	now lastUrikEricInteraction is turns;

instead of going up from Grey Abbey Library while (Eric is in Bunker and (HP of Eric > 9 and HP of Eric < 20) and Urik is in Sitting Area and (UrikEricInteraction is 4) and (lastUrikEricInteraction - turns) > 8):
	move player to Sitting Area;
	if debugactive is 1:
		say "     DEBUG: ERIC AND URIK BJ - UrikEricInteraction: [UrikEricInteraction][line break]";
	say "[EricUrikBJ]";

to say EricUrikBJ:
	say "     As you walk up the stairs to the upper floor of the library, you spot Eric walking into the space between two long bookshelves, seemingly moving along with a specific purpose if you had to guess from his stride. Curious what he's up to, you start to follow, going after him with about 20 feet between you and both of you moving along between the shelves. You're of half a mind to just call out to him and ask where he's going when Eric suddenly slows down, the rhythm of his previously so determined steps interrupted and becoming more irregular. The college athlete bites his lip and looks to the side for a second, bending his head a bit to peer across the backs of the shelf's books, looking at something behind them. He stays like that for a few seconds more, then takes a deep breath and starts to move on, soon turning the corner as the shelf ends and walking towards out of sight.";
	say "     Your suspicion about whom Eric might be interested in meeting up here is confirmed when you get to the spot from which Eric spied at him from behind the shelf - it is Urik, your orc slave. The muscular brute is dozing on one of the many sofas in the library, sitting on it in a relaxed posture with his legs spread and arms on the backrest. Seems a bit like he's found at least a little bit to like about being yours now - contrary to an orc warrior's existence, he's got a pretty comfortable time of leisure here. Eric is currently approaching the resting orc, walking up to Urik with renewed vigor after almost faltering before. A moment later, he's at the sofa and quietly sits down next to the orc. The athletic student stays quiet for a little while, just taking in the muscled brute right next to him, then eventually raises a hand and slowly stretches it out towards Urik's bare chest. Blushing a little bit as he strokes over the orc's firm pec first, Eric moves on to shake Urik a little to wake him up and says 'Hello' in a shy tone.";
	LineBreak;
	say "     [bold type]Do you want to keep watching what happens between them next ([link]Y[as]y[end link]), or will you turn your attention elsewhere ([link]N[as]n[end link])?[roman type][line break]";
	if player consents: [watch]
		LineBreak;
		project the Figure of Eric_Urik_naked_icon;
		say "     The muscle-packed orc wakes up in a flash, raising his head from where it was resting on the back of the sofa and looking around. As he sees Eric, a smile crosses Urik's face and he lets his eyes wander down to the college student's tight shorts and back up again while sliding an arm around his midriff. 'Hey there lil['] buddy,' the orc slave says to Eric in a husky tone, stroking his side a bit with a large hand. You can't help but wonder at how much Urik's demeanor to Eric changed since the two of them met - from rough treatment and rejection to now... actually being pretty nice to the slender human sitting next to him. Sure, you had a word with Urik, but this is still quite a development - its almost as if the big brute can't help but feel a connection to the lithe college student.";
		say "     Seeing the orc sit there relaxedly, one arm around and holding his smaller friend, the association that comes up in your mind is more of a protective big brother than a ruthless orc slaver (even a former one). Of course, if Urik and Eric were siblings, that'd be an... interesting family dynamic all of its own, as the thin loincloth hiding Urik's shaft twitches a little and you can see him getting harder by the second. He feels something for Eric alright - and at least half of it is lust. With a beaming smile baring one tusk, Urik tousles Eric's hair and asks, 'So, what up lil['] E? Your pussy itching for some attention? Told ya to be more direct - what are'ya still wearing clothes for then?!' Hooking a thumb under the belt-line of Eric's shorts, the orc starts to push them down, only to have the college athlete squeeze his arm to stop.";
		WaitLineBreak;
		say "     'N-no, that's not... it,' Eric says in a mixture of stumbling over his words and pausing before the last. 'I - um, you see...' he stutters on, and after a few seconds, Urik's brows draw together and the orc asks demandingly, 'Got a problem? Some bastard making trouble? I'll give him a thrashing and -' Eric quickly puts his hand back on Urik's chest, softly pushing to keep the orc from getting up while he hastily bursts out with, 'Nononono - it is just... I wanted to thank you. For - for being so nice to me now. Besides the... sex and all.' The young cuntboy starts blushing a little after saying the last bit, but still smiles happily at his big friend. Seems like there were more interactions between them than you thought - well, that was only to be expected in hindsight... they're living in the same building and it's not like you've got them under constant surveillance.";
		say "     Urik relaxes in his seat again, then gives a friendly grunt and tells Eric, 'Course I do. You're a bit on the wimpy side and don't have no dick, but I like you. You're - what'chacallit - ah, 'cute'. And who's to say that we can't fix ya up into a handsome hunk eventually. Just think about it - some nice muscles on that frame, and...' The orc lets his wander over Eric's body, squeezing and touching him - in the process of which he slides the shirt of the young man's chest and throws it casually to the side. Even though there is a little bit of embarrassment and blushing left at being half-stripped so suddenly, Eric seems to enjoy the attention, breathing a little faster and leaning in to Urik's touch. 'Bit of training will bulk you up,' Urik says in a teasing tone and puts his hand on Eric's chest, stroking the abs so easily visible on his skinny chest and rubbing a nipple for a second.";
		WaitLineBreak;
		say "     'As for the other thing...' Urik goes on to say, then slides the thumb of his left hand under Eric's shorts again and this time pushes them halfway down the young athlete's legs in one go. As Eric isn't wearing underwear (maybe in anticipation of something like this?), this of course reveals the little treasure trail of red hair leading down from his navel, leading to a well-trimmed bush of pubic hair and the transgendered teen's pussy. The large orc strokes his index finger over Eric's folds and clit, drawing an aroused squeak from the naked human as he says, 'I kinda dig it now. It's not a foot-long, throbbing dick, but... fun in its own way.' With that said, Urik puts the tip of his thumb on Eric's clit and rubs a little back and forth, making the teenager moan and squirm against his arm.";
		say "     After having some clear enjoyment in teasing Eric with very gentle touches and stroking (for an orc), Urik lets go of him eventually, allowing the panting student to catch his breath again. 'But hey, if you wanna thank me kindly, I know just the way,' the orc says next, giving Eric a beaming smile. 'Yes? How can I - oh!' Eric starts to say, then gives an open-mouthed stare at the thick green shaft that springs up as Urik pulls aside his bulging loincloth. Perfectly happy to make use of this opportunity, Urik simply slides a hand up to cup the head of his human friend, then pushes Eric down to his crotch. A loud and satisfied grunt echoes through the library as the green-skinned throbbing cock-head slips between the cuntboy's lips, stretching them wide as Urik wedges the tip of his dick into Eric's mouth.";
		WaitLineBreak;
		say "     'Ngghhh - yeah!' your orc slave calls out when Eric starts suckling on his erection and playing his tongue over the cum-slit at the very top. Well-familiar with the taste and pleasurable effects of orc cum by now, Urik's little friend eagerly slurps up the little throbs of pre that leak out. His cheeks start to redden a little - not in a blush this time, but rather the start of getting buzzed on the bounty of Urik's balls. Even though Eric can take little more than the head of the green-skinned hunk's shaft, the young man is doing a nice job of worshiping the orc's manhood, stroking its girthy length with both hands while sucking on it. At the same time, Urik moves his hand down to the pale-skinned buttocks of his little friend, groping their firm curves and then feeling around for Eric's holes. Soon, the orc has two fingers thrusting in and out of Eric, fingering both his ass and pussy at the same time.";
		say "     Watching the two of them please one another with such eagerness, you can see clearly that Urik has a soft spot for Eric - while he may have his hand on the trans teen's head, he isn't actually trying to push him further down on his erection, instead just letting him take as much as he is able and even tousling his hair with surprising gentleness. Along the same lines, rubbing Eric just to please him is not something the typical orc warrior would even think of, and yet your tamed orc is doing it all on his own initiative. It is debatable what caused this change in the green-skinned brute - could be being fucked by Toven and serving as Boghrim's cum-dump during the slave hunt, or maybe your own treatment of the orc after you won him, or even just something about Eric that makes even the most brutish people and feral beasts come to care for him. No matter what, the two of them together sure give a hot show on that sofa.";
		WaitLineBreak;
		say "     Urik and Eric's bout of cock-sucking and fingering heats up quickly as Eric soon decides to feel around lower, cupping the orc's balls and then stroking the start of his butt-crack even further down. This draws a happy grunt from his partner and within moments, Urik slides his hips right up to the edge of his seat, basically opening up full access to his back door. Still suckling hard on the big brute's hard shaft, Eric runs his hand down between Urik's firm buns, then pushes in three fingers against the trembling pucker he encounters. Bellowing a deep grunt full of lust and pleasure, the orc throws his head back against the sofa cushions and thrusts up his hips, shoving several more inches into a wide-eyed Eric's mouth.";
		say "     Gagging and choking, the young man has to pull off and coughs a few times, drawing a somewhat worried look from Urik. The orc carefully brushes a red lock of hair out of Eric's face and asks in a surprisingly gentle tone, 'Everything okay?' Eric looks up at him and smiles as he sees the look of genuine concern in the orc's eyes, then replies with an edge of amusement in his voice, 'Yeah, don't worry. I just wasn't fully prepared to how you'd react to something like THIS.' And that is when he pushes even harder against Urik's asshole, sliding in not just fingers, but his whole slender hand. The orc bucks wildly as he is penetrated like this, shouting, 'Hell yeah! Fist my ass lil'E! Harder! OH GAWD YES!' Sounds like Eric found his prostate and is now directly stimulating it - and just moments later, Urik gives a guttural shout and thrusts his hips up into the air, his cock erupting with long strings of white cum that splashes down all over him, Eric, the sofa and the floor.";
		WaitLineBreak;
		say "     Having come to be a bit of a slut for orc cum, Eric tries to slide his lips back over the still spurting piece of green man-meat, but the sheer force and volume of even one spurt makes him pull back a second later, cum dripping from his lips and face as he couldn't contain more than a mouthful. His face streaked with creamy white, the college athlete swallows eagerly, then suddenly is pulled from where he is sitting on the sofa - right into a bear-hug from Urik, who kisses him deeply. The two unlikely partners make out with one another while the orc's cock still spurts out more and more cum, splattering both thoroughly. When they pull their lips apart from making out in cum-drunk giddiness, Urik says loudly, 'THAT's how I wanna be thanked all the time. So if ya feel like giving me a treat, you know what to do!'";
		say "     Eric giggles at the orc's announcement, then leans his head down to lick up a streak of cum next to Urik's right nipple, stopping to suck on it too. 'Yeah, you're a real nice buddy,' Urik tells him, then suddenly scrunches up his brows in thought. 'Wait - you didn't come yet, didcha? Time to take care of my pussyboy!' the orc murmurs, then lifts Eric up with both hands. Sliding the lithe athlete's legs over his shoulders to hook over the backrest of the sofa, Urik puts his human friend's crotch right in front of his face and starts eating him out like that while supporting Eric with a hand under his ass and behind his lower back. The naked college student moans out loud at the sudden start of getting his clit sucked on and nibbled - as well as the lofty and exposed position Urik put him in.";
		WaitLineBreak;
		say "     Giddy from orc cum, being fingered and now Urik doing his best to please him with his mouth, Eric doesn't last very long under the orc's treatment. Soon, he clenches his legs around the big brute's head, grinding his crotch against Urik's face as an orgasm rocks his body. He almost winds himself out of Urik's grip with his wild twitches, but the orc manages to hold his smaller partner secure after switching his grip a little bit. Slurping up Eric's femcum as the young athlete rides out his orgasm, Urik supports Eric without even the slightest tremble from his strong arms, then eventually lowers him again to straddle his hips and be made out with.";
		say "     With everything over but the cleaning up - which the two of them start doing by licking cum and femcum off one another - you stroll back into the more open area of the library before the two of you have any opportunity to stop you. The thought that it surely was refreshing to see that Urik can be nice if he wants to springs up in your mind, and you can't help but smile a little before turning back to other matters.";
	else:
		LineBreak;
		say "     Smiling at the fact that Eric is getting out of his shell a bit and searched out your orc slave for some fun, you turn away from the two of them and walk away. Before you're even halfway down the long row of bookshelves, a loud moan and slurping noises from behind you show that someone's sure having a good time right now.";
	now UrikEricInteraction is 5; [Urik and Eric talked and Urik got a BJ]
	now lastUrikEricInteraction is turns;

instead of navigating Grey Abbey Library while (Eric is in Bunker and (HP of Eric > 9 and HP of Eric < 20) and Urik is in Sitting Area and (UrikEricInteraction is 5) and (lastUrikEricInteraction - turns) > 8):
	say "[NavCheck Grey Abbey Library]";
	if NavCheckReturn is false, stop the action;
	move player to Grey Abbey Library;
	if debugactive is 1:
		say "     DEBUG: ERIC + URIK HANG OUT - UrikEricInteraction: [UrikEricInteraction][line break]";
	say "[EricUrikHangOut]";

to say EricUrikHangOut:
	say "     Coming into the library, you spot a familiar pair of people sitting on one of the sofas in the relatively open central section of the building. Looks like Eric is hanging out with your orcish slave Urik and is leaning against the side of the big, green-skinned brute as he reads a book. Meanwhile, the orc himself is asleep, head leaned back as he dozes peacefully with an arm wrapped around Eric's side. Despite the orc not really being the book-reading type, this apparently didn't stop Eric from trying to get him interested anyways. Still, while it was only to be expected that he at some point dropped the book his smaller human friend selected, what does catch your attention is that the orc seems to have stayed with Eric afterwards, just holding on to him right until he fell asleep.";
	say "     The two of them together on the sofa sure do make a nice picture - one large orc with bulging muscles and next to him a lithe athlete of a young human, snug against the larger male. You find yourself watching them for longer than you expected, right until the point in which Eric does look up and notices you. With a smile, he calls out to you, waving to come closer. 'Hi, how are things out there? Nothing too bad roaming the streets right now, I hope?' the college athlete asks in a friendly tone and you chat a little with him about what critters you saw on your way back. This conversation does wake up Urik after a little while, and with a little snorted grunt, he raises his head and opens his eyes while reflexively drawing Eric closer.";
	WaitLineBreak;
	say "     'Huh? Whut - oh, its you boss,' the orc grunts, obviously still a bit sleepy as he blinks at you. Then he looks at the young man pressed to his side and a hint of a smile tugs at the corners of his mouth. Returning his gaze to you, Urik adds, 'Been 'nice' to your friend since we... had that talk. Hell, he even made me join him for a 'book club' and all.' Judging from the snort that follows, Urik seems to find the basic idea of spending time like this ridiculous, but then... he nevertheless did try his best to participate. You talk a little with the big brute, stressing that he should also have an eye out for the library's security - as some creatures might notice the inhabited building and could come looking for loot, or sexual partners.";
	say "     When you're done talking with the two of them, you say your goodbyes and start walking towards the front desk of the library to sort through your equipment a bit. As you go along, you hear Urik's deep voice from behind you. 'So, lil'E... this reading thing isn't really my wavelength. How about we get something more interesting going? I know that 'pussy' thing of yours wants to be touched a lot. How about getting a full-on ride? Feel an orc cock in it!' The sound of indrawn breath makes you guess that the orc likely slid his hand somewhere intimate and is touching Eric. 'I - um...' Eric starts, then gives a breathless pant, 'Want to, but but... it's too public here and... oooh!' Glancing over your shoulder, you see that Urik's on his feet now, carrying Eric in a pose that has him half-hanging over one green-skinned shoulder. With a tusk-bearing smile on his face, the orc gives Eric's ass a squeeze with the hand holding on to him, then walks towards the stairs to the upper floor.";
	say "     [line break]";
	say "     [bold type]Do you let Urik walk off with Eric to fuck him ([link]Y[as]y[end link]), or will you stop the orc cold, ordering him not to ([link]N[as]n[end link])?[roman type][line break]";
	if player consents: [sex]
		LineBreak;
		say "     [bold type]Do you want to follow them and watch?[roman type][line break]";
		if player consents: [sex]
			LineBreak;
			project the Figure of Eric_Urik_naked_icon;
			say "     'I'm gonna fuck you so hard you'll see stars,' the orc says in an amused, gruff tone, playfully jostling Eric on his shoulder as he carries the college athlete with him. Urik strides forward in a quick walk, showing how eager the orc is to take Eric, and so it doesn't take long for them to reach the top of the stairs. You give them a few moments head start, then quietly follow the horny duo, careful to keep from being noticed - it wouldn't do for Eric to get embarrassed and change his mind, after all. By the time you've climbed upstairs yourself, Urik is just vanishing behind one of the rows of bookshelves - no doubt to go to the somewhat out of the way sofa on which you've found them entwined before.";
			say "     Hurrying to catch up, you make your way through the library until soon finding a spot from which you can see the spot in which Urik usually hangs out - and where he and Eric had lots of oral sex before. The red-headed college athlete is already laid out lengthwise on the sofa, panting softly in arousal, and Urik is kneeling between his legs, leaning over the smaller human. Casually throwing the shirt on the floor that he just pulled off Eric's lightly muscled chest, the orc then gives his partner a tusk-bearing smile and kisses him right on the mouth, pushing his tongue in between Eric's lips. The two of them make out for a long moment, with Urik bracing himself on the cushions above Eric's head while the transgendered teen runs his hands over the orc's hard pecs and abs, brushing against the hair on his chest and pinching Urik's nipples.";
			WaitLineBreak;
			say "     The two of them eventually pull apart a little, breathing hard in built-up lust, and Urik tells Eric with a smile, 'I'm gonna show you what this orc is made of!' Straightening up, he slides his hands under Eric's long legs and pulls them up, squeezing the track runner's toned thighs in appreciation, then goes on to hook two large fingers under the belt-line of Eric's shorts. Grinning broadly at the young student, Urik pulls the article of clothing off Eric in a quick tug, sending it flying into the air to land on the top shelf of a nearby bookcase. An amused grunt draws your attention back to the orc straight away, and you can see Urik looking down at his stretched-out friend with an intrigued expression. 'Hey, this is new,' he says to Eric, referring to the small piece of black fabric covering the shyly blushing human's crotch. Urik brings his hand down between Eric's legs and rubs over the simple - and rather skimpy - tanga his friend is wearing, drawing a moan as he pushes the fabric in a little between the student's nether lips.";
			say "     'I - um... like wearing them,' Eric admits, and as Urik keeps stroking up and down he pants out the words, 'They're so soft... and... nice against... my pussy.' Giving a gruff chuckle at the admission, Urik says, 'Told ya before - stop being such a pussy. Err - you know what I mean. Just wear what you want and own it - you're definitively rocking the panties, little dude.' With an aroused grunt, Urik pounces on Eric, sucking on his nipples and lightly nibbling on them while at the same time drawing the black tanga side and pushing a finger in between his nether lips. Moans fill this corner of the library as Eric is fingered and licked, writhing in pleasure and with his hands holding on tightly to the sofa cushions.";
			WaitLineBreak;
			say "     After taking his time in pleasuring Eric for a bit, Urik eventually pulls his thrusting digit out of the red-headed teenager's pussy. Bringing the finger up to his mouth, the orc licks it off like a treat, ending in a deliberate loud pop. 'You're one sweet little treat,' Urik says with a laugh, then follows up by carefully peeling the by now quite soaked panties off Eric. He holds the little shred of black fabric in his hand for a second, then brings it to his nose and takes a deep breath. 'Smells just like you. I'm gonna keep it,' the green-skinned brute says with a grin, then tugs the scrunched up tanga away under a sofa cushion. Eric's eyes go wide at the realization that Urik likes him - and lusts after him - enough to want to keep a memento, then even wider as the orc rips the loincloth off his crotch, revealing the thick green shaft of his erection.";
			say "     'Never thought I'd be this hard for fucking anything other than a hot slave's ass,' Urik groans in a lusty tone and spreads Eric's legs to move on top of the smaller human. This brings his crotch into contact with the pale-skinned student's, the curve of his hairy balls brushing against Eric's skin as he lowers himself, then rubs the shaft of his manhood up and down against the outer folds of the cuntboy's pussy. Thick, glistening drops of pre form at the tip of the orc's shaft, soon dripping down into the trimmed bush of Eric's pubes or being brushed off on the slightly protruding little button of his clit. Until Urik stops for a second that is, holding his index finger under the leaking cum-slit of his erection and wiping off a glistening dollop of the sticky liquid. Then he brings his hand to Eric's face, smearing the young athlete's lips with his pre - and Eric responds by enveloping the tip of his finger with his lips, suckling on it.";
			WaitLineBreak;
			say "     The sexual tension between the two of them reaches its height when Urik leans down to give Eric a deep and hungry kiss - and his hand moves to line his shaft up with the pussyboy's opening. Then the orc presses in - firmly, but slowly nudging apart Eric's drippingly wet nether lips. The lithe human stiffens a little, lying stretched out under the looming bulk of his orcish partner, then moans loudly into Urik's open mouth as the head and another further inch of the green-skinned brute's prick slides into him. 'Nnnghh! So tight!' Urik growls in obvious pleasure and holds on to his sexual partner tightly, half-lifting him off the sofa. You can see the firm cords of muscle in his legs tense, then relax again, as the orc holds himself back from hammering into Eric hard, instead giving him a moment to get used to the thick cock.";
			if EricVirginityTaken is 0: [virgin Eric]
				say "     'Like that cock, don'tcha?' Urik asks with a broad grin and runs a hand over Eric's naked chest, distracting himself from the desire to thrust his hips by teasing the student's nipples. 'Yesss...' Eric gasps, 'You're so thick and hot! I - I've never had any man in me before y-you. God, this feels so amazing! G-give me more. I want it!' Only too ready to oblige, the orc pushes his hips forward slowly while keeping a firm grip on the smaller human's form, allowing inch after inch of his thick manhood to sink into Eric. It is an almost entrancing thing to see such a big cock vanish into Eric's pussy, stretching his nether lips wide around the shaft. Soon, a little bulge becomes obvious under the trans teen's toned abs - and it becomes only more pronounced as Urik's cock pushes in even further.";
				now EricVirginityTaken is 5; [fucked and impregnated by Urik]
				if HP of Eric is 10: [virgin Eric]
					now HP of Eric is 14; [an NPC fucked Eric first and took his virginity]
			else: [non-virgin Eric]
				say "     'Like that cock, don'tcha?' Urik asks with a broad grin and runs a hand over Eric's naked chest, distracting himself from the desire to thrust his hips by teasing the student's nipples. 'Yesss...' Eric gasps, 'You're so thick and hot! G-give me more. I want it!' Only too ready to oblige, the orc pushes his hips forward slowly while keeping a firm grip on the smaller human's form, allowing inch after inch of his thick manhood to sink into Eric. It is an almost entrancing thing to see such a big cock vanish into Eric's pussy, stretching his nether lips wide around the shaft. Soon, a little bulge becomes obvious under the trans teen's toned abs - and it becomes only more pronounced as Urik's cock pushes in even further.";
			WaitLineBreak;
			say "     There is one moment in which the orc pauses for a second, as if having reached some internal barrier in Eric. Urik stretches his head forward and licks Eric's neck, then whispers something into his ear. The slender athlete wraps his arms around his green-skinned partner's shoulders, freeing the orc's arms to grip his hips instead of holding him up against his chest. Then Urik plants his lips firmly on the small human's, kissing him deeply as he thrusts forward hard, sinking the last two inches of his shaft into Eric's sex while giving a loud growl. His heavy balls pressing against Eric's crotch, the orc holds still once more, just keeping his partner in his arms for the moment being, then pulls his lips back from the breathlessly panting young man.";
			say "     'Knew you could take it, lil'E. You're a real trooper,' Urik says in an affectionate tone, hands moving to caress Eric's back and sides while he licks and kisses the pale-skinned teenager's neck. 'I - wow... you feel so incredibly big inside me,' Eric gasps out, pulling one arm from around Urik's shoulders to snake it down to his stomach. As he feels the quite large cock-bulge Urik's prick is making, Eric's eyes widen and he says, 'Um... how does this even... work? I think you're all the way in... you know, the womb. And it's starting to feel better and better.' The big brute holding him chuckles loudly and explains, 'That's what orc cum - and pre - does, kid. Makes a breeder nice and stretchy, when he needs to be. How else did you think they were pushing out orclings through a tight and fuck-able asshole?!'";
			WaitLineBreak;
			say "     Sticking his tongue into Eric's mouth as he opens it to say something more, Urik begins making out with the human teen - while at the same time pulling back his cock about halfway and then thrusting back into the well-stretched pussy of his slender partner. Looks like the college student's insides have been soaking in Urik's pre-cum long enough to readily stretch around the thick shaft, including his cervix, which gives Urik great pleasure as he pops his throbbing cock-head past its tight ring again and again. The two of them fill the library's echoing halls with loud moans and grunts, Urik thrusting into his smaller partner and Eric clinging to him with arms and legs wrapped around the muscled bulk of his fucker. And the sex is far from one-sided, as the lithe redhead gyrates his hips against Urik's crotch and rocks into his thrusts, panting in pleasure as he is penetrated all the way.";
			say "     You watch with bated breath as the coupling of the orc and human gets more and more intense. Now that Eric is well and ready for it, the big green brute that he has befriended really takes out all the stops - hammering in and out of his pussy with full force, creating rhythmic slapping noises of Urik's balls against Eric's crotch. It is almost hypnotic to watch Eric's stomach bulge out in the shape of the thick cock being driven into his body, then sink back down again as the orc withdraws - until finally, Urik rams into the smaller human all the way and roars in lust, his hairy balls pulsing and throbbing. You see a shudder of pleasure go through the moaning cuntboy under him as the first heavy spurt of orc cum gushes into his womb, followed by another, and another. The athletic college student orgasms right along with Urik, breathlessly gasping and leaving scratches on the orc's muscled back as his body is rocked with waves of pleasure.";
			WaitLineBreak;
			say "     Riding out their shared climax, the two of them hold on to one another tightly and start making out after catching their breaths at least a little bit. As you watch Urik cradle Eric's body against his chest, you can't help but wonder at the transformation of their relationship - from the orc snatching up a convenient human and wanting to use him as a cock-sleeve, to genuine affection and friendship between two very unlikely beings. Not that their interactions aren't highly sexualized - almost anything is these days - but there is quite a difference to for example a regular orc warrior, who'd just breed his current bitch, then go out hunting for another with his cock still dripping cum. Meanwhile, Urik is still balls-deep inside Eric - whose belly has swollen up to look almost three months pregnant - and the orc chuckles loudly as he pulls back from another kiss and looks down between them. ";
			say "     Putting a large hand on Eric's bulging stomach, he grunts, 'Almost looks like you got an orcling in there already, lil guy. Feels pretty neat too.' The college athlete's reply is pretty much just babbled word fragments and moans of course, as he is totally blissed out from the sensations of Urik's massive load filling him and being absorbed into his body. 'Lovin the orc cock I see,' Urik tells him with a smile, then plants a quick kiss on Eric's lips and gently pulls the human off his still pretty hard erection. Creamy white cum immediately starts to squirt out of the student's over-stuffed vagina, with some of it staining the sofa before Urik can get his head between Eric's legs and starts eating him out. It only takes a short while of hungry slurping and swallowing before the orc is as cum-drunk as his friend, and soon the two of them soon fall asleep on the sofa, entwined after sharing a mouthful of Urik's seed between them.";
			now UrikEricInteraction is 6; [Urik bred Eric's pussy]
		else: [don't watch the sex]
			LineBreak;
			say "     With a smile on your lips, you watch the orc carry his smaller friend off. Not too long after they vanish up to the first floor, you can hear pleased moans and pants, intermixed with lusty grunts echo through the library. Sounds like Eric's getting the ride of his life!";
			now UrikEricInteraction is 6; [Urik bred Eric's pussy]
	else: [no sex]
		LineBreak;
		say "     Clearing your throat, you step into the way of the orc and order him to put down Eric immediately. 'Hey boss,' Urik says with a little grumble as he sets Eric on his feet again, then continues, 'I was just gonna give the lil guy what he needs. He's just too shy to ask and...' The orc falls silent as he sees your look of disapproval. Making it clear in no uncertain terms that he can't just grab Eric and carry him off to be fucked - even if the young athlete is rather easy to talk into things. Meanwhile, Eric stands next to the two of you, an intense blush on his face as he listens. The college student bites his lips in indecision, but despite his desire to speak up, he just can't get out of his shell enough to do so. In the end, he silently looks after Urik as you send the orc off upstairs alone. With a quiet sigh of unresolved arousal, the redhead then hurries away, vanishing between the bookshelves for the moment.";
		now UrikEricInteraction is 50; [Urik stopped from breeding Eric's pussy, but Eric's desire to get fucked is awakened]
	now lastUrikEricInteraction is turns;

instead of navigating Grey Abbey Library while (Eric is in Bunker and (HP of Eric > 9 and HP of Eric < 20) and Urik is in Sitting Area and (UrikEricInteraction is 6) and (lastUrikEricInteraction - turns) > 8):
	say "[NavCheck Grey Abbey Library]";
	if NavCheckReturn is false, stop the action;
	move player to Grey Abbey Library;
	if debugactive is 1:
		say "     DEBUG: ERIC + URIK FUCK IN THE LIBRARY - UrikEricInteraction: [UrikEricInteraction][line break]";
	say "[EricUrikLibraryFuck]";

to say EricUrikLibraryFuck:
	say "     Coming into the library, you see Urik on the ground floor, with the large orc striding towards the rows of bookshelves further back in a confident fashion. He's got a definite element of swagger in his walk, which leads you to guess that he's not planning to just pick a good book or two. Pausing at one of the rows, he looks down the aisle in between with a grin and adjusts the sizable bulge under his loincloth. Then your orcish slave turns the corner and walks towards his target.";
	say "     [bold type]It isn't too hard to guess that Urik's intent on getting his rocks off. Do you want to check out who he's after?[roman type][line break]";
	LineBreak;
	say "     ([link]Y[as]y[end link]) - Dash over there and see what's going on.";
	say "     ([link]N[as]n[end link]) - Orcs will be orcs, you guess. Let them have their fun without observation.";
	if player consents:
		LineBreak;
		project the Figure of Eric_Urik_naked_icon;
		say "     Following after Urik with a quick sprint, you arrive at the right shelf and take a glance around its edge - about 15 feet down the aisle, your green-skinned slave stands, bent over Eric. The college athlete is blushing and biting his lip, a book held closely against his chest. Seems like he can't decide what to look at exactly, with Eric's gaze jumping between focusing on Urik's loincloth and the orc's abs and pecs - which are literally just inches from the aroused teen's face. You can guess that he is even now taking in the orc's masculine scent with each rapid breath, further stimulating his libido.";
		say "     'Come on, lil'E. Put that book away and I'll show you what real fun is,' Urik tells him in a tone laden with arousal while stroking a finger along Eric's jawline and pulling his head up to look him in the eye. 'We both know you want this,' the orc proceeds to tell his much smaller human partner and grabs the front of his tight stripper-shorts, stretching them down to hook under his balls and put his thick shaft and weighty balls in full display. Leaning forward, the green-skinned brute follows up by kissing Eric deeply.";
		WaitLineBreak;
		say "     The clatter of a book hitting the ground tells you that the teenager has come to his decision, even before hearing Eric's loud gasp of, 'Yes please! Take me!' - given in one of the short moments that Urik's tongue isn't in his mouth as they make out. Gleefully accepting Eric's consent, the large orc hooks two fingers under the college athlete's loose t-shirt and gives a quick pull upwards, sliding it off his slender chest. He balls the shirt together in his hands and gives it a long sniff, then throws it aside casually, returning his attention to the half-naked student in front of him.";
		say "     'You like having an orc daddy, don't you?' Urik grunts with a chuckle as Eric reaches out on his own accord, one hand moving to touch and stroke his orcish partner's side, the other coming to rest on the big brute's throbbing erection. 'Yeah,' the teen admits and goes on to say in a dreamy voice, 'You're so big and strong. I - I like that very much.' Laughter from the large orc fills the library as he allows Eric to feel him up some more. Then eventually, Urik tousles the smaller human's red hair and puts his hands on Eric's tight buttocks, bodily picking him up. Putting the slender athlete over his shoulder, the orc pulls his shorts down and chuckles about the black silk briefs that are revealed as he does so.";
		WaitLineBreak;
		say "     'Gonna show you what it really means to be taken by an orc,' Urik tells Eric affectionately and rubs his hand over the smooth fabric of his underwear, pushing in a finger to stroke along the crack between his buttocks. He lets his finger move up and down, sometimes even straying deeper to rub the transgender teen's feminine folds through the thin fabric - but he mainly concentrates on Eric's ass. Eventually, Urik takes hold of the skimpy underwear and tugs it off his partner, dropping the scrap of fabric to the floor. Groping the teenager's bare buttocks for a moment, the orc then puts his fingers in his mouth, getting them good and wet.";
		say "     While spreading Eric's cheeks with two fingers, Urik tells him, 'You got a pussy, which admittedly feels pretty nice, but a proper little orc breeder takes it up the ass!' And with that said, the green-skinned brute pushes his middle finger in against his partner's back door. A breathless sigh of arousal comes from the transgender teen as he feels the steady pressure and wiggling of that fingertip, slowly working its way in past the ring of his pucker. 'Man, you're really tight boy,' Urik grunts in obvious anticipation. 'This lil' ass is gonna be a snug fuck! Just gotta prep you a bit before...'";
		WaitLineBreak;
		say "     Continuing to finger Eric some more, the orc soon starts to switch up with lowering his hand to his own cock, stroking its length and milking pre-cum from the large dickhead. Again and again, he wipes up the slick fluid with his finger, using that to massage into the human's hole and working it into his inner passage. Orc cum - and precum - being as potent as it is, Eric's arousal sky-rockets and he soon is moaning almost non-stop, trembling in lust with every penetration of his partner's digits. And not only that... getting more stretchy and flexible bit by bit, the college athlete's asshole soon is able to take two of Urik's thick fingers - stretched tight, but readily expanding to allow them entry.";
		say "     'Yeah, you're ready to be a good little breeder slut!' Urik calls out amusedly and gives Eric's ass a light slap. Then he takes the smaller human down from hanging over his shoulder, pulling him against his chest to make out with. Already in a bit of a sexual haze from all the pre, the only reply from Eric is a drawn-out moan - though he does wrap his arms around Urik's neck and legs around his chest to hold onto his orc daddy. Holding his thick shaft straight up, the green-skinned brute uses his other arm to push Eric down upon it.";
		WaitLineBreak;
		say "     A shared gasp of lust, need and satisfaction from both of them echoes through the library as Urik's dickhead pops past Eric's pucker, soon followed by more and more of the mighty shaft. 'Nnnnghh! So full!' Eric shouts as he clings to the orc's chest and you can literally see his flat tummy start to bulge as he takes inch by inch of the shaft. By the time the orc bottoms out, Eric looks about three months pregnant, his belly bulging as if he was carrying the orc's child. 'Great breeder slut,' Urik grunts out between his jutting tusks, the strain in his voice making it clear that he had to hold himself back hard to not just plunge all the way into Eric from the get-go.";
		say "     You see the orc's balls twitch a little, no doubt sending more throbs of pre to fill the slender human. And then, his restraint finally runs out. With more of a growl than any recognizable words, Urik starts to pump Eric up and down on his erection, really taking out all the stops. Wet slurps fill the library from him pulling out of the teenager's asshole, then plunging in all the way once more, ending in a meaty slap of his balls smacking against Eric's buttocks. The muscular male uses his little friend like a man possessed, grinding Eric against his crotch like an over-sized fleshlight - and the college student clearly enjoys being used this way, letting out aroused shouts with each new thrust.";
		WaitLineBreak;
		say "     'Sweet! Little! Bitch!' Urik grunts out word by word in between his ponderous shoves into Eric's depths, getting quite close to an orgasm now. Then he shouts, 'Oooohhh YEAH! Take my orclings you little slut!' and squeezes Eric tight against his chest as he starts to blast a massive load up into the college student's tight passage. Grunting deeply with each throb of his balls, the orc breeds Eric into delirium, making the teen pant and moan nonstop as his body absorbs the potent load.";
		say "     Even while his cock keeps spurting more cum into Eric, now that the immediate pressure is taken off Urik pulls back a little from his lust-fuelled berserk state and softens his grip on the slender teen in his arms. 'You did good lil'E,' the orc says affectionately and strokes the pale skin of the redhead's back slowly. 'Being so tiny and yet taking my dick like a champ. You've more than earned the title of honorary orc breeder. My little orc breeder.' And with that, the muscular brute lowers his head to give Eric a loving little bite from his sharp tusks, marking the curve between his shoulder and neck with two small pricks of redness.";
		WaitLineBreak;
		say "     After this somewhat savage, yet at the same time strangely beautiful, show of affection, the orc moves to sit down right here he stands, leaning back against the bookshelf with Eric still impaled on his cock. And like that, arms wrapped around his well-bred little partner, the orc dozes off together with his human friend.";
	else:
		LineBreak;
		say "     Shrugging your shoulders, you turn your attention to other matters. It doesn't take long before lust-filled grunts and moaning echo through the large hall of the library, indicating that someone is making the orc very happy indeed.";
	now UrikEricInteraction is 7; [Urik bred Eric's ass]
	now lastUrikEricInteraction is turns;

[ Ryousei Interactions                 ]

instead of going down from the Grey Abbey Library while (Eric is in Bunker and HP of Eric < 99 and RyouseiEricInteraction < 1 and companion of player is royal tiger):
	move player to Bunker;
	if debugactive is 1:
		say "     DEBUG: Eric meets Ryousei [line break]";
	say "     As you come down the stairway and walk into the main room of the bunker, you run into Eric. The slender student is just on his way upstairs, holding a book in his hand - most likely to exchange it for another one. He gives you a smile in greeting as he passes - and while distracted in doing so, walks right into Ryousei as the anthro tiger follows you through the door. You hear a surprised sound from the young human as he steps back and looks at the person he collided with - his eyes going wide as he takes in the rich fabric of the tiger's kimono, then looks up to see the furry head of the otherworldly being. 'Oh, er - sorry. I didn't mean to... um,' the college student starts, only to fall silent as the tiger lays a clawed hand on his shoulder and gives him a friendly squeeze.";
	say "     'No harm done, young one,' Ryousei says in his deep voice, smiling at Eric and showing his muzzle full of sharp teeth. The impressive sight makes Eric gulp, drawing a chuckle from the anthro tiger. 'Be calm, little human. You have nothing to fear from me,' he continues and Eric replies, 'Thank you, sir. I'm Eric.' The slender hand of the athletic student vanishes almost completely in the much larger paw-hand of the tiger as they shake hands in greeting. 'I am Ryousei, first general of the mighty shogun Aki.' The two of them exchange a few words, Ryousei telling the tale how he was thrown into your dimension through a foul trick of his enemies, while Eric explains that he's a student. 'The pursuit of knowledge - always a noble endeavour,' Ryousei replies, then remembers something and glances down to the ground.";
	WaitLineBreak;
	say "     'Ah, you dropped your book earlier,' he says, then crouches down, picking up the hardcover book Eric had been holding. Glancing at its title, the tiger nods, then holds it out for Eric to take. You notice his nostrils flaring a little bit while doing so, apparently taking in the human student's scent. 'Thank you. I hope we can talk again sometime. The place you're from seems amazing,' Eric replies as he takes the book, then bids his farewell and steps through the doorway to go up into the library. Ryousei looks after him for a moment, tail twitching a little. Then he turns to you and remarks, 'What an interesting young man with the most peculiar scent. I certainly wouldn't mind spending some time with him.'";
	say "     'Of course, the needs of our current situation come first - I will gladly accompany you on your travel through the city, but maybe if it's time to rest at some point, we could return here? I have always liked being around knowledge seekers and students,' the tall anthro says in a friendly tone, then steps close to you again, ready to go into battle by your side.";
	now RyouseiEricInteraction is 1;
	now lastRyouseiEricInteraction is turns;

instead of navigating Grey Abbey Library while (Eric is in Bunker and Ryousei is in Grey Abbey Library and HP of Eric < 99 and RyouseiEricInteraction > 0 and (lastRyouseiEricInteraction - turns) > 8 and a random chance of 1 in 5 succeeds):
	say "[NavCheck Grey Abbey Library]";
	if NavCheckReturn is false, stop the action;
	move player to Grey Abbey Library;
	if debugactive is 1:
		say "     DEBUG: Eric & Ryousei talk in the Library - RyouseiEricInteraction: [RyouseiEricInteraction], lastRyouseiEricInteraction: [lastRyouseiEricInteraction], current turn: [turns][line break]";
	say "     As you enter the library, you spot your anthro tiger companion Ryousei sitting cross-legged in front of one of the low sofa tables in the back of the room - and next to him Eric, listening to a tale the feline recounts with avid interest. Curious about what they're talking about, you set out towards the two of them. Ryousei's rich, deep voice carries quite well in the quiet library, so even before you reach them, you overhear, [RyouseiTellsEricAStory]";

instead of going down from Grey Abbey 2F while (Eric is in Bunker and Ryousei is in Grey Abbey Library and HP of Eric < 99 and RyouseiEricInteraction > 0 and (lastRyouseiEricInteraction - turns) > 8 and a random chance of 1 in 5 succeeds):
	move player to Grey Abbey Library;
	if debugactive is 1:
		say "     DEBUG: Eric & Ryousei talk in the Library - RyouseiEricInteraction: [RyouseiEricInteraction], lastRyouseiEricInteraction: [lastRyouseiEricInteraction], current turn: [turns][line break]";
	say "     Walking down the stairs to the ground floor of the library, you spot your anthro tiger companion Ryousei sitting cross-legged in front of one of the low sofa tables in the back of the room - and next to him Eric, listening to a tale the feline recounts with avid interest. Curious about what they're talking about, you set out towards the two of them. Ryousei's rich, deep voice carries quite well in the quiet library, so even before you reach them, you overhear, [RyouseiTellsEricAStory]";

to say RyouseiTellsEricAStory:
	let randomnumber be a random number from 1 to 5;
	if randomnumber is:
		-- 1:
			say "'...but what they didn't know was that the very maiden they were searching for had been transformed into a willow-tree along the road. So she had to watch her beloved set out on a dangerous - and futile - quest to find her. Without being able to do anything about it, she wept to see him go. And then...'";
		-- 2:
			say "'...Shir'ley entranced everyone at the banquet with her great beauty and masterful dance, garbed in nothing more than a few wisps of fabric. Among her most devout admirers were the generals Lo'ma and Titus, vowing to themselves to possess her. Lo'ma was the first to be able to approach her when the crowd broke up to mingle and invited Shir'ley to a visit of his castle. But the soldiers who arrived the next day to pick her up were agents of Titus, spiriting the dancer away. And then...'";
		-- 3:
			say "'...so they lit a fire in the cave, hoping to keep away the giant rock trolls. And for what it's worth - the beasts really do hate fire, so usually that works. Just not if you're standing in the open mouth of the sleeping king of the rock troll tribe. So it awoke with...'";
		-- 4:
			say "'...the tengu was balancing on one leg in a meditative stance. A moment later, it opened one eye and gave him a cunning smile. Then it said, 'What is the sound of one hand clapping? Think wisely, your life will depend on it. Sphinxes are known to eat those that disappoint.' And with that said, the black bird suddenly vanished in a puff of smoke, blowing away on the wind...'";
		-- 5:
			say "'...of course, shogun Aki had ordered me to ensure that his people were safe. The mayor assumed that meant simply ensuring that they weren't eaten by the beasts of the forest and kept squeezing them to the edge of starvation with taxes. It didn't take long to... rectify his mistaken assumption.' Raising one hand, the tiger flexes his fingers a little, revealing sharp claws to show off to Eric.";
	say "     Becoming aware of your presence, Ryousei turns his head towards you and gives a broad smile. 'Ah, welcome my friend. I was just trading tales with Eric about my world and yours. Would you like to join the two of us?'";
	LineBreak;
	say "     ([link]Y[as]y[end link]) - Sit down at the table and listen.";
	say "     ([link]N[as]n[end link]) - Thankfully decline the offer.";
	if player consents:
		LineBreak;
		say "     You smile at the anthro tiger and Eric, happily taking a cross-legged seat at the table. Listening to Ryousei's ongoing tale, you are drawn into the narrative of its complex world and are able to forget about your own troubles for a while.";
	else:
		LineBreak;
		say "     You smile and thank the anthro tiger for his offer, but tell the two of them that you can't right now - things to do to ensure your survival in the city, as usual.";
	if RyouseiEricInteraction is 1:
		now RyouseiEricInteraction is 2; [watched em have story time]

instead of navigating Grey Abbey Library while (Eric is in Bunker and Ryousei is in Grey Abbey Library and HP of Eric < 99 and RyouseiEricInteraction > 0 and (lastRyouseiEricInteraction - turns) > 8 and a random chance of 1 in 5 succeeds):
	say "[NavCheck Grey Abbey Library]";
	if NavCheckReturn is false, stop the action;
	move player to Grey Abbey Library;
	if debugactive is 1:
		say "     DEBUG: Eric & Ryousei do tai chi - RyouseiEricInteraction: [RyouseiEricInteraction], lastRyouseiEricInteraction: [lastRyouseiEricInteraction], current turn: [turns][line break]";
	say "     As you enter the library, [RyouseiAndEricDoTaiChi]";

instead of going down from Grey Abbey 2F while (Eric is in Bunker and Ryousei is in Grey Abbey Library and HP of Eric < 99 and RyouseiEricInteraction > 0 and (lastRyouseiEricInteraction - turns) > 8 and a random chance of 1 in 5 succeeds):
	move player to Grey Abbey Library;
	if debugactive is 1:
		say "     DEBUG: Eric & Ryousei do tai chi - RyouseiEricInteraction: [RyouseiEricInteraction], lastRyouseiEricInteraction: [lastRyouseiEricInteraction], current turn: [turns][line break]";
	say "     Walking down the stairs to the ground floor of the library, [RyouseiAndEricDoTaiChi]";

to say RyouseiAndEricDoTaiChi:
	say "you spot your anthro tiger companion Ryousei back in one corner of the room, standing in a peculiar pose - legs spread fairly wide with one arm raised and the other stretched out. Then he moves, slow but smoothly, taking on a different position with his hands furled further in against his body. Ah, now you recognize what this is - Ryousei is doing Tai Chi! After holding his pose for a few more seconds, the anthro tiger visibly takes a deep breath, then ends his set and stands up straight again.";
	say "     Ryousei gives a friendly smile while looking at something and steps forward out of your line of sight. Walking a little bit to get a better viewpoint, you now see that he wasn't doing his workout alone. Eric is there with him and now your feline companion is teaching the college student to imitate his exercises, correcting his pose with gentle touches on Eric's body. Looks like the two of them are having a nice time. With relaxation and simple companionship (non-sexual, that is) being hard to come by these days in the city, you almost get envious of them...";
	say "     [bold type]But hey, why not join them? Surely your two friends wouldn't mind.[roman type][line break]";
	LineBreak;
	say "     ([link]Y[as]y[end link]) - Walk over and join the little exercise group.";
	say "     ([link]N[as]n[end link]) - Nah, let them have their shared moment on their own.";
	if player consents:
		LineBreak;
		say "     In a relaxed stroll you move over to the two of them and are soon greeted by a broad smile from the anthro tiger. 'Ah, welcome my friend. I was just teaching Eric some excesses for health and clearness of spirit. Would you like to join us?' You eagerly accept and take position right next to Eric, then begin to mimic the movements Ryousei puts him through. The interesting training session that follows takes a good twenty minutes and leaves you a little bit worn out, yet at the same time very relaxed and feeling good about yourself. This really is a boon to your humanity, soothing some of the strains that living and surviving in this city day after day puts upon it.";
		increase humanity of player by 10;
		if humanity of player > 100:
			now humanity of player is 100;
	else:
		LineBreak;
		say "     Content in just standing back and watching a moment from afar, you observe the unlikely pair of a mighty anthro tiger and a slender red-headed student talk and train together. It does you some good to see that such simple moments of fun are still possible in this now so incredibly over-sexed city. You feel more human, even just from watching.";
		increase humanity of player by 5;
		if humanity of player > 100:
			now humanity of player is 100;
	if RyouseiEricInteraction is 2:
		now RyouseiEricInteraction is 3; [watched em do tai chi]

after going to Grey Abbey Library while (Eric is in Bunker and Ryousei is in Grey Abbey Library and HP of Eric > 9 and HP of Eric < 20 and RyouseiEricInteraction > 2 and (lastRyouseiEricInteraction - turns) > 8):
	say "     As you walk into the front section of the library, you see Eric a little distance ahead of you, moving towards a somewhat out of the way corner of the expansive room. You know that this is where Ryousei has made his camp, so your curiosity drives you to follow the red-head college student and see what is going on. Walking along the curved row of bookshelves that divides the otherworldly tiger's domain from the main room, you can see Eric through the gap between the books and shelving. He looks happy and eager, most likely being out to continue his exercises or story time with Ryousei. Yet as the young man reaches a certain spot along his route, he suddenly pauses in his steps, holding his breath for a moment as he looks ahead, then goes on more slowly, as if not to make a sound. As you move into a better position along the bookshelf to see what Eric is looking at, you see that it is Ryousei - sitting on the ground cross-legged, dressed in nothing more than his white fundoshi underwear and meditating with closed eyes.";
	say "     The anthro tiger really is a sight to behold - regal and cultured even in just his underwear, he sits there with a serene expression on his face and breathes in and out slowly, his muscular chest expanding and contracting with each breath. Eric almost seems spell-bound at the sight, walking closer with soft steps and his gaze wandering over the tiger's almost naked form. Shyly biting his lip, as if nervous about making a sound to disturb the otherworldly being, the young trans-man slowly drifts closer and closer. When only a few steps divide the two of them, you notice a change in Ryousei's breathing, with the tiger's nostrils flaring a little as he draws in a deeper breath, then another. A heartbeat later, he opens his eyes and gives Eric a warm smile, waving him closer. 'Welcome, young one. What brings you to me littler corner of this grand library? Shall we share stories, train, or are there... [italic type]other[roman type] desires you want to fulfill?'";
	WaitLineBreak;
	say "     Momentarily speechless from being caught staring at the tiger, as well as the implied offer, Eric freezes in motion, as if unsure if he should stay or run away. Ryousei keeps his hand outstretched to bid him closer and goes on to say, 'I knew there was something special about your scent but couldn't place it until getting a stronger dose just now. It is rare to encounter one of the All-Mother's chose life-givers outside of a temple, or at least with numerous protectors. And you seem so nervous about revealing yourself at all. Tell me, is the faith persecuted in this savage land, and you had to go into hiding?' Ryousei keeps a friendly, caring tone as he asks Eric the last question, yet you can see from he twitch in his tail-tip that anger is brewing under the placid exterior of the mighty cat. 'You mean, you know that...' Eric stutters, waving a hand at his crotch and gaining a smiling nod from Ryousei. 'And there are more like me in your world?'";
	say "     Another nod makes the young man relax and a curious expression appear on his face, which is answered by a chuckle from the sitting tiger. 'People like yourself are chosen by the All-Mother. She is the goddess of life, and it is by her will that life prevails, even in times of strife and death. Those who are the most worthy of a given tribe are chosen to renew their people, even if they were male originally. It is a great honor.' Clearing his throat, Eric haltingly gets out the reply, 'But - but I'm not from your world. And I don't believe in that goddess. My gender was just an accident. I was bitten by someone infected.' Smiling, Ryousei adds, 'You do not need to believe in her. She believes in you - that you are special and will be the right parent to bring new life for your people. Tell me, from what you know about this contagion ravaging your city - is it normal that the only way you have changed is your gender? Believe it, you are chosen among the human tribe.' Eric stares at him wide-eyed, then slowly nods.";
	WaitLineBreak;
	say "     Silence stretches out between the two of them, with Eric trying to take in what the tiger said and Ryousei giving him the time he needs, before eventually saying, 'My earlier offer was a genuine one. If you have only recently been chosen, all of this will still be very new to you. I could show you some ways to enjoy your new form. And it would be my honor to fill your womb if you want me to.' Blushing deeply at the earnest expression on his anthro tiger friend, Eric looks at his muscular body again and steps closer, clearly about to give in to the lust he feels for Ryousei.";
	LineBreak;
	say "     [bold type]What do you want to do now?[roman type][line break]";
	say "     [link](1)[as]1[end link] - Watch the tiger and transgendered human mate.";
	say "     [link](2)[as]2[end link] - Quietly leave and give them their privacy.";
	say "     [link](3)[as]3[end link] - Quickly step out from behind the bookshelf and interfere.";
	now calcnumber is 0;
	while calcnumber < 1 or calcnumber > 3:
		say "Choice? (1-3)>[run paragraph on]";
		get a number;
		if calcnumber is 1 or calcnumber is 2 or calcnumber is 3:
			break;
		else:
			say "Invalid choice. Type [link]1[end link] to watch them, [link]2[end link] to leave, or [link]3[end link] to interfere.";
	if calcnumber is 1: [watch them]
		LineBreak;
		say "     Coming to stand right in front of the large anthro tiger, Eric looks into Ryousei's eyes and bites his lip, then gives a shy little nod. 'Yes, I - I want to do stuff with you,' he says in a shy voice, earning a pleased purr from the big cat. Ryousei smiles at his little friend and replies, 'Just relax, I'll take good care of you, my human friend.' And with that, he reaches up to stroke over the college student's chest, feeling the young man's pecs and flat abs. Letting his hands wander down, Ryousei quickly proceeds to hook his fingers under the band of Eric's shorts, pulling them off the slender athlete and revealing a skimpy pair of black panties underneath. 'You're quite beautiful, you know that?' Eric's otherworldly friend says with a smile, then leans forward to lick the inside of his thighs, all the while going on to say, 'Such soft, smooth skin. And the scent of your arousal alone is incredibly enticing.'";
		say "     Purring loudly, Ryousei pushes his head forward to nuzzle Eric's crotch, taking a deep sniff of his already slightly damp panties. A lick over the thin material follows, and another and another, licking Eric's pussy and getting him quite wound up, until the tiger soon graduates to removing the panties next. Now left with an almost naked trans-man, Ryousei eagerly goes down on him, playing his broad tongue over Eric's nether lips. The college athlete starts moaning happily and places both hands on his friend's shoulders, happy to just keep standing there, bracing against the tiger and being serviced by him. Ryousei sure knows how to treat his partner, demonstrating quite a few tricks with his tongue, all the while purring loudly and this vibrating his tongue against Eric's sex. Soon the tiger adds a finger to push into his pussy, giving the young man an extra level of stimulation that quickly gets him closer and closer to orgasm.";
		WaitLineBreak;
		say "     'Yes, YES! Just like that. I - I'm gonna...' Eric moans out loud, his fingers digging into the fur on Ryousei's shoulders as he humps against the tiger's face. He lets out a final gasp as he is pushed over the edge and comes, gushing femcum that his partner happily slurps up and swallows down. The two of them stay in that position for a while, with Ryousei continuing to lick his human friend and doing his best to prolong Eric's orgasm and the college athlete bracing against the tiger's broad shoulders. Only when the young student has recovered a bit and isn't as weak-kneed as before does Ryousei rise to his feet and stand in front of him, towering over the smaller human. 'Did you enjoy that, Eric?' he asks with a smile, chuckling as a happily moaned, 'Yes!' comes in reply. 'There is more to come, my friend,' the muscular tiger adds, then undoes the binding of his fundoshi and drops the garment to the ground.";
		say "     'Oh my!' Eric grunts as he looks down to see the hard rod with its soft little spines that pushed out of the tiger's sheath. Taking him by the hand, Ryousei guides Eric to touch his cock, stroking along its firm length and feeling over the hot shaft. The otherworldly feline lets his human friend explore his sex to his heart's content, then eventually tucks up the student's shirt and pulls it off his pale-skinned chest, throwing the garment aside. He leans down to kiss Eric on the lips, starting out a bout of making out between the two of them that culminates in Ryousei sliding both his large hands under the student's buttocks, lifting him off the ground and holding him up so they can more easily keep kissing. Eric in turn wraps his legs around his furry partner's hips, holding himself up on the large tiger.";
		WaitLineBreak;
		say "     It doesn't take long before man-handling his human friend to make out with him escalates to Ryousei lifting Eric a little bit further and lining up his hard rod, then sliding the slender young man's wet pussy down onto his shaft. Both of them let out loud moans as the tiger enters his friend's pussy and pushes deep into him[if HP of Eric is 10], breaking his hymen and taking the cuntboy's virginity in the process[end if]. Especially the small bulge at the base of his cock is quite a hit with Eric, who gasps in pleasure as that spreads his nether lips when Ryousei bottoms out. Just holding his partner steady for a moment, Ryousei allows Eric a little moment to get used to the feeling of fullness and licks the side of his neck, the grunts into his ear, 'I hope you are ready, my friend. I don't think I can hold back much longer.' Eric pulls the tiger's muzzle up to his face to kiss it and replies, 'Take me Ryo! I want it!'";
		say "     It is as if those words flip a switch in the large feline, freeing Ryousei to show the wild side of his people. With a lusty growl, he pulls Eric up on his shaft, making the young man gasp in shocked pleasure as the soft spines on Ryousei's cock rub his insides. Jamming the small human down on his pole to meet a forceful thrust of his hips, the anthro feline drives himself home into his mate again, and then keeps going just like that, pounding Eric hard and fast onto his throbbing cock. The deep-throated purring of the tiger gets even louder then before, now intermixed with lusty growls and possessive roars as he shows an almost feral intensity in his behaviour towards Eric. In their no-holds-barred fuck, Eric at times looks like a rag-doll as he is man-handled by the horny beast that is his friend, yet he moans and gasps happily as he is fucked, even shouting for Ryousei to keep going. He clearly likes a wild ride.";
		WaitLineBreak;
		say "     From your position behind the bookshelf, you have a prime view of the hot interspecies mating between your two friends, watching them go at it with interest. Being hammered with a thick, spined cock and feeling Ryousei's knot pop past his opening again and again, Eric is quickly driven to ecstatic heights, moaning whorishly despite his previous orgasm not too long ago. His partner is not too far behind, grunting and growling deeply at the pleasure of taking the college student's tight pussy for a ride. Grinding against each other in frantic haste, Eric is the first to pass the point of no return, letting out a breathless shout as he comes, gushing femcum and soaking Ryousei's crotch fur. Just a few heartbeats later, the large tiger rams him down on his cock with full force and roars in satisfaction, his balls throbbing to deliver spurt after spurt of potent tiger cum into the human cuntboy.";
		say "     Holding Eric firmly in his arms, Ryousei continues to do smaller thrusts against his body, coinciding with each new throb of cum painting the young man's insides white. With his lusts now satisfied through more and more cum filling his sexy little mate, Ryousei's friendly and cultured self takes the reigns back now. The tiger slowly licks Eric's sweaty skin and then looks him in the eye as he says, 'You are an amazing partner to be with, my friend. I definitively would love to see your belly swell with my children. If this time doesn't take, how about we try again. And often.' Eric is still far too out of it to do anything but give a happy nod, then sinks forward and rests his head on Ryousei's shoulder. The tiger takes this with amusement, patting his sex-friend gently and then walking over to his bedroll. Still holding onto Eric, he lays down on the mat, stretching out on his back to allow Eric to rest on his warm, purring chest.";
		now RyouseiEricInteraction is 5; [player watched Eric and Ryo fuck]
		if HP of Eric is 10: [virgin Eric]
			now HP of Eric is 14; [an NPC fucked Eric first and took his virginity]
		if EricVirginityTaken is 0:
			now EricVirginityTaken is 8; [by Ryousei]
	else if calcnumber is 2: [leave them]
		LineBreak;
		say "     Quietly stepping back from the spot from which you had been watching the two of them, you turn back to the entrance of the library. As you walk away, you can hear Eric's moans rise up behind you.";
		now RyouseiEricInteraction is 4; [player didn't watch Eric and Ryo fuck]
		if HP of Eric is 10: [virgin Eric]
			now HP of Eric is 14; [an NPC fucked Eric first and took his virginity]
		if EricVirginityTaken is 0:
			now EricVirginityTaken is 8; [by Ryousei]
	else if calcnumber is 3: [interfere]
		LineBreak;
		say "     Walking to the end of the bookshelf, you turn the corner and step into sight of your two companions. Ryousei takes your sudden appearance with his usual friendly demeanour, while Eric gets quite flustered and red in the face. As the large tiger asks you if you need his assistance on another trip into the city, Eric quickly uses the chance to excuse himself and hurry off out of sight. Chatting a little with your otherworldly friend, you eventually leave Ryousei to get back to meditation, with him saying again that he'll be there when you call him.";
		now RyouseiEricInteraction is 100; [player interfered in the 'moment' between em]


[ Sven Interactions                    ]

instead of going down from the Grey Abbey Library while (Eric is in Bunker and HP of Eric < 99 and HP of Sven >= 30 and HP of Sven < 50 and ConfSvenEricInteraction < 1):
	move player to Bunker;
	if debugactive is 1:
		say "     DEBUG: Eric meets Confident Sven [line break]";
	say "     As you come down the stairway and walk into the main room of the bunker, your gaze falls upon Eric, sitting cross-legged on a bed and reading a book. The college student is totally concentrated on it, eating up the pages and oblivious to anything around him - like for example Sven, who is leaning against a wall not to far off, apparently checking Eric out. Then the snow-leopard seems to come to a decision, a smile spreading over his face as he pushes off from the wall and walks over towards Eric on his slender paws. 'Hey there,' Sven confidently says after sitting down next to Eric, offering his paw to shake. Looking up from his book, Eric's eyes go wide as he is surprised by the anthro feline sitting so closely next to him. He is quick to catch himself again though, returning Sven's smile and taking his paw in greeting.";
	say "     'Thought I'd introduce myself, with the two of us being in the same boat and all that. Tenvale College students, stranded in the city and finding a refuge here. So... I'm Sven,' the friendly snow leopard goes on to say, earning a reply of, 'Oh. Yeah, sure! I'm Eric, nice to meet you.' There are a few seconds of silence as neither of them can find more to say, until Eric suddenly asks, 'Um... how did you know I went to Tenvale?' Sven gives an amused snort and reaches over to tug on the front of Eric's shirt, making the young man look down and see the lettering and logo of the college on it. 'Oh. Of course,' Eric adds after that and the two of them laugh together at the situation.";
	WaitLineBreak;
	say "     With the ice between the two young guys now well and truly broken, Sven starts to chat Eric up about their shared time in Tenvale College. As it turns out, they did actually have one class together, even if they never knowingly met or talked before. For a little while, the atmosphere in the room almost makes you forget what is going on these days - it's just two guys chatting and laughing as they recount the most interesting and funny events of the last semester. It doesn't take that long before the conversation veers off to focus on the nanite outbreak, with Eric glumly recounting how a friend turned into a shaggy monster and bit him.";
	say "     Sven listens intently to Eric's further tale, how he barricaded himself in the lockerroom and all that, until the college athlete gets even more distraught as he brings up the fate of his ex-girlfriend Stacy. 'If I - if things hadn't gone as they did the day before, I could have been there to protect her. Maybe she'd still be human, you know...' Eric quietly sobs, putting his face in his hands. Then a white-furred paw closes on the college student's shoulder and Sven gives him a little shake to get him out of his slump. 'Hey, you don't know that. And don't blame yourself. From what you told me, she dumped you, not the other way around, and you still went out to look for her afterwards regardless.'";
	WaitLineBreak;
	say "     'Some things just happen, no matter what you do. It's... fate, I guess. Just look at me, hah!' Sven goes on to say, holding up his white-furred right arm and wiggling with the digits of his paw. Eric raises one hand to touch his arm, stroking over the soft fur - which seems to help him lay the self-recriminations to rest for now. Smiling as his newfound friend touches him gently, Sven goes on to casually snake his quite long tail around the sitting human, the end angling upwards ever so slowly until it tickles the side of Eric's neck, just under the ear. Rubbing his neck, the college athlete is surprised as his hand encounters the soft tail-tip, making him turn his head and look right at it.";
	say "     The conversation of the two college students turns to nicer topics afterwards, with Sven telling an action-packed story about how you and he fought off the snow leopard and answering Eric's questions about how it feels to be a big cat with fur and all that. You drift away after a little while, leaving the two of them to talk and get to know each other better. One thing is for sure though - they're hitting it off quite well, and you don't doubt that Sven and Eric will be fast friends in no time.";
	now ConfSvenEricInteraction is 1;
	now lastConfSvenEricInteraction is turns;

[ Fang Interactions                    ]

instead of navigating Grey Abbey Library while (XP of Erica is 0 and Fang is in Grey Abbey Library and (HP of Eric > 9 and HP of Eric < 20) and (lastfuck of Eric - turns) > 12):
	say "[NavCheck Grey Abbey Library]";
	if NavCheckReturn is false, stop the action;
	move player to Grey Abbey Library;
	if debugactive is 1:
		say "     DEBUG: Eric first Fang sex walkin, XP of Erica: [Xp of Erica], HP of Eric: [HP of Eric], lastfuck of Eric: [lastfuck of Eric] [line break]";
	say "     As you enter the library, you see Eric walk in between two of the long shelves, intently scanning over the titles of the books. Now that you think of it, he's been spending quite a bit of his time up here lately, picking out books and reading. Well, it's something interesting to do at least. Just as you start turning away to leave him to his reading, you see Fang's furred shape silently stalk after Eric. Knowing that he's a wild and horny beast, you see where this might lead...";
	LineBreak;
	say "     ([link]Y[as]y[end link]) - Go after them to see what happens and maybe do something about it.";
	say "     ([link]N[as]n[end link]) - Leave them to it and turn your attention to other things.";
	if player consents: [follow]
		LineBreak;
		say "     Walking into the same space between the bookshelves that you saw your two companions go into, you spot Eric some distance ahead of you, crouched down in front of a shelf and still checking out books, totally oblivious to Fang stalking him. Then the dark-furred wolf catches up to the young man and pounces, hitting him with both front paws in the back and making him fall over on all fours, with the books he was holding tumbling on the floor. 'Hey, what are you doing,' the college athlete starts to exclaim - only to fall silent with a frightened 'Eeep' when he turns his head to face his attacker and finds herself face to face with a snarling and dominantly growling Fang. With Eric frozen motionless from seeing the wolf's sharp fangs bared at him, the feral beast raises a paw and pushes down on his shoulders, successfully managing to make him lower his front some more, now looking up at the wolf in a classically submissive pose.";
		say "     Then, giving a commanding growl that you think might mean 'stay', the wolf pads around his prey, sticking his nose in between Eric's legs from behind and taking a deep sniff. It's obvious that Fang likes the young trans-man's scent quite a bit - as his knotted shaft starts to push out from its sheath and he gives aroused growls and pants. A moment later, the feral wolf nips at Eric, catching his shorts between his teeth and giving them a tug downwards, baring his shapely behind and the white panties that form the last barrier between him and this young man's pussy. Interestingly, you notice that the silky material of Eric's underwear is rather damp at the front - almost as if he can't help but be aroused from the situation he now finds himself in.";
		LineBreak;
		if HP of Fang < 3: [Beta Fang can be stopped]
			say "     The sound of ripping cloth as Fang takes Eric's panties between his teeth and wrenches them off his body breaks you out of the stasis in which you watched what has been going on. If you want to stop Fang, now would be the time to do it!";
			LineBreak;
			say "     ([link]Y[as]y[end link]) - Pull the wolf off Eric right now.";
			say "     ([link]N[as]n[end link]) - Just let things happen...";
			if player consents: [stop beta Fang]
				LineBreak;
				say "     Rushing forward, you grab Fang by the scruff of his neck just as he rears up to mount the athletic student. The feral beast's head twists towards you as he starts a frustrated snarl at being cock-blocked... only to end in a whimper as he realizes he bared his teeth at the pack Alpha. You give the now submissively whining wolf a rough shake to remind him who's the boss, then tell him to keep his paws off Eric in the future. As you let go of Fang afterwards, he hesitates for just a second, looking with longing at Eric's bared pussy, then turns around and scurries off, tail between his legs.";
				WaitLineBreak;
				say "     Now that the wolf is gone, Eric quickly stands up and turns around, throwing his arms around you as he almost bubbles over with saying, 'Oh thank you. Thank you. I was so afraid. He was gonna -' The reassuring hug you decide to give him at this moment leads over into a moment of shocked silence... as pulling Eric closer to yourself brings the small trickle of female juices down his inner thighs into contact with your skin for a second. Both your eyes move downwards, looking at the pair of shorts still pushed down to his knees... and the swollen and dripping nether lips they're doing nothing to hide. Face flushing a deep red in embarrassment, the young man doesn't quite manage to suppress a little moan escaping his lips, then takes a deep breath and continues, '- he was going to fuck me. And... and I didn't even try to get away. I - I didn't want to, because... I just got so horny and wet even thinking about it. Oh god! What's wrong with me? I -'";
				say "     Pulling Eric close again, you stop his agitated babbling by bringing your lips to his, just holding and kissing the young trans-man until he calms down a little bit. Then you gently tell him that it's nothing to worry about too much... the nanites may make people forget their inhibitions and do crazy things in the heat of the moment, but as long as you stay true to yourself and don't succumb to such thoughts afterwards, it's just temporary. And clearly, he's not affected if he worries about it now. Eric nods slowly, though even as he accepts your reasoning, you can almost see that the thoughts in his head are still circling about what he almost willingly let a feral animal do to him. Maybe you should distract him a bit so he doesn't worry about Fang anymore - nothing happened after all and you can't hang after 'what if's' all day.";
				LineBreak;
				say "     [bold type]What do you want to do?[roman type][line break]";
				say "     ([link]Y[as]y[end link]) - Sit with him on a comfortable sofa, cuddle and read one of the books he picked together.";
				say "     ([link]N[as]n[end link]) - Have sex with him yourself - he's still pretty aroused and it'd certainly make him think of someone else than your wolf pet...";
				if player consents: [calm Eric down]
					LineBreak;
					say "     Giving Eric another quick kiss on the lips, you bend down and pick up the books Fang made him drop, guide the young athlete over to the next reading group, where you sit down comfortably together with him. Leaning back with your arm around his shoulders, you then open up a book and hold it so you can both see it, then start reading aloud from it. Between the two of you taking turns, you make it quite a few chapters into the interesting piece of literature that Eric picked out, more than long enough for her residual anxiousness about Fang to fade. In fact, you like exploring the story of the book together with your trans friend so much that you almost have to force yourself to get up, sighing about having to get back to ensuring your survival in this chaotic city.";
				else: [fuck him]
					LineBreak;
					say "     Giving Eric another quick kiss on the lips, you sneak a hand under his T-shirt, moving up to stroke over his flat abs, then up to his pecs and sensitive nipples that make the young man sigh with arousal as you play with them. As wound up as he is from his earlier encounter with Fang, the beautiful redhead just melts into your arms, readily letting himself be guided over to the next reading group, where he kneels on a softly cushioned sofa. Then the college athlete pulls his shirt over his head in a quick move, baring his well-trained, slender body for you to enjoy. A moment later, he automatically lowers himself down to all fours, legs spread widely to bare his wet and ready pussy in a typical doggie-style position. Seems like the encounter with Fang did leave some interesting effects after all...";
					if cocks of player > 0:
						say "     Finding yourself confronted with such a very enticing display of Eric's naked body, you almost rip your clothes and gear off, just flinging it to the ground as you step towards the sofa. With your raging libido in control now, you quickly climb on it behind the slender student, grunting in lust as your rock-hard cock brushes against his soft skin an eye-blink later. Eric gives a needy, almost pleading sigh and rocks back a little bit - which makes his drippingly wet nether lips engulf the tip of your shaft. As you feel the warm and tight grip of his inner passage around your manhood, you can't help but thrust into him deeply, only stopping when your crotch is flush against his behind and your cock balls-deep inside the beautiful college athlete.";
						WaitLineBreak;
						say "     'Yes. Please fuck me!' comes Eric's high-pitched moan as he starts up rocking his body back and forth to fuck himself on your shaft, quickly drawing you out of the trance of simply enjoying being inside him. You don't think you could have refused anything at all that he might have asked from you right now - and you're more than happy to take hold of the young man's hips to really thrust deep and keep going after that, pounding into his pussy with audible slaps each time your hips meet. The sounds of sex fill the aisles of the library - moans, grunts and loud panting echoing between the bookshelves as the two of you fuck each other eagerly. A smile creeps over your lips as you think about how this situation would have played out before the nanite apocalypse... yourself and a transgendered teen like Eric, totally naked and humping like bunnies - right here in a public library.";
						say "     The image of a grey-haired librarian coming to investigate and shockedly looking over the rim of her glasses at the fucking couple she'd have found draws a chuckle from you - and gives you a naughty little idea. After your next deep thrust, you lean forward on top of Eric's back and wrap your arms around his chest, then whisper into his ear, 'Sssh. Quiet, this is a library.' It's funny to hear him give a shocked gasp and try to stifle his moans - unsuccessfully, as you seek out his nipples with both hands and gently pinch them until he eventually pants out, 'Wait - what? The library is closed. There's no one here but -' The rest of his protest is replaced by a deep moan as you choose that very moment to pull out almost all the way and hammer your cock back into Eric's wet pussy, then continue to fuck him with unabated intensity.";
						WaitLineBreak;
						say "     You and your sexy friend go at it for some more time, until the relentless rubbing of your hard shaft against all the right spots inside him drive Eric to a very vocal orgasm. Hands digging into the fabric of the sofa, the young man almost screams in lust while his pussy starts to squirt and drip femcum, as well as giving you quite nice sensations yourself with the trembling and twitching of its inner muscles. It only takes a few more deep thrusts before you reach your own climax and your manhood starts to pulse as it delivers spurt after spurt of your fertile load deep into Eric's pussy.";
						say "     Breathing heavily, you eventually pull your cock out of the college athlete's trained body, then move to lie on the sofa with him, holding each other in post-coital bliss. Exhausted as he is from the scare with Fang and you wearing him out afterwards, Eric gives you a soft kiss on the lips. After the soft murmur of, 'I love you,' he dozes off afterwards. You kiss his forehead and wish you could stay like this forever, your arms around him as you rest in peace on the sofa. With a last thought you imagine your cum exploring his womb for an egg to create life with, then fall asleep yourself.";
					else if cunts of player > 0:
						say "     Finding yourself confronted with such a very enticing display of Eric's naked body, you almost rip your clothes and gear off, just flinging it to the ground as you step towards the sofa. With your raging libido in control now, you quickly sink to your knees beside it, sighing softly as you see the beautiful flower-like shape of his sex. Then you lean forward and give the little nub of his clit a teasing lick - which makes Eric give a needy, almost pleading sigh, then rock back a little bit to prolong your contact as you pull away again. Such a nice little pair of nether lips he presents to you - swollen and spread, with a glittering sheen of femcum. Your hands move almost on their own to touch them, rubbing over his folds before dipping inside, entering the warm cave of his sex and feeling to find the right spots to draw ever louder moans and pants from Eric. Meanwhile, your other hand brushes down your own body and starts to fondle your pussy in sync with Eric's, driving both your libidos higher and higher.";
						WaitLineBreak;
						say "     'Yes. Stroke me! Faster!' come Eric's high-pitched moans as he starts rocking her body back and forth to fuck herself on your fingers. You don't think you could have refused anything at all that he might have asked from you right now - and you're more than happy to intensify your manual stimulation of the trans-guy's pussy. The sounds of sex fill the aisles of the library - moans, grunts and loud panting echoing between the bookshelves. A smile creeps over your lips as you think about how this situation would have played out before the nanite apocalypse... yourself and a transgendered teen like Eric, totally naked and oh so wet and aroused - right here in a public library.";
						say "     The image of a grey-haired librarian coming to investigate and shockedly looking over the rim of her glasses at the fucking couple she'd have found draws a chuckle from you - and gives you a naughty little idea. Gently pulling your hand away from his crotch, you stand up and then lean over Eric's back, wrapping your arms around his chest and then whispering, 'Sssh. Quiet, this is a library.' It's funny to hear him give a shocked gasp and try to stifle his moans - unsuccessfully, as you seek out his nipples with both hands and gently pinch them until he eventually pants out, 'Wait - what? The library is closed. There's no one here but -' The rest of his protest is replaced by a deep moan as you choose that very moment to brush over his clit again, rubbing the little nub while sticking the fingers of your other hand between his pussy lips.";
						WaitLineBreak;
						say "     You and your sexy friend go at it for some more time, until the relentless rubbing of your talented fingers against all the right spots inside him drive Eric to a very vocal orgasm. Hands digging into the fabric of the sofa, the young man almost screams in lust while his pussy starts to squirt and drip femcum, soon trickling down over your hand and arm. It only takes a few more moments of frantic rubbing before you reach your own climax and start to squirt your female juices all over the carpet next to the sofa.";
						say "     Breathing heavily, you eventually get up from where you were leaning against the sofa and Eric's right leg, then move to lie on the sofa with him, holding each other in post-coital bliss. Exhausted as he is from the scare with Fang and you wearing him out afterwards, Eric gives you a soft kiss on the lips. After the soft murmur of, 'I love you,' he dozes off afterwards. You kiss his forehead and wish you could stay like this forever, your arms around him as you rest in peace on the sofa. With a last thought you imagine sharing a 69 in which you both lick each other, then fall asleep yourself.";
					else:
						say "     Finding yourself confronted with such a very enticing display of Eric's naked body, you almost rip your clothes and gear off, just flinging it to the ground as you step towards the sofa. With your raging libido in control now, you quickly sink to your knees beside it, sighing softly as you see the beautiful flower-like shape of his sex. Then you lean forward and give the little nub of his clit a teasing lick - which makes Eric give a needy, almost pleading sigh, then rock back a little bit to prolong your contact as you pull away again. Such a nice little pair of nether lips he presents to you - swollen and spread, with a glittering sheen of femcum. Your hands move almost on their own to touch them, rubbing over his folds before dipping inside, entering the warm cave of his sex and feeling to find the right spots to draw ever louder moans and pants from Eric. Meanwhile, your other hand brushes down your own body and starts to fondle the smooth and sexless, but nevertheless quite sensitive area of your crotch in sync with Eric's pussy, driving both your libidos higher and higher.";
						WaitLineBreak;
						say "     'Yes. Stroke me! Faster!' come Eric's high-pitched moans as he starts rocking his body back and forth to fuck himself on your fingers. You don't think you could have refused anything at all that he might have asked from you right now - and you're more than happy to intensify your manual stimulation of the trans-guy's pussy. The sounds of sex fill the aisles of the library - moans, grunts and loud panting echoing between the bookshelves. A smile creeps over your lips as you think about how this situation would have played out before the nanite apocalypse... yourself and a transgendered teen like Eric, totally naked and oh so wet and aroused - right here in a public library.";
						say "     The image of a grey-haired librarian coming to investigate and shockedly looking over the rim of her glasses at the fucking couple she'd have found draws a chuckle from you - and gives you a naughty little idea. Gently pulling your hand away from his crotch, you stand up and then lean over Eric's back, wrapping your arms around his chest and then whispering, 'Sssh. Quiet, this is a library.' It's funny to hear him give a shocked gasp and try to stifle his moans - unsuccessfully, as you seek out his nipples with both hands and gently pinch them until he eventually pants out, 'Wait - what? The library is closed. There's no one here but -' The rest of his protest is replaced by a deep moan as you choose that very moment to brush over his clit again, rubbing the little nub while sticking the fingers of your other hand between his pussy lips.";
						WaitLineBreak;
						say "     You and your sexy friend go at it for some more time, until the relentless rubbing of your talented fingers against all the right spots inside him drive Eric to a very vocal orgasm. Hands digging into the fabric of the sofa, the young man almost screams in lust while his pussy starts to squirt and drip femcum, soon trickling down over your hand and arm. It only takes a few more moments of frantic rubbing before you reach your own climax tremble all over as an amazing orgasm rocks your body.";
						say "     Breathing heavily, you eventually get up from where you were leaning against the sofa and Eric's right leg, then move to lie on the sofa with him, holding each other in post-coital bliss. Exhausted as he is from the scare with Fang and you wearing him out afterwards, Eric gives you a soft kiss on the lips. After the soft murmur of, 'I love you,' he dozes off afterwards. You kiss her forehead and wish you could stay like this forever, your arms around her as you rest in peace on the sofa. With a last thought you imagine sharing a 69 in which you both lick each other, then fall asleep yourself.";
				now XP of Erica is 99;
				now lastfuck of Eric is turns;
			else: [not stopping Beta Fang]
				LineBreak;
				if HP of Eric is 10: [virgin]
					say "     Silently watching, you just stay where you are and watch as your pet wolf rears up and sinks his canine cock into Eric's waiting pussy, sinking his maleness deep with a lusty growl. There is a little whimper from the teenager as his virginity is taken by the feral animal, making this coupling one he will never forget. ";
					now EricVirginityTaken is 6; [Fang took his virginity and knocked Eric up]
					now HP of Eric is 14; [catch-all for non virgin]
				else:
					say "     Silently watching, you just stay where you are and watch as your pet wolf rears up and sinks his canine cock into Eric's waiting pussy, sinking his maleness deep with a lusty growl. ";
				say "It's oddly exciting to see the wild animal mounting the pale-skinned human under him, his tail raised proudly as Eric can't help gasping in arousal and need. Clearly the college student is getting off more than just a little bit from being pounded by the wolf's pointy, canine shaft. As for yourself - you do suddenly realize that your left hand is down by your crotch, rubbing it to satisfy your building arousal at the sexy show. An interesting little thought bubbles up in your mind, telling you that ready the acceptance of all this - bestiality, interspecies sex and just going along with almost anything sexual once the actual act starts - must be inherent in nearly all nanite strain's mental package. And then, the realization is gone again, forgotten as your fingers open the front of your pants, baring the [if cocks of player > 0]half-hard erection you're already sporting and giving it a few slow jerks[else if cunts of player > 0]wet and swollen pussy between your legs and allowing you to rub gently over its clit[else]smooth and sexless area of your crotch and allowing you to rub gently over its sensitive skin[end if].";
				WaitLineBreak;
				say "     Under your watching eyes, Fang makes Eric his bitch, pounding into him with an animal's boundless ferocity and soon even lightly nipping at his neck to hold on to him and show his dominance. The college athlete gives high-pitched moans as he is penetrated deeply again and again - enjoying being humped so much that he even rocks backward to meet his thrusts and get more of that wolf shaft inside him. Quite a hot little show you're getting here - and in such an interesting locale. You can't help but giggle at what would have happened if this was going on before the nanite apocalypse in a public library... a young, naked guy being mounted by a wolf, filling the room with all kinds of squelchy noises while the animal's master is standing nearby and touching [if cocks of player > 0]himself[else if cunts of player > 0]herself[else]himself[end if].";
				say "     As the unequal couple's mating continues though quite a while more of hot and heavy fucking, Fang eventually gives one especially deep thrust that pops his knot inside Eric's pussy. Then the wolf simply holds still, giving pants that somehow seem very self-satisfied - while at the same time, a large fleshy bulge at the base of his cock expands, tying their bodies together. With his knot firmly in place, ensuring that he's got all the time in the world to flood his womb with burst after burst of canine seed, Fang now nuzzles Eric's neck and the side of his head, much more amicable now that he's claimed him as one of his bitches. Getting bred by the feral beast is the last straw for Eric himself - his body shudders as he orgasms, giving lust-filled moans and shouts.";
				WaitLineBreak;
				say "     With the fuck-show now being over and nothing to see except a wolf balls-deep inside a slender trans teen, you... stay a while yet, looking at Eric's enticing body while continuing to stroke yourself. It doesn't take long before the familiar sensations of an imminent orgasm build up inside you. Quickly dodging around the corner of the nearest bookshelf, you get out of sight before your rising moans draw Eric's attention, then [if cocks of player > 0]blast your load all over a meter-wide section of world literature[else if cunts of player > 0]squirt more than a little femcum to drip and soak into the carpet on the library floor[else]tremble and twitch as a breathtaking climax rocks your world[end if].";
				now XP of Erica is 3;
		else: [Alpha Fang does what he want]
			LineBreak;
			say "     The sound of ripping cloth as Fang takes Eric's panties between his teeth and wrenches them off his body breaks you out of the stasis in which you watched what has been going on. The quick thought of maybe stopping him rushes through your mind, but... no, it doesn't matter if you want to or not, you don't dare approach the dominant wolf right now. And then... the whole concept of intervening becomes moot anyways, as the mighty wolf just rears up and thrusts into the young man, mounting your friend with a loud and dominant growl that makes clear that the alpha wolf has claimed another bitch for himself. You can't help but be reminded of when he fucked you the last time, driving you to a heightened state of arousal as you imagine being the one under his furry body right now.";
			if HP of Eric is 10: [virgin]
				say "     Silently watching, you just stay where you are and watch as your alpha wolf rears up and sinks his canine cock into Eric's waiting pussy, sinking his maleness deep with a lusty growl. There is a little whimper from the teenager as his virginity is taken by the feral animal, making this coupling one he will never forget. ";
				now EricVirginityTaken is 6; [Fang took his virginity and knocked Eric up]
				now HP of Eric is 14; [catch-all for non virgin]
			else:
				say "     Silently watching, you just stay where you are and watch as your alpha wolf rears up and sinks his canine cock into Eric's waiting pussy, sinking his maleness deep with a lusty growl. ";
			say "It's oddly exciting to see the wild animal mounting the pale-skinned human under him, his tail raised proudly as Eric can't help gasping in arousal and need. Clearly the college student is getting off more than just a little bit from being pounded by the wolf's pointy, canine shaft. As for yourself - you do suddenly realize that your left hand is down by your crotch, rubbing it to satisfy your building arousal at the sexy show. An interesting little thought bubbles up in your mind, telling you that ready the acceptance of all this - bestiality, interspecies sex and just going along with almost anything sexual once the actual act starts - must be inherent in nearly all nanite strain's mental package. And then, the realization is gone again, forgotten as your fingers open the front of your pants, baring the [if cocks of player > 0]half-hard erection you're already sporting and giving it a few slow jerks[else if cunts of player > 0]wet and swollen pussy between your legs and allowing you to rub gently over its clit[else]smooth and sexless area of your crotch and allowing you to rub gently over its sensitive skin[end if].";
			WaitLineBreak;
			say "     Under your watching eyes, Fang makes Eric his bitch, pounding into him with an animal's boundless ferocity and soon even lightly nipping at his neck to hold on to him and show his dominance. The college athlete gives high-pitched moans as he is penetrated deeply again and again - enjoying being humped so much that he even rocks backward to meet his thrusts and get more of that wolf shaft inside him. Quite a hot little show you're getting here - and in such an interesting locale. You can't help but giggle at what would have happened if this was going on before the nanite apocalypse in a public library... a young, naked guy being mounted by a wolf, filling the room with all kinds of squelchy noises while another of the mighty animal's submissive partner's is standing nearby and touching [if cocks of player > 0]himself[else if cunts of player > 0]herself[else]himself[end if].";
			say "     As the unequal couple's mating continues though quite a while more of hot and heavy fucking, Fang eventually gives one especially deep thrust that pops his knot inside Eric's pussy. Then the wolf simply holds still, giving pants that somehow seem very self-satisfied - while at the same time, a large fleshy bulge at the base of his cock expands, tying their bodies together. With his knot firmly in place, ensuring that he's got all the time in the world to flood his womb with burst after burst of canine seed, Fang now nuzzles Eric's neck and the side of his head, much more amicable now that he's claimed him as one of his bitches. Getting bred by the feral beast is the last straw for Eric herself - his body shudders as he orgasms, giving lust-filled moans and shouts.";
			WaitLineBreak;
			say "     With the fuck-show now being over and nothing to see except a wolf balls-deep inside a slender trans teen, you... stay a while yet, looking at Eric's enticing body while continuing to stroke yourself. It doesn't take long before the familiar sensations of an imminent orgasm build up inside you. Quickly dodging around the corner of the nearest bookshelf, you get out of sight before your rising moans draw Eric's attention, then [if cocks of player > 0]blast your load all over a meter-wide section of world literature[else if cunts of player > 0]squirt more than a little femcum to drip and soak into the carpet on the library floor[else]tremble and twitch as a breathtaking climax rocks your world[end if].";
	else:
		LineBreak;
		say "     Oh well, it would happen at some point no matter what you do. It's not like you've got the time to constantly watch over what Fang is doing anyways. Some short time later, you hear lust-filled growls and pants sound from somewhere between the bookshelves, culminating in a satisfied howl not long after.";
		now XP of Erica is 1;
		now lastfuck of Eric is turns;

Section 5 - Endings

when play ends:
	if (HP of Eric is 0) and Sports Arena Lockerroom is known:
		if humanity of player < 10:
			increase score by 0; [do nothing, player succumbed and unaware of Eric's fate.]
		else:
			say "     When the soldiers come through the city to rescue survivors, you're all taken to a containment facility for medical evaluation and quarantine. There you meet Eric again, still rather distraught that he couldn't save or even find his girlfriend. Later, when it's time for prodding and probing you survivors, there's a bit of a commotion after Eric gets called into the examination room. Several doctors and scientists are called in and Eric gets moved to another wing of the facility and you don't see him again after that. You wonder what's so special about him.";
	else if ((Eric is in the bunker) and (HP of Eric is 1 or HP of Eric is 10 or HP of Eric is 20)): [cuntboy virgin Eric]
		if (humanity of player < 10):
			if (cocks of player > 0):
				say "     When you succumb to your infection, you make your way back to the bunker, and jump the virgin Eric you know is waiting there for you. Coming in at night, you're on his bed and plunge your shaft inside him before he even knows you're there. You keep fucking him for hours, filling his pussy with load after load of your potent cum until you finally have to rest and fall into an exhausted sleep. Slowly inching out from under you so you don't wake up, Eric flees out into the city, carrying with him your offspring already developing in his womb.";
			else:
				say "     When you succumb to your infection, you forget about Eric, turning to other things instead. Abandoned in the bunker, he stays there as long as he can, scavenging the area around it for food. On one of the trips, a pack of huskies sniff him out and he's wrestled down by several females and brought before their alpha male. The horny dog-morph forcefully takes his virginity, then breeds him at least three times a day for weeks. When some soldiers finally come by and save Eric from captivity, he's already showing a quite visible baby bump from the litter of four half-human puppies growing inside him.";
		else:
			say "     When the soldiers come through the city to rescue survivors, you're all taken to a containment facility for medical evaluation and quarantine. Eric receives special notice as he's proven immune to shifts in species, but susceptible to gender transformation. They keep him locked up for testing and prodding, and it's several weeks after you're released until you hear from him again. He meets you at a bar for a drink, thanking you again for saving him and taking him in during the time in the city. Then he moves back to his family's farm in the hinterland to take some quiet time to come to terms with being a technically female now.";
	else if ((Eric is in the bunker) and (HP of Eric is 11)): [cuntboy Eric, impregnated by the player]
		if (humanity of player < 10):
			if (cocks of player > 0):
				say "     When you succumb to your infection, you make your way back to the bunker, and jump Eric before he realizes anything is amiss. You keep fucking him for hours, filling his pussy with load after load of your potent cum until you finally have to rest and fall into an exhausted sleep. Having fallen in love with you before the infection wiped away your sanity, he hesitates a long time but finally decides he can't stay with you. Slowly inching out from under you so you don't wake up, Eric flees out into the city, carrying with him your offspring already developing in his womb.";
			else:
				say "     When you succumb to your infection, you forget about Eric, turning to other things instead. Abandoned in the bunker, he stays there as long as he can, searching for you and scavenging the area around it for food. On one of the trips, a pack of huskies sniff him out and he's wrestled down by several females and brought before their alpha male. The horny dog-morph forcefully takes his pussy, then breeds him at least three times a day for weeks. When some soldiers finally come by and save Eric from captivity, he's already showing a quite visible baby bump from the litter of four half-human puppies growing inside him.";
		else:
			say "     When the soldiers come through the city to rescue survivors, you're all taken to a containment facility for medical evaluation and quarantine. Eric receives special notice as he's proven immune to shifts in species, but susceptible to gender transformation. They keep him locked up for testing and prodding for several weeks in an isolated environment, only allowing you to speak over the phone.";
			say "     When he's finally released, he throws his arms around you and kisses you deeply as he comes out of the exit where you're waiting for him. Taking your hand and guiding it to his belly, he says 'I didn't want to say it on the phone, so... you're going to be a father. I'm pregnant.' His look of apprehension at your reaction quickly vanishes as you smile happily and give him another kiss. You walk away from the holding facility hand in hand, thoughts wandering to where to put a nursery in a shared home.";
	else if ((Eric is in the bunker) and (HP of Eric is 12)): [cuntboy Eric, impregnated by Rane]
		if (humanity of player < 10):
			if (cocks of player > 0):
				say "     When you succumb to your infection, you make your way back to the bunker, and jump Eric before he realizes anything is amiss. You keep fucking him for hours, filling his pussy with load after load of your potent cum until you finally have to rest and fall into an exhausted sleep. Slowly inching out from under you so you don't wake up, Eric flees to find refuge with Rane, who takes him in and regularly fucks the young man in both his pussy and ass. It doesn't take long till it becomes obvious that Rane's child is growing in Eric's womb - something the oni is quite proud of, though he does make Eric promise not to get 'too clingy'.";
			else:
				say "     When you succumb to your infection, you forget about Eric, turning to other things instead. Abandoned in the bunker, he stays there as long as he can, searching for you and scavenging the area around it for food. As you don't return, Eric eventually approaches Rane, who takes him in and regularly fucks the young man in both his pussy and ass. It doesn't take long till it becomes obvious that Rane's child is growing in Eric's womb - something the oni is quite proud of, though he does make Eric promise not to get 'too clingy'.";
		else:
			say "     When the soldiers come through the city to rescue survivors, you're all taken to a containment facility for medical evaluation and quarantine. Eric receives special notice as he's proven immune to shifts in species, but susceptible to gender transformation. They keep him locked up for testing and prodding for several weeks in an isolated environment, only allowing you to speak over the phone.";
			say "     When he's finally released, he throws his arms around you for a hug as he comes out of the exit where you're waiting for him. Taking your hand and guiding it to his belly, he says 'I didn't want to say it on the phone, so... I'm pregnant. Can you... help me find Rane? It's his, I'm sure about that.' His look of apprehension at your reaction quickly vanishes as you smile and nod. Together, you search out Rane and the blue oni is quite proud of learning he'll be a father - and he does take care of the young man, though he does make Eric promise not to get 'too clingy'.";
	else if ((Eric is in the bunker) and (HP of Eric is 13)): [cuntboy Eric, impregnated by Rane, fucked by the player]
		if (humanity of player < 10):
			if (cocks of player > 0):
				say "     When you succumb to your infection, you make your way back to the bunker, and jump Eric before he realizes anything is amiss. You keep fucking him for hours, filling his pussy with load after load of your potent cum until you finally have to rest and fall into an exhausted sleep. Having fallen in love with you before the infection wiped away your sanity, he hesitates a long time but finally decides he can't stay with you. Slowly inching out from under you so you don't wake up, Eric flees to find refuge with Rane, who takes him in and regularly fucks the young man in both his pussy and ass. It doesn't take long till it becomes obvious that Rane's child is growing in Eric's womb - something the oni is quite proud of, though he does make Eric promise not to get 'too clingy'.";
			else:
				say "     When you succumb to your infection, you forget about Eric, turning to other things instead. Abandoned in the bunker, he stays there as long as he can, searching for you and scavenging the area around it for food. As you don't return, Eric eventually approaches Rane, who takes him in and regularly fucks the young man in both his pussy and ass. It doesn't take long till it becomes obvious that Rane's child is growing in Eric's womb - something the oni is quite proud of, though he does make Eric promise not to get 'too clingy'.";
		else:
			say "     When the soldiers come through the city to rescue survivors, you're all taken to a containment facility for medical evaluation and quarantine. Eric receives special notice as he's proven immune to shifts in species, but susceptible to gender transformation. They keep him locked up for testing and prodding for several weeks in an isolated environment, only allowing you to speak over the phone.";
			say "     When he's finally released, he throws his arms around you for a hug and kiss as he comes out of the exit where you're waiting for him. Taking your hand and guiding it to his belly, he says 'I didn't want to say it on the phone, so... I'm pregnant. Can you... help me find Rane? It's his, I'm sure about that.' His look of apprehension at your reaction quickly vanishes as you smile and nod, then tell him you don't mind that he's carrying another's child. Together, you search out Rane and the blue oni is quite proud of learning he'll be a father - and he does take care of the young man, though he does make Eric promise not to get 'too clingy'.";
	else if ((Eric is in the bunker) and (HP of Eric is 14 or HP of Eric is 15)): [cuntboy Eric, impregnated by NPC specified by EricVirginityTaken]
		if EricVirginityTaken is 3: [felinoid]
			if (humanity of player < 10):
				if bodyname of player is "Felinoid":
					say "     Eric turns out to be a good fuck-toy for you and your felinoid mate, both your entrancing musk making him a very happy addition to your pride - eager to follow any command and be mounted again and again. It doesn't take long till it becomes obvious that the feline actually impregnated Eric when he took his virginity - and a small litter of kittens is growing in Eric's womb...";
				else:
					if (cocks of player > 0):
						say "     Even though he fails to draw you under his spell as you succumb to your infection, the felinoid stays nearby and watches as you make your way back to the bunker and jump Eric before he realizes anything is amiss. You keep fucking him for hours, filling his pussy with load after load of your potent cum until you finally have to rest and fall into an exhausted sleep. And this is the moment your former feline companion strikes, padding in on silent paws and rubbing his furred cheek against an exhausted Eric's body. The felinoid's entrancing musk soon shows its power over your college athlete, and Eric can't help but want to follow the big cat and be with him. Slowly inching out from under you so you don't wake up, Eric is guided back to the park and the felinoid's den. And there he stays, well-cared for and often cuddled and fucked by his new master. It doesn't take long till it becomes obvious that the feline actually impregnated Eric when he took his virginity - and a small litter of kittens is growing in Eric's womb. The young man is more than happy with it, content in his new role as the felinoid's sex toy and the mother of his children...";
					else:
						say "     When you succumb to your infection, you forget about Eric, turning to other things instead. Abandoned in the bunker, he stays there as long as he can, searching for you and scavenging the area around it for food. One of those trips is when your former feline companion strikes, padding in on silent paws and rubbing his furred cheek against an Eric's body. The felinoid's entrancing musk soon shows its power over the college athlete, and Eric can't help but want to follow the big cat and be with him. Eric is guided back to the park and the felinoid's den. And there he stays, well-cared for and often cuddled and fucked by his new master. It doesn't take long till it becomes obvious that the feline actually impregnated Eric when he took his virginity - and a small litter of kittens is growing in Eric's womb. The young man is more than happy with it, content in his new role as the felinoid's sex toy and the mother of his children...";
			else:
				if HP of Eric is 14:
					say "     When the soldiers come through the city to rescue survivors, you're all taken to a containment facility for medical evaluation and quarantine. Eric receives special notice as he's proven immune to shifts in species, but susceptible to gender transformation. They keep him locked up for testing and prodding for several weeks in an isolated environment, only allowing you to speak over the phone.";
					say "     When he's finally released, he throws his arms around you for a hug as he comes out of the exit where you're waiting for him. Taking your hand and guiding it to his belly, he says 'I didn't want to say it on the phone, so... I'm pregnant. And with more than one too. I - I just know it - they - are... his. Your big cat's kittens.' Eric is blushing deeply at his admission of being pregnant after a feral/human mating, but you just give him a warm embrace and try to calm him down. His babies sure won't be the first interspecies children - and definitively not be the last, from how things are going these days. And then, the felinoid himself is there with the two of you too, rubbing his flank against Eric's hips and calming the young man with a healthy dose of affection and a bit of his entrancing musk. Scritching behind the cat's ears, you feel quite confident that this will work out just fine...";
				if HP of Eric is 15:
					say "     When the soldiers come through the city to rescue survivors, you're all taken to a containment facility for medical evaluation and quarantine. Eric receives special notice as he's proven immune to shifts in species, but susceptible to gender transformation. They keep him locked up for testing and prodding for several weeks in an isolated environment, only allowing you to speak over the phone.";
					say "     When he's finally released, he throws his arms around you and kisses you deeply as he comes out of the exit where you're waiting for him. Taking your hand and guiding it to his belly, he says 'I didn't want to say it on the phone, so... I'm pregnant. And with more than one too. I - I just know it - they - are... his. Your big cat's kittens.' Eric is blushing deeply at his admission of being pregnant after a feral/human mating, but you just give him a warm embrace and try to calm him down. His babies sure won't be the first interspecies children - and definitively not be the last, from how things are going these days. His look of apprehension at your reaction quickly vanishes as you tell him just that and give him another kiss. And then, the felinoid himself is there with the two of you too, rubbing his flank against Eric's hips and calming the young man with a healthy dose of affection and a bit of his entrancing musk. Scritching behind the cat's ears, you feel quite confident that this will work out just fine. As you walk away from the holding facility hand in hand, your thoughts are already wandering to imagining a nursery in a shared home.";
		else if EricVirginityTaken is 4: [Carl]
			if (humanity of player < 10):
				if (cocks of player > 0):
					say "     When you succumb to your infection, you make your way back to the bunker and jump Eric before he realizes anything is amiss. You rip his clothes off and line up your cock to enter him - only to find yourself pulled off the cuntboy and shoved aside. Defending his friend with a snarl on his face, Carl growls at you and barks at Eric to gather up his things while he keeps you in check. Then the two of them flee out into the city, abandoning the library to your feral presence. They have quite a hard time making it out on the streets after being so suddenly up-rooted from the seemingly safe-haven - but they do last out, even though there are many close calls. By the time the military moves in, Carl and Eric are almost inseparable, happy that they found each other and can depend on the other, no matter that.";
					say "     The human and husky are checked out by the army doctors in the containment station to make sure nothing is amiss before they are being released outside the city. Eric receives special notice as he's proven immune to shifts in species, but susceptible to gender transformation. They keep him locked up for testing and prodding for several weeks in an isolated environment - and in that time the result of his time together with Carl reveals itself... as morning sickness sets in. A quickly done ultrasound shows Eric to be pregnant with twin anthro puppies. Carl's tail wags like wild as he hears the news from his apprehensive friend and the muscular canine doesn't waste a second to embrace Eric, planting a kiss on his lips. And so Carl puts in a request for 'family housing' when he is told to report back at his home base, cradling the still small-ish belly bump of his boyfriend as he does so.";
				else:
					say "     When you succumb to your infection, you forget about Eric, turning to other things instead. Abandoned in the bunker, he stays living there, teaming up with Carl to go scavenging for food and water in the surrounding blocks. At first things go alright, but their trips soon draw the attention of a gang of hyena bikers, who raid the library one night. Eric and Carl flee out into the city, abandoning the library to the laughing hyenas. They have quite a hard time making it out on the streets after being so suddenly up-rooted from the seemingly safe-haven - but they do last out, even though there are many close calls. By the time the military moves in, Carl and Eric are almost inseparable, happy that they found each other and can depend on the other, no matter that.";
					say "     As the human and husky are checked out by the army doctors in the containment station to make sure nothing is amiss before they are being released outside the city. Eric receives special notice as he's proven immune to shifts in species, but susceptible to gender transformation. They keep him locked up for testing and prodding for several weeks in an isolated environment - and in that time the result of his time together with Carl reveals itself... as morning sickness sets in. A quickly done ultrasound shows Eric to be pregnant with twin anthro puppies. Carl's tail wags like wild as he hears the news from his apprehensive friend and the muscular canine doesn't waste a second to embrace Eric, planting a kiss on his lips. And so Carl puts in a request for 'family housing' when he is told to report back at his home base a short while later, cradling the still small-ish belly bump of his boyfriend as he does so.";
			else:
				say "     When the soldiers come through the city to rescue survivors, you're all taken to a containment facility for medical evaluation and quarantine. Eric receives special notice as he's proven immune to shifts in species, but susceptible to gender transformation. They keep him locked up for testing and prodding for several weeks in an isolated environment - and in that time the result of his time together with Carl reveals itself... as morning sickness sets in. A quickly done ultrasound shows Eric to be pregnant with twin anthro puppies.";
				say "     When he's finally released, you're there to greet Eric on the now quite different outside - as everyone reels with integrating transformed people back into society. He looks around a second, as if searching for someone, throws his arms around you for a hug and tells you how glad he is to see you. Taking the college athlete home with you as a start, you tell him what's been going on and chat, though he seems somewhat subdued and frightful. A little bit of gentle prodding makes the young man open up, pulling the print-out of his ultrasound from a backpack-pocket. As he points out the tiny starts of tails on the puppies in his womb, quite a few things suddenly click into place for you...";
				say "     Bringing up something you forgot to mention in all the excitement, you tell Eric that Carl did want to come and welcome him, but couldn't - as he was quickly put back on duty as one of the better-adjusted transformed soldiers. This puts a relieved smile on Eric's face, only to vanish again as he looks at the picture in his hand. 'But, but what will he think of... this?' the young man says, his insecurity raising its head again. Grabbing him by the arm and giving Eric a supporting squeeze, you calm his fears with some effort and say that Carl will be delighted. And he is - the very next day, your canine soldier friend's tail wags like wild as he hears the news from a very apprehensive Eric. The muscular canine doesn't waste a second to embrace the shy student, planting a kiss on his lips. And so Carl puts in a request for 'family housing' when he is told to report back at his home base a short while later, cradling the still small-ish belly bump of his boyfriend as he does so.";
		else if EricVirginityTaken is 5: [Urik]
			if (humanity of player < 10):
				if Urik is in Sitting Area: [Urik is close to Eric]
					if (cocks of player > 0):
						say "     When you succumb to your infection, you make your way back to the bunker and jump Eric before he realizes anything is amiss. You rip his clothes off and line up your cock to enter him - only to find yourself pulled off the cuntboy and shoved aside. Defending the small-ish human that ended up being his friend, Urik growls at you and makes some derisive comments about not being able to control yourself, then calls over for Eric to gather up his things while he keeps you in check. The two of them flee out into the city, abandoning the library to your feral presence. With Urik's impressive physique, they manage to make it out on the streets fairly well after so suddenly being up-rooted from the seemingly safe-haven of the library. One thing they do avoid is coming anywhere near the hunting grounds of Urik's former orc tribe - as the green-skinned brute doesn't want to serve yet another master. Of course, his cravings don't just go away, so Eric (cheerfully) helps him out a lot in that regard, frequently fingering and even fisting the orc's ass and sharing his bountiful cum in sloppy kisses. By the time the military moves in, Urik and Eric are almost inseparable, happy that they can depend on the other, no matter that.";
						say "     The large orc and smaller human are checked out by the army doctors in the containment station to make sure nothing is amiss before they are being released outside the city. Eric receives special notice as he's proven immune to shifts in species, but susceptible to gender transformation. They keep him locked up for testing and prodding for several weeks in an isolated environment - and in that time the result of his time together with Urik reveals itself... as morning sickness sets in. A quickly done ultrasound shows Eric to be pregnant with a rapidly growing orcling. Urik's chest swells with pride he hears the news from his apprehensive friend and the muscular orc doesn't waste a second to embrace Eric, making a raunchy comment an planting a kiss on his lips. As soon as Eric is released, the orc takes him to the place he found for himself in the meantime, eager to take care of his little friend and await the birth of their first child.";
					else:
						say "     When you succumb to your infection, you forget about Eric, turning to other things instead. Abandoned in the bunker, he stays living there, teaming up with his orc friend Urik to go scavenging for food and water in the surrounding blocks. With the big green-skinned brute to defend the two of them, they manage to hold out very well, as any creature who would casually raid the place is quickly driven away. One thing they do avoid is coming anywhere near the hunting grounds of Urik's former orc tribe - as the green-skinned brute doesn't want to serve yet another master. Of course, his cravings don't just go away, so Eric (cheerfully) helps him out a lot in that regard, frequently fingering and even fisting the orc's ass and sharing his bountiful cum in sloppy kisses. By the time the military moves in, Urik and Eric are almost inseparable, happy that they can depend on the other, no matter that.";
						say "     The large orc and smaller human are checked out by the army doctors in the containment station to make sure nothing is amiss before they are being released outside the city. Eric receives special notice as he's proven immune to shifts in species, but susceptible to gender transformation. They keep him locked up for testing and prodding for several weeks in an isolated environment - and in that time the result of his time together with Urik reveals itself... as morning sickness sets in. A quickly done ultrasound shows Eric to be pregnant with a rapidly growing orcling. Urik's chest swells with pride he hears the news from his apprehensive friend and the muscular orc doesn't waste a second to embrace Eric, making a raunchy comment an planting a kiss on his lips. As soon as Eric is released, the orc takes him to the place he found for himself in the meantime, eager to take care of his little friend and await the birth of their first child.";
				else: [Urik is in the orc lair]
					if (cocks of player > 0):
						say "     When you succumb to your infection, you make your way back to the bunker and jump Eric before he realizes anything is amiss. You rip his clothes off and line up your cock to enter him - and do so, repeatedly and without pause. Hours later, as you doze off with your lust sated, the distraught Eric flees the library as quietly as he can, not even stopping to gather his clothes. Mostly naked, with streaks of your cum trickling down the insides of his legs, the young student does quickly attract the attention of numerous inhabitants of the surrounding city blocks - and a commotion breaks out who will get to keep such a sexy treat for themselves. After besting several other contenders, a chain-wielding hyena snatches up Eric and lays him down on his motorcycle, then slides into his seat - and Eric, at the same time. With the college student speared on his throbbing shaft, the gang-member rides off down a mostly cleared street, never to be seen again.";
					else:
						say "     When you succumb to your infection, you forget about Eric, turning to other things instead. Abandoned in the bunker, he stays living there, going scavenging for food and water in the surrounding blocks. At first things go alright, but his trips soon draw the attention of a gang of hyena bikers, who raid the library one night. There is a little bit of a scuffle about who gets to own such a nice little treat as Eric, but soon, the winner snatches up Eric and lays him down on his motorcycle, then slides into his seat - and Eric, at the same time. With the college student speared on his throbbing shaft, the gang-member rides off down a mostly cleared street, never to be seen again.";
			else:
				say "     When the soldiers come through the city to rescue survivors, you're all taken to a containment facility for medical evaluation and quarantine. Eric receives special notice as he's proven immune to shifts in species, but susceptible to gender transformation. They keep him locked up for testing and prodding for several weeks in an isolated environment - and in that time the result of his time together with Urik reveals itself... as morning sickness sets in. A quickly done ultrasound shows Eric to be pregnant with a quickly growing orcling.";
				say "     When he's finally released, you're there to greet Eric on the now quite different outside - as everyone reels with integrating transformed people back into society. He looks around a second, as if searching for someone, throws his arms around you for a hug and tells you how glad he is to see you. Taking the college athlete home with you as a start, you tell him what's been going on and chat, though he seems somewhat subdued and frightful. A little bit of gentle prodding makes the young man open up, pulling the print-out of his ultrasound from a backpack-pocket. As he points out the form of the orcish baby in his womb, quite a few things suddenly click into place for you...";
				say "     Bringing up something you forgot to mention in all the excitement, you tell Eric that Urik did want to come and welcome him, but couldn't - as he wasn't allowed to switch shifts in the construction company he works in. This puts a relieved smile on Eric's face, only to vanish again as he looks at the picture in his hand. 'But, but what will he think of... this?' the young man says, his insecurity raising its head again. Grabbing him by the arm and giving Eric a supporting squeeze, you calm his fears with some effort and say that Urik will be delighted. After all the time they spent together, Eric really should know better than to worry about the orc, of all things.";
				say "     Just as you said - a few hours later, the big green brute comes home to your place and grins broadly as he sees his little friend again. The large orc doesn't waste a second to embrace the shy student as he learns that he'll be a father, planting a kiss on his lips and making a raunchy comment about planting his seed well. After this, Eric moves in with you and eagerly shares the orc's bed, with everyone happily awaiting the birth of their first child.";
		else if EricVirginityTaken is 6: [Fang]
			if (humanity of player < 10):
				say "     When you succumb to your infection, you forget about Eric, turning to other things instead. Abandoned in the bunker, he stays there as long as he can, searching for you and scavenging the area around it for food. One of those trips is when Fang strikes, padding in on silent paws and pouncing on Eric to throw him to the ground. As he did before, the wolf forces his prey into a submissive position and rips his clothes to shreds, then mounts Eric to breed his pussy. Taking his time with such a fine bitch, the feral beast keeps at it for hours, then shoos the totally exhausted teenager towards his lair. And there he stays, giving up on trying to escape after the first few attempts that produce nothing but some painful nips and harsh fucks. At least with Fang, he is well-cared for and gets used to sleeping cuddled up against the warm side of his new master between the bouts of getting bred by his alpha. It doesn't take long till it becomes obvious that the canine actually impregnated Eric when he took his virginity - and a small litter of wolf cubs is already growing in Eric's womb. The young man is more than happy about that, content in his new role as the alpha wolf's sex toy and the mother of his children...";
			else:
				if HP of Eric is 14:
					say "     When the soldiers come through the city to rescue survivors, you're all taken to a containment facility for medical evaluation and quarantine. Eric receives special notice as he's proven immune to shifts in species, but susceptible to gender transformation. They keep him locked up for testing and prodding for several weeks in an isolated environment, only allowing you to speak over the phone.";
					say "     When he's finally released, he throws his arms around you for a hug as he comes out of the exit where you're waiting for him. Taking your hand and guiding it to his belly, he says 'I didn't want to say it on the phone, so... I'm pregnant. And with more than one too. I - I just know it - they - are... his. Your wolf's cubs.' Eric is blushing deeply at his admission of being pregnant after a feral/human mating, but you just give him a warm embrace and try to calm him down. His babies sure won't be the first interspecies children - and definitively not be the last, from how things are going these days. And then, Fang himself is there with the two of you too, tail raised proudly as he bounds up to Eric and sticks his muzzle between his legs to sniff him. Patting the large wolf's side, you feel quite confident that this will work out just fine...";
				else if HP of Eric is 15:
					say "     When the soldiers come through the city to rescue survivors, you're all taken to a containment facility for medical evaluation and quarantine. Eric receives special notice as he's proven immune to shifts in species, but susceptible to gender transformation. They keep him locked up for testing and prodding for several weeks in an isolated environment, only allowing you to speak over the phone.";
					say "     When he's finally released, he throws his arms around you and kisses you deeply as he comes out of the exit where you're waiting for him. Taking your hand and guiding it to his belly, he says 'I didn't want to say it on the phone, so... I'm pregnant. And with more than one too. I - I just know it - they - are... his. Your wolf's cubs.' Eric is blushing deeply at his admission of being pregnant after a feral/human mating, but you just give him a warm embrace and try to calm him down. His babies sure won't be the first interspecies children - and definitively not be the last, from how things are going these days. His look of apprehension at your reaction quickly vanishes as you tell him just that and give him another kiss. And then, Fang himself is there with the two of you too, tail raised proudly as he bounds up to Eric and sticks his muzzle between his legs to sniff him. As you walk away from the holding facility hand in hand, your thoughts are already wandering to imagining a nursery in a shared home.";
		else if EricVirginityTaken is 7: [Monster under the bed]
			if (humanity of player < 10):
				say "     When you succumb to your infection, you forget about Eric, turning to other things instead. Abandoned in the bunker, he stays there as long as he can, searching for you and scavenging the area around it for food. Then one day, he awakens feeling a little strange, and on pulling back his blanket, is shocked to realize that his belly now is bulging and swollen with new life growing inside it. Placing his hands on the rounded curve of his pregnant belly, Eric whimpers as he feels something move inside him, pushing back with what seems to be a mass of tentacles. Frightened, he starts to get up, but when he sets his feet down next to the bed, tentacles from underneath it quickly wrap around his ankles. The unseen creature that impregnated him has returned, and apparently doesn't want to let the mother of its offspring stumble into the city in his panic.";
				say "     Subduing the slender cuntboy with little effort, it pushes him onto the bed and holds Eric down with more tentacles, then slips a thicker appendage down his throat, feeding him with a steady trickle of its slimy seed. The college athlete is never found when the military moves in to do its sweep through the city and eventually leaves with the rescued survivors, remaining down in the bunker that was your and his refuge, and now has become the breeding ground of the monster under the bed.";
			else:
				say "     When the soldiers come through the city to rescue survivors, you're all taken to a containment facility for medical evaluation and quarantine. Eric receives special notice as he's proven immune to shifts in species, but susceptible to gender transformation. They keep him locked up for testing and prodding for several weeks in an isolated environment, only allowing you to speak over the phone. ";
				if TomeFound is 23: [player knew about tentacle fuck and told Eric]
					say "Then at some point, he suddenly isn't available to talk anymore and there is radio silence for several days. As you are just about to raise a big stink about what they are hiding, Eric is actually released all of a sudden, wearing a bit of a shell-shocked expression.";
					say "     Throwing his arms around you as he leaves the isolation facility, he holds onto you for dear life, then explains in a distraught tone that that tentacle creature from under his bed had apparently impregnated him. And worse, when the doctors made moves to get rid of whatever it would have been, they were attacked by tentacles suddenly appearing from under the gurney. After fighting off the creature by a hair's width, it took a setup with multiple high-powered lights to dispel every last shadow in the room to keep it out, finally allowing him to be freed from the unwanted passenger. You doubt that Eric will sleep soundly anytime soon after that ordeal...";
				else if TomeFound is 4 or TomeFound is 24: [player knew about tentacle fuck and didn't tell Eric]
					say "Then at some point, he suddenly isn't available to talk anymore. Somewhat freaked out about what that may mean, you investigate and keep at it till a nurse from the isolation facility eventually admits to you that they... lost Eric somehow, after his belly suddenly grew to pregnant roundness in the course of a single night. Not long after that, black tentacles snaked out from under his bed, dragging him away underneath it, where he vanished.";
					say "     A cold shiver runs down your spine, and you remember what happened that one night after Eric found that weird book. Maybe you should have told him about what happened, giving a little warning about the pregnancy, and possibly the fact that the creature was still after him. One thing is for sure - you really doubt you'll ever see the innocent college student again.";
				else if TomeFound is 96: [player knew about tentacle fuck and gave Eric the book back]
					say "Then at some point, he suddenly isn't available to talk anymore. Somewhat freaked out about what that may mean, you investigate and keep at it till you manage to corner a nurse from the isolation facility and ask him some pointed questions. The man's face shows a haunted look as he haltingly tells you what happened.";
					say "     Apparently Eric's belly grew to pregnant roundness in the course of a single night at some point one day. What exactly happened after that is anyone's guess - a female doctor and nurse went in to check on him, then the door to the room suddenly was thrown shut and wouldn't open anymore. Really weird chanting was heard from inside, and when it ended, there was not a trace to be found of any of the three people who had been in the room. A cold shiver runs down your spine, and you can't help but remember that weird book Eric found that one day. Maybe you really shouldn't have given it back to him.";
				if TomeFound is 3 or TomeFound is 98: [Eric was tentacle-fucked, player doesn't know that]
					say "Then at some point, he suddenly isn't available to talk anymore. Somewhat freaked out about what that may mean, you investigate and keep at it till a nurse from the isolation facility eventually admits to you that they... lost Eric somehow, after his belly suddenly grew to pregnant roundness in the course of a single night. Not long after that, black tentacles snaked out from under his bed, dragging him away underneath it, where he vanished.";
					say "     A cold shiver runs down your spine, and you can't help but remember that weird book Eric found that one day. Could this have something to do with that? No matter which, you really doubt you'll ever see the innocent college student again.";
		else if EricVirginityTaken is 8: [Ryousei]
			if (humanity of player < 10):
				say "     When you succumb to your infection, you make your way back to the bunker and jump Eric before he realizes anything is amiss. [if cocks of player > 0]You rip his clothes off and line up your cock to enter him [else]You grab him by the hair and push him down to orally please you [end if]- only to find yourself pulled off the cuntboy and shoved aside. Defending his friend with a snarl on his face, Ryousei growls at you and calls out for Eric to gather up his things while he keeps you in check. Then the two of them flee out into the city, abandoning the library to your feral presence. Out and about with the otherworldly tiger, the college student is well-protected by Ryousei in their further adventures in the city, growing even closer than they had been before and also continuing their intimate relations. Shortly before Ryousei actually ends up finding a way to return to his home again, morning sickness reveals that Eric is pregnant by the proud feline. When the time comes for Ryousei to open and step through a magical portal, Eric is right by his side, ready to leave everything behind to stay with his lover and bear their children in another world.";
			else:
				if HP of Eric is 14:
					say "     When the soldiers come through the city to rescue survivors, you're all taken to a containment facility for medical evaluation and quarantine. Eric receives special notice as he's proven immune to shifts in species, but susceptible to gender transformation. They keep him locked up for testing and prodding for several weeks in an isolated environment, only allowing you to speak over the phone. When he's finally released, he throws his arms around you for a hug as he comes out of the exit where you're waiting for him. Taking your hand and guiding it to his belly, he says, 'I didn't want to say it on the phone, but... I'm pregnant. It's a little boy, a tiger boy. Do you know where Ryousei is?' Eric looks hopefully at you, then smiles in relief as you reply that Ryousei actually knows enough magic for short distance teleportation.";
					say "     As soon as you find a place to stop for a moment where you are out of sight from all the soldiers at the facility, you call your otherworldly friend, and he appears moments later. The large cat is overjoyed as he learns the news from Eric, purring loudly as he embraces his smaller mate and shares a deep kiss with the young trans-man. From then on, the two of them are almost inseparable, with Ryousei spending every moment that he can with Eric, any time that he isn't busy on his quest to find a way to his home plane again. And when he eventually actually does, the tiger invites his human mate to accompany him through the magical portal. Eric does so with a smile, ready to leave everything behind to stay with his lover and bear their children in another world.";
				else if HP of Eric is 15:
					say "     When the soldiers come through the city to rescue survivors, you're all taken to a containment facility for medical evaluation and quarantine. Eric receives special notice as he's proven immune to shifts in species, but susceptible to gender transformation. They keep him locked up for testing and prodding for several weeks in an isolated environment, only allowing you to speak over the phone. When he's finally released, he throws his arms around you and gives you a kiss on the lips when he comes out of the exit where you're waiting for him. Taking your hand and guiding it to his belly, he says, 'I didn't want to say it on the phone, but... I'm pregnant. It's a little boy - Ryousei's, not yours. I hope that's not a problem between us?' Eric looks at you with some concern on his face, then gasps in relief when you simply congratulate him and Ryousei.";
					say "     As soon as you find a place to stop for a moment where you are out of sight from all the soldiers at the facility, you call your otherworldly friend, and he appears moments later. The large cat is overjoyed as he learns the news from Eric, purring loudly as he embraces his smaller mate and shares a deep kiss with the young trans-man. From then on, the two of them are almost inseparable, with Ryousei spending every moment that he can with Eric, any time that he isn't busy on his quest to find a way to his home plane again. And when he eventually actually does, the tiger invites his human mate to accompany him through the matical portal. Eric does so with a smile, ready to leave everything behind to stay with his lover and bear their children in another world.";
	else if ((Eric is in the bunker) and (HP of Eric is 21)): [horsecocked virgin Eric]
		if (humanity of player < 10):
			if (cocks of player > 0):
				say "     When you succumb to your infection, you forget about Eric, turning to other things instead. Abandoned in the bunker, he stays there as long as he can, scavenging the area around it for food. On one of the trips, he runs into a succubus who uses her alluring shape to draw Eric in and bind him to her will. Riding his cock till he fills her with his seed, she then calls in some friends and soon a whole pack of demons takes the thick horsecock into their pussies and asses. Not satisfied to wait for a ride on his manhood, several incubi take Eric's ass and mouth instead. When the whole gang-bang ebbs out and everyone is in a sweaty pile on the floor, the demons decide they want to keep Eric - permanently - and carry him off to their infernal realm.";
			else:
				say "     When you succumb to your infection, you make your way back to the bunker, and jump the Eric before he realizes anything is amiss. Rubbing up against his quickly hardening horsecock, you take away his ability to resist and fuck him for hours, filling your pussy with load after load of his potent cum. You're relentless in riding him, stroking him to hardness even as he begs for a break. He might have loved it at first, but when you fall asleep in exhaustion later, he slowly inches away from you so you don't wake up, then flees out into the city.";
		else:
			say "     When the soldiers come through the city to rescue survivors, you're all taken to a containment facility for medical evaluation and quarantine. Eric receives special notice as he's proven immune to shifts in species, but susceptible to gender transformation. They keep him locked up for testing and prodding, and it's several weeks after you're released until you hear from him again. He meets you at a bar for a drink, thanking you again for saving him and taking him in during the time in the city. Then he moves back to his family's farm in the hinterland to take some quiet time to come to terms with what happened in the city.";
			say "     He invites you to visit a while later and spend some peaceful time out in the countryside. It's quite nice out there and Eric even shows you how to ride. When you two later go for a riding and camping trip in a nearby forest, you awake in the middle of the night when you hear one of the horses whinny. Curious, you step out of the tent and look around in the moonlight, finding Eric behind some nearby trees, fucking one of the two mares you rode out here with his long horsecock. Looks like he inherited a few urges from the centaur donor of his 'cure'. You step out behind the trees, tilling him you understand and continue to watch them until he breeds the mare with a huge load of his cum.";
			say "     You visit Eric and the farm from time to time after that and see several horses['] bellies bulge with pregnancies over the coming months. Most are the results of normal equine couplings, but the two mares you had with you on that camping trip later give birth to two beautiful centaur foals, a boy and a girl, making Eric a very proud father.";
	else if ((Eric is in the bunker) and (HP of Eric is 22)): [horsecocked Eric]
		if (humanity of player < 10):
			if (cunts of player > 0):
				say "     When you succumb to your infection, you make your way back to the bunker, and jump the Eric before he realizes anything is amiss. Rubbing up against his quickly hardening horsecock, you take away his ability to resist and fuck him for hours, filling your pussy with load after load of his potent cum. You're relentless in riding him, stroking him to hardness even as he begs for a break. He might have loved it at first, but when you fall asleep in exhaustion later, he slowly inches away from you so you don't wake up, then flees out into the city.";
			else:
				say "     When you succumb to your infection, you forget about Eric, turning to other things instead. Abandoned in the bunker, he stays there as long as he can, searching for you and scavenging the area around it for food. On one of the trips, he runs into a succubus who uses her alluring shape to draw Eric in and bind him to her will. Riding his cock till he fills her with his seed, she then calls in some friends and soon a whole pack of demons takes the thick horsecock into their pussies and asses. Not satisfied to wait for a ride on his manhood, several incubi take Eric's ass and mouth instead. When the whole gang-bang ebbs out and everyone is in a sweaty pile on the floor, the demons decide they want to keep Eric - permanently - and carry him off to their infernal realm.";
		else:
			say "     When the soldiers come through the city to rescue survivors, you're all taken to a containment facility for medical evaluation and quarantine. Eric receives special notice as he's proven immune to shifts in species, but susceptible to gender transformation. They keep him locked up for testing and prodding for several weeks in an isolated environment, only allowing you to speak over the phone.";
			say "     When he's finally released, he throws his arms around you and kisses you deeply as he comes out of the exit where you're waiting for him. After some hot and heavy sex in celebration of your reunion, you drive out to his family's farm out in the countryside to get some peace and quiet for a while. It's quite nice out there and Eric even shows you how to ride.";
			say "     A while later, you two go for a riding and camping trip in a nearby forest, during which you're awoken in the middle of the night by Eric. Sporting an almost painfully hard cock, he confesses that he just can't stop thinking about fucking the mares you two rode out there. Looks like he inherited a few urges from the centaur donor of his 'cure'. You tell him you understand and accompany him outside, where he fucks both horses and fills them with his seed.";
			say "     From then on, you return to the farm from time to time, having amazing sex as the mare's pheromones put Eric's libido into overdrive. He also keeps on fucking both Claire and Brenda, your 'special' mares from that first night. After a while, their bellies start swelling in obvious pregnancies, and about ten months later, two beautiful little centaur foals are born. With Eric's son and daughter joining the family, you think it's about time to add a stable to your own house back home and move them and their mothers there...";
	else if Eric is in the bunker and HP of Eric is 31: [satyr virgin Eric]
		if humanity of player < 10:
			if cocks of player > 0:
				say "     When you succumb to your infection, you forget about Eric, turning to other things instead. Abandoned in the bunker, he stays there as long as he can, scavenging the area around it for food. On one of the trips, he runs into a succubus who uses her alluring shape to draw Eric in and bind him to her will. Riding his cock till he fills her with his seed, she then calls in some friends and soon a whole pack of demons takes the virile satyrcock into their pussies and asses. Not satisfied to wait for a ride on his manhood, several incubi take Eric's ass and mouth instead. When the whole gang-bang ebbs out and everyone is in a sweaty pile on the floor, the demons decide they want to keep Eric - permanently - and carry him off to their infernal realm.";
			else:
				say "     When you succumb to your infection, you make your way back to the bunker, and jump the Eric before he realizes anything is amiss. Rubbing up against his quickly hardening satyrcock, you take away his ability to resist and fuck him for hours, filling your pussy with load after load of his potent cum. You're relentless in riding him, stroking him to hardness even as he begs for a break. He might have loved it at first, but when you fall asleep in exhaustion later, he slowly inches away from you so you don't wake up, then flees out into the city.";
		else:
			say "     When the soldiers come through the city to rescue survivors, you're all taken to a containment facility for medical evaluation and quarantine. Eric receives special notice as he's proven immune to shifts in species, but susceptible to gender transformation. They keep him locked up for testing and prodding, and it's several weeks after you're released until you hear from him again. He meets you at a bar for a drink, thanking you again for saving him and taking him in during the time in the city. After having been stuck in the camp for so long, he's eager to get a drink and soon he's partying it up. What was going to be a quick drink turns into one after another as you start going from bar to bar.";
			say "     At one particularly lively club, you lose track of your friend for a while, but are too drunk yourself to really worry about it. It's not until some time later that you spot him in a secluded, shadowy corner with a very hot chick, banging away at her quite vigorously. Catching sight of you, he grins and winks, flashing for you to give him another five. About twenty minutes later, he and his new girlfriend join you in a booth, snuggling and kissing as they fill you in. It seems she was in the city as well during the outbreak. Once a guy, she ran afoul of some voluptuous women at the museum and transformed into a sexy nymph like them. Had it not been for a timely interruption by a sudden and heated battle between some amazons and ninjas, she'd not have made her escape at all. Feeling a strong connection to one another and able to sympathize with the plights each other has been through, they make for a very happy couple.";
	else if Eric is in the bunker and HP of Eric is 32: [satyr Eric]
		if humanity of player < 10:
			if cunts of player > 0:
				say "     When you succumb to your infection, you make your way back to the bunker, and jump the Eric before he realizes anything is amiss. Rubbing up against his quickly hardening horsecock, you take away his ability to resist and fuck him for hours, filling your pussy with load after load of his potent cum. You're relentless in riding him, stroking him to hardness even as he begs for a break. He might have loved it at first, but when you fall asleep in exhaustion later, he slowly inches away from you so you don't wake up, then flees out into the city.";
			else:
				say "     When you succumb to your infection, you forget about Eric, turning to other things instead. Abandoned in the bunker, he stays there as long as he can, searching for you and scavenging the area around it for food. On one of the trips, he runs into a succubus who uses her alluring shape to draw Eric in and bind him to her will. Riding his cock till he fills her with his seed, she then calls in some friends and soon a whole pack of demons takes the virile satyrcock into their pussies and asses. Not satisfied to wait for a ride on his manhood, several incubi take Eric's ass and mouth instead. When the whole gang-bang ebbs out and everyone is in a sweaty pile on the floor, the demons decide they want to keep Eric - permanently - and carry him off to their infernal realm.";
		else:
			say "     When the soldiers come through the city to rescue survivors, you're all taken to a containment facility for medical evaluation and quarantine. Eric receives special notice as he's proven immune to shifts in species, but susceptible to gender transformation. They keep him locked up for testing and prodding for several weeks in an isolated environment, only allowing you to speak over the phone.";
			say "     When he's finally released, he throws his arms around you and kisses you deeply as he comes out of the exit where you're waiting for him. After some hot and heavy sex in celebration of your reunion, he suggests you go out for a few drinks to unwind after everything you've been through. What you thought might be a quick drink turns into one after another as you start going from bar to bar.";
			say "     Going from club to club, Eric drinks and parties very heartily. He sneaks off with you for sex at least once at every stop and usually manages to snag a quick fuck from some other lover while he's there as well. Enjoying yourself as well, you're often there beside him with some lover of the moment. Eric's good looks and growing confidence make him very popular, and your sure his strong, virile musk doesn't hurt his chances either. Eric becomes quite the party animal, very popular and always fun to go hang out with, though he's often a little sauced as well. But even then, he's still always able to attract a few lovers for you both the share in some secluded spot whenever you go out on the town together.";
	else if ((Eric is in the bunker) and (HP of Eric is 99)): [sex slave cuntboy]
		if (humanity of player < 10):
			if (cocks of player > 0):
				say "     When you succumb to your infection, you make your way back to the bunker, and jump Eric. Coming in at night, you're on his bed and plunge your shaft inside him before he even knows you're there. You keep fucking him for hours, filling his pussy with load after load of your potent cum until you finally have to rest and fall into an exhausted sleep. Slowly inching out from under you so you don't wake up, Eric flees out into the city, carrying with him your offspring already developing in his womb.";
			else:
				say "     When you succumb to your infection, you forget about Eric, turning to other things instead. Abandoned in the bunker, he stays there as long as he can, scavenging the area around it for food. On one of the trips, a hermaphrodite gryphon spots him from the air and swoops down on him. Quickly overpowering the cuntboy, she then takes him to her nest on top of a nearby building and fucks him hard and often, filling his womb with hir eggs. When some soldiers finally come by several weeks later and save Eric from captivity, he's holding two speckled eggs warm with a few blankets, another one almost ready inside his bulging belly.";
		else:
			say "     When the soldiers come through the city to rescue survivors, you're all taken to a containment facility for medical evaluation and quarantine. Eric receives special notice as he's proven immune to shifts in species, but susceptible to gender transformation. They keep him locked up for testing and prodding, and it's several weeks after you're released until you hear from him again. He seeks you out one night, knocking at your door. A bit hesitantly he says 'Please fuck me, I - I need it - and you.' and opens up his coat, showing he's naked beneath. You wave him inside, then close the door and guide your submissive cuntboy towards the bedroom...";
	else if (HP of Eric is 100): [Stacy's girlfriend now]
		if humanity of player > 9:
			say "     When the soldiers come through the city to rescue survivors, you're all taken to a containment facility for medical evaluation and quarantine. While waiting for the doctors to examine and clear you, you hear soldiers talk about a huge green humanoid in the campus area accompanied by a massively pregnant human. Sounds like Stacy and Eric. Apparently she took out a full squad of soldiers when they wanted to 'rescue' her boy/girl-friend, adding two female soldiers to her breeding partners and leaving the rest to be picked up by horny bunny jocks.";
	else if HP of Eric is 200: [transformed into Erica]
		say ""; [dealt with in Erica's file instead]
	else if Sports Arena Lockerroom is known:
		say "ERROR-Eric-[HP of Eric]E: He should have had one of the other endings by now. Please report under which circumstances you got to see this.";


Eric ends here.
