Version 1 of Inner Mall Events by Wahn begins here.
[ Version 1 - New Event Area ]

[ DianaRelationship                                        ]
[   0: not met                                             ]
[   1: player gave her a pep talk                          ]
[  10: player took her virginity                           ]
[ 100: freaked her out                                     ]
[ 101: player was not interested                           ]

[ SizeEnvyTracker                                          ]
[   0: not found the event yet                             ]
[   1: player gave a BJ to the guys - as a woman           ]
[   2: player gave a BJ to the guys - as a man             ]
[  50: player competed - won                               ]
[  51: player competed - 2nd place                         ]
[  52: player competed - 3rd place                         ]
[  53: player competed - last place                        ]
[  99: player watched - no interaction                     ]
[ 100: player didn't watch                                 ]

[ MiltonRelationship                                       ]
[  0: not met yet                                          ]
[  1: player knows his name                                ]
[  2: two-sided introductions, and a nice chat             ]

[ AxelRelationship                                         ]
[   0: not met yet                                         ]
[   1: player knows his name                               ]
[   2: two-sided introductions                             ]
[   3: female player blew him                              ]
[   4: male player blew him                                ]
[  20: female player blew him off for payment              ]
[  21: male player blew him off for payment                ]
[ 100: avoids the player or is ignored by him              ]


SizeEnvyTracker is a number that varies.
JayMarkRelationship is a number that varies.
MiltonRelationship is a number that varies.
AxelRelationship is a number that varies.
AxelLastBJ is a number that varies. AxelLastBJ is usually 10000.

Dressing Room Rampage is a situation.
The sarea of Dressing Room Rampage is "Smith Haven".

when play begins:
	add Dressing Room Rampage to badspots of furry;

Instead of resolving a Dressing Room Rampage:
	say "     Wandering the hallways of the Smith Haven Mall, you pass through crowds of all sorts of people: lots of mall rats, other anthros, demi-human hybrids, as well as very rare pure humans. You stroll in and out of various stores, some occupied by the refugees of the outbreak, others laying abandoned. But just as you pass through a fancy clothing boutique that is empty of people, you hear something - the slapping sound of flesh on flesh, followed by a lewd moan. Curiosity guides your steps deeper into the store, walking along the aisles full of skimpy garments that are less than useless in the current crisis, until you spot a series of dressing rooms against the back wall. You notice that the third little room has its curtain drawn closed, and it is moving a little, as if being bumped around by its occupants. Judging by their tone of voice, the moans emanating from within must belong to two men who are clearly distracted indulging in carnal pleasures.";
	say "     [bold type]Do you want to pull back the curtain and have a closer look?[roman type][line break]";
	LineBreak;
	say "     ([link]Y[as]y[end link]) - Sure! They won't mind some company, will they?";
	say "     ([link]N[as]n[end link]) - Hell no! Give the guys some privacy.";
	if player consents:
		LineBreak;
		say "     Stepping forward, you take hold of the red drapes hiding the inside of the dressing room cabin and slowly pull it aside, revealing the two men within. They are an interesting couple - a magnificently large polar bear, with broad shoulders and hard muscles on his bulky frame, holding a much smaller partner by the hips as he pounds into him from behind with a thick, black-skinned shaft, balls slapping the bottom's ass in a regular rhythm. For a second, you almost peg the guy being fucked as a short, uninfected male, given his bare pink skin and rock-hard humanoid cock - but no, he's too slender and elfin for that. The glimpse of some green and red garment lying crumpled on the floor makes things click in your mind, and your guess at him being a Christmas elf is confirmed when another hard thrust makes his shoulder-length hair swing forward, revealing pointy ears beneath.";
		say "     Suddenly having a [bodyname of player in lower case] standing in front of them doesn't give pause to either of the two men. The elf has his gaze firmly trained upon the two large mirrors covering whole sections of the wall in the little room, watching his top's shaft saw in and out of his ass. Meanwhile, the polar bear just continues to pound into his little partner, although he actually registers your presence, letting out a gruff grunt to acknowledge you. 'Join in or fuck off. Better choose quickly! And draw that fucking curtain before more spectators come in,' the bear barks out in a harsh tone, spearing you with an intense gaze that demands an immediate reply.";
		say "     [bold type]How do you react to his demand?[roman type][line break]";
		LineBreak;
		say "     ([link]Y[as]y[end link]) - Step into the dressing room and strip, presenting your crotch to the elf.";
		say "     ([link]N[as]n[end link]) - Draw the curtain closed again, leaving the two of them alone.";
		if player consents:
			LineBreak;
			say "     'Damn boy, squeeze that ass. Yeah!' the polar bear grunts out loud, his large hands tightly wrapped around the elf's hips as he grinds his crotch against his ass. The small, human-like bottom whimpers in submissive pleasure from the deep penetration, his belly bulging out a little with the ursine's generous shaft. Accepting the polar bear's enticing invitation, you quickly strip down and ";
			if player is male:
				say "present your hardening cock to the slender twink of an elf. The happily moaning bottom reacts immediately, opening wide to accept your offered shaft without a beat of hesitation. His diminutive mouth forms a warm, wet vise that suckles slickly on your pulsing prick, sending shivers of arousal through your form. For such a small guy, he sure knows how to deep-throat! You run your fingers through the long and soft strands of his hair, then grab hold of them to guide the elf's blushing face up and down your [cock of player] erection, savoring his every gurgling moan around your pre-dripping cock-meat. Face-fucking the elfin male, you exchange a broad grin with the polar bear top on the other end, whose steady thrusts sink your dick deeper into his bottom's squeezing throat.";
				say "     'Quite something, isn't he?' the white-furred man says proudly, half-grunting the words as he pounds the elf's ass with one savage thrust after another. 'Best ass one could wish for. Such a fucking [italic type]tight[roman type] boy-pussy!' Given the enthusiasm with which the big man is pounding his submissive partner, you're surprised that the little guy can take it all. Maybe Christmas elves are naturally stretchy, or maybe the bottom is just exceptionally skilled at what he does? The sensation of his slurping mouth and tensing throat around your cock certainly suggests it, the little elf taking your rapid face-fucking effortlessly. He even employs little tricks to tease your arousal to greater heights, from the massaging rippling of his throat to the nimble, curling sweeps of that tiny tongue lavishing your [cock size desc of player], throbbing cock.";
				WaitLineBreak;
				say "     Spit-roasting the pale-skinned elf between the two of you is a lot of fun, and soon, you hear the grunts of the bucking polar bear grow more and more intense, heralding his impending orgasm. You pick up the slack and start really going to town on his bottom boy's face, slamming your hips against his puckered lips with increasing zeal, your own arousal soaring as his throat reflexively seizes around your shaft. It's a close call, but in the end, the broad-shouldered ursine is the first to come, thrusting in all the way and stuffing the slender elf with heavy spurts of potent seed, a hot and sticky deluge of heat that draws a fluttering moan around your member. You're only moments behind the bear, ramming your pointy-eared partner down on your shaft as you feel your balls churn and tighten. Groaning in ecstasy, the first spurt of seed paints his tongue white, and the rest is shot directly down the elf's greedy gullet, pulse after pulse of scintillating warmth coursing through his trembling form.";
				say "     Blissfully riding out your orgasm, you stay leaned over the small form of the elfin bottom, your cock throbbing with tapering spurts of cum, until you suddenly feel a tapping on your thighs, getting more urgent by the second. It takes a heartbeat or two for you to register what it actually is - your cocksucker is running out of air! you quickly slide yourself out of his tight, sweet throat, freeing the little guy to gasp for air and pant in big gulps to soothe his burning lungs. 'Thanks,' he says breathlessly as he looks up at you, amber eyes meeting your own with a cheerful smile before the guy licks his lips to catch a stray streak of cum. Meanwhile, the polar bear top behind him reaches around his still thoroughly impaled bottom boy to take hold of his hard and dripping cock, jerking him off with rapid pumps of that large, furry hand.";
			else:
				say "present your [bodyname of player in lower case][if player is female] pussy [else] crotch [end if]to the slender twink of an elf. The happily moaning bottom reacts immediately, sticking out his tongue to lick over your [if player is female]nether lips. The tip of his fleshy appendage circles your clit a few times[else]sensitive skin. The tip of his fleshy appendage seeks out a surprisingly sensitive spot[end if], making sure to stimulate it nice and long to drive you wild. He may just be a small dude, but this little guy sure knows how to please [if player is female]a woman[else]someone[end if]! You run your fingers through the long and soft strands of his hair, then grab it and use it as a nice handhold, grinding the elf's head up and down against your crotch. Rubbing up against the elfin male, you exchange a broad grin with the polar bear top on the other end.";
				say "     'Quite something, isn't he?' the white-furred man says proudly, half-grunting the words as he pounds the elf's ass with thrust after hard thrust. 'Best ass one can wish for. Such a fucking [italic type]tight[roman type] boy-pussy!' Given the enthusiasm with which the big man is pounding his submissive partner, you're surprised that the little guy can take it all. Maybe Christmas elves are just naturally stretchy, or the bottom is just exceptionally skilled at what he does. The sensation of his slurping tongue and the little teasing nibbles [if player is female]on your clit[else]he gives you[end if] certainly suggest it, as he eagerly replies to your grinding and even employs some little tricks with his tongue to tease your arousal to ever higher levels.";
				WaitLineBreak;
				say "     Spit-roasting the pale-skinned elf between the two of you is a lot of fun, and soon, you can hear the grunts of the fucking polar bear get more and more intense, heralding his impending orgasm. You take up the challenge and really push his bottom boy's face up against your [if player is female]pussy, sending your own arousal soaring from the new depth his questing tongue can reach[else]crotch, sending your own arousal soring from the increase in licking that brings with it[end if]. It is a close thing, but in the end, the broad-shouldered ursine is the first to come, thrusting in all the way and breeding the twinky elf with heavy spurts of his potent seed. You're only moments behind though, hands clamped on your pointy-eared partner as you start to [if player is female]squirt femcum into his face. He happily catches it with his tongue, then puts his lips over your clit to suckle on it and prolong your orgasm[else]tremble against his soft-skinned face[end if].";
				say "     Blissfully riding out the height of pleasure, you stay leaned over the small form of the elfin bottom, your [if player is female]sex feeling hot and wet[else]body feeling hot and sweaty[end if], until you suddenly feel a tapping on your thighs. It takes a heartbeat or two for you to register what it actually is - you've still got the elf's head wedged against your crotch, holding him rather tightly. Somewhat shamefaced, you quickly let go of his long silky hair, freeing the little guy to raise his upper body. 'Thanks,' he says with an eager smile and looks up at you, amber eyes meeting your own as the guy smiles and licks his lips. Meanwhile, the polar bear top behind him reaches around his still thoroughly impaled bottom boy and takes hold of his hard cock, jerking him off with rapid pumps of his large hand.";
			WaitLineBreak;
			say "     Wound up as the elf already is from your threesome, it doesn't take very long before he moans out loud and starts to cum, splattering the ground between his legs with spurt of his creamy white load. The polar bear keeps holding his cock until his orgasm has run its course, then brings his furry hand to the elf's face and has him lick up a streak of cum matting the fur on the side of the index finger. 'That's my boy,' the big ursine says proudly, tousling the elf's long hair. Then he turns his gaze to you and says, 'What do you think of this little slut?' The beaming smile and thumbs up he gets in response is all the bear needs to know. With a chuckle, he adds, 'Would you believe that this sweet twink was my top when we stumbled into the mall together? I'm Mark and he's Jay by the way. Been together for five years now, just... the other way around, before things happened.'";
			say "     'Hey [mister],' the exhausted elf tells you in a happy tone, lifting himself from being bent over and leaning back against the polar bear's broad chest, now giving you the full view of his slender, naked body for the first time. He is a sexy twink indeed, with his belly currently bulging out a fair bit, both from Mark's cock as well as the load of cum the bear pumped into him. Strong, white-furred arms wrap around the lithe elf and Mark adds, 'Crazy how things happen, eh? Came here to find refuge together with my man. I was a happy sub ever since I lost my virginity, but after some alone-time with Santa Claws... I started feeling differently. Stronger. More dominant. You know how it goes.' Jay leans into his embrace happily, rubbing his cheek against the polar bear's white fur, then adding a playful comment of, 'I love how my big bear daddy makes me feel. He's shown me a whole new side of myself.'";
			WaitLineBreak;
			say "     After you introduce yourself[if player is not defaultnamed] as [name of player][end if], the three of you chat a little while longer until Mark grows soft enough that his dick slips out of his lover all on its own. What doesn't come out though is cum, as all of it is apparently so deeply planted into the elven bottom that there is no danger of leakage from his tight behind. The two of them start picking up clothes to get dressed again, which actually is a bit of a difficult task with all three of you in the small dressing room. After bumping into each other a few times, you are actually allowed to go first at getting dressed, so you can step out and give them a bit more space. As you are about to pull the curtain shut behind yourself, Mark gives you an eager grin, while Jay cheerfully calls out, 'Have a nice day. Hope to see you again sometime [mister].'";
			now JayMarkRelationship is 3; [fucked around with the two of them, player knows the names]
			now Resolution of Dressing Room Rampage is 1; [fucked around in the dressing room]
		else:
			LineBreak;
			say "     Face burning in embarrassment, you murmur an apology and step back, drawing the curtain closed again. The sounds of sex from the other side continue without even a hint of an interruption. Shrugging, you turn around, quietly leaving the store again. The rest of your current trip through the building doesn't reveal any particularly interesting situations, so you eventually end up where you started.";
			now JayMarkRelationship is 1; [saw the two of them]
			now Resolution of Dressing Room Rampage is 2; [saw them naked in the dressing room]
	else:
		LineBreak;
		say "     The men in the dressing booth seem to be making the best of the whole refugee situation in the mall right now. You wish them well in your mind and turn around, quietly leaving the store again. Moving on, you follow one side of the mall wing, checking out some of the former businesses to pass the time. As you make your way forward, you eventually double back on the other side of the wide mall hallway, and fate leads you past the very store where you heard the commotion from the dressing room just as what must have been the participants walk out of it. Visually, the gay couple couldn't be more different: a towering polar bear in a checkered flannel shirt and jeans, accompanied by what is clearly a Christmas elf, complete with the stereotypical red and green outfit and sharply pointed ears that stick out through the long brown hair cascading over his shoulders.";
		say "     Yet the fact that one of them is only half as tall as the other doesn't stop them from being together, as evident by their very open affection for one another. Patting the thick and sturdy ursine leg beside him, the elf calls out, 'How about a goodbye kiss, big guy?' With a grin, the large anthro bear picks his boyfriend up for a deep and hungry kiss. Arms wrapped partially around the much bigger man's broad chest, the elf tells him, 'Be careful out there. You may be my big, strong bear now, but I worry sometimes.' With a consoling grunt, his ursine partner replies, 'Of course, hon. Nothing will keep me from coming back to you.' Following another kiss between them, the big polar bear sets his lover down, then walks off towards the mall entrance. Looking after him, you manage to lose track of his diminutive partner. Being only about four feet tall, he is quite easy to lose in the crowds of people populating the mall.";
		now JayMarkRelationship is 1; [saw the two of them]
		now Resolution of Dressing Room Rampage is 3; [saw them outside the dressing room]
	add "Tag: Met Jay&Mark" to Traits of player;
	now Dressing Room Rampage is resolved;

Elven Issues is a situation.
The Prereq1 of Elven Issues is Dressing Room Rampage.
The Prereq1Resolution of Elven Issues is { 1, 2, 3 }.
The sarea of Elven Issues is "Smith Haven".

Instead of resolving a Elven Issues:
	say "     As you go for a stroll through the mall, you suddenly hear a bit of a commotion ahead of you. Shouts of 'Hey, stop! That's mine! Thief!' come from somewhere ahead, followed by the sight of a kangaroo-morph sprinting your way. She is rushing through the thick crowd of people in the middle of the east wing of the mall at a breakneck pace, followed by a small-ish figure in a green and red outfit, running as fast as he can and furiously calling after her. It is a Christmas elf, and one you know: [if JayMarkRelationship is 3]Jay, the boyfriend of Mark the polar bear, whom you met in the dressing room of a fancy boutique[else]He was getting pounded by a quite large polar bear in the dressing room of a fancy boutique when you stumbled over him[end if]. Looks like the kangaroo will pass right by you in a few seconds.";
	say "     [bold type]How do you react to this?[roman type][line break]";
	LineBreak;
	say "     ([link]Y[as]y[end link]) - Stick out your foot and trip her.";
	say "     ([link]N[as]n[end link]) - Do not get involved.";
	if player consents:
		LineBreak;
		project the figure of Jay_elf_outfit_icon;
		say "     Holding out your foot at just the right moment, you pull the legs out under the thieving marsupial, sending her to fall flat on her face. The four foot tall elf chasing after her calls out in vindication, rushing to stand over the kangaroo with his arms crossed in front of his chest. 'Just because I'm small doesn't mean you can just take whatever you want. Give it back.' Looking up defiantly, she doesn't reply for a long moment. [if JayMarkRelationship is 3]Jay[else]The elf[end if] suddenly grabs a handful of hair, pulling her head up sharply. He meets the woman's eyes with a steely gaze and says in a low tone, 'I am not some weak little victim, stupid bitch. Now give it back, or I'll tell the wolverines all about a certain petty thief disturbing the peace. You'll be out on the street before you know it.' With a growl under her breath, the kangaroo reaches into her pouch, pulling out a thin leather strap tied into a loop. A heavy gold ring dangles from it, clearly belonging to a man. Pulling the band over his head and stuffing the ring under his clothing to let the ring dangle over his breastbone, Jay takes a deep breath and lets it out slowly.";
		say "     After that, he hisses to the kangaroo, 'Get out of here, and I better not see you causing trouble again.' After pushing herself up to stand, the woman runs off without looking back. As soon as she is gone, the diminutive man turns to you and says, [if JayMarkRelationship is 1]'Thank you, [mister]. I'm Jay, by the way. It's a pleasure to meet you.' [else]'Thank you, [mister].' [end if]You introduce yourself [if player is not defaultnamed]as [name of player][else]in turn[end if] and nod for him to continue. 'I don't have much left from my life before. This was one of the commitment rings I got for myself and Mark. It doesn't even fit me anymore like this, and he's the provider now, but one should always remember where you come from.' With the way he says this, you sense that he has accepted his new self, but he clearly still gets frustrated when bigger people pick on him. Reaching out, the elf shakes your hand and smiles, then adds, 'I'll make sure to return the favor sometime. For now, I need to head to the entrance court to meet up with Mark. Since I can't exactly help him scavenge out there, the least I can do is give him a warm welcome when he returns.' With that said, he ducks into the crowd and is gone a moment later.";
		now Resolution of Elven Issues is 1; [helped Jay]
	else:
		LineBreak;
		say "     Just after the kangaroo rushes past you, a whole crowd of mall rats rushes out of a video game store, swamping the hallway completely. This stops [if JayMarkRelationship is 3]Jay's[else]the elf's[end if] pursuit cold, preventing him from following the thief any further. By the time the crowd disperses enough for the elf to continue on, the kangaroo is gone without a trace. The slender male pulls himself to his full four foot height and puts his hands on his hips, staring at the people ahead and giving a deep sigh. 'Well, fuck!' he grumbles, then whirls around and stalks off, back the way he came. In his huff, he doesn't even notice you as he dashes past.";
		now Resolution of Elven Issues is 2; [didn't help Jay]
	now Elven Issues is resolved;

Mark's Dinner Invite is a situation.
The Prereq1 of Mark's Dinner Invite is Elven Issues.
The Prereq1Resolution of Mark's Dinner Invite is { 1 }. [must have helped Jay]
The sarea of Mark's Dinner Invite is "Smith Haven".

Instead of resolving a Mark's Dinner Invite:
	say "     As you walk into the east wing of the mall, you draw the attention of a powerful polar bear, towering a full head over the surrounding crowd of people. Moving towards you with long strides, he has little trouble navigating the hallway despite how crowded it is, a swarm of mall rats congregating around the video game store nearby. Then again, no one really wants to stand in the way of such a muscular and broad-shouldered ursine, so they all quickly step out of his path on their own volition. The big white bear moves to stand before you, gives you a brief inspection, and then creases a broad grin as he offers you his large hand-paw to shake.";
	say "     '[if JayMarkRelationship is 1]Hey there, I'm Mark [end if]I hear you've been helping out my man. Thank you. Things have been hard for him since the transformation. So, how about joining us for dinner sometime? Got some good hauls out in the city recently, and we'd be happy to share a little something with a nice person like yourself,' the bear offers with a smile that shows off his large, sharp fangs. 'When you have the time, just meet me at the north entrance of the mall in the evening. I always come in on that side after a day's scavenging and hang out a bit with the wolverines. And be sure you're hungry, it'll be a nice little feast.' The bear squeezes your shoulder in a friendly way, then walks off again, leaving you to dwell on his offer.";
	now Mark's Dinner Invite is resolved;
	now JayMarkRelationship is 2; [player knows their names (for sure)]
	now thirst of Mark is 1; [dinner invite extended]
	now XP of Mark is 1; [starting his daily rhythm]
	now XP of Jay is 1; [starting his daily rhythm]

[ End of Jay + Mark content, other events below ]


Size Envy is a situation.
The sarea of Size Envy is "Smith Haven".

when play begins:
	add Size Envy to badspots of furry;

Instead of resolving a Size Envy:
	say "     Wandering the hallways of the Smith Haven Mall, you pass through crowds of all sorts of people: lots of mall rats, other anthros, demi-human hybrids, as well as very rare pure humans. You curiously stroll in and out of the various stores - some are occupied by the refugees, others lay abandoned. Going into one of the places that is inhabited, your attention is drawn by a group of young men huddled in the far corner, with one of them suddenly calling out, 'No way! You're just pulling our leg.' Casually turning your steps to move closer, you inspect the little group of guys: there is a German Shepherd-human hybrid sporting paw-feet and a tail, a slender mall rat with spiky, purple hair, a shirtless anthro donkey wearing jeans, and a clockwork fox standing there in the nude, unconcerned about showing off his metallic body and all of its details.";
	say "     'Nope, I'm not!' the mall rat says with a proud smirk on his face, then grabs the front of his baggy pants and gives his crotch a squeeze. 'You simply can't be bigger then Axel,' the clockwork fox interjects, raising his arm with a few soft clicks and pointing at the donkey-boy, who nods and adds, 'Not to toot my own horn, but us equines are just naturally bigger, you know. And you're... well, short. In height, I mean.' Crossing his arms in front of his chest, the partially canine young man (whose voice you recognize as being the one who called out) demands, 'So cut the tall tales, Nicholas! Just admit that you were making it up.' Nicholas the mall rat just keeps grinning, then wiggles his eyebrows and says, 'Wanna bet that I'm bigger than all of you, Rob? A bottle of water each, winner takes all? You in too Axel, Milton?' Nods of agreement go through the little group, though when Nicholas pulls out a tape measure from his pocket, the guys pause as they realize that he planned this.";
	WaitLineBreak;
	say "[SizeEnvyMenu]";

to say SizeEnvyMenu:
	LineBreak;
	say "     [bold type]Well, this certainly could get interesting. How do you want to deal with the development between the guys?[roman type][line break]";
	now sextablerun is 0;
	blank out the whole of table of fucking options;
	[]
	choose a blank row in table of fucking options;
	now title entry is "Casually observe their competition";
	now sortorder entry is 1;
	now description entry is "Simply watch the action";
	[]
	choose a blank row in table of fucking options;
	now title entry is "Step up and offer a blowjob for the winner, in trade for the water";
	now sortorder entry is 2;
	now description entry is "Trade a little mouth action for several bottles of clean water";
	[]
	if player is male and carried of water bottle > 0: [only males and herms can compete, and you need a bottle]
		choose a blank row in table of fucking options;
		now title entry is "Step up and ask to join the competition";
		now sortorder entry is 3;
		now description entry is "Compete with the guys in dick size";
	[]
	sort the table of fucking options in sortorder order;
	repeat with y running from 1 to number of filled rows in table of fucking options:
		choose row y from the table of fucking options;
		say "[link][y] - [title entry][as][y][end link][line break]";
	say "[link]0 - Nevermind[as]0[end link][line break]";
	while sextablerun is 0:
		say "Pick the corresponding number> [run paragraph on]";
		get a number;
		if calcnumber > 0 and calcnumber <= the number of filled rows in table of fucking options:
			now current menu selection is calcnumber;
			choose row calcnumber in table of fucking options;
			say "[title entry]: [description entry]?";
			if player consents:
				let nam be title entry;
				now sextablerun is 1;
				if (nam is "Casually observe their competition"):
					say "[SizeEnvy_Observe]";
				if (nam is "Step up and offer a blowjob for the winner, in trade for the water"):
					say "[SizeEnvy_BJ]";
				if (nam is "Step up and ask to join the competition"):
					say "[SizeEnvy_Compete]";
				wait for any key;
		else if calcnumber is 0:
			now sextablerun is 1;
			say "     You step back from the group of young men and simply walk out of their temporary home.";
			now SizeEnvyTracker is 100; [just left]
			now Resolution of Size Envy is 7; [left]
			wait for any key;
		else:
			say "Invalid Option. Pick between 1 and [the number of filled rows in the table of fucking options] or 0 to exit.";
	clear the screen and hyperlink list;
	now Size Envy is resolved;
	if MiltonRelationship < 1:
		now MiltonRelationship is 1; [player knows his name at least]
	if AxelRelationship < 1:
		now AxelRelationship is 1; [player knows his name at least]

to say SizeEnvy_Observe:
	say "     Quietly strolling closer, you lean against a nearby wall from where you have a good view of the four young men.";
	say "[SizeEnvy_Strip]";
	WaitLineBreak;
	say "     'Okay, I win. Pay up, guys. Much as I'd love to offer you a chance at having a rub and seeing it in action, we've got some company and don't want to escalate things here, do we?' Nicholas nods in your direction, making the other guys aware of your presence, quickly shoving their dicks back into their pants with startled expressions. Except Milton, that is - he just opens a little pressure valve on his clockwork body, and with a little hiss, the shaft of his brass cock shrinks to its original size. Their mall rat friend stays fully naked from the hips down while the guys go grab the water bottles they lost and hand them over, only then going to collect his pants and putting them back on. With a grin to you, he puts them in a backpack, then tells his friends, 'Come on guys, let's hang in the atrium.' Just a moment later, they're gone, leaving you behind in the store.";
	now Resolution of Size Envy is 1; [watched]
	now SizeEnvyTracker is 99; [player watched - no interaction]

to say SizeEnvy_Strip:
	say "     Milton is the easiest to measure as he doesn't wear any clothing at all. The clockwork fox wraps his fingers around the knotted cock hanging between his legs, pumping the flexible metal construct up and down and making quiet ticking and humming noises as he does so. The coppery flesh bends easily in his grasp and expands a little to reach a fully extended state, leaking clear lubricant from the tip that the mechanical young man rubs into his shaft. Nicholas smiles at his friend as he lays the tape measure on top of his dick, then announces, 'Nine inches. Nice one, man.' The clockwork fox grins back and gives his buddy a gentle fist-bump, then steps aside, still slowly stroking himself.";
	say "     'You next, Rob,' the mall rat tells the human hybrid, crooking his finger to make him step forward. Rob is a bit hesitant at first, looking to the other guys, then drops his trousers and reveals that his German Shepherd infection reaches all the way from the foot-paws to just below the navel, including a furry canine sheath that already has the tip of his shaft poking out. With a little bit of rubbing and stroking, he gets himself fully hard too, then presents the red rocket of his canine shaft to Nicholas. 'Eight inches,' the mall rat gives as his verdict a moment later, to which Rob replies, 'Yeah, but it's got a really nice knot, too - that counts in bed, if you get my drift.' Nicholas raises his eyebrows and moves his hand to give his friend's knot a little squeeze, chuckling as the young man lets out a moan. 'I'll call it a nine, so you're even with Mil.'";
	WaitLineBreak;
	say "     Axel steps up confidently, rubbing a dick-shaped bulge in his jeans that stretches down one pants-leg. 'Time to finish this,' he says with a laugh, then pops the buttons of his jeans and shoves them down, making a massive equine shaft spring up as it is freed from confinement. The anthro donkey's dick is certainly an impressive piece of equipment, with weighty balls, a long black shaft and a flared head. He wraps his hand around it and strokes up and down until a gleaming drop of pre forms at the tip. Only then does he allow his buddy to lay the tape measure along the top of his shaft, to announce a moment later, 'Thirteen inches! Hung like a horse, even though he's a donkey.' Axel gives him a beaming grin, putting his hands behind his head and standing in a proud pose.";
	say "     'That doesn't mean you've won, you know,' Nicholas adds with a chuckle as he starts to undo his own baggy pants, drawing disbelieving glances from the other guys. 'See it and weep!' the mall rat calls in a teasing tone, then shoves his pants down his legs and kicks them off. The piece of man-meat hanging between his legs is almost monstrous, at least on a not quite five foot tall anthro rodent. It literally reaches his knee! Hanging his tape measure over one shoulder, the grinning mall rat strokes himself with both hands, getting the pinkish-white cock fully hard and erect. When he rolls out the measuring band over its top, everyone in the little group leans in to have a look - he's all of fifteen inches long. 'Damn, that's one big kahuna,' Milton says in a shocked tone, a sentiment that the other two guys fully share.";

to say SizeEnvy_BJ:
	say "     Quietly strolling closer, you lean against a nearby wall from where you have a good view of the four young men, then clear your throat. Rob, Axel and Milton are a bit startled as they see you, while Nicholas clearly was already aware of your presence. 'Yeah? What do you want?' he asks, a slight smile on his muzzle as he clearly expects a good answer. When you offer the four young men oral pleasure in exchange for the water that they were originally betting, they are only too happy to say yes[if player is male], if only after some objections that you're a guy from Axel and Milton. Rolling his eyes, Nicholas brushes any hesitation aside with the argument, 'Hey guys. A blowjob is a blowjob. Doesn't matter who gives it, come on!' [else]. [end if]The deal settled, you move right up to them, eager to watch the competition from a ringside seat.";
	say "[SizeEnvy_Strip]";
	WaitLineBreak;
	say "     'Okay, I win. Let's have some fun with our new friend here now!' The guys step out of their lowered pants and crowd around you with eager expressions. Sinking to your knees, you find yourself presented with four hard cocks. On a whim, you reach for Axel first, holding up his equine shaft and licking over its head to taste the young donkey's sweet pre-cum. 'Fuuuck yeah,' he lets out in a pleased grunt, putting one hand gently on the top of your head to guide you closer. Suckling on his big rod, one hand wrapped around the base of his manhood, you reach out with the other one and take hold of Milton's flexible brass shaft. The clockwork fox holds his breath for a second, making the ticking of his body stop, then gives a groan, and a little spurt of clear lube shoots out of the tip of his cock.";
	say "     Curious about the fox's taste, you switch over to his cock and slowly take the head into your mouth - it is warm and slightly slippery with what you would guess to be almond oil. Not a bad taste for a guy to have. Suckling on his shaft, you make sure not to neglect Axel's cock either, pumping its length with a firm grip at the same time. After going down on the mechanical fox for a little while, you pull back from him with an intentionally loud pop, then look around for the next contestant. Rob's red doggy bone comes into sight, but someone's hand is already wrapped around it, and it's not his own. Glancing up, you see Nicholas smile broadly, then say in a low voice, 'Take care of them. We're good here.' The demi-human by his side is standing there with his eyes closed, biting his lip in pleasure and simply holding on to Nicholas with one hand on his shoulder. The mall rat clearly doesn't mind that their sexual interaction is currently only one way.";
	WaitLineBreak;
	say "     Getting back to your own erect studs, you hold their dicks up next to each other, licking back and forth between them again and again, your tongue slurping over the undersides of their hard lengths. As you do so, the two of them slowly inch closer to one another to allow you easier access - until eventually, their cocks bump heads. Hearing indrawn breaths from above, you glance up to see them staring at one another with wide eyes, hesitating for several long seconds before Axel throws his arm around his friend's shoulders and grunts out, 'Let's just enjoy this.' Milton lets out a little huff, then lays his own arm on Axel's shoulder in turn. Smiling a little to yourself about them pushing past at least that hang-up, you guide their dicks side by side, pressing them together so that you can lick across them both with single sweep of your tongue.";
	say "     After more switching back and forth between their dickheads, suckling here and there, you eventually attempt to take both guys into your mouth at the same time. It takes quite a bit of effort to open your mouth wide enough and wedge the two friends['] dickheads in at the same time, but you eventually manage it, and the happy moans this earns you are well worth the trouble. Lips tightly stretched around their tips, you're given some freedom with your hands, which you use to reach for the balls of your two partners. Warm, furry, and quite a handful on one side, and firm and warm in a sun-heated metal kind of way on the other, you caress them with eager attention, really pushing their buttons. Between the sucking, rubbing against a friend's dick, and getting fondled, the two of them have no chance of holding back for very long, and soon, you can hear them pant out that they are getting close.";
	WaitLineBreak;
	say "     Intensifying your sucking even more to finish the guys off, you are rewarded by a thick and creamy spurt of equine cum, followed up by what seems like thick almond milk from the clockwork fox. By pure chance, their orgasms line up just right to have one blasting cum in the pause between spurts of the other one, meaning that you're exposed to a constant barrage of nut-milk. With nothing else to do but chugging it down as quickly as they fill your mouth, you swallow everything the guys have to give, leaving you rather full by the time they run out of steam. When you finally pull back from their dicks and turn around to check on the other two guys, you are just in time to hear Rob groan out loud, then blast you straight across the forehead with his load. Spurt after spurt covers your face, and you quickly shut your eyes so he doesn't hit them too.";
	say "     You don't see anything for a little while, not daring to open your eyes, then feel someone use a towel or something similar to dab at your face, wiping off the canine cum around your eyes. Slowly opening them again, you see that it was Nicholas, who gives you a somewhat shame-faced smile. 'Sorry about that. I was aiming him at your shoulder, then suddenly you turn your head, and... well, things were too late to stop after that first blast hit your forehead. Your face looked pretty hot covered with Rob's load, to be honest. But now, think you could finish me off? Haven't cum yet myself.' Laughing about the horny mall rat's focus on his dick, you open your lips to catch the end of his massive prick between them, then start bobbing up and down on it. He clearly is quite aroused from handling his friend's canine cock earlier, as it doesn't take long at all for Nicholas to reach his own orgasm, blasting thick spurts of cream down your throat to join the cum of his friends.";
	WaitLineBreak;
	say "     After catching his breath, Nicholas says, 'Time to pay up.' Rob, Axel and Milton have made themselves presentable again in the meantime, and they each grab a bottle of water from their packs, bringing it back to hand to you. Their mall rat friend stays fully naked from the hips down, unconcerned with his giant dick swinging between his legs as he goes to grab his pants, then pulls out one more water bottle from one of the large side pockets. This leaves you with a nice and even number of pure water bottles. While you pack them away and clean yourself up, the mall rat thanks you and tells his friends, 'Come on guys, let's hang in the atrium.' Just a moment later, they're gone, leaving you behind in the store.";
	PlayerDrink 20;
	PlayerEat 20;
	LineBreak;
	say "[bold type]You gain 4 water bottles![roman type][line break]";
	increase carried of water bottle by 4;
	if player is male:
		now SizeEnvyTracker is 2; [player gave a BJ to the guys - as a man]
		now AxelRelationship is 4;
	else:
		now SizeEnvyTracker is 1; [player gave a BJ to the guys - as a woman]
		now AxelRelationship is 3;
	now Resolution of Size Envy is 2; [gave out BJs]
	now Donkey Needs is active;

to say SizeEnvy_Compete:
	say "     Quietly strolling closer, you lean against a nearby wall from where you have a good view of the four young men, then clear your throat. Rob, Axel and Milton are a bit startled as they see you, while Nicholas clearly was already aware of your presence. 'Yeah? What do you want?' he asks, a slight smile on his muzzle as he clearly expects a good answer. When you introduce yourself[if player is not defaultnamed] as [name of player][end if] and pull out a bottle of water from your pack, they look surprised at the sudden intrusion into their group and competition. There is a bit of murmuring from the donkey and clockwork fox, but Nicholas pushes that out of the way by introducing each of his friends in turn and giving you the go-ahead to join in. With a grin on your face, you move right up to them, eager to participate.";
	say "[SizeEnvy_Strip]";
	WaitLineBreak;
	if cock length of player > 15: [player wins]
		say "     With a confident grin on your face, you pull out your own [cock of player] manhood, jerking its length before the gathered friends. 'Fucking hell,' Rob groans as he sees what you bring to the competition, and even Nicholas gives you a respectful nod after he measures your erection. '[cock length of player] inches, I'm impressed. Guess we have a winner, guys. Time to pay up.' Rob and Axel quickly shove their dicks back into their pants with startled expressions and walk off to get your payment. Meanwhile, Milton just opens a little pressure valve on his clockwork body, allowing the shaft of his brass cock to shrink to its original size with a soft hiss, then also goes to get a water bottle from his pack. Their mall rat friend stays fully naked from the hips down, stroking himself gently before leaning a bit closer to you and whispering, 'This never was about the water. I don't begrudge you the win. And thanks for showing your piece. It's a good one.'";
		say "     As the others start to come back, Nicholas winks at you, then grabs his own pants and pulls a bottle from one of the many pockets on it, handing it to you. One by one, the young men do the same, leaving you with a nice and even number of pure water bottles. While you pack them away, the mall rat tells his friends, 'Come on guys, let's hang in the atrium.' Just a moment later, they're gone, leaving you behind in the store.";
		LineBreak;
		say "[bold type]You gain 4 water bottles![roman type][line break]";
		increase carried of water bottle by 4;
		now SizeEnvyTracker is 50; [player competed - won]
		now Resolution of Size Envy is 3; [competed - 1st]
	else if cock length of player is 15: [evenly matched]
		say "     With a confident grin on your face, you pull out your own [cock of player] manhood, jerking its length before the gathered friends. 'Fucking hell,' Rob groans as he sees what you bring to the competition, and even Nicholas gives you a respectful nod after he measures your erection. '[cock length of player] inches, I'm impressed. Guess we're evenly matched, so let's split. You keep your stake and get one more, I'll take the rest. Okay guys, time to pay up.' Rob and Axel quickly shove their dicks back into their pants with startled expressions, then walk off to get your payment. Meanwhile, Milton just opens a little pressure valve on his clockwork body, allowing the shaft of his brass cock to shrink to its original size with a soft hiss, then also goes to get a water bottle from his pack.";
		say "     Their mall rat friend stays fully naked from the hips down, stroking himself gently before leaning a bit closer to you and whispering, 'This never was about the water. I don't begrudge you half the pot. And thanks for showing your piece. It's a good one.' As the others start to come back, Nicholas winks at you, then grabs his own pants and pulls a bottle from one of the many pockets on it, handing it to you. One by one, the remaining young men give him their bottles, leaving him with a nice armful of pure water bottles. After stuffing them into his backpack, the mall rat tells his friends, 'Come on guys, let's hang in the atrium.' Just a moment later, they're gone, leaving you behind in the store.";
		LineBreak;
		say "[bold type]You gain 1 water bottle![roman type][line break]";
		increase carried of water bottle by 1;
		now SizeEnvyTracker is 51; [player competed - draw]
		now Resolution of Size Envy is 4; [competed - draw]
	else if cock length of player > 8: [third place]
		say "     Putting on a confident expression, you pull out your own [cock of player] manhood, jerking its length before the gathered friends. 'Fucking hell,' Rob groans as he sees what you bring to the competition, and even Nicholas gives you a respectful nod after he measures your erection. '[cock length of player] inches, not bad at all, but I still win. Okay guys, time to pay up.' Rob and Axel quickly shove their dicks back into their pants with startled expressions, then walk off to get your payment. Meanwhile, Milton just opens a little pressure valve on his clockwork body, allowing the shaft of his brass cock to shrink to its original size with a soft hiss, then also goes to get a water bottle from his pack.";
		say "     Their mall rat friend stays fully naked from the hips down, stroking himself gently before leaning a bit closer to you and whispering, 'This never was about the water, to be honest. Thanks for showing your piece. It's a good one.' As the others start to come back, Nicholas winks at you, then accepts the stakes of each of his friends, and finally your own bet, leaving him with a nice armful of pure water bottles. After stuffing them into his backpack, the mall rat tells his friends, 'Come on guys, let's hang in the atrium.' Just a moment later, they're gone, leaving you behind in the store.";
		LineBreak;
		say "[bold type]You lose 1 water bottle![roman type][line break]";
		decrease carried of water bottle by 1;
		now SizeEnvyTracker is 52; [player competed - third place]
		now Resolution of Size Envy is 5; [competed - 3rd]
	else:
		say "     Somewhat nervous about exposing yourself in what turned out to be a group of very big boys indeed, you pull out your own [cock of player] manhood, jerking its length before the gathered friends. 'Finally someone smal-' Rob starts to say, then clamps his hand in front of his mouth, getting red-faced. Nicholas simply gives you an encouraging smile and comes closer to measure your erection. '[cock length of player] inches, not bad at all, but that still leaves me the undisputed winner. Okay guys, time to pay up.' Rob and Axel quickly shove their dicks back into their pants with startled expressions, then walk off to get your payment. Meanwhile, Milton just opens a little pressure valve on his clockwork body, allowing the shaft of his brass cock to shrink to its original size with a soft hiss, then also goes to get a water bottle from his pack.";
		say "     Their mall rat friend stays fully naked from the hips down, stroking himself gently before leaning a bit closer to you and whispering, 'This never was about the water, to be honest. Thanks for showing your piece too. No need to be self-conscious just because we're bigger. It all depends on how you use [']em, right?' As the others start to come back, Nicholas winks at you, then accepts the stakes of each of his friends, and finally your own bet, leaving him with a nice armful of pure water bottles. After stuffing them into his backpack, the mall rat tells his friends, 'Come on guys, let's hang in the atrium.' Just a moment later, they're gone, leaving you behind in the store.";
		LineBreak;
		say "[bold type]You lose 1 water bottle![roman type][line break]";
		decrease carried of water bottle by 1;
		now SizeEnvyTracker is 53; [player competed - third place]
		now Resolution of Size Envy is 6; [competed - last]
	now AxelRelationship is 2; [two sided introductions]
	now MiltonRelationship is 2; [two sided introductions]

Standard Maintenance is a situation.
The Prereq1 of Standard Maintenance is Size Envy.
The Prereq1Resolution of Standard Maintenance is { 1, 2, 3, 4, 5, 6, 7 }.
The sarea of Standard Maintenance is "Smith Haven".

Instead of resolving a Standard Maintenance:
	say "     Wandering the hallways of the Smith Haven Mall, you pass through crowds of all sorts of people: lots of mall rats, other anthros, demi-human hybrids, as well as very rare pure humans. You curiously stroll in and out of the various stores - some are occupied by the refugees, others lay abandoned. Eventually you wander into a place you have been in before where you saw those four young men comparing their lengths. By pure chance, one of the guys is actually there too - Milton, the clockwork fox. He is sitting cross-legged on a large white mat, bent over forward as he disassembles his foot-paw, spreading countless little cogs and pieces of machinery out around him. A spray-can in his hand hisses a little as he uses the compressed air inside to clean his mechanical parts.";
	say "     [bold type]What do you want to do now?[roman type][line break]";
	LineBreak;
	say "     ([link]Y[as]y[end link]) - Walk up and try to start a conversation.";
	say "     ([link]N[as]n[end link]) - Leave him to his work.";
	if player consents:
		LineBreak;
		say "     Moving closer, you say hello to the clockwork fox and he glances up at you, his mechanical parts clicking a little as he moves. 'Oh hey, um - [if MiltonRelationship > 1]didn't think I'd see you again[else]you're new here, aren't you?' he asks, to which you shake your head. 'Well, I'm Milton[end if]. I'd get up, but as you can see, I'm a bit out of commission right now.' Waving him down to stay sitting, you [if MiltonRelationship < 2]tell him your name in turn, then [end if]take a cross-legged pose across the field of gears. 'So[if player is not defaultnamed], [name of player][end if] - what brings you [if MiltonRelationship > 1]back [end if]here? Wanted to learn a bit of fox mechanics? I can tell you one thing: This is not as uncomfortable as it may look.' He raises his disassembled leg a little, tapping this part or that. 'Here are the structural members, joints and whatnot, while the moving parts are currently spread out here. This new body is a mechanical marvel - and the gears re-grow if I lose any. But sadly, the amazing abilities somehow do not include any way to get grit and dust out of the works...'";
		say "     He explains more details of his body to you as he slowly reassembles himself, pushing the pieces back into place to see them instantly snap into motion with smooth precision. Apparently he learned in the first few days after his infection that he can actually just take pieces of himself apart and put them back together, as long as the separate parts stay within about three feet of his body. The concept is strange, but fascinating, and somehow it feels good to just spend a while talking to the bright young man, even if he is made of metal. When he eventually is all the way assembled again, Milton stands up and gives you a smile and a handshake, then packs up his gear. With the words, 'It was nice talking to you. Hope to see you sometime again,' the young man soon sets out into the hallways of the mall, most likely to find his friends.";
		SanBoost 5;
		now MiltonRelationship is 2; [two-sided introductions, and a nice chat]
	else:
		LineBreak;
		say "     You quietly watch him for a few seconds longer, then shrug and continue on your way. Eventually, you reach the point of the mall where you started your little exploration tour.";
	now Standard Maintenance is resolved;

Donkey Needs is a situation.
Donkey Needs is inactive.
The sarea of Donkey Needs is "Smith Haven".

Instead of resolving a Donkey Needs:
	if AxelLastBJ - turns < 8: [not horny right now]
		say "[DonkeyChat]";
	else: [horny Axel]
		say "     Wandering the hallways of the Smith Haven Mall, you pass through crowds of all sorts of people: lots of mall rats, other anthros, demi-human hybrids, as well as very rare pure humans. There is always something interesting to see in here, and you're just about to check out some commotion up ahead when a voice calls out to you from the side. Looking around, you see that it is Axel, one of the young men you encountered a while ago and subsequently gave a blowjob to. 'Hey there[if player is not defaultnamed] [name of player][end if],' he says with a nod of his head when you walk over to where he is leaning against a wall, right next to a narrow service hallway. As before, the only thing he is wearing is a pair of jeans, leaving his chest bare. The anthro donkey has a fit look to him without being overly muscular, and he clearly has something on his mind as he casually glances left and right before going on to speak.";
		say "     'So, um... I haven't been able to get what you did out of my mind. That thing with your tongue was quite something,' Axel says in a quiet voice. A quick glance down realize that the masculine donkey is currently half-hard, with his large shaft creating a noticeable bulge down one pants-leg of the jeans. Letting out a frustrated grunt, he adds, 'But what girls I know around here are either too freaked out by things for any sex at all, or if they're not, they want some commitment and shit. Hell, I just wanna get off, not tie myself to a girlfriend.' Rubbing the back of his neck, Axel goes on to say, 'Any chance you could do your magic again? I mean, you didn't seem to have any problems in just going down on my cock before. And I'm not saying that you're a [if SizeEnvyTracker is 1]slut or anything, you understand? Just - just a cool gal that helps a needful guy[else]gay cock-hound or anything, you understand? Just - just a cool dude that helps a needful bro[end if] out, eh?'";
		LineBreak;
		say "     [bold type]Axel clearly isn't the best with words, but maybe that doesn't matter when you're hung like a donkey?[roman type][line break]";
		say "     [link](1)[as]1[end link] - Take him into the service corridor and blow him.";
		say "     [link](2)[as]2[end link] - If he wants head, he can pay you.";
		say "     [link](3)[as]3[end link] - Not right now. He can whack himself off or something.";
		say "     [link](4)[as]4[end link] - Nope. And he should stop asking.";
		now calcnumber is 0;
		while calcnumber < 1 or calcnumber > 4:
			say "Choice? (1-4)>[run paragraph on]";
			get a number;
			if calcnumber is 1 or calcnumber is 2 or calcnumber is 3 or calcnumber is 4:
				break;
			else:
				say "Invalid choice. Type [link]1[end link] to blow him, [link]2[end link] to blow him for a payment, [link]3[end link] to refuse or [link]4[end link] to refuse for good.";
		if calcnumber is 1:
			LineBreak;
			say "[HallwayBlowAxel]";
		else if calcnumber is 2:
			LineBreak;
			say "     Smiling at the donkey boy, you lower your hand and rub it over his bulge, drawing a needy grunt from him. You then you tell him that if he wants you to get him off, he has to pay for it. Axel looks at you with a disappointed expression, sputtering, 'B-but I thought... Uhm... Okay, fine - I'll get something. Be right back.' With that, the donkey boy hurries off into the crowd, returning a few minutes later with a bottle of fresh water for you. He swallows visibly as you accept the payment, then waits while you stuff it in your pack.";
			LineBreak;
			say "[bold type]You gain 1 water bottle![roman type][line break]";
			increase carried of water bottle by 1;
			say "[HallwayBlowAxel]";
		else if calcnumber is 3:
			LineBreak;
			say "     Gently patting Axel on the shoulder, you tell him that you have other plans right now. He is visibly deflated at the possibility of getting his rocks off being denied, but takes your decision well enough. The donkey shrugs and says, 'Okay then, maybe another time?' With a hopeful glance to you, he pushes off from the wall and walks away, moving out of sight in the crowd.";
		else:
			LineBreak;
			say "     Putting on a serious expression, you look Axel straight in the eye and tell him that you won't be going down on him. Not now, nor ever in the future. The donkey boy gets a bit flustered at this open and definite rejection, swallowing and nodding as you ask if he understands you. 'I - um, I guess I'll just go then. Sorry for asking.' With that, the anthro equine hastily walks off into the crowd and does his best to vanish from sight. [bold type]After this embarrassment, he might just avoid you for good from now on.[roman type]";
			now AxelRelationship is 100; [avoids the player]
			now Donkey Needs is resolved;
			now Donkey Chat is resolved;

to say HallwayBlowAxel:
	say "     Grinning at the nervous young man, you pat him on the shoulder and say to follow you, then stroll into the service corridor. Stopping about twenty feet down the hallway and turning around, you see him close behind you, nostrils flaring as he takes hasty breaths in his excitement ";
	if player is male:
		say "and the nervousness of having [if SizeEnvyTracker is 2 or AxelRelationship is 3 or AxelRelationship is 21]another[else]a[end if] homosexual encounter.";
		if player is dominant:
			say "     Capitalizing on his weakness in a sudden move, you push the donkey boy against one of the walls, one hand grasping his side while the other presses against one of his firm pecs. As you aggressively follow up with a kiss, he turns his head defensively to the side and says, 'Stop! W-what's this? I didn't say that-' Interrupting, you tell him that if he wants his blowjob, he has to follow your rules, then put your hand on the side of his muzzle, drawing it towards your head again. Axel's eyes go wide as he starts to realize what he's gotten himself into, but he does comply, opening his mouth nervously as you plant a kiss on his lips, giving him a little bit of tongue too.";
		else if player is submissive:
			say "     Bidding him to move to one of the walls, your voice full of excitement at being able to serve such a fine specimen of masculinity, you watch Axel take position and lean back. Gaze wandering over his equine physique and fit form, you eat him up with your eyes alone, mouth watering at soon having his cock to suck on. The donkey boy gives a nervous laugh at your intense look, then smiles as he realizes how worshipful your expression is. The long shaft bulging out his jeans twitches visibly and he murmurs to himself, 'Never thought I'd like a guy looking at me like that.'";
		else:
			say "     Waving him towards one of the side walls, you tell Axel in a friendly tone to just lean back and enjoy. He takes position as instructed, yet can't help but glance back the way you came from, obviously nervous about people being able to see what is about to happen here. Waving a hand in his line of sight, you grin at him and add that he shouldn't worry so much. This is only between the two of you. Axel visibly relaxes at your calming words and murmurs to himself, 'Yeah. Just some guys letting off some steam together. Nothing gay about that.'";
	else: [female]
		say "and slight nervousness.";
		if player is dominant:
			say "     Capitalizing on his weakness in a sudden move, you push the donkey boy against one of the walls, one hand grasping his side while the other presses against one of his firm pecs. As you aggressively follow up with a kiss, he is surprised at first, but quickly gets into it, returning your affections and even getting into a little bit of tongue-wrestling. 'Wow! That was nice!' he pants out when you finally pull back to allow him a breath.";
		else if player is submissive:
			say "     Bidding him to move to one of the walls, your voice full of excitement at being able to serve such a fine specimen of masculinity, you watch Axel take position and lean back. Gaze wandering over his equine physique and fit form, you eat him up with your eyes alone, mouth watering at soon having his cock to suck on. The donkey boy gives a nervous laugh at your intense look, then smiles as he realizes how worshipful your expression is. The long shaft bulging out his jeans twitches visibly and he murmurs to himself, 'Why can't Sadie be like that?'";
		else:
			say "     Waving him towards one of the side walls, you tell Axel in a friendly tone to just lean back and enjoy. He takes position as instructed, yet can't help but glance back the way you came from, obviously nervous about people being able to see what is about to happen here. Waving a hand in his line of sight, you grin at him and add that he shouldn't worry so much. This is only between the two of you. Axel visibly relaxes from your calming words and murmurs to himself, 'I guess even if people watch, they'd just get envious.'";
	say "[AxelBJ]";

to say AxelBJ:
	say "     Eager to play with the horny donkey boy, you move your hands to his hips, running them along the belt-line of his jeans until you reach his crotch. The anthro equine's cock is straining against the tough fabric of the jeans, only having gotten harder from the buildup of sexual tension between the two of you. Axel's hot breath washes over your ear as you bend your head down to open the button of his pants, soon followed by the zipper. As you pull open the front of his pants, the young man quickly hooks both thumbs over the upper edge of his jeans and shoves. He lets out a relieved gasp as his dick is finally freed from its prison of cloth, jerking upwards and whacking against your body from the suddenness of being released. As you already know, Axel is a big boy indeed, standing erect at thirteen inches of equine cock.";
	WaitLineBreak;
	say "     The magnificent shaft is covered in jet-black skin and has a visible ring a third down its length from Axel's sheath. Its end is blunted, with a flaring rim around the head of the cock and pre-cum already leaking from its slit. His erection is warm to the touch as you take hold of it, giving your young friend a slow and teasing stroke. '[one of]Nnnhgh, fuck yeah![or]Hell yeah![or]Just like that![or]Damn, that's good![or]Fuck![or]Suck it![or]Fucking tease![at random]' he groans out loud, eager for you to continue. Still stroking the donkey boy's cock, you crouch down and bury your nose in the wrinkled flesh of his weighty balls, starting out your oral service by getting a good, deep huff of his masculine aroma and then lapping at his cum-factories with your tongue. Axel groans in pleasure as you slather first one, then the other in your spit and also gently suckle on them. Each deft lick slowly moves higher, tracing the veins on his length with your tongue.";
	say "     Arousal boiling in his veins, your eager partner can't help himself from scraping one hoof over the stone floor of the hallway, then stomping loudly as you reach his dickhead and engulf it with your lips. Sucking on the broad and flared tip smears the taste of Axel's pre-cum over your palate, delightfully rich and nutty. This leaves you eager for the main event too, so you inhale as much of that equine prick as you can until you feel it in the back of your throat. Waiting a few seconds to let Axel revel in the sensation of tightness, you slowly pull back off his dick to take a gasping breath and look up at him, strings of spit still connecting you to his cock. '[one of]Damn, that's so hot![or]Your throat feels so good![or]You look hot like that![or]Like that dick, eh?[at random] More please!' the donkey boy grunts out, placing a hand on your head to nudge you closer to his crotch.";
	WaitLineBreak;
	say "     Grinning at the eagerness of your equine partner, you set to work bobbing your mouth up and down on his shaft, slurping your tongue over his length as you go along. Especially some teasing touches of the flared rim and his cum-slit drive Axel wild, creating more noise with his hooves on the stone floor tiles. With the musky scent of this virile male thick in your nose and his hand now actively pushing you to go deeper when throating him, you kind of lose track of time, with nothing on your mind except servicing your partner's cock. After who knows how long, Axel lets out an urgent grunt of, '[one of]I'm gonna cuuuummmmMMMMMM![or]Gonna cream you, slut![or]Take my load, bitch![or]Take this, babe![or]Hope you're ready for this load![at random]' and starts blasting thick spurts of creamy equine seed into your mouth. The first jet flows directly into your stomach as he's lodged deep in your throat when his cock throbs hard. After another pulse or two, you pull yourself off his fire hose-like erection.";
	say "     A fresh gush of cum squirts out and covers your tongue in an explosion of Axel's taste, eagerly lapped up and swallowed to make room for the next. Grunting and whinnying, your equine partner fills your mouth with a deluge of cum, almost adding it quicker than you can gulp it down. Soon, there is enough nut-milk in your stomach to be considered as a hearty meal, and you can't help but drool a little cum, unable to keep it all contained with your lips around Axel's shaft. Thankfully, this is about the time when he finally runs out of steam, so only a few drips and dollops of his cream land on the donkey boy's discarded jeans. '[one of]Fuck that was good[or]I'm totally fucked out[or]That was fricking awesome[or]Oh my god, you're a cum vampire[or]Holy shit, you're a keeper[at random]!' Axel pants, so exhausted from the intense orgasm that he has to lean back against the wall to brace himself. Meanwhile, you pull off his cock and gulp down the extra mouthful of cum, then give your eager partner a grin.";
	WaitLineBreak;
	say "     '[one of]Best blowjob I've ever got[or]That was one GREAT blowjob[or]You totally drained my balls[or]Damn, that was some primo head[at random]!' Axel is happy to announce in thanks, giving you a shaky fist-bump before pulling his pants back up. A satisfied grin on his face, the young man stumbles off, leaving you behind to wipe away the cum-drool from your lips and suck it off your fingers. Given the state of the city, a free meal certainly isn't something to scoff at...";
	PlayerEat 20;
	now AxelLastBJ is turns;
	if AxelRelationship < 3:
		if player is male:
			now AxelRelationship is 4; [had a BJ from a male player]
		else:
			now AxelRelationship is 3; [had a BJ from a female player]

Donkey Chat is a situation.
The Prereq1 of Donkey Chat is Size Envy.
The Prereq1Resolution of Donkey Chat is { 1, 2, 3, 4, 5, 6, 7 }.
The sarea of Donkey Chat is "Smith Haven".

Instead of resolving a Donkey Chat:
	say "[DonkeyChat]";

to say DonkeyChat:
	say "     Wandering the hallways of the Smith Haven Mall, you pass through crowds of all sorts of people: lots of mall rats, other anthros, demi-human hybrids, as well as very rare pure humans. You curiously stroll in and out of the various stores - some are occupied by the refugees, others lay abandoned. Eventually you wander into a place you have been in before where you saw those four young men comparing their lengths. By pure chance, one of the guys is actually there too - Axel, the donkey boy, dressed in just a pair of jeans and with his chest bare. He is leaning against one of the walls, wearing a set of headphones that somewhat awkwardly fit on his nonhuman ears. There's a far-away look in his eyes as he nods his head to the music, and you don't think he's really paying attention to anything around him right now.";
	LineBreak;
	say "     [bold type]What do you want to do now?[roman type][line break]";
	say "     [link](1)[as]1[end link] - Walk up and try to start a conversation.";
	say "     [link](2)[as]2[end link] - Leave him to his tunes.";
	say "     [link](3)[as]3[end link] - Ignore Axel from now on.";
	now calcnumber is 0;
	while calcnumber < 1 or calcnumber > 3:
		say "Choice? (1-3)>[run paragraph on]";
		get a number;
		if calcnumber is 1 or calcnumber is 2 or calcnumber is 3:
			break;
		else:
			say "Invalid choice. Type [link]1[end link] to chat with him, [link]2[end link] to leave or [link]3[end link] to ignore him in the future.";
	if calcnumber is 1:
		LineBreak;
		say "     Moving closer, you wave your hand in the young adult donkey's line of sight. He snaps out of staring at the other side of the room and glances at you in surprise, then reaches up to take off the headphones. 'Hey there. [if AxelRelationship > 1]Back again, eh? [else]Are you another new arrival?' he asks, to which you give a vague nod. 'I'm Axel. Nice to meet ya. [end if]So, what's up? I'm just hanging out here myself, listening to some songs. Funny thing, eh - that we're in the midst of all this shit going on, yet most of what resulted from it is being bored out of our minds. There's only so much one can do, cut off from everything as we are. Man, I wish there was Internet connection here.' With a shrug, the donkey boy looks to you after that, waiting for what you have to say.";
		LineBreak;
		say "     [bold type]What do you want to talk about with Axel?[roman type][line break]";
		say "     [link](1)[as]1[end link] - Just chat a bit about the city and whatnot.";
		say "     [link](2)[as]2[end link] - Ask if you can listen to the music with him.";
		say "     [link](3)[as]3[end link] - Sex is a nice distraction. Make a move to blow him off.";
		now calcnumber is 0;
		while calcnumber < 1 or calcnumber > 3:
			say "Choice? (1-3)>[run paragraph on]";
			get a number;
			if calcnumber is 1 or calcnumber is 2 or calcnumber is 3:
				break;
			else:
				say "Invalid choice. Type [link]1[end link] to chat, [link]2[end link] to listen to music with him or [link]3[end link] to offer a blowjob.";
		if calcnumber is 1: [chat]
			LineBreak;
			say "     You start chatting with Axel, at first recounting the things you've seen and done out in the city, then going on to other topics. He explains that he is actually in a band, together with his buddy Milton. Seems like the donkey boy decided not to rack up college loans and instead wants to follow his dream of working his way up as a musician. With the two of you just talking about [']normal['] topics and his excited recounting of gigs they had, as well as their hopes of attracting a producer's attention, time just flies by. Somehow, if feels good for your mental stability to just brush off the grim reality of the current city events and listen to the young man tell you of his dreams. Eventually, he winds down in his tale and thanks you for listening, then gives you a smile and a fist-bump before setting out to meet his friends at the food court.";
			SanBoost 5;
			now Resolution of Donkey Chat is 1; [talked]
		else if calcnumber is 2: [listen to the music]
			LineBreak;
			say "     'Oh, sure! You know, me and Milton actually taped this together. We're in a band with Casper and Kim. You'll love it!' the donkey boy says excitedly and twists the speakers of his headphones around far enough that you can listen in at the same time as him. The song that comes up next is fairly catchy and well played, and Axel is happy to point out the [']best['] parts for you, many of them electric guitar solo or duo passages that he himself played. Somehow, if feels good for your mental stability to just brush off the grim reality of the current city events and simply listen to music, as well as the young man telling you about it in excited tones. Eventually, after going through numerous songs, Axel winds down and thanks you for listening, then gives you a smile and a fist-bump before setting out to meet his friends at the food court.";
			SanBoost 5;
			now Resolution of Donkey Chat is 2; [listened to music]
		else: [sex him up]
			LineBreak;
			if AxelRelationship < 3: [first time]
				say "     A grin spreads over your face as you tell the young man that there is another thing that can drive the boredom away. He looks at you with raised eyebrows. 'Yeah yeah, I know. But even with the best of friends, you can only listen to the same stories so many times, and - HEY! What are you... oh!' Putting your hand right on his crotch and giving the bulge there a firm squeeze shocks the anthro donkey at first, but he can't help but let out a needy grunt at being touched like this. Seems like your friend sure is pent up. He then catches himself and shakes his head as if to clear it. 'Wait. Wow. Just a second here! I - um, ";
				if player is male:
					say "I'm not into dudes, you know. Nope. No, definitively not.' Resting your hand right on the spot where a half-hard shaft snakes its way down his pants-leg and feeling it throb, you have your doubts about that. The young man does protest a bit much about the whole idea too, but for now you just keep silent about that and don't call it out.";
					if player is dominant:
						say "     You capitalize on the fact that even though he protests weakly, Axel doesn't actually shove you away, so you push the donkey boy against the wall with a hand planted on one of his firm pecs. As you aggressively follow up with a kiss, he turns his head defensively to the side and says, 'Stop! I said I didn't-' Interrupting, you tell him that he should shut up and just enjoy that you'll give him a blowjob in a second, then put your hand on the side of his muzzle, drawing it towards your head again. Axel's eyes go wide as he starts to realize that you're not just gonna let him shrug this off, but he does comply, opening his mouth nervously as you plant a kiss on his lips, giving him a little bit of tongue too.";
					else if player is submissive:
						say "     Laying a hand on his chest, gently touching the somewhat twitchy donkey boy, you tell him in a friendly tone that you just want to help him let off some steam. He can simply close his eyes and let you take care of everything. As you tell the young man this, your voice is full of excitement at the chance to serve such a fine specimen of masculinity, something he picks up on with wonder. Between his obvious state of pent-up arousal and the worshipful approach you are showing, Axel is brought to a point where he re-thinks his initial refusal, then eventually gives a cautious nod to you. Smiling, you stroke your hand down over his fit form, just eating up every touch and scent, mouth watering at soon having his cock to suck on. The donkey boy gives a nervous laugh at your intense look and swallows visibly, followed by a murmur of, 'Never thought I'd like a guy looking at me like that.'";
					else:
						say "     Giving the donkey boy a friendly smile, you tell him calmly that he shouldn't worry about it. This is just you helping him to relieve some pressure, nothing gay about it. He can just relax, close his eyes and lean back. 'But I - I'm...' Axel starts to say, only to stop when you raise a finger to your lips and shake your head. With a gentle push against his chest, you have him lean back against the wall, and he actually does as instructed, visibly swallowing before closing his eyes. Adding that he shouldn't worry so much, you continue telling him more calming words until Axel eventually murmurs to himself, 'Alright, yeah. Just some guys letting off some steam together. No homo, right?'";
					say "[AxelBJ]";
					if AxelRelationship < 5:
						now AxelRelationship is 4; [had a BJ from a male player]
				else: [female player]
					say "what's your idea for this? You don't think that this'll make us boyfriend and girlfriend, right? I don't really wanna tie myself down right now, alright?' Noticing the slight rise in pitch of his voice as he says the word [italic type]girl[roman type]friend, you have a guess that Axel might be hiding some thoughts for other, more masculine options as well, though that doesn't matter to you now. Resting your hand right on the spot where a half-hard shaft snakes its way down his pants-leg, you can feel it throb and react to your touch.";
					say "     Giving the donkey boy a friendly smile, you tell him calmly that he shouldn't worry about it. This is just you helping him to relieve some pressure, nothing more. He can just relax, close his eyes and lean back. 'I - really? Because girls are usually all...' Axel starts to say, only to stop when you raise a finger to your lips and shake your head. With a gentle push against his chest, you have him lean back against the wall, and he looks at you excitedly. Adding that he shouldn't worry so much, you smile at him and hear when he murmurs to himself, 'Oh man, everyone's gonna be so jealous.'";
					say "[AxelBJ]";
					if AxelRelationship < 4:
						now AxelRelationship is 3; [had a BJ from a female player]
				now Resolution of Donkey Chat is 3; [oral]
			else: [repeats]
				say "     Telling the young man that there is another thing that can drive the boredom away, you lower your hand to rest on his crotch and give the bulge at the front a squeeze. 'Oh? Oh! You wanna do it again? That's awesome! ";
				if player is male:
					say "But remember, I'm not [italic type]really[roman type] into dudes. Nope. No, definitively not.' Resting your hand right on the spot where a half-hard shaft snakes its way down his pants-leg and feeling it throb, you have your doubts about that. The young man does protest a bit much about the whole idea too, but for now you just keep silent about that and don't call it out.";
					if player is dominant:
						say "     Capitalizing on the fact that he let you blow him before, you disregard his weak protests and simply push the donkey boy against the wall with a hand planted on one of his firm pecs. As you aggressively follow up with going for a kiss, he turns his head defensively to the side and says, 'Hey! I said I don't-' Interrupting, you tell him that he should shut up and just enjoy the blowjob like last time, then put your hand on the side of his muzzle, drawing it towards your head again. Axel's eyes go wide as he starts to realize that you're in charge, but he complies as before, opening his mouth nervously as you plant a kiss on his lips, giving him a little bit of tongue too.";
					else if player is submissive:
						say "     Laying a hand on his chest, gently touching the somewhat twitchy donkey boy, you tell him in a friendly tone that you just want to help him let off some steam, like before. He can simply close his eyes and let you take care of everything. As you tell the young man this, your voice is full of excitement at the chance to serve such a fine specimen of masculinity, something he picks up on with wonder. Between his obvious state of pent-up arousal and the worshipful approach you are showing, Axel gives a cautious nod to you. Smiling, you stroke your hand down over his fit form, just eating up every touch and scent, mouth watering at soon having his cock to suck on. The donkey boy gives a nervous laugh at your intense look and swallows visibly, followed by a murmur of, 'Never thought I'd like a guy looking at me like that.'";
					else:
						say "     Giving the donkey boy a friendly smile, you tell him calmly that he shouldn't worry about it. This is just you helping him to relieve some pressure, just like before and with nothing gay about it. He can just relax, close his eyes and lean back. 'I... oh alright,' Axel says somewhat nervously. With a gentle push against his chest, you have him lean back against the wall, and he actually does as instructed, visibly swallowing before closing his eyes. Adding that he shouldn't worry so much, you continue telling him more calming words until Axel eventually murmurs to himself, 'Just some guys letting off steam together. That's all.'";
					say "[AxelBJ]";
					if AxelRelationship < 5:
						now AxelRelationship is 4; [had a BJ from a male player]
				else: [female]
					say "Just remember, this doesn't make us boyfriend and girlfriend or anything. I don't really wanna tie myself down right now, alright?' Noticing the slight rise in pitch of his voice as he says the word [italic type]girl[roman type]friend, you have a guess that Axel might be hiding some thoughts for other, more masculine options, but it does not matter to you now. Resting your hand right on the spot where a half-hard shaft snakes its way down his pants-leg, you can feel it throb and react to your touch.";
					say "     Giving the donkey boy a friendly smile, you tell him calmly that he shouldn't worry about it. This is just you helping him to relieve some pressure, nothing more. He can just relax, close his eyes and lean back. 'I - really? Because girls are usually all...' Axel starts to say, only to stop when you raise a finger to your lips and shake your head. With a gentle push against his chest, you have him lean back against the wall, and he looks at you excitedly. Adding that he shouldn't worry so much, you smile at him and hear when he murmurs to himself, 'Oh man, everyone's gonna be so jealous.'";
					say "[AxelBJ]";
					if AxelRelationship < 4:
						now AxelRelationship is 3; [had a BJ from a female player]
				now Resolution of Donkey Chat is 4; [repeat oral]
			if AxelRelationship is not 100:
				now Donkey Needs is active;
		if AxelRelationship is 1:
			now AxelRelationship is 2; [two-sided introductions, and a nice chat]
	else if calcnumber is 2:
		LineBreak;
		say "     You quietly watch Axel for a few seconds longer, then shrug and continue on your way. Eventually, you reach the point of the mall where you started your little exploration tour.";
	else:
		LineBreak;
		say "     You quietly watch Axel for a few seconds longer, then shrug and continue on your way. Not having any interest in the donkey boy, you resolve to not stop if you see him in the future...";
		now Resolution of Donkey Chat is 5; [avoiding him]
		now Donkey Chat is resolved;
		now Donkey Needs is resolved;
		now AxelRelationship is 100; [ignoring him]

Full Litter is a situation.
The sarea of Full Litter is "Smith Haven".

instead of going north from Mall Foodcourt while (lastMallInteriorScene - turns > 0 and Full Litter is active and Full Litter is not resolved and a random chance of 1 in 3 succeeds):
	move player to Mall Atrium;
	if debugactive is 1:
		say "     DEBUG: Walk-in Event around the mall - Misc atmosphere setting[line break]";
	FullLitterEvent;

instead of resolving Full Litter:
	FullLitterEvent;

to FullLitterEvent:
	say "     As you move through the food court into the atrium, you pass by a rare sight - a fully human woman. She is wearing a thin white top and a long, red skirt that ends just below her knees. She is conversing with another woman, a canine with bushy looking tan fur and small pointed ears. The human woman is cradling her swollen chest. 'Oh my gosh, Linda, you're pregnant! I'm so happy for you!' the canine cheers, embracing the human in a hug. 'Thank you so much, I'm so happy my husband and I finally did it!' Linda replies, looking softly at her bulging stomach. 'So, what are you carrying in there?' the canine asks, giving a soft poke at the woman's stomach. Linda looks up excitedly, replying, 'A full litter of puppies! We're so happy to have this many kids!' The two then happily embrace again. Your path leads you past them, and soon you leave them behind you. It seems like even different species won't stop a mother from loving her children, and the thought brings a smile to your face.";
	now Full Litter is resolved;
	now lastMallInteriorScene is turns;

Cat Toy Vendors is a situation.
The sarea of Cat Toy Vendors is "Smith Haven".

instead of resolving Cat Toy Vendors:
	say "     Wandering through the hallways of the expansive Smith Haven Mall, you spot some cat-morphs selling various custom cat toys to their feline kin. Apparently a surprising number of the transformed people in the crowd of refugees in here are captivated by an instinctual love of mice on string. It is charming to see their wide-eyed expressions as many a head track a toy mouse being demonstrated, with them instinctually wiggling their butts as they get into a slightly pouncing stance. The vendors giggle to each other as a whole group of new customers line up and get ready to trade food and drinks for the small toys being sold.";
	now Cat Toy Vendors is resolved;

Prowling Macho is a situation.
The sarea of Prowling Macho is "Smith Haven".

instead of resolving Prowling Macho:
	say "     On your way through the expansive Smith Haven Mall, you spot a big and broad-shouldered wolfman standing tall at the side, letting his gaze roam over the people slowly moving past him. He wears a cocky smile on his muzzle and not much else, save for a spiked collar to emphasize his masculinity. There's clearly no ring to attach a leash on that thing, so this is definitely a Top Dog. Arms crossed in front of his muscular chest, the big guy's gaze follows this or that woman, and he's clearly entertaining some lurid fantasies by way that the tip of his canine shaft is poking out of the black-furred sheath between his legs. He reminds you of a predator searching for prey, but at least not the kind that roam the streets outside and stake their claims by force. He then apparently makes his decision and strides through the crowd, with people almost automatically parting before his towering form.";
	say "     Holding out a large paw-hand in front of a female lynx, whose sizeable breasts and nipple piercings show clearly through her stretched sleeveless top, the guy stops her in her tracks and says, 'Hey there, babe. You seem like a broad who knows how to have fun. Want me to show you a good time?' Not giving her much time to gather her thoughts, he proceeds to raise his hand and stroke the side of her furred arm, then bends forward to [']whisper['] into her ear, loud enough for you to catch as well, 'I could smell your heat from half a dozen steps away. Come on, you know you want it.' And with that, he gives her tufted ear a playful nip and draws the woman's hand to his crotch. Letting out an involuntary moan as she feels the warmth of his manhood under her fingers, the lynx bites her lip, then nods salaciously to him. With a satisfied chuckle from the wolfman, he lays an arm around her to draw her close, then guides his new conquest towards a small mall restroom nearby.";
	say "     [bold type]Do you want to go after them and see what happens next?[roman type][line break]";
	LineBreak;
	say "     ([link]Y[as]y[end link]) - Sure thing, you wanna see it all. And it's not like they're going anywhere private.";
	say "     ([link]N[as]n[end link]) - Nah, you're good. Not interested in public bathroom banging.";
	if player consents:
		LineBreak;
		say "     By the time you manage to push your way through the crowd and enter the restroom, the wolfman already has his lynx laid out between the two basins of the room's counter. Her back rests against the gray and white tiles of the room's back wall, and she moans helplessly as the macho dude tugs her pants off with one quick wrench, throwing them aside in a crumpled-up wad. 'Yeah, that's what I'm talking about!' he calls out in satisfaction as he draws his thumb through the slightly swollen and gaping folds of her sex, then draws out strings of her sticky wetness between his fingers for a moment before licking them off. Grinning at the woman whimpering in helpless lust, he hooks his fingers under her top and pushes it up and above the curves of her breasts, revealing a pair of silvery rings adorning her nipples. 'Very nice,' he adds, tugging on the piercings and making her gasp at the rough stimulation.";
		say "     Taking hold of his by now fully erect doggy cock, the wolfman smacks it on the short fur of her flat belly, then grinds the underside of his shaft against her clit. 'So, what's your name anyways? I'm Ray, and you'd do well to remember that.' Continuing to tease her drenched pussy, the wolfman watches with great amusement as she opens her mouth to moan with helpless need, eventually managing to gasp out a reply, 'G- *oohhh* Grace. My *god!* my name is Grace.' With a broad grin on his muzzle, the hunky wolfman replies, 'Then get ready for the ride of a lifetime, Gracie!' before ramming his thick shaft into her pussy, thumping the lynx against the back wall before he grasps her by the hips to keep his new fuck-hole steady as he saws in and out of her.";
		WaitLineBreak;
		say "     Ray clearly doesn't believe in taking things slow. You can see his muscular form ripple all over as the wolfman really pounds into his smaller partner, his balls slapping wetly against her buttocks with every eager pump into Grace's sopping sex. She doesn't seem to object to his roughness in the slightest, almost shouting out her eager moans, her hands scrambling to brace herself against the wall or a basin while she's reamed by that hard canine cock. Standing just a few steps away from the two of them, you're enthralled by the spectacle of this handsome male mounting his partner, his hips rocking back and forth as he slams into her. Soon enough, his knot starts to fill out, making Grace gasp and arch her back as it pops in and back out of her pussy a few times before his fingers wrap around the still-growing bulge.";
		say "     'Sorry, slut, but I've got better things to do than hang out here for half an hour till this thing goes down and slides out of ya again. Maybe I'll knot ya next time,' Ray tells the moaning lynx in a no-nonsense tone. He then goes right back to fucking her like a man possessed, only now with his hand in place to prevent him from hilting her. After a few more wild thrusts, the larger male throws his head back and lets out a full-throated howl, his fingers clenching tight around his knot as he starts to unload into Grace. You can see the muscles of his ass and legs tense rhythmically as he floods her pussy with his virile seed, creating a sticky white mess as the feline's sex overflows with virile cream. Dipping a finger into the cum squirting out around his throbbing cock, Ray paints the letter [']R['] on the fur of Grace's belly, then pulls out of her with little further ceremony.";
		WaitLineBreak;
		say "     'Looking forward to next time with ya, Gracie,' Ray says in a casual tone. Finished with her, the wolf turns around and saunters away from the freshly bred lynx, leaving her wearing a dazed, pleasure-addled expression as she stares at the ceiling with raspy breaths. As he passes you, the alpha male gives you a cocky grin, uncaring or maybe even a little flattered that you watched him fuck her. A moment later, the big wolfman has left the restroom, and you're alone with Grace, watching the canine's spunk ooze out of her to drip to the ground. The lynx still looks fairly out of it, a relentless cycle of heat seeming to dominate her actions.";
		LineBreak;
		say "     [bold type]What do you want to do now?[roman type][line break]";
		say "     [link](1)[as]1[end link] - Have a go with her yourself.";
		say "     [link](2)[as]2[end link] - Eat out Grace's pussy.";
		say "     [link](3)[as]3[end link] - Just leave.";
		now calcnumber is 0;
		while calcnumber < 1 or calcnumber > 3:
			say "Choice? (1-3)>[run paragraph on]";
			get a number;
			if calcnumber is 1 or calcnumber is 2 or calcnumber is 3:
				break;
			else:
				say "Invalid choice. Type [link]1[end link] to have a go with her, [link]2[end link] to eat her out or [link]3[end link] to leave.";
		if calcnumber is 1:
			LineBreak;
			if player is male: [male+herm fuck]
				say "     Moving over to where the lynx is still half-sitting, half-lying on the bathroom counter, you rest your hands on the insides of her thighs, stroking the soft fur on her body. Grace reacts to this with a quiet moan and automatically spreads her legs a bit further, her gaze still far away and not even looking at you. Stepping up between the woman's legs, you quickly [SelfStripCrotch], then stroke your [cock of player] shaft in anticipation of entering her. As you jerk yourself to full hardness, your gaze wanders from the gaping opening of her sex and the mess of cum oozing from it, over her little button of a clit, the flat stomach bearing Ray's mark, and the twin, pierced orbs of her breasts. With the heat-crazed lynx already warmed up from the hard fuck and creampie, foreplay is kind of a waste of time, so you simply line yourself up and thrust deep into her pussy.";
				say "     Grace feels nicely warm and wet around your shaft, and Ray's virile load just drenches the length of your cock in his creamy deposit, some of it squelching out of her every time you sheathe yourself in her pussy. Whenever you pull back, sticky strings of seed connect you to the moaning lynx, and soon your balls are completely soaked in Ray's cum, dripping and splattering everywhere while you fuck. Enjoying this compliant feline quite a bit, you don't mind that you're just getting Ray's sloppy seconds, some part of you even finding this second-hand connection to the handsome wolfman hot. Eager for more, Grace's legs wrap around your hips to pull you tight against her cum-sullied crotch, and she groans with desire as you set to rutting her in earnest.";
				WaitLineBreak;
				say "     The two of you fill the little restroom with moans and cries of pleasure, not being quiet at all as you drive into her again and again. Somehow, it's almost as if you are being included in her lust and need to breed, your sex-fogged mind caring little about the one or two creatures who intrude on your passion and gasp before shutting the door again. All that's important right now is the bliss of Grace's pussy skillfully wringing your dick, and you hammer into her with wild abandon. The hard fucking leaves your feline partner in a lust-filled daze, and she purrs deeply as your length fills her again and again. She soon releases a needy yowl, her inner muscles trembling and squeezing around you as she climaxes. Feeling Grace twitch around your [cock of player] shaft and knowing that you brought this beautiful woman to orgasm drives your own lust past the point of no return. With a satisfied grunt, you sink into her one last time, then unload everything you got, your cum mingling with the copious deposit that Ray left in her earlier.";
				say "     As her orgasm slowly ebbs down, Grace slumps back against the wall to recuperate with raspy, heavy breathing. She then opens her eyes again, and for the first time, actually focuses her gaze on you. 'Thanks. I - I really needed that. These heat rushes are just insane. Also, not that I'm complaining about your dick in me or anything, but who are you?' Straightening your spine, you introduce yourself[if player is not defaultnamed] as [name of player][end if] and find yourself relieved that she just smiles in response and gives a little giggle when she looks down at herself. 'Man, what a mess. Any chance that you could hand me some paper towels? Oh, and in case I didn't mention it earlier - always a little fuzzy about these episodes afterwards - I'm Grace.' You slowly pull your length out of her so that the sordid mix of your cum and Ray's doesn't gush like a waterfall, then step to the side and grab several handfuls of paper towels, wiping yourself off and passing along more to Grace.";
				now Resolution of Prowling Macho is 1; [fucked Grace]
			else: [female+neuter stroke her]
				say "     Moving over to where the lynx is still half-sitting, half-lying on the bathroom counter, you rest your hands on the insides of her thighs, stroking the soft fur on her body. Grace reacts to this with a quiet moan and automatically spreads her legs a bit further, her gaze still far away and not even looking at you. Stepping up between the woman's legs, you move a hand to her sex and wipe a finger over the cum-slick folds of her pussy, playing around a little with it and gauging just how much of Ray's load will squelch out when you thrust one finger, then two and three into her depths. With the heat-crazed lynx already warmed up from the hard fuck and creampie, you are free to stroke and rub her to your heart's content, stimulating her pussy and especially the little bump of her clit in a teasing, playful manner.";
				say "     Grace feels nicely warm and wet around your fingers as you explore her body, and Ray's virile load just drenches your hand, some of it squelching out of her every time you slide in. With each retraction, sticky strings of cum connect you to the moaning lynx, and soon, Ray's cum starts to drip down your elbow as you fondle the moaning and twitching woman. Enjoying playing with this compliant feline quite a bit, you find that you don't mind making use of Ray's sloppy seconds at all, some part you even finding it hot to have this second-hand connection to the handsome wolfman. Eager for more, Grace's legs wrap around your hips to pull you in closer, urging you to continue.";
				WaitLineBreak;
				say "     The two of you fill the little restroom with groans and cries of pleasure, Grace not being quiet at all as you rub and caress her on the counter. Somehow, it's almost as if you are being included in her lust and need to get off, caring little about the one or two creatures who intrude on your passion and gasp before shutting the door again. Fingers playing over her most sensitive spots with wild abandon, you push Grace to new heights of pleasure. The manual stimulation leaves your feline partner in a lust-filled daze, and she purrs deeply as you thrust your fingers into her again and again. The lynx soon lets out a needy yowl, her inner muscles trembling and squeezing around your digits as she climaxes. You feel a great satisfaction as you watch her delighted expression and the way her shapely breasts rise and fall during her heaving breaths, the feline panting hotly as your fingers sweep and curl in her slavering pussy.";
				say "     As her orgasm slowly ebbs down, Grace slumps back against the wall with a dazed, fluttering sigh. She then opens her eyes again, and for the first time, actually focuses her gaze on you. 'Thanks. I - I really needed that. These heat rushes are just insane. Also, not that I'm complaining about you being knuckle deep in me or anything, but who are you?' Straightening your spine, you introduce yourself[if player is not defaultnamed] as [name of player][end if] and find yourself relieved that she just smiles in response and gives a little giggle when she looks down at herself. 'Man, what a mess. Any chance that you could hand me some paper towels? Oh, and in case I didn't mention it earlier - always a little fuzzy about these episodes afterwards - I'm Grace.' You slowly pull yourself out of her so that the frothy mixture of Ray's cum and her quim doesn't gush out like a waterfall, then step to the side and grab several handfuls of paper towels, wiping yourself off and passing along more to Grace.";
				now Resolution of Prowling Macho is 2; [stroked Grace]
			WaitLineBreak;
			say "     Demonstrating a surprising level of aplomb, the feline woman cleans herself up quickly, and after throwing the cum-soaked clumps of paper towels into the trash, she casually pulls her pants back on. Of course, anyone who goes through a full transformation and manages to hold on to their humanity already demonstrates admirable resilience, but it seems that Grace was a tough cookie even before the outbreak. Wiggling her breasts at you with an amused grin, she tugs her top back into place, then pulls a blister pack out of her pocket and looks over to you. 'Everyone always said that I have a shitty taste in men. So what?! Getting your brain fucked out in quickies with muscle hunks has its own appeal. I can't help but get off on it. And hey, guess who's having the last laugh now for buying morning after pills in bulk?' Pushing one of the small white tablets out of its packaging, she throws it into her mouth and swallows, then finishes fixing up her appearance. 'See ya, sweetie. I got places to be,' Grace says, stepping outside of the bathroom again.";
		else if calcnumber is 2: [eat her out]
			LineBreak;
			say "     Moving over to where the lynx is still half-sitting, half-lying on the bathroom counter, you rest your hands on the insides of her thighs, stroking the soft fur on her body. Grace reacts to this with a quiet moan and automatically spreads her legs a bit further, her gaze still far away and not even looking at you. Going into a half-crouch in front of the woman, you let your gaze wander from the gaping opening of her sex and the mess of cum oozing from it, over her little button of a clit, the flat stomach bearing Ray's mark, and the twin, pierced orbs of her breasts. Hands resting on her thighs and gently caressing them, you push your head down to her crotch and draw a long, slow lick from the base of her folds to the clit at the top. You then wrap your lips around her clit and smear your spunk-slathered tongue across her sensitive button, coaxing a soft, pleased purr from the well-fucked lynx.";
			say "     Ray's cum brings with it a delightfully rich, nutty flavor, and you can't help but savor the taste of such a virile male. This awakens the desire for more of the wolfman's cum inside you, so you bury your face between Grace's legs and press your mouth against her sex, licking and slurping up every dollop of musk-laced seed. Trembling in pleasure under this new stimulation, the mostly naked woman groans for you to keep going, her arousal driven to new heights when you start to suckle on her clit after many long licks, teasing the little nub with the tip of your tongue. The task of cleaning Grace up is quite fun and tasty, more so than you had even imagined, and you spend quite a while going down on her, devouring Ray's cum and pleasuring the needy woman until she eventually can't contain herself anymore and screams in orgasm, femcum gushing freely from her slit to mix with the last remaining traces of Ray's thick cum.";
			WaitLineBreak;
			say "     As her orgasm slowly ebbs down, Grace slumps back against the wall to recuperate with raspy, heavy breathing. She then opens her eyes again, and for the first time, actually focuses her gaze on you. 'Thanks. I - I really needed that. These heat rushes are just insane. Also, not that I'm complaining about the very nice service or anything, but who are you?' Standing up and introducing yourself[if player is not defaultnamed] as [name of player][end if], you find yourself relieved that she just smiles in response and gives a little giggle when she looks down at herself. 'Usually when something like this happens, I'm a sticky mess. Almost wish I had you around all the time. That was some good tongue-work there! In case I didn't mention it earlier - always a little fuzzy about these episodes afterwards - I'm Grace. Now... could you maybe hand me my pants?'";
			say "     Demonstrating a surprising level of aplomb, the feline woman casually pulls her pants back on as you hand them to her. Of course, anyone who goes through a full transformation and manages to hold on to their humanity already demonstrates admirable resilience, but it seems that Grace was a tough cookie even before the outbreak. Wiggling her breasts at you with an amused grin, she tugs her top back into place, then pulls a blister pack out of her pocket and looks over to you. 'Everyone always said that I have a shitty taste in men. So what?! Getting your brain fucked out by a brutish muscle hunk has its own appeal. I can't help but get off on it. And hey, guess who's having the last laugh now for buying morning after pills in bulk?' Pushing one of the small white tablets out of its packaging, she throws it into her mouth and swallows, then finishes fixing up her appearance. 'See ya, sweetie. I got places to be,' Grace says, stepping outside of the bathroom again.";
			now Resolution of Prowling Macho is 3; [ate Grace out]
		else:
			LineBreak;
			say "     Quietly walking to the door, you leave the naked and dripping lynx behind and go about your business.";
			now Resolution of Prowling Macho is 4; [left Grace after watching]
	else:
		LineBreak;
		say "     With a shrug at the antics of some mall inhabitants, you just turn your back on the two of them, walking on in your tour to find anything that actually interests you.";
		now Resolution of Prowling Macho is 99; [desinterested in Grace]
	now Prowling Macho is resolved;

SailboatPainting is a situation.
The sarea of SailboatPainting is "Smith Haven".

instead of resolving SailboatPainting:
	say "     You are scanning around the stores and kiosks of the mall, when your attention stops on a heavy-set black-furred Mallrat standing in front of an art store. A gray knit cap covers his head, and his clothing consists of a blue heavily food-stained dress shirt, dirty khaki pants and a green Army jacket. He clutches a brown paper bag and a can of soda in his left paw. The closer you get to him, the more pungent his musk becomes. The slovenly rat-man stands stock still, not seeming to notice you or even twitching his tail. Between his horrible hygiene and the filthy state of his clothes, you wouldn't be surprised if he'd been standing there for days. Instead, he is intently focused on a framed gray-dot painting set on a display easel.";
	say "     You are about to ask what he's looking for, when your eyes focus in just the right way to see a hidden picture. 'Oh, a sailboat,' you say out loud. A few seconds pass in silence, before the unkempt rodent bellows out a rage scream loud enough for the entire Mall to hear. He disdainfully throws aside his bag and soda before dejectedly kicking over the easel and storming away. Not quite sure of what you just did to set him off, you shrug, collect the lunch he left behind (waste not want not) and continue on your way.";
	LineBreak;
	say "     [bold type]You gain 1 soda![roman type][line break]";
	increase carried of soda by 1;
	say "     [bold type]You gain 1 food![roman type][line break]";
	increase carried of food by 1;
	now SailboatPainting is resolved;

Inner Mall Events ends here.
