Version 1 of Mul by Wahn begins here.
[Version 1 - Split off into his own file]


Section 1 - NPC

Mul is a man. Mul is in Main Hall.
The description of Mul is "[MulDesc]".
The conversation of Mul is { "Mew!" }.
MulAnalAcceptance is a number that varies.
The icon of Mul is Figure of Mul_clothed_icon.

to say MulDesc:
	if Mul is in Slave Cell 2:
		say "     Mul is the prime example of an orcish warrior - tall and very muscular, with somewhat oversized hand and feet as compared to a human. Currently, his brutish features look calm and peaceful - as the big brute is right in the middle of a post-coital nap after fucking you to exhaustion.";
	else:
		say "     Mul is the prime example of an orcish warrior - tall and very muscular, with somewhat oversized hand and feet as compared to a human. He has short black hair and wears a necklace made out of wooden spheres and large teeth that rests on his muscular pecs. The only type of clothing that he - and anyone in his orc tribe - ever seems to wear is a loincloth of some sort or other. Some of those are clearly self-made, others got a more refined look - maybe they raided a costume shop or stage theater? No matter what, they're definitively pretty revealing, showing off the warrior's statuesque builds and obvious muscles.";
		say "     Currently, the big orc is sitting at a table in the drinking hall, quaffing back large glasses of orc brew while watching [one of]a nearby fight[or]another orc break in a new slave-boy[or]two orcs arm-wrestle[or]a drinking competition[at random]. His back is turned to you, so he hasn't noticed your presence - [if MulAnalAcceptance < 5]and that's good, since he sees you as his property and sex slave[else]and you can surprise him with a demand for more sex, if you choose to[end if].";

instead of sniffing Mul:
	say "     He's got an attractive male scent, with slight undertones of cum and sweat that make him appear even more manly somehow.";

instead of conversing the Mul:
	if Mul is in Slave Cell 2:
		say "     It'd be better for you if you didn't wake him now...";
	else:
		say "     Just strolling up to the orc and engaging him in conversation doesn't seem quite a good idea right now. After all, he thinks of you as property, so he might just make a scene - and you just can't fight a room full of orcs all at once. And even if not - a civil conversation with him seems... unlikely.";

instead of fucking Mul:
	if Mul is in Slave Cell 2:
		say "     He's pretty worn out, let him sleep for now.";
	else:
		if cocks of player is 0 or cockname of player is not "Orc Warrior" or player is not pure:
			say "     You're currently not quite 'man enough' to fuck Mul. Brazenly approaching the mighty orc right in the middle of the drinking hall and surrounded by his buddies... seems something that only a true orc warrior would do - which you're not... right now.";
		else if MulAnalAcceptance is 0:
			say "     Oh yeah, looking at the broad and green back of Mul, plus the deliciously firm ass barely hidden by his loincloth, you feel a longing for the big lug of an orc in your loins, making your cock start to fill out. But... how would you arrange it? The orc sees you as a slave, so just approaching him would simply lead to a brawl. Maybe you should try again once you've got something to hold over his head. With the views of orcs in general saying that only breeders get fucked... maybe you could get one over on Mul sometime when he's alone and break him in a bit first...";
		else if MulAnalAcceptance is 1:
			say "     Oh yeah, looking at the broad and green back of Mul, plus the deliciously firm ass barely hidden by his loincloth, you feel a longing for the big lug of an orc in your loins, making your cock start to fill out. But... how would you arrange it? The orc sees you as a slave, so just approaching him would simply lead to a brawl. Well, you've fucked him once, but that might not have sufficed. Better break him in a bit more first...";
		else if MulAnalAcceptance is 2:
			say "     Oh yeah, looking at the broad and green back of Mul, plus the deliciously firm ass barely hidden by his loincloth, you feel a longing for the big lug of an orc in your loins, making your cock start to fill out. Having pounded this powerful orc's ass multiple times already, you do have an idea how to get him to put out too...";
			LineBreak;
			say "     Baring your own green orcish shaft, you jerk yourself to full hardness. It's strangely exciting to do this right here in the drinking hall, surrounded by other orcs. True, there's... one... two... three... five... six orcs naked right now, fucking their slaves or doing a cumshot competition, but still... you're an intruder here, the only one not fully succumbed to the orc infection. So with your heart beating a bit faster, you milk pre-cum out of your cock and catch it in your cupped hand, then smear the rich and sticky goop all over your index and middle finger. Now prepared for your plan, you walk up behind Mul, coming to stand right next to where the big man is sitting, then lean over him and all too casually lower a hand to his hips.";
			if graphics is true:
				project the figure of Mul_face_icon;
			say "     Mul turns to look who's encroaching so closely, his eyes widening as he realizes it's you - which is just the right moment to strike. Quickly slipping your hand under the band of his loincloth, you push your slimy fingers against his pucker - which readily opens and allows your digits in... no wonder, after how well you've broken his ass in before. The orc slaver's halfway open mouth brings forth only a quickly stifled needy moan instead of what he wanted to say when he spotted you, and his butthole twitches around your fingers as if to welcome you back. A moment later, visibly fighting to suppress an obvious show of his arousal at getting fingered, the orc gives a low growl, 'Stop that, you bastard.'";
			WaitLineBreak;
			say "     Oh, but why would you - you've got him by the balls now and can make the orc do what you want. Mul would be finished if all the others knew that he takes it up the ass - and likes it. One shout from you, combined with the fact that he's got a raging boner while someone fingers him would be enough. Which is exactly what you tell him. The orc gives another low growl, followed by a breathless pant - a result of your precum being absorbed by his inner walls and showing its effect. Hastily looking around to see if anyone noticed or sees your hand under his loincloth, Mul gives a relieved sigh as the orc sitting beside him thunks down on the table with his head, far too drunk to notice anything. Finally, as you demonstratively wiggle your fingers a little bit, he says, 'Fine, you win. But don't think I won't pay you back if we meet in a... less exposed place. Now - let's go to the back rooms before someone notices after all.'";
			say "     Mul leads you out of the drinking hall, down the western hallway and into a room that must once have been the police-men's locker-room. Throwing the door shut after both of you are in, the powerful orc pushes a whole section of heavy lockers in front of it, making sure you're not going to get disturbed. He rips his loincloth off his hips and throws it to the ground, revealing his thick and meaty shaft, then reaches to his own butt and dips a finger in the asshole, moaning loudly at the touch. 'You dosed me with cum, didn't you? I feel... horny... and I need -' Mul takes a deep breath, grunting loudly as he jams another finger into his hole, then continues with an expression somewhere between fury and pleading, 'I need someone to fuck me! Pound my ass, you dirty bastard! Give me your cock!'";
			WaitLineBreak;
			say "     Just what you wanted to hear. With a wide smile on your lips, you quickly take off gear and clothing, then put a hand on your shaft	and demonstratively jerk it while watching Mul finger himself. The orc's breathing goes faster and faster, soon sounding more like lusty grunts as his arousal mounts at the sight of your hard cock.";
			LineBreak;
			say "     [MulLockerroomSexMenu]";
			now MulAnalAcceptance is 3;
		else if MulAnalAcceptance > 2:
			say "     Silently walking up behind the strong orc, you whisper in his ear that you want to fuck him again - while at the same time casually sliding a hand under his loincloth and squeezing one of his firm and muscular buttcheeks. A snarl starts to form in Mul's throat, only to be quickly quenched as he looks at all the other orcs around you and decides that making a scene might not be the best idea[if lastfuck of Mul - turns < 8], given that you can still feel the wetness of cum in his crack - a remainder from your last fun-time[else] right now[end if]. Still, he gives a deep growl, then says just loud enough for only you to hear, 'I'll get you for this, bastard. Eventually you'll be mine and there'll be - *gasp*' You can't help yourself, interrupting his little rant with a finger that you slip into his hole.";
			if graphics is true:
				project the figure of Mul_face_icon;
			say "     As well-trained as you have the orc by now, his pucker readily yields to your probing digit, allowing you to rub Mul's inner walls, which totally breaks his concentration. Fighting down all further moans and gasps after the first one, the orc gives in to you a moment later and says, 'Fine, let's go.' Mul leads the way, passing others whom he grunts to, gives slap on the back, and one orc brute whom he decks hard enough to knock him out - then you're finally out of the drinking hall in a corridor leading west. After about 25 feet, you reach the door to the now unused locker-room of the policemen who once were stationed here - your out of the way fuck-nest for fun with Mul.";
			WaitLineBreak;
			say "     Throwing the door shut after both of you are in, the powerful orc starts to push a whole section of heavy lockers in front of it, wanting to make sure you're not going to get disturbed. While Mul is still in the progress of doing so, you start fingering him again, teasing his pucker and groping his weighty balls with the other hand. The orc can't help but give a loud moan as you push two fingers into him and rub very sensitive spots of the inner walls. His arousal at having something in his ass again is so strong that he even forgets to barricade - or even fully close - the door, leaving the option for someone to come along and find the two of you - not that Mul cares about anything but the lust you've woken inside him right now.";
			say "     Soon, Mul rips his loincloth off his hips and throws it to the ground, revealing a thick and meaty shaft, then reaches to his own butt and holds both cheeks apart to give you easier access. 'I feel... horny... and I need -' Mul takes a deep breath, grunting loudly as you jam another finger into his hole, then continues with an expression somewhere between fury and pleading, 'I need someone to fuck me! Pound my ass, you dirty bastard! Give me your cock!'";
			WaitLineBreak;
			say "     Just what you wanted to hear. With a wide smile on your lips, you quickly take off gear and clothing, then put a hand on your shaft	and demonstratively jerk it while watching Mul finger himself. The orc's breathing goes faster and faster, soon sounding more like lusty grunts as his arousal mounts at the sight of your hard cock.";
			LineBreak;
			say "[MulLockerroomSexMenu]";

instead of going East from Dark Hallway 1 while a random chance of 1 in 3 succeeds and lastfuck of Mul - turns > 7:
	now inasituation is true;
	now OrcSpecialFightNumber is 1;   [meeting Mul]
	challenge "Orc Warrior";

instead of going East from Dark Hallway 2 while a random chance of 1 in 3 succeeds and lastfuck of Mul - turns > 7:
	now inasituation is true;
	now OrcSpecialFightNumber is 1;   [meeting Mul]
	challenge "Orc Warrior";

Section 2 - Locker Room Sex

to say MulLockerroomSexMenu:
	setmonster "Orc Warrior";
	now sextablerun is 0;
	blank out the whole of table of fucking options;
	[]
	if player is male:
		choose a blank row in table of fucking options;
		now title entry is "Take him from behind";
		now sortorder entry is 1;
		now description entry is "Push Mul against the wall and really pound into him";
	[]
	if player is male:
		choose a blank row in table of fucking options;
		now title entry is "Let him ride you";
		now sortorder entry is 2;
		now description entry is "Lie down on a bench and let Mul fuck himself on your pole";
	[]
	if player is male:
		choose a blank row in table of fucking options;
		now title entry is "Fuck him missionary style";
		now sortorder entry is 3;
		now description entry is "Let Mul lie on a bench and take him, face to face";
	[]
	if player is male:
		choose a blank row in table of fucking options;
		now title entry is "Ride Mul's thick shaft";
		now sortorder entry is 4;
		now description entry is "Power-bottom your orcish slut";
	[]
	if (cocks of player > 0 and demon brute is tamed and DemonBruteStatus < 2):
		choose a blank row in table of fucking options;
		now title entry is "Let Brutus fuck Mul";
		now sortorder entry is 5;
		now description entry is "Give the demon a treat and let him sink his prick into Mul";
	[]
	if (cocks of player > 0 and felinoid companion is tamed):
		choose a blank row in table of fucking options;
		now title entry is "Let Klauz fuck Mul";
		now sortorder entry is 6;
		now description entry is "Allow your feline companion to mount Mul";
	[]
	if player is male:
		choose a blank row in table of fucking options;
		now title entry is "Suck Mul while fingering his ass";
		now sortorder entry is 7;
		now description entry is "Train Mul to equate something rubbing his prostate with getting off";
	[]
	sort the table of fucking options in sortorder order;
	repeat with y running from 1 to number of filled rows in table of fucking options:
		choose row y from the table of fucking options;
		say "[link][y] - [title entry][as][y][end link][line break]";
	say "[link]100 - Nevermind[as]100[end link][line break]";
	while sextablerun is 0:
		say "Pick the corresponding number> [run paragraph on]";
		get a number;
		if calcnumber > 0 and calcnumber <= the number of filled rows in table of fucking options:
			now current menu selection is calcnumber;
			choose row calcnumber in table of fucking options;
			say "[title entry]: [description entry]?";
			if player consents:
				let nam be title entry;
				clear the screen and hyperlink list;
				now sextablerun is 1;
				if nam is "Take him from behind":
					say "[MulLockerroomSex1]";
				if nam is "Let him ride you":
					say "[MulLockerroomSex2]";
				if nam is "Fuck him missionary style":
					say "[MulLockerroomSex3]";
				if nam is "Ride Mul's thick shaft":
					say "[MulLockerroomSex4]";
				if nam is "Let Brutus fuck Mul":
					say "[MulLockerroomSex5]";
				if nam is "Let Klauz fuck Mul":
					say "[MulLockerroomSex6]";
				if nam is "Suck Mul while fingering his ass":
					say "[MulLockerroomSex7]";
				now lastfuck of Mul is turns;
				wait for any key;
		else if calcnumber is 100:
			say "Break off?";
			if the player consents:
				now sextablerun is 1;
				say "     You step back from the powerful orc, shaking your head slightly as he gives a questioning look.";
				wait for any key;
			else:
				say "Pick between 1 and [the number of filled rows in the table of fucking options] or 100 to exit.";
		else:
			say "Invalid Option. Pick between 1 and [the number of filled rows in the table of fucking options] or 100 to exit.";
	clear the screen and hyperlink list;

to say MulLockerroomSex1: [Pounding against the wall]
	say "     In the mood for a hard, no nonsense fuck, you grasp Mul by the shoulder and push him forward to stumble against one of the walls. As his large hands thud against the wall to catch himself, you're behind the orc an eye-blink later with your erection leading the way, thrusting deep into the strong male's tight hole and making him roar at the sudden anal invasion. Thanks to already breaking him in very well, Mul's pucker readily expands to allow more and more of your shaft in, while at the same time still being nice and snug around your member. The big male's hole feels fantastic to be in, and the fact that you're dominating the very orc that wanted to take you as a slave makes fucking him all the sweeter.";
	say "     Being used to getting fucked by now - and getting off on it quite a bit, Mul's anal muscles flex and twitch as you pound into him hard. Part of it is just him reacting to you hitting the prostate, but there are also some moments in which the orc's hole almost seems to jerk you off inside him. Apparently, your muscled green playmate has accepted this role so much now that he is experimenting with new techniques to make wild anal sex feel even better for you both. You can't help but give a very satisfied laugh at the situation - you, balls deep inside a mighty orc warrior and pounding into him hard so that he has to brace himself with both arms against the wall... and that right in the orc lair, with all the other green brutes just a short hallway away.";
	WaitLineBreak;
	say "     Grunts and slapping noises of your hips against Mul's ass fill the locker-room, coming in a rapid pace as you fuck him deeply without restraint. He's an orc after all - strong and tough, your bottom-boy can take whatever you can dish out. And you're quite certain that he even likes the rough treatment... having reached around him to take hold of Mul's own thick shaft, you can feel it twitch and pulse each time you give him an especially deep thrust. In a wild and exhilarating ride, you soon drive the big man closer and closer to the edge, his grunts and moans coming quicker and becoming slightly higher pitched.";
	say "     Forgetting his stubborn pride completely in the heat of sex, the orc even starts to shout, 'Yeah, take me! Faster! Pound my ass! Ngh - Nnngh! More! NnnnngggghhhHH!' With that last drawn-out roar, Mul starts to cum, his shaft rhythmically pulsing in your hand as stream after stream of cum blasts through it and covers the locker-room wall. With each spurt of the orc's seed, all the muscles in Mul's body twitch and tense - including those inside his ass, around your shaft. This results in you joining your brutish partner in orgasm just moments later, gripping him tightly around the hips as your balls start to unload everything they got. Your seed gets pumped into Mul in weighty bursts, filling him up with creamy orc cum.";
	WaitLineBreak;
	say "     After blasting the last few spurts of your orgasm into Mul, you pull out of him with a slurp and leave the large orc to sink to his knees on shaky legs. Standing back, you take in your handiwork - one mighty orc warrior slouched against the locker-room wall, with cum dripping out of his hole and him still panting like a needy bitch. You can't help but laugh as he leans forward, resting his shoulder against the plaster to have free hands that immediately start to finger his stretched hole. As he is doing so, Mul suddenly takes a deep sniff and focuses on something - his own cum, slowly oozing down the wall right in front of him. Being the slut for orc cum you've turned him into, there is no hesitation at all as he eagerly licks the sperm up.";
	say "     The very self-satisfied smile on your lips stays with you the whole time as you get dressed, then leave the freshly-bred orc to lap up all the cum he can get. Walking back into the main hall of the orc lair, you can't help but think about the reaction all these other brutes would have if they could see Mul now, on his knees and dripping your seed. You'll have to come back and fuck him again soon - this is just too delicious to pass up.";
	if MulAnalAcceptance < 10:
		increase MulAnalAcceptance by 1;

to say MulLockerroomSex2: [Let him ride your cock]
	say "     Mmmh, yes - making the muscled orc brute mount your shaft himself sure is a delicious thought. He won't be able to tell himself that it's just you raping him if he's the one who sinks his own ass on your pole. What a nice lesson to teach your orcish bottom slut! A domineering smile spreads over your lips as you look at Mul and stroke your own shaft, then turn your back and walk a few steps away from him, heedless of the opening this gives the strong fighter. Why would you be worried, after all - you already got him pleading for your cock, panting in lust-addled heat. All that comes from Mul is a nonplussed grunt leading over into a needy groan - oh yeah, he's well and ready!";
	say "     Sitting down on one of the long wooden benches lined up between the rows of lockers, you swing one foot over it to straddle the thing, then stroke your cock demonstratively and hold it up for the orc to feast his eyes on. Taunting that if he wants it, he can come and fuck himself on your shaft, you lean back and watch the big green male gape at your offer. Expressions flicker over Mul's face - anger and shock, bottomless need and indecision, to name a few... then he suddenly gives a deep grunt, huffing loudly as he walks up to you. The orc scowls at your lying form as he comes to stand right next to the bench, then he moves into position, swinging a leg over it - and you - to stand over your crotch with his back turned in your direction... as if not looking into your eyes as he takes your dick would change anything about what he's about to do.";
	WaitLineBreak;
	say "     You can't quite make out what he murmurs to himself next, but you don't really care, as he starts to lower himself further and further, soon bumping his butt-crack against your hard shaft. A large hand reaches down, taking hold of your manhood and holding it straight up, then you can feel Mul's pucker against your cockhead. With a grunt and a downward push, the orc's muscled ring readily stretches around your shaft, allowing you inside his narrow passage. Yeah - still just awesomely tight and gripping as the time you took Mul's cherry. He's come far in the meantime - from you having to almost knock him out before you could stick your dick in, to now willingly sinking down on your rock-hard pole!";
	say "     The big orc gives lusty grunts and lowers himself further, both hands on his firm buttcheeks - holding them apart as he takes in more and more of your shaft. Then finally, you can feel the downy fuzz of hair on his butt against your crotch, your erection now fully inside Mul. He holds still like that for a moment, taking in the feeling of having your manhood inside his body once more and squeezing his muscles around it. But soon, just sitting passively on your cock isn't enough for the mighty orc warrior - he straightens his legs again, pulling off your pole in one quick move that shows you his winking pucker... before he impales himself on your shaft again with a satisfied roar. As you well know, Mul likes it rough - he is an orc after all!";
	WaitLineBreak;
	say "     Grunts and slapping noises of your hips against Mul's ass fill the locker-room, coming in a rapid pace as he rides your erection hard - and you join in to mix things up a bit, thrusting your hips up when he least expects it. It's a wild fuck between you two, both strong orcs with lots of stamina who go at it without restraint... until you grip him tightly by the hips suddenly, bringing his movements to a stop. You've got to strain yourself to hold on as the needy orc tries to continue, then stops trying after a short moment. Still panting deeply, he barks over his shoulder, 'What?!' ...while at the same time squeezing his anal muscles tightly around your cock. You're almost tempted to just continue as before, but no - you want more from him.";
	say "     Moving your hands to his green buttcheeks and squeezing their firm curves, you tell Mul to turn around - face the man whose cock he's riding like a proper little breeder. The orc answers with an angry growl at your taunting tone, but that is immediately replaced by a needy gasp when you give a tug of your hips, sliding most of your shaft out of his tight chute. Mul's body tries to automatically follow, get the piece of man-meat that is giving him all this pleasure back inside his hole - but you stand fast, not letting him do it. There is a second of hesitation yet, followed by a snarled, 'You bastard! Fine, I'll do it!'";
	WaitLineBreak;
	say "     Letting go of your unyielding grip on Mul, you watch in satisfaction as he sinks himself down on your pole again with a relieved moan. Then, he starts to turn around, still impaled on your erection, first bracing himself with those thick, muscled arms and then swinging a leg over you till he's straddling your hips the right way around. You grin at the mix of sullen anger and bottomless lust on his face, sticking out your tongue and giving a deep thrust as he looks down at you. As Mul starts fucking himself on your pole again, you take hold of the orc's weighty manhood and give it a few strokes, while your other hand cups his balls and fondles them.";
	say "     Getting back to the sensations of your cock hitting his prostrate and with your hands on his erection, the big man soon veers closer and closer to the point of no return, his grunts and moans coming quicker and louder. Forgetting his stubborn pride completely in the heat of sex, the orc even starts to shout, 'Yeah, your cock feels great! Faster! Pound my ass! Ngh - Nnngh! More! NnnnngggghhhHH!' With that last drawn-out roar, Mul starts to cum, his shaft rhythmically pulsing in your hand as stream after stream of cum blasts through it and splatters all over your chest and face.";
	WaitLineBreak;
	say "     With each spurt of the orc's seed, all the muscles in Mul's body twitch and tense - including those inside his ass, around your shaft. This results in you joining your brutish partner in orgasm just moments later, bucking up against him as your balls start to unload everything they got. Your seed gets pumped into Mul in weighty bursts, filling him up with creamy orc cum. As your shaft continues to pulse with spurts of cum, Mul writhes on top of it, clearly overwhelmed by the massive injection of the potent stimulant. He even sinks forward, lying half on top of you and bracing himself on the bench below as he twitches in arousal.";
	say "     You let the orc catch his breath, stroking and feeling his body at your leisure, now that you've got him pretty buzzed with cum and as docile as he'll ever get. Even pulling his head down to yours and giving him a lusty kiss that makes your tusks rub together in a very interesting sensation, you bask in the situation for a moment or two, then put your arms around Mul and give him a light slap on the butt. Wrenched out of his aroused haze, the orc focuses on your very close face, whose lips tell him a moment later to clean you. For now, there's no resistance left in Mul and he readily starts to lick his own creamy cum off your face, then chest. Being the slut for orc cum you've turned him into, he pulls off your shaft when done with lapping at your pecs, then proceeds to take your cock into his mouth to get everything stuck to it.";
	WaitLineBreak;
	say "     A very self-satisfied smile spreads on your lips the whole time as you're cleaned and then get dressed, eventually leaving the freshly-bred orc to stick his fingers up his own back door and suck what cum leaks out off the thick digits. Walking back into the main hall of the orc lair, you can't help but think about the reaction all these other brutes would have if they could see Mul now, on his knees and dripping your seed. You'll have to come back and fuck him again soon - this is just too delicious to pass up.";
	if MulAnalAcceptance < 10:
		increase MulAnalAcceptance by 1;

to say MulLockerroomSex3: [Missionary Fuck]
	say "     In the mood for something more intimate than a quick pounding, you order the horny orc to lie down, pointing at the shredded pile of police-men's uniforms a bit further in the back of the room. Following Mul as he does so, you take a moment to savor the sight of such a magnificent male spread out on the ground before you, waiting to be taken, then kneel between his spread legs and stroke the inside of his thighs. Oh yeah, you'll enjoy your time with this big brute, giving him what his body has learned to crave. As wound up as you have him by now, he starts to raise his legs all on his own, baring the enticing rosette of his pucker, which even 'winks' at you as Mul relaxes his muscles, then tenses them again.";
	say "     You find yourself kneeling down and nudging his back door with your hard cock almost without thought, but stop yourself from just plunging in. Instead, you tease him a bit with the tip, grinning widely at the needy little gasps when you almost - but not quite - enter him with your shaft. Running your hands over the green-skinned man's ripped abs, firm pecs and bulging biceps, you lean over him and take a good whiff of his masculine scent then lick over one of his nipples. The aroused moan from Mul that follows tells you everything you wanted to know - pleased by having another weak spot you can use to make your orcish bitch tremble and howl, you vigorously attack his nipples, sucking on one and flicking it with your tongue while you rub and pinch the other one between your fingers.";
	WaitLineBreak;
	say "     In short order, you have Mul trembling with lust, his hands clenching around big bunches of clothing shreds while his head is leaned back and he almost shouts out his moans. Seeing the ruggedly handsome face of your green-skinned playmate, you get a naughty idea of what you could do with the usually so gruff orc... so you stretch yourself a bit, grip his shoulders with your own strong hands - and plant a hungry kiss right on his spread lips, invading his mouth with your tongue. Mul's eyes open in a flash and he gives you a shocked expression, bucking up reflexively to throw you off - but the moment of resistance is short-lived. The pleasure he gets from your lips and tongue pushes aside the inherent worry of acting in a way that's 'not manly' - which leaves you with an eager, but inexperienced partner in making out.";
	say "     Sharing a very satisfying snog with the orc, you decide it's finally time to take him. Sliding down your hand between the two of you, grasping Mul's shaft on the way and giving it a little stroke, you soon take hold of your own shaft and guide it to your partner's waiting hole. As well-trained as you have him by now, the orcish slaver's pucker readily spreads around your manhood as it pushes into him, forming a delightfully tight ring that stretches around your cock. He feels amazing around you, nice and gripping even after having been fucked a few times - though that's not natural tightness anymore but rather conscious choice, as he flexes his inner muscles to give pleasant sensations to both of you.";
	WaitLineBreak;
	say "     Pulling almost all of your shaft out again, you then slam back in with one mighty thrust, making Mul roar in lust and wrap his strong legs around your hips. It's obvious that while he may get off getting fucked, this orc brute is no sissy - he likes his sex rough, giving or taking it... and you're only too happy to oblige, pounding into his hole without holding back. Most of the time that you buck into him, your lips remain locked with the sexy male, muffling the moans and groans between the two of you - although that doesn't mean it's quiet in the out of the way locker-room, with the loud slapping of your crotch against his butt filling the air...";
	say "     Your wild coupling continues for some time, with you rutting the orc as you make out with him, building your arousal up more and more - until you finally reach the point of no return. Sinking your shaft into Mul all the way one last time, you tightly grip his shoulders with your hands as your balls pulse with the first massive spurt that splashes into him, followed by another, and another. Getting bred by another orc is the last straw for your green-skinned bottom boy too, given the pleasant sensations your pulsing shaft creates - as well as the intoxicating effects of his all the cum filling his hole and being absorbed into his body. Mul's own towering erection swings and twitches as long blasts of cum spray from the cock-slit of his member, liberally splattering the orc's chest.";
	WaitLineBreak;
	say "     While still keeping your cock inside Mul's hole, you straighten your upper body and look down at the orc - well-bred and still with a man's shaft up bis butthole, which combined with a cum-splattered chest creates the image of a fine butt-slut. Chuckling at how far you can push the strong orc warrior by just using the right buttons, you scoop up a bit of his cum with your hand, then hold it out for him to lick clean. After Mul sucks the last creamy drop from your fingers, you get more and more, continuing to feed the eager orc his own load. Eventually, it's all gone and the muscled man is buzzed indeed, still suckling on your fingers to maybe get some more. By this time, your softening shaft has slipped out of his hole, so you stand up and grab your clothes and gear.";
	say "     After getting dressed, you walk to the door, taking another quick look at your little fuck-nest. Leaving the freshly-bred orc to stick his fingers up his own back door and suck what cum leaks out off the thick digits, you leave the room. Walking back into the main hall of the orc lair, you can't help but think about the reaction all these other brutes would have if they could see Mul now, lying on the floor and slurping your seed from his fingers. You'll have to come back and fuck him again soon - this is just too delicious to pass up.";
	if MulAnalAcceptance < 10:
		increase MulAnalAcceptance by 1;

to say MulLockerroomSex4: [Ride Mul]
	say "     In the mood to make use of the half-tamed orc warrior in another way right now, you order Mul to lie down, pointing at the shredded pile of police-men's uniforms a bit further in the back of the room. Following him as he does so, you take a moment to savor the sight of such a magnificent male spread out on the ground before you, waiting to be taken, then kneel between his spread legs and stroke the inside of his thighs. Oh yeah, you'll enjoy your time with this big brute, giving him what his body has learned to crave. As wound up as you have him by now, he starts to raise his legs all on his own, baring the enticing rosette of his pucker, which even 'winks' at you as Mul relaxes his muscles, then tenses them again.";
	say "     You find yourself kneeling down and nudging his back door with your hard cock almost without thought, but stop yourself from just plunging in. Instead, you tease him a bit with the tip, grinning widely at the needy little gasps when you almost - but not quite - enter him with your shaft. Running your hands over the green-skinned man's ripped abs, firm pecs and bulging biceps, you lean over him and take a good whiff of his masculine scent then lick over one of his nipples. The aroused moan from Mul that follows tells you everything you wanted to know - pleased by having another weak spot you can use to make your orcish bitch tremble and howl, you vigorously attack his nipples, sucking on one and flicking it with your tongue while you rub and pinch the other one between your fingers.";
	WaitLineBreak;
	say "     In short order, you have Mul trembling with lust, his hands clenching around big bunches of clothing shreds while his head is leaned back and he almost shouts out his moans. Seeing the ruggedly handsome face of your green-skinned playmate, you get a naughty idea of what you could do with the usually so gruff orc... so you stretch yourself a bit, grip his shoulders with your own strong hands - and plant a hungry kiss right on his spread lips, invading his mouth with your tongue. Mul's eyes open in a flash and he gives you a shocked expression, bucking up reflexively to throw you off - but the moment of resistance is short-lived. The pleasure he gets from your lips and tongue pushes aside the inherent worry of acting in a way that's 'not manly' - which leaves you with an eager, but inexperienced partner in making out.";
	say "     Sharing a very satisfying snog with the orc, you decide it's finally time to take him - up your own ass, that is. Sliding down your hand between the two of you, grasping Mul's shaft on the way and giving it several long strokes, you command him to finger his hole, like the good little slut he's become. With little more than an annoyed grunt, he does as instructed, stretching himself to push against his pucker with thick fingers. As well-trained as you have him by now, the orcish slaver pants and gives needy whimpers as he rams two, then three digits in and out, with his shaft throbbing each time he brushes against an especially sensitive spot up his chute. Pushing yourself up from leaning over him, you brush a hand down his muscled chest and give his proudly standing pole an appreciative squeeze, then stand up and step over him, setting a foot left and right of the orc's hips.";
	WaitLineBreak;
	say "     Eyes closed as he works his fuckhole, the big orc doesn't even realize what you're planning to do until you crouch down and brush his cock with your buttcheeks. The familiar sensation of a man's buns against his shaft does make your green-skinned bitch's eyes fly open instantly. Seeing you hovering over his cock makes a spark of the big orc's domineering spirit flare up, and he starts to push himself up, saying the words, 'Oh yeah, I'll pound you har - *Ooof! Unnghh*' Alas, his thoughts of being the top in your coupling are short-lived, as you force him back down on the ground right away, with the stretched fingers of your hand resting on his muscled pecs, forcing him to take only shallow breaths. And like that, you explain to the orc that he's still your slut, even if you wanna make use of his cock for your own enjoyment. As you let go of him a moment later, Mul doesn't do anything but give a grunt of assent, staying calm on his back and just fondling his ass.";
	say "     Now that you've established who's the boss, you reach behind yourself and take hold of his proud member, then angle it at your back door and sink down a little more, pressing against it. With a lusty grunt from two voices, the orc's thick cockhead sinks into your body as the pucker yields, spreading your opening tight around its girth. The orc's cock is quite big and meaty, making you gasp as you twitch the wrong way after the initial penetration. Though with you being the one in control, taking on this mighty organ is no problem - as you can take your time, only wincing slightly as you sink yourself deeper bit by bit, seeing the hard shaft as a challenge to vanquish, just like its owner. Before much longer, more pleasant feelings prevail as its sides rub against your inner walls, touching sensitive spots deep inside you.";
	WaitLineBreak;
	say "     As you proceed to impale yourself on the orcish warrior's erection, you feel something warm and wet leak into you from the tip of his cock, accompanied by a soothing feeling of well-being. That must be more of his precum - feels a bit strange, but good, and it certainly helps taking his thick meat. Some time later, you're finally all the way down on his prick, his hard shaft buried all the way in you and his two large cum-factories resting against your skin. Feeling a bit giddy, now that you're sitting on one bit more than a foot-long and impressively girthy cock, you look down upon Mul and chuckle to yourself. Even with the nanite apocalypse and all, some things are working out very well for you these days.";
	say "     After taking a deep breath, you start sliding up and down on Mul's manhood, fucking yourself first slowly, then faster and faster as your insides stretch to accommodate his size and more of his precum makes your hole pretty slick and wet. Between the mind-blowing sensations of such a thick piece of meat reaching ALL the places you wanna get fucked in and him leaking aphrodisiac-laden pre into your insides, it doesn't take all that long until your arousal rises above all limits, making you almost shout out in orgasm and [if cocks of player > 0]spray your cum all over the orc's broad chest[else if cunts of player > 0]femcum sprays from your pussy to splatter down on the orc's abs[else]a tingly feeling spreads through your whole body[end if].";
	WaitLineBreak;
	say "     Having your hole tremble and twitch around his orcish member while you come gives Mul the last little push he needed to reach his own climax, and with a loud and very satisfied grunt, the orc starts blasting a massive load of cum into your innermost depths. He bucks up against you as he comes, all the while still fingering himself. Clearly reveling in the feeling of his seed squishing around his thrusting shaft inside your body, the orc gives lusty grunts with each new blast. With the amount of cum he pumps into you, quite a bit squirts out around his cock as he does so, to drip down onto his own crotch and the ground below.[mimpregchance]";
	say "     Exhausted but happy, you pull off your orc slut's still pretty hard shaft, then stand up on somewhat weak knees. But you're not quite done with him, as Mul learns when you straddle his chest after turning around, ass towards the orc warrior's head. Playfully pinching his nipples, you don't even have to say anything, as even to Mul it is pretty clear what you want - and he starts lapping at your butthole almost instantly, hungrily eating his own cum out of you. Chuckling at how far you can push the strong orc warrior by just using the right buttons, you scoop up a bit of the cum sticking to his crotch with your hand, then hold it out for him to lick clean. After Mul sucks the last creamy drop from your fingers, you get more and more, continuing to feed the eager orc the spill of his own load, then press back again, your ass-crack right over his face. Eventually, even the smallest trickle of his orcish seed is gone and Mul is buzzed indeed, simply nuzzling your rear and still lapping a bit in simple reflex.";
	WaitLineBreak;
	say "     With a wide smile on your face, you stand up and grab your clothes and gear, then start putting it all on. After getting dressed, you walk to the door, taking another quick look at your little fuck-nest. The buzzed-out orc is even now still dazedly fingering his back door, and you think he'll keep doing that for some time. Walking back into the main hall of the orc lair, you can't help but think about the reaction all these other brutes would have if they could see Mul now, lying on the floor and having three digits up his chute. You'll have to come back and have sex with him again soon - this is just too delicious to pass up.";
	if MulAnalAcceptance < 10 and MulAnalAcceptance > 3:
		decrease MulAnalAcceptance by 1;

to say MulLockerroomSex5: [Pounding against the wall - with Brutus]
	say "     In the mood to see the big orc taken in a hard, no nonsense fuck, you grasp Mul by the shoulder and push him forward to stumble against one of the walls. As his large hands thud against the wall to catch himself, you're behind the orc an eye-blink later with your erection leading the way, coming to rest between the firm buns of his ass with a meaty thud. Pressing against him from behind, you revel for a second in the fact that even though you can feel his mighty muscles tighten and flex, the green brute doesn't really struggle against being man-handled in such a way. No - he's far too hungry for a hard shaft to pound his slutty ass. And you got just the right cock to do so...";
	if DBCaptureQuestVar is 5: [evil]
		if companion of player is demon brute:
			say "     Looking over to where Brutus has been standing all along, watching and glowering in silence - since you previously forbade him to disturb you - you see that the demon has sprung his typical impressive erection at the show he is being given. Held back from acting on his lust by the magic in your amulet, it is painfully obvious that the purple giant is really itching to have a go at Mul himself. Since that's what you had planned anyways, you just give him a smile and allow Brutus to fuck Mul - without injuring him, you add quickly as a malicious gleam flickers in the demon's eyes. Brutus gives a slightly annoyed grunt, then steps forward and growls, 'About time! Let me show you how to destroy someone's hole, 'master'.' Surprised at the sudden switch in partners, Mul looks back over his shoulder and takes in the towering figure. Your orcish bottom-boy only has time to gasp, 'Oh fuck!' - then Brutus is upon him, one large hand closing on the orc's shoulder to hold him in place, the other lining up his infernal pole.";
		else:
			say "     Grasping the demontooth amulet hanging around your neck, you intone the magic words Nermine taught you, causing a purple swirl of smoke to pour out of the magic item, soon solidifying into the towering figure of your demonic companion. Checking out where you've summoned him this time, the purple giant lets his gaze wander over the trashed locker-room, then returns to your naked form, followed by a long stare at Mul being pressed against the wall. Brutus almost instantly springs his typical impressive erection at the situation before him - it is clear that he's more than a little interested. And so, it is with a smile and allow Brutus to fuck Mul - without injuring him, you add quickly as a malicious gleam flickers in the demon's eyes. Brutus gives a slightly annoyed grunt, then steps forward and growls, 'About time! Let me show you how to destroy someone's hole, 'master'.' Surprised at the sudden switch in partners, Mul looks back over his shoulder and takes in the towering figure. Your orcish bottom-boy only has time to gasp, 'Oh fuck!' - then Brutus is upon him, one large hand closing on the orc's shoulder to hold him in place, the other lining up his infernal pole.";
		WaitLineBreak;
		say "     Without even the slightest hint at concern for Mul's feelings about the matter, Brutus rams his whole shaft into the orc's back door, driving Mul against the wall with a horny roar that is echoed by the orc's own lusty grunt at the sudden deep penetration. Looks like a good thing that you fingered the orc a bit already and he is prepared for getting fucked. Then Brutus pulls back, his purple shaft plopping out of the orc's hole with a wet slurp - only to be driven in all the way an eye-blink later. It is good that your demonic slave has magically enforced instructions not to injure Mul, as he clearly wants to - being the vicious beast that he is. Even so, the purple brute goes as far as his bond allows, using his powerful form really go to town on the orc in his control. And it shows, as the hard pounding of his hips against Mul's rear fills the locker-room with loud slapping noises, and the orc even gets lifted off his feet a few times. The demon grunts and roars as he fucks the orc hard, horny as hell and just a little frustrated he can't completely break him.";
		say "     Meanwhile, on the other end of the infernal erection being hammered in and out of his chute... Mul loves every second of it. Being a real man - a real orc - he takes the hard pounding with a gruff grin on his face, even angling his hips for Brutus to go as deep as he can. The orc's own shaft leaves a visible trail of precum smeared over the wall as he's pushed against it. 'Is that all you got, demon?' Mul pants out in between his loud groans and gasps at the next thrust and the next, egging on Brutus to continue giving him the ride of his life.";
		WaitLineBreak;
		say "     The two big brutes really are an amazing match, both able to dish out a long and hard fuck - and resilient enough to take one too. And so, you're treated to a very sexy show of unrestrained humping, with roars, growls and grunts filling the locker-room until finally, Mul calls out, 'I'm close! Fuck me! Fuck! FUCK! NNNnggghhh!' Thrusting his hips back against the large demon's crotch and throwing his head back, the orc gives a climactic shout and then starts to cum, blasting the wall in front of himself with spurt after spurt of his potent seed. Brutus isn't far behind him either, as the trembling and flexing of the orgasming orc's hole gives him the feeling of being jerked off - and that inside an already warm and tight fuckhole. Thus, he soon wraps his arms around Mul from behind, lifting the orc off his feet as he clutches him to his chest, then rams him down on his shaft several times like an oversized fleshlight. You can literally see the purple orbs of your demon's balls pulse as they send forth a mighty load, filling his partner with more and more cum until Mul has an actual bulge in his stomach, being so full.";
		if companion of player is demon brute:
			say "     After catching his breath, Brutus says, 'I've had better sluts, but you'll do, orc. This was fun.' And with that, he gives Mul's ass a hard slap, enough to leave a slight bruise, but not actually breaking skin with his claws, then pulls his softening erection out with a wet slurp. Giving his still-dripping member and Mul's gaping hole a proud grin, the demon then walks back over to you, taking his usual position by your side again. ";
		else:
			say "     After catching his breath, Brutus says, 'I've had better sluts, but you'll do, orc. This was fun.' And with that, he gives Mul's ass a hard slap, enough to leave a slight bruise, but not actually breaking skin with his claws, then pulls his softening erection out with a wet slurp. Giving his still-dripping member and Mul's gaping hole a proud grin, the demon then walks back over to you and impatiently waits for you to intone the magic words and send him back into the amulet. ";
		say "Meanwhile, Mul still stands against the wall, leaning his head against it - still trying to come to terms with not only being fucked by you, but your pets as well. Best not to let him dwell on such things too long, so you step up behind the orc and 'suggest' he take care of the tasty, tasty orc cum slowly trickling down the wall in front of him. With little more than a grunt, Mul crouches and laps his own seed up, hungrily swallowing it.";
		WaitLineBreak;
		say "     With a wide smile on your face, you grab your clothes and gear, then start putting it all on. After getting dressed, you walk to the door, taking another quick look at your little fuck-nest. The well-bred orc is even now still licking up the last little trickle of seed and fingering the cream-filled hole between his buns, and you think he'll keep doing that for some time. Walking back into the main hall of the orc lair, you can't help but think about the reaction all these other brutes would have if they could see Mul now. You'll have to come back and have sex with him again soon - this is just too delicious to pass up.";
	else: [good]
		if companion of player is demon brute:
			say "     Looking over to where Brutus has been standing all along, silently waiting for his master to have some fun - you see that the demon has sprung an his typical impressive erection at the show. Being the utterly devoted companion that he is, he'd never think of interrupting you, but it is painfully obvious that the purple giant is more than interested in having a go himself. Since that's what you had planned anyways, you just give him a very wide smile and command Brutus to fuck Mul. 'Thank you master,' the demon brute rumbles in his deep voice, at the same time as Mul looks back over his shoulder and takes in the towering figure. Your orcish bottom-boy only has time to gasp, 'Oh fuck!' - then Brutus is upon him, one large hand closing on the orc's shoulder to hold him in place, the other lining up his infernal pole.";
		else:
			say "     Grasping the demontooth amulet hanging around your neck, you intone the magic words Nermine taught you, causing a purple swirl of smoke to pour out of the magic item, soon solidifying into the towering figure of your demonic companion. Checking out where you've summoned him this time, the purple giant lets his gaze wander over the trashed locker-room, then returns to your naked form, followed by a long stare at Mul being pressed against the wall. Brutus almost instantly springs his typical impressive erection at the situation before him - it is clear that he's more than a little interested. And so, it is with a very wide smile that you command your demonic friend to fuck Mul. 'Thank you master,' the demon brute rumbles in his deep voice, at the same time as Mul looks back over his shoulder and takes in the towering figure. Your orcish bottom-boy only has time to gasp, 'Oh fuck!' - then Brutus is upon him, one large hand closing on the orc's shoulder to hold him in place, the other lining up his infernal pole.";
		WaitLineBreak;
		say "     Giving Mul's back door a nudge or two with his cockhead, Brutus finds it nice and ready for his cock and thrusts in without any more hesitation, driving Mul against the wall with a horny roar that is echoed by the orc's own lusty grunt at the sudden deep penetration. Then he pulls back, his purple shaft plopping out of the orc's hole with a wet slurp - only to be driven in all the way an eye-blink later. Even though your demon friend isn't as vicious during sex as he was in the old days, his powerful form is built to really go to town on anyone he might meet - and it shows, as the hard pounding of his hips against Mul's rear fills the locker-room with loud slapping noises, and the orc even gets lifted off his feet a few times. The demon grunts and roars as he fucks the orc hard, for once letting go of all the care he shows towards other partners - as not to break them, a worry he doesn't have with the muscled orc.";
		say "     Meanwhile, on the other end of the infernal erection being hammered in and out of his chute... Mul loves every second of it. Being a real man - a real orc - he takes the hard pounding with a gruff grin on his face, even angling his hips for Brutus to go as deep as he can. The orc's own shaft leaves a visible trail of precum smeared over the wall as he's pushed against it. 'Is that all you got, demon?' Mul pants out in between his loud groans and gasps at the next thrust and the next, egging on Brutus to continue giving him the ride of his life.";
		WaitLineBreak;
		say "     The two big brutes really are an amazing match, both able to dish out a long and hard fuck - and resilient enough to take one too. And so, you're treated to a very sexy show of unrestrained humping, with roars, growls and grunts filling the locker-room until finally, Mul calls out, 'I'm close! Fuck me! Fuck! FUCK! NNNnggghhh!' Thrusting his hips back against the large demon's crotch and throwing his head back, the orc gives a climactic shout and then starts to cum, blasting the wall in front of himself with spurt after spurt of his potent seed. Brutus isn't far behind him either, as the trembling and flexing of the orgasming orc's hole gives him the feeling of being jerked off - and that inside an already warm and tight fuckhole. Thus, he soon wraps his arms around Mul from behind, lifting the orc off his feet as he clutches him to his chest. You can literally see the purple orbs of your demon's balls pulse as they send forth a mighty load, filling his partner with more and more cum until Mul has an actual bulge in his stomach, being so full.";
		if companion of player is demon brute:
			say "     After catching his breath, Brutus says, 'You're a good fuck, orc. This was fun, thanks.' And with that, he gives Mul's shoulder an affectionate squeeze, then pulls his softening erection out with a wet slurp. Giving his still-dripping member and Mul's gaping hole a proud grin, the demon then walks back over to you, taking his usual position by your side again. ";
		else:
			say "     After catching his breath, Brutus says, 'You're a good fuck, orc. This was fun, thanks.' And with that, he gives Mul's shoulder an affectionate squeeze, then pulls his softening erection out with a wet slurp. Giving his still-dripping member and Mul's gaping hole a proud grin, the demon then walks back over to you and patiently waits for you to intone the magic words and send him back into the amulet. ";
		say "Meanwhile, Mul still stands against the wall, leaning his head against it - still trying to come to terms with not only being fucked by you, but your pets as well. Best not to let him dwell on such things too long, so you step up behind the orc and 'suggest' he take care of the tasty, tasty orc cum slowly trickling down the wall in front of him. With little more than a grunt, Mul crouches and laps his own seed up, hungrily swallowing it.";
		WaitLineBreak;
		say "     With a wide smile on your face, you grab your clothes and gear, then start putting it all on. After getting dressed, you walk to the door, taking another quick look at your little fuck-nest. The well-bred orc is even now still licking up the last little trickle of seed and fingering the cream-filled hole between his buns, and you think he'll keep doing that for some time. Walking back into the main hall of the orc lair, you can't help but think about the reaction all these other brutes would have if they could see Mul now. You'll have to come back and have sex with him again soon - this is just too delicious to pass up.";
	if MulAnalAcceptance < 10:
		increase MulAnalAcceptance by 1;

to say MulLockerroomSex6: [Spit-Roasting Mul with the Felinoid]
	say "     In the mood to see the big orc taken in a hard, no nonsense fuck, you grasp Mul by the shoulder and push him forward to stumble over to the shredded pile of police-men's uniforms a bit further in the back of the room. He actually falls down, landing on all fours as you step up and give him another shove, then tell him to raise his ass and get ready for a wild ride. You're behind the orc an eye-blink later with your erection leading the way, coming to rest between the firm buns of his ass with a meaty thud. Pressing your crotch against those muscled cheeks from behind, you revel for a second in the fact that even though you can feel his mighty muscles tighten and flex, the green brute doesn't really struggle against being man-handled in such a way. No - he's far too hungry for a hard shaft to pound his slutty ass. And you got just the right cock to do so...";
	if companion of player is felinoid companion:
		say "     Looking over to where Klauz has been sitting on his haunches all along, silently watching and slowly twitching his tail, you wave for him to come closer - and the big cat replies with an amused mrowl. Almost casually standing up, he pads towards the two of you on his large paws, with a loud purr rumbling in the depth of his throat. Arriving beside Mul in barely an eye-blink, the felinoid proceeds to inspect the naked orc in his own time, sniffing his flank and licking him, then gives a satisfied growl and rubs his cheek against the orc's shoulder, then head, spreading his scent. Knowing the big cat's behavior well by now, you realize what he's doing - for one, marking the green brute as his, and also pushing Mul deeper and deeper into a very receptive state with every musk-laden breath he takes. Not that he needs it right now, with you warming the orc up already, but you guess he just wants to make sure.";
	else:
		say "     Looking over to the not quite closed door to the locker-room, you meet the eyes of Klauz, who had been watching what was going on, silently peeking around the edge of the door. It is as you suspected - the big cat never is all that far away from you, always ready to join you if there's trouble - or to get his rocks off. Something tells you he might be taking liberties with creatures you fought too - just 'happening' to walk into them when you're just gone. As you wave for him to come closer, the big cat replies with an amused mrowl. Almost casually slipping through the door opening, he pads towards the two of you on his large paws, with a loud purr rumbling in the depth of his throat. Arriving beside Mul in barely an eye-blink, the felinoid proceeds to inspect the naked orc in his own time, sniffing his flank and licking him, then gives a satisfied growl and rubs his cheek against the orc's shoulder, then head, spreading his scent. Knowing the big cat's behavior well by now, you realize what he's doing - for one, marking the green brute as his, and also pushing Mul deeper and deeper into a very receptive state with every musk-laden breath he takes. Not that he needs it right now, with you warming the orc up already, but you guess he just wants to make sure.";
	WaitLineBreak;
	say "     As Klauz arrives beside you after a full circle around Mul, still waving his tail in front of the big orc's nose and brushing it against his face, he gives you a relatively abrupt yowl that you're very sure means, 'Move over.' With this being what you wanted to happen all along, you're more than happy to give up your place to the big cat, who immediately sticks his muzzle between Mul's cheeks, sniffing and licking at his rear entrance. The green brute of an orc moans deeply as the felinoid's tongue laps over his pucker, then pushes inside, wiggling around. A moment later, the cat gives a loud, lusty growl - seems he got a taste of your pre in Mul's hole. More than a little turned on by the effects of a pretty fresh bit of orc precum, Klauz does what comes natural and mounts Mul with a roar, pouncing on him and driving his barbed shaft deep with a single thrust.";
	say "     It is good that Mul is an orc, strong and tough, plus ready to enjoy a really hard fuck, as the felinoid pounds into him with the ferocity of a wild beast, resting his bulk on the orc's back as his hips keep humping against firm buttocks. Beside driving Mul to gasp and moan with very deep thrusts and the sensations of all those soft, nubby spikes on a feline cock sawing against his inner walls, Klauz also gives Mul a soft bite in the neck, driving the orc into a mini-orgasm as the teeth prick his skin. Lust-drunk from orc precum and feline musk, Mul howls, 'Fuck me. Fuckkk MMEEE! GOD! FUUUUCK!' His thick cock starts to throb and blasts splashes of rich seed over the shredded uniforms below.";
	WaitLineBreak;
	say "     Just watching Mul come from being fucked, then go right on rocking back to meet the felinoid's next thrust as his cock is still spurting more cum is quite hot - but the throb of your own cock makes you remember to tend to your own needs and not just be an observer, so you move around and come to kneel in front of the groaning orc. With his mouth open in almost constant panting and moaning from Klauz's merciless humping, it is no problem at all to push your prick between those sexy lips, which reflexively close around your meat and start sucking. Ah, it is good to be an orc - having the sheer taste of your pre drive even a tough guy like Mul into sucking your dick like a born cum-slut. As you shove your erection into Mul's throat, enjoying the tightness of his warm passage, you can't help but grin down at the big cat still holding a soft grip on the orc's neck. A fitting companion in this new sex-crazed world - comes as a thought into your head, and you scratch him behind his ears as you continue to face-fuck Mul.";
	say "     With the felinoid still ravaging his ass and your shaft leaking a steady stream of aphrodisiac-laden precum down his throat, it doesn't take all that long until Mul's arousal builds up to another spectacular orgasm. With him gurgling and grunting around your shaft, his hands grip fistfuls of blue cloth and he bucks up against Klauz, then his big prick starts to erupt with a veritable deluge of rich, creamy cum, spurting into the police uniform shreds and even making wet splashes as everything directly in the line of fire is fully soaked and still he shoots more. In the throes of his climax, Mul's throat muscles, as well as anal muscles, tremble and flex like crazy - which drives both you and the felinoid over the edge right with him. Driving in all the way until the orc's nose is buried deep in your pubes, you let go a full load of orc cum, shouting in satisfaction as you fill your half-tamed orc warrior with your seed. In the meantime, Klauz raises his head to roar as he breeds Mul good, his virile semen splashing against the orc's prostate and quickly filling up his insides, to soon start leaking out around his cock.";
	WaitLineBreak;
	say "     For several long moments, nothing but heavy breathing and panting fills the locker-room as all of your orgasms slowly wind down and cocks spill forth the last ebbing spurts of cum in this hole or that, or on the ground. Satisfied with having gotten your rocks off, you pull out of Mul's mouth a short while later, allowing the orc's slurred exclamation of, 'Nnnnggh. Damn. Been fucked by an animal...' He doesn't get any further as the felinoid grips his neck between his teeth again, almost as if to say, 'Yup, and you're my bitch now.' The soft bite pushes Mul to give an involuntary moan in new arousal, something that the large cat on top of him rewards with a deep purr, loud as an idling motor. Then the feral beast throws himself to the side, pulling Mul with him as he lands on the ground, paws wrapped around the orc's chest and hips grinding against him a little.";
	say "     Grinning at the scene of Klauz cuddling against Mul like he's his favorite toy, all the while still being balls-deep in the orc's ass with his barbed shaft, you move to collect your gear again and get dressed. With a look back at the two of them, you tell the felinoid to catch up with you when he's done, then leave. Walking back into the main hall of the orc lair, you can't help but think about the reaction all these other brutes would have if they could see Mul now - buzzed, with a stomach full of orc cum and a feline cock stuck in his ass. You'll have to come back and have sex with him again soon - this is just too delicious to pass up.";
	if MulAnalAcceptance < 10:
		increase MulAnalAcceptance by 1;

to say MulLockerroomSex7: [BJ and fingering]
	say "     Mmmh, yes - training the muscled orc brute to mentally connect something up his rear with getting off. What a nice lesson to teach your orcish bottom slut! Eventually he'll be so used to your fingers or dick up in that tight hole that he'll need it to get off. A domineering smile spreads over your lips as you look at Mul and stroke your own shaft, then turn your back and walk a few steps away from him, heedless of the opening this gives the strong fighter. Why would you be worried, after all - you already got him pleading for your cock, panting in lust-addled heat. All that comes from Mul is a nonplussed grunt leading over into a needy groan - oh yeah, he's well and ready!";
	say "     Stepping over to one of the long wooden benches lined up between the rows of lockers, you pat the smooth surface and wave Mul forward, ordering him to lay down and taunt him a bit as he complies. He sure is one sexy brute, with muscles just rippling under green skin as the orc sits on the bench, then leans back with a grunt, lifting his hips in an invitation that speaks of the deep-seated need you've awoken in him. Crouching down in front of the orc, you run a finger up and down over his quivering hole and playfully stretch out his need and bottomless lust, just teasing the muscled ring and pulling back a little when he tries to edge towards you.";
	WaitLineBreak;
	say "     Finally, you relent - by ramming two fingers into his hungry hole in a quick jab that as Mul groaning in arousal. The orc pants like a bitch in heat as you rub his insides and twist your fingers to stretch him out good. But then, you don't go on to sink your bone into him, but instead reach out and take hold of his heavy shaft in a tight grip. It is almost comical to see his eyes go wide as you start stroking his prick in the same rhythm as fingering him, each down-pull coinciding with a brush against his prostate. Strong muscles in his arms and legs tense and flex as he is pushed to higher and higher levels of arousal.";
	say "     Letting the pleasurable connection between dick and ass sink in on Mul's mind for a few minutes of fun play with your green-skinned bitch, you eventually take things to the next level - by leaning forward and running your tongue up the underside of his throbbing shaft. 'Nnnngh -' the orc grunts in lust, then as you reach the tip and slide your lips over his cockhead, he pants, 'Yeah, my... finger me harder. And keep sucking. Ngh! Please. More.' With his thick piece of meat between your lips, your chuckle at that is a bit muffled. Amazing, how well-behaved an orc can get - if one just knows the right buttons to push. Which you gleefully do, running your tongue along the rim of his prick and then poking at the cock-slit to slurp up his tasty precum leaking out. You can't really tell if you're so giddy and thrilled about the situation because you got Mul exactly where you want him, or the first effects of his cum. Likely either, or both - but in the end, you don't really care. It is great fun, and even if you get roaring drunk off his cum, Mul is too far gone to capitalize on it by now.";
	WaitLineBreak;
	say "     Between slurping his precum and bobbing up and down on Mul's erection, while at the same time jerking and fingering him, you lose track of time for a while as your whole world just shrinks down to the sexy hunk of an orc and yourself. At some point, you added a third finger to spread him open wider, then a fourth, really taking his stretched hole to new limits with your strong and not at all dainty digits. Moans and grunts fill the locker-room as both your lust builds up higher and higher, with Mul soon starting to instinctively buck up his hips in fucking motions that drive his cock deeper into your mouth. He's definitively getting close, so you stop jerking him completely and just keep his cockhead held between your lips while going all out working his ass over with your fingers.";
	say "     It barely takes a moment until your relentless attack on his prostate drives the green-skinned hunk over the edge, shouting out a groan as you nudge it again and again with probing fingers. The metal legs of the bench that Mul holds on to with both raised arms groan and bend a little as an orgasm wracks his naked form, and he humps up with a furious thrust, driving half his prick into your mouth before it starts spewing forth a bucket-load of cum. Even drinking it down as fast as you can, the orc's output just is too much to contain, and more than a little escapes your mouth to run down over his shaft as creamy white drool.";
	WaitLineBreak;
	say "     Eagerly swallowing Mul's aphrodisiac-laden seed, you keep suckling on his prick until the individual spurts slowly get smaller and the orc's orgasm eventually subsides. Man, you're totally stuffed now, your stomach so full with his load that you couldn't take in even one bit more - even though you're more than a little tempted to lick his shaft and crotch to get what escaped you earlier. As your lust-drunk gaze wanders over his fucked-out form, you quickly hone in on Mul's hungry hole, still gaping a little from all the stretching you put it through. It seems obvious to your buzzed mind what to do next - and you look down to your own still very hard erection.";
	say "     Grinning widely at the thick strand of precum oozing from its cockhead into a small puddle on the ground, you wipe it up and jerk your hard cock with a cum-slick hand, then bring it up to Mul's rear entrance. With his opening gaping so invitingly, you decide to take the opportunity to actually see how you breed him and don't slam it in, instead just working on grinding out the load bubbling for release in your balls. Your muscled butt-slut doesn't have long to wait, as you quickly reach the point of no return and grunt deeply as you feel the first spurt. It lands just under Mul's balls, splattering your partner with your mark of ownership, but the next blast you aim better, shooting right up the orc's open chute, as do the ones after that. There is something oh so very satisfying about seeing each long string of cum connecting you to Mul, then hearing him pant needily as it splashes his insides and starts to get absorbed. Each spurt feels amazing, but also takes a bit of energy out of you, making it harder and harder to keep standing...";
	WaitLineBreak;
	say "     You awake some while later, head resting on the broad chest of a still dozing-out Mul. Seems you deposited your load in his ass, then fell on top of him to sleep off your buzz. With a wide smile on your face, you grab your clothes and gear, then start putting it all on. After getting dressed, you walk to the door, taking another quick look at your little fuck-nest. The well-bred orc is still asleep, lying there with cum splattered over his crotch - as well as your load slowly leaking out of his hole to create a small puddle on the bench. Walking back into the main hall of the orc lair, you can't help but think about the reaction all these other brutes would have if they could see Mul now. You'll have to come back and have sex with him again soon - this is just too delicious to pass up.";
	if MulAnalAcceptance < 10:
		increase MulAnalAcceptance by 2;

Section 3 - Lair Sex

to say MulFuck1:
	say "     'My brothers Yatur and Koghh are busy [one of]training with each other[or]giving Orbul a good stuffing[or]outside, having gone for a hunt together[or]fucking some soldiers that are being passed around in the main hall[or]in a brawl[at random], so I guess I've got you all to myself right now.' He chuckles and grips the bulge in his loincloth, continuing with 'Time to please your master Mul, little piggy.' With that, he steps up to you, pulling off your gear and clothing without much restraint or care, just tossing everything aside until you're completely naked before him. His large orc hands grope you all over, roughly squeezing your ass and feeling you up. ";
	if skinname of player is not "Orc Breeder" and skinname of player is not "Orc Warrior" and skinname of player is not "Hulking Cheerleader":
		say "'Oh yes, you'll do nicely. I can't wait till you have beautiful green skin on you...'";
	else if player is impreg_now:
		say "'Oh yes, you'll do nicely. You look good with that swollen belly of yours. Just like a proper breeder is supposed to...'";
	else:
		say "'Oh yes, you'll do nicely. I'll teach you all you need to know to please your master!'";
	if player is submissive: [sub players]
		say "     Pulling the ragged fabric of his loincloth aside, Mul shows you his thick and meaty cock, then puts a hand on your shoulder and pushes down, making you kneel. He softly whacks his thick green shaft against your forehead and grabs your hair tightly, pulling your head against his balls. Following the barked order of 'Lick them!', you obediently lap away at his hairy globes, your pulse racing as the rough treatment plays right into your submissive nature. Doing your best to please him, you take as much as you can of one, then the other ball into your mouth your tongue, playing over them and seeking out sensitive spots - which earns you a satisfied grunt from your orc master. He even lets go of your hair and actually smiles down at you, then says 'Good, that's a proper little slave. Ready to please. Now why don't you hold them with your hands and...'";
		WaitLineBreak;
		say "     Mul spends a while instructing you in all his favorite ways of getting his balls played with, from letting you lick their underside, to gently massaging and even lightly squeezing them. Eager to please the mighty orc, you enthusiastically worship his weighty globes, stimulating him so much that he has to suddenly push you away to avoid coming. Looking up at the orc warrior, you see his whole body go tense and hear him give a breathless gasp, then pant as he stops just short of blowing his load. Only a single big drop of greenish-white orc cum runs out of the tip of his thick shaft, then down its underside, to be quickly licked up by yourself. The taste of Mul's cum spreads over your tongue, delicious like ambrosia and leaves you pretty randy and you hungry for more. Chuckling at your behavior, Mul says 'Phew, almost made me blow my load with your talented tongue. Nicely done, pet, but that'd be too fast... I still wanna fuck your ass.'";
		say "     He waits a moment more to allow himself to relax, then presents you with his hard shaft. 'Blow me - and use lots of spit. You're gonna need it when I stick it in you!' he grumbles, a lusty grin on his face. Eagerly, you slide your lips over the tip of his erect dick and suckle on it for a moment, then hold his manhood up so you can lick up and down the long shaft, teasingly following the veins on it with your tongue. The trickle of precum that soon starts oozing out of his cockhead is amazingly tasty, giving you even more of a rush at taking care of this big brute. As you go on switching up between licking him and sucking his prick, the orc moans 'Can't get enough of my cock, can you? Sluts make the best slaves, really!' He lets you continue for quite a bit, then grunts and pulls you off suddenly, ordering 'Get on the fuckbench!' Being roughly pulled up by your arm, you're given a push towards the sturdy leather-covered bench in the middle of the cell. Stumbling over to it, Mul tells you to lie down on your stomach, legs spread and dangling over the sides of the narrow and sturdy bench. A moment later, the powerful orc warrior moves to stand over your body and reaches down to spread your cheeks. You tremble in anticipation of him just using you for his enjoyment and do your best to relax your sphincter to be ready.";
		WaitLineBreak;
		say "     Your orcish master whacks his erection against your ass with a meaty thud, then slides the hot rod up and down your crack before finally lining up its tip with your hole. Gripping your hips with two large hands, he presses forward, giving a satisfied grunt as he pushes through your back door, stretching it tight around his invading member.";
	else: [normal players]
		say "     Pulling the ragged fabric of his loincloth aside, Mul shows you his thick and meaty cock, then puts a hand on your shoulder and pushes down, making you kneel. He softly whacks his thick green shaft against your forehead and grabs your hair tightly, pulling your head against his balls. Following the barked order of 'Lick them!', you reluctantly give his hairy globes a lick or two, then wince as he gives your hair a jerk and growls 'Faster'. As angering him wouldn't be a good idea, you swallow your pride and start lapping away at his nuts in earnest - which earns you a satisfied grunt from your orc 'owner'. He even loosens his grip on your hair a bit, then gives you a patronizing smile and says 'That's better. You'll learn in time, little slave. Now why don't you hold them with your hands and...'";
		WaitLineBreak;
		say "     Mul spends a while instructing you in all his favorite ways of getting his balls played with, from letting you lick their underside, to gently massaging and even lightly squeezing them. As it seems best to keep him in a good mood, you do your best in taking care of his weighty globes. Then an idea springs up in your mind - if you get him to shoot his load now, that might just save you getting fucked by the massive schlong just inches from your face. Deciding to try it, you really get into pleasuring Mul and eventually stimulate him so much that he has to push you away to avoid coming. Looking up at the orc warrior, you see his whole body go tense and hear him give a breathless gasp, then pant as he stops just short of blowing his load. Damn, that didn't work out - but it was worth a try. Your thoughts are interrupted when you spot a single big drop of greenish-white orc cum runs out of the tip of Mul's thick shaft, then down its underside. Something about it just binds your attention completely, and with each breath you take in, the pleasant and heady smell of orc cum gets to you more. Seconds later, you give in to the desire that wakes inside you and find yourself leaning forward, eagerly licking up the drop of cum from his shaft. The taste of Mul's cum spreads over your tongue, delicious like ambrosia and leaves you pretty randy and you hungry for more. Chuckling at your behavior, Mul says 'Phew, almost made me blow my load with your talented tongue. Nicely done, pet, but that'd be too fast... I still wanna fuck your ass.'";
		say "     He waits a moment more to allow himself to relax, then presents you with his hard shaft. 'Blow me - and use lots of spit. You're gonna need it when I stick it in you!' he grumbles, a lusty grin on his face. Not having much choice else if you don't want him to rip up your ass something terrible later, you start going down on him, switching up between sucking on the tip of his manhood and licking its shaft. The trickle of precum that soon starts oozing out of his cockhead is amazingly tasty, giving you kind of a rush that makes being forced to do this not seem so bad. The orc lets you continue for a bit, then grunts and pulls you off his cock, ordering 'Get on the fuckbench!' Being roughly pulled up by your arm, you're given a push towards the sturdy leather-covered bench in the middle of the cell. Stumbling over to it, Mul tells you to lie down on your stomach, legs spread and dangling over the sides of the narrow and sturdy bench. A moment later, the powerful orc warrior moves to stand over your body and reaches down to spread your cheeks. Trembling at the thought of taking his thick meat, you do your best to relax your sphincter to be ready.";
		WaitLineBreak;
		say "     Your orc 'owner' whacks his erection against your ass with a meaty thud, then slides the hot rod up and down your crack before finally lining up its tip with your hole. Gripping your hips with two large hands, he presses forward, giving a satisfied grunt as he pushes through your back door, stretching it tight around his invading member.";
	say "     It's big - pretty big and thick and meaty, making you gasp from the initial penetration. But as the orc's shaft sinks deeper into your body, pleasant feelings prevail as its sides rub against your inner walls, touching sensitive spots deep inside you. Even though you relaxed as much as you could, it's still quite a lot to take - which the orc seems to know very well, moving deeper only slowly and with surprising patience, sometimes even stopping for a moment so you can get used to it. As he does so, you feel something warm and wet leak into you from the tip of his cock, accompanied by a soothing feeling of well-being. That must be more of his precum - feels a bit strange, but good, and it certainly helps taking his thick meat. Some time later, he finally bottoms out inside you, hard shaft buried all the way and his two large cum-factories resting against your skin.";
	WaitLineBreak;
	say "     After giving you a moment to get used to the stretching feeling of having a whole foot of hard cock inside your ass, he pulls back and thrusts back in with a loud grunt - hard and deep, creating a slapping noise as his hips hit your ass. No wonder he went so slow before, or that'd have ripped you in two! And he just keeps on going like that, now taking out all the stops and really pounding into you like the big brute he is. The sensations of his thrusts make you moan and howl in lust, conscious thought pushed aside completely by the feelings of having that thick shaft deep inside you. Having already enjoyed some ball-play and a blowjob from you, it doesn't take all that long until Mul reaches the limit of his endurance and orgasms, burying his shaft deep in your ass as he pumps blast after blast of cum into you.[mimpregchance]";
	say "     After his precum already made you feel good, being filled by a massive load of real orc cum almost blows your mind. Its special properties really push your arousal right over the edge, making you [if cocks of player > 0]spray your own cum against the leather of the bench. [else if cunts of player > 0]squirting femcum all over the leather of the bench under your crotch. [else]tremble and shake an orgasm wracks your body. [end if]You're so out of it for a while that you barely feel your orc fucker pull out - though the sensations of him pushing a thick finger into your stretched, cum-filled hole brings you back to reality in a second, gasping at the sudden penetration. After pushing his probing finger in and out a few times and using it to rub your insides, Mul walks around the bench and holds out his hand with the command 'Taste it'.";
	WaitLineBreak;
	if player is submissive: [sub players]
		say "     Sucking some of the cum he just fucked into your ass from your master's fingers - of course you jump at this, moaning as you pull his hand closer eagerly. Then your lips are around his digit, eagerly sucking on it to get all of the nectar-like orc cum off. Mul chuckles and says 'You like that, don't you? Be a good little slave and you'll get lots of it from my brothers and me - and others, if we loan you out.' After giving you some more moments to really clean up all of the tasty cum he has on his hand, the orc smugly strolls over to the cell door and leaves, throwing it shut behind himself.";
	else:
		say "     Sucking some of the cum he just fucked into your ass from your 'owner's' fingers - the thought makes you grimace and flinch away. Though not far - as Mul's other hand quickly gets a painful grip in your hair and holds you still. 'Struggling won't help you, slave,' the orc barks and pulls your head back, sticking his cum-covered finger into your mouth as you yelp in pain. 'Now clean it, suck it all off and swallow,' he commands, and you're forced to comply. Even worse, his seed actually tastes quite good, making you a bit light-headed as you swallow it. Mul chuckles and says 'You can't tell me that you don't like it, slave - I can see it on your face. Just give in and accept it.' After giving you some more moments to really clean up all of the cum he has on his hand, the orc smugly strolls over to the cell door and leaves, throwing it shut behind himself.";
	if MulAnalAcceptance < 10 and MulAnalAcceptance > 1:
		decrease MulAnalAcceptance by 1;

to say MulFuck2: [Mul Fucks the player in the hallway]
	say "     Mul chuckles and grips the bulge in his loincloth, continuing with 'Time to please your master Mul, little piggy.' With that, he steps up to you, pulling off your gear and clothing without much restraint or care, just tossing everything aside until you're completely naked before him, right there in the hallway. His large orc hands grope you all over, roughly squeezing your ass and feeling you up. ";
	if skinname of player is not "Orc Breeder" and skinname of player is not "Orc Warrior" and skinname of player is not "Hulking Cheerleader":
		say "'Oh yes, you'll do nicely. I can't wait till you have beautiful green skin on you...'";
	else if player is impreg_now:
		say "'Oh yes, you'll do nicely. You look good with that swollen belly of yours. Just like a proper breeder is supposed to...'";
	else:
		say "'Oh yes, you'll do nicely. I'll teach you all you need to know to please your master!'";
	if player is submissive: [sub players]
		say "     Pulling the ragged fabric of his loincloth aside, Mul shows you his thick and meaty cock, then puts a hand on your shoulder and pushes down, making you kneel. He softly whacks his thick green shaft against your forehead and grabs your hair tightly, pulling your head against his balls. Following the barked order of 'Lick them!', you obediently lap away at his hairy globes, your pulse racing as the rough treatment plays right into your submissive nature. Doing your best to please him, you take as much as you can of one, then the other ball into your mouth your tongue, playing over them and seeking out sensitive spots - which earns you a satisfied grunt from your orc master. He even lets go of your hair and actually smiles down at you, then says 'Good, that's a proper little slave. Ready to please. Now why don't you hold them with your hands and...'";
		WaitLineBreak;
		say "     Mul spends a while instructing you in all his favorite ways of getting his balls played with, from letting you lick their underside, to gently massaging and even lightly squeezing them. Eager to please the mighty orc, you enthusiastically worship his weighty globes, stimulating him so much that he has to suddenly push you away to avoid coming. Looking up at the orc warrior, you see his whole body go tense and hear him give a breathless gasp, then pant as he stops just short of blowing his load. Only a single big drop of greenish-white orc cum runs out of the tip of his thick shaft, then down its underside, to be quickly licked up by yourself. The taste of Mul's cum spreads over your tongue, delicious like ambrosia and leaves you pretty randy and you hungry for more. Chuckling at your behavior, Mul says 'Phew, almost made me blow my load with your talented tongue. Nicely done, pet, but that'd be too fast... I still wanna fuck your ass.'";
		say "     He waits a moment more to allow himself to relax, then presents you with his hard shaft. 'Blow me - and use lots of spit. You're gonna need it when I stick it in you!' he grumbles, a lusty grin on his face. Eagerly, you slide your lips over the tip of his erect dick and suckle on it for a moment, then hold his manhood up so you can lick up and down the long shaft, teasingly following the veins on it with your tongue. The trickle of precum that soon starts oozing out of his cockhead is amazingly tasty, giving you even more of a rush at taking care of this big brute. As you go on switching up between licking him and sucking his prick, the orc moans 'Can't get enough of my cock, can you? Sluts make the best slaves, really!' He lets you continue for quite a bit, then grunts and pulls you off suddenly, ordering 'Against the wall!' Being roughly pulled up by your arm, you're given a push towards the nearest wall in the hallway. Stumbling over to it, you catch yourself with both hands, coming to stand against it with your ass stuck out for Mul. A moment later, the powerful orc warrior moves to stand right behind you and reaches down to spread your cheeks. You tremble in anticipation of him just using you for his enjoyment and do your best to relax your sphincter to be ready.";
		WaitLineBreak;
		say "     Your orcish master whacks his erection against your ass with a meaty thud, then slides the hot rod up and down your crack before finally lining up its tip with your hole. Gripping your hips with two large hands, he presses forward, giving a satisfied grunt as he pushes through your back door, stretching it tight around his invading member.";
	else: [normal players]
		say "     Pulling the ragged fabric of his loincloth aside, Mul shows you his thick and meaty cock, then puts a hand on your shoulder and pushes down, making you kneel. He softly whacks his thick green shaft against your forehead and grabs your hair tightly, pulling your head against his balls. Following the barked order of 'Lick them!', you reluctantly give his hairy globes a lick or two, then wince as he gives your hair a jerk and growls 'Faster'. As angering him wouldn't be a good idea, you swallow your pride and start lapping away at his nuts in earnest - which earns you a satisfied grunt from your orc 'owner'. He even loosens his grip on your hair a bit, then gives you a patronizing smile and says 'That's better. You'll learn in time, little slave. Now why don't you hold them with your hands and...'";
		WaitLineBreak;
		say "     Mul spends a while instructing you in all his favorite ways of getting his balls played with, from letting you lick their underside, to gently massaging and even lightly squeezing them. As it seems best to keep him in a good mood, you do your best in taking care of his weighty globes. Then an idea springs up in your mind - if you get him to shoot his load now, that might just save you getting fucked by the massive schlong just inches from your face. Deciding to try it, you really get into pleasuring Mul and eventually stimulate him so much that he has to push you away to avoid coming. Looking up at the orc warrior, you see his whole body go tense and hear him give a breathless gasp, then pant as he stops just short of blowing his load. Damn, that didn't work out - but it was worth a try. Your thoughts are interrupted when you spot a single big drop of greenish-white orc cum runs out of the tip of Mul's thick shaft, then down its underside. Something about it just binds your attention completely, and with each breath you take in, the pleasant and heady smell of orc cum gets to you more. Seconds later, you give in to the desire that wakes inside you and find yourself leaning forward, eagerly licking up the drop of cum from his shaft. The taste of Mul's cum spreads over your tongue, delicious like ambrosia and leaves you pretty randy and you hungry for more. Chuckling at your behavior, Mul says 'Phew, almost made me blow my load with your talented tongue. Nicely done, pet, but that'd be too fast... I still wanna fuck your ass.'";
		say "     He waits a moment more to allow himself to relax, then presents you with his hard shaft. 'Blow me - and use lots of spit. You're gonna need it when I stick it in you!' he grumbles, a lusty grin on his face. Not having much choice else if you don't want him to rip up your ass something terrible later, you start going down on him, switching up between sucking on the tip of his manhood and licking its shaft. The trickle of precum that soon starts oozing out of his cockhead is amazingly tasty, giving you kind of a rush that makes being forced to do this not seem so bad. The orc lets you continue for a bit, then grunts and pulls you off his cock, ordering 'Against the wall!' Being roughly pulled up by your arm, you're given a push towards the nearest wall in the hallway. Stumbling over to it, you catch yourself with both hands, coming to stand against it with your ass woefully exposed. A moment later, the powerful orc warrior moves to stand right behind you and reaches down to spread your cheeks. Trembling at the thought of taking his thick meat, you do your best to relax your sphincter to be ready.";
		WaitLineBreak;
		say "     Your orc 'owner' whacks his erection against your ass with a meaty thud, then slides the hot rod up and down your crack before finally lining up its tip with your hole. Gripping your hips with two large hands, he presses forward, giving a satisfied grunt as he pushes through your back door, stretching it tight around his invading member.";
	say "     It's big - pretty big and thick and meaty, making you gasp from the initial penetration. But as the orc's shaft sinks deeper into your body, pleasant feelings prevail as its sides rub against your inner walls, touching sensitive spots deep inside you. Even though you relaxed as much as you could, it's still quite a lot to take - which the orc seems to know very well, moving deeper only slowly and with surprising patience, sometimes even stopping for a moment so you can get used to it. As he does so, you feel something warm and wet leak into you from the tip of his cock, accompanied by a soothing feeling of well-being. That must be more of his precum - feels a bit strange, but good, and it certainly helps taking his thick meat. Some time later, he finally bottoms out inside you, hard shaft buried all the way and his two large cum-factories resting against your skin.";
	WaitLineBreak;
	say "     After giving you a moment to get used to the stretching feeling of having a whole foot of hard cock inside your ass, he pulls back and thrusts back in with a loud grunt - hard and deep, creating a slapping noise as his hips hit your ass. No wonder he went so slow before, or that'd have ripped you in two! And he just keeps on going like that, now taking out all the stops and really pounding into you like the big brute he is. The sensations of his thrusts make you moan and howl in lust, conscious thought pushed aside completely by the feelings of having that thick shaft deep inside you. Having already enjoyed some ball-play and a blowjob from you, it doesn't take all that long until Mul reaches the limit of his endurance and orgasms, burying his shaft deep in your ass as he pumps blast after blast of cum into you.[mimpregchance]";
	say "     After his precum already made you feel good, being filled by a massive load of real orc cum almost blows your mind. Its special properties really push your arousal right over the edge, making you [if cocks of player > 0]spray your own cum all over the wall and floor of the hallway. [else if cunts of player > 0]squirting femcum all over the wall and floor of the hallway. [else]tremble and shake an orgasm wracks your body. [end if]You're so out of it for a while that you couldn't have kept standing - were it not for the massive prick still impaling your ass. Then a muscular arm snakes around you, holding you against Mul's chest as he pulls out. His erection is replaced by a thick finger that pushes into your stretched, cum-filled hole and brings you back to reality in a second, gasping at the repeated penetration. After pushing his probing finger in and out a few times and using it to rub your insides, Mul brings his hand in front of your face and commands 'Taste it'.";
	WaitLineBreak;
	if player is submissive: [sub players]
		say "     Sucking some of the cum he just fucked into your ass from your master's fingers - of course you jump at this, moaning as you stretch your neck to reach his finger. Then your lips are around his digit, eagerly sucking on it to get all of the nectar-like orc cum off. Mul chuckles and says 'You like that, don't you? Be a good little slave and you'll get lots of it from my brothers and me - and others, if we loan you out.' After giving you some more moments to really clean up all of the tasty cum he has on his hand, then collect your belongings, the orc throws you over his shoulder and carries you back to your cell. There, he puts you down to lie on the cot inside before leaving and throwing the door shut behind himself.";
	else:
		say "     Sucking some of the cum he just fucked into your ass from your 'owner's' fingers - the thought makes you grimace and flinch away. Though not far - as Mul tightens his arm around your chest enough to take your breath away. 'Struggling won't help you, slave,' the orc barks and after holding you like that for a few more seconds, loosens his grip again to stick his cum-covered finger into your mouth as you gasp for air. 'Now clean it, suck it all off and swallow,' he commands, and you're forced to comply. Even worse, his seed actually tastes quite good, making you a bit light-headed as you swallow it. Mul chuckles and says 'You can't tell me that you don't like it, slave - I can see it on your face. Just give in and accept it.' After giving you some more moments to really clean up all of the tasty cum he has on his hand, then collect your belongings, the orc throws you over his shoulder and carries you back to your cell. There, he puts you down to lie on the cot inside before leaving and throwing the door shut behind himself.";
	if MulAnalAcceptance < 10 and MulAnalAcceptance > 1:
		decrease MulAnalAcceptance by 1;

to say MulAnal:
	if MulAnalAcceptance is 0:
		say "     Kneeling down beside the downed orc, you take hold of his meaty shaft and stroke it a few times, then let your hand wander to his balls. You weigh the hairy globes in your hand and give them an appreciative fondle before you move even lower, sliding your hand between his legs and brushing over his asshole with an exploring finger. As you gently rub the skin around his opening, the Mul starts panting softly from the pleasurable touch, and you can see his manhood grow moment by moment. When you soon do push a finger in against his pucker and probe his hole, the defeated orc warrior doesn't quite realize what you're doing at first - other than that it makes him feel quite interesting.";
		say "     Though that doesn't last long - shaking off the somewhat dazed state and the lustful haze you've put him in, the orc raises his upper body and grunts, 'Wait - no. Stop that! I'm not a breeder! You're supposed to take MY cock', then tries to get up and brush you off. It's an easy task to stop him from doing so, given that you've just kicked his ass and have a quite powerful orcish physique yourself. With one of your big hands on his chest to hold him down, you lean over the orc and growl at him with bared tusks. That show of strength - plus putting your other hand on his balls and giving them a tight warning squeeze - makes Mul surrender to your pleasure. 'Okay, you win you bastard,' he growls, then lets his head fall back to lie on the ground. Your captive's face scrunches up sullenly as you spread his legs with your hands, though he doesn't resist as you do so.";
		WaitLineBreak;
		say "     After getting two fingers nice and wet with spit, you push them against his hole, penetrating his now tense muscle with a bit of effort. Your vanquished orc doesn't seem to want to bottom for you, though as you probe his depths and rub his inner walls, Mul can't hide that he does get aroused by your touch - after all, his thick cock filling out more and more till it stands proudly erect is a pretty obvious sign. 'This means nothing,' he growls loudly, looking at you with a snarl as your eyes meet past his hard manhood. To distract him a bit from his futile resistance, you do put your other hand on his towering pole, jerking up and down on it. Given this new focus to his attention, the green brute loses some of his inhibitions, moaning openly at your touch and leaking precum from the tip of his shaft. Even his pucker relaxes a bit, now that he's no longer consciously clenching it, and you can now push much easier into him and reach his prostate with a teasing touch.";
		say "     You keep going like this for a few minutes, finger-fucking your orcish captive's ass while jerking him off, then quietly pull our your probing digits and line up your manhood with his hole. All the preparation does pay off nicely, as you can penetrate him in a smooth glide in and hit his prostrate with your first thrust, making the previously oh so reluctant orc howl in lust and pleasure. And given the awesome feeling of his tight (most likely virgin) hole stretching around your shaft, you're no less vocal, grunting loudly as you bottom out deep inside him. Panting, you close your eyes and savor the sensations of being balls-deep in this powerful male, fully concentrating on the feeling of his tight hole, his firm cheeks against your balls and the muscles of his legs under your hands.";
		WaitLineBreak;
		say "     Then suddenly, you hear the words 'Get it over with already' in a low growl. Opening your eyes, you do look down on the supine orc, taking in the somewhat sullen expression on his face - caught between pleasure at each little move your cock makes and gruff rejection. He gives a groan and you feel his anal muscles flex around your shaft, then he says with a quaver in his voice, 'Do what you wanna do and fuck off. I'm not into this shit!' The obvious lie - given that his cock is hard as ever - brings a smile to your face and the thought of maybe letting him squirm a bit more, denying that obvious fact, goes through your mind. But your own arousal gets the better of you and your hips start moving almost of their own. Gripping the orc warrior's legs tightly you pull back and back, till only the very tip of your shaft is still inside him, then thrust back in all the way, filling the air with a lustful shout of two voices as you do. With that, the floodgates break completely and you start giving your orc a hard and deep fuck, really pounding into him.";
		say "     You don't know for how long the wild coupling between you lasts, and you don't really care, in the lust-filled haze you find yourself in while fucking the orcish slaver. At some point in the unrestrained copulation between the two of you, Mul's moans start getting deeper and louder, then turn into lust-filled roars as he bucks against you and cum starts gushing out of his thick shaft. He shoots a truly impressive amount of creamy orc cum in high arcs, to splat down audibly all over his chest, neck and face. While the green brute does so, his anal muscles twitch around your own cock with each burst of his seed, making your arousal mount quickly and soon reach its maximum. After just a few more thrusts, you join your orc partner in orgasm. With a deep grunt, you slam into him one last time, your shaft buried as deeply as possible inside his tightly gripping depths as it starts unloading spurt after spurt of your cum. Holding on to the orc's legs, you fill his insides with your seed, then rest with your manhood still inside him and you catch your breath.";
		WaitLineBreak;
		say "     Exhausted but happy, you pull out of Mul's well-bred hole, then stand up on somewhat weak knees. After collecting your clothes and gear, you give the orc an affectionate pat on his sticky chest, then walk away, leaving the panting brute to pick himself and come to terms with being fucked on his own.";
		now MulAnalAcceptance is 1;
	else if MulAnalAcceptance is 1:
		say "     Kneeling down beside the downed orc, you take hold of his meaty shaft and stroke it a few times, then let your hand wander to his balls. You weigh the hairy globes in your hand and give them an appreciative fondle before you move even lower, sliding your hand between his legs and brushing over his asshole with an exploring finger. As you gently rub the skin around his opening, the Mul starts panting softly from the pleasurable touch, and you can see his manhood grow moment by moment. When you soon do push a finger in against his pucker and probe his hole, the defeated orc warrior doesn't quite realize what you're doing at first - other than that it makes him feel quite interesting.";
		say "     Though that doesn't last long - shaking off the somewhat dazed state and the lustful haze you've put him in, the orc raises his upper body and grunts, 'Wait - no. Stop that! I'm not a breeder! You're supposed to take MY cock', then tries to get up and brush you off. It's an easy task to stop him from doing so, given that you've just kicked his ass and have a quite powerful orcish physique yourself. With one of your big hands on his chest to hold him down, you lean over the orc and growl at him with bared tusks. That show of strength - plus putting your other hand on his balls and giving them a tight warning squeeze - makes Mul surrender to your pleasure. 'Okay, you win you bastard,' he growls, then lets his head fall back to lie on the ground. Your captive's face scrunches up sullenly as you spread his legs with your hands, though he doesn't resist as you do so.";
		WaitLineBreak;
		say "     After getting two fingers nice and wet with spit, you push them against his hole, penetrating his ring muscle with a bit of effort, though much easier than when you broke him in last time. Seems like he remembers that he can't keep your probings digit out, meaning that he only clenches his muscle moderately strong to make things harder and isn't going all-out to deny your entrance. As you feel around in his depths and rub his inner walls, Mul can't hide that he does get aroused by your touch - after all, his thick cock filling out more and more till it stands proudly erect is a pretty obvious sign. 'This means nothing,' he growls loudly, looking at you with a snarl as your eyes meet past his hard manhood. 'Getting hard from that is just a physical reaction. It doesn't mean I'm your breeder bitch now!' To distract him a bit from his sullen mumbling, you do put your other hand on his towering pole, jerking up and down on it. Given this new focus to his attention, the green brute loses some of his inhibitions, moaning openly at your touch and leaking precum from the tip of his shaft. Even his pucker gets on with the program, twitching and flexing almost welcoming around your fingers, especially when you reach his prostate with a teasing touch and stroke over it.";
		say "     You keep going like this for a few minutes, finger-fucking your orcish captive's ass while jerking him off, then quietly pull our your probing digits and line up your manhood with his hole. All the preparation does pay off nicely, as you can penetrate him in a smooth glide in and hit his prostrate with your first thrust, making the once oh so reluctant orc howl in lust and pleasure. And given the awesome feeling of his tight hole stretching around your shaft, you're no less vocal, grunting loudly as you bottom out deep inside him. Panting, you close your eyes and savor the sensations of being balls-deep in this powerful male, fully concentrating on the feeling of his tight hole, his firm cheeks against your balls and the muscles of his legs under your hands.";
		WaitLineBreak;
		say "     Then suddenly, you hear the words 'Fuck me' in almost a whisper. Opening your eyes, you do look down on the supine orc, taking in the resigned expression on his face. He gives a groan and you feel his anal muscles flex around your shaft, then he says a bit louder 'If I'm getting fucked anyways, at least make it good so I can enjoy it.' For a moment, the thought of maybe letting him beg a bit more goes through your mind, though your own arousal gets the better of you and your hips start moving almost of their own. Gripping the orc warrior's legs tightly you pull back and back, till only the very tip of your shaft is still inside him, then thrust back in all the way, filling the air with a lustful shout of two voices as you do. With that, the floodgates break completely and you start giving your orc a hard and deep fuck, really pounding into him.";
		say "     You don't know for how long the wild coupling between you lasts, and you don't really care, in the lust-filled haze you find yourself in while fucking your orcish partner. At some point in the unrestrained copulation between the two of you, your bottom-boy orc's moans start getting deeper and louder, then turn into lust-filled roars as he bucks against you and cum starts gushing out of his thick shaft. He shoots a truly impressive amount of creamy orc cum in high arcs, to splat down audibly all over his chest, neck and face. While the green brute does so, his anal muscles twitch around your own cock with each burst of his seed, making your arousal mount quickly and soon reach its maximum. After just a few more thrusts, you join your orc partner in orgasm. With a deep grunt, you slam into him one last time, your shaft buried as deeply as possible inside his tightly gripping depths as it starts unloading spurt after spurt of your cum. Holding on to Mul's legs, you fill his insides with your seed, then rest with your manhood still inside him and you catch your breath.";
		WaitLineBreak;
		say "     Exhausted but happy, you pull out of your toy orc's well-bred hole, then stand up on somewhat weak knees. After collecting your clothes and gear, you give the orc an affectionate pat on his sticky chest, then walk away, leaving the panting brute to pick himself and come to terms with being fucked on his own.";
		now MulAnalAcceptance is 2;
	else if MulAnalAcceptance > 1:
		say "     Kneeling down beside the downed orc, you take hold of his meaty shaft and stroke it a few times, then let your hand wander to his balls. You weigh the hairy globes in your hand and give them an appreciative fondle before you move even lower, sliding your hand between his legs and brushing over his asshole with an exploring finger. As you gently rub the skin around his opening, the Mul starts panting softly from the pleasurable touch, and you can see his manhood grow moment by moment. When you soon do push a finger in against his pucker and probe his hole, the defeated orc warrior doesn't quite realize what you're doing at first - other than that it makes him feel quite interesting.";
		say "     Though that doesn't last long - shaking off the somewhat dazed state and the lustful haze you've put him in, the orc raises his upper body and grunts, 'Wait - no. Stop that! I'm not a breeder! You're supposed to take MY cock', then tries to get up and brush you off. It's an easy task to stop him from doing so, given that you've just kicked his ass and have a quite powerful orcish physique yourself. With one of your big hands on his chest to hold him down, you lean over the orc and growl at him with bared tusks. That show of strength - plus putting your other hand on his balls and giving them a tight warning squeeze - makes Mul surrender to your pleasure. 'Okay, you win you bastard,' he growls, then lets his head fall back to lie on the ground. Your captive's face scrunches up sullenly as you spread his legs with your hands, though he doesn't resist as you do so.";
		WaitLineBreak;
		say "     After getting two fingers nice and wet with spit, you push them against his hole, penetrating his ring muscle with relative ease. Seems like he's finally accepted that getting fingered - and fucked - does feel good, even though he never would allow anyone to do so on his own. As you probe his depths and rub his inner walls, Mul can't hide that he does get aroused by your touch - after all, his thick cock filling out more and more till it stands proudly erect is a pretty obvious sign. 'This means nothing,' he growls loudly, looking at you with a snarl as your eyes meet past his hard manhood. 'Just because anal does feel kind of good doesn't mean I'm your breeder bitch now!' To distract him a bit from his sullen mumbling, you do put your other hand on his towering pole, jerking up and down on it. Given this new focus to his attention, the green brute loses some of his inhibitions, moaning openly at your touch and leaking precum from the tip of his shaft. Even his pucker gets on with the program, twitching and flexing almost welcoming around your fingers, especially when you reach his prostate with a teasing touch and stroke over it.";
		say "     You keep going like this for a few minutes, finger-fucking your orcish captive's ass while jerking him off, then quietly pull our your probing digits and line up your manhood with his hole. All the preparation does pay off nicely, as you can penetrate him in a smooth glide in and hit his prostrate with your first thrust, making the once oh so reluctant orc howl in lust and pleasure. And given the awesome feeling of his tight, well-trained hole stretching around your shaft, you're no less vocal, grunting loudly as you bottom out deep inside him. Panting, you close your eyes and savor the sensations of being balls-deep in this powerful male, fully concentrating on the feeling of his tight hole, his firm cheeks against your balls and the muscles of his legs under your hands.";
		WaitLineBreak;
		say "     Then suddenly, you hear the words 'Fuck me' in almost a whisper. Opening your eyes, you do look down on the supine orc, taking in the needful expression on his face. He gives a groan and you feel his anal muscles flex around your shaft, then he says a bit louder 'You - it... it feels so good. I want it, need it - now!' For a moment, the thought of maybe letting him beg a bit more goes through your mind, though your own arousal gets the better of you and your hips start moving almost of their own. Gripping the orc warrior's legs tightly you pull back and back, till only the very tip of your shaft is still inside him, then thrust back in all the way, filling the air with a lustful shout of two voices as you do. With that, the floodgates break completely and you start giving your orc a hard and deep fuck, really pounding into him.";
		say "     You don't know for how long the wild coupling between you lasts, and you don't really care, in the lust-filled haze you find yourself in while fucking your orcish partner. At some point in the unrestrained copulation between the two of you, your bottom-boy orc's moans start getting deeper and louder, then turn into lust-filled roars as he bucks against you and cum starts gushing out of his thick shaft. He shoots a truly impressive amount of creamy orc cum in high arcs, to splat down audibly all over his chest, neck and face. While the green brute does so, his anal muscles twitch around your own cock with each burst of his seed, making your arousal mount quickly and soon reach its maximum. After just a few more thrusts, you join your orc partner in orgasm. With a deep grunt, you slam into him one last time, your shaft buried as deeply as possible inside his tightly gripping depths as it starts unloading spurt after spurt of your cum. Holding on to Mul's legs, you fill his insides with your seed, then rest with your manhood still inside him and you catch your breath.";
		WaitLineBreak;
		say "     Exhausted but happy, you pull out of your toy orc's well-bred hole, then stand up on somewhat weak knees. After collecting your clothes and gear, you give the orc an affectionate pat on his sticky chest, then walk away, leaving the panting brute to pick himself and come to terms with being fucked on his own.";
		if MulAnalAcceptance < 10:
			increase MulAnalAcceptance by 1;

to say MulAnalRide:[Mul rides the player's cock]
	say "     Mul chuckles and grips the bulge in his loincloth, continuing with 'You've only gotten me more excited with your struggles, little piggy.' Giving a furtive look up and down the hallway to look if anyone is watching, he then grabs you and drags you into the interrogation room, locking its door after you're both inside and he has switched on the lights. With a lusty grunt, he then starts to pull off your gear and clothing, without much restraint or care, just tossing everything aside until you're completely naked before him. His large orc hands grope you all over, roughly squeezing your ass and feeling you up. ";
	if skinname of player is not "Orc Breeder" and skinname of player is not "Orc Warrior" and skinname of player is not "Hulking Cheerleader":
		say "'Oh yes, you'll do nicely. I can't wait till you have beautiful green skin on you...'";
	else:
		say "'Oh yes, you'll do nicely. I'll teach you all you need to know to please your master!'";
	if player is submissive: [sub players]
		say "     Pulling the ragged fabric of his loincloth aside, Mul shows you his thick and meaty cock, then puts a hand on your shoulder and pushes down, making you kneel. He softly whacks his thick green shaft against your forehead and grabs your hair tightly, pulling your head against his balls. Following the barked order of 'Lick them!', you obediently lap away at his hairy globes, your pulse racing as the rough treatment plays right into your submissive nature. Doing your best to please him, you take as much as you can of one, then the other ball into your mouth your tongue, playing over them and seeking out sensitive spots - which earns you a satisfied grunt from your orc master. He even lets go of your hair and actually smiles down at you, then says 'Good, that's a proper little slave. Ready to please. Now why don't you hold them with your hands and...'";
		WaitLineBreak;
		say "     Mul spends a while instructing you in all his favorite ways of getting his balls played with, from letting you lick their underside, to gently massaging and even lightly squeezing them. Eager to please the mighty orc, you enthusiastically worship his weighty globes, stimulating him so much that he has to suddenly push you away to avoid coming. Looking up at the orc warrior, you see his whole body go tense and hear him give a breathless gasp, then pant as he stops just short of blowing his load. Only a single big drop of greenish-white orc cum runs out of the tip of his thick shaft, then down its underside, to be quickly licked up by yourself. The taste of Mul's cum spreads over your tongue, delicious like ambrosia and leaves you pretty randy and hungry for more. Chuckling at your behavior, Mul says 'Phew, almost made me blow my load with your talented tongue. Nicely done, pet, but that'd be too fast... I have a certain itch I wanna use you to sate.'";
		say "     He hesitates for a moment longer, looking at the door as if to make sure it's still closed, then turns around, presenting his firmly muscled butt to you. 'Get licking slave-boy,' your orc master commands in a low voice, holding his buttcheeks apart with two strong hands. Eagerly leaning forward and pressing your nose against the somewhat hairy skin of his crack, you then take a deep sniff of his clean, masculine smell and start lapping away at his hole. Mul's pucker is pretty relaxed and accommodating, easily allowing you to push your tongue into his body - which does make you wonder if he's been training himself with some toy since you turned him on to anal sex. Amid low moans, the green-skinned brute gives a silent grunt of 'Yeah, just like that - and use your fingers too.' You immediately get to work probing and stroking his insides with two, then three fingers, much to the orc's arousal.";
		WaitLineBreak;
		if a random chance of 1 in 2 succeeds: [comes from having eaten his ass]
			say "     When you reach your other arm through between his legs and start massaging his full, green balls at the same time, it's only a question of time till you push him to the point of no return. Only a short while later, Mul's moans and grunts quickly get pretty loud, culminating in almost a roar as thick spurts of cum blast from his cock to splat down on the ground and even hit the wall next to the door.";
			say "     After waiting a while for his orgasm to subside and to catch his breath, Mul turns around and pulls you to your feet, then bends you over the fuckbench in the middle of the room. He gropes your butt, then holds your cheeks apart with his fingers as he brings his still pretty hard cock up and rubs it against you, leaving your hole wet with the cum still clinging to its tip and everything more that he can milk out of his manhood. Giving your ass a light slap after that bit of deception is done, he pins you down with a stare and growls 'Not a word about this - I fucked you, if anyone asks.' With that said, the orc allows you to quickly gather up your belongings, then leads you back into your cell and throws its door shut.";
		else: [rides the player's cock]
			say "     Suddenly, Mul draws away from you and turns around lust flaring in his eyes. With the lusty grunt of, 'I wanna fuck!', his two strong hands grip you under your arms and you are lifted up, then almost thrown to lie lengthwise on a sofa, with the orc climbing on top of you a moment later. He comes to kneel above you, straddling your hips, and catches your wrists to hold them down above your head with one hand, while the other one gropes your crotch. Taking hold of your erection, the orc holds it up and lowers his hips to meet it. Soon, you can feel the tip of your [cock of player] shaft push against his pucker, then sink inside, enveloped by a warm and tight passage. 'Yeah!' Mul grunts loudly as his cheeks touch your crotch and all of your erection is inside him, then he starts to rock back and forth, fucking himself on your pole.";
			say "     Given how wound-up he already is from all the oral attention he got from you, it doesn't take all too long until riding your cock brings Mul's arousal to the boiling point. After a quick build-up of the volume and urgency in his grunts and moans, the green brute bends his body back to take all of you inside him and gives a roar that heralds a veritable explosion of cum from his massive dick. Spurt after spurt of thick, creamy orc cum pulse from the slit of his manhood to splash down on your chest, face and the sofa. Eager to join your master in orgasm, your pump your hips up against him and enjoy the twitching of his anal muscles around your thrusting shaft, while at the same time wiping up all the cum you can get with your hand so suck it hungrily from your fingers. In no time at all, you reach the point of no return and joyfully pass it, writhing on the sofa as your whole body shakes from a mind-blowing climax and your seed gets blasted into the orc's gut.";
			WaitLineBreak;
			say "     After waiting a while for his orgasm to subside and to catch his breath, Mul lifts himself from the impalement on your softening erection and stands up. Grabbing your leg with one big hand, he lifts it, then brings his still pretty hard cock forward and rubs it against you, leaving your hole wet with the cum still clinging to its tip and everything more that he can milk out of his manhood. Giving your ass a light slap after that bit of deception is done, he pins you down with a stare and growls 'A good slave has to know to keep his master's secrets too. Not a word about this - I fucked you, if anyone asks.' With that said, the orc snatches up a piece of your clothing and uses it to dab away the bit of your cum that leaked out of him, then allows you to quickly gather up your belongings and leads you back into the cell that is your home.";
	else: [non-sub players]
		say "     Pulling the ragged fabric of his loincloth aside, Mul shows you his thick and meaty cock, then puts a hand on your shoulder and pushes down, making you kneel. He softly whacks his thick green shaft against your forehead and grabs your hair tightly, pulling your head against his balls. Following the barked order of 'Lick them!', you reluctantly give his hairy globes a lick or two, then wince as he gives your hair a jerk and growls 'Faster'. As angering him wouldn't be a good idea, you swallow your pride and start lapping away at his nuts in earnest - which earns you a satisfied grunt from your orc 'owner'. He even loosens his grip on your hair a bit, then gives you a patronizing smile and says 'That's better. You'll learn in time, little slave. Now why don't you hold them with your hands and...'";
		WaitLineBreak;
		say "     Mul spends a while instructing you in all his favorite ways of getting his balls played with, from letting you lick their underside, to gently massaging and even lightly squeezing them. As it seems best to keep him in a good mood, you do your best in taking care of his weighty globes. Then an idea springs up in your mind - if you get him to shoot his load now, that might just save you getting fucked by the massive schlong just inches from your face. Deciding to try it, you really get into pleasuring Mul and eventually stimulate him so much that he has to push you away to avoid coming. Looking up at the orc warrior, you see his whole body go tense and hear him give a breathless gasp, then pant as he stops just short of blowing his load. Damn, that didn't work out - but it was worth a try. Your thoughts are interrupted when you spot a single big drop of greenish-white orc cum runs out of the tip of Mul's thick shaft, then down its underside. Something about it just binds your attention completely, and with each breath you take in, the pleasant and heady smell of orc cum gets to you more. Seconds later, you give in to the desire that wakes inside you and find yourself leaning forward, eagerly licking up the drop of cum from his shaft. The taste of Mul's cum spreads over your tongue, delicious like ambrosia and leaves you pretty randy and you hungry for more. Chuckling at your behavior, Mul says Phew, almost made me blow my load with your talented tongue. Nicely done, pet, but that'd be too fast... I have a certain itch I wanna use you to sate.'";
		say "     He hesitates for a moment longer, looking at the door as if to make sure it's still closed, then turns around, presenting his firmly muscled butt to you. 'Get licking slave-boy,' your orc 'owner' commands in a low voice, holding his buttcheeks apart with two strong hands. Not having much choice else if you don't want him to enrage him, you start lapping away at his hole, slowly running your tongue up his crack and teasing his pucker. Thankfully, there is nothing but a clean, masculine smell to him, at least making this experience a relatively tolerable one. Mul's pucker is pretty relaxed and accommodating, easily allowing you to push your tongue into his body - which does make you wonder if he's been training himself with some toy since you turned him on to anal sex. Amid low moans, the green-skinned brute gives a silent grunt of 'Yeah, just like that - and use your fingers too.' You immediately get to work probing and stroking his insides with two, then three fingers, much to the orc's arousal.";
		WaitLineBreak;
		if a random chance of 1 in 2 succeeds: [comes from having eaten his ass]
			say "     When you reach your other arm through between his legs and start massaging his full, green balls at the same time, it's only a question of time till you push him to the point of no return. Only a short while later, Mul's moans and grunts quickly get pretty loud, culminating in almost a roar as thick spurts of cum blast from his cock to splat down on the ground and even hit the wall next to the door.";
			say "     After waiting a while for his orgasm to subside and to catch his breath, Mul turns around and pulls you to your feet, then bends you over the fuckbench in the middle of the room. He gropes your butt, then holds your cheeks apart with his fingers as he brings his still pretty hard cock up and rubs it against you, leaving your hole wet with the cum still clinging to its tip and everything more that he can milk out of his manhood. Giving your ass a light slap after that bit of deception is done, he pins you down with a stare and growls 'Not a word about this - I fucked you, if anyone asks.' With that said, the orc allows you to quickly gather up your belongings, then leads you back into your cell and throws its door shut.";
		else: [rides the player's cock]
			say "     Suddenly, Mul draws away from you and turns around lust flaring in his eyes. With the lusty grunt of, 'I wanna fuck!', his two strong hands grip you under your arms and you are lifted up, then almost thrown to lie lengthwise on a sofa, with the orc climbing on top of you a moment later. He comes to kneel above you, straddling your hips, and catches your wrists to hold them down above your head with one hand, while the other one gropes your crotch. Taking hold of your erection, the orc holds it up and lowers his hips to meet it. Soon, you can feel the tip of your [cock of player] shaft push against his pucker, then sink inside, enveloped by a warm and tight passage. 'Yeah!' Mul grunts loudly as his cheeks touch your crotch and all of your erection is inside him, then he starts to rock back and forth, fucking himself on your pole.";
			say "     Given how wound-up he already is from all the oral attention he got from you, it doesn't take all too long until riding your cock brings Mul's arousal to the boiling point. After a quick build-up of the volume and urgency in his grunts and moans, the green brute bends his body back to take all of you inside him and gives a roar that heralds a veritable explosion of cum from his massive dick. Spurt after spurt of thick, creamy orc cum pulse from the slit of his manhood to splash down on your chest, face and the sofa. Eager to get off yourself, your pump your hips up against him and enjoy the twitching of his anal muscles around your thrusting shaft. In no time at all, you reach the point of no return and joyfully pass it, writhing on the sofa as your whole body shakes from a mind-blowing climax and your seed gets blasted into the orc's gut.";
			WaitLineBreak;
			say "     After waiting a while for his orgasm to subside and to catch his breath, Mul lifts himself from the impalement on your softening erection and stands up. Grabbing your leg with one big hand, he lifts it, then brings his still pretty hard cock forward and rubs it against you, leaving your hole wet with the cum still clinging to its tip and everything more that he can milk out of his manhood. Giving your ass a light slap after that bit of deception is done, he pins you down with a stare and growls 'A good slave has to know to keep his master's secrets too. Not a word about this - I fucked you, if anyone asks.' With that said, the orc snatches up a piece of your clothing and uses it to dab away the bit of your cum that leaked out of him, then allows you to quickly gather up your belongings and leads you back into the cell that is your home.";
	if MulAnalAcceptance < 10:
		increase MulAnalAcceptance by 1;

to say MulBottomAnalRide:[Mul rides the player's cock, or gets fingered]
	say "     Mul chuckles and grips the bulge in his loincloth, continuing with 'Told ya that you don't have a chance against a real orc. Only gotten me more excited with your struggles, little piggy.' Giving a look to the wide-open sliding door of your little fighting arena, he drags you over behind the car that was in the garage as the nanite plague hit. With a lusty grunt, he then starts to pull off your gear and clothing, without much restraint or care, just tossing everything aside until you're completely naked before him. His large orc hands grope you all over, roughly squeezing your ass and feeling you up. 'Oh, I'm gonna enjoy taking you!'";
	if player is submissive: [sub players]
		say "     Pulling the ragged fabric of his loincloth aside, Mul shows you his thick and meaty cock, then puts a hand on your shoulder and pushes down, making you kneel. He softly whacks his thick green shaft against your forehead and grabs your hair tightly, pulling your head against his balls. Following the barked order of 'Lick them!', you obediently lap away at his hairy globes, your pulse racing as the rough treatment plays right into your submissive nature. Doing your best to please him, you take as much as you can of one, then the other ball into your mouth your tongue, playing over them and seeking out sensitive spots - which earns you a satisfied grunt from your orc master. He even lets go of your hair and actually smiles down at you, then says 'Good, that's a proper little slave. Ready to please. Now why don't you hold them with your hands and...'";
		WaitLineBreak;
		say "     Mul spends a while instructing you in all his favorite ways of getting his balls played with, from letting you lick their underside, to gently massaging and even lightly squeezing them. Eager to please the mighty orc, you enthusiastically worship his weighty globes, stimulating him so much that he has to suddenly push you away to avoid coming. Looking up at the orc warrior, you see his whole body go tense and hear him give a breathless gasp, then pant as he stops just short of blowing his load. Only a single big drop of greenish-white orc cum runs out of the tip of his thick shaft, then down its underside, to be quickly licked up by yourself. The taste of Mul's cum spreads over your tongue, delicious like ambrosia and leaves you pretty randy and hungry for more. Chuckling at your behavior, Mul says 'Phew, almost made me blow my load with your talented tongue. Nicely done, pet, but that'd be too fast... your ass is mine next!'";
		say "     He waits a moment more to allow himself to relax, then presents you with his hard shaft. 'Blow me - and use lots of spit. You're gonna need it when I stick it in you!' he grumbles, a lusty grin on his face. Eagerly, you slide your lips over the tip of his erect dick and suckle on it for a moment, then hold his manhood up so you can lick up and down the long shaft, teasingly following the veins on it with your tongue. The trickle of precum that soon starts oozing out of his cockhead is amazingly tasty, giving you even more of a rush at taking care of this big brute. As you go on switching up between licking him and sucking his prick, the orc moans 'Can't get enough of my cock, can you? Sluts make the best slaves, really!' He lets you continue for quite a bit, then grunts and pulls you off suddenly, ordering 'Bend over the hood!' Being roughly pulled up by your arm, you're given a push towards the car in the garage. Stumbling over to it, you catch yourself with both hands, coming to stand against it with your ass stuck out for Mul. A moment later, the powerful orc warrior moves to stand right behind you and reaches down to spread your cheeks. You tremble in anticipation of him just using you for his enjoyment and do your best to relax your sphincter to be ready.";
		WaitLineBreak;
		say "     Yet as Mul steps up behind you and takes his cock in hand, slapping it against your waiting rear, it feels... less hard than you would have expected. Lining the tip of his member up with your opening, the big brute gives a hard thrust, penetrating deeply and drawing a needy moan from yourself. As he starts fucking into you after that, you're hit with the realization that despite his rapid pace and the force with which he forces his manhood in, Mul is actually softening more and more. You can't help but feel that there's... something missing for him to enjoy himself. Like a hard cock in his ass, as you've trained him to enjoy. Soon, the orc's wilted cock actually pops out of your ass on its own, too soft to stay inside. This draws a frustrated grunt from the green-skinned brute and he snarls loudly, punching the car hard enough to leave a dent. 'Must have had something bad to eat, I - I don't feel like fucking you right now,' comes a loud grumble, full of anger and denial. Reaching for his loincloth, the orc adds, 'Seems you're out of luck, slut. Guess your hole won't be stretched out today by my thick prick.'";
		LineBreak;
		say "     What now?";
		say "     ([link]Y[as]y[end link]) - Do you accept the explanation and let a sexually frustrated Mul stalk off?";
		say "     ([link]N[as]n[end link]) - Offer an 'alternate way' for him to enjoy himself?";
		if player consents:
			LineBreak;
			say "     With a little bit of a sigh, you do the best duty a submissive partner can give - consoling him that it's likely just a one-time thing. Mul doesn't really take it all too well, no matter what. With a low grumble in his throat, the orc leaves you behind in the garage and vanishes around the next corner. After giving him some lead-time, you eventually pack up your gear too and get back to the orc lair.";
		else:
			say "     Doing the best duty a submissive partner can give, you console the orc that this could be just a one-time thing, and that maybe, it might be 'curable' through special stimulation techniques. Unobtrusively, you mention that he did enjoy having his prostate played with in the past... the argument makes your big, muscled orc pause for a second, then he gives a huff through his nose and glances towards the garage door. There is not a living thing in sight. Coming to a decision, he then leans forward resting his upper body against the car hood, presenting a firmly muscled butt to you. 'Get licking slave-boy,' your orc master commands in a low voice, holding his buttcheeks apart with two strong hands. Eagerly kneeling down and pressing your nose against the somewhat hairy skin of his crack, you then take a deep sniff of his clean, masculine smell and start lapping away at his hole. Mul's pucker is pretty relaxed and accommodating, easily allowing you to push your tongue into his body - yeah, this has become a well-trained fuckhole, even if he still tries to deny it. Amid low moans, the green-skinned brute gives a silent grunt of 'Yeah, just like that - and use your fingers too.' You immediately get to work probing and stroking his insides with two, then three fingers, much to the orc's arousal. It is no great wonder that as soon as you put some attention to his back door, the orc's cock sprang to full-on erection and hardness. By now the piece of green-skinned man-meat is throbbing very noticeably, leaking a steady stream of pre onto the floor.";
			WaitLineBreak;
			if cocks of player is 0 or a random chance of 1 in 2 succeeds: [comes from having eaten his ass]
				say "     When you reach your other arm through between his legs and start massaging his full, green balls at the same time, it's only a question of time till you push him to the point of no return. Only a short while later, Mul's moans and grunts quickly get pretty loud, culminating in almost a roar as thick spurts of cum blast from his cock to splat all over the front grill of the car he's leaning over.";
				say "     After waiting a while for his orgasm to subside and to catch his breath, Mul turns around and pulls you to your feet, then bends you over the car hood in his place. He gropes your butt, then holds your cheeks apart with his fingers as he brings his still pretty hard cock up and rubs it against you, leaving your hole wet with the cum still clinging to its tip and everything more that he can milk out of his manhood. Giving your ass a light slap after that bit of deception is done, he pins you down with a stare and growls 'Not a word about this - I fucked you, if anyone asks.' With that said, the orc gives you a victorious leer - as if he had actually fucked you, then strides out of the garage, leaving you to pick yourself up after the fight and sex. After giving him some lead-time, you eventually pack up your gear too and get back to the orc lair.";
			else: [rides the player's cock]
				say "     Suddenly, Mul pushes off from leaning on the car hood and reaches out to hook a hand under your shoulder, dragging you to your feet. With the lusty grunt of, 'I wanna fuck!', he snatches up an old blanket on which several of the scattered tools lay, throwing it on the ground and pushing you down on it. Before you really know what's going on, the orc is already getting on the ground himself. He comes to kneel above you, straddling your hips, and catches your wrists to hold them down above your head with one hand, while the other one gropes your crotch. Taking hold of your erection, the green-skinned brute holds it up and lowers his hips to meet it. Soon, you can feel the tip of your [cock of player] shaft push against his pucker, then sink inside, enveloped by a warm and tight passage. 'Yeah!' Mul grunts loudly as his cheeks touch your crotch and all of your erection is inside him, then he starts to rock back and forth, fucking himself on your pole.";
				say "     Given how wound-up he already is from all the oral attention he got from you, it doesn't take all too long until riding your cock brings Mul's arousal to the boiling point. After a quick build-up of the volume and urgency in his grunts and moans, the green brute bends his body back to take all of you inside him and gives a roar that heralds a veritable explosion of cum from his massive dick. Spurt after spurt of thick, creamy orc cum pulse from the slit of his manhood to splash down on your chest, face and the blanket. Eager to join your master in orgasm, your pump your hips up against him and enjoy the twitching of his anal muscles around your thrusting shaft, while at the same time wiping up all the cum you can get with your hand so suck it hungrily from your fingers. In no time at all, you reach the point of no return and joyfully pass it, writhing on the stained blanket as your whole body shakes from a mind-blowing climax and your seed gets blasted into the orc's gut.";
				WaitLineBreak;
				say "     After waiting a while for his orgasm to subside and to catch his breath, Mul lifts himself from the impalement on your softening erection and stands up. Grabbing your leg with one big hand, he lifts it, then brings his still pretty hard cock forward and rubs it against you, leaving your hole wet with the cum still clinging to its tip and everything more that he can milk out of his manhood. Giving your ass a light slap after that bit of deception is done, he pins you down with a stare and growls 'A good slave has to know to keep his master's secrets too. Not a word about this - I fucked you, if anyone asks.' With that said, the orc snatches up a piece of your clothing and uses it to dab away the bit of your cum that leaked out of him. Then he strides out of the garage, leaving you to pick yourself up after the fight and sex. After giving him some lead-time, you eventually pack up your gear too and get back to the orc lair.";
	else: [non-sub players]
		say "     Pulling the ragged fabric of his loincloth aside, Mul shows you his thick and meaty cock, then puts a hand on your shoulder and pushes down, making you kneel. He softly whacks his thick green shaft against your forehead and grabs your hair tightly, pulling your head against his balls. Following the barked order of 'Lick them!', you reluctantly give his hairy globes a lick or two, then wince as he gives your hair a jerk and growls 'Faster'. As angering him wouldn't be a good idea, you swallow your pride and start lapping away at his nuts in earnest - which earns you a satisfied grunt from your orc 'owner'. He even loosens his grip on your hair a bit, then gives you a patronizing smile and says 'That's better. You'll learn in time, little slave. Now why don't you hold them with your hands and...'";
		WaitLineBreak;
		say "     Mul spends a while instructing you in all his favorite ways of getting his balls played with, from letting you lick their underside, to gently massaging and even lightly squeezing them. As it seems best to keep him in a good mood, you do your best in taking care of his weighty globes. Then an idea springs up in your mind - if you get him to shoot his load now, that might just save you getting fucked by the massive schlong just inches from your face. Deciding to try it, you really get into pleasuring Mul and eventually stimulate him so much that he has to push you away to avoid coming. Looking up at the orc warrior, you see his whole body go tense and hear him give a breathless gasp, then pant as he stops just short of blowing his load. Damn, that didn't work out - but it was worth a try. Your thoughts are interrupted when you spot a single big drop of greenish-white orc cum runs out of the tip of Mul's thick shaft, then down its underside. Something about it just binds your attention completely, and with each breath you take in, the pleasant and heady smell of orc cum gets to you more. Seconds later, you give in to the desire that wakes inside you and find yourself leaning forward, eagerly licking up the drop of cum from his shaft. The taste of Mul's cum spreads over your tongue, delicious like ambrosia and leaves you pretty randy and you hungry for more. Chuckling at your behavior, Mul says Phew, almost made me blow my load with your talented tongue. Nicely done, pet, but that'd be too fast... I still wanna fuck your ass.'";
		say "     He waits a moment more to allow himself to relax, then presents you with his hard shaft. 'Blow me - and use lots of spit. You're gonna need it when I stick it in you!' he grumbles, a lusty grin on his face. Not having much choice else if you don't want him to rip up your ass something terrible later, you start going down on him, switching up between sucking on the tip of his manhood and licking its shaft. The trickle of precum that soon starts oozing out of his cockhead is amazingly tasty, giving you kind of a rush that makes being forced to do this not seem so bad. The orc lets you continue for a bit, then grunts and pulls you off his cock, ordering 'Bend over the hood!' Being roughly pulled up by your arm, you're given a push towards the car in the garage. Stumbling over to it, you catch yourself with both hands, coming to stand against it with your ass stuck out for Mul. A moment later, the powerful orc warrior moves to stand right behind you and reaches down to spread your cheeks. Trembling at the thought of taking his thick meat, you do your best to relax your sphincter to be ready.";
		WaitLineBreak;
		say "     Yet as Mul steps up behind you and takes his cock in hand, slapping it against your waiting rear, it feels... less hard than you would have expected. Lining the tip of his member up with your opening, the big brute gives a hard thrust, penetrating deeply and forcing a pained gasp from yourself. As he starts fucking into you after that, you're hit with the realization that despite his rapid pace and the force with which he forces his manhood in, Mul is actually softening more and more. You can't help but feel that there's... something missing for him to enjoy himself. Like a hard cock in his ass, as you've trained him to enjoy. Soon, the orc's wilted cock actually pops out of your ass on its own, too soft to stay inside. This draws a frustrated grunt from the green-skinned brute and he snarls loudly, punching the car hard enough to leave a dent. 'Must have had something bad to eat, I - I don't feel like fucking you right now,' comes a loud grumble, full of anger and denial. Reaching for his loincloth, the orc adds, 'Your lucky day, fucker. Guess your hole won't be stretched out today by my thick prick.'";
		LineBreak;
		say "     Are you relieved to have gotten around being fucked - mostly, at least - ([link]Y[as]y[end link]), or will you offer an 'alternate way' for him to enjoy himself - and have some fun of your own with the big orc ([link]N[as]n[end link])?";
		if player consents:
			LineBreak;
			say "     Giving a relieved sigh, you earn a grumble from the big orc, which only gets louder as you can't help but comment about having a big mouth, then not being able to go through with things. Oh, that really hit the mark. Mul balls up his fists and seems ready to just give you a hard thrashing, but then forces himself to relax again. 'Not worth my time,' he mumbles, then stomps off, leaving you behind in the garage. After giving him some lead-time, you eventually pack up your gear too and get back to the orc lair.";
		else:
			say "     Doing your best to sound at least somewhat consoling and reasonable, you tell the orc that this could be just a one-time thing, and that maybe, it might be 'curable' through special stimulation techniques. After all, he did enjoy having his prostate played with in the past... the argument makes your big, muscled orc pause for a second, then he gives a huff through his nose and glances towards the garage door. There is not a living thing in sight. Coming to a decision, he then leans forward resting his upper body against the car hood, presenting a firmly muscled butt to you. 'Get licking slave,' your orc 'owner' commands in a low voice, holding his buttcheeks apart with two strong hands. A grin spreads on your face at having your plan of 'butt-slut-training' Mul work out for yet another encounter with the orc and you start lapping away at his hole, slowly running your tongue up his crack and teasing his pucker. Thankfully, there is nothing but a clean, masculine smell to him, making this experience a relatively pleasurable one. Mul's pucker is pretty relaxed and accommodating, easily allowing you to push your tongue into his body - yeah, this has become a well-trained fuckhole, even if he still tries to deny it. Amid low moans, the green-skinned brute gives a silent grunt of 'Yeah, just like that - and use your fingers too.' You immediately get to work probing and stroking his insides with two, then three fingers, much to the orc's arousal. It is no great wonder that as soon as you put some attention to his back door, the orc's cock sprang to full-on erection and hardness. By now the piece of green-skinned man-meat is throbbing very noticeably, leaking a steady stream of pre onto the floor.";
			WaitLineBreak;
			if a random chance of 1 in 2 succeeds: [comes from having eaten his ass]
				say "     When you reach your other arm through between his legs and start massaging his full, green balls at the same time, it's only a question of time till you push him to the point of no return. Only a short while later, Mul's moans and grunts quickly get pretty loud, culminating in almost a roar as thick spurts of cum blast from his cock to splat all over the front grill of the car he's leaning over.";
				say "     After waiting a while for his orgasm to subside and to catch his breath, Mul turns around and pulls you to your feet, then bends you over the car hood in his place. He gropes your butt, then holds your cheeks apart with his fingers as he brings his still pretty hard cock up and rubs it against you, leaving your hole wet with the cum still clinging to its tip and everything more that he can milk out of his manhood. Giving your ass a light slap after that bit of deception is done, he pins you down with a stare and growls 'Not a word about this - I fucked you, if anyone asks.' With that said, the orc gives you a victorious leer - as if he had actually fucked you, then strides out of the garage, leaving you to pick yourself up after the fight and sex. After giving him some lead-time, you eventually pack up your gear too and get back to the orc lair.";
			else: [rides the player's cock]
				say "     Suddenly, Mul pushes off from leaning on the car hood and reaches out to hook a hand under your shoulder, dragging you to your feet. With the lusty grunt of, 'I wanna fuck!', he snatches up an old blanket on which several of the scattered tools lay, throwing it on the ground and pushing you down on it. Before you really know what's going on, the orc is already getting on the ground himself. He comes to kneel above you, straddling your hips, and catches your wrists to hold them down above your head with one hand, while the other one gropes your crotch. Taking hold of your erection, the green-skinned brute holds it up and lowers his hips to meet it. Soon, you can feel the tip of your [cock of player] shaft push against his pucker, then sink inside, enveloped by a warm and tight passage. 'Yeah!' Mul grunts loudly as his cheeks touch your crotch and all of your erection is inside him, then he starts to rock back and forth, fucking himself on your pole.";
				say "     Given how wound-up he already is from all the oral attention he got from you, it doesn't take all too long until riding your cock brings Mul's arousal to the boiling point. After a quick build-up of the volume and urgency in his grunts and moans, the green brute bends his body back to take all of you inside him and gives a roar that heralds a veritable explosion of cum from his massive dick. Spurt after spurt of thick, creamy orc cum pulse from the slit of his manhood to splash down on your chest, face and the blanket. Eager to get off yourself, your pump your hips up against him and enjoy the twitching of his anal muscles around your thrusting shaft. In no time at all, you reach the point of no return and joyfully pass it, writhing on the sofa as your whole body shakes from a mind-blowing climax and your seed gets blasted into the orc's gut.";
				WaitLineBreak;
				say "     After waiting a while for his orgasm to subside and to catch his breath, Mul lifts himself from the impalement on your softening erection and stands up. Grabbing your leg with one big hand, he lifts it, then brings his still pretty hard cock forward and rubs it against you, leaving your hole wet with the cum still clinging to its tip and everything more that he can milk out of his manhood. Giving your ass a light slap after that bit of deception is done, he pins you down with a stare and growls 'A good slave has to know to keep his master's secrets too. Not a word about this - I fucked you, if anyone asks.' With that said, the orc snatches up a piece of your clothing and uses it to dab away the bit of your cum that leaked out of him. Then he strides out of the garage, leaving you to pick yourself up after the fight and sex. After giving him some lead-time, you eventually pack up your gear too and get back to the orc lair.";
	if MulAnalAcceptance < 10:
		increase MulAnalAcceptance by 1;

to say ObservationRoomFuckMulAnal:
	say "     Looks like just sitting around in here and waiting really does pay off - as the door to the interrogation room suddenly opens and two persons enter. The first of them reaches out and flips a switch on what you now recognize as a portable and battery-powered spotlight standing against a wall, bathing the room in light, which allows you to recognize your orc 'play-mate' Mul and a smaller, less brutish orc - a breeder slave. The mighty orc warrior throws the door shut and walks over to a couch, undoing his loincloth and then letting himself fall into it. He sits there with spread legs and grins as the other orc kneels before him and starts to worship his manhood, gently handling his thick cock and the weighty globes of his balls. Mul leans his head back, grunting and moaning loudly as his obedient slave goes down on him.";
	say "     Letting your eyes wander through the room, you find it comfortably equipped with two leather couches along the walls, as well as another of the sturdy fuck-benches you already know from the cells - though this one sports some leather restraints at strategic places. Strewn about the room are quite a few sex toys in various shapes and sizes, and a corner holds a whole pile of lube bottles. The orcs certainly stocked their lair well - they must have ransacked more than one porn store to get all this.";
	LineBreak;
	say "     Do you want to watch what happens next in the interrogation room?";
	if player consents:
		LineBreak;
		say "     You watch the breeder slave worship Mul's cock, lapping at it and suckling on the thick head while massaging Mul's weighty balls. Even though a bit smaller in comparison to the brutish orc warrior, the green-skinned man kneeling between Mul's legs is quite a sight to behold himself - with an enviable stature and trained muscles to compliment his dashing good looks and flowing black hair. Even the 'pretty-boy' orcs are fit enough to make a good showing with the best of regular humans in a fitness studio. And his ass is simply a top's dream - presented in all its rounded, grope-able glory as he kneels, with the emerald green ring of his pucker winking in anticipation of taking a thick orc cock. A small trickle of white from the inviting hole shows that he's been fucked today already - and maybe a few times, at that.";
		say "     Mul gets serviced expertly by his green-skinned slut, but even so you notice that he's not fully hard yet - his thick prick falling short of the raging pillar you've had in your hands before. Could it be that he's... Your thoughts are interrupted by the big orc grunting, 'Orbul! Go - go lock the door.' As the breeder raises his head from nuzzling against Mul's balls to look at him curiously, Mul reaches to his loincloth and fumbles with a knotted strap holding the key before impatiently just snapping the leather band and thrusting it into Orbul's hand. Nothing if not obedient, the smaller orc immediately goes to the entrance and locks it with a definite click, then returns to his master and gets back to kneeling on the floor, looking up at him expectantly, waiting for his next command.";
		WaitLineBreak;
		say "     'Lick me,' Mul says in an uncharacteristically quiet tone, grunting in annoyance as Orbul starts to reach out for his cock. 'Not there,' the bigger orc adds, then lifts his legs and scrunches down a bit on the sofa, putting his firm butt right at the edge. There is a second of hesitation from the breeder as he ponders the unusual request, then Orbul just goes for it, burying his face between Mul's cheeks and pressing his tongue into the other orc's hole. Lusty grunts start to fill the interrogation room as you watch the result of your 'training' sessions with Mul - him now feeling the desire - the need - to have something inside. Before long, Orbul's oral service escalates to him pressing in several fingers against the orc warrior's readily stretching hole, wiggling them around inside and finding Mul's prostate after a few moments, judging from the way the orc bucks against his hand and groans. The precum previously just oozing out of his dickhead comes out in a little spurt as his magic button is pressed, leaving a glistening streak across Mul's chest, showing just how much he's gotten into anal now.";
		say "     Being addicted to his master's orc cum, like orc breeders usually are, Orbul can't help himself and rises into a half-crouch to lean over the bigger orc. Bent forward, he hungrily laps up Mul's pre before catching the warrior's shaft between his lips, suckling the big cockhead while still fondling his master's ass. Mul just leaning back, lost in enjoying the service with his large hands tightly gripping the edge of the sofa, Orbul is free to experiment a bit - finding out just how to milk the most tasty precum from his master and really wind him up. You watch in excitement as he fondles, strokes and finger-fucks Mul, thinking back to your own session of fun with the big orc.";
		WaitLineBreak;
		say "     Your trip along memory lane is cut short as Orbul sucks one of Mul's balls into his mouth while rubbing against his prostate at the same time - creating another of those precum-spurts that arches up higher this time, creating a white dash on the orc warrior's left pec. Eager to slurp up the tasty treat, Orbul immediately stretches forward, bracing himself on Mul's abs and running his tongue over the firm flesh of his muscled chest. Then, just as he gets to the bigger orc's cum-streaked nipple, Orbul's own cock nudges against Mul's back door. Fearfully, Orbul looks up and meets his master's eye - but after a second or two, Mul just runs his hand through the breeder's hair and pulls tight against his chest with a lusty grunt. Lips pressed to the bigger orc's nipple, sucking on it and giving a teasing nibble, Orbul thrusts his hips forward, sinking his manhood into Mul.";
		if a random chance of 1 in 2 succeeds:
			say "     You watch the two men in the other room start fucking in their unconventional pairing, getting more and more aroused yourself - until suddenly, a large hand pushes against your back, pinning you against the window, face pressed against the cool glass. As you struggle and try to turn around, your arms are quickly caught and twisted behind your back. From the corner of your eye, you see that it's a pretty big and muscled orc who holds your wrists tightly. He must have entered the observation room while you were busy watching Mul and his breeder. 'I knew I heard something from in here,' a deep voice says into your ear, then gives a snort of amusement as the green-skinned warrior looks past you. 'Hah - I knew Orbul was Mul's favorite, but... look at that. The supposedly proud orc giving it up to a slave. Who'd have thought that the moans and whimpers coming out of there were his!'";
			WaitLineBreak;
			say "     With that the orc grabs your head and makes you look at the two orcs in the other room again, where Orbul's full balls are rapidly whacking against another male's buttocks - an everyday occurrence in this orc lair... if it was the other way around. But no, this time one of the powerful orc brutes is taking it up the rear, moaning like a needy bitch. A sense of pride fills you as you watch Mul being fucked - and fucked hard, as the orc breeder finds his pace. You broke the mighty orc in to taking a cock up his ass, and now he's even letting his slave do him. Your captor grunts 'They do give a nice show, definitively... maybe I should introduce that big pansy to my shaft too. Wrestle Mul to the ground and pound him in the great hall like the breeder he is! He'll be my bitch and I'll be able to rake in lots of loot from the others, making them pay to fuck the biggest, baddest... bottom slut of an orc!'";
			say "     Hearing the big brute make plans for exploiting Mul - YOUR Mul, after all the work it was to break him in properly - makes something inside of you rebel and push you to actions that surprise your captor in their intensity. In a sudden burst of energy, you struggle against him holding you, twisting your body to ram an elbow into his abs and kicking backwards with one leg. Sadly, you don't quite manage the disabling strike on his balls that was your best hope for winning an out, instead just bruising his upper thigh. And so, the orc manages to wrestle full control back from you, giving a swat against the side of your head that makes you see stars for a moment. 'That really pushed your buttons, eh? Guess now I know who had the honor of fucking Mul's virgin ass. That must have been good fun! Ooh, just imagine him being gang-banged now, orc after orc breeding him into a sloppy mess!'";
			WaitLineBreak;
			say "     As you tense your muscles and wrestle against his hold in reply, the orc grips you even tighter, then scoffs, 'Fine. No need to go berserk - I'll hold off on caching in on Mul. For now, it'll be enough fun to know what's going on behind the scenes. Catch the fucker in the act like right now... as well as a certain someone peeping on our muscled butt-slut.' The way he licks the side of your neck, lightly scraping your skin with a tusk, leaves no doubt whom he means. 'So you just keep doing what you do. It'll make it a sweet treat to catch you in here.' Well, with the secret of Mul's re-oriented preferences being out, it looks like this is the best you gonna get. Silently nodding your head, the urge to defend your claim on the orc is satisfied and you relax a little as the manic energy leaves your muscles.";
			if player is submissive: [sub players]
				say "     A moment later, you start feeling something big press against your butt - the orc's cock, getting hard as he watches the action in the interrogation room. Lowering his hand from your head to squeeze your butt, the orc says 'Let's have some fun too then - you do want me to fuck you, don't you?' As this plays perfectly into your desires to be dominated and used by such a strong, virile male, you loudly moan yes and rub your ass against his erection. 'Such an eager little slut,' the orc chuckles, then lets go of your arms to allow you to push your pants down. Leaning forward, your shoulder against the one-way mirror, you reach back and spread your cheeks, waiting for the orc warrior to take you. ";
				WaitLineBreak;
				say "     You feel the big head of his meaty shaft push against your back door for a moment as your captor smears some of his copious pre-cum on you. Then he uses a finger to rub around your hole before pushing it in slowly, probing your insides with his thick digit. Panting against the window in lust as you're being fingered, you give yourself over to him fully, relaxing your muscles as he soon adds another finger to stretch your passage. Your orc master's touch really gets you going, and by the time he grunts 'Ready to take my cock now?', your [if cocks of player > 0]own erection is hard as rock[else if cunts of player > 0]swollen pussy lips are wet and dripping[else]knees are pretty weak from arousal and anticipation[end if] and you immediately yelp for him to fuck you. Chuckling at such eagerness, the mighty orc warrior lines up his tip with your hole. Then he grips your hips with two large hands and presses forward, giving a satisfied grunt as he pushes through your back door, stretching it tight around his invading member.";
				say "     It's big - pretty big and thick and meaty, making you gasp from the initial penetration. But as the orc's shaft sinks deeper into your body, pleasant feelings prevail as its sides rub against your inner walls, touching sensitive spots deep inside you. Even though you relaxed as much as you could, it's still quite a lot to take - which the orc seems to know very well, moving deeper only slowly and with surprising patience, sometimes even stopping for a moment so you can get used to it. As he does so, you feel something warm and wet leak into you from the tip of his cock, accompanied by a soothing feeling of well-being. That must be his precum - feels a bit strange, but good, and it certainly helps taking his thick meat. Some time later, he finally bottoms out inside you, hard shaft buried all the way and his two large cum-factories resting against your skin.";
				WaitLineBreak;
				say "     As your master gives you a moment to get used to the stretching feeling of having a whole foot of hard cock inside your ass, you focus again on what's going on in the other room. Looks like Orbul's lust is in roaring flames with a man's warm and tight chute wrapped around his shaft. He's really letting out some of his wilder impulses - suckling hard on one then the other of Mul's nipples, forceful enough to leave hickeys, and even giving the big guy some light nips with his tusks. Good for Mul that he heals almost instantly, otherwise it'd be patently clear that he wasn't the dominant partner in his latest fuck. Any further observations are pushed right out of your mind as your own orc fucker pulls back and thrusts inside again - hard and deep, creating a slapping noise as his hips hit your ass. No wonder he went so slow before, or that'd have ripped you in two! And he just keeps on going like that, now taking out all the stops and really pounding into you like the big brute he is. The sensations of his thrusts make you moan and howl in lust, conscious thought obliterated completely by the feelings of having that thick shaft deep inside you.";
				say "     Everything after that is just a haze of arousal and need, and you can't even remember how long it took for his wild fucking to drive you over the edge, [if cocks of player > 0]spraying your own cum all over the wall under the observation window[else if cunts of player > 0]squirting femcum all over the wall under the observation window[else]trembling and panting against the observation window as you orgasm[end if]. Having your hole tremble and twitch around his orcish member while you come gives your captor the last little push he needed to reach his own climax, and with a loud and very satisfied grunt, the orc starts blasting a massive load of cum into your innermost depths. He keeps fucking you as he comes, clearly reveling in the feeling of his seed squishing around his thrusting shaft inside your body. With the amount of cum he pumps into you, quite a bit squirts out around his cock as he does so, to run down the inside of your legs and drip onto the ground.[mimpregchance]";
				WaitLineBreak;
				say "     When you come down from the rush of orgasm, though still buzzed with the pleasant feeling of orc cum in your ass, you see that Mul and Orbul finished too at some point. Still leaning back on the couch, his hips slid right to the edge and both legs wrapped around Orbul's hips, Mul is a sight to behold - cum-splatters all over his chest and abs, with some of the creamy load even sticking to his chin and cheek. But not for long, as Orbul licks his master's face clean, then is pulled into a hungry kiss, sharing the tasty cum as their tongues wrestle with each other. After some more eager making out, Orbul starts to lap Mul clean, removing the evidence of their unconventional coupling. He's back between Mul's legs, sucking his own seed from the orc's creamy hole, when Mul eventually finds his voice again, grunting, 'Not a word about this to anyone.' Raising his head, the orc breeder replies, 'Of course, master.' And with that, he goes back to eating out the orc warrior, wiggling his tongue to make Mul groan and shiver in arousal.";
				say "     Your captor's deep voice says from behind you, 'Now that's a real breeder in there. Orbul, I mean. Excellently trained and a prime hole to fill - good to see that he's got spunk too. I've tried trading some other guys for him, though the brothers just won't deal.' With a sigh, the orc pulls out of you, then pushes a finger in your slippery hole and makes you gasp by rubbing [if cocks of player > 0]against your prostate[else]your inner walls[end if] 'Be back soon, little peeper. Catching you is fun!' With that, the orc gives you a playfully light swat on the butt, then walks out of the room.";
			else:
				say "     A moment later, you start feeling something big press against your butt - the orc's cock, getting hard as he watches the action in the interrogation room. Lowering his hand from your head to squeeze your butt, the orc says 'Let's have some fun too then - you do want me to fuck you, don't you?' As you refuse and try to pull yourself out of his iron grip on your wrists, the orc twists your arms a bit further, making you whimper in pain. 'Liar. Why else would you be hanging around here to play Peeping Tom. No matter - I'll give you what you need.' The orc grips you by the neck with his other hand for a moment, squeezing a bit to show his power, then growls 'And you'll obey like a good little breeder should if you don't want me to kick your ass. Now put your hands on the glass and bend over.' As the orc lets go a moment later, you rub your bruised wrists, then take position against the one-way mirror. Not much choice otherwise, as you're right in his grasp and this room isn't big enough to fight him properly.";
				WaitLineBreak;
				say "     You feel the big head of his meaty shaft push against your back door for a moment as your captor smears some of his copious pre-cum on you. Then he uses a finger to rub around your hole before pushing it in slowly, probing your insides with his thick digit. You wince a bit at the unwanted intrusion, though you can't help but start feeling a pleasant tingle too a moment later. That might have something to do with getting his precum in you. Before long, you're panting against the window in lust as you're being fingered, doing your best to relax your muscles when he adds another finger to stretch your passage. Your orc captor's touch really gets you going, and by the time he grunts 'Ready to take my cock now?', your [if cocks of player > 0]own erection is hard as rock [else if cunts of player > 0]swollen pussy lips are wet and dripping [else]knees are pretty weak from arousal [end if]and you hesitantly ask for him to fuck you. Chuckling at how quickly your reluctance faded, the mighty orc warrior lines up his tip with your hole. Then he grips your hips with two large hands and presses forward, giving a satisfied grunt as he pushes through your back door, stretching it tight around his invading member.";
				say "     It's big - pretty big and thick and meaty, making you gasp from the initial penetration. But as the orc's shaft sinks deeper into your body, pleasant feelings prevail as its sides rub against your inner walls, touching sensitive spots deep inside you. Even though you relaxed as much as you could, it's still quite a lot to take - which the orc seems to know very well, moving deeper only slowly and with surprising patience, sometimes even stopping for a moment so you can get used to it. As he does so, you feel something warm and wet leak into you from the tip of his cock, accompanied by a soothing feeling of well-being. That must be more of his precum - feels a bit strange, but good, and it certainly helps taking his thick meat. Some time later, he finally bottoms out inside you, hard shaft buried all the way and his two large cum-factories resting against your skin.";
				WaitLineBreak;
				say "     As your captor gives you a moment to get used to the stretching feeling of having a whole foot of hard cock inside your ass, you focus again on what's going on in the other room. Looks like Orbul's lust is in roaring flames with a man's warm and tight chute wrapped around his shaft. He's really letting out some of his wilder impulses - suckling hard on one then the other of Mul's nipples, forceful enough to leave hickeys, and even giving the big guy some light nips with his tusks. Good for Mul that he heals almost instantly, otherwise it'd be patently clear that he wasn't the dominant partner in his latest fuck. Any further observations are pushed right out of your mind as your own orc fucker pulls back and thrusts inside again - hard and deep, creating a slapping noise as his hips hit your ass. No wonder he went so slow before, or that'd have ripped you in two! And he just keeps on going like that, now taking out all the stops and really pounding into you like the big brute he is. The sensations of his thrusts make you moan and howl in lust, conscious thought obliterated completely by the feelings of having that thick shaft deep inside you.";
				say "     Everything after that is just a haze of arousal and need, and you can't even remember how long it took for his wild fucking to drive you over the edge, [if cocks of player > 0]spraying your own cum all over the wall under the observation window[else if cunts of player > 0]squirting femcum all over the wall under the observation window[else]trembling and panting against the observation window as you orgasm[end if]. Having your hole tremble and twitch around his orcish member while you come gives your captor the last little push he needed to reach his own climax, and with a loud and very satisfied grunt, the orc starts blasting a massive load of cum into your innermost depths. He keeps fucking you as he comes, clearly reveling in the feeling of his seed squishing around his thrusting shaft inside your body. With the amount of cum he pumps into you, quite a bit squirts out around his cock as he does so, to run down the inside of your legs and drip onto the ground.[mimpregchance]";
				WaitLineBreak;
				say "     When you come down from the rush of orgasm, though still buzzed with the pleasant feeling of orc cum in your ass, you see that Mul and Orbul finished too at some point. Still leaning back on the couch, his hips slid right to the edge and both legs wrapped around Orbul's hips, Mul is a sight to behold - cum-splatters all over his chest and abs, with some of the creamy load even sticking to his chin and cheek. But not for long, as Orbul licks his master's face clean, then is pulled into a hungry kiss, sharing the tasty cum as their tongues wrestle with each other. After some more eager making out, Orbul starts to lap Mul clean, removing the evidence of their unconventional coupling. He's back between Mul's legs, sucking his own seed from the orc's creamy hole, when Mul eventually finds his voice again, grunting, 'Not a word about this to anyone.' Raising his head, the orc breeder replies, 'Of course, master.' And with that, he goes back to eating out the orc warrior, wiggling his tongue to make Mul groan and shiver in arousal.";
				say "     Your captor's deep voice says from behind you, 'Now that's a real breeder in there. Orbul, I mean. Excellently trained and a prime hole to fill - good to see that he's got spunk too. I've tried trading some other guys for him, though the brothers just won't deal.' With a sigh, the orc pulls out of you, then pushes a finger in your slippery hole and makes you gasp by rubbing [if cocks of player > 0]against your prostate[else]your inner walls[end if] 'Be back soon, little peeper. Catching you is fun!' With that, the orc gives you a playfully light swat on the butt, then walks out of the room.";
		else:
			say "     The slap of flesh against flesh fills the interrogation room, with the green orbs hanging under an orc's shaft whacking against another male's buttocks - an everyday occurrence in this orc lair... but everything else about it isn't. This time, one of the powerful orc brutes is taking it up the rear, moaning like a needy bitch. A sense of pride fills you as you watch Mul being fucked - and fucked hard, as the orc breeder finds his pace. You broke the mighty orc in to taking a cock up his ass, and now he's even letting his slave do him. He may bluster and deny it, grumble as you guide him to another session in your little locker-room fuck-nest, but Mul's become quite a butt-slut. And Orbul - with his lust inflamed and a man's warm and tight chute wrapped around his shaft, he's letting out some of his wilder impulses - suckling hard on one then the other of Mul's nipples, forceful enough to leave hickeys, and even giving the big guy some light nips with his tusks. Good for Mul that he heals almost instantly, otherwise it'd be patently clear that he wasn't the dominant partner in his latest fuck.";
			WaitLineBreak;
			say "     The sexy show goes on for quite a while - with Orbul proving that even a 'pretty-boy' breeder has enviable endurance, but eventually Mul just can't contain himself anymore. With a loud roar, he bucks against the other orc and starts blasting away long strings of cum. *Splat* The first hits the wall behind the sofa, starting a creamy trail as his seed begins to ooze down. *Splat* The second string hit Mul in the chin, followed by another and another - all over his chest and abs. Feeling his master's hole contract and spasm around his shaft, Orbul isn't far behind, and with an urgent gasp, he grinds his hips forward hard, then fills Mul's hole with his seed, spurting deep into the bigger orc's insides.";
			say "     Collapsing forward in exhaustion as his orgasm begins to ebb some moments later, Orbul's head comes to rest on Mul's firm abs. There he rests for a while, just breathing calmly and enjoying the feeling of having his slowly softening cock in a warm and tight place. Then eventually, Orbul starts to lap Mul clean, eagerly removing the evidence of their unconventional coupling. He's back between Mul's legs, sucking his own seed from the orc's creamy hole, when Mul eventually finds his voice again, grunting, 'Not a word about this to anyone.' Raising his head, the orc breeder replies, 'Of course, master.' And with that, he goes back to eating out the orc warrior, wiggling his tongue to make Mul groan and shiver in arousal.";
	else:
		LineBreak;
		say "     Flipping the little switch for the microphones, you cut off the sound from the other room and turn your mind to other things, ignoring the one-way mirror completely.";
	if MulAnalAcceptance < 10:
		increase MulAnalAcceptance by 1;

to say ObservationRoomFuck:
	if player is submissive: [sub players]
		say "     Looks like just sitting around in here and waiting really does pay off - as the door to the interrogation room suddenly opens and two persons enter. The first of them reaches out and flips a switch on what you now recognize as a portable and battery-powered spotlight standing against a wall, bathing the room in light, which allows you to recognize your orc master Mul and a smaller, less brutish orc - a breeder slave. The mighty orc warrior throws the door shut and walks over to a couch, undoing his loincloth and then letting himself fall into it. He sits there with spread legs and grins as the other orc kneels before him and starts to worship his manhood, gently handling his thick cock and the weighty globes of his balls. Mul leans his head back, grunting and moaning loudly as his obedient slave goes down on him.";
	else:
		say "     Looks like just sitting around in here and waiting really does pay off - as the door to the interrogation room suddenly opens and two persons enter. The first of them reaches out and flips a switch on what you now recognize as a portable and battery-powered spotlight standing against a wall, bathing the room in light, which allows you to recognize your orc 'owner' Mul and a smaller, less brutish orc - a breeder slave. The mighty orc warrior throws the door shut and walks over to a couch, undoing his loincloth and then letting himself fall into it. He sits there with spread legs and grins as the other orc kneels before him and starts to worship his manhood, gently handling his thick cock and the weighty globes of his balls. Mul leans his head back, grunting and moaning loudly as his obedient slave goes down on him.";
	say "     Letting your eyes wander through the room, you find it comfortably equipped with two leather couches along the walls, as well as another of the sturdy fuck-benches you already know from the cells - though this one sports some leather restraints at strategic places. Strewn about the room are quite a few sex toys in various shapes and sizes, and a corner holds a whole pile of lube bottles. The orcs certainly stocked their lair well - they must have ransacked more than one porn store to get all this.";
	LineBreak;
	say "     Do you want to watch what happens next in the interrogation room?";
	if player consents:
		LineBreak;
		say "     You watch the two men in the other room have oral sex and listen to their moans, until suddenly - a large hand pushes against your back, pinning you against the window, face pressed against the cool glass. As you struggle and try to turn around, your arms are quickly caught and twisted behind your back. From the corner of your eye, you see that it's a pretty big and muscled orc who holds your wrists tightly. He must have entered the observation room while you were busy watching Mul and his breeder. 'I knew I heard something from in here,' a deep voice says into your ear, then continues, 'Do you enjoy watching Orbul please his master? Maybe want to be in his place?' With that the orc grabs your head and makes you look at the two orcs in the other room again, where Orbul by now has the tip of Mul's cock in his mouth and is eagerly sucking on it. Your captor grunts 'They do give a nice show, definitively...'";
		if player is submissive: [sub players]
			say "     A moment later, you start feeling something big press against your butt - the orc's cock, getting hard as he watches the action in the interrogation room. Lowering his hand from your head to squeeze your butt, the orc says 'Let's have some fun too then - you do want me to fuck you, don't you?' As this plays perfectly into your desires to be dominated and used by such a strong, virile male, you loudly moan yes and rub your ass against his erection. 'Such an eager little slut,' the orc chuckles, then lets go of your arms to allow you to push your pants down. Leaning forward, your shoulder against the one-way mirror, you reach back and spread your cheeks, waiting for the orc warrior to take you. ";
			WaitLineBreak;
			say "     You feel the big head of his meaty shaft push against your back door for a moment as your captor smears some of his copious pre-cum on you. Then he uses a finger to rub around your hole before pushing it in slowly, probing your insides with his thick digit. Panting against the window in lust as you're being fingered, you give yourself over to him fully, relaxing your muscles as he soon adds another finger to stretch your passage. Your orc master's touch really gets you going, and by the time he grunts 'Ready to take my cock now?', your [if cocks of player > 0]own erection is hard as rock[else if cunts of player > 0]swollen pussy lips are wet and dripping[else]knees are pretty weak from arousal and anticipation[end if] and you immediately yelp for him to fuck you. Chuckling at such eagerness, the mighty orc warrior lines up his tip with your hole. Then he grips your hips with two large hands and presses forward, giving a satisfied grunt as he pushes through your back door, stretching it tight around his invading member.";
			say "     It's big - pretty big and thick and meaty, making you gasp from the initial penetration. But as the orc's shaft sinks deeper into your body, pleasant feelings prevail as its sides rub against your inner walls, touching sensitive spots deep inside you. Even though you relaxed as much as you could, it's still quite a lot to take - which the orc seems to know very well, moving deeper only slowly and with surprising patience, sometimes even stopping for a moment so you can get used to it. As he does so, you feel something warm and wet leak into you from the tip of his cock, accompanied by a soothing feeling of well-being. That must be his precum - feels a bit strange, but good, and it certainly helps taking his thick meat. Some time later, he finally bottoms out inside you, hard shaft buried all the way and his two large cum-factories resting against your skin.";
			WaitLineBreak;
			say "     As your master gives you a moment to get used to the stretching feeling of having a whole foot of hard cock inside your ass, you focus again on what's going on in the other room. Looks like Mul is already well into fucking Orbul's well-used hole, with the breeder on his lap and sliding up and down on Mul's thick pole. Any further observations are pushed right out of your mind as your own orc fucker pulls back and thrusts inside again - hard and deep, creating a slapping noise as his hips hit your ass. No wonder he went so slow before, or that'd have ripped you in two! And he just keeps on going like that, now taking out all the stops and really pounding into you like the big brute he is. The sensations of his thrusts make you moan and howl in lust, conscious thought obliterated completely by the feelings of having that thick shaft deep inside you.";
			say "     Everything after that is just a haze of arousal and need, and you can't even remember how long it took for his wild fucking to drive you over the edge, [if cocks of player > 0]spraying your own cum all over the wall under the observation window[else if cunts of player > 0]squirting femcum all over the wall under the observation window[else]trembling and panting against the observation window as you orgasm[end if]. Having your hole tremble and twitch around his orcish member while you come gives your captor the last little push he needed to reach his own climax, and with a loud and very satisfied grunt, the orc starts blasting a massive load of cum into your innermost depths. He keeps fucking you as he comes, clearly reveling in the feeling of his seed squishing around his thrusting shaft inside your body. With the amount of cum he pumps into you, quite a bit squirts out around his cock as he does so, to run down the inside of your legs and drip onto the ground.[mimpregchance]";
			WaitLineBreak;
			say "     When you come down from the rush of orgasm, though still buzzed with the pleasant feeling of orc cum in your ass, you see that Mul and Orbul finished too at some point. Leaned back on the couch, the orc warrior how just holds his freshly filled breeder, an arm around his chest as he softly strokes his back. Orbul is resting his head against Mul's broad chest peacefully and his ass is still impaled on his master's cock. Your captor's deep voice says from behind you 'Now that's a real breeder in there. I've tried trading some other guys for him, though the brothers just won't deal.' With a sigh, the orc pulls out of you, then pushes a finger in your slippery hole and makes you gasp by rubbing [if cocks of player > 0]against your prostate[else]your inner walls[end if] 'You know what - I'm just gonna leave you to sneak around in here. Catching you was fun, and I want to do it again sometime... so come back soon, little peeper.' With that, the orc gives you a playfully light swat on the butt, then walks out of the room.";
		else:
			say "     A moment later, you start feeling something big press against your butt - the orc's cock, getting hard as he watches the action in the interrogation room. Lowering his hand from your head to squeeze your butt, the orc says 'Let's have some fun too then - you do want me to fuck you, don't you?' As you refuse and try to pull yourself out of his iron grip on your wrists, the orc twists your arms a bit further, making you whimper in pain. 'Liar. Why else would you be hanging around here to play Peeping Tom. No matter - I'll give you what you need.' The orc grips you by the neck with his other hand for a moment, squeezing a bit to show his power, then growls 'And you'll obey like a good little breeder should if you don't want me to kick your ass. Now put your hands on the glass and bend over.' As the orc lets go a moment later, you rub your bruised wrists, then take position against the one-way mirror. Not much choice otherwise, as you're right in his grasp and this room isn't big enough to fight him properly.";
			WaitLineBreak;
			say "     You feel the big head of his meaty shaft push against your back door for a moment as your captor smears some of his copious pre-cum on you. Then he uses a finger to rub around your hole before pushing it in slowly, probing your insides with his thick digit. You wince a bit at the unwanted intrusion, though you can't help but start feeling a pleasant tingle too a moment later. That might have something to do with getting his precum in you. Before long, you're panting against the window in lust as you're being fingered, doing your best to relax your muscles when he adds another finger to stretch your passage. Your orc captor's touch really gets you going, and by the time he grunts 'Ready to take my cock now?', your [if cocks of player > 0]own erection is hard as rock [else if cunts of player > 0]swollen pussy lips are wet and dripping [else]knees are pretty weak from arousal [end if]and you hesitantly ask for him to fuck you. Chuckling at how quickly your reluctance faded, the mighty orc warrior lines up his tip with your hole. Then he grips your hips with two large hands and presses forward, giving a satisfied grunt as he pushes through your back door, stretching it tight around his invading member.";
			say "     It's big - pretty big and thick and meaty, making you gasp from the initial penetration. But as the orc's shaft sinks deeper into your body, pleasant feelings prevail as its sides rub against your inner walls, touching sensitive spots deep inside you. Even though you relaxed as much as you could, it's still quite a lot to take - which the orc seems to know very well, moving deeper only slowly and with surprising patience, sometimes even stopping for a moment so you can get used to it. As he does so, you feel something warm and wet leak into you from the tip of his cock, accompanied by a soothing feeling of well-being. That must be more of his precum - feels a bit strange, but good, and it certainly helps taking his thick meat. Some time later, he finally bottoms out inside you, hard shaft buried all the way and his two large cum-factories resting against your skin.";
			WaitLineBreak;
			say "     As your captor gives you a moment to get used to the stretching feeling of having a whole foot of hard cock inside your ass, you focus again on what's going on in the other room. Looks like Mul is already well into fucking Orbul's well-used hole, with the breeder on his lap and sliding up and down on Mul's thick pole. Any further observations are pushed right out of your mind as your own orc fucker pulls back and thrusts inside again - hard and deep, creating a slapping noise as his hips hit your ass. No wonder he went so slow before, or that'd have ripped you in two! And he just keeps on going like that, now taking out all the stops and really pounding into you like the big brute he is. The sensations of his thrusts make you moan and howl in lust, conscious thought obliterated completely by the feelings of having that thick shaft deep inside you.";
			say "     Everything after that is just a haze of arousal and need, and you can't even remember how long it took for his wild fucking to drive you over the edge, [if cocks of player > 0]spraying your own cum all over the wall under the observation window[else if cunts of player > 0]squirting femcum all over the wall under the observation window[else]trembling and panting against the observation window as you orgasm[end if]. Having your hole tremble and twitch around his orcish member while you come gives your captor the last little push he needed to reach his own climax, and with a loud and very satisfied grunt, the orc starts blasting a massive load of cum into your innermost depths. He keeps fucking you as he comes, clearly reveling in the feeling of his seed squishing around his thrusting shaft inside your body. With the amount of cum he pumps into you, quite a bit squirts out around his cock as he does so, to run down the inside of your legs and drip onto the ground.[mimpregchance]";
			WaitLineBreak;
			say "     When you come down from the rush of orgasm, though still buzzed with the pleasant feeling of orc cum in your ass, you see that Mul and Orbul finished too at some point. Leaned back on the couch, the orc warrior how just holds his freshly filled breeder, an arm around his chest as he softly strokes his back. Orbul is resting his head against Mul's broad chest peacefully and his ass is still impaled on his master's cock. Your captor's deep voice says from behind you 'Now that's a real breeder in there. I've tried trading some other guys for him, though the brothers just won't deal.' With a sigh, the orc pulls out of you, then pushes a finger in your slippery hole and makes you gasp by rubbing [if cocks of player > 0]against your prostate[else]your inner walls[end if] 'You know what - I'm just gonna leave you to sneak around in here. Catching you was fun, and I want to do it again sometime... so come back soon, little peeper.' With that, the orc gives you a playfully light swat on the butt, then walks out of the room.";
	else:
		LineBreak;
		say "     Flipping the little switch for the microphones, you cut off the sound from the other room and turn your mind to other things, ignoring the one-way mirror completely.";
	if MulAnalAcceptance < 10:
		increase MulAnalAcceptance by 1;

Section 4 - Library Sex

instead of navigating Grey Abbey Library while ((MulAnalAcceptance > 8) and (lastfuck of Mul - turns) > 8):
	say "[NavCheck Grey Abbey Library]";
	if NavCheckReturn is false, stop the action;
	move player to Grey Abbey Library;
	if debugactive is 1:
		say "     DEBUG: MUL SEX WALKIN [line break]";
	if graphics is true:
		project the figure of Mul_face_icon;
	say "     As you walk up to the library and set your foot on the stairs in front of the entrance, you notice that someone is already there, waiting for you. It is Mul, the proud orc warrior you've had so much fun with lately - mainly by breaking him in to be fucked. Leaning against one of the stone lions next to the doors, he looks up at you with a gruff expression, baring his tusks and giving a grunt, followed by an almost growled, 'There you are. Finally.' The green-skinned brute stands up straight, looking down at you at the bottom of the stairs with his big, muscular arms crossed in front of his broad chest. You can see the muscles of his jaw flexing a little as he presses his lips together, before finally pulling his expression into a slight grimace and saying in a low tone, 'I need it... from you. Need you... To... You know.'";
	say "     The orc's face takes on a peculiar shade of emerald green - a blush, if you're not mistaken - and he reaches over the stone lion's back, pulling out an item deposited out of sight there. It's a dildo, and not a small one. Hefting the rubber sex toy in his hand, your orcish bottom-boy grunts out around his tusks, 'This helps, but... it's not enough. I feel like... ARRGH, dammit - you know what you did to me! Fuck me already and take care of my need to be filled!'";
	LineBreak;
	say "     ([link]Y[as]y[end link]) Take Mul inside and have some fun with him.";
	say "     ([link]N[as]n[end link]) Wave the orc off. He can go somewhere else and play with his toy.";
	if player consents:
		LineBreak;
		say "[MulLibrarySexMenu]";
	else:
		LineBreak;
		say "     You're the one who holds all the cards here, and if you don't feel like giving the brute a good pounding... he'll just have to get his rocks off somewhere else. With a somewhat cruel grin on your face, you reject the orc's offer and tell him to fuck off. Snarling, Mul stalks away, still with the dildo in his hand.";

to say MulLibrarySexMenu:
	now sextablerun is 0;
	blank out the whole of table of fucking options;
	[]
	if player is male:
		choose a blank row in table of fucking options;
		now title entry is "Take him from behind";
		now sortorder entry is 1;
		now description entry is "Push Mul against a bookcase and really pound into him";
	[]
	if player is male:
		choose a blank row in table of fucking options;
		now title entry is "Let him ride you";
		now sortorder entry is 2;
		now description entry is "Lie down on a bench and let Mul fuck himself on your pole";
	[]
	if player is male:
		choose a blank row in table of fucking options;
		now title entry is "Fuck him missionary style";
		now sortorder entry is 3;
		now description entry is "Let Mul lie on a bench and take him, face to face";
	[]
	choose a blank row in table of fucking options;
	now title entry is "Ride Mul's thick shaft";
	now sortorder entry is 4;
	now description entry is "Power-bottom your orcish slut";
	[]
	if (cocks of player > 0 and demon brute is tamed and DemonBruteStatus < 2):
		choose a blank row in table of fucking options;
		now title entry is "Let Brutus fuck Mul";
		now sortorder entry is 5;
		now description entry is "Give the orc a treat and power-bottom him";
	[]
	if (felinoid companion is tamed):
		choose a blank row in table of fucking options;
		now title entry is "Let Klauz fuck Mul";
		now sortorder entry is 6;
		now description entry is "Allow Klauz to mount Mul";
	[]
	if (Fang is in Grey Abbey Library and HP of Fang > 1 and HP of Fang < 100):
		choose a blank row in table of fucking options;
		now title entry is "Let Fang fuck Mul";
		now sortorder entry is 7;
		now description entry is "Allow the feral wolf to mount Mul";
	[]
	if (HP of Sven > 7 and HP of Sven < 30 and cocks of player > 0): [***sex-pet Sven only currently]
		choose a blank row in table of fucking options;
		now title entry is "Get Sven to fuck Mul";
		now sortorder entry is 8;
		now description entry is "Make the big orc bottom for your snowmeow pet";
	[]
	choose a blank row in table of fucking options;
	now title entry is "Make him use the dildo on himself";
	now sortorder entry is 9;
	now description entry is "Watch as Mul slides the sex toy in his ass";
	[]
	sort the table of fucking options in sortorder order;
	repeat with y running from 1 to number of filled rows in table of fucking options:
		choose row y from the table of fucking options;
		say "[link][y] - [title entry][as][y][end link][line break]";
	say "[link]100 - Nevermind[as]100[end link][line break]";
	while sextablerun is 0:
		say "Pick the corresponding number> [run paragraph on]";
		get a number;
		if calcnumber > 0 and calcnumber <= the number of filled rows in table of fucking options:
			now current menu selection is calcnumber;
			choose row calcnumber in table of fucking options;
			say "[title entry]: [description entry]?";
			if player consents:
				let nam be title entry;
				clear the screen and hyperlink list;
				now sextablerun is 1;
				if nam is "Take him from behind":
					say "[MulLibrarySex1]";
				if nam is "Let him ride you":
					say "[MulLibrarySex2]";
				if nam is "Fuck him missionary style":
					say "[MulLibrarySex3]";
				if nam is "Ride Mul's thick shaft":
					say "[MulLibrarySex4]";
				if nam is "Let Brutus fuck Mul":
					say "[MulLibrarySex5]";
				if nam is "Let Klauz fuck Mul":
					say "[MulLibrarySex6]";
				if nam is "Let Fang fuck Mul":
					say "[MulLibrarySex7]";
				if nam is "Get Sven to fuck Mul":
					say "[MulLibrarySex8]";
				if nam is "Make him use the dildo on himself":
					say "[MulLibrarySex9]";
				now lastfuck of Mul is turns;
				wait for any key;
		else if calcnumber is 100:
			say "Break off?";
			if the player consents:
				now sextablerun is 1;
				say "     You step back from the powerful orc, shaking your head slightly as he gives a questioning look.";
				wait for any key;
			else:
				say "Pick between 1 and [the number of filled rows in the table of fucking options] or 100 to exit.";
		else:
			say "Invalid Option. Pick between 1 and [the number of filled rows in the table of fucking options] or 100 to exit.";
	clear the screen and hyperlink list;

to say MulLibrarySex1: [Pounding Mul while standing]
	say "     In the mood for a hard, no nonsense fuck, you grasp Mul by the shoulder and push him forward to stumble forward, catching himself on a bookcase. As his large hands thud against the shelf and grip on tightly, you're behind the orc an eye-blink later with your erection leading the way, thrusting deep into the strong male's tight hole and making him roar at the sudden anal invasion. Thanks to already breaking him in very well, Mul's pucker readily expands to allow more and more of your shaft in, while at the same time still being nice and snug around your member. The big male's hole feels fantastic to be in, and the fact that you're dominating the very orc that wanted to take you as a slave makes fucking him all the sweeter.";
	say "     Being used to getting fucked by now - and getting off on it quite a bit, Mul's anal muscles flex and twitch as you pound into him hard. Part of it is just him reacting to you hitting the prostate, but there are also some moments in which the orc's hole almost seems to jerk you off inside him. Apparently, your muscled green playmate has accepted this role so much now that he is experimenting with new techniques to make wild anal sex feel even better for you both. You can't help but give a very satisfied laugh at the situation - you, balls deep inside a mighty orc warrior and pounding into him hard so that he has to brace himself with both arms... right on the open expanse of this public library, with his moans echoing through the usually so silent halls. You don't think there is any corner of the building where one can't hear your orc butt-slut grunt as he takes your cock deep.";
	WaitLineBreak;
	say "     Grunts and slapping noises of your hips against Mul's ass fill the large chamber, coming in a rapid pace as you fuck him deeply without restraint. He's an orc after all - strong and tough, your bottom-boy can take whatever you can dish out. And you're quite certain that he even likes the rough treatment... having reached around him to take hold of Mul's own thick shaft, you can feel it twitch and pulse each time you give him an especially deep thrust. In a wild and exhilarating ride, you soon drive the big man closer and closer to the edge, his grunts and moans coming quicker and becoming slightly higher pitched.";
	say "     Forgetting his stubborn pride completely in the heat of sex, the orc even starts to shout, 'Yeah, take me! Faster! Pound my ass! Ngh - Nnngh! More! NnnnngggghhhHH!' With that last drawn-out roar, Mul starts to cum, his shaft rhythmically pulsing in your hand as stream after stream of cum blasts through it and covers any number of books in sticky white splashes. With each spurt of the orc's seed, all the muscles in Mul's body twitch and tense - including those inside his ass, around your shaft. This results in you joining your brutish partner in orgasm just moments later, gripping him tightly around the hips as your balls start to unload everything they got. Your seed gets pumped into Mul in weighty bursts, filling him up with creamy cum.";
	WaitLineBreak;
	say "     After blasting the last few spurts of your orgasm into Mul, you pull out of him with a slurp and leave the large orc to sink to his knees on shaky legs. Standing back, you take in your handiwork - one mighty orc warrior slouched against a cum-splattered bookshelf, with your seed dripping out of his hole and him still panting like a needy bitch. You can't help but laugh as he leans forward, resting his shoulder against the shelf and knocking a few books to the ground, just to have free hands that immediately start to finger his stretched hole. As he is doing so, Mul suddenly takes a deep sniff and focuses on something - his own cum, slowly oozing down the backs of books standing right in front of him. Being the slut for orc cum you've turned him into, there is no hesitation at all as he eagerly licks the sperm up.";
	say "     The very self-satisfied smile on your lips stays with you the whole time as you get dressed, then leave the freshly-bred orc to lap up all the cum he can get before eventually starting a walk of shame back to the orc lair - in all likely-hood making up some fancy story about this or that creature he fucked to tell his brothers and other orc buddies...";
	if MulAnalAcceptance < 10:
		increase MulAnalAcceptance by 1;

to say MulLibrarySex2: [Let him ride your cock]
	say "     Mmmh, yes - making the muscled orc brute mount your shaft himself sure is a delicious thought. He won't be able to tell himself that it's just you raping him if he's the one who sinks his own ass on your pole. What a nice lesson to teach your orcish bottom slut! A domineering smile spreads over your lips as you look at Mul and stroke your own shaft, then turn your back and walk a few steps away from him, heedless of the opening this gives the strong fighter. Why would you be worried, after all - you already got him pleading for your cock, panting in lust-addled heat. All that comes from Mul is a nonplussed grunt leading over into a needy groan - oh yeah, he's well and ready!";
	say "     Sitting down on a nearby sofa in a reading group right in the middle of the library, you spread your legs and draw the attention of the needy orc by clearing your throat. Then you stroke your cock demonstratively and hold it up for the orc to feast his eyes on. Taunting that if he wants it, he can come and fuck himself on your shaft, you lean back and watch the big green male gape at your offer. Expressions flicker over Mul's face - anger and shock, bottomless need and indecision, to name a few... then he suddenly gives a deep grunt, huffing loudly as he walks up to you. The orc scowls at your lying form as he comes to stand right next to the sofa, then he moves into position, sliding a knee forward to brace on the seat cushions, followed by the other one. Now kneeling over your crotch, he somewhat shyly looks to the side even as puts a finger in his mouth, then reaches down to brush its wetness against his own back door... as if not looking into your eyes as he prepares to take your dick would change anything about what he's about to do.";
	WaitLineBreak;
	say "     You can't quite make out what Mul murmurs to himself next, but you don't really care, as he starts to lower himself further and further, soon bumping his butt-crack against your hard shaft. A large hand reaches down, taking hold of your manhood and holding it straight up, then you can feel Mul's pucker against your cockhead. With a grunt and a downward push, the orc's muscled ring readily stretches around your shaft, allowing you inside his narrow passage. Yeah - still just awesomely tight and gripping as the time you took Mul's cherry. He's come far in the meantime - from you having to almost knock him out before you could stick your dick in, to now willingly sinking down on your rock-hard pole!";
	say "     The big orc gives lusty grunts and lowers himself further, both hands on his firm buttcheeks - holding them apart as he takes in more and more of your shaft. Then finally, you can feel the downy fuzz of hair on his butt against your crotch, your erection now fully inside Mul. He holds still like that for a moment, taking in the feeling of having your manhood inside his body once more and squeezing his muscles around it. But soon, just sitting passively on your cock isn't enough for the mighty orc warrior - he straightens his legs again, pulling off your pole in one quick move that has his hard cock bounce up and down... before he impales himself on your shaft again with a satisfied roar. As you well know, Mul likes it rough - he is an orc after all!";
	WaitLineBreak;
	say "     Grunts and slapping noises of your hips against Mul's ass fill the usually so silent halls of the library, coming in a rapid pace as he rides your erection hard - and you join in to mix things up a bit, thrusting your hips up when he least expects it. It's a wild fuck between you two, going at it without restraint... until you grip him by the hips in sudden tightness, bringing his movements to a stop. You've got to strain yourself to hold on as the needy orc tries to continue, then stops trying after a short moment. Still panting deeply, he looks right at you for the first time, 'What?!' ...while at the same time squeezing his anal muscles tightly around your cock. You're almost tempted to just continue as before, but no - you want more from him.";
	say "     Moving your hands to his green buttcheeks and squeezing their firm curves, you tell Mul look at you - let you see the lust in his eyes that being treated like a slutty breeder makes him feel - face you like the man-whore that he's become. The orc answers with an angry growl at your taunting tone, but that is immediately replaced by a needy gasp when you give a tug of your hips, sliding most of your shaft out of his tight chute. Mul's body tries to automatically follow, get the piece of man-meat that is giving him all this pleasure back inside his hole - but you stand fast, not letting him do it. There is a second of hesitation yet, followed by a snarled, 'You bastard! Fine, I'll do it!'";
	WaitLineBreak;
	say "     And with that, he looks right into your eyes as the words, 'Fuck me please,' pass is lips - after which you let your unyielding grip go. With great satisfaction you watch as he sinks himself down on your pole again with a relieved moan. Then, he starts to slide up and down, rocking his hips to fuck himself on your pole. You grin at the mix of sullen anger and bottomless lust on his face, sticking out your tongue and giving a deep thrust when your eyes meet once more. As Mul proceeds to grind against your pole, you take hold of the orc's weighty manhood and give it a few strokes, while your other hand cups his balls and fondles them.";
	say "     Getting back to the sensations of your cock hitting his prostrate and with your hands on his erection, the big man soon veers closer and closer to the point of no return, his grunts and moans coming quicker and louder. Forgetting his stubborn pride completely in the heat of sex, the orc even starts to shout, 'Yeah, your cock feels great! Faster! Pound my ass! Ngh - Nnngh! More! NnnnngggghhhHH!' With that last drawn-out roar, Mul starts to cum, his shaft rhythmically pulsing in your hand as stream after stream of cum blasts through it and splatters all over your chest and face.";
	WaitLineBreak;
	say "     With each spurt of the orc's seed, all the muscles in Mul's body twitch and tense - including those inside his ass, around your shaft. This results in you joining your brutish partner in orgasm just moments later, bucking up against him as your balls start to unload everything they got. Your seed gets pumped into Mul in weighty bursts, filling him up with creamy cum. As your shaft continues to pulse with spurts of cum, Mul writhes on top of it, clearly overwhelmed by feeling the injection of another male's seed. He even sinks forward, lying half on top of you and bracing himself on the bench below as he twitches in arousal.";
	say "     You let the orc catch his breath, stroking and feeling his body at your leisure, now that you've got him worn out and as docile as he'll ever get. Even pulling his head down to yours and giving him a lusty kiss, you bask in the situation for a moment or two, then put your arms around Mul and give him a light slap on the butt. Wrenched out of his aroused haze, the orc focuses on your very close face, whose lips tell him a moment later to clean you. For now, there's no resistance left in Mul and he readily starts to lick his own creamy cum off your face, then chest. Being the slut for cum you've turned him into, he pulls off your shaft when done with lapping at your pecs, then proceeds to take your cock into his mouth to get everything stuck to it.";
	WaitLineBreak;
	say "     A very self-satisfied smile covers your face the whole time as you're cleaned and then get dressed, eventually leaving the freshly-bred orc to stick his fingers up his own back door and suck what cum leaks out off the thick digits. Eventually he'll start a walk of shame back to the orc lair - in all likely-hood making up some fancy story about this or that creature he fucked to tell his brothers and other orc buddies...";
	if MulAnalAcceptance < 10:
		increase MulAnalAcceptance by 1;

to say MulLibrarySex3: [Missionary Fuck]
	say "     In the mood for something more intimate than a quick pounding, you order the horny orc to lie down, pointing at a large sofa standing in a reading group pretty much in the middle of the library's ground floor. You'll be on center stage for anyone else in the building, or even someone who just comes along and looks through the glass front doors. Following Mul as he obeys, you take a moment to savor the sight of such a magnificent male following your commands and lying down where you tell him, pulling off his loincloth as he does so. He's totally waiting to be taken, and you kneel between his spread legs to stroke the inside of his thighs. Oh yeah, you'll enjoy your time with this big brute, giving him what his body has learned to crave. As wound up as you have him by now, he starts to raise his legs all on his own, baring the enticing rosette of his pucker, which even 'winks' at you as Mul relaxes his muscles, then tenses them again.";
	say "     You find yourself kneeling down and nudging his back door with your hard cock almost without thought, but stop yourself from just plunging in. Instead, you tease him a bit with the tip, grinning widely at the needy little gasps when you almost - but not quite - enter him with your shaft. Running your hands over the green-skinned man's ripped abs, firm pecs and bulging biceps, you lean over him and take a good whiff of his masculine scent then lick over one of his nipples. The aroused moan from Mul that follows tells you everything you wanted to know - pleased by having another weak spot you can use to make your orcish bitch tremble and howl, you vigorously attack his nipples, sucking on one and flicking it with your tongue while you rub and pinch the other one between your fingers.";
	WaitLineBreak;
	say "     In short order, you have Mul trembling with lust, his hands clenching in their grasp of the sofa cushions while his head is leaned back and he almost shouts out his moans. Seeing the ruggedly handsome face of your green-skinned playmate, you get a naughty idea of what you could do with the usually so gruff orc... so you stretch yourself a bit, grip his shoulders with your own strong hands - and plant a hungry kiss right on his spread lips, invading his mouth with your tongue. Mul's eyes open in a flash and he gives you a shocked expression, bucking up reflexively to throw you off - but the moment of resistance is short-lived. The pleasure he gets from your lips and tongue pushes aside the inherent worry of acting in a way that's 'not manly' - which leaves you with an eager, but inexperienced partner in making out.";
	say "     Sharing a very satisfying snog with the orc, you decide it's finally time to take him. Sliding down your hand between the two of you, grasping Mul's shaft on the way and giving it a little stroke, you soon take hold of your own shaft and guide it to your partner's waiting hole. As well-trained as you have him by now, the orcish slaver's pucker readily spreads around your manhood as it pushes into him, forming a delightfully tight ring that stretches around your cock. He feels amazing around you, nice and gripping even after having been fucked a few times - though that's not natural tightness anymore but rather conscious choice, as he flexes his inner muscles to give pleasant sensations to both of you.";
	WaitLineBreak;
	say "     Pulling almost all of your shaft out again, you then slam back in with one mighty thrust, making Mul roar in lust and wrap his strong legs around your hips. It's obvious that while he may get off getting fucked, this orc brute is no sissy - he likes his sex rough, giving or taking it... and you're only too happy to oblige, pounding into his hole without holding back. Most of the time that you buck into him, your lips remain locked with the sexy male, muffling the moans and groans between the two of you - although that doesn't mean it is quiet in the echoing halls of the library, not with the loud slapping of your crotch against his butt filling the air...";
	say "     Your wild coupling continues for some time, with you rutting the orc as you make out with him, building your arousal up more and more - until you finally reach the point of no return. Sinking your shaft into Mul all the way one last time, you tightly grip his shoulders with your hands as your balls pulse with the first massive spurt that splashes into him, followed by another, and another. Getting bred by another male is the last straw for your green-skinned bottom boy too, with the throb of your cock against his prostate and your seed filling his insides - all of which creates pleasant sensations for the trained butt-slut. Mul's own towering erection swings and twitches as long blasts of cum spray from the cock-slit of his member, liberally splattering the orc's chest.";
	WaitLineBreak;
	say "     While still keeping your cock inside Mul's hole, you straighten your upper body and look down at the orc - well-bred and still with a man's shaft up bis hungry hole, which combined with a cum-splattered chest creates the image of a fine butt-slut. Chuckling at how far you can push the strong orc warrior by just using the right buttons, you scoop up a bit of his cum with your hand, then hold it out for him to lick clean. After Mul sucks the last creamy drop from your fingers, you get more and more, continuing to feed the eager orc his own load. Eventually, it's all gone and the muscled man is buzzed indeed, still suckling on your fingers to maybe get some more. By this time, your softening shaft has slipped out of his hole, so you stand up and grab your clothes and gear.";
	say "     The very self-satisfied smile on your lips stays with you the whole time as you get dressed, then leave the freshly-bred orc to lap up all the cum he can get before eventually starting a walk of shame back to the orc lair - in all likely-hood making up some fancy story about this or that creature he fucked to tell his brothers and other orc buddies...";
	if MulAnalAcceptance < 10:
		increase MulAnalAcceptance by 1;

to say MulLibrarySex4: [Ride Mul]
	say "     In the mood to make use of the half-tamed orc warrior in another way right now, you order Mul to lie down, pointing at a large sofa standing in a reading group pretty much in the middle of the library's ground floor. You'll be on center stage for anyone else in the building, or even someone who just comes along and looks through the glass front doors. Following Mul as he obeys, you take a moment to savor the sight of such a magnificent male following your commands and lying down where you tell him, pulling off his loincloth as he does so. He's totally waiting to be taken, and you kneel between his spread legs to stroke the inside of his thighs. Oh yeah, you'll enjoy your time with this big brute, giving him what his body has learned to crave. As wound up as you have him by now, he starts to raise his legs all on his own, baring the enticing rosette of his pucker, which even 'winks' at you as Mul relaxes his muscles, then tenses them again.";
	say "     You find yourself kneeling on the sofa and nudging his back door with your hand almost without thought, two fingers sliding in easily and allowing you to wind up the increasingly aroused orc more and more. While fingering his asshole, your other hand gets busy on the big brute's thick green shaft, slowly jerking his towering pole of man-meat. It doesn't take long before a first glistening drop of pre-cum forms at his cock-slit, beckoning you with its delicious smell - yet you keep yourself under control and just concentrate on milking the slick fluid out of him. More and more pre oozes out of Mul's shaft as you do a slow but steady hand-job and fingering, soon forming a slightly milky puddle on his crotch, where the cum drips from his cockhead and also lands when you flick the orc's dick playfully. There, that should be enough - telling Mul to close his eyes, you grin as he does so, then take up the dildo the muscled butt-slut brought along. With a swipe of your hand over his crotch, you've got a whole lot of pheromone-laden pre-cum to lube the sex toy with, after which you line it up with his rear entrance. And then, you ram it inside - making your orcish bitch tremble and howl as you grind the rubber cock in and out of his hungry hole.";
	WaitLineBreak;
	say "     After having some fun playing with the orc's hole, you decide it's finally time to take him - up your own ass, that is. Sliding your hand over his hard and flexing abs, grasping Mul's shaft and giving it several long strokes, you command him to fuck himself with the dildo, like the good little slut he's become. With little more than an annoyed grunt, he does as instructed, stretching himself to push the rubber toy against his pucker with thick fingers. As well-trained as you have him by now, the orcish slaver pants and gives needy whimpers as he grinds the artificial cock against his prostate, with his shaft throbbing each time he hits the mark. Pushing yourself up from leaning over him, you brush a hand down his muscled chest and give his proudly standing pole an appreciative squeeze, then stand up and step over him, setting a foot left and right of the orc's hips.";
	say "     Eyes closed as he works his fuckhole, the big orc doesn't even realize what you're planning to do until you crouch down and brush his cock with your buttcheeks. The familiar sensation of someone's buns against his shaft does make your green-skinned bitch's eyes fly open instantly. Seeing you hovering over his cock makes a spark of the big orc's domineering spirit flare up, and he starts to push himself up, saying the words, 'Oh yeah, I'll pound you har - *Ooof! Unnghh*' Alas, his thoughts of being the top in your coupling are short-lived, as you force him back down on the ground right away, with the stretched fingers of your hand resting on his muscled pecs, pressuring him to take only shallow breaths. And like that, you explain to the orc that he's still your slut, even if you wanna make use of his cock for your own enjoyment. As you let go of him a moment later, Mul doesn't do anything but give a grunt of assent, staying calm on his back and just toy-fucking his own ass.";
	WaitLineBreak;
	say "     Now that you've established who's the boss, you reach behind yourself and take hold of his proud member, then angle it at your back door and sink down a little more, pressing against it. With a lusty grunt from two voices, the orc's thick cockhead sinks into your body as the pucker yields, spreading your opening tight around its girth. The orc's cock is quite big and meaty, making you gasp as you twitch the wrong way after the initial penetration. Though with you being the one in control, taking on this mighty organ is no problem - as you can take your time, only wincing slightly as you sink yourself deeper bit by bit, seeing the hard shaft as a challenge to vanquish, just like its owner. Before much longer, more pleasant feelings prevail as its sides rub against your inner walls, touching sensitive spots deep inside you.";
	say "     As you proceed to impale yourself on the orcish warrior's erection, you feel something warm and wet leak into you from the tip of his cock, accompanied by a soothing feeling of well-being. That must be more of his precum - feels a bit strange, but good, and it certainly helps taking his thick meat. Some time later, you're finally all the way down on his prick, his hard shaft buried all the way in you and his two large cum-factories resting against your skin. Feeling a bit giddy, now that you're sitting on one bit more than a foot-long and impressively girthy cock, you look down upon Mul and chuckle to yourself. Even with the nanite apocalypse and all, some things are working out very well for you these days.";
	WaitLineBreak;
	say "     After taking a deep breath, you start sliding up and down on Mul's manhood, fucking yourself first slowly, then faster and faster as your insides stretch to accommodate his size and more of his precum makes your hole pretty slick and wet. Between the mind-blowing sensations of such a thick piece of meat reaching ALL the places you wanna get fucked in and him leaking aphrodisiac-laden pre into your insides, it doesn't take all that long until your arousal rises above all limits, making you almost shout out in orgasm and [if cocks of player > 0]spray your cum all over the orc's broad chest[else if cunts of player > 0]femcum sprays from your pussy to splatter down on the orc's abs[else]a tingly feeling spreads through your whole body[end if].";
	say "     Having your hole tremble and twitch around his orcish member while you come gives Mul the last little push he needed to reach his own climax, and with a loud and very satisfied grunt, the orc starts blasting a massive load of cum into your innermost depths. He bucks up against you as he comes, all the while still moving the toy against his rear. Clearly reveling in the feeling of his seed squishing around his thrusting shaft inside your body, the orc gives lusty grunts with each new blast. With the amount of cum he pumps into you, quite a bit squirts out around his cock as he does so, to drip down onto his own crotch and the ground below.[mimpregchance]";
	WaitLineBreak;
	say "     Exhausted but happy, you pull off your orc slut's still pretty hard shaft, then stand up on somewhat weak knees. But you're not quite done with him, as Mul learns when you straddle his chest after turning around, ass towards the orc warrior's head. Playfully pinching his nipples, you don't even have to say anything, as even to Mul it is pretty clear what you want - and he starts lapping at your butthole almost instantly, hungrily eating his own cum out of you. Chuckling at how far you can push the strong orc warrior by just using the right buttons, you scoop up a bit of the cum sticking to his crotch with your hand, then hold it out for him to lick clean. After Mul sucks the last creamy drop from your fingers, you get more and more, continuing to feed the eager orc the spill of his own load, then press back again, your ass-crack right over his face. Eventually, even the smallest trickle of his orcish seed is gone and Mul is buzzed indeed, simply nuzzling your rear and still lapping a bit in simple reflex.";
	say "     The very self-satisfied smile on your lips stays with you the whole time as you get dressed, then leave the freshly-bred orc to lap up all the cum he can get before eventually starting a walk of shame back to the orc lair - in all likely-hood making up some fancy story about this or that creature he fucked to tell his brothers and other orc buddies...";
	if MulAnalAcceptance < 10 and MulAnalAcceptance > 1:
		decrease MulAnalAcceptance by 1;

to say MulLibrarySex5: [Pounding against the wall - with Brutus]
	say "     In the mood for a hard, no nonsense fuck, you grasp Mul by the shoulder and push him forward to stumble forward, catching himself on a bookcase. As his large hands thud against the shelf and grip on tightly, you're behind the orc an eye-blink later[if cocks of player > 0] with your erection leading the way, coming to rest between the firm buns of his ass with a meaty thud[end if]. Pressing against him from behind, you revel for a second in the fact that even though you can feel his mighty muscles tighten and flex, the green brute doesn't really struggle against being man-handled in such a way. No - he's far too hungry for a hard shaft to pound his slutty ass. And you got just the right cock to do so...";
	if DBCaptureQuestVar is 5: [evil]
		if companion of player is demon brute:
			say "     Looking over to where Brutus has been standing all along, watching and glowering in silence - since you previously forbade him to disturb you - you see that the demon has sprung his typical impressive erection at the show he is being given. Held back from acting on his lust by the magic in your amulet, it is painfully obvious that the purple giant is really itching to have a go at Mul himself. Since that's what you had planned anyways, you just give him a smile and allow Brutus to fuck Mul - without injuring him, you add quickly as a malicious gleam flickers in the demon's eyes. Brutus gives a slightly annoyed grunt, then steps forward and growls, 'About time! Let me show you how to destroy someone's hole, 'master'.' Surprised at the sudden switch in partners, Mul looks back over his shoulder and takes in the towering figure. Your orcish bottom-boy only has time to gasp, 'Oh fuck!' - then Brutus is upon him, one large hand closing on the orc's shoulder to hold him in place, the other lining up his infernal pole.";
		else:
			say "     Grasping the demontooth amulet hanging around your neck, you intone the magic words Nermine taught you, causing a purple swirl of smoke to pour out of the magic item, soon solidifying into the towering figure of your demonic companion. Checking out where you've summoned him this time, the purple giant lets his gaze wander over the trashed locker-room, then returns to your naked form, followed by a long stare at Mul being pressed against the wall. Brutus almost instantly springs his typical impressive erection at the situation before him - it is clear that he's more than a little interested. And so, it is with a smile and allow Brutus to fuck Mul - without injuring him, you add quickly as a malicious gleam flickers in the demon's eyes. Brutus gives a slightly annoyed grunt, then steps forward and growls, 'About time! Let me show you how to destroy someone's hole, 'master'.' Surprised at the sudden switch in partners, Mul looks back over his shoulder and takes in the towering figure. Your orcish bottom-boy only has time to gasp, 'Oh fuck!' - then Brutus is upon him, one large hand closing on the orc's shoulder to hold him in place, the other lining up his infernal pole.";
		WaitLineBreak;
		say "     Without even the slightest hint at concern for Mul's feelings about the matter, Brutus rams his whole shaft into the orc's back door, driving Mul against the wall of bookshelves with a horny roar that is echoed by the orc's own lusty grunt at the sudden deep penetration. The shelf Mul is gripping rocks almost far enough to fall over, and all around large and small books tumble to the ground. Looks like a good thing that you fingered the orc a bit already and he is prepared for getting fucked. Then Brutus pulls back, his purple shaft plopping out of the orc's hole with a wet slurp - only to be driven in all the way an eye-blink later. Thank god that your demonic slave has magically enforced instructions not to injure anyone but whom you tell him to, as he clearly wants to punish Mul's abused hole - being the vicious beast that he is. Even so, the purple brute goes as far as his bond allows, using his powerful form really go to town on the orc in his control. And it shows, as the hard pounding of his hips against Mul's rear fills the echoing halls of the library with loud slapping noises, and the orc even gets lifted off his feet a few times. The demon grunts and roars as he fucks the green-skinned brute hard, horny as hell and just a little frustrated he can't completely break him.";
		say "     Meanwhile, on the other end of the infernal erection being hammered in and out of his chute... Mul loves every second of it. Being a real man - a real orc - he takes the hard pounding with a gruff grin on his face, even angling his hips for Brutus to go as deep as he can. The orc's own shaft leaves long splatters of precum visible all over the books still standing in the trembling and rocking shelf he holds on to, with more splashes flung from the tip of his erection with each pounding thrust from Brutus. 'Is that all you got, demon?' Mul pants in between his loud groans and gasps at the next penetration and the next, egging on Brutus to continue giving him the ride of his life.";
		WaitLineBreak;
		say "     The two big brutes really are an amazing match, both able to dish out a long and hard fuck - and resilient enough to take one too. And so, you're treated to a very sexy show of unrestrained humping, with roars, growls and grunts filling the library until finally, Mul calls out, 'I'm close! Fuck me! Fuck! FUCK! NNNnggghhh!' Thrusting his hips back against the large demon's crotch and throwing his head back, the orc gives a climactic shout and then starts to cum, blasting the bookshelf in front of himself with spurt after spurt of his potent seed. The first one of them is even heavy enough to send the book it impacted tumbling down - which had been already on the brink of falling, but it still was quite a shot. Brutus isn't far behind him either, as the trembling and flexing of the orgasming orc's hole gives him the feeling of being jerked off - and that inside an already warm and tight fuckhole. Thus, he soon wraps his arms around Mul from behind, lifting the orc off his feet as he clutches him to his chest, then rams him down on his shaft several times like an oversized fleshlight. You can literally see the purple orbs of your demon's balls pulse as they send forth a mighty load, filling his partner with more and more cum until Mul has an actual bulge in his stomach, being so full.";
		if companion of player is demon brute:
			say "     After catching his breath, Brutus says, 'I've had better sluts, but you'll do, orc. This was fun.' And with that, he gives Mul's ass a hard slap, enough to leave a slight bruise, but not actually breaking skin with his claws, then pulls his softening erection out with a wet slurp. Giving his still-dripping member and Mul's gaping hole a proud grin, the demon then walks back over to you, taking his usual position by your side again. ";
		else:
			say "     After catching his breath, Brutus says, 'I've had better sluts, but you'll do, orc. This was fun.' And with that, he gives Mul's ass a hard slap, enough to leave a slight bruise, but not actually breaking skin with his claws, then pulls his softening erection out with a wet slurp. Giving his still-dripping member and Mul's gaping hole a proud grin, the demon then walks back over to you and impatiently waits for you to intone the magic words and send him back into the amulet. ";
		say "Meanwhile, Mul still stands against the by now almost empty bookshelf, leaning his head against a cross-brace - still trying to come to terms with not only being fucked by you, but your pets as well. Best not to let him dwell on such things too long, so you step up behind the orc and 'suggest' he take care of the tasty, tasty orc cum slowly spilled in sticky splotches over the books and smooth boards of the bookshelf in front of him. With little more than a grunt, Mul crouches and laps his own seed up, hungrily swallowing it.";
		WaitLineBreak;
		say "     The very self-satisfied smile on your lips stays with you the whole time as you walk off, leave the freshly-bred orc behind. Mul is even now still licking up the last little trickle of seed and fingering the cream-filled hole between his buns, and you think he'll keep doing that for some time. Eventually, he'll be starting a walk of shame back to the orc lair - in all likely-hood making up some fancy story about this or that creature he fucked to tell his brothers and other orc buddies...";
	else: [good]
		if companion of player is demon brute:
			say "     Looking over to where Brutus has been standing all along, silently waiting for his master to have some fun - you see that the demon has sprung an his typical impressive erection at the show. Being the utterly devoted companion that he is, he'd never think of interrupting you, but it is painfully obvious that the purple giant is more than interested in having a go himself. Since that's what you had planned anyways, you just give him a very wide smile and command Brutus to fuck Mul. 'Thank you master,' the demon brute rumbles in his deep voice, at the same time as Mul looks back over his shoulder and takes in the towering figure. Your orcish bottom-boy only has time to gasp, 'Oh fuck!' - then Brutus is upon him, one large hand closing on the orc's shoulder to hold him in place, the other lining up his infernal pole.";
		else:
			say "     Grasping the demontooth amulet hanging around your neck, you intone the magic words Nermine taught you, causing a purple swirl of smoke to pour out of the magic item, soon solidifying into the towering figure of your demonic companion. Checking out where you've summoned him this time, the purple giant lets his gaze wander over the trashed locker-room, then returns to your naked form, followed by a long stare at Mul being pressed against the wall. Brutus almost instantly springs his typical impressive erection at the situation before him - it is clear that he's more than a little interested. And so, it is with a very wide smile that you command your demonic friend to fuck Mul. 'Thank you master,' the demon brute rumbles in his deep voice, at the same time as Mul looks back over his shoulder and takes in the towering figure. Your orcish bottom-boy only has time to gasp, 'Oh fuck!' - then Brutus is upon him, one large hand closing on the orc's shoulder to hold him in place, the other lining up his infernal pole.";
		WaitLineBreak;
		say "     Giving Mul's back door a nudge or two with his cockhead, Brutus finds it nice and ready for his cock and thrusts in without any more hesitation, driving Mul against the wall of bookshelves with a horny roar that is echoed by the orc's own lusty grunt at the sudden deep penetration. The shelf Mul is gripping rocks almost far enough to fall over, and all around large and small books tumble to the ground. Then Brutus pulls back, his purple shaft plopping out of the orc's hole with a wet slurp - only to be driven in all the way an eye-blink later. Even though your demon friend isn't as vicious during sex as he was in the old days, his powerful form is built to really go to town on anyone he might meet - and it shows, as the hard pounding of his hips against Mul's rear fills the echoing library with loud slapping noises, and the orc even gets lifted off his feet a few times. The demon grunts and roars as he fucks the orc hard, for once letting go of all the care he shows towards other partners - as not to break them, a worry he doesn't need to have with the muscled orc.";
		say "     Meanwhile, on the other end of the infernal erection being hammered in and out of his chute... Mul loves every second of it. Being a real man - a real orc - he takes the hard pounding with a gruff grin on his face, even angling his hips for Brutus to go as deep as he can. The orc's own shaft leaves long splatters of precum visible all over the books still standing in the trembling and rocking shelf he holds on to, with more splashes flung from the tip of his erection with each pounding thrust from Brutus. 'Is that all you got, demon?' Mul pants out in between his loud groans and gasps at the next thrust and the next, egging on Brutus to continue giving him the ride of his life.";
		WaitLineBreak;
		say "     The two big brutes really are an amazing match, both able to dish out a long and hard fuck - and resilient enough to take one too. And so, you're treated to a very sexy show of unrestrained humping, with roars, growls and grunts filling the locker-room until finally, Mul calls out, 'I'm close! Fuck me! Fuck! FUCK! NNNnggghhh!' Thrusting his hips back against the large demon's crotch and throwing his head back, the orc gives a climactic shout and then starts to cum, blasting the bookshelf in front of himself with spurt after spurt of his potent seed. The first one of them is even heavy enough to send the book it impacted tumbling down - which had been already on the brink of falling, but it still was quite a shot. Brutus isn't far behind him either, as the trembling and flexing of the orgasming orc's hole gives him the feeling of being jerked off - and that inside an already warm and tight fuckhole. Thus, he soon wraps his arms around Mul from behind, lifting the orc off his feet as he clutches him to his chest. You can literally see the purple orbs of your demon's balls pulse as they send forth a mighty load, filling his partner with more and more cum until Mul has an actual bulge in his stomach, being so full.";
		if companion of player is demon brute:
			say "     After catching his breath, Brutus says, 'You're a good fuck, orc. This was fun, thanks.' And with that, he gives Mul's shoulder an affectionate squeeze, then pulls his softening erection out with a wet slurp. Giving his still-dripping member and Mul's gaping hole a proud grin, the demon then walks back over to you, taking his usual position by your side again. ";
		else:
			say "     After catching his breath, Brutus says, 'You're a good fuck, orc. This was fun, thanks.' And with that, he gives Mul's shoulder an affectionate squeeze, then pulls his softening erection out with a wet slurp. Giving his still-dripping member and Mul's gaping hole a proud grin, the demon then walks back over to you and patiently waits for you to intone the magic words and send him back into the amulet. ";
		say "Meanwhile, Mul still stands against the by now almost empty bookshelf, leaning his head against a cross-brace - still trying to come to terms with not only being fucked by you, but your pets as well. Best not to let him dwell on such things too long, so you step up behind the orc and 'suggest' he take care of the tasty, tasty orc cum slowly spilled in sticky splotches over the books and smooth boards of the bookshelf in front of him. With little more than a grunt, Mul crouches and laps his own seed up, hungrily swallowing it.";
		WaitLineBreak;
		say "     The very self-satisfied smile on your lips stays with you the whole time as you walk off, leave the freshly-bred orc behind. Mul is even now still licking up the last little trickle of seed and fingering the cream-filled hole between his buns, and you think he'll keep doing that for some time. Eventually, he'll be starting a walk of shame back to the orc lair - in all likely-hood making up some fancy story about this or that creature he fucked to tell his brothers and other orc buddies...";
	if MulAnalAcceptance < 10:
		increase MulAnalAcceptance by 1;

to say MulLibrarySex6: [Spit-Roasting Mul with the Felinoid]
	say "     Opening the door to the library and walking inside, you beckon the orc to follow you and he complies, still with his dildo in hand. Now that you have this big brute all tamed and ready to serve, the mood strikes you to see the orc taken in a hard, no nonsense fuck. Grasping him by the shoulder, you push him to stumble forward, over to the big sofa in a reading group right at the front of the big hall that is the Grey Abbey Library. He actually falls onto it, face-planting into the cushioned backrest and grumbles back at you - which you answer with a taunt that he's your bitch and should get used to it. Pulling the loincloth off his hips and giving the newly revealed green buttocks a little slap, you then tell him to raise his ass and get ready for a wild ride.";
	WaitLineBreak;
	say "     Mul obeys, giving a needy grunt and moves into a proper fucking position, chest lying on the sofa while his knees rest on the floor in front of it, raising the orc's muscled behind in open invitation. You're behind the orc an eye-blink later, [if cocks of player > 0]with your erection leading the way, coming to rest between the firm buns of his ass with a meaty thud. Pressing your crotch against those muscled cheeks from behind,[else]sliding a hand between the firm bunts of his ass and rubbing up and down. Pressing a finger in against his pucker, to be easily accepted by the well-trained opening,[end if] you revel for a second in the fact that even though you can feel his mighty muscles tighten and flex, the green brute doesn't really struggle against being man-handled in such a way. No - he's far too hungry for a hard shaft to pound his slutty ass. And you got just the right cock to do so...";
	if companion of player is felinoid companion:
		say "     Looking over to where Klauz has been sitting on his haunches all along, silently watching and slowly twitching his tail, you wave for him to come closer - and the big cat replies with an amused mrowl. Almost casually standing up, he pads towards the two of you on his large paws, with a loud purr rumbling in the depth of his throat. Arriving beside Mul in barely an eye-blink, the felinoid proceeds to inspect the naked orc in his own time, sniffing his flank and licking him, then gives a satisfied growl and gets on the sofa himself, rubbing his cheek against the orc's shoulder, then head, spreading his scent. Knowing the big cat's behavior well by now, you realize what he's doing - for one, marking the green brute as his, and also pushing Mul deeper and deeper into a very receptive state with every musk-laden breath he takes. Not that he needs it right now, with you warming the orc up already, but you guess he just wants to make sure.";
	else:
		say "     Looking around in the expansive first floor of the library, you meet the eyes of Klauz, who had been watching what was going on, silently peeking at you from between two of the long shelves. It is as you suspected - the big cat never is all that far away from you, always ready to join you if there's trouble - or to get his rocks off. Something tells you he might be taking liberties with creatures you fought too - just 'happening' to walk into them when you're just gone. As you wave for him to come closer, the big cat replies with an amused mrowl. Stalking forward in a casual-looking way, he pads towards the two of you on his large paws, with a loud purr rumbling in the depth of his throat. Arriving beside Mul in barely an eye-blink, the felinoid proceeds to inspect the naked orc in his own time, sniffing his flank and licking him, then gives a satisfied growl and gets on the sofa himself, rubbing his cheek against the orc's shoulder, then head, spreading his scent. Knowing the big cat's behavior well by now, you realize what he's doing - for one, marking the green brute as his, and also pushing Mul deeper and deeper into a very receptive state with every musk-laden breath he takes. Not that he needs it right now, with you warming the orc up already, but you guess he just wants to make sure.";
	WaitLineBreak;
	say "     As Klauz jumps down to the floor next to you after a thorough inspection of Mul, he gives you a relatively abrupt yowl that you're very sure means, 'Move over.' With this being what you wanted to happen all along, you're more than happy to give up your place to the big cat, who immediately sticks his muzzle between Mul's cheeks, sniffing and licking at his rear entrance. The green brute of an orc moans deeply as the felinoid's tongue laps over his pucker, then pushes inside, wiggling around. A moment later, the cat gives a loud, lusty growl - seems he likes the taste of your green-skinned butt-slut. And so, Klauz does what comes natural and mounts Mul with a roar, pouncing on him and driving his barbed shaft deep with a single thrust.";
	say "     It is good that Mul is an orc, strong and tough, plus ready to enjoy a really hard fuck, as the felinoid pounds into him with the ferocity of a wild beast, resting his bulk on the orc's back as his hips keep humping against firm buttocks. Beside driving Mul to gasp and moan with very deep thrusts and the sensations of all those soft, nubby spikes on a feline cock sawing against his inner walls, Klauz also gives Mul a soft bite in the neck, driving the orc into a mini-orgasm as the teeth prick his skin. Lust-drunk from a hard cock hammering his prostate and the feline musk, Mul howls, 'Fuck me. Fuckkk MMEEE! GOD! FUUUUCK!' His thick cock starts to throb and blasts splashes of rich seed against the side of the sofa under him.";
	WaitLineBreak;
	say "     Just watching Mul come from being fucked, then go right on rocking back to meet the felinoid's next thrust as his cock is still spurting more cum is quite hot - but the [if cocks of player > 0]throb of your own cock[else if cunts of player > 0]tingle of your moist pussy[else]tingle of your sexless crotch[end if] makes you remember to tend to your own needs and not just be an observer, so you quickly strip and step up on the sofa yourself, sliding in between the backrest and where the groaning orc's head is. With his mouth open in almost constant panting and moaning from Klauz's merciless humping, it is no problem at all to ";
	if cocks of player > 0:
		say "push your prick between those sexy lips, which reflexively close around your meat and start sucking. Ah, taming this brute was an awesome idea - having such a tough guy sucking you like a born cum-slut makes you feel powerful, as if you could rule this whole crazy place all of your own. As you shove your erection into Mul's throat, enjoying the tightness of his warm passage, you can't help but grin down at the big cat still holding a soft grip on the orc's neck. A fitting companion in this new sex-crazed world - comes as a thought into your head, and you scratch him behind his ears as you continue to face-fuck Mul.";
	else if cunts of player > 0:
		say "pull him against your crotch, to bump into your dripping pussy. Even though he's not really used to female bits, it just takes a few pointers to get the orc licking and suckling on your clit. Ah, taming this brute was an awesome idea - having such a tough guy lapping away at your sex makes you feel powerful, as if you could rule this whole crazy place all of your own. As you push his nose against your pubic mound in ecstasy, you can't help but grin down at the big cat still holding a soft grip on the orc's neck. A fitting companion in this new sex-crazed world - comes as a thought into your head, and you scratch him behind his ears as you continue to face-fuck Mul.";
	else:
		say "pull him against your crotch, to bump into your sexless pubic mound. Even though he's rather perplexed by the absence of visible genitalia, it just takes a few pointers to get the orc licking on sensitive spots. Ah, taming this brute was an awesome idea - having such a tough guy lapping away at your sex makes you feel powerful, as if you could rule this whole crazy place all of your own. As you push his nose against your pubic mound in ecstasy, you can't help but grin down at the big cat still holding a soft grip on the orc's neck. A fitting companion in this new sex-crazed world - comes as a thought into your head, and you scratch him behind his ears as you continue to face-fuck Mul.";
	say "     With Klauz still ravaging his ass and you having the orc service you orally, it doesn't take all that long until Mul's arousal builds up to another spectacular orgasm. With him gurgling and grunting [if cocks of player > 0]around your shaft[else]into your crotch[end if], his hands dig into the sofa padding and he bucks up against the felinoid, then his big prick starts to erupt with a veritable deluge of rich, creamy cum, spurting against the already-stained sofa and even making wet splashes on the ground when the soaked fabric simply can't absorb any more and he still blasts away more of his orcish seed. In the throes of his climax, Mul's throat muscles and tongue, as well as anal muscles, tremble and flex like crazy - which drives both you and Klauz over the edge right with him. [if cocks of player > 0]Driving in all the way until the orc's nose is buried deep in your pubes, you let go a full load of cum, shouting in satisfaction as you fill your half-tamed orc warrior with your seed[else if cunts of player > 0]Grabbing Mul's head and pulling him tight against your crotch, your pussy starts to spurt femcum, splashing your half-tamed orc warrior's face wetly[else]Grabbing Mul's head and pulling him tight against your crotch, you tremble in lust at the touch of his lapping tongue[end if]. In the meantime, the felinoid raises his head to roar as he breeds Mul good, his virile semen splashing against the orc's prostate and quickly filling up his insides, to soon start leaking out around his cock.";
	WaitLineBreak;
	say "     For several long moments, nothing but heavy breathing and panting fills the library as all of your orgasms slowly wind down and cocks spill forth the last ebbing spurts of cum in this hole or that, or on the ground. Satisfied with having gotten your rocks off, you pull away from Mul's mouth a short while later, allowing the orc's slurred exclamation of, 'Nnnnggh. Damn. Been fucked by an animal...' He doesn't get any further as Klauz grips his neck between his teeth again, almost as if to say, 'Yup, and you're my bitch now.' The soft bite pushes Mul to give an involuntary moan in new arousal, something that the large cat on top of him rewards with a deep purr, loud as an idling motor. Then the feral beast throws himself to the side, pulling Mul with him as he lands on the ground, paws wrapped around the orc's chest and hips grinding against him a little.";
	say "     Grinning at the scene of the felinoid cuddling against Mul like he's his favorite toy, all the while still being balls-deep in the orc's ass with his barbed shaft, you move to collect your gear again and get dressed. With a look back at the two of them, you tell Klauz to catch up with you when he's done, then walk away from the stained sofa and the two males on the ground behind it. Moving to another part of the big library ground floor, you try to concentrate on other matters - like surviving in this crazy place - but your thoughts often return to the hunky orc, hoping he'll come over more often in the future.";
	if MulAnalAcceptance < 10:
		increase MulAnalAcceptance by 1;

to say MulLibrarySex7: [Spit-Roasting Mul with Fang]
	say "     Opening the door to the library and walking inside, you beckon the orc to follow you and he complies, still with his dildo in hand. Now that you have this big brute all tamed and ready to serve, the mood strikes you to see the orc taken in a hard, no nonsense fuck. Grasping him by the shoulder, you push him to stumble forward, over to the big sofa in a reading group right at the front of the big hall that is the Grey Abbey Library. He actually falls onto it, face-planting into the cushioned backrest and grumbles back at you - which you answer with a taunt that he's your bitch and should get used to it. Pulling the loincloth off his hips and giving the newly revealed green buttocks a little slap, you then tell him to raise his ass and get ready for a wild ride.";
	WaitLineBreak;
	say "     Mul obeys, giving a needy grunt and moves into a proper fucking position, chest lying on the sofa while his knees rest on the floor in front of it, raising the orc's muscled behind in open invitation. You're behind the orc an eye-blink later, [if cocks of player > 0]with your erection leading the way, coming to rest between the firm buns of his ass with a meaty thud. Pressing your crotch against those muscled cheeks from behind,[else]sliding a hand between the firm bunts of his ass and rubbing up and down. Pressing a finger in against his pucker, to be easily accepted by the well-trained opening,[end if] you revel for a second in the fact that even though you can feel his mighty muscles tighten and flex, the green brute doesn't really struggle against being man-handled in such a way. No - he's far too hungry for a hard shaft to pound his slutty ass. And you got just the right cock to do so...";
	if HP of Fang is 2: [Beta Fang]
		say "     Looking around in the library you spot your feral wolf pet right away - as Fang isn't all that far off, in a prime position to observe what you did with Mul. He's on his long rope leash, tied to a nearby shelf, and you know full well that it was anchored on the other side of the room when you came in. It doesn't bother you much that the wolf cleverly unties and reties his leash to move around. The fact that he does wear the collar you put on him and does his best to be a dutiful pet and watchdog is proof enough of his devotion to you. And that definitively deserves a reward. Commanding Mul to stay, like the obedient slut he is, you stroll over towards Fang while chuckling at the orc's reply of a somewhat annoyed, yet still compliant growl.";
		WaitLineBreak;
		say "     As you step up to your feral wolf pet, Fang greets you with a happily wagging tail, lifting his head and licking the hand of his master. Crouching down, you give the black and dark gray beast a good scritching, running your hands through his soft fur and inspecting the muscled shape of the canine. As your wandering hands get to his crotch, you feel the full orbs resting in his furred sack, as well as the already un-sheathed doggie cock dangling beneath his body like a knobby spear. He's more than ready to have some fun. You give the wolf's cock a few slow strokes, feeling his hot and hard bone under your fingers, then stand back up again. Telling the happily whining canine that he's been a good boy, you undo the knot of the leash on his collar, allowing him to run free - dashing straight for the waiting orc.";
		say "     You hear the victorious growl of a wolf taking down his prey as Fang pounces on Mul - jumping the bent-over male and thrusting his canine shaft between his buttocks with uncanny aim. The brutish orc gives a surprised grunt at the deep penetration, followed by another as Fang jams his knot past Mul's pucker in his second thrust. Stretching his body forward, the wolf bites Mul's neck lightly and holds on to him with his teeth - something that drives the orc's arousal through the roof, as nipping a breeder with their tusks is a sign of affection for the green-skinned brutes. Now having taken hold of his bitch, the wolf proceeds to buck into him hard and fast without any further delay. Wanting to enjoy himself to the fullest extent, Fang fucks Mul with unrestrained animalistic vigor, just pounding him as deep as he can.";
		WaitLineBreak;
		say "     It is good that Mul is an orc, strong and tough, plus ready to enjoy a really hard fuck, as Fang really takes out all the stops in ravaging the hole his master has given him. It doesn't take much of this anal assault - a hard cock hammering his prostate and the feeling of a canine knot inside his body - and Mul is driven over the edge for an almost mind-breaking orgasm. He howls, 'Fuck me. Fuckkk MMEEE! GOD! FUUUUCK!' and his thick cock starts to throb and blasts splashes of rich seed against the side of the sofa under him.";
		say "     Just watching Mul come from being fucked, then go right on rocking back to meet the feral wolf's next thrust as his cock is still spurting more cum is quite hot - but the [if cocks of player > 0]throb of your own cock[else if cunts of player > 0]tingle of your moist pussy[else]tingle of your sexless crotch[end if] makes you remember to tend to your own needs and not just be an observer, so you quickly strip and step up on the sofa yourself, sliding in between the backrest and where the groaning orc's head is. With his mouth open in almost constant panting and moaning from Fang's merciless humping, it is no problem at all to ";
		if cocks of player > 0:
			say "push your prick between those sexy lips, which reflexively close around your meat and start sucking. Ah, taming this brute was an awesome idea - having such a tough guy sucking you like a born cum-slut makes you feel powerful, as if you could rule this whole crazy place all of your own. As you shove your erection into Mul's throat, enjoying the tightness of his warm passage, you can't help but grin down at the horny canine still holding a soft grip on the orc's neck. A fitting companion in this new sex-crazed world - comes as a thought into your head, and you scratch him behind his ears as you continue to face-fuck Mul.";
		else if cunts of player > 0:
			say "pull him against your crotch, to bump into your dripping pussy. Even though he's not really used to female bits, it just takes a few pointers to get the orc licking and suckling on your clit. Ah, taming this brute was an awesome idea - having such a tough guy lapping away at your sex makes you feel powerful, as if you could rule this whole crazy place all of your own. As you push his nose against your pubic mound in ecstasy, you can't help but grin down at the horny canine still holding a soft grip on the orc's neck. A fitting companion in this new sex-crazed world - comes as a thought into your head, and you scratch him behind his ears as you continue to face-fuck Mul.";
		else:
			say "pull him against your crotch, to bump into your dripping pussy. Even though he's not really used to female bits, it just takes a few pointers to get the orc licking and suckling on your clit. Ah, taming this brute was an awesome idea - having such a tough guy lapping away at your sex makes you feel powerful, as if you could rule this whole crazy place all of your own. As you push his nose against your pubic mound in ecstasy, you can't help but grin down at the horny canine still holding a soft grip on the orc's neck. A fitting companion in this new sex-crazed world - comes as a thought into your head, and you scratch him behind his ears as you continue to face-fuck Mul.";
		say "     With the feral wolf still ravaging his ass and you having the orc service you orally, it doesn't take all that long until Mul's arousal builds up to another spectacular orgasm. With him gurgling and grunting [if cocks of player > 0]around your shaft[else]into your crotch[end if], his hands dig into the sofa padding and he bucks up against Fang, then his big prick starts to erupt with a veritable deluge of rich, creamy cum, spurting against the already-stained sofa and even making wet splashes on the ground when the soaked fabric simply can't absorb any more and he still blasts away more of his orcish seed. In the throes of his climax, Mul's throat muscles and tongue, as well as anal muscles, tremble and flex like crazy - which drives both you and your wolf pet over the edge right with him. [if cocks of player > 0]Driving in all the way until the orc's nose is buried deep in your pubes, you let go a full load of cum, shouting in satisfaction as you fill your half-tamed orc warrior with your seed[else if cunts of player > 0]Grabbing Mul's head and pulling him tight against your crotch, your pussy starts to spurt femcum, splashing your half-tamed orc warrior's face wetly[else]Grabbing Mul's head and pulling him tight against your crotch, you tremble in lust at the touch of his lapping tongue[end if]. In the meantime, Fang raises his head to howl as he breeds Mul good, knot swelling up even further to tie them together tightly as his virile semen splashes against the orc's prostate and quickly fills up his insides.";
		WaitLineBreak;
		say "     For several long moments, nothing but heavy breathing and panting fills the library as all of your orgasms slowly wind down and cocks spill forth the last ebbing spurts of cum in this hole or that, or on the ground. Satisfied with having gotten your rocks off, you pull away from Mul's mouth a short while later, allowing the orc's slurred exclamation of, 'Nnnnggh. Damn. Been fucked by an animal...' He doesn't get any further as Fang grips his neck between his teeth a bit tighter, almost as if to say, 'Yup, and you're my bitch now.' The bite pushes Mul to give an involuntary moan in new arousal, something that the proud canine on top of him rewards with a throaty rumble. Then the feral beast starts to lick the salty sweat off Mul's neck and muscled back, wanting to take care of his bitch while waiting for his knot to go down.";
		say "     Grinning at the scene of the feral wolf knotted to Mul's ass, lapping away at his new fuck-toy, you move to collect your gear again and get dressed. With a look back at the two of them, you tell the wolf to be a good boy and howl when he's ready to go on the leash again, then walk away from the stained sofa and the two males on it. Moving to another part of the big library ground floor, you try to concentrate on other matters - like surviving in this crazy place - but your thoughts often return to the hunky orc, hoping he'll come over more often in the future.";
	else if HP of Fang > 2: [Alpha Fang]
		say "     Looking around in the library you spot your feral wolf alpha right away - as Fang isn't all that far off, in a prime position to observe what you are doing with the new bitch you brought. He stands proudly on all four legs, a picture of strength and virility with a well-muscled form covered in black and dark gray fur. Clearly enjoying the show, the wolf's canine cock dangles erect between his legs, even dripping a little pre-cum from the pointed tip. Looks like it is definitively time to give your alpha the his right of sampling the orcish slut you've brought into the lair. Giving Mul's raised ass a slap that leaves a clear hand-print, at least for a few seconds, you back away a little and step to the side, clearing a direct path for Fang to the waiting male. The wolf gives a chuff and trots forward, giving you a sniff and quick lick to express his satisfaction, then dashes forward to close with the sofa.";
		say "     You hear the victorious growl of a wolf taking down his prey as Fang pounces on Mul - jumping the bent-over male and thrusting his canine shaft between his buttocks with uncanny aim. The brutish orc gives a surprised grunt at the deep penetration, followed by another as Fang jams his knot past Mul's pucker in his second thrust. Stretching his body forward, the wolf bites Mul's neck lightly and holds on to him with his teeth - something that drives the orc's arousal through the roof, as nipping a breeder with their tusks is a sign of affection for the green-skinned brutes. Now having taken hold of his bitch, the wolf proceeds to buck into him hard and fast without any further delay. Wanting to enjoy himself to the fullest extent, Fang fucks Mul with unrestrained animalistic vigor, just pounding him as deep as he can.";
		WaitLineBreak;
		say "     It is good that Mul is an orc, strong and tough, plus ready to enjoy a really hard fuck, as Fang really takes out all the stops in ravaging the hole his master has given him. It doesn't take much of this anal assault - a hard cock hammering his prostate and the feeling of a canine knot inside his body - and Mul is driven over the edge for an almost mind-breaking orgasm. He howls, 'Fuck me. Fuckkk MMEEE! GOD! FUUUUCK!' and his thick cock starts to throb and blasts splashes of rich seed against the side of the sofa under him.";
		say "     Just watching Mul come from being fucked, then go right on rocking back to meet the feral wolf's next thrust as his cock is still spurting more cum is quite hot - but the [if cocks of player > 0]throb of your own cock[else if cunts of player > 0]tingle of your moist pussy[else]tingle of your sexless crotch[end if] makes you remember to tend to your own needs and not just be an observer, so you quickly strip and step up on the sofa yourself, sliding in between the backrest and where the groaning orc's head is. With his mouth open in almost constant panting and moaning from Fang's merciless humping, it is no problem at all to ";
		if cocks of player > 0:
			say "push your prick between those sexy lips, which reflexively close around your meat and start sucking. Ah, taming this brute was an awesome idea - having such a tough guy sucking you like a born cum-slut makes you feel powerful, as if you could rule this whole crazy place all of your own. As you shove your erection into Mul's throat, enjoying the tightness of his warm passage, you can't help but grin down at the horny canine still holding a soft grip on the orc's neck. A fitting alpha to follow in this new sex-crazed world - comes as a thought into your head, and you scratch him behind his ears as you continue to face-fuck Mul.";
		else if cunts of player > 0:
			say "pull him against your crotch, to bump into your dripping pussy. Even though he's not really used to female bits, it just takes a few pointers to get the orc licking and suckling on your clit. Ah, taming this brute was an awesome idea - having such a tough guy lapping away at your sex makes you feel powerful, as if you could rule this whole crazy place all of your own. As you push his nose against your pubic mound in ecstasy, you can't help but grin down at the horny canine still holding a soft grip on the orc's neck. A fitting alpha to follow in this new sex-crazed world - comes as a thought into your head, and you scratch him behind his ears as you continue to face-fuck Mul.";
		else:
			say "pull him against your crotch, to bump into your sexless pubic mound. Even though he's rather perplexed by the absence of visible genitalia, it just takes a few pointers to get the orc licking on sensitive spots. Ah, taming this brute was an awesome idea - having such a tough guy lapping away at your sex makes you feel powerful, as if you could rule this whole crazy place all of your own. As you push his nose against your pubic mound in ecstasy, you can't help but grin down at the horny canine still holding a soft grip on the orc's neck. A fitting alpha to follow in this new sex-crazed world - comes as a thought into your head, and you scratch him behind his ears as you continue to face-fuck Mul.";
		say "     With the feral wolf still ravaging his ass and you having the orc service you orally, it doesn't take all that long until Mul's arousal builds up to another spectacular orgasm. With him gurgling and grunting [if cocks of player > 0]around your shaft[else]into your crotch[end if], his hands dig into the sofa padding and he bucks up against Fang, then his big prick starts to erupt with a veritable deluge of rich, creamy cum, spurting against the already-stained sofa and even making wet splashes on the ground when the soaked fabric simply can't absorb any more and he still blasts away more of his orcish seed. In the throes of his climax, Mul's throat muscles and tongue, as well as anal muscles, tremble and flex like crazy - which drives both you and your alpha wolf over the edge right with him. [if cocks of player > 0]Driving in all the way until the orc's nose is buried deep in your pubes, you let go a full load of cum, shouting in satisfaction as you fill your half-tamed orc warrior with your seed[else if cunts of player > 0]Grabbing Mul's head and pulling him tight against your crotch, your pussy starts to spurt femcum, splashing your half-tamed orc warrior's face wetly[else]Grabbing Mul's head and pulling him tight against your crotch, you tremble in lust at the touch of his lapping tongue[end if]. In the meantime, Fang raises his head to howl as he breeds Mul good, knot swelling up even further to tie them together tightly as his virile semen splashes against the orc's prostate and quickly fills up his insides.";
		WaitLineBreak;
		say "     For several long moments, nothing but heavy breathing and panting fills the library as all of your orgasms slowly wind down and cocks spill forth the last ebbing spurts of cum in this hole or that, or on the ground. Satisfied with having gotten your rocks off, you pull away from Mul's mouth a short while later, allowing the orc's slurred exclamation of, 'Nnnnggh. Damn. Been fucked by an animal...' He doesn't get any further as Fang grips his neck between his teeth a bit tighter, almost as if to say, 'Yup, and you're my bitch now.' The bite pushes Mul to give an involuntary moan in new arousal, something that the proud canine on top of him rewards with a throaty rumble. Then the feral beast starts to lick the salty sweat off Mul's neck and muscled back, wanting to take care of his bitch while waiting for his knot to go down.";
		say "     Grinning at the scene of the feral wolf knotted to Mul's ass, lapping away at his new fuck-toy, you move to collect your gear again and get dressed. With a look back at the two of them, you tell the wolf to be a good boy and howl when he's ready to go on the leash again, then walk away from the stained sofa and the two males on it. Moving to another part of the big library ground floor, you try to concentrate on other matters - like surviving in this crazy place - but your thoughts often return to the hunky orc, hoping he'll come over more often in the future.";
	else:
		say "     ERROR: Unexpected Hp value for Fang: [HP of Fang] - please report this on the Forum or directly to Wahn.";
	if MulAnalAcceptance < 10:
		increase MulAnalAcceptance by 1;

to say MulLibrarySex8: [Threesome with Sven and Mul]
	say "     Opening the door to the library and walking inside, you beckon the orc to follow you and he complies, still with his dildo in hand. Now that you have this big brute all tamed and ready to serve, the mood strikes you to mix things up and see the orc together with your other pet, Sven. Grasping him by the shoulder, you guide Mul over to the bunker entrance, then down the multiple flights of stairs and into the main bunker room below. With the green brute by your side, you walk up to Sven's bed, where the sexy snow leopard lies on his belly, fluffy tail swishing lazily through the air above the cute butt of his as he reads a book. He's so concentrated on the text that he doesn't even realize anyone is close. Before you can say anything, Mul quickly catches the soft-furred appendage of your pet, pulling it up to reveal Sven's rosy pucker - giving a horny chuckle as he does so.";
	say "     Shocked at suddenly being man-handled like this, Sven twists around with his fur standing on end in fright. He wails, 'AAIIIIEE - HELP! MASTER - there's... oh,' then falls silent as he spots you past Mul's muscular form, giving him a mildly amused smile. The rapidly panting snowmeow gives a cute sigh at you being near, then says, 'Hello master. I - you brought a friend?' Mul completely ignores what the snow leopard says or does, instead putting a big hand on his tight buttocks, giving them a squeeze. The orc runs a thick finger up and down Sven's crack, making the snow leopard moan, then tells you, 'Nice little cock-warmer. Downright decent of you to give me something to pound while... you know, you friggin ass-pirate. Will have to take care I don't break him, though.'";
	WaitLineBreak;
	say "     Assuring the orc that really shouldn't be a problem, you step up to the bed and put a calming hand on the still slightly trembling snowmeow, then give him a good scritch behind the ear and earning a satisfied purr that way. In a gentle tone, you tell Sven that he will have some fun with you and your friend Mul, then beckon him to stand up. It is almost comical to see the two of them stand next to each other, Sven at just a little under five feet tall, while Mul towers over him with more than seven. You can't help but smirk at what you've planned next. Looking at the two waiting males, one big and muscled - the other slender and cute, you clear your throat. Then you tell Mul to get on all fours on the bed and Sven to eat his ass, get him ready for further fun first.";
	say "     The orc grunts at the smaller feline next to him, chuckling at how this makes Sven twitch in fright, then pulls his loincloth off and casually drops it on the ground. Under the wide-eyed gaze of Sven (at the size of the orc's dick), he then climbs on the snow-leopard's bed and leans forward. Mul grumbles a little under his breath, the usual bluster at getting fucked by you, but the fully hard and throbbing cock swinging between his legs shows that he's more than looking forward to a good dicking. Stroking down Sven's back, you gently push him forward and tell him to be a good pet, after which he obediently takes position behind the kneeling orc, bending his head to lap at Mul's crack. Watching the snowmeow go down on Mul, all the while still stroking Sven's soft fur yourself, it is obvious to you that the orc does enjoy the oral stimulation quite a bit. Seems like the somewhat rough feline tongue of your pet is right up the tough guy's alley.";
	WaitLineBreak;
	say "     In between watching Sven lick Mul's butt-hole and also stroke and fondle the orc's thick cock and heavy balls, you first get rid of your own clothes, then concentrate your petting on the snowmeow's crotch. It doesn't take all that long before the happy little fucktoy is fully erect in your hand, his stiff rod feeling even hotter than the soft fur of Sven's body. With everything prepared now, you slide your arms under Sven's body from behind, reaching around to playfully pinch his nipples, then pull the slender guy up against your chest and give him a kiss. 'Oooh master,' he moans in contentment, feeling your erection press against his own buttocks, then gives a pleased purr as you say that it's time to fuck. You let your hands wander downward, caressing Sven's body, yet instead of reaching around to line your own cock up with his love-hole, you take a hold of the leopard's erection and push him forward to kneel right behind Mul.";
	say "     Giving a surprised yet definitively also aroused mrowl, Sven draws in a breath as you line him up with the orc's well-prepared opening. Brushing the side of your face against the soft shape of Sven's ear, you whisper for your pet to fuck the orc and hump against him with your hips, sending his manhood to penetrate Mul's pucker. The orc grunts in lust at feeling another man's shaft inside his body, not even realizing that it isn't you, but rather the subby snowmeow making use of him. As much as a butt-slut he now is, the green-skinned brute simply grips the sheets on the bed tighter and lowers his head to press it to the mattress, sliding his ass up just a little bit more. Meanwhile, Sven gives a few light bucks into the orc's stretched passage, then looks over his shoulder at you, purrumbling loudly but at the same time unsure in his role as the top right now.";
	WaitLineBreak;
	say "     It is fun to have Mul being fucked by a 'little cock-warmer', in his words, but it soon becomes clear that Sven doesn't quite have the temperament to make full use of the well-sized feline shaft of his. The needy grunt of, 'Harder! I'm not a pansy, fuck me harder!' that Mul gives just a moment later only illustrates the point - but you've already got a pleasurable solution. It takes just a moment to reach around and slide two fingers into Sven's moaning mouth, have the snowmeow suckle on them for a bit and then slicking up your own shaft with his spit. Then you line yourself up between his silky-smooth furred buttocks and thrust into the feline fucktoy - hard. The doubled-up moans from both Sven and Mul as you drive the snow-leopard's cock balls-deep into the orc are music to your ears.";
	say "     With soaring arousal, you fuck Sven - and through him Mul too - greatly enjoying the soft and warm furry shape against your body and driving the orc into the mattress with extra-hard thrusts. Ah, what a rush... from subby little exchange students to one of the biggest orcs you know of, no one can resist you! And now you're even enjoying two of them at the same time! All of which drives your lust to ever new heights in short notice, until finally, you can't contain it anymore. Withe an aroused grunt, you buck into Sven all the way one last time, grinding against his amazing ass as the first blasts of cum paint his insides white. You hug him tight against you and give the moaning young man a deep kiss, pushing him past his own point of no return as you do so. Trembling in your arms, the slender snow leopard twitches rhythmically and gives cute little gasps as he deposits his own load into Mul's ass.";
	WaitLineBreak;
	say "     The two of you are breathing hard, holding on to one another as you ride out your respective orgasms. Yet there is a third member of your little threesome, and as further thrusts stop coming, Mul rocks back against Sven's still cumming shaft for a few seconds, then twists to look over his shoulder and growl, 'What's the holdup back th- hey! You made that fucking pussy fuck me?! I knew there was something strange about those weak-ass thrusts at first.' Mul sounds a bit annoyed, though you'd guess it's mostly because the fucking stopped and he's not got off yet...";
	LineBreak;
	say "     What now?";
	say "     ([link]Y[as]y[end link]) - You're still horny and your dick's getting harder by the second at the thought of having a go at Mul's cum-slick fuckhole.";
	say "     ([link]N[as]n[end link]) - Grab the dildo and fuck Mul with it until he blows.";
	if player consents:
		LineBreak;
		say "     Well, you can't leave the horny butt-slut hanging, can you? Just the thought of hammering into his cum-slick butt makes you go fully hard again in seconds! Giving your exhausted but happy snowmeow pet another kiss, you move backwards on your knees and take him with you, making Mul groan in arousal as the feline shaft slips out of his hole with a wet slurp. Gently lowering Sven to curl up on the bed, you then get into position behind the waiting orc and thrust into him all the way in one deep plunge. Mmmh, he feels great around your shaft - warm and wet with Sven's load, tensing his muscles just the right way to tightly grip your manhood. Without hesitation, you proceed to fuck him in a rapid tempo, really pounding your hips against his muscled buttocks and making the bunker ring with slapping noises as your crotch meets his ass.";
		say "     And that is exactly what Mul wants - what he needs, really. He's an orc after all - strong and tough, ready to take whatever you can dish out for him as a bottom-boy. Having reached around him to take hold of Mul's own thick shaft, you can feel it twitch and pulse each time you give him an especially deep thrust. In a wild and exhilarating ride, you soon drive the big man closer and closer to the edge, his grunts and moans coming quicker and becoming slightly higher pitched. Eventually, he even forgets his stubborn pride completely in the heat of sex and the orc starts to shout, 'Yeah, take me! Faster! Pound my ass! Ngh - Nnngh! More! NnnnngggghhhHH!' With that last drawn-out roar, Mul starts to cum, his shaft rhythmically pulsing in your hand as stream after stream of cum blasts through it and covers Sven's bed in sticky white splashes. With each spurt of the orc's seed, all the muscles in Mul's body twitch and tense - including those inside his ass, around your shaft. This results in you joining your brutish partner in orgasm just moments later, gripping him tightly around the hips as your balls start to unload everything they got left. Your seed gets pumped into Mul in weighty bursts, filling him up with creamy cum.";
		WaitLineBreak;
		say "     After blasting the last few spurts of your orgasm into Mul, you pull out of him with a slurp and leave the large orc to sink down on the bed, coming to lay on the cum-soaked sheets. He huffs a few more times, then dozes off in exhaustion. Standing up from the bed, you take in your handiwork - one mighty orc warrior sprawled out on Sven's cum-splattered bed, and the well-satisfied snowmeow pet cuddling up against his side to rest comfortably together with Mul. The very self-satisfied smile on your lips stays with you the whole time as you get dressed, then leave the freshly-bred orc to rest, together with your other pet. Eventually, he'll be starting a walk of shame back to the orc lair - in all likelihood making up some fancy story about this or that creature he fucked to tell his brothers and other orc buddies...";
	else:
		LineBreak;
		say "     Well, you can't leave the horny butt-slut hanging, can you? While your own cock is just a bit sensitive and fucked-out right now, the big dildo the orc brought with him will more than make up for that. Giving your exhausted but happy snowmeow pet another kiss, you move backwards on your knees and take him with you, making Mul groan in arousal as the feline shaft slips out of his hole with a wet slurp. Gently lowering Sven to curl up on the bed, you then quickly snatch up the dildo from where it has fallen beside the bed and get into position behind the waiting orc. With a quick jab of the rubber sex toy, you thrust it into him all the way in one deep plunge. Mmmh, such a sexy groan from taking a hard dick. Without hesitation, you proceed to fuck him with the toy in a rapid tempo, really hammering it in between those buttocks, then twisting and wiggling it as you pull the dildo back out.";
		say "     And that is exactly what Mul wants - what he needs, really. He's an orc after all - strong and tough, ready to take whatever you can dish out for him as a bottom-boy. Having reached around him to take hold of Mul's own thick shaft, you can feel it twitch and pulse each time you give him an especially deep thrust. In a wild and exhilarating ride, you soon drive the big man closer and closer to the edge, his grunts and moans coming quicker and becoming slightly higher pitched. Eventually, he even forgets his stubborn pride completely in the heat of sex and the orc starts to shout, 'Yeah, take me! Faster! Pound my ass! Ngh - Nnngh! More! NnnnngggghhhHH!' With that last drawn-out roar, Mul starts to cum, his shaft rhythmically pulsing in your hand as stream after stream of cum blasts through it and covers Sven's bed in sticky white splashes. With each spurt of the orc's seed, all the muscles in Mul's body twitch and tense - including those inside his ass, around the dildo in your hand, making it twitch in rhythm with his orgasm.";
		WaitLineBreak;
		say "     After twisting and turning the rubber cock inside Mul a few times, earning deep groans each time, you pull out of him with a slurp and leave the large orc to sink down on the bed, coming to lay on the cum-soaked sheets. He huffs a few more times, then dozes off in exhaustion. Standing up from the bed, you take in your handiwork - one mighty orc warrior sprawled out on Sven's cum-splattered bed, and the well-satisfied snowmeow pet cuddling up against his side to rest comfortably together with Mul. The very self-satisfied smile on your lips stays with you the whole time as you get dressed, then leave the freshly-bred orc to rest, together with your other pet. Eventually, he'll be starting a walk of shame back to the orc lair - in all likelihood making up some fancy story about this or that creature he fucked to tell his brothers and other orc buddies...";
	if MulAnalAcceptance < 10:
		increase MulAnalAcceptance by 1;

to say MulLibrarySex9: [Toy Show]
	say "     In the mood for a little show of his need to be fucked, you order the horny orc to lie down, pointing at a large sofa standing in a reading group pretty much in the middle of the library's ground floor. There, he'll be on center stage for anyone else in the building, or even someone who just comes along and looks through the glass front doors. Following Mul as he obeys, you take a moment to savor the sight of such a magnificent male following your commands and lying down where you tell him, pulling off his loincloth as he does so. He's totally waiting to be taken, and you kneel between his spread legs to stroke the inside of his thighs. Oh yeah, this takes you back to fucking him for the first time, and you almost [if cocks of player > 0]want to simply sink your cock into him right now[else]want to finger-fuck him right now[end if] - but no, you keep your original idea in mind and hold yourself back. It is time for the big brute to show just how badly he craves a hard dick in his ass. As wound up as you have him by now, he starts to raise his legs all on his own, baring the enticing rosette of his pucker, which even 'winks' at you as Mul relaxes his muscles, then tenses them again.";
	say "     You teasingly stroke up and down over his open butt-crack, drawing deep moans from the needy orc before moving back a little and reaching for the well-sized dildo he brought along. Mul stays in his position for a long moment, just lying back with closed eyes and waiting for your next touch, but eventually raises his head to look at you and give an impatient grunt. His eyes narrow as the green-skinned brute sees you looking at him expectantly, his sex-toy in hand. 'What'cha doing?' he mumbles, raising his ass a little bit more as he adds, 'Go on, fuck me! I wanna feel it!' Yet you don't get to work on him, as he expects, instead just swiping up a drop of pre-cum from the tip of his cock and smearing that over the dildo. Then you hold it out to him with a grin on your face and tell the orc to fuck his own ass with it, prove to you what a needy butt-slut he's become. As Mul starts grumbling, 'I didn't come here just to -' you give his butt a slap and tell him that he came because he's your bitch. And if you want him to stick that dildo up his rear, he'll very well do it.";
	WaitLineBreak;
	say "     Giving a grunt and baring his tusks, the orc frowns and stares into your eyes - only to look down at the dildo after a long moment and giving in. Accepting the rubber toy as you hold it out, the big brute strokes his cock some more, rubbing its pre-cum leaking tip against the dildo. Soon, it's glistening wet, at which point Mul guides the artificial cock between his legs, pressing it in against a well-trained pucker. With a mixture of a moan and a sigh, the toy slides home into the orc's rear and he immediately starts to work it in and out of his ass again. In short order, Mul is trembling with lust, one hand hand clenching in its grasp of the sofa cushions while his other one works tirelessly between his legs. His head lays back and presses against the sofa, eyes closed as he imagines... in all likely-hood yourself, thrusting into his needy passage.";
	say "     Seeing the ruggedly handsome face of your green-skinned playmate, you get a naughty idea of what you could do with the usually so gruff orc... so you move around the orc a bit, grip his shoulders and plant a hungry kiss right on his spread lips, invading his mouth with your tongue. Mul's eyes open in a flash and he gives you a shocked expression, bucking up reflexively as if to sit up - but the moment of resistance is short-lived. The pleasure he gets from your lips and tongue pushes aside the inherent worry of acting in a way that's 'not manly' - which leaves you with an eager, but inexperienced partner in making out. Sharing a very satisfying snog with the orc, you think about how you want to deal with your own arousal at being able to make him do all this. ";
	if cocks of player > 0:
		say "The erection throbbing between your legs definitively needs some attention soon. There's only the question which end of your sexy orc you'll make use of to get off.";
		LineBreak;
		say "     ([link]Y[as]y[end link]) - Double-penetrate him together with the dildo.";
		say "     ([link]N[as]n[end link]) - Face-fuck him.";
		if player consents:
			LineBreak;
			say "     Pulling away from sucking on Mul's tongue and sharing his breath in a deep kiss, you smile at the orc and tell him that since he wanted your cock so badly, he'll get it. And with that said, you move around back between his legs, then line your shaft up with his already occupied ass. Before he can do anything more than give the start of a grunt and begin to pull the dildo out, you simply thrust forward and push your manhood in beside the sex toy - hammering it home together with your own erection. Moaning wildly at the sudden double-penetration, Mul bucks on the sofa as he tries to accommodate your cock too. 'Yeaarrgh! Guess that's how it feels to push an orcling out!' the orc groans breathlessly, clearly straining with the treatment - yet also intensely aroused at the hard fuck. After all, he's an orc - big, though and strong, so Mul can take a lot of punishment.";
			say "     When you start fucking into him with the dildo pressed tight against your boner and sliding along with it, the orc goes wild, shouting nearly unintelligible screams and moans as he bucks with every thrust. There is not a hint of his usually so stubborn pride, as it is completely forgotten in the heat of sex, with him roaring, 'Ngh - Nnngh! More! NnnnngggghhhHH! Pound my ass!' It doesn't take much longer of this extreme fuck before you drive Mul over the edge and he starts to cum, his shaft rhythmically pulsing as he gets off hands-free, just from the feeling of being fucked hard. Stream after stream of cum blasts out of his trobbing cockhead and splatters all over the orc's chest and face.";
			WaitLineBreak;
			say "     With each spurt of the orc's seed, all the muscles in Mul's body twitch and tense - including those inside his ass, around your shaft. What a sexy, tight-assed bitch you've tamed for yourself. Humping into him with unrestrained intensity even as he is still cumming, you revel in every moment of seeing him cream himself, your own arousal soaring with each splat of cum on his broad chest. This results in you joining your brutish partner in orgasm just a few moments later, bucking up against him as your balls start to unload everything they got. Your seed gets pumped into Mul in weighty bursts, filling him up with creamy cum. As your shaft continues to pulse with spurts of cum, Mul writhes under you, clearly overwhelmed by feeling the injection of another male's seed into his hungry hole.";
			say "     Then suddenly, Mul's whole body bucks up, muscles straining and bulging as he shouts, 'BREED ME, YOU FUCKER! YEAHHHHHRRGH!' Both legs wrapping around your body, holding you tight and pressing you into him even harder, the orc's muscled frame is rocked by another orgasm, forcing another heavy gush of seed from his balls before the previous ones have even fully ebbed off. With an unintelligible grunt of pure lust, the thick green pole between his legs sends forth a long spurt that hits Mul right in the face, painting him in white splashes. Another and another follow with each passing second, turning your bottom-boy orc into a total cum-drenched mess. As the height of the climax is over, Mul plops down bonelessly on his back, totally exhausted by two cumshots in immediate succession.";
			WaitLineBreak;
			say "     You let the orc catch his breath, stroking and feeling his body at your leisure, now that you've got him worn out and as docile as he'll ever get. Even pulling his head up to yours and giving him a lusty kiss, you bask in the situation for a moment or two, then put a hand on the dildo, holding it fast as you slide your own softening prick from his rear. The severely stretched pucker on your orcish butt-slut proves to have the same regenerative power as the rest of his body, firming up and shrinking flexibly to soon fit snugly around the remaining dildo. Looking down at the fucked-out orc, you give him a playful slap on the butt and tell him what a good bitch he's become. There is a little grumble in reply, but that's it, as the orc proceeds to wipe up the gianz mess of cum from his face and washboard abs, sucking it off his fingers hungrily. Hah, what a slut.";
		else:
			LineBreak;
			say "     Pulling away from sucking on Mul's tongue and sharing his breath in a deep kiss, you smile at the orc and tell him that his mouth will get a workout too. And with that said, you move and straddle his chest, right over the wide and muscled pecs. Taking hold of the orc's head behind his pointy ears, you pull him against your crotch, bumping his lips with your hard cock. Reflexively, he envelops your manhood and starts sucking. Ah, taming this brute was an awesome idea - having such a tough guy sucking you like a born cum-slut makes you feel powerful, as if you could rule this whole crazy place all of your own. As you shove your erection into Mul's throat, enjoying the tightness of his warm passage, you can't help but look over your shoulder at him still fucking himself and grin wildly.";
			say "     With the big orc still working his own rear hard, it doesn't take all that much longer till he is driven over the edge and starts to cum, his shaft rhythmically pulsing and sending stream after stream of cum blasting out. Quite a bit of it hits your back and buttocks, splattering your body to trickle down afterwards and drip back on Mul himself. In the throes of his climax, Mul's throat muscles and tongue, tremble and flex like crazy - which drives you over the edge right with him. Driving in all the way until the orc's nose is buried deep in your pubes, you let go a full load of cum, shouting in satisfaction as you fill your half-tamed orc warrior with your seed.";
	else:
		if cunts of player > 0:
			say "     Pulling away from sucking on Mul's tongue and sharing his breath in a deep kiss, you smile at the orc and tell him that his mouth will get a workout too. And with that said, you move and straddle his chest, right over the wide and muscled pecs. Taking hold of the orc's head behind his pointy ears, you pull him against your crotch, to bump into your dripping pussy. Even though he's not really used to female bits, it just takes a few pointers to get the orc licking and suckling on your clit. Ah, taming this brute was an awesome idea - having such a tough guy lapping away at your sex makes you feel powerful, as if you could rule this whole crazy place all of your own. As you push his nose against your pubic mound in ecstasy, you can't help but look over your shoulder at him still fucking himself and grin wildly.";
		else:
			say "     Pulling away from sucking on Mul's tongue and sharing his breath in a deep kiss, you smile at the orc and tell him that his mouth will get a workout too. And with that said, you move and straddle his chest, right over the wide and muscled pecs. Taking hold of the orc's head behind his pointy ears, you pull him against your crotch, to bump into your sexless pubic mound. Even though he's quite baffled by the absence of visible genitalia, it just takes a few pointers to get the orc licking and suckling on a few very sensitive spots. Ah, taming this brute was an awesome idea - having such a tough guy lapping away at your sex makes you feel powerful, as if you could rule this whole crazy place all of your own. As you push his nose against your pubic mound in ecstasy, you can't help but look over your shoulder at him still fucking himself and grin wildly.";
		say "     With the big orc still working his own rear hard, it doesn't take all that much longer till he is driven over the edge and starts to cum, his shaft rhythmically pulsing and sending stream after stream of cum blasting out. Quite a bit of it hits your back and buttocks, splattering your body to trickle down afterwards and drip back on Mul himself. In the throes of his climax, Mul's throat muscles and tongue, tremble and flex like crazy - which drives you over the edge right with him. Grabbing Mul's head and pulling him tight against your crotch, [if cunts of player > 0]your pussy starts to spurt femcum, splashing your half-tamed orc warrior's face wetly[else]you tremble in lust at the touch of his lapping tongue[end if].";
	WaitLineBreak;
	say "     The very self-satisfied smile on your lips stays with you the whole time as you get dressed, then leave the freshly-bred orc to lap up all the cum he can get before eventually starting a walk of shame back to the orc lair - in all likely-hood making up some fancy story about this or that creature he fucked to tell his brothers and other orc buddies...";
	if MulAnalAcceptance < 10:
		increase MulAnalAcceptance by 1;

Mul ends here.
