Version 1 of Naiad by Wahn begins here.
[Version 1.2 - Endings adjusted]

"Adds a Naiad to Flexible Survival's Wandering Monsters table."

Section 1 - Creature Responses

to say Naiad Wins:
	say "     The last of your resistance melts away and you stand dazedly in front of the naiad. She pulls your mouth to hers for a kiss that takes your breath away for a moment, then leads you off towards the nearby building holding the athletic swimming pools. Soon you're standing on the ceramic tiles next to the pool, your eyes glued to your captor's naked form as she does an expert dive and glides through the water.";
	say "     'Come in, I'm waiting...' she calls as she surfaces again, prompting you to almost rip your clothes off. You jump in with moderately big splash, then start to swim towar- hm, where is she? That question immediately answers itself as you feel the beautiful female's hands stroke the insides of your legs as she moves them upwards towards your crotch.";
	if Player is male:[male+herm]
		say "     The naiad grabs hold of your cock and balls, stroking up and down on your shaft until you're hard as you can get. Then you feel her lips touch the tip of your manhood in a small kiss, followed by her sliding it into her mouth and bobbing up and down on it. It feels amazing, but you have to wonder when she'll come up to breathe. Maybe she doesn't have to, as she stays underwater for minute after minute, giving you an exceptionally good blowjob.";
		say "     Then suddenly, she pulls off your cock and surfaces, going in for a deep kiss with you. Smiling, she says 'Let's try something different' and wraps her legs around your hips, pulling herself tight against you. Reaching down with one hand, she guides your cock into her vagina, giving a pleased moan as she sinks down on the hard shaft. Then she starts fucking herself on your manhood, grinding her hips against yours and panting in lust.";
		LineBreak;
		say "     Being inside her is better than you could have dreamed and she has a nifty trick of gripping your shaft with some nicely developed muscles in her vagina, but that doesn't make it easy for you to concentrate on staying afloat. As she slams herself down on your shaft hard, you get pushed underwater and have to struggle a bit to get up again, gasping for air. The naiad comments with one a bit shame-reddened face 'Oh yes, you need to breathe... sorry, I forgot.' With a sigh, she pulls herself off your body and darts towards the nearest corner of the pool, taking position in it. With her back to the corner, she rests both her arms on the pool edges left and right, which raises her perfect breasts above the waterline for you to see.";
		say "     Eager to continue, you swim over and join her in the corner. While your feet find the ledge down on the pool wall to stand on, your hands are drawn to her breasts, feeling and caressing their round shapes. Moving on from there, you run your hands down her sides until you reach her hips, then hold on to them and pull yourself against her. It's such a great feeling to enter her body again, sliding into that warm cave, then thrusting in and out. Without the danger of drowning, you can take the stops out now, fucking her hard and fast, filling the pool hall with both your moans and gasps.";
		say "     Going at it with deep thrusts, fondling and sucking on her nipples, it doesn't take much longer until your sexy naiad's moans rise in pitch and volume and she finally gives a satisfied scream of lust as she orgasms, clutching your body tightly against hers. Having sex with this supernatural beauty and getting her to come gives your arousal quite a boost, which makes the need to cum rise quickly inside you. You manage another two, three thrusts, then slam forward and sink all of your hard shaft inside her as you start shooting long strings of cum. Breathing hard, you press your lips to hers and make out while your balls pump more and more cum into her womb.";
		LineBreak;
		say "     After enjoying some more time in the pool with her, getting down from your orgasm high and enjoying the view of her naked form, you gather your clothes and step back out onto the wild college campus.";
	else if Player is female:[female]
		say "     The naiad strokes your sensitive pussy lips, rubbing her fingers up and down over them. Then you feel her lips touch your pubic mound, giving you a few small kisses, followed by her tongue pushing in between your nether lips. She gives you a few licks, then pushes in a finger, then two, fondling your hole before she goes back to licking it. It feels amazing, but you have to wonder when she'll come up to breathe. Maybe she doesn't have to, as she stays underwater for minute after minute, giving you an exceptionally good oral experience.";
		say "     Then suddenly she surfaces, going in for a deep kiss with you. Smiling, she says 'Let's try something different' and pushes down on your shoulders. Willing to return the favor, you duck underwater and go for her crotch, fondling and licking her. Seems like you're well received, as she writhes in pleasure and lowers her arms to hold you against her and stroke your head and shoulders. If only she wouldn't hold on so tight... you're getting a bit short on oxygen and only when you struggle does she let go. With a desperate kick you push yourself up to the surface, gasping for air. The naiad comments with one a bit shame-reddened face 'Oh yes, you need to breathe... sorry, I forgot.' With a sigh, she darts towards the edge of the pool and pulls herself up on it, giving you a nice view of her back and pert ass. Turning around she sits on the edge, then waves for you to come over before she leans back on her elbows and spreads her legs a bit.";
		say "     Eager to continue, you swim over and join her, your legs feet searching out the ledge down on the pool wall to stand on. Stroking her sides, then sliding your hands further up, you caress the naiad's breasts, feeling and caressing their round shapes. Then you bring them back down again to stroke her pussy lips and hold them open as you lick her, making your supernatural beauty gasp and pant in lust. You spend some time pleasing her with your tongue, then start inserting first one, then multiple fingers into her vagina. Being a woman yourself, you know exactly how to fondle her love channel and get her more and more aroused. Before long, your sexy naiad's moans rise in pitch and volume and she finally gives a satisfied scream of lust as she orgasms and femcum starts running over your fingers to drip into the water.";
		say "     Getting this supernatural to come gives your arousal quite a boost, and you bring your hands towards your own pussy to stroke yourself to completion. Still softly moaning between words, the naiad says 'Stop. I'll help you with that' then slides into the pool and moves against you underwater. It doesn't take much stroking and licking until you gasp and have to hold on to the edge of the pool as you orgasm.";
		LineBreak;
		say "     After enjoying some more time in the pool with her, getting down from your high and enjoying the view of the naiad's naked form, you gather your clothes and step back out onto the wild college campus.";
	else:[neuter]
		say "     The naiad strokes your genderless crotch, rubbing her fingers over the more sensitive skin there. Then you feel her lips touch your skin, giving you a few small kisses, followed by her tongue licking the insides of your legs, then up between them and over your crotch. Even though you don't have any real genitals, it's still very enjoyable. It feels amazing, but you have to wonder when she'll come up to breathe. Maybe she doesn't have to, as she stays underwater for minute after minute, giving you an exceptionally good oral experience.";
		say "     Then suddenly she surfaces, going in for a deep kiss with you. Smiling, she says 'Let's try something different' and pushes down on your shoulders. Willing to return the favor, you duck underwater and go for her crotch, fondling and licking her. Seems like you're well received, as she writhes in pleasure and lowers her arms to hold you against her and stroke your head and shoulders. If only she wouldn't hold on so tight... you're getting a bit short on oxygen and only when you struggle does she let go. With a desperate kick you push yourself up to the surface, gasping for air. The naiad comments with one a bit shame-reddened face 'Oh yes, you need to breathe... sorry, I forgot.' With a sigh, she darts towards the edge of the pool and pulls herself up on it, giving you a nice view of her back and pert ass. Turning around she sits on the edge, then waves for you to come over before she leans back on her elbows and spreads her legs a bit.";
		say "     Eager to continue, you swim over and join her, your legs feet searching out the ledge down on the pool wall to stand on. Stroking her sides, then sliding your hands further up, you caress the naiad's breasts, feeling and caressing their round shapes. Then you bring them back down again to stroke her pussy lips and hold them open as you lick her, making your supernatural beauty gasp and pant in lust. You spend some time pleasing her with your tongue, then start inserting first one, then multiple fingers into her vagina. Being a woman yourself, you know exactly how to fondle her love channel and get her more and more aroused. Before long, your sexy naiad's moans rise in pitch and volume and she finally gives a satisfied scream of lust as she orgasms and femcum starts running over your fingers to drip into the water.";
		LineBreak;
		say "     After enjoying some more time in the pool with her, during which she caresses you some more while you enjoy the view of the naiad's naked form, you gather your clothes and step back out onto the wild college campus.";

to say Naiad Loses:
	say "     With a wince and rather shocked expression on her face, the naiad falls on her shapely butt. 'Ow,' she says as she rubs her bruises, continuing with a sulky expression 'This isn't how it's supposed to be - mortals should be easier to control. Why do you resist? I just wanted to have some fun.'";
	wait for any key;
	if Player is neuter:
		say "     Not bothering to explain that you don't even have a gender right now and couldn't do much with her, you turn away and walk off, leaving a rather surprised and disappointed naiad behind.";
	else:
		say "[NaiadSexMenu]";

to say NaiadSexMenu:
	setmonster "Naiad";
	now sextablerun is 0;
	blank out the whole of table of fucking options;
	[]
	if Player is male:
		choose a blank row in table of fucking options;
		now title entry is "Fuck her pussy";
		now sortorder entry is 1;
		now description entry is "Slide your [Cock of Player] shaft into the naiad's moist pussy";
	[]
	if Player is male:
		choose a blank row in table of fucking options;
		now title entry is "Fuck her ass";
		now sortorder entry is 2;
		now description entry is "Take the Naiad's back door for a ride with your [Cock of Player] shaft";
	[]
	if Player is female:
		choose a blank row in table of fucking options;
		now title entry is "Let her lick your pussy";
		now sortorder entry is 3;
		now description entry is "Get some oral service from her";
	[]
	if Player is male:
		choose a blank row in table of fucking options;
		now title entry is "Make her blow you off";
		now sortorder entry is 4;
		now description entry is "Get some oral service from her";
	[]
	sort the table of fucking options in sortorder order;
	repeat with y running from 1 to number of filled rows in table of fucking options:
		choose row y from the table of fucking options;
		say "[link][y] - [title entry][as][y][end link][line break]";
	say "[link]0 - Nevermind[as]0[end link][line break]";
	while sextablerun is 0:
		say "Pick the corresponding number> [run paragraph on]";
		get a number;
		if calcnumber > 0 and calcnumber <= the number of filled rows in table of fucking options:
			now current menu selection is calcnumber;
			choose row calcnumber in table of fucking options;
			say "[title entry]: [description entry]?";
			if Player consents:
				let nam be title entry;
				now sextablerun is 1;
				if (nam is "Fuck her pussy"):
					say "[NaiadSex1]";
				else if (nam is "Fuck her ass"):
					say "[NaiadSex2]";
				else if (nam is "Let her lick your pussy"):
					say "[NaiadSex3]";
				else if (nam is "Make her blow you off"):
					say "[NaiadSex4]";
				wait for any key;
		else if calcnumber is 0:
			now sextablerun is 1;
			say "     Deciding you should focus on more important stuff right now, you turn away and walk off, leaving a rather surprised and disappointed naiad behind.";
			wait for any key;
		else:
			say "Invalid Option. Pick between 1 and [the number of filled rows in the table of fucking options].";
	clear the screen and hyperlink list;

to say NaiadSex1: [fucking]
	say "     Taking off your clothes, you grab hold of your already growing erection and stroke it till it's fully hard. Even though she had other plans, the naiad does look quite interested in your erect manhood. Well, she was horny enough to go out looking for someone to fuck. You nod to the small pile of your clothes and suggest she should lie down on them. Watching her beautiful naked body as she does so and spreads her legs a bit is quite a turn-on. It's so hot to see this supernatural beauty lie before you, ready to be fucked. You can't wait any longer, fall to your knees in front of her and move your hips forward, burying your [Cock of Player] shaft deep in her pussy. Your satisfied grunt is answered by her needful moan, then another and another as you start thrusting in and out.";
	say "     Being inside her is better than you could have dreamed and she has a nifty trick of gripping your shaft with some nicely developed muscles in her vagina. She makes you horny as fuck, fucking her with hard and deep thrusts and not holding back at all. Rutting on the ground like mating beasts, the two of you make quite a bit of noise and it's a wonder that doesn't attract any opportunistic creatures - especially as the naiad orgasms, screaming in lust as her pussy starts to drip with femcum. You're not far behind, slamming forward one last time and sinking all of your hard shaft inside her as you start shooting long strings of cum. Breathing hard, you press your lips to hers and make out while your balls pump more and more cum into her womb.";
	say "     You stay on top of - and inside - her for a while longer, making out, fondling and sucking her perfect breasts. Then you pull out and stand up, helping your sex partner to her feet. While you pick up your clothes and are busy putting them on, the naiad says 'That was satisfying - in a barbaric kind of way. I still don't know why you wouldn't just follow me to my much more comfortable and refreshing pool. This land sex is so sticky and dirty... I can't wait to get back in the water.' She walks off towards a large building you recognize as an athletic swimming complex.";

to say NaiadSex2: [anal fucking]
	say "     Taking off your clothes, you grab hold of your already growing erection and stroke it till it's fully hard. Even though she had other plans, the naiad does look quite interested in your erect manhood. Well, she was horny enough to go out looking for someone to fuck. You nod to the small pile of your clothes and suggest she should get down on them - and on all fours too. The young woman raises an eyebrow but still complies, kneeling down on the fabric and then bending forward. It is quite a turn-on to watch her beautiful naked body flex and move as she gets into position, then spreads her legs a bit and slides a hand under herself to rub the sensitive clit at the upper end of her nether lips. Seeing this supernatural beauty on all fours before you makes you almost painfully hard with the eagerness to sink into her. She moans softly from touching herself and throws you inviting looks over her shoulder while spreading her pussy with two fingers. This is one horny naiad you got...";
	say "     You can't wait any longer, fall to your knees just behind the blond beauty and guide your cock forward with one hand - bumping right into her offered and waiting pussy in your eagerness. Penetrating her with the tip of your shaft, you feel the welcoming wetness of her all around it and hear her give a satisfied moan - yet as enticing as it feels, this isn't the hole you want to take right now. With a groan at having to pull out, you slide your manhood out from between her spread nether lips, then align its glistening head with the transformed student's pucker. Before she can say more than, 'What!?' you plunge into your intended target with relish, burying your [Cock of Player] shaft deep in her back door. Your satisfied grunt is answered by a needful moan at being fucked, then another and another as you start thrusting in and out.";
	WaitLineBreak;
	say "     Being inside her is better than you could have dreamed. Once she has the time to adjust that you're fucking her in her other hole, the naiad shows that she has the trained muscles of a swimmer or gymnast - and that does mean all of them. There is this nifty trick she does of gripping your shaft tightly at just the right moments, intensifying the sensations of being inside the hot little minx. Everything about her makes you horny as hell, and you can't help but fuck her without holding back at all, going at it extra hard and deep thrusts. Rutting on the ground like mating beasts, the two of you make quite a bit of noise and it's a wonder that doesn't attract any opportunistic creatures - especially as the naiad orgasms, screaming in lust as her pussy starts to drip with femcum. You're not far behind, slamming forward one last time and sinking all of your hard shaft inside her ass as you start shooting long strings of cum. Breathing hard, you sink down over her back and wrap your arms around her, cupping the shapely breasts on her chest and nibbling at her ear while your balls pump more and more cum up into her ass.";
	say "     You stay on top of - and inside - the naiad for a while longer, fondling her body and perfect breasts. Eventually, when your cock starts going soft, you pull out and stand up, helping your sex partner to her feet. While you pick up your clothes and are busy putting them on, the naiad says 'That was satisfying - in a barbaric kind of way, with you violating my butt in such a strangely stimulating manner. Although it can't be denied that the perverted ideas of land-dwellers have some merits... I still don't know why you wouldn't just follow me to my much more comfortable and refreshing pool. Having sex in the dry is so sticky and dirty... I can't wait to get back in the water.' Giving you a little wave, she walks off towards a large building you recognize as an athletic swimming complex.";

to say NaiadSex3: [FF oral]
	say "     Taking off your clothes, you run a hand over your already quite moist pussy lips. Even though she had other plans, the naiad does look quite interested in your naked body. Well, she was horny enough to go out looking for someone to fuck. You nod to the small pile of your clothes and tell her to get on her knees and get ready to lick you. Watching her beautiful naked body as she does so and licks her lips is quite a turn-on. It's so hot to see this supernatural beauty before you, ready to please you orally.";
	say "     You can't wait any longer... stepping up to her, you put your hands on her head and pull her against your crotch. Going on from there, she starts licking your pussy lips, then pushes her tongue in between them, sometimes switching it up with fingers too for extra pleasure. Quite good with her tongue, this naiad. Her expert oral stimulation brings close to orgasm quickly and you hold her head tight against you as you cross the point of no return. Moaning and panting loudly, your body shakes as your pussy starts dripping with female juices, some squirts of femcum even hitting the naiad in the face and her beautiful hair.";
	say "     She doesn't look all that happy about that, saying 'Couldn't you just have followed me to my much more comfortable and refreshing pool? This land sex is so sticky and dirty... I can't wait to get back in the water.' While you grab your clothes and put them back on, she walks off towards a large building you recognize as an athletic swimming complex.";

to say Naiadsex4: [MF oral]
	say "     Taking off your clothes, you grab hold of your already growing erection and stroke it till it's fully hard. Even though she had other plans, the naiad does look quite interested in your erect manhood. Well, she was horny enough to go out looking for someone to fuck. You nod to the small pile of your clothes and say 'On your knees and get ready to suck me off.' Watching her beautiful naked body as she does so and licks her lips is quite a turn-on. It's so hot to see this supernatural beauty before you, ready to take your cock.";
	say "     You can't wait any longer... stepping up to her, you put your hands on her head and shove your hips forward, thrusting your [Cock of Player] shaft into her mouth. Going on from there, she bobs up and down on your cock, running her tongue over it for some extra pleasure and even deep throats it once or twice. Quite a little cocksucker, this naiad. Her expert oral stimulation brings close to cumming quickly and you'd guess she would have sucked the cum right out of you, but you have a different plan. Pulling back out of her mouth as you feel the need to come rising, you're just in time to shoot spurt after spurt of your seed all over the naiad's face, golden blond hair and breasts.";
	say "     She doesn't look all that happy about that, saying 'Couldn't you just have followed me to my much more comfortable and refreshing pool? This land sex is so sticky and dirty... I can't wait to get back in the water.' While you grab your clothes and put them back on, she walks off towards a large building you recognize as an athletic swimming complex.";

to say Naiad Desc:
	setmongender 4;
	say "     A strikingly beautiful woman crosses your path, her body completely naked and with small drops of water glistening all over her perfect skin. Pulling aside long blond hair to fall over her shoulder, she gives you a smile and somewhat hungry look. 'Come swim with me, it'll be unforgettable for you.'";
	say "     Something tells you that she won't take no for an answer...";

Section 2 - Creature Insertion

Table of Random Critters (continued)
NewTypeInfection (truth state)	Species Name	Name	Enemy Title	Enemy Name	Enemy Type	Attack	Defeated	Victory	Desc	Face	Body	Skin	Tail	Cock	Face Change	Body Change	Skin Change	Ass Change	Cock Change	str	dex	sta	per	int	cha	sex	HP	lev	wdam	area	Cock Count	Cock Length	Ball Size	Nipple Count	Breast Size	Male Breast Size	Cunt Count	Cunt Depth	Cunt Tightness	Libido	Loot	Lootchance	Scale (number)	Body Descriptor (text)	Type (text)	Magic (truth state)	Resbypass (truth state)	non-infectious (truth state)	Cross-Infection (text)	DayCycle	Altcombat (text)	BannedStatus (truth state)
--	--	--	--	--	--	--	--	--	--	--	--	--	--	--	--	--	--	--	--	--	--	--	--	--	--	--	--	--	--	--	--	--	--	--	--	--	--	--	--	--	--	--	--	--	--	--	--	--	--	--;

When Play begins:
	Choose a blank row from Table of Random Critters;
	now NewTypeInfection entry is false;
	now Species Name entry is "Naiad";
	add "Naiad" to infections of FemaleList;
	add "Naiad" to infections of Swimlist;
	add "Naiad" to infections of MagicalList;
	add "Naiad" to infections of MythologicalList;
	now Name entry is "Naiad";
	now enemy title entry is "";
	now enemy Name entry is "";
	now enemy type entry is 0; [non-unique enemy]
	now attack entry is "[one of]The naiad strokes your arm and you feel your will to resist weaken.[or]Giving you a seductive look, the naiad makes your thoughts wander, weakening your will to resist.[or]She comes up to you closely and pushes her naked body against yours. Why do you even resist this?[or]As she gives you a smile and a wink, images of the both of you frolicking in the water dance in front of your eyes. Distracted, you feel some of the need to resist drain away.[at random]";
	now defeated entry is "[Naiad Loses]";
	now victory entry is "[Naiad Wins]";
	now desc entry is "[Naiad Desc]";
	now face entry is "that of a very beautiful woman, with aquamarine blue eyes. Long strands of golden blond hair flow down over your shoulders";
	now body entry is "a well-shaped young woman's, with a slender and flexible build that seems made for swimming, darting and gliding through the water. Perfectly rounded perky breasts complete the picture that will take many a man's breath away with its supernatural beauty";
	now skin entry is "[one of]perfect[or]soft and sleek[or]beautiful[at random]";
	now tail entry is "Your shapely ass has just the right amount of pert buttcheeks to make it deliciously grab-able.";
	now cock entry is "[one of]amazing[or]perfect[or]human-like[at random]";
	now face change entry is "it flows like water and reshapes itself, creating a woman's face of exquisite beauty. Long strands of golden blond hair flow down over your shoulders and complete the picture";
	now body change entry is "your flesh flows like water, become more slender and flexible before finally stabilizing in the shape of a beautiful woman. Your breasts and curves now are absolutely perfect, one could say supernaturally so";
	now skin change entry is "any imperfections are quickly washed away, leaving you with smooth and beautiful skin";
	now ass change entry is "it becomes tight and shapely, with deliciously grab-able cheeks";
	now cock change entry is "it becomes a perfectly shaped human maleness";
	now str entry is 12;
	now dex entry is 22;
	now sta entry is 14;
	now per entry is 20;
	now int entry is 12;
	now cha entry is 12;
	now sex entry is "Female";          [ Defines which sex the infection will try and make you. current options are 'Male' 'Female' 'Both']
	now HP entry is 60;                 [ How many HP has the monster got? ]
	now lev entry is 8;                 [ Level of the Monster, you get this much HP if you win, or this much HP halved if you loose ]
	now wdam entry is 8;                [ Amount of Damage monster Does when attacking.]
	now area entry is "Campus";         [ Case sensitive]
	now Cock Count entry is 0;               [ number of cocks if sex is 'Male' or 'Both' ]
	now Cock Length entry is 0;
	now Ball Size entry is 0;          [ Size of balls ]
	now Nipple Count entry is 2;             [ Number of nipples. ]
	now Breast Size entry is 2;         [cup size as number, counting Flat Pecs = 0, A = 1, B = 2, ...]
	now Male Breast Size entry is 0; [ Breast size for if Sex="Male", usually zero. ]
	now Cunt Count entry is 1;               [ number of pussies if sex is 'Female' or 'Both' ]
	now Cunt Depth entry is 8;
	now Cunt Tightness entry is 6;
	now libido entry is 25;             [ Amount player Libido will go up if defeated ]
	now loot entry is "";               [ Loot monster drops, usually infective with the monster's _own_ strain (for example if there is a Cross-Infection from sex)]
	now lootchance entry is 0;          [ Chance of loot dropping 0-100 ]
	now scale entry is 2;               [ Number 1-5, approx size/height of infected PC body: 1=tiny, 3=avg, 5=huge ]
	now body descriptor entry is "[one of]sleek[or]flexible[or]slender[at random]";
	now type entry is "human-like";
	now magic entry is true;
	now resbypass entry is false;
	now non-infectious entry is false;
	now Cross-Infection entry is ""; [infection that this infection will give the player when they lose; can be left empty if they infect with the monster's own]
	now DayCycle entry is 0;      [ 0 = Up at all times; 1 = Diurnal (day encounters only); 2 = Nocturnal (night encounters only);]
	now altcombat entry is "default";
	now BannedStatus entry is false;

Table of New Infection Parts (continued)
Species Name	Name	Body Weight	Body Definition	Androginity	Head Change	Head Description	Head Adjective	Head Skin Adjective	Head Color	Head Adornments	Hair Length	Hair Shape	Hair Color	Hair Style	Beard Style	Body Hair Length	Eye Color	Eye Adjective	Mouth Length	Mouth Circumference	Tongue Adjective	Tongue Color	Tongue Length	Torso Change	Torso Description	Torso Adjective	Torso Skin Adjective	Torso Adornments	Torso Color	Torso Pattern	Breast Adjective	Breast Size	Male Breast Size	Nipple Count	Nipple Color	Nipple Shape	Back Change	Back Adornments	Back Skin Adjective	Back Color	Arms Change	Arms Description	Arms Skin Adjective	Arms Color	Locomotion	Legs Change	Legs Description	Legs Skin Adjective	Legs Color	Ass Change	Ass Description	Ass Skin Adjective	Ass Color	Ass Width	Tail Change	Tail Description	tail skin adjective	Tail Color	Asshole Depth	Asshole Tightness	Asshole Color	Cock Change	Cock Description	Cock Adjective	Cock Color	Cock Count	Cock Girth	Cock Length	Ball Description	Ball Count	Ball Size	Cunt Change	Cunt Description	Cunt Adjective	Cunt Color	Cunt Count	Cunt Depth	Cunt Tightness	Clit Size
--	--	--	--	--	--	--	--	--	--	--	--	--	--	--	--	--	--	--	--	--	--	--	--	--	--	--	--	--	--	--	--	--	--	--	--	--	--	--	--	--	--	--	--	--	--	--	--	--	--	--	--	--	--	--	--	--	--	--	--	--	--	--	--	--	--	--	--	--	--	--	--	--	--	--	--	--	--	--;

When Play begins:
	Choose a blank row from Table of New Infection Parts;
	now Species Name entry is "";
	now Name entry is ""; [matching infection name to Table of Random Critters]
	now Body Weight entry is 5; [scale of 1-9 for body weight, grouped into low weight (1-3), mid weight (4-6) and high weight (7-9)]
	now Body Definition entry is 5; [scale of 1-9 for body definition, grouped into low muscle (1-3), mid muscle (4-6), high muscle (7-9)]
	[Body Adjective is generated out of the body weight and body definition and can be used in scenes - one word descriptive adjective depending on weight and definition groups: low weight group: skinny/slender/lithe; mid weight group: average/fit/muscled; high weight group: pudgy/husky/jacked]
	now Androginity entry is 5; [1-9 scale of hypermasculine to hyperfeminine]
	[Gender Adjective is generated out of androginity 1-9: hypermasculine/masculine/effeminate/somewhat effeminate/androgynous/feminine butch/tomboyish/feminine/hyperfeminine]
	now Head Change entry is ""; [partial sentence that fits in: "Your head and face [one of]tingle[or]go flush[or]vibrate with odd pleasure[or]go cold[or]feel oily[at random] as [head change entry]."]
	now Head Description entry is ""; [partial sentence that fits in "Your face and head resemble that of [Head Description of Player]. You have [Eye Adjective of Player], [Eye Color of Player] eyes and an overall [Gender Adjective of Player] appearance."]
	now Head Adjective entry is ""; [one word descriptive adjective (avian/canine/...)]
	now Head Skin Adjective entry is ""; [one word descriptive adjective]
	now Head Color entry is ""; [single word color adjective for the dominant color of the skin/fur/feathers/scales]
	now Head Adornments entry is "";[partial sentence that fits in "Before moving on from your head, you give your [head adornments of Player] a proud glance followed by a light caress."]
	now Hair Length entry is 2; [hair length in inches]
	now Hair Shape entry is ""; [one word shape descriptor (curly/straight/...)]
	now Hair Color entry is ""; [one word color descriptor]
	now Hair Style entry is ""; [one word style descriptor (ponytail/mohawk/buzzcut/...) to fit "On top of your head you have [Hair Length of Player] inch long, [Hair Shape of Player] [Hair Color of Player] hair in the [Hair Style of Player] style."]
	now Beard Style entry is ""; [short beard style (goatee/3-day stubble beard/porn stache/mutton chops beard/...) to go into "You have a [Hair Color of Player] [Beard Style of Player]."]
	now Body Hair Length entry is 0; [numerical value, 0-4 (no body hair/light/moderate/heavy/furry) - only set to > 0 if the infection does not have fur/scales/etc. !]
	now Eye Color entry is ""; [one word color descriptor]
	now Eye Adjective entry is ""; [one word descriptive adjective (slitted/round/...)]
	now Mouth Length entry is 3; [inches deep for face fucking; maximum possible will be double this number (when deep throating)]
	[Mouth Length Adjective  is generated by a function and can be used in scenes too - "petite, shallow, average, deep, bottomless"]
	now Mouth Circumference entry is 3; [mouth circumference 1-5, see Mouth Circumference Adjective]
	[Mouth Circumference Adjective is generated by a function and can be used in scenes too - "tiny, small, normal, wide, gaping"]
	now Tongue Adjective entry is ""; [one word descriptive adjective (wide/slobbery/...)]
	now Tongue Color entry is ""; [one word color descriptor]
	now Tongue Length entry is 3; [length in inches]
	now Torso Change entry is ""; [partial sentence that fits in: "Your torso [one of]tingles[or]goes flush[or]vibrates with odd pleasure[or]goes cold[or]feels oily[at random] as [Torso Change entry]."]
	now Torso Description entry is ""; [partial sentence, fitting in "Looking down at yourself, you appear [Gender Adjective of Player] with a [Body Adjective of Player] build. Your torso is [Torso Description of Player][if Body Hair Length of Player > 1], covered in [Torso Color of Player] skin and [Body Hair Description of Player][else if Body Hair Length of Player is 1], covered in smooth, [Torso Color of Player] skin[end if]."]
	now Torso Adjective entry is ""; [one word descriptive adjective (avian/canine/...)]
	now Torso Adornments entry is ""; [(pouch/udders/...); partial sentence to fit: "You take a moment to feel your [torso adornments of Player]."]
	now Torso Skin Adjective entry is ""; [one word adjective (feathered/furred/scaly/...); EMPTY "" for creatures with just skin]
	now Torso Color entry is ""; [single word color adjective for the dominant color of the skin/fur/feathers/scales]
	now Torso Pattern entry is ""; [single word color adjective for the dominant pattern of the skin/fur/feathers/scales]
	now Breast Adjective entry is ""; [adjective(s) example: round, pointy, perky, saggy, bouncy. This would serve as either a general appearance of a infections breasts or possibly something that may be effected by a item or NPC.]
	now Breast Size entry is 0; [cup size as number, counting Flat Pecs = 0, A = 1, B = 2, ...]
	now Male Breast Size entry is 0; [cup size as number, counting Flat Pecs = 0, A = 1, B = 2, ...]
	now Nipple Count entry is 2; [count of nipples]
	now Nipple Color entry is ""; [one word color descriptor]
	now Nipple Shape entry is ""; [shape example: any shape will do as long as it has a baseline with a current infection or item]
	now Back Change entry is ""; [partial sentence that fits in: "Your back [one of]tingles[or]goes flush[or]vibrates with odd pleasure[or]goes cold[or]feels oily[at random] as [Back Change entry]."]
	now Back Adornments entry is ""; [partial sentence to fit: "Your back tickles with the feeling of movement caused by [back adornments of Player]."]
	now Back Skin Adjective entry is ""; [one word adjective (feathered/furred/scaly/...); EMPTY "" for creatures with just skin]
	now Back Color entry is ""; [single word color adjective for the dominant color of the skin/fur/feathers/scales]
	[Limbs Adjective is generated by a function and can be used in scenes too - "rail-thin, slender, sinewy, average, firm, muscular, flabby, meaty, rippling"]
	now Arms Change entry is ""; [partial sentence that fits in: "Your arms [one of]tingle[or]go flush[or]vibrate with odd pleasure[or]go cold[or]feel oily[at random] as [Arms Change entry]."]
	now Arms Description entry is ""; [partial sentence to fit: "Your [Limbs Adjective of Player] arms are [Arms Description of Player]."]
	now Arms Skin Adjective entry is ""; [one word adjective (feathered/furred/scaly/...); EMPTY "" for creatures with just skin]
	now Arms Color entry is ""; [single word color adjective for the dominant color of the skin/fur/feathers/scales]
	now Locomotion entry is ""; [one word adjective: (bipedal/quadrupedal/octapedal/serpentine/sliding)]
	now Legs Change entry is ""; [partial sentence that fits in: "Your legs [one of]tingle[or]go flush[or]vibrate with odd pleasure[or]go cold[or]feel oily[at random] as [Legs Change entry]."]
	now Legs Description entry is ""; [partial sentence to fit: "As your inspection goes even lower, you come to the two [Body Adjective of Player] legs supporting you. They are [legs description of Player]."]
	now Legs Skin Adjective entry is ""; [one word adjective (feathered/furred/scaly/...); EMPTY "" for creatures with just skin]
	now Legs Color entry is ""; [single word color adjective for the dominant color of the skin/fur/feathers/scales]
	now Ass Change entry is ""; [partial sentence that fits in: "Your ass [one of]tingles[or]goes flush[or]vibrates with odd pleasure[or]goes cold[or]feels oily[at random] as [Ass Change entry]."]
	now Ass Description entry is ""; [partial sentence to fit: "Using your hands you feel your behind enjoying the sensation of your [Ass Width Adjective of Player], [Ass Shape Adjective of Player] [Ass Description of Player]"]
	now Ass Skin Adjective entry is "";  [one word adjective (feathered/furred/scaly/...); EMPTY "" for creatures with just skin]
	now Ass Color entry is ""; [single word color adjective for the dominant color of the skin/fur/feathers/scales]
	now Ass Width entry is 3; [ass width from 1-5]
	[Ass Width Adjective generated by function out of ass width: dainty/small/round/huge/enormous]
	[Ass Adjective generated by function out of body definition and ass width]
	now Tail Change entry is ""; [partial sentence that fits in: "Your rear [one of]tingles[or]goes flush[or]vibrates with odd pleasure[or]goes cold[or]feels oily[at random] as [if HasTail of Player is true]your existing tail is changed into a [Tail Description entry][else][Tail Change entry][end if]."]
	now Tail Description entry is ""; [partial sentence to fit: "Just below your lower back sprouts a [tail description of Player], which you move back and forth with glee."]
	now Tail Skin Adjective entry is ""; [one word adjective (feathered/furred/scaly/...); EMPTY "" for creatures with just skin]
	now Tail Color entry is ""; [single word color adjective for the dominant color of the skin/fur/feathers/scales]
	now Asshole Depth entry is 7; [inches deep for anal fucking]
	[Asshole Depth Adjective is generated by a function and can be used in scenes too - "petite (< 3), shallow (< 5), average (< 9), deep (< 15), bottomless (15+)"]
	now Asshole Tightness entry is 3; [asshole tightness 1-5, "extremely tight, tight, receptive, open, gaping"]
	[Asshole Tightness Adjective is generated by a function and can be used in scenes too - "extremely tight, tight, receptive, open, gaping"]
	now Asshole Color entry is ""; [one word color descriptor]
	now Cock Count entry is 0;
	now Cock Girth entry is 0; [thickness 1-5, generates the Cock Girth Adjective]
	[Cock Girth Adjective is generated by a function and can be used in scenes too: thin/slender/average/thick/monstrous]
	now Cock Length entry is 0; [length in inches]
	now Cock Adjective entry is ""; [one word adjective: avian/canine/...]
	now Cock Change entry is ""; [partial sentence that fits in: "Your cock [one of]tingles[or]goes flush[or]vibrates with odd pleasure[or]goes cold[or]feels oily[at random] as [Cock Change entry]."]
	now Cock Description entry is ""; [partial sentence to fit: "You have a [Cock Girth Adjective of Player], [Cock Length of Player]-inch-long [cock adjective of Player] [one of]cock[or]penis[or]shaft[or]maleness[at random] that [cock description of Player]."]
	now Cock Color entry is ""; [one word color descriptor]
	now Ball Count entry is 0; [allowed numbers: 1 (uniball), 2 or 4]
	now Ball Size entry is 0; [size of balls 1-7: "acorn-sized", "dove egg-sized", "chicken egg-sized" "goose-egg sized", "ostrich-egg sized", "basketball-sized", "beachball-sized"]
	[Ball Size Adjective is generated by a function and can be used in scenes too]
	now Ball Description entry is ""; [partial sentence to fit: "Underneath it hangs a pair of [Ball Size Adjective of Player] [ball description of Player]."]
	now Cunt Count entry is 0;
	now Cunt Depth entry is 0;
	now Cunt Tightness entry is 0; [size 1-5, generates adjectives of extremely tight/tight/receptive/open/gaping]
	[Cunt Tightness Adjective is generated by a function and can be used in scenes too: extremely tight/tight/well-used/open/gaping]
	now Cunt Adjective entry is ""; [one word adjective: avian/canine/...]
	now Cunt Change entry is ""; [partial sentence that fits in: "Your pussy [one of]tingles[or]goes flush[or]vibrates with odd pleasure[or]goes cold[or]feels oily[at random] as [Cunt change entry]."]
	now Cunt Description entry is ""; [partial sentence to fit: "You have a [Cunt Tightness Adjective of Player] [one of]cunt[or]pussy[or]vagina[or]cleft[at random] that is [cunt description of Player]."]
	now Cunt Color entry is ""; [one word color descriptor]
	now Clit Size entry is 0; [size 1-5, see Clit Size Adjective]
	[Clit Size Adjective is generated by a function and can be used in scenes: very small/small/average/large/very large]


when play ends:
	if BodyName of Player is "Naiad":
		if humanity of Player < 10:
			say "Before long, your instincts take over, driving you to seek out a body of water to claim for your own. As you find a suitable lake in a park and do so, its contents supernaturally become fresh and clean again, a rarity in this stricken city. This causes all kinds of people to search out your lake, the infected as well as the rare human survivors. You allow most to drink, punishing those who try to pollute your water and inviting selected guests to swim and couple with you.";
			say "When the military finally moves in, some soldiers think you a surviving human and try to 'rescue' you - which doesn't go so well for them. They end up wet as drowned rats and washed all the way to the park entrance - except for a cute one you decide to keep for a while and play with. In the end, you're marked down as 'too much trouble to bring in' and left in peace. So there you stay, in your pristine enchanted lake in the middle of the chaotic infected city.";
		else:
			say "When the military moves in, you're brought to a holding facility for uninfected survivors, seeing as you look human. Just to be on the safe side, the doctors give everyone a shot to neutralize infectious nanites and then you're hustled out to a disaster relief center so they can deal with the harder infected cases. Now free in the outside world, you keep yourself afloat with small jobs while training your swimming skills and taking part in one tournament after another. Soon you're up to the interregional competitions, where you make a pretty big splash by winning out against the former champion, a dolphin morph...";

Naiad ends here.
