Version 1 of Nelson by Wahn begins here.
[Version 1 - Put into its own file]

[ Lust of Nelson:                                                              ]
[   0: Player hasn't brought up any gay sex before                             ]
[   1: Told the player that he doesn't really swing that way                   ]

[ Character Notes:                                                             ]
[ - Does not really go for gay sex, will not suck anyone, will not be fucked   ]
[ - Won't give reacharounds, doesn't like touching dicks of other people       ]
[ - Is horny enough to fuck a guy in the ass, but that's it                    ]
[ - Kink: Loves his nipples played with, goes wild and animalistic when he does]
[ - Background: Latino (Carlos the Clydesdale on the farm is his cousin)       ]
[ - Worked in the zoo, fled to find his cousin                                 ]
[                                                                              ]

Section 1 - Meeting Nelson

[First Encounter - Alexandra introduces]
after going to Worker Barracks while (Alexandra is in Worker Barracks and PlayerMet of Nelson is false and a random chance of 1 in 2 succeeds):
	project Figure of Nelson_clothed_icon;
	say "     As you enter the worker barracks and look around, you see Alexandra leaning against the wall in the back of the large room. She gives you a small wave of her hand, indicating that she wants to talk about something. Strolling over to your dobie bitch, you pull her close and give her a demanding kiss, keeping her bared breasts pressing into your side as you ask what's up. 'Hey boss, with you parking me here in the fuck-farm and all, I gotta say I've been having a nice time so far. Got a few favorites among the guys too. Karel and Isaac of course, but there's also that zebra guy, Nelson, who's really packing a monster dick! Thought you might want to meet him too, and right now is a really good time for it!' The ex-cop grins at you, her tail wagging behind her back, then nods over to the doorway leading deeper into the building, where the communal shower room is situated.";
	say "     You've got to wait for a moment, but then a six-foot tall equine walks into the room, his zebra-striped, muscular body covered in nothing more than a towel around the hips. Alexandra quickly slips from your grasp, sauntering over to the man, greeting him with a smile and a lick over his firm pecs, followed by a lusty kiss as he bends his neck down to her. Your breeding bitch then takes him by the hand, leading the man over to you. 'Nelson, I want you to meet my boss. And boss - this is Nelson!' she says in introduction, then gives his towel a sharp pull after the last words, making it drop to the floor and baring the naked, wet body of the zebra stallion to you. He's very well hung with a black-skinned shaft, already half-hard due to Alexandra's earlier approach. Reflexively, he starts to move both large hands to cover himself, but the dobie stops him with a gentle tug on his arm and the words, 'It'd be a shame to hide that thing, big boy!'";
	WaitLineBreak;
	say "     Clearing his throat and raising an arm to scratch the back of his neck, Nelson relaxes a bit and looks you in the eyes, his mouth pulling into a friendly smile. 'Err, hello there, [sir]! [if PlayerFucked of Nelson is true]We kinda 'met' before, but never with introductions. [else]I've seen you around, but we never got introduced. [end if]Nelson Coleman, pleasure to meet ya!' Holding out a large hand big enough to dwarf a human's, he gives you a shake, followed by a broad grin. 'Really gotta thank you for making the barracks a much nicer place. I think just about all of us were boned up half of the time, horny as fuck with little chance to get off, besides jerking off. Then you brought Alexandra here, and she's been [if Alexandra is BarracksSlut]spreading her sweet pussy for everyone[else]handing out blowjobs all the time[end if]! Quite a lady, I gotta say!' An amused snort from beside the zebra draws your attention to your doberwoman, who gives the man a light smack against his side. 'I'm no lady, I'm a bad dog bitch! The boss's been using me as a puppy mill! And you're just perfect to father some more pups with, stud!'";
	say "     'Uhm, I -' Nelson starts to say, glancing back towards you, only to let out an aroused grunt instead of further words as Alexandra sinks down in front of him and licks the side of his shaft. 'Just look at these full, heavy balls! You should see all of the cum he's gushing when he comes!' The anthro canine says from her crouched position, cupping the black orbs in the zebra's sack, then starts to lap at them. 'Nnnghh - fuck yeah! She's an insatiable bitch, [sir]! Thanks again, and I'm ready for doing anything you want with her! Feed her loads, knock her up, anything!' Amusement is clear in Alexandra's voice as she pulls her muzzle back from Nelson's balls and says, 'See why I like him, boss? Hung, virile and ready to please!' With that said, she runs her tongue over the blunt head of his erection, then slips her muzzle over it and starts to suck the zebra off.";
	WaitLineBreak;
	say "     [bold type]With Alexandra eagerly 'demonstrating' the stud to you, the question remains what you want to do now.[roman type][line break]";
	say "     [link](1)[as]1[end link] - Just stand back and watch.";
	say "     [link](2)[as]2[end link] - Sink to your knees and join in.";
	say "     [link](3)[as]3[end link] - Tell Nelson to enjoy it and turn to other things.";
	now calcnumber is 0;
	while calcnumber < 1 or calcnumber > 3:
		say "Choice? (1-3)>[run paragraph on]";
		get a number;
		if calcnumber is 1 or calcnumber is 2 or calcnumber is 3:
			break;
		else:
			say "Invalid choice. Type [link]1[end link] to watch, [link]2[end link] to join in or [link]3[end link] to turn to other things.";
	if calcnumber is 1: [watch Nelson and Alexandra]
		LineBreak;
		say "     Giving Nelson a smile and a thumbs up, you step back a little to take in the whole picture all at once: He's one very large and muscular zebra stud, standing bare-ass naked in the worker barracks and with his more than a foot-long black cock in the muzzle of your dobie bitch. You can see her throat bulging from the long shaft inside it. The ex-cop uses her muzzle and long floppy tongue to service him expertly, slurping on the fat shaft and licking its sides by curling her tongue up along it. She cups the full orbs of his balls, massaging and lightly squeezing them. Seeing his cum-factories fill both her hands, you have little doubt of his virility, and you can't help but wonder just how much the guy puts out when he does come. While you're still contemplating this, Alexandra pulls off her equine lollypop, grinning up at you with her tail wagging behind her back.";
		say "     'Told you he was a beast!' she says proudly, holding up the long black shaft glistening with her spit and his pre-cum welling up at the tip of his flared head. Then she bends her head down a little, opening her muzzle wide to engulf one of his balls. Nelson tenses a bit as he feels her canines lightly pressing into his flesh, but then the canine bitch starts lapping with eager abandon, tracing her tongue-tip over the sensitive skin again and again. 'Man, this is amazing!' the zebra groans, meeting your eyes for a second before turning his whole attention down to Alexandra as she switches balls and goes down on the other one. More and more pre-cum starts to leak from Nelson's blunt dickhead, brought up through his long shaft in little pulses and throbs to then trickle down along his length and finally soak the fur on the top and sides of Alexandra's muzzle.";
		WaitLineBreak;
		say "     Pulling back a little, your breeding bitch licks up the sweet nectar of Nelson's pre with obvious pleasure, then traces her tongue up the underside of his shaft to slurp up more of it. After she reaches his dickhead and takes its flared rim between her jaws once more, Alexandra sucks hard on it, making the stallion groan in lust. Wrapping her hands around his length on both sides of the medial ring, she strokes up and down rapidly, squeezing his black manhood just tight enough to simulate him being inside of a gripping pussy. The large male tenses up as her treatment inflames his lust to new heights, breath coming more quickly and his hooves scraping over the floorboards as he takes a more secure stance. Before much longer, Nelson grunts out in an urgent tone, 'Getting kinda close now!' Alexandra just keeps going, encouraged rather than pulling off his shaft.";
		say "     Just before you see the first big throb go through his balls, she pushes forward and inhales as much of his length as she can, up to her nose being pressed against his pubes. The sudden change of sensation seconds before he erupts into her makes Nelson shout in arousal, followed by bellowed grunts as a deluge of zebra cum fills Alexandra's stomach. She keeps his cock inside her mouth for a long moment, holding her breath as he goes on and on cumming, before she can't help but pull back, taking in a gasped breath. Still not done with his orgasm, the zebra shoots thick streaks of sperm over her face, neck and the curving orbs of her breasts, making quite a mess of the eager bitch. It takes almost another minute or so before his output starts to wane, eventually dying down to a few last spurts before stopping. This leaves Nelson standing over Alexandra and breathing hard, while she is wiping up streaks of his seed and sucks it off her fingers.";
		WaitLineBreak;
		say "     'I think I'll need to lie down for a bit,' the zebra says in a well-pleased, but somewhat embarrassed tone once he catches his breath, looking back and forth between you and Alexandra as she stands up before him. 'Kiss me, stud!' she tells him in a firm tone and Nelson immediately obeys, their muzzles meeting and Alexandra pushing her tongue into his mouth. You can't be sure, but you guess that it must still be covered in his cum, which your bitch is sharing back to him. If she does, the big man accepts this without complaint, making out eagerly with the doberwoman and groping her breasts as he does so. When they eventually pull apart, Alexandra smiles at him and adds, 'Good boy! Now get your rest.' She swats his firm, striped ass as the man bends down to grab his towel, then walks over to one of the beds to lay down on it.";
		say "     'Got some prime stallions on this farm, boss! Nice idea of you to send me here!' Alexandra tells you with a broad smile on her muzzle, one hand wiping up a bit more of the goo making her chest fur sticky and playfully waving it your way as if to smear you too with Nelson's seed. Chuckling, she licks it off instead a moment later, nodding her head towards the showers. 'I need to go clean up now. But while I do, I want you to think of that bad boy and his big shaft. Imagine how it feels to have that go into you...' With that said, the former cop saunters off, waving her hips and wagging her tail as she goes.";
	else if calcnumber is 2: [Join in with Alexandra to service Nelson]
		LineBreak;
		say "     Giving Nelson a smile and a thumbs up, you step forward yourself and sink down to the same height as Alexandra, eye-level to the big black shaft of a very horny zebra stallion. Glancing upwards, you let your gaze wander over his towering and muscle-packed body, stroking and feeling it as you can't help but think what nice breeding material this guy is. Kids he puts into Alexandra surely would have exceptional genetics indeed - and not just because they'd be zebra doberman mixtures! A slurping sound shakes you out of your daydreaming, drawing your attention back to what's just in front of you - a foot-long black cock in the muzzle of your dobie bitch. The ex-cop uses her muzzle and long floppy tongue to service Nelson expertly, sucking on the fat shaft and licking its sides by curling her tongue up along it. She cups the full orbs of his balls, massaging and lightly squeezing them.";
		say "     Seeing his cum-factories fill both her hands, you have little doubt of his virility, and you wonder how it'll feel to run your tongue over them. Leaning foward and stretching your neck, you find out a moment later, nose buried against the short hairs of his white front and huffing his clean, animalistic scent while you lick his balls. They feel firm and fairly smooth against your tongue, his black skin not so much wrinkled but rather stretched over the shape of his cum-factories, as if straining to contain the virile load of the stallion. You start to wonder just how much the guy puts out when he does come. While you switch back and forth between the zebra's balls, Alexandra pulls off her equine lollypop at some point, as you can feel her tongue licking your cheek, then ear, followed by the proudly spoken words, 'Told you he was a beast! Why don't you try out the cock for a bit and I'll keep going on his balls?'";
		WaitLineBreak;
		say "     Following Alexandra's suggestion, you turn your attention to the thick, black-skinned pillar of maleness that is Nelson's cock. It's maybe a foot and a half long and clearly non-human, with a raised ring partway up the shaft and a large, flared head at the end. From the cum-slit on that, pre-cum is welling up in little pulses and throbs, trickling down along his length. Alexandra meanwhile opens her muzzle wide to engulf one of his balls, making Nelson tense a bit as he feels her canines lightly pressing into his flesh. Yet as the canine bitch starts lapping with eager abandon, tracing her tongue-tip over the sensitive skin again and again, he throws off any worry, instead moaning, 'Man, this is amazing!' This ramps up his pre-cum production even more, and as its trickle starts reaching all the way down Nelson's cock and finally soaks the fur on the top and sides of Alexandra's muzzle, you are reminded that you're supposed to go for his dick.";
		say "     Opening your mouth, you stick your tongue out wide and begin to trace it up along the zebra's shaft, slurping in the musky liquid of his pre-cum. The taste of the virile stallion fills your whole mouth by the time you reach his dickhead and slide your lips over it, then suckle on Nelson's cock. A loud groan from above you tells you that the zebra stallion likes this quite a bit, so you go further, switching back and forth between hard sucks and more gentle moments. Wrapping your hands around his length on both sides of the medial ring, you stroke up and down rapidly, squeezing his black manhood just tight enough to simulate him being inside a gripping pussy. The large male tenses up as the treatment inflames his lust to new heights, breath coming more quickly and his hooves scraping over the floorboards as he takes a more secure stance.";
		WaitLineBreak;
		say "     Before much longer, Nelson grunts out in an urgent tone, 'Getting kinda close now!' In a flash, Alexandra's muzzle is next to your face, with the bitch raising her head from sucking on the stallion's balls and now snaking her tongue around Nelson's upper cock. In a swift move that doesn't so much push you aside but rather steals his dickhead from your mouth to be sucked into hers, the bitch takes over, then pushes forward and inhales as much of his length as she can, up to her nose being pressed against Nelson's pubes. The sudden change of sensation seconds before he was about to come her makes Nelson shout in arousal, followed by bellowed grunts as a deluge of zebra cum starts to erupt from his cock. Being right beside them, you can see every throb and pulse of his balls, gushing down Alexandra's hungry throat and filling her stomach.";
		say "     Alexandra keeps his cock inside her mouth for a long moment, holding her breath as he goes on and on cumming, before she can't help but pull back, taking in a gasped breath. Still not done with his orgasm, the zebra shoots thick streaks of sperm over her face, neck and the curving orbs of her breasts, making quite a mess of the eager bitch. It takes almost another minute or so before his output starts to wane, eventually dying down to a few last spurts before stopping. This leaves Nelson standing over you and Alexandra, breathing hard while she is wiping up streaks of his seed and sucks it off her fingers. 'Told ya he's fun!' Alexandra says in amusement, then adds, 'You're not cross for me taking that blast, are you boss? It can be a bit much if you're unprepared.' You're not quite sure if she meant that or if Alexandra is a pushy bitch, maybe it's a bit of both.";
		WaitLineBreak;
		say "     'I think I'll need to lie down for a bit,' Nelson says in a well-pleased, but somewhat embarrassed tone once he catches his breath, looking back and forth between you and Alexandra as she stands up before him. 'Kiss me, stud!' she tells him in a firm tone and Nelson immediately obeys, their muzzles meeting and Alexandra pushing her tongue into his mouth. You can't be sure, but you guess that it must still be covered in his cum, which your bitch is sharing back to him. If she does, the big man accepts this without complaint, making out eagerly with the doberwoman and groping her breasts as he does so. When they eventually pull apart, Alexandra smiles at him and adds, 'Good boy! Now get your rest.' She swats his firm, striped ass as the man bends down to grab his towel, then walks over to one of the beds to lay down on it.";
		say "     'Got some prime stallions on this farm, boss! Nice idea of you to send me here!' Alexandra tells you with a broad smile on her muzzle, one hand wiping up a bit more of the goo making her chest fur sticky and playfully waving it your way as if to smear you too with Nelson's seed. Chuckling, she licks it off instead a moment later, nodding her head towards the showers. 'I need to go clean up now. But while I do, I want you to think of that bad boy and his big shaft. Imagine how it feels to have that go into you...' With that said, the former cop saunters off, waving her hips and wagging her tail as she goes.";
		NPCSexAftermath Player receives "OralCock" from Nelson;
	else if calcnumber is 3:
		LineBreak;
		say "     Smiling at the zebra farmhand enjoying the oral attention of your dobie bitch, you pat his arm to get Nelson's attention, then tell him to enjoy himself with her. The large man grins broadly and replies, 'I'm sure I will, [sir]!' then lowers a hand to the top of her head, guiding Alexandra to take his shaft deeper. After a last look at the formerly so stiff and stuffy cop now eagerly suckling on an anthro equine cock, you leave them to it and walk away, turning your mind to other things.";
	NPCSexAftermath Alexandra receives "OralCock" from Nelson;
	now PlayerMet of Nelson is true;
	now Nelson is in Worker Barracks;

Section 2 - NPC

Table of GameCharacterIDs (continued)
object	name
Nelson	"Nelson"

Nelson is a man.
ScaleValue of Nelson is 4. [human+ sized]
Body Weight of Nelson is 7. [scale of 1-9 for body weight, grouped into low weight (1-3), mid weight (4-6) and high weight (7-9)]
Body Definition of Nelson is 8. [scale of 1-9 for body definition, grouped into low muscle (1-3), mid muscle (4-6), high muscle (7-9)]
[Body Adjective is generated out of the body weight and body definition and can be used in scenes - one word descriptive adjective depending on weight and definition groups: low weight group: skinny/slender/lithe; mid weight group: average/fit/muscled; high weight group: pudgy/husky/jacked]
Androginity of Nelson is 2. [Gender Adjective is generated out of androginity 1-9: hypermasculine/masculine/somewhat effeminate/effeminate/androgynous/feminine butch/tomboyish/feminine/hyperfeminine]
Mouth Length of Nelson is 5. [inches deep for face fucking; maximum possible will be double this number (when deep throating)]
Mouth Circumference of Nelson is 3. [mouth circumference 1-5, "tiny, small, normal, wide, gaping"]
Tongue Length of Nelson is 5. [length in inches]
Breast Size of Nelson is 0. [cup size as number, counting Flat Pecs = 0, A = 1, B = 2, ...]
Nipple Count of Nelson is 2. [count of nipples]
Asshole Depth of Nelson is 10. [inches deep for anal fucking]
Asshole Tightness of Nelson is 2. [asshole tightness 1-5, "extremely tight, tight, receptive, open, gaping"]
Cock Count of Nelson is 1. [number of cocks]
Cock Girth of Nelson is 4. [thickness 1-5, thin/slender/average/thick/monstrous]
Cock Length of Nelson is 15. [length in inches]
Ball Count of Nelson is 2. [allowed numbers: 1 (uniball), 2 or 4]
Ball Size of Nelson is 4. [size of balls 1-7: "acorn-sized", "dove egg-sized", "chicken egg-sized" "goose-egg sized", "ostrich-egg sized", "basketball-sized", "beachball-sized"]
Cunt Count of Nelson is 0. [number of cunts]
Cunt Depth of Nelson is 0. [penetratable length in inches; some minor stretching allowed, or more with Twisted Capacity]
Cunt Tightness of Nelson is 0. [size 1-5, generates adjectives of extremely tight/tight/receptive/open/gaping]
Clit Size of Nelson is 0. [size 1-5, very small/small/average/large/very large]
[Basic Interaction states as of game start]
PlayerMet of Nelson is false.
PlayerRomanced of Nelson is false.
PlayerFriended of Nelson is false.
PlayerControlled of Nelson is false.
PlayerFucked of Nelson is false.
OralVirgin of Nelson is false.
Virgin of Nelson is true.
AnalVirgin of Nelson is true.
PenileVirgin of Nelson is false.
SexuallyExperienced of Nelson is true.
TwistedCapacity of Nelson is false. [Twisted Characters can take any penetration, no matter the size]
Sterile of Nelson is false. [steriles can't knock people up]
MainInfection of Nelson is "Zebra Stallion".
Description of Nelson is "[NelsonDesc]".
Conversation of Nelson is { "Mew!" }.

instead of sniffing Nelson:
	say "Nelson has a pleasant animalistic smell, masculine and strong.";

to say NelsonDesc:
	project Figure of Nelson_clothed_icon;
	if debugactive is 1:
		say "DEBUG -> HP: [HP of Nelson] <- DEBUG[line break]";
	if Nelson is not asleep:
		say "     Nelson is one of the farmhands on the McDermott Farm, part of the work crews that keep the place running even in the midst of the nanite apocalypse. He is a particularly large and strong anthro zebra, his at least six foot tall frame on par with the draft horse statures of the Clydesdales in the group. As is the usual attire for farm horsemen, he's dressed in a sturdy pair of jeans and a cowboy hat, with nothing covering his broad chest and the rippling muscles under his short, striped fur. His strong legs end in broad hooves, making it unnecessary for Nelson to wear any kind of footwear.";
		say "     The man shows a cheerful, friendly demeanor, giving you a smile and a wave as he notices your attention, then flexes his arms and chest a little to show off. From what you've seen of him so far, he appears to be a fairly uncomplicated guy, content to do a manual labor job - and do it well, given his impressive size and strength.";
	else: [sleeping]
		say "     Nelson is one of the farmhands on the McDermott Farm, part of the work crews that keep the place running even in the midst of the nanite apocalypse. He is a particularly large and strong anthro zebra, his at least six foot tall frame on par with the draft horse statures of the Clydesdales in the group. The man is sleeping right now, lying stretched out in his bed. Nothing but a thin blanket covers his impressively muscled, naked body.";

[daily movement]
an everyturn rule:
	if PlayerMet of Nelson is true:
		[if TimekeepingVar is 1 or TimekeepingVar is -7:] [midnight - he's asleep]
		[else if TimekeepingVar is 0 or TimekeepingVar is -8:] [pre dawn - he's asleep]
		if TimekeepingVar is 7 or TimekeepingVar is -1: [early morning - Nelson wakes up]
			if Player is in Worker Barracks and Nelson is in Worker Barracks:
				say "     Seeing some movement from the corner of your eye, you turn around a little and see Nelson throwing back the thin blanket covering his large, zebra-striped body and sitting up on his bed. The equine farmhand yawns and stretches, showing off quite a few muscles as he does so. As he stands up, your gaze is inevitably drawn to the full orbs of his balls swinging between his legs, on full display as the man sleeps in the buff. He doesn't seem overly concerned with his nakedness and calmly takes a clean towel to wrap around his hips before walking over to the shower room. As Nelson passes you, he gives a friendly nod in greeting.";
			now Sleeping of Nelson is false;
		else if TimekeepingVar is 6 or TimekeepingVar is -2: [mid-morning - breakfast]
			if Player is in Worker Barracks and Nelson is in Worker Barracks:
				say "     Nelson joins a few other horsemen at the table in the front of the room, having a healthy, vegetarian breakfast. The large men put away quite a bit of cereal, but that's only to be expected if they work hard each day. Afterwards, a work crew assembles and they trot from the building.";
			else if Player is in Central Farm Square and Nelson is in Worker Barracks:
				say "     A group of horsemen leave the worker barracks together, chatting and joking with each other as they stop by a shed to grab scythes and other tools. You recognize Nelson the zebra among their number and say hello, with him acknowledging you in turn with a friendly nod as he walks past.";
			now Nelson is nowhere; [parked in the void]
		[else if TimekeepingVar is 5 or TimekeepingVar is -3:] [noon - unused, he's at work]
		else if TimekeepingVar is 4 or TimekeepingVar is -4: [mid afternoon - return from work]
			if Player is in Worker Barracks and Nelson is nowhere:
				say "     A group of horsemen come into the barracks, looking somewhat tired but in good enough spirit overall. You can see their coats being somewhat matted with sweat. Looks like they spent some time doing manual labor today. As more men pass, you see one you know by Name - it's Nelson, the zebra among all the horses here. '[one of]Hey, nice to see ya,' [or]Hiho,' [or]Buenos dias,' [at random]he says and pats your shoulder, exchanging a few words before he goes to freshen up a bit.";
			else if Player is in Central Farm Square and Nelson is nowhere:
				say "     You see a group of horsemen come back onto the farm proper through the front gate, looking somewhat tired but in good enough spirit overall. They're carrying scythes and a few other farming implements and must have spent the last few hours cutting down the encroaching grass. As the men trot past you, one of them gives you a friendly wave and calls out. It's Nelson, the zebra farmhand. '[one of]Hey, nice to see ya,' [or]Hiho,' [or]Buenos dias,' [at random]he says and pats your shoulder, exchanging a few words before he follows the rest of his comrades to put away his tools and goes into the barracks.";
			now Nelson is in Worker Barracks;
		[else if TimekeepingVar is 3 or TimekeepingVar is -5:] [evening unused]
		else if TimekeepingVar is 2 or TimekeepingVar is -6: [early night - unused, he just hangs out]
			if Player is in Worker Barracks and Nelson is in Worker Barracks:
				say "     The atmosphere in the worker barracks takes on a more jovial tone, as the last of the farmhands come in from their shifts and groups form to play various games. You see a few of the guys over at a dartboard, while others prefer playing Poker using various food items as money. One of those is the zebra farmhand Nelson, who gives you a friendly nod as you meet his eyes. He continues to play for a while, [one of]winning big in the end and proudly pocketing a candy bar[or]losing three ears of corn he was using as his bid[or]coming out with about as much loose fruits as he started[at random] before he eventually calls it quits. Standing up, the large equine wanders to his bed and strips down, then lies down and dozes off soon after.";
			now Sleeping of Nelson is true;

Section 3 - Talk Options

instead of conversing the Nelson:
	project Figure of Nelson_clothed_icon;
	if Nelson is asleep:
		say "     The muscular zebra is deep asleep, splayed out nakedly under a thin blanket. [bold type]Do you want to wake him?[roman type][line break]";
		LineBreak;
		say "     ([link]Y[as]y[end link]) - Yup. He had enough rest.";
		say "     ([link]N[as]n[end link]) - Nah, it's not that important.";
		if Player consents:
			LineBreak;
			say "     Bending over and giving the anthro zebra a little shake, Nelson gives a groan as he is pulled from dreamland. A moment later, his eyes open and blearily blink at you, after which he quickly sits up when realizing who's waking him. 'Oh hey, [sir]. Is something up?'";
			now Sleeping of Nelson is false;
			say "[NelsonTalkMenu]";
		else:
			say "     Seeing that the anthro zebra is resting, you decide to wait and talk to him later.";
	else:
		say "[NelsonTalkMenu]";

to say NelsonTalkMenu:
	project Figure of Nelson_clothed_icon;
	say "     [bold type]What do you want to talk with Nelson about?[roman type][line break]";
	now sextablerun is 0;
	blank out the whole of table of fucking options;
	[]
	choose a blank row in table of fucking options;
	now title entry is "Just chat a bit";
	now sortorder entry is 1;
	now description entry is "Talk about what comes to mind";
	[]
	choose a blank row in table of fucking options;
	now title entry is "Ask how he got to be on the farm";
	now sortorder entry is 2;
	now description entry is "Learn more about Nelson's background";
	[]
	sort the table of fucking options in sortorder order;
	repeat with y running from 1 to number of filled rows in table of fucking options:
		choose row y from the table of fucking options;
		say "[link][y] - [title entry][as][y][end link][line break]";
	say "[link]0 - Nevermind[as]0[end link][line break]";
	while sextablerun is 0:
		say "Pick the corresponding number> [run paragraph on]";
		get a number;
		if calcnumber > 0 and calcnumber <= the number of filled rows in table of fucking options:
			now current menu selection is calcnumber;
			choose row calcnumber in table of fucking options;
			say "[title entry]: [description entry]?";
			if Player consents:
				let nam be title entry;
				now sextablerun is 1;
				if (nam is "Just chat a bit"):
					say "[NelsonTalk1]";
				if (nam is "Ask how he got to be on the farm"):
					say "[NelsonTalk2]";
				wait for any key;
		else if calcnumber is 0:
			now sextablerun is 1;
			say "     You step back from the zebra farmhand, shaking your head slightly as he gives a questioning look.";
			wait for any key;
		else:
			say "Invalid Option. Pick between 1 and [the number of filled rows in the table of fucking options].";
	clear the screen and hyperlink list;

to say NelsonTalk1: [short chat]
	say "     You chat a little with Nelson, exchanging tales of what you've seen out in the city and him recounting meetings with the beasts that roam the dry plains. Overall, you've got a nice time talking with the friendly man, before eventually running out of immediate topics and saying your goodbyes.";

to say NelsonTalk2: [backstory]
	say "     As you ask Nelson how he got to the farm, the anthro zebra snorts and strokes a hand over his striped arm. 'Guess it's obvious that I haven't been here since the beginning of this thing, eh? What with all of the other dudes being mostly the same kind of stallion and me sticking out like a sore thumb, hah!' Glancing around, he points at a Clydesdale with a prominent golden nose ring. 'Just so you know, that's my cousin Carlos over there. Not that anyone'd guess that if you just looked at us side by side.' His words are true enough, as the two of them only really have their large size and general muscular build in common, deviating a lot in all other regards. Black and white stripes and a fairly short coat on Nelson for example, while Carlos is a rich, smooth brown all over his body, and his arms and legs are white-blond starting at the elbows and knees, ending in fluffy fetlocks.";
	say "     'Well, we're originally from a podunk mountain village out a fair bit east. Not much opportunities there, I can tell you that, so I left when the going was good. Found a decent job here on the coast, and I bet you can guess where!' He grins at you expectantly, tracing a hand over the short mane of hair standing up like a short mohawk on his head. 'It was the zoo of course, yup. Spent years watching my family's critters, so taking care of zoo animals was a good fit. Meanwhile, Carlos hired on here, under old Mr. McDermott. The gramps of our current boss, Anthony. We stopped by each other's places every so often - it's good to have someone who understands your hick jokes, ya'know?' Chuckling to himself as he thinks back, Nelson smiles, then shakes off the memory.";
	WaitLineBreak;
	say "     Clearing his throat, the zebra continues, 'So, when shit started to go down, I was in the zoo. Doing an inventory of fruit and hay bales, of all things. Then suddenly, there's a knock at the door leading to the zebra enclosure. At first I thought some idiot had climbed over the fence and now wanted out after realizing that it's harder to get over it from the inside, but when I unlocked the door, there was a babe waiting for me there. Naked from her eager smile, over glorious boobs all the way down to her hooves. I was gonna commend her for the insane makeup and ballsy approach, but then I recognized the fur pattern from brushing it every week for the last two years. Before I managed to get over the shock that she somehow was one of my charges - Nsia, but transformed, she was saying she wanted to thank me for taking care of her for so long and stepped up to kiss me.";
	say "     'What can I say - things went wild after that and she was a real animal in the sack!' Nelson has to adjust his bulge a little as he recounts some details of his sexual encounter, ending with blowing a load in the zebra woman and suckling on her well-curved breasts. 'I still wonder if I made some foals that day. Sadly, staying wasn't much of an option, as the next thing that happened was Mwenye wrenching me off his mare! In the haste to, you know, get naked and fucking, I didn't close the door and the dominant stallion found us. He was anthro too by then, and man, that dude was pissed! Never get between a zebra and his woman, I can tell you that! Had quite a punching and kicking match. He got me good several times and I think broke my leg, but somehow I found myself standing on it with no problem a moment later. The fur spreading over my arms and body might have had something to do with that I guess...'";
	WaitLineBreak;
	say "     Nelson shrugs, then says, 'Long story short: Had a great fuck, then a fight, became a zebra in the course of all of that and then high-tailed it out of there. The stallion seemed ready to just keep going kicking the shit out of each other, and I can think of nicer ways to spend a day. Thankfully, from what I saw as I was making my way out, the animals didn't need anyone to look out for them anymore. Hell, half of them were out already, boning each other or any passersby. So I didn't have to feel too guilty about abandoning the place. The shit going on in the streets was more of the same, and even built like a brickhouse in this new body, I doubt I could have lasted forever there without something making me their bitch. So my plan was to find Carlos and join up with him, then go road warrior together and escape east.'";
	say "     The zebra shrugs his broad shoulders and looks around for a second, then adds, 'Gotta admit that I was hella surprised to find this place still standing, and fairly civil. My cousin vouched for me with Anthony, so in the end I just stayed here with all of them. Good enough place to ride out the apocalypse, even if it could use some more pussy. But hey, you helped a bunch with that, so thanks again, [sir]!'";


Section 5 - Sex Options

instead of fucking the Nelson:
	project Figure of Nelson_naked_icon;
	if Nelson is asleep:
		say "     The muscular zebra is deep asleep, splayed out nakedly under a thin blanket. [bold type]Do you want to wake him?[roman type][line break]";
		LineBreak;
		say "     ([link]Y[as]y[end link]) - Yup. He had enough rest.";
		say "     ([link]N[as]n[end link]) - Nah, it's not that important.";
		if Player consents:
			LineBreak;
			say "     Bending over and giving the anthro zebra a little shake, Nelson gives a groan as he is pulled from dreamland. A moment later, his eyes open and blearily blink at you, after which he quickly sits up when realizing who's waking him. 'Oh hey, [sir]. Is something up?'";
			now Sleeping of Nelson is false;
			say "[NelsonSexMenu]";
		else:
			say "     Shaking your head to clear it from lusty thoughts, you decide not to wake Nelson up right now.";
	else:
		if lastfuck of Nelson - turns < 4:
			say "     As you approach Nelson, the powerful zebra grins broadly, giving your shoulder a friendly slap. 'Hey there, you horny again, eh? Really wish I could fuck around right now, but there's work to do, you see. Can't let my duties slide. So, how about we get it on a bit later, OK?'";
		else:
			say "     As you approach Nelson, the powerful zebra grins broadly, giving your shoulder a friendly slap. His other hand is on the bulge in his jeans, rubbing himself through the fabric. 'Hey there, you horny again, eh? Me too! [bold type]What do you wanna do?[roman type]'";
			LineBreak;
			say "[NelsonSexMenu]";

to say NelsonSexMenu:
	now sextablerun is 0;
	blank out the whole of table of fucking options;
	[]
	if Player is male and Lust of Nelson is 0:
		choose a blank row in table of fucking options;
		now title entry is "Ask him to blow your cock";
		now sortorder entry is 1;
		now description entry is "Enjoy your zebra friend's mouth";
	[]
	if Player is female:
		choose a blank row in table of fucking options;
		now title entry is "Ask him to lick your pussy";
		now sortorder entry is 2;
		now description entry is "Enjoy your zebra friend's tongue";
	[]
	choose a blank row in table of fucking options;
	now title entry is "Offer to blow him";
	now sortorder entry is 3;
	now description entry is "Get sucking on that thick zebra cock";
	[]
	choose a blank row in table of fucking options;
	now title entry is "Ask to milk some cum out of Nelson's dick";
	now sortorder entry is 4;
	now description entry is "Get a bottle of prime zebra stud milk";
	[]
	if Player is female:
		choose a blank row in table of fucking options;
		now title entry is "Offer your pussy to him";
		now sortorder entry is 5;
		now description entry is "Be pounded with the zebra's thick cock";
	[]
	if Lust of Nelson is 0:
		choose a blank row in table of fucking options;
		now title entry is "Offer your ass to him";
		now sortorder entry is 6;
		now description entry is "Be pounded with the zebra's thick cock";
	[]
	if Player is male and Lust of Nelson is 0:
		choose a blank row in table of fucking options;
		now title entry is "Ask to fuck him";
		now sortorder entry is 7;
		now description entry is "Take the zebra's ass";
	[]
	sort the table of fucking options in sortorder order;
	repeat with y running from 1 to number of filled rows in table of fucking options:
		choose row y from the table of fucking options;
		say "[link][y] - [title entry][as][y][end link][line break]";
	say "[link]0 - Nevermind[as]0[end link][line break]";
	while sextablerun is 0:
		say "Pick the corresponding number> [run paragraph on]";
		get a number;
		if calcnumber > 0 and calcnumber <= the number of filled rows in table of fucking options:
			now current menu selection is calcnumber;
			choose row calcnumber in table of fucking options;
			say "[title entry]: [description entry]?";
			if Player consents:
				let nam be title entry;
				now sextablerun is 1;
				if (nam is "Ask him to blow your cock"):
					say "[NelsonSex1]";
				else if (nam is "Ask him to lick your pussy"):
					say "[NelsonSex2]";
				else if (nam is "Offer to blow him"):
					say "[NelsonSex3]";
				else if (nam is "Ask to milk some cum out of Nelson's dick"):
					say "[NelsonSex4]";
				else if (nam is "Offer your pussy to him"):
					say "[NelsonSex5]";
				else if (nam is "Offer your ass to him"):
					say "[NelsonSex6]";
				else if (nam is "Ask to fuck him"):
					say "[NelsonSex7]";
				wait for any key;
		else if calcnumber is 0:
			now sextablerun is 1;
			say "     You step back from the zebra farmhand, shaking your head slightly as he gives a questioning look.";
			wait for any key;
		else:
			say "Invalid Option. Pick between 1 and [the number of filled rows in the table of fucking options] or 0 to exit.";
	clear the screen and hyperlink list;

to say NelsonSex1: [cock sucked by Nelson]
	if Lust of Nelson is 0: [never talked about 'gay' stuff]
		say "     As you ask the zebra farmhand for a blowjob, the large man looks at you with a puzzled expression and raises his hands defensively. 'Wow, wow - where did that come from?! Sorry to tell ya, but I'm not really into the cock-slobbering lifestyle. Too gay for my taste, you know.' Shrugging those impressively wide shoulders of his apologetically, he grasps the side of your arm and gives it a squeeze. 'So, no hard feelings, eh? I'm sure you got... a really nice dick and whatever. It's just not my scene to be rubbing my nose in a dude's pubes, alright?' He's clearly a bit embarrassed about your request and quickly changes the topic after that, chatting about nothing of real importance before excusing himself a little while later.";
		now Lust of Nelson is 1;
	else:
		say "     [bold type]Error Nelson[Lust of Nelson]! Please report how you saw this message on the Flexible Survival Discord![roman type][line break]";

to say NelsonSex2: [cunt licked by Nelson]
	say "     Stepping even closer to the zebra farmhand, you hook a hand behind his head and pull him in for a deep kiss that soon involves his tongue exploring your mouth. While exchanging an eager and lustful snog with the big man, his hands explore your form, stroking and touching[if player is naked] the naked curves of your body[else], with his fingers tugging at what clothes you wear[end if]. You enjoy the sensations of just making out with him for a while, then eventually pull back and look him in the eyes, asking the zebra to lick your pussy. 'How could I say no to that, [sir]!' he replies in a husky tone, his tongue tracing over his broad lips and an eager gleam burning in his eyes. Taking hold of his large hand, you guide a readily obeying Nelson towards the nearest bed. While it is unlikely that this is actually his, there aren't any complaints from the other horsemen in the room for wanting to use it. In fact, several of them edge closer or move around a little, and the bunch of them seem quietly happy that you're not going off into a hard to see corner or even to another room.";
	say "     Arriving at the bed, you grab the crumpled blanket lying on it and spread it out, creating a smooth surface. Then you[if player is not naked] quickly strip off your clothes and gear and[end if] lie back on the mattress, coming to rest on your angled elbows and looking up at your horny zebra stallion. Nelson watches you with lust in his eyes, his gaze wandering up and down over your body. [if player is male]He hesitates a barely perceptible moment as his eyes run into on the cock rising above your pussy, giving a little shrug to himself before focusing on your female parts instead. [end if]The large male begins to move in to join you on the bed, no doubt happy to get licking, but as he does so, you clear your throat and say that you'd also like to have a nice show. Chuckling and giving a broad smile, Nelson flexes first one arm, then the other, sending ripples through the striped pattern on his body as he moves. Quite a sight to behold, this equine hunk, and he poses a little more before spinning around and flicking his tail in your direction.";
	WaitLineBreak;
	say "     You can hear the sounds of his button being undone and a zipper sliding down, then the farmhand hooks his thumbs over the beltline of his jeans and pushes them down. Your gaze is immediately drawn to the firm globes of his buttocks, striped as the rest of him, followed by seeing a glimpse of large, heavy balls swinging between his legs as he kicks the pants off fully. As Nelson slowly turns around next, you're treated to seeing the full erect length of his 15-inch cock, jet-black and blunt like a horse's. 'This is all because of you! Can't get enough of seeing that sexy body of yours!' he says eagerly, and also a bit proudly as he hefts the huge shaft with both hands, stroking slowly up and down over it. As a reply, you spread your legs and trace a single finger over the folds of your sex, raising them to show Nelson the wetness brought on by your arousal. Then you ask him to show you his skills with that tongue.";
	say "     Hooves scrape over the wooden floorboards as Nelson quickly kneels down before you, his hands taking hold of your spread legs and caressing them. Then he bends his neck to bring the zebra muzzle he calls his own down to your crotch, followed by a first lap of his broad, warm and wet tongue over your sensitive folds. You can't help but pant in lust at the sensation of being licked, and the warmth of his breath washing over your bared sex. The proud stallion continues to slowly brush his tongue over your crotch for a little while, grinning broadly at the pants and gasps he draws from you while doing so, before eventually moving on to snaking a finger in between your nether lips. Being the six foot tall anthro equine that he is, Nelson's exploring finger isn't all that small either, and you feel quite nicely filled by his digit, especially as he begins to curl it inside you and strokes some very sensitive spots.";
	WaitLineBreak;
	say "     Nelson licks your nether lips while fingering you, then soon homes in to focus on the nub of your clit. He gives it a lot of attention, teasing and caressing it to drive your arousal to ever higher levels. As you writhe on the bed, moaning loudly, you vaguely register sounds from the rest of the room, among which are wolf whistles, talking voices and some chuckles and laughter. Seems like the rest of the farmhands are enjoying the performance you and Nelson are giving them. Not too much later, you feel yourself getting fairly close to orgasming and gasp out words to inform Nelson. The anthro stallion promptly plants his lips over the top half of your pussy and begins to suckle on your clit, complete with his tongue-tip playing with it and driving you wild! You tremble and shake under this sensual assault to your sex, filling the worker barracks with full-voiced shouts of lust as a massive orgasm breaks over you.";
	say "     The zebra farmhand never stops wiggling his finger inside your pussy, or sucking on your clit, swallowing what femcum leaks out of your sex without reservation. [if player is male]His oral pleasuring doesn't extend to your dick though, which he does his best to ignore completely, even though it is right in front of his face and often literally rubbing against his nose. Therefore, your erection throbs and pulses wholly on its own, sticking up as straight as it will go as the spurts of cum start flying. This leaves you a little bit of a well-satisfied, but sticky and sweaty, mess by the time your climax has run its course, with long streaks of your own cum all over your chest. [else]By the time your climax has run its course, you're left a well-satisfied, but sticky and sweaty, mess. [end if]Lying on your back, panting and with your eyes closed, you feel Nelson lower your legs until they rest against the fabric of the blanket, followed by sounds you take to be him standing up again. His breath audibly quickens after that, and you can hear a few horny grunts from your stallion partner.";
	WaitLineBreak;
	say "     Opening your eyes, you see that the zebra is now towering over you, still fully naked and with his massive shaft held in two hands as they stroke over his erection in urgent movement. Looking down at his handiwork of your sated, panting form, with a hungry gaze, he clearly must have decided that he's earned his own release too.";
	say "     [bold type]What do you do?[roman type][line break]";
	say "     [link](1)[as]1[end link] - Stay where you are and be bukkake'd.";
	say "     [link](2)[as]2[end link] - Glare at the zebra and make him aim his dick to the side.";
	now calcnumber is 0;
	while calcnumber < 1 or calcnumber > 2:
		say "Choice? (1-2)>[run paragraph on]";
		get a number;
		if calcnumber is 1 or calcnumber is 2:
			break;
		else:
			say "Invalid choice. Type [link]1[end link] to get a cum shower or [link]2[end link] to make Nelson aim somewhere else.";
	if calcnumber is 1: [bukkake]
		LineBreak;
		say "     You smile up at Nelson and stroke over your body while giving him lascivious looks. Horned up as he is from your sexual adventure up till now, it doesn't take all that long before the large male lets out a deep grunt, with his balls twitching in their sack as they send forth a first massive spurt of cum. This one splashes down onto the blanket just next to your chest, but the next hits you right over the breastbone, with more equine seed following in the next few shots. Before long, you're drenched in Nelson's cum, well before his own orgasm slowly ebbs off, and the further spurts fall short and just soak the blanket again.";
		say "     Breathing heavily, the farmhand looks down on you and gives a somewhat apologetic smile. 'Sorry for making such a mess,' he tells you, then offers his hand for you to take and pulls you to your feet. 'Come on, let me help you clean up. It's the least I can do.' With that said, he grabs the discarded clothing from the floor and guides you towards the showers, followed by a fun little time of scrubbing each other's naked, soapy forms. Some time later, now clean, towelled and with everyone having their clothes and gear back on, the two of you emerge from the bathroom again. 'It was fun spending a while together with you,' Nelson says and strokes a hand over your arm. He was about to say something further, but gets interrupted by someone shouting, 'Hey! Who messed up my bed? It's wet with something!' Looking a bit sheepishly as he remembers the cummy mess he left there, the zebra hurriedly adds, 'Hope to see you later, I gotta go deal with that now.' And with that, he rushes off to come clean to his comrade.";
	else if calcnumber is 2: [nope]
		LineBreak;
		say "     Meeting the zebra's gaze, you glare at him and shake your head, making it clear that you're not up for being cummed on. Shame-facedly, he turns his body to the side, aiming his erection at the bed instead of your body. Horned up as the man is from your sexual adventure up till now, it doesn't take all that long before he lets out a deep grunt, with his balls twitching in their sack as they send forth a first massive spurt of cum. It splashes down onto the blanket fairly close to yourself, and he takes care to direct the further spurts more to the side after that. Breathing heavily, the farmhand looks down at the bed and yourself, then pants out, 'Man, I really needed that.' Then he offers his hand for you to take and pulls you to your feet. 'Come on, let me help you clean up. It's the least I can do.' With that said, he grabs the discarded clothing from the floor and guides you towards the showers, followed by a fun little time of scrubbing each other's naked, soapy forms. Some time later, now clean, towelled and with everyone having their clothes and gear back on, the two of you emerge from the bathroom again. 'It was fun spending a while together with you,' Nelson says and strokes a hand over your arm. He was about to say something further, but gets interrupted by someone shouting, 'Hey! Who messed up my bed? It's wet with something!' Looking a bit sheepishly as he remembers the cummy mess he left there, the zebra hurriedly adds, 'Hope to see you later, I gotta go deal with that now.' And with that, he rushes off to come clean to his comrade.";
	NPCSexAftermath Nelson receives "OralPussy" from Player;

to say NelsonSex3: [player sucks Nelson]
	say "     As you lay a hand on the zebra farmhand's crotch and casually ask if he needs to let off some steam, you feel a throb under your fingers. 'I do, you got that right [sir]! These equine balls pretty much always are ready to deliver! Which is great, but a bit difficult if you live together with only dudes. Your dobie bitch really has been a godsend! Too bad there's only one of her for all of us.' He chuckles and gives you a thankful smile, while you continue to lightly grope his bulge. Nelson's breath quickens a little as your attention inevitably arouses him, further filling out his manhood and making it strain against the fabric of his pants. The large male's face takes on a lusty, but somewhat pinched expression before long, and you grin at the power you have over the man by just touching him, continuing for a little while before popping the button of the jeans and drawing his zipper down.";
	say "     Nelson groans as you free his cock from its confinement, his thick black shaft of equine maleness almost bursting out of his pants, hitting the side of your arm and leaving a wet smear of pre-cum on it. 'Nnngh! Thank you, it was getting a bit tight in there!' You continue pulling on his pants, shimmying them down on his thighs until the towering male's heavy pair of balls is finally dangling freely. Cupping the twinned proof of his virility, you lightly squeeze and fondle the zebra's balls and wrap your other hand around his shaft. With his family jewels in your grip, you look straight into Nelson's eyes and offer to blow him. 'Hell yeah!' comes the man's instant reply, followed by the words, [if player is female]'I sure won't say no when a sexy gal offers to take care of me[else]'Damn, before all of this shit, I'd have been antsy about a dude offering. But now, I'll say bring it on! Just don't expect me to return the favor, alright?[end if]!'";
	WaitLineBreak;
	say "     You chuckle and smile at Nelson, stroking along the hard length to quickly make it go fully erect, almost a foot and a half in length. The blunt head of his equine erection is wet with pre-cum as it leaks from the cum-slit, which you spread along his shaft while jerking your hand up and down, filling the air with the aroma of his masculinity. Leaning in to the big, striped stallion, you stick out your tongue and run it over the blunt tip of his erection, getting a first taste of his masculinity as you lick up some of the copious pre-cum. Your touch stimulates the anthro zebra into letting out a lusty groan and lowering his hand to rest on top of your head. Eager to continue servicing the sexy male, you open wide and slide your lips over his thick shaft, sinking down on it until his tip tickles the back of your throat. Then you withdraw a little again and start bobbing up and down, all the while Nelson continues to leak more of his pre onto your tongue.";
	say "     'Damn, you're good at this!' your stallion pants in an almost entranced voice, stroking over your head as he lightly grinds his hips forward to meet your sucking mouth. Meanwhile, your tingers continue to caress and stroke Nelson's balls and inner thighs, winding the large man up and getting him closer to orgasming with every moment. You know you almost went too far when he lets out a grunt and a genuine spurt of pre pulses from his dickhead, bathing your tongue in the rich taste of his nut-juice. The zebra breathlessly pants, 'Keep going! Fuck, I'm close!' and moves his hand to the back of your head to push you further onto his shaft, but you catch his wrist and shake your head as you pull back from his erection. As the spit-glistening pole leaves your mouth, you glance up at Nelson and grin broadly, waiting for a few seconds as his shaft throbs right in front of your face.";
	WaitLineBreak;
	say "     Deciding that you've had enough of teasing your boy-toy as a somewhat desperate look spreads on his face, you lean in and kiss his dickhead, followed by opening wide and inhaling as much of his cock as you can in one big gulp. With your tongue plastered to the underside of his shaft and literally feeling his heartbeat as throbs of the erection, you go all out in slurping on Nelson's cock and take his balls in both hands, massaging them in a just firm enough grip. Having been near climax before, this new assault quickly drives the anthro zebra wild. You hear his hooves scape over the floorboards as he shifts his stance, then stomps down hard when his orgasm breaks, letting out a guttural shout of lust as he comes! The very first heavy spurt of seed is almost enough to overfill your mouth, so you quickly swallow it down, only to find yourself confronted with another and another after that.";
	say "     His hand-filling cum factories pulse under your fingers as the send forth a deluge of potent seed, filling your stomach with a meal's worth of rich protein. By the time the big guy calms down and his further spurts ebb off, you're well-sated, but still take care to lick the last little bit off his dickhead. 'God, that felt amazing!' Nelson tells you, beaming with a grin all over his equine face and holding out a large hand to help you up from your position in front of him. 'Couldn't even say who's better, yourself or Alexandra, as it's just so fucking nice. Really appreciate everything you're doing, [sir]!' He keeps gushing a little further about you saving everyone on the farm from horrendous blue balls, then eventually tucks his cock away and zips his jeans back up. After a final friendly squeeze of your shoulder, the zebra gets back to his duties then.";
	NPCSexAftermath Player receives "OralCock" from Nelson;

to say NelsonSex4: [player milks Nelson]
	say "     As you lay a hand on the zebra farmhand's crotch and casually ask if he needs to let off some steam, you feel a throb under your fingers. 'I do, you got that right [sir]! These equine balls pretty much always are ready to deliver! Which is great, but a bit difficult if you live together with only dudes. Your dobie bitch really has been a godsend! Too bad there's only one of her for all of us.' He chuckles and gives you a thankful smile, while you continue to lightly grope his bulge. Nelson's breath quickens a little as your attention inevitably arouses him, further filling out his manhood and making it strain against the fabric of his pants. The large male's face takes on a lusty, but somewhat pinched expression before long, and you grin at the power you have over the man by just touching him, continuing for a little while before popping the button of the jeans and drawing his zipper down.";
	say "     Nelson groans as you free his cock from its confinement, his thick black shaft of equine maleness almost bursting out of his pants, hitting the side of your arm and leaving a wet smear of pre-cum on it. 'Nnngh! Thank you, it was getting a bit tight in there!' You continue pulling on his pants, shimmying them down on his thighs until the towering male's heavy pair of balls is finally dangling freely. Cupping the twinned proof of his virility, you lightly squeeze and fondle the zebra's balls and wrap your other hand around his shaft. Stroking along the hard length quickly makes it go fully erect, almost a foot and a half in length. The blunt head of his equine erection is wet with pre-cum as it leaks from the cum-slit, which you spread along his shaft while jerking your hand up and down, filling the air with the aroma of his masculinity.";
	WaitLineBreak;
	say "     You continue to caress and stroke Nelson for a little while, winding the large man up and getting him closer and closer to orgasming. You know you almost went too far when he lets out a grunt and a genuine spurt of pre pulses from his dickhead, landing on the floor with an audible splat. The zebra breathlessly pants, 'Keep going! Fuck, I'm close!' and moves his hand to take over as you pause too long for his taste, but you catch his wrist and shake your head. Holding up your finger in a gesture for him to wait a second, you quickly dig an empty plastic bottle from your gear and uncap it, then press its wide-open end over the cum-slit of your stallion. Nelson is far beyond caring what you might be planning to do with a bottle of his cum, instead just thrusting his hips reflexively as your fingers wrap around his erection once more. This doesn't exactly make it easy to keep your collection bottle lined up, but it is kinda fun to wrestle his cock and stroke it at the same time.";
	say "     As close as you had already gotten him before, it's only a matter of a minute or two before the whole body of your muscle hunk zebra stiffens and he lets out an aroused grunt. A heartbeat later, his whole cock pulses as it gushes forth a heavy blast of creamy whiteness, hitting the end of your bottle with a loud thud. More spurts follow in a rapid tempo, each filling your container further with the zebra's seed. As he effortlessly passes the halfway mark, you can't help but wonder what you'll do if he fills the whole bottle up in one go. Thoughts of trying to snatch up another bottle, letting the overflow splat on the floor or doing some... other things are shooting through your mind in quick succession, and you're still trying to decide which you want to go for when you realize that the volume of Nelson's spurts is actually ebbing off slowly. It's still a respectable amount that spurts out, but not coming with the same urgent force now.";
	WaitLineBreak;
	say "     You continue to jerk Nelson's dick all the way until his orgasm has run its course, milking everything his balls have to give out to fill your bottle almost to the very top. As he finally raises a hand to gently push yours off his by now quite sensitive member, you hear the zebra say, 'Phew, I needed that!' He smiles at you, then begins to pull up his pants and stashes away his shrinking cock. Meanwhile, you put the lid on the bottle and quickly grab a pen, giving it the unambiguous label of 'zebra cum' before packing the bottle away in your backpack. The towering, equine sperm donor looks at you doing so a bit bemusedly, then opens his mouth to say or ask something, only to stop himself and shake his head. Having set his clothes back in order, he pats your arm and says, 'Thanks for giving me a nice time!' and then excuses himself, walking off to chat with some of his buddies.";
	ItemGain zebra cum by 1;

to say NelsonSex5: [player pussy fucked by Nelson]
	say "     Stepping even closer to the zebra farmhand, you hook a hand behind his head and pull him in for a deep kiss that soon involves his tongue exploring your mouth. While exchanging an eager and lustful snog with the big man, his hands explore your form, stroking and touching[if player is naked] the naked curves of your body[else], with his fingers tugging at what clothes you wear[end if]. You enjoy the sensations of just making out with him for a while, then eventually pull back and look him in the eyes, asking the zebra to fuck you. 'Hell yeah! How could I say no to that, [sir]!' he replies in a husky tone, his tongue tracing over his broad lips and an eager gleam burning in his eyes. Taking hold of his large hand, you guide a readily obeying Nelson towards the nearest bed. While it is unlikely that this is actually his, there aren't any complaints from the other horsemen in the room for wanting to use it. In fact, several of them edge closer or move around a little, and the bunch of them seem quietly happy that you're not going off into a hard to see corner or even to another room.";
	say "     Arriving at the bed, you grab the crumpled blanket lying on it and spread it out, creating a smooth surface. Then you[if player is not naked] quickly strip off your clothes and gear and[end if] lie back on the mattress, coming to rest on your angled elbows and looking up at your horny zebra stallion. Nelson watches you with lust in his eyes, his gaze wandering up and down over your body. [if player is male]He hesitates a barely perceptible moment as his eyes run into on the cock rising above your pussy, giving a little shrug to himself before focusing on your female parts instead. [end if]The large male reaches for his zipper, eager to join you on the bed, but you clear your throat and tell him that he could give you a little bit of a show first. Chuckling and giving a broad smile, Nelson flexes first one arm, then the other, sending ripples through the striped pattern on his body as he moves. Quite a sight to behold, this equine hunk, and he poses a little more before spinning around and flicking his tail in your direction.";
	WaitLineBreak;
	say "     You can hear the sounds of his button being undone and a zipper sliding down, then the farmhand hooks his thumbs over the beltline of his jeans and pushes them down. Your gaze is immediately drawn to the firm globes of his buttocks, striped as the rest of him, followed by seeing a glimpse of large, heavy balls swinging between his legs as he kicks the pants off fully. As Nelson slowly turns around next, you're treated to seeing the full erect length of his 15-inch cock, jet-black and blunt like a horse's. 'This is all because of you! Can't get enough of seeing that sexy body of yours!' he says eagerly, and also a bit proudly as he hefts the huge shaft with both hands, stroking slowly up and down over it. As a reply, you spread your legs and trace a single finger over the folds of your sex, raising them to show Nelson the wetness brought on by your arousal. Then you ask him to come and take you.";
	say "     Hooves scrape over the wooden floorboards as Nelson quickly climbs onto the bed with you, getting into position on top. His muzzle dips to kiss you, once again taking up the make-out session you had before, but now it's your turn to grope the hunky farmhand while he his braced in a kind of push-up position to keep the weight of his body off you. Letting your hands wander, you feel the firm outlines of his abs, stroking over the short, striped coat on his torso and working your way up to his pecs. The meaty packs of muscle are a handful, protruding over his lower chest, and you playfully squeeze them, then pinch his nipples. That was just the right thing to do apparently, as he moans into your mouth mid-kiss, followed by him panting the words, 'God, that fells nice!' Chuckling at the thought of a big, strong zebra-dude having a sensitive spot like that, you move your fingers over his right breast and pinch him again, causing him to push himself up as he grunts in lust. This gives you just the opening you need, raising your head and planting your lips on the other pec, right over his second pleasure-button.";
	WaitLineBreak;
	say "     Sticking out your tongue to lick him, you trace its tip over the little fur-less nub. Your hands resting against the sides of Nelson's torso feel his muscles tense, with the farmhand grunting out, 'Fuckyeah! Fuuuckk!' By pushing his arousal to new heights like this, you seem to have short-circuited the zebra's urges, as the next thing you feel is the warmth of his thick cock grinding against your crotch and stomach. [if player is male]Even the fact that it is rubbing right against your own cock, sliding up and down along it, doesn't seem to faze the usually a bit straight-laced equine male one bit right now. [end if]Hands digging into the blanket and mattress over your head as he humps reflexively, Nelson throws his head back moans loudly. Recognizing that even aiming where he thrusts is outside of the big man's capability in the rutting mindset he has right now, you let go of his nipple long enough to glance down and catch the huge cock leaving tracks of pre-cum on your body.";
	say "     Eager to feel his unchained power, you nudge Nelson's dickhead right between the folds of your nether lips and find yourself impaled deeply on the huge cock a heartbeat later. Your gasp at the sudden, deep penetration joins the beast-like sounds Nelson is making right now, and you have no doubt that simply everyone in the whole barracks is staring at the two of you, not that you have even a second to think about that though. No, your mind is fully on the big horny male hammering into your sex, and your arms wrap around his torso to pull yourself against his warmth. While doing so, you feel the protrusion of one of his nipples against your cheek and proceed to move your mouth over it again, getting back to licking, sucking and lightly biting it. It isn't always easy, as some of his heavier thrusts make you bounce, but you always return quickly to continue suckling on the proud stallion.";
	WaitLineBreak;
	if Cunt Depth of Player + 2 < Cock Length of Nelson: [standard value for Nelson: 15]
		if Player is not twistcapped: [doesn't fit, even with stretching]
			say "     Ramming his enormous cock into you as far as it will go in his animalistic rut, Nelson keeps hitting your cervix with all of his deeper thrusts. Still, you barely register any pain caused by his impatient pushing, not compared to the overwhelming pleasure of being fucked by your zebra hunk. Meanwhile, his erection makes your innards shift and flex a little, but this is apparently as deep as he can go, with any further force simply bouncing you up a little, swinging underneath the large man as you hold onto him with your arms. 'Nnnnghh!' comes a lust-filled grunt from Nelson, and he throbs hard inside you before withdrawing halfway and ramming himself home once again. ";
			increase Cunt Depth of Player by 1; [oversized fucks stretch characters bit by bit]
		else:
			say "     Ramming his enormous cock into you as far as it will go in his animalistic rut, Nelson keeps hitting your cervix with all of his deeper thrusts. At first there is a little bit of pain from the impatient pushing against your inner barrier, which you barely register compared to the overwhelming pleasure of being fucked by your zebra hunk. Then suddenly, you feel your innards shift and flex a little, apparently surrendering to his intrusion and allowing his pole to fully slot into you. 'Nnnnghh!' comes a lust-filled grunt from Nelson, and he throbs hard inside you before withdrawing halfway and ramming himself home once again. ";
	else: [he fits in the player]
		say "     Ramming his enormous cock into you as far as it will go in his animalistic rut, Nelson's whole thick length vanishes inside your receptive pussy, with his heavy balls smacking against your crotch every time. 'Nnnnghh! Take all of my cock!' comes a lust-filled grunt from Nelson, and he throbs hard inside you before withdrawing halfway and ramming himself home once again. ";
	say "The continued sensations of your inner muscles clamping down hard around his shaft drive Nelson wild, and the volume of his horny bellows and grunts increases more and more. Your own lust-fogged mind recognizes that he can't last much longer now, so you decide to act and push him over the edge. Lifting your legs to clamp them up around his hips, you pull yourself fully against the large zebra, then give his pec another love-bite, with your tongue slurping over his sensitive nipple and teasing it.";
	say "     'Fuuuck yeah!' Nelson shouts loudly, burying himself into your needy pussy as far as he can, just in time for his balls to spasm and sending forth a deluge of rich zebra seed to flood your womb. Throb after heavy throb, you feel his shaft pulse inside your stretched pussy, adding more equine baby-batter by the second. There barely seems an end to it, and you continue to cling to the heaving chest of the big man, with the sensation of his manhood moving inside you and stuffing you full of cum sending your own primal urges into overdrive. Receiving a seemingly inexaustible load from such a prime stud has your womb literally gushing with pleasure-hormones, and to it is only some scant moments later that you feel the building wave of an orgasm crash over you. [if player is male]Your own [cock of player] shaft sticks up stiffly against Nelson's abs and starts to pulse, drenching your pressed-together stomachs in sticky seed even as femcum leaks[else]Gasping, you feel femcum leak[end if] from your folds, trickling over Nelson's still-plusing balls.";
	WaitLineBreak;
	say "     You feel the moment in which the zebra's climax starts to wane eventually, both from a reduction in his further blasts of cum into your overstuffed pussy, as well as the fact that your back brushes against the blanket underneath you as the anthro eqine lowers himself to the bed. For a second, it seems like you'll be pinned underneath his bulk, but the big man rolls the two of you over onto your sides before that can happen. 'Wow, that was quite a ride,' he pants, looking you into the eyes with a happy, but exhausted expression on his face. 'Hope I didn't go too wild. It's just, well, if someone plays with my nipples, all the stops come out.' Pointing down and patting your belly, bulging out further than just a little while ago from both his massive load and Nelson's slowly softening cock inside, you quip that you did notice that. The two of you keep talking a little, just lying there in post-coital bliss for a while.";
	say "     When Nelson's erection eventually slips from your pussy, together with a gush of semen, he quickly pulls up a bit of fabric to help you soak that up, a mixture of embarrassment at the mess and pride for his virility on his face. 'Sorry, I guess I creamed you good,' he tells you, then gets off the bed and offers his hand for you to take. 'Come on, let me help you clean up. It's the least I can do.' With that said, he grabs the discarded clothing from the floor and guides you towards the showers, followed by a fun little time of scrubbing each other's naked, soapy forms. Some time later, now clean, towelled and with everyone having their clothes and gear back on, the two of you emerge from the bathroom again. 'It was fun spending a while together with you,' Nelson says and strokes a hand over your arm. He was about to say something further, but gets interrupted by someone shouting, 'Hey! Who messed up my bed? It's wet with something!' Looking a bit sheepishly as he remembers the cummy mess he left there, the zebra hurriedly adds, 'Hope to see you later, I gotta go deal with that now.' And with that, he rushes off to come clean to his comrade.";
	NPCSexAftermath Player receives "PussyFuck" from Nelson;

to say NelsonSex6: [player ass fucked by Nelson]
	say "     Stepping even closer to the zebra farmhand, you hook a hand behind his head and pull him in for a deep kiss that soon involves his tongue exploring your mouth. While exchanging an eager and lustful snog with the big man, his hands explore your form, stroking and touching[if player is naked] the naked curves of your body[else], with his fingers tugging at what clothes you wear[end if]. You enjoy the sensations of just making out with him for a while, then eventually pull back and look him in the eyes, asking the zebra to fuck your ass. ";
	if player is female: [has a pussy, still wants it in the ass]
		say "'Hell yeah! I love kinky chicks!' he replies in a husky tone, his tongue tracing over his broad lips and an eager gleam burning in his eyes. Taking hold of his large hand, you guide a readily obeying Nelson towards the nearest bed. While it is unlikely that this is actually his, there aren't any complaints from the other horsemen in the room for wanting to use it. In fact, several of them edge closer or move around a little, and the bunch of them seem quietly happy that you're not going off into a hard to see corner or even to another room.";
	else: [he'll fuck a dude, because that's totally not gay ;)]
		say "Eyebrows rising, Nelson puts a hand on your shoulder and clears his throat. 'I'm not gay, dude. Just wanna make sure you understand that. Though with how quickly my balls ache for release these days, I kinda see the point now in what some buds of mine kept saying. A hole's a hole, and all that. So... I'm game if you wanna be railed like a filly. Just don't expect a reacharound or anything,' he replies, at first a little haltingly, then with an almost boisteous tone at the end. Patting Nelson's arm and winking at him, you stroll over to the nearest bed, closely followed by the striped stallion. While it is unlikely that this is actually his, there aren't any complaints from the other horsemen in the room for wanting to use it. In fact, several of them edge closer or move around a little, and the bunch of them seem quietly happy that you're not going off into a hard to see corner or even to another room.";
	say "     Arriving at the bed, you grab the crumpled blanket lying on it and spread it out, creating a smooth surface. Then you[if player is not naked] quickly strip off your clothes and gear and[end if] climb on the bed, getting on all fours and raising your rear in open invitation Nelson watches you with lust in his eyes, his gaze wandering up and down over your body. [if player is male]He hesitates a barely perceptible moment as his eyes glimpse what's between your legs, followed by a little shrug to himself. [end if]The large male pops the button of his pants and pulls down the zipper, eager to get some action. Hooves scrape over the floorboards as he pushes down his jeans, then kicks them off, stepping up behind you. Chuckling, the zebra smacks his cock into the crack between your buttocks and rubs it up and down, making you feel the girth and warmth of his member. Gathering a glob of spit, Nelson lets it drip onto your hole off his outstretched tongue, rubbing his erection over it to get it wet and ready.";
	WaitLineBreak;
	say "     Meanwhile, you lower your front onto the bed, freeing both hands to reach back and spread those cheeks, opening yourself up for the horny anthro. He is quick enough to make use of the invitation, aligning the flared head of his erection with your back door entrance. You can feel it pressing against your pucker, first slowly then with increasing force that your body surrenders to him quickly. Both of you moan out loud as he pops in, stretching the walls of his hole around his girth. Pushing deeper, he sinks inch by inch into you while letting his hands wander up to your shoulders, getting a good grip. 'God, that feels nice. Warm and tight around my shaft!' Nelson grunts as he bottoms out soon after, his hard schlong throbbing in your hole. 'Can't wait to fuck that ass of yours. You ready?' Proving himself slightly impatient, he starts moving before you've even started to nod in reply, with his hard length rubbing your inner walls and stimulating you quite nicely.";
	say "     Withdrawing almost all the way, until just the dickhead is left inside you, Nelson tightens his grip on your shoulders, using it as leverage to ram forward hard. You can't help but let out a loud gasp as you find yourself impaled on what feels like one and a half feet of cock, followed by what are basically whorish moans as the big hunk doesn't stop, instead just continuing to move in and out of you in a wild fuck-session. Barely registering the sounds of other farmhands amused and aroused laughs and comments, your world is mainly reduced to just yourself and the huge piece of man-meat fucking you. Nelson seems tireless in hammering your most sensitive spots, leaving you unable to do much more than stay face-planted on the mattress, and maybe drool a little.";
	WaitLineBreak;
	say "     The continued sensations of your inner muscles clamping down hard around his shaft drive Nelson wild, and the volume of his horny bellows and grunts increases more and more. Your own lust-fogged mind recognizes that he can't last much longer now, so you decide to act and push him over the edge. Rolling your hips to give him all sorts of new and exciting sensations, you then clamp your hole tight around his thrusting shaft. 'Daaamnn!' Nelson shouts loudly, burying himself in your hungry hole as far as he can, just in time for his balls to spasm and sending forth a deluge of rich zebra seed to flood your back passage. Throb after heavy throb, you feel his shaft pulse, adding more equine baby-batter by the second. There barely seems an end to it, and you continue to serve as his cum-receptable, with the feeling of his manhood moving inside you and stuffing you full of cum sending your own primal urges into overdrive.";
	say "     It is only some scant moments later that you feel the building wave of an orgasm crash over you. [if player is male]Your own [cock of player] shaft is hard as a rock and starts to pulse, splattering the blanket under you in sticky seed even as femcum leaks[else]Gasping, you feel femcum leak[end if] from your folds, trickling down the insides of your legs. You feel the moment in which the zebra's climax starts to wane eventually, both from a reduction in his further blasts of cum into your overstuffed ass, as well as the fact that you are pushed down onto the mattress as the anthro eqine sinks forward on top of you. For a second, it seems like you'll be pinned underneath his bulk, but the big man rolls the two of you over onto your sides before that can happen. 'Wow, that was quite a ride,' he pants, looking you into the eyes with a happy, but exhausted expression on his face. 'Hope I didn't go too wild. When it's pounding time, I just kinda go for it, you know.' Pointing down and patting your belly, bulging out further than just a little while ago from both his massive load and Nelson's slowly softening cock inside, you quip that you did notice that. The two of you keep talking a little, just lying there in post-coital bliss for a while.";
	WaitLineBreak;
	say "     When Nelson's erection eventually slips from your ass, together with a gush of semen, he quickly pulls up a bit of fabric to help you soak that up, a mixture of embarrassment at the mess and pride for his virility on his face. 'Sorry, I guess I creamed you good,' he tells you, then gets off the bed and offers his hand for you to take. 'Come on, let me help you clean up. It's the least I can do.' With that said, he grabs the discarded clothing from the floor and guides you towards the showers, followed by a fun little time of scrubbing each other's naked, soapy forms. Some time later, now clean, towelled and with everyone having their clothes and gear back on, the two of you emerge from the bathroom again. 'It was fun spending a while together with you,' Nelson says and strokes a hand over your arm. He was about to say something further, but gets interrupted by someone shouting, 'Hey! Who messed up my bed? It's wet with something!' Looking a bit sheepishly as he remembers the cummy mess he left there, the zebra hurriedly adds, 'Hope to see you later, I gotta go deal with that now.' And with that, he rushes off to come clean to his comrade.";
	NPCSexAftermath Player receives "AssFuck" from Nelson;

to say NelsonSex7: [fucking Nelson]
	if Lust of Nelson is 0: [never talked about 'gay' stuff]
		say "     As you ask the zebra farmhand if you can fuck his ass, the large man looks at you with a puzzled expression and raises his hands defensively. 'Wow, wow - where did that come from?! Sorry to tell ya, but my ass is off limits! Nothing going in there, no way! That'd be really gay!' Shrugging those impressively wide shoulders of his apologetically, he grasps the side of your arm and gives it a squeeze. 'So, no hard feelings, eh? I'm sure you got... a really nice dick and whatever. I just don't want it in my rear end, alright?' He's clearly a bit embarrassed about your request and quickly changes the topic after that, chatting about nothing of real importance before excusing himself a little while later.";
		now Lust of Nelson is 1;
	else:
		say "     [bold type]Error Nelson[Lust of Nelson]! Please report how you saw this message on the Flexible Survival Discord![roman type][line break]";


Section 4 - Nelson Breeding

to say AlexandraBreeding_Nelson:
	project the Figure of Alexandra_clothed_icon;
	say "     A smile plays over your lips as you tell Alexandra that you want to see her in another session with Nelson. The former cop lets out an amused snort, then comment, 'Hah! You like seeing that huge hunk of a zebra on top of me, ain't that right boss?! Him driving that massive equine cock into my pussy and making my belly bulge! Always a fun time in this breeding program you're so invested in!' Grabbing her by the back of the neck, you pull the bitch closer and kiss her a little forcefully. Letting your hands wander over her breasts, you remind Alexandra that she's your bitch, and you'll have her bred whenever you want. 'Yeah boss, anything you say. I'm down for some breeding, so let's get going!' With that, you guide her over to where you spotted the zebra horsemen earlier, a broad grin on your face.";
	if Nelson is not asleep:
		say "     'Hello again, [Sir],' Nelson says respectfully, standing up from where he was sitting and dipping the rim of his cowboy hat. Before you can say anything in reply, Alexandra is already sauntering up to the large zebra, giving him a tooth-bearing grin. 'It's your lucky day, stud!' she says, stroking a paw-hand over his rippling abs and then sinking down to her haunches in front of the man. Her fingers quickly undo the button of his jeans and his zipper, followed by tugging the garment down from his crotch. 'OH!' Nelson grunts, his cock starting to push out from its sheath with a twitch. Some wolf whistles from other horsemen start up as Alexandra begins to lap at the zebra's growing cock and balls, giving him enthusiastic oral pleasure. The moaning farmhand moves a hand to rest on Alexandra's head, stroking it and pushing her to continue, then looks over to you. 'Guess I don't have to ask what you're planning, eh? Man, I really gotta say - farm life has gotten incredible since you've showed up with your bitch! Thank you, [sir]! It's awesome [if Alexandra is BarracksSlut]to be able to spread her sweet pussy regularly[else]to get regular blowjobs from her[end if]!'";
		WaitLineBreak;
	else:
		say "     You reach out for the blanket covering the six foot tall zebra hunk, slowly pulling it off his stretched-out body to reveal his muscular frame in all his naked glory. Nelson must be having some particularly nice dream right now, as you can see his monster of a cock lying half-hard on his abs. Pulling Alexandra close, you give her breasts another appreciative squeeze, then whisper into her ear that she should be the one to wake up this sleeping hunk. 'Sure thing,' she answers with a smile, climbing onto the bed with the zebra and bringing her head forward to lap over his manhood. Eyes roaming over the stallion, then back to your tough, but obedient bitch, you stroll over to stand next to the bed  beside Nelson's head. It doesn't take long before Alexandra's ministrations make him stir in his sleep, moving a little and letting out a low moan. He raises a hand to rub the sleep from his eyelids and finds himself meeting your gaze as the sleep-drowsy look vanishes from his eyes.";
		WaitLineBreak;
		say "     '[if player is not defaultnamed][name of Player]! [else][Sir]! [end if]What's -' is as far as he gets before Alexandra opens her muzzle wide and slides it over one of his massive balls, letting her lips and floppy tongue play over the bulging cum-factory as she sucks on it. 'NNnghhh! Fuck yeah!' Nelson grunts and pushes himself up on his elbows, allowing him to look down over his chest and see the firm tower of his erection, wet with spit and in Alexandra's hand. He doesn't see much of the doberwoman's face, mainly the ears poking up from where she's between his legs and worshiping the zebra's balls. The moaning farmhand moves a hand to rest on Alexandra's head, stroking it and pushing her to continue, then looks over to you. 'Guess I don't have to ask what you're planning, eh? Man, I really gotta say - farm life has gotten incredible since you've showed up with your bitch! Thank you, [sir]! It's awesome [if Alexandra is BarracksSlut]to be able to spread her sweet pussy regularly[else]to get regular blowjobs from her[end if]!'";
	say "     You let things continue for a little while longer, with Alexandra taking the blunt tip of Nelson's cock into her mouth, floppy tongue lapping at its flared rim and the slit that he's leaking pre-cum out of. It feels really good to know that you've got absolute authority over the breeding bitch that you've turned this former cop into, and through using her, even a muscular hunk like Nelson basically feeds from your hand. Reveling in the sensation, you then bring your hand up to your mouth and give a sharp whistle, at which point both Alexandra and Nelson come to stand before you, ready for their instructions.";
	LineBreak;
	say "[AlexandraZebraSexMenu]";

to say AlexandraZebraSexMenu:
	now sextablerun is 0;
	blank out the whole of table of fucking options;
	say "     [bold type]How do you want this to go from here?[roman type][line break]";
	[]
	choose a blank row in table of fucking options;
	now title entry is "You want Alexandra to ride Nelson, cowgirl style";
	now sortorder entry is 1;
	now description entry is "Put Nelson on his bed and have Alexandra mount his pole";
	[]
	choose a blank row in table of fucking options;
	now title entry is "Nelson should bend the bitch over one of the tables and pound her pregnant";
	now sortorder entry is 2;
	now description entry is "Let the zebra breed her, right in the middle of the room";
	[]
	sort the table of fucking options in sortorder order;
	repeat with y running from 1 to number of filled rows in table of fucking options:
		choose row y from the table of fucking options;
		say "[link][y] - [title entry][as][y][end link][line break]";
	say "[link]0 - Nevermind[as]0[end link][line break]";
	while sextablerun is 0:
		say "Pick the corresponding number> [run paragraph on]";
		get a number;
		if calcnumber > 0 and calcnumber <= the number of filled rows in table of fucking options:
			now current menu selection is calcnumber;
			choose row calcnumber in table of fucking options;
			say "[title entry]: [description entry]?";
			if Player consents:
				let nam be title entry;
				now sextablerun is 1;
				if (nam is "You want Alexandra to ride Nelson, cowgirl style"):
					say "[AlexandrazebraBreeding1]";
				else if (nam is "Nelson should bend the bitch over one of the tables and pound her pregnant"):
					say "[AlexandrazebraBreeding2]";
				wait for any key;
		else if calcnumber is 0:
			now sextablerun is 1;
			say "     As you change your mind and tell the two of them that sex is off for right now, Alexandra bursts out with, 'You can be an utter bastard sometimes! Getting a bitch all hot and bothered and then...' She stops herself from ranting and just gives you a frustrated bark, then stomps off to sulk. Meanwhile, Nelson is left standing where he is, speechless. He stares at the doberwoman as she walks off, then at you. 'But, but...' he stammers, his gaze switching to his own cock, standing hard and ready with a shiny coating of Alexandra's spit. Finally, he blows out his breath, then wanders off towards the showers - to jerk off, cool off, or likely both.";
			wait for any key;
		else:
			say "Invalid Option. Pick between 1 and [the number of filled rows in the table of fucking options] or 0 to exit.";
	clear the screen and hyperlink list;

to say AlexandrazebraBreeding1: [cowgirl style]
	say "     With a grin spreading over your face, you tell Nelson that Alexandra dreamed of being a cowgirl when she was a little girl, and you want to fulfill that wish for her. 'Yeah, that and get me knocked up!' the dobie bitch throws in with a snort, which you pay her back by giving her a playful swat on the rump. Nelson watches the interplay between you with a grin and grabs his erection, wagging it up and down so it thuds against his rock hard abs. '[Sir], I'm your pony, err - zebra for that job!' the farmhand replies eagerly, his eyes eating up Alexandra, mostly focusing on her breasts. It's quick work to instruct them about the positions you want to see them in, and before long, Nelson is stretched out naked on his bed, upper body propped up on his elbows so he can watch the show of Alexandra stripping, same as every other male [if Corbin is in Worker Barracks and HP of Corbin > 0]and cuntboy[end if] present.";
	say "     As she presents herself gleefully when shrugging off the leather jacket, first covering her breasts, then pinching her nipples and making them bounce, wolf whistles rise from the watching crowd. Her very tight jeans are the next to go, being inched down over her long legs by the bent-over bitch. In the back of the room, you can hear one of the guys gripe a little about being jealous of Nelson, with his neighbor slapping the back of his head lightly and saying, 'Better shut up, or [if Alexandra is BarracksSlut]she'll put you at the end of the list for breeding her[else]will let you wait days before she blows you next[end if]! She doesn't like whiners.' Watching her closely, you spot a twitch of Alexandra's pointy ears and her muzzle pulling into a bit of a smirk. She heard them too and clearly enjoys being able to wrap all of these hunks around her finger quite a bit.";
	WaitLineBreak;
	say "     As the pair of jeans falls onto the ground in a loose heap, Alexandra is left wearing just the one piece of clothing - a pair of panties that she's chosen to wear today, as a change of pace. It is a slim, black affair with few frills to it, which suits the tough bitch quite well. The dobie lowers her hand to stroke herself through the thin material, moaning out loud and letting her gaze sweep over the watching crowd. She gives some winks to this guy or that, licking her lips as she looks at those that have erect cocks out and are stoking them. Then finally, she slips the last fabric off her body, now somewhat sodden from her own arousal. Laughing, Alexandra balls the panties up and throws them at Nelson, to land on his broad, muscular pecs. The zebra lets out a horny grunt, snatching up the skimpy garment and bringing it up to his nose for a long sniff. You can see a fresh spurt of pre-cum well up from his dickhead, drawing a sticky line in the air as it then drips down to his abs.";
	say "     'Horsie ride time, eh boss?' Alexandra says to you, shaking her chest to make those full breasts wiggle, then steps up onto the bed, standing over the stallion you selected to breed her. 'God, you're a beautiful woman,' Nelson compliments her, putting aside the panties to focus his whole attention on the naked anthro before him. 'Bitch, you mean!' Alexandra corrects him amusedly, then starts to crouch down over the zebra, one foot-paw on each side of his hips. The lighter, almost blonde bush of her crotch fur brushes the side of Nelson's cock, prompting the horny man to take hold of his erection and keeping it steady for her. 'That's a good pony!' comes your tough bitch's comment as she slides her nether lips up and down along his shaft, adding female juices to the saliva already coating Nelson's manhood. He lets out a breathless, aroused pant, hands gripping the sides of the bed tightly to stop himself from grabbing Alexandra and ramming her down on his erection right now.";
	WaitLineBreak;
	if Player is female: [player has a pussy, so Nelson's alright with oral]
		say "     [bold type]Watching the two of them go at it, the thought rises in you to get some pleasure yourself.[roman type][line break]";
		say "     [link](1)[as]1[end link] - Climb on top of Nelson and have him eat you out.";
		say "     [link](2)[as]2[end link] - Just stay on the sidelines and watch them.";
		now calcnumber is 0;
		while calcnumber < 1 or calcnumber > 2:
			say "Choice? (1-2)>[run paragraph on]";
			get a number;
			if calcnumber is 1 or calcnumber is 2:
				break;
			else:
				say "Invalid choice. Type [link]1[end link] to get your pussy licked or [link]2[end link] to stay on the side and watch.";
		if calcnumber is 1: [pussy eating]
			LineBreak;
			say "     Feeling randy, you [if player is not naked]quickly strip down and [end if]drop your gear into a pile next to the bed, then give Nelson's shoulder a light slap and tell him that he's having more than one partner today. The zebra glances aside, [if Player is not male]a lusty smirk spreading over his muzzle as his eyes take in your naked form[else]momentarily concerned as he focuses on your dick before you explain that he'll just be taking care of your female parts[end if]. 'Yes [sir]!' he replies eagerly. 'Love how much of a kinky freak you are, boss! Not just wanting me bred, but also being there right in the action,' Alexandra comments with a chuckle, then sinks herself down further onto Nelson and rotates her hips in circling movements to make the zebra let out a breathless moan.";
			say "     You choose that moment to swing your leg over him, straddling the stallion's chest while still keeping Alexandra's gaze locked to your own. Leaning forward to kiss the dobie bitch, you stick your rear out at the same moment, pushing the folds of your pussy closer to Nelson's head. The zebra is quick on the uptake as you present yourself like that, and he starts licking your slit with his broad, wet tongue, filling the room with slurping noises. Alexandra makes out with you while also bouncing up and down on Nelson's cock, then eventually draws back a little and grins at you. 'Wanna see what you've arranged to push up my pussy?' the doberwoman asks, already pushing her hips down and leaning backwards before you can reply. This allows more of Nelson's dick inside her than before, with her stomach showing a distinct bulge from the blunt head of his erection as it pushes into her abs from the inside.";
			WaitLineBreak;
			if Cunt Depth of Alexandra + 2 < Cock Length of Nelson: [standard values: 10 (+2 stretching allowance) vs 15]
				say "     Your bitch lets out a breathless moan as she finally stops, with not quite all of his manhood inside her. 'Damn, our boy's a big one, isn't he?' Alexandra says with a lusty gleam in her eyes. Looking down, you can see her female juices trickle down over the last inches of his cock, a clear sign of her arousal at what you're making her do. 'His dickhead is right against my cervix, pressing against the gates of the puppy factory!' the dobie pants out, lowering a hand to cradle the cock-bulge on her stomach. 'Let's go the rest of the way!' she then adds in a manic tone, lifting herself up a little before hammering down into his shaft with full force. [if TwistedCapacity of Alexandra is false]The former cop trashes around and lets out almost feral sounds as she impales herself on the enormous cock, with it forcing its way into her womb. 'Fucking hell is he big!' she shouts, holding back a whimper at the pain. Yet at the same time, she's into it too, [else]The former cop screams victoriously as her altered body somehow accommodates to let him slip into her womb. 'Fuck yeah, that's one big dick!' she barks out with harsh laughter, [end if]gushing more female juices over his crotch-fur.";
				say "     Finding himself fully sheathed inside Alexandra, with her sex squeezing down on his cock, Nelson goes wild beneath you. He lets out throaty moans and his tongue is all over the place - one moment lapping at your clit, the next worming its way into your vagina. After pausing for a moment to get used to his girth inside her, Alexandra begins to rock up and down on Nelson's cock again, fucking herself on his manhood. 'Damn, I love this monster dick in me! Blast some puppies up that pussy, Nelson!' Mumbling something unintelligible under you, tongue still up your pussy, Nelson starts to hump his hips upwards, meeting Alexandra as she slides down and making her bounce on his cock, with the two of them driving each other to new heights of arousal. ";
				if TwistedCapacity of Alexandra is false:
					increase Cunt Depth of Alexandra by 1; [oversized fucks stretch characters bit by bit]
			else: [he actually fits into her]
				say "     Your bitch lets out a breathless moan as she finally stops, her nether lips spread wide around his girth and all of the humongous cock inside her. 'Damn, I love being able to take huge cocks like that one now! All the fucking really worked out my pussy!' Alexandra says with a lusty gleam in her eyes. Looking down, you can see her female juices trickle down and soak Nelson's crotch-fur, a clear sign of her arousal at what you're making her do. 'Just look at it!' the dobie pants out, lowering a hand to cradle the cock-bulge on her stomach. Finding himself fully sheathed inside Alexandra, with her sex squeezing down on his cock, Nelson goes wild beneath you. He lets out throaty moans and his tongue is all over the place - one moment lapping at your clit, the next worming its way into your vagina. After pausing for a moment to get used to his girth inside her, Alexandra begins to rock up and down on Nelson's cock again, fucking herself on his manhood.";
				say "     'Damn, I love this monster dick in me! Blast some puppies up that pussy, Nelson!' Mumbling something unintelligible under you, tongue still up your pussy, Nelson starts to hump his hips upwards, meeting Alexandra as she slides down and making her bounce on his cock, with the two of them driving each other to new heights of arousal. ";
			say "Seeing the pairing that you've set up come closer and closer to its conclusion, you revel in your power over these two, with Alexandra broken in to be your breeding bitch, and Nelson servicing you eagerly as you control him through his sex drive. Between those two things, and your hand slipping down to your crotch to caress [if player is male]your own cock[else]your clit[end if], it doesn't take much longer before you reach your climax. Rocking your whole body back against Nelson's muzzle, you tremble and quiver around his wriggling tongue, gushing female juices over his face[if player is male] at the same time as your cock shoots out long streaks of cum that paint a pattern on his abs and chest[end if].";
			WaitLineBreak;
			say "     Your orgasm appears to be the signal that both of your partners were waiting, without even knowing it, as both of them follow you past the point of no return just a few moments later. Still licking and slurping away at your pussy, his muzzle smeared with your juices, Nelson bucks his hips up HARD and grunts loudly as his erection starts to pulse into the dobie on top of it. You can literally see the blunt zebra dickhead throb under Alexandra's abs, delivering a deluge of thick, creamy cum right into her womb. There is so much of it that her belly swells, almost as if already pregnant, eventually obscuring the outline of Nelson's cock as a smoothly rounded curve takes its place on her stomach. Intensely aroused at fulfilling the demands you set for her and letting herself be bred, Alexandra barks loudly as she herself orgasms, the moment Nelson's first spurt of seed paints her womb white. She cradles her stomach, feeling it swell moment by moment while her pussy squeezes his cock tightly and femcum gushes out of it.";
			say "     The three of you stay in that position for a while, with Alexandra and yourself on top of Nelson, leaning against each other in content exhaustion while the big male just lies there, slowly stroking your bodies. The dobie bitch is the first to speak eventually and says, 'Man, I feel stuffed! So much cum, and a huge zebra dick too, hah!' She runs her hands over the curve of her swollen stomach, grinning broadly. 'Almost a pity that I gotta get off him at all, but hopefully this puppy mill will swell of its own soon.' With that said, she gingerly pushes herself up, getting her paws under her so she can slide along Nelson's still fairly hard erection, until only the flared head remains inside her body, making her pussy lips bulge out a little.";
			WaitLineBreak;
			say "     Then the former cop pulls off him with a sudden tug, allowing Nelson's cock to flop down on his abs with a thud, followed by a gush of frothy cum escaping from her overstuffed pussy. It washes over the big zebra, soaking the fur of his crotch, midriff and thighs, as well as the sheets beneath. Of course, some of it also splashes back up and hits you, which the bad bitch apparently was counting on. 'You wanted to be right in the middle of the action, boss!' she says with a smirk, then steps down from the bed, grinning broadly. Keeping a hand over her pussy to catch further cum spilling out, the doberwoman then saunters over towards the shower. You yourself get off Nelson too, sitting down on the edge of the bed for a moment and letting your gaze sweep over your gear, pushing it aside a little so that it won't get dirty when you or him follow Alexandra to clean up.";
			say "     'Man, what an incredible lay,' Nelson comments as he sits up behind you a moment later, dabbing at his soaked fur with the bedsheet. 'Though I gotta say, she'd be a bit bitchy to live with all the time. Say, how do you deal with that? Or did you pick her because you like butting heads?' The two of you exchange some more words, talking about your views on Alexandra while Nelson pulls off the sex-smelling bed linen and balls it up, to dump in a large clothes hamper when you finally make your way to the showers to wash down. A little while later, all of you are back in the main room of the worker barracks, clean and fresh.";
			NPCSexAftermath Nelson receives "OralPussy" from Player;
		else:
			LineBreak;
			say "[AlexandrazebraBreeding1_Watch]";
	else:
		say "[AlexandrazebraBreeding1_Watch]";
	now lastdobiemess is 86; [Nelson came in her]
	impregAlexandraChance with "Nelson"; [chance to knock her up]
	NPCSexAftermath Alexandra receives "PussyFuck" from Nelson;

to say AlexandrazebraBreeding1_Watch:
	say "     Deciding to stay out of it and simply get a close-up view of the action, you half-sit on the edge of the bed and tell Nelson that you want to see him breed your bitch. The zebra glances aside and replies eagerly, 'Yes [sir]!' Alexandra comments this with a chuckle and the words, 'Love how much of a kinky freak you are, boss! Up close and involved in seeing your bad dog knocked up!' With that said, she sinks herself down further onto Nelson and rotates her hips in circling movements to make the zebra let out a breathless moan. At the same time, she moves her hands to cup the rounded curves of her breasts, jiggling and rubbing them together to entice both of you. The large zebra's gaze is certainly firmly tied to her swaying body, and you yourself can barely take your eyes away either. The doberwoman keeps going like that for a little while, then grins at you. 'Wanna see what you've arranged to push up my pussy?' Alexandra asks with a smirk, already pushing her hips down and leaning backwards before you can reply. This allows more of Nelson's dick inside her than before, with her stomach showing a distinct bulge from the blunt head of his erection as it pushes into her abs from the inside.";
	WaitLineBreak;
	if Cunt Depth of Alexandra + 2 < Cock Length of Nelson: [standard values: 10 (+2 stretching allowance) vs 15]
		say "     Your bitch lets out a breathless moan as she finally stops, with not quite all of his manhood inside her. 'Damn, our boy's a big one, isn't he?' Alexandra says with a lusty gleam in her eyes. Looking down, you can see her female juices trickle down over the last inches of his cock, a clear sign of her arousal at what you're making her do. 'His dickhead is right against my cervix, pressing against the gates of the puppy factory!' the dobie pants out, lowering a hand to cradle the cock-bulge on her stomach. 'Let's go the rest of the way!' she then adds in a manic tone, lifting herself up a little before hammering down into his shaft with full force. [if TwistedCapacity of Alexandra is false]The former cop trashes around and lets out almost feral sounds as she impales herself on the enormous cock, with it forcing its way into her womb. 'Fucking hell is he big!' she shouts, holding back a whimper at the pain. Yet at the same time, she's into it too, [else]The former cop screams victoriously as her altered body somehow accommodates to let him slip into her womb. 'Fuck yeah, that's one big dick!' she barks out with harsh laughter, [end if]gushing more female juices over his crotch-fur.";
		say "     Finding himself fully sheathed inside Alexandra, with her sex squeezing down on his cock, Nelson goes wild on the bed, trashing a bit as he barely controls himself from leaving the position and taking control from the anthro dog riding him. He lets out throaty moans, throwing his head back as his fingers dig into the blankets. After pausing for a moment to get used to his girth inside her, Alexandra begins to rock up and down on Nelson's cock again, fucking herself on his manhood. 'Damn, I love this monster dick in me! Blast some puppies up that pussy, Nelson!' Mumbling something unintelligible under his breath, Nelson starts to hump his hips upwards, meeting Alexandra as she slides down and making her bounce on his cock, with the two of them driving each other to new heights of arousal. ";
		if TwistedCapacity of Alexandra is false:
			increase Cunt Depth of Alexandra by 1; [oversized fucks stretch characters bit by bit]
	else: [he actually fits into her]
		say "     Your bitch lets out a breathless moan as she finally stops, her nether lips spread wide around his girth and all of the humongous cock inside her. 'Damn, I love being able to take huge cocks like that one now! All the fucking really worked out my pussy!' Alexandra says with a lusty gleam in her eyes. Looking down, you can see her female juices trickle down and soak Nelson's crotch-fur, a clear sign of her arousal at what you're making her do. 'Just look at it!' the dobie pants out, lowering a hand to cradle the cock-bulge on her stomach. Finding himself fully sheathed inside Alexandra, with her sex squeezing down on his cock, Nelson goes wild on the bed, trashing a bit as he barely controls himself from leaving the position and taking control from the anthro dog riding him. He lets out throaty moans, throwing his head back as his fingers dig into the blankets. After pausing for a moment to get used to his girth inside her, Alexandra begins to rock up and down on Nelson's cock again, fucking herself on his manhood.";
		say "     'Damn, I love this monster dick in me! Blast some puppies up that pussy, Nelson!' Mumbling something unintelligible under his breath, Nelson starts to hump his hips upwards, meeting Alexandra as she slides down and making her bounce on his cock, with the two of them driving each other to new heights of arousal. ";
	say "Seeing the pairing that you've set up come closer and closer to its conclusion, you revel in your power over these two, with Alexandra broken in to be your breeding bitch, and Nelson being ready to do almost anything as you control him through his sex drive. Letting your hand stray down to your own crotch, you stimulate yourself just a little bit, enjoying the warm glow of lust.";
	WaitLineBreak;
	say "     The two of them rock against each other, the intensity of their movements building up until the arousal they share just can't be contained anymore. With a loud grunt, Nelson bucks his hips up HARD and clamps his hands around Alexandra's hips as his erection starts to pulse into the dobie on top of it. You can literally see the blunt zebra dickhead throb under Alexandra's abs, delivering a deluge of thick, creamy cum right into her womb. There is so much of it that her belly swells, almost as if already pregnant, eventually obscuring the outline of Nelson's cock as a smoothly rounded curve takes its place on her stomach. Intensely aroused at fulfilling the demands you set for her and letting herself be bred, Alexandra barks loudly as she herself orgasms, the moment Nelson's first spurt of seed paints her womb white. She cradles her stomach, feeling it swell moment by moment while her pussy squeezes his cock tightly and femcum gushes out of it.";
	say "     You watch them ride out their orgasms together, with Alexandra staying on top of Nelson, but sinking forward a little to brace herself on his broad, strong chest. Meanwhile the zebra keeps lying where he is on the bed, the muscle tension build up for their fuck now having gone of out of him and his arms slowly stroking Alexandra. The dobie bitch is the first to speak eventually and says, 'Man, I feel stuffed! So much cum, and a huge zebra dick too, hah!' She runs her hands over the curve of her swollen stomach, grinning broadly. 'Almost a pity that I gotta get off him at all, but hopefully this puppy mill will swell of its own soon.' With that said, she gingerly pushes herself up, getting her paws under her so she can slide along Nelson's still fairly hard erection, until only the flared head remains inside her body, making her pussy lips bulge out a little.";
	WaitLineBreak;
	say "     Then the former cop pulls off him with a sudden tug, allowing Nelson's cock to flop down on his abs with a thud, followed by a gush of frothy cum escaping from her overstuffed pussy. It washes over the big zebra, soaking the fur of his crotch, midriff and thighs, as well as the sheets beneath. Some splashes go far enough to even hit you, which the bad bitch apparently was counting on. 'You wanted to be right in the middle of the action, boss!' she says with a smirk, then steps down from the bed, grinning broadly. Keeping a hand over her pussy to catch further cum spilling out, the doberwoman then saunters over towards the shower. You use the sheets to wipe away what cum landed on you, then stand up and glance at the worn-out breeding stud on his bed.";
	say "     'Man, what an incredible lay,' Nelson comments as he sits up, dabbing at his soaked fur with the bedsheet. 'Though I gotta say, she'd be a bit bitchy to live with all the time. Say, how do you deal with that? Or did you pick her because you like butting heads?' The two of you exchange some more words, talking about your views on Alexandra while Nelson pulls off the sex-smelling bed linen and balls it up, to dump in a large clothes hamper when he finally makes his way to the showers to wash down. A little while later, both Alexandra and him re-emerge from the other room, now clean and fresh again.";

to say AlexandrazebraBreeding2: [bent over the table]
	say "     With a grin spreading over your face, you tell Nelson that you'd love to see Alexandra in a bit of cop and robber roleplay, so how about him playing a policeman who's just pulled over a bad dog biker chick. Then he can strip-search her and... let things run their natural course. 'Really, boss? That sounds like a 70's porno plot if I ever heard it,' Alexandra says with a snort, but you can see from the wagging of her short tail that she's actually liking the idea. Glancing around to take in all of the farm worker males [if Corbin is in Worker Barracks and HP of Corbin > 0]and one cuntboy[end if] that are present and watching the show unfold, Alexandra struts more to the center of the room, swaying her hips to draw everyone's eyes. Glancing over her shoulder at Nelson, she then says in a haughty tone, 'What do you want, Stripy?! I was cruising nicely on the highway and you blare your sirens at me!'";
	say "     Nelson stares for a second at Alexandra, then glances down at his naked body before apparently deciding that he'll just roll with the sudden bout of improv. The tall zebra clears his throat and squares his shoulder, then walks up to the dobie bitch with firm steps of his large hooves. 'Hello ma'am. I'm officer Montoya. We've got reasonable suspicion that you might be transporting drugs, so I'm afraid you'll have to be searched! Please step over to the car and place your hands on the hood!' Nelson says, trying to make his voice sound gruff and commanding as he points over to the nearby table. The group of horsemen that are playing cards on it chuckle and grin, quickly clearing off the top and pushing their chairs back to have a ringside seat for what will come next.";
	WaitLineBreak;
	say "     Meanwhile, Alexandra has half-turned to the zebra, lips pulling back a little from her teeth as she replies, 'Fuck you, copper! You can't do that, I know my rights! Who the fuck even gave a striped circus pony like you a uniform?! Should have left that to the actual pigs, or did they put you through oinking school?' Following up by giving him the finger, Alexandra shows herself combative to Nelson, who grabs her by the arm and starts to push it down, at which point the dobie helps the plot along by twisting her body around, leaving Nelson holding her forearm against her back. She growls and barks out, 'Let go! That's police violence!' The zebra 'cop' apparently has enough of her, quickly catches the free hand and also puts it in a loose hold, then walks Alexandra forward until she's at the table. 'You will place your hands on the car hood, and not raise them from there, do you understand?!' Alexandra grunts in reply, then nods.";
	say "     Now that he doesn't have his hands full with the bitch anymore, Nelson looks around at his coworkers, who seem to be enjoying the show quite a bit so far. There's thumbs up and a whistle or two being given to him, with someone from the back of the room soon shouting, 'Pat-down!' You can see Nelson's cock throb a little as he looks at Alexandra after that suggestion. 'I will have to check your pockets and clothing for drugs, ma'am,' he says in his gruff 'cop-voice', stepping up behind her and patting down the back and sides of her leather jacket, checking their pockets, then feeling up her front. Starting at her abs and letting his fingers glide up the doberwoman's chest, he soon arrives at her full breasts, giving them a generous squeeze and flicking over her nipples. While breaking his role a bit, no one is about to complain about it in your amateur live porn production, and a number of the other horsemen even casually pull down their zippers to start jerking off.";
	WaitLineBreak;
	say "     'Sure enjoying himself, aren't you Stripy? I can feel your dick through your pants! You do know that a woman's supposed to do this for other women, right?!' Alexandra gets a dig in, which Nelson counters with, 'Please be quiet, ma'am. I will now continue to search you!' Letting go of her breasts now, he places two large hands on the former cop's rump, feeling her up a little before starting to stroke down over the outsides and backs of her legs. Nelson crouches down to go all the way to Alexandra's paws, then runs his hands up the front of her legs and finally pushing against her pubic mound, drawing a little pant of arousal from the dobie. 'See, nothing to find! Bet you knew that beforehand, didn't you pervert!' she barks defiantly, with Nelson replying, 'Not exactly, ma'am. There's been talk about female drug smugglers hiding their goods somewhere else I still have to check...'";
	say "     Nelson's fingers one in on the button of Alexandra's jeans, popping it open and then pulling down the zipper. He shimmies the tight pants over her ass and pulls them down along her toned legs, lifting first one paw then the other to take the jeans off completely. 'Please spread your legs wider,' he requests, pushing Alexandra's paws aside gently but firmly as she barks back, 'Make me!' Sinking to his haunches behind her, the large zebra raises a hand to stroke the insides of her thighs, then moves to her crotch. His questing fingers stroke over the open folds of her nether lips and find her clit, rubbing it a little and making Alexandra pant audibly. Nelson caresses and strokes your bad dog bitch a little, then soon moves on to sink a finger into her pussy. 'Fuck,' Alexandra says under her breath, her tongue starting to loll out of her muzzle as she starts to move her hips a little in reaction to the penetration.";
	WaitLineBreak;
	say "     Sinking his thick finger into the female dog up to the knuckle and feeling around a little, Nelson has his 'perp' panting and moaning in no time at all. Unsurprisingly, he himself is leaking pre-cum steadily from his large equine shaft, with wet strings connecting its blunt head to a little puddle on the floorboards. 'No drug packages so far,' the zebra says in a by now more amused and aroused voice than before, grinning at his nearby buddies as they jerk off. 'Though there might still be traces of drugs detectable. I'll have to check!' Pulling his finger out of Alexandra, the farmhand brings his thumb and index finger together demonstratively, showing off Alexandra's juices by letting his fingers meet and pulling them apart again. Then he catches the strand of femcum stretching out between them on his tongue and smacks his lips as if taste-testing something, followed by sticking his whole finger into his mouth and sucking it clean.";
	say "     'Mmmmh, I think there's a trace of... something. Did you push the drugs all the way up there? Ma'am, I'll have to do a 'deeper' search with a special tool now!' Alexandra lets out a snort at the unsurprising direction her pat-down is taking, not commenting this time, although you can see her tail wagging up a storm. There's some cheers coming from the back of the room as Nelson stands up, taking hold of his cock and bringing it up between the dobie bitch's legs. Rubbing against Alexandra's sodden pussy lips and over her clit, Nelson's pre-cum and her copious juices make his insertion into the anthro canine's snatch a moment later very easy, with him slipping into her body with an aroused grunt. Panting as he feels her inside grip his shaft, Nelson grabs Alexandra by the hips and pushes deeper slowly. It is clear that his mind is fully on having sex with the sexy bitch now, as he only half-heartedly stammers, 'Ma'am, I'm gonna... gonna... fuck that feels nice...'";
	WaitLineBreak;
	say "     You decide to release Nelson from his role by telling him to just fuck her already, followed by giving the big man a moderately strong slap on the ass, which sends him bucking into Alexandra [italic type]hard[roman type]. ";
	if Cunt Depth of Alexandra + 2 < Cock Length of Nelson: [standard values: 10 (+2 stretching allowance) vs 15]
		say "Your bitch lets out a shocked gasp as about a foot in length of equine cock rams into her from behind - though that's still not quite all of Nelson's shaft. 'Damn, that's one big cock, Stripy!' Alexandra barks out and moans loudly. 'His dickhead is right against my cervix, pressing against the gates of the puppy factory!' the dobie pants out, lowering a hand to cradle the cock-bulge on her stomach. 'Let's go the rest of the way!' she then adds in a manic tone, throwing her hips back with full force to meet his crotch. [if TwistedCapacity of Alexandra is false]The former cop trashes around and lets out almost feral sounds as she impales herself on the enormous cock, with it forcing its way into her womb. 'Fucking hell!' she shouts, holding back a whimper at the pain. Yet at the same time, she's into it too, [else]The former cop screams victoriously as her altered body somehow accommodates to let him slip into her womb. 'Fuck yeah, that's one big dick!' she barks out with harsh laughter, [end if]gushing more female juices around his cock, which trickles over his swinging balls.";
		say "     Finding himself fully sheathed inside Alexandra, with her sex squeezing down on his cock, Nelson goes wild, hands gripping onto the doberwoman's hips as he grinds himself into her. He lets out throaty moans, throwing his head back and shouting, 'God, what a sweet pussy!' There is little hesitation in him to allow Alexandra time to get used to his girth, as lust is directing his actions and telling him to get humping right away. Bent over the smaller canine, the large zebra starts to thrust. The huge piece of man-meat that is his cock slides in and out of her, popping past the opening of her womb again and again, now somewhat easier as the initial stretch has already happened. Breathlessly, Alexandra comments his movements with, 'Damn, I love this monster dick in me! Blast some puppies up that pussy, Nelson!' Mumbling 'Kinky bitch' under his breath, Nelson speeds up his movements some more, making her bounce on his cock and pulling her into the thrusts with both hands.";
		if TwistedCapacity of Alexandra is false:
			increase Cunt Depth of Alexandra by 1; [oversized fucks stretch characters bit by bit]
	else: [he actually fits into her]
		say "Your bitch lets out a breathless moan as his crotch meets her ass, while her nether lips are spread wide around his girth and all of the humongous cock rests inside her. 'Damn, I love being able to take huge cocks like that one now! All the fucking really worked out my pussy!' Alexandra says with a lusty gleam in her eyes. Looking down, you can see her female juices trickling over the base of Nelson's girth, then down to his large, swinging balls. 'Just look at it!' the dobie pants out, lowering a hand to cradle the cock-bulge on her stomach. Finding himself fully sheathed inside Alexandra, with her sex squeezing down on his cock, Nelson goes wild, hands gripping onto the doberwoman's hips as he grinds himself into her. He lets out throaty moans, throwing his head back and shouting, 'God, what a sweet pussy!'";
		say "     There is little hesitation in him to allow Alexandra time to get used to his girth, as lust is directing his actions and telling him to get humping right away. Bent over the smaller canine, the large zebra starts to thrust. The huge piece of man-meat that is his cock slides in and out of her, popping past the opening of her womb again and again, now somewhat easier as the initial stretch has already happened. Breathlessly, Alexandra comments his movements with, 'Damn, I love this monster dick in me! Blast some puppies up that pussy, Nelson!' Mumbling 'Kinky bitch' under his breath, Nelson speeds up his movements some more, making her bounce on his cock and pulling her into the thrusts with both hands.";
	WaitLineBreak;
	say "     Seeing the pairing that you've set up come closer and closer to its conclusion, you revel in your power over these two, with Alexandra broken in to be your breeding bitch, and Nelson being ready to do almost anything as you control him through his sex drive. Letting your hand stray down to your own crotch, you stimulate yourself just a little bit, enjoying the warm glow of lust. All around, the other inhabitants of the worker barracks also have been drawn in by the live sex show. By this point, there aren't many comments or whistles anymore, but rather panting noises and quickening breaths, with huge equine cocks being jerked in rhythm to Nelson's thrusts into Alexandra. Meanwhile, the two stars of the show rock against each other, the intensity of their movements building up until the arousal they share just can't be contained anymore. With a loud grunt, Nelson bucks his hips into the needy bitch HARD and clamps his hands around Alexandra's hips as his erection starts to pulse into the dobie.";
	say "     You can literally see the blunt zebra dickhead throb under Alexandra's abs, delivering a deluge of thick, creamy cum right into her womb. There is so much of it that her belly swells, almost as if already pregnant, eventually obscuring the outline of Nelson's cock as a smoothly rounded curve takes its place on her stomach. Intensely aroused at fulfilling the demands you set for her and letting herself be bred, Alexandra barks loudly as she herself orgasms, the moment Nelson's first spurt of seed paints her womb white. She cradles her stomach, feeling it swell moment by moment while her pussy squeezes his cock tightly and femcum gushes out of it. Then suddenly, there's the sound of chair legs scraping over the ground, and the chair even falling over backwards as a horseman jumps up from where he was sitting close to the table. He was one of the card-playing bunch that turned into jerking voyeurs, and now he steps up towards Alexandra with his dick in hand. Driven by lust, he jerks himself furiously, moments later erupting to bathe Alexandra in splashes of equine cum.";
	WaitLineBreak;
	say "     Three other strapping Clydesdales follow the example set for them, crowding in around Alexandra and jerking off onto her, resulting in a wild cross-fire of cum-spurts that leaves the ex-cop drenched, with her hair plastered against her head and dripping cum. Still riding out her orgasm while cum is being shot inside and onto her, Alexandra pants needily and catches her breath, then soon pushes herself up from where she was bent over the table. This of course makes her pussy move around Nelson's cock still impaling her body, drawing another horny grunt from him. 'Man, I feel stuffed! So much cum, and a huge zebra dick too, hah!' Alexandra says with a grin, running her hands over the curve of her swollen stomach. But then, she looks to the side and sees one of the many thick streaks of cum on her jacket, standing out in sharp contrast to the black leather. 'What the fuck did you guys think you were doing? You better hope that comes out without marks, or you owe me a new jacket for making such a mess!'";
	say "     Somewhat annoyed, Alexandra shrugs off her jacket and shoves it at the chest of one of the gaping horsemen, accompanied by a demand of, 'You, clean that!' Then she tries to run her fingers through the spiky mess of her head hair, finding it sticky and clumped together with cum. 'Ugh, cum in my hair, just what I needed. You, you, and you - all of you are gonna help me wash this out properly. And I'm not talking about shower sex to go with that either, just you cleaning up your mess!' the bitch says to the nearest horsemen, then reaches back to pat Nelson's side, smiling at him as she looks over her shoulder. 'You were great, stud! Bet this puppy mill will swell soon.' With that said, she gingerly starts to pull off his still fairly hard cock, until only the flared head remains inside her body, making her pussy lips bulge out a little.";
	WaitLineBreak;
	say "     With a sudden tug, the former cop allows Nelson's cock to slip from her pussy, flopping down between his legs accompanied by a gush of frothy cum escaping from her overstuffed pussy. It washes over the big zebra's thighs and lower legs, splashing up as it hits the ground too. Then the bad dog bitch struts off towards the showers, shooing her cleaning crew ahead of herself and leaving a trail of dripped cum. Once she is gone, Nelson comments, 'Man, what an incredible lay! Though I gotta say, she'd be a bit bitchy to live with all the time. Say, how do you deal with that? Or did you pick her because you like butting heads?' The two of you exchange some more words, talking about your views on Alexandra while Nelson looks at the wet fur on his crotch and legs, then finally makes his way to the showers to wash down. A little while later, both Alexandra, her helpers and Nelson re-emerge from the other room, now clean and fresh again.";
	now lastdobiemess is 86; [zebra came in her]
	impregAlexandraChance with "Nelson"; [chance to knock her up]
	NPCSexAftermath Alexandra receives "PussyFuck" from Nelson;

Nelson ends here.
