Version 1 of PAN Frat Bros by Wahn begins here.

[
PAN Frat Brothers

Up to 22 frat brothers living in the PAN frat building (by room numbers)

President, Right-Hand Man and 3 Pledges are out in the Grove


1 - Frat President: Nicholas Alexander (turned into a male dryad in the Grove)
			Age: 23 (5th year)
			Ancestry: Greek
			Relations: Father, grandfather were members
			Orientation: Bisexual (openly - had the respect from others to not be teased about it)
			Cock: uncut; 7 inch (human), 14 (dryad) - others can gape at his cock, "look at that log of a dick!"

2 - Right-Hand Man: Thiago
			Age: 22 (3rd year)
			Ancestry: Brazilian
			Relations:
			Orientation: straight (human), bisexual (dryad) - finding himself drawn to Nicholas since their transformation; struggling with it a little
			Cock: cut; 9 inch (human), 8+8 (dryad) - branching dick

3 - Swim-Team Captain: River
			Age: 22 (3rd year)
			Ancestry: Nordic (tall, blond)
			Background:
				Best friend (as kids) almost drowned and River couldn't get him out of the water, someone else dragged them both out of the dangerous current in the sea they got in - that got him motivated to be the best in swimming and he really pushes himself, now being a star athlete in college
			Relations:
				Kai ("Sea") - their mother was really into nature so she named her sons River and Sea (just Kai was luckier to get a hawaiian sea)
				Brook - sister
			Orientation: mostly gay (powerbottom), publicly bi - can get it up for females to keep his image (imagines dudes, asked women to finger his ass/peg him)
			Cock: cut; 10 inch (human), 11 inch (nymph)
			Notes:
				Protective over Sylvanus

4 - Football Team Captain: Han
			Age: 21 (3rd year)
			Ancestry: Asian
			Relations:
			Grandfather immigrated from Asia, father was born in the US
			Traditional upbringing
			Orientation: Straight (human), Bi (cyclops) - somewhat freaked out over it (and having one eye), but he can't stay away from the guys
			Cock Size: cut; 6 inch; 15 inch (cyclops)
			Idea: He drinks with an orc breeder from the nerd frat (slut npc), the orc slips some bottled orc cum into the satyr wine, Han gets super horny
						Choice: stand back and watch as the orc and Han vanish into his room; slip in and take Han by the arm to bring him to his room (he'll be "painfully hard" and at the same time discombobulated - asking for "help" from the player to get his dick taken care of - BJ or jerking him off)

5 - Rising Star: Richard
			Age: 19 (1st year)
			Ancestry: Greek/British
			Relations:
			Orientation: Bisexual (doesn't talk about it much)
			Cock Size: cut; 8 inch (human); 10 inch (satyr)
			Sports: Lacrosse Player
			Background: Legacy (father + grandfather were members)
									Got a sports scholarship to pay his own way
			Notes:
			Include a "yeah, approaching an infected was stupid" (referring to Sylvanus) in his training sessions with the expedition crew
			Secret pregnancy fetish (from overhearing him as he was in rut)

6 - Lost Pledge: Maddox
			Age: 20
			Relations: Irish
			Orientation:
			Cock Size:

7 - Lost Pledge: Clay
			Age: 20
			Relations: Irish
			Orientation:
			Cock Size:

8 - Lost Pledge Yisroel
			Age: 20
			Relations: Israeli
			Orientation:
			Cock Size: cut; 10 inch (human), none (dryad cuntboy)

Subelements of the Frat Brothers Group NPC
9 - Angelo Silva (latin lover, sleeps with any girl he can)
			Age: 20
			Ancestry: Portugese
			Orientation: straight
			Cock Size: cut; 7 inch (human); uncut; 8 inch (satyr - future transformation should be as part of his story, not random)
			Background: Soccer Player (but its not his primary interest)
									Really likes music, plays electric guitar
									One of the nerd frat guys set up his phone-camera connection for him (with which he takes his porn vids)
			Notes:
			Secretly loves the taste of cum (eats his own regularly)

10 - Big John (offensive guard football player, knows Roman)
			Age: 20
			Relations: English
			Orientation:
			Cock Size:
			Info:
			Uses somewhat corny/cringy words during sex - "babycakes" and whatnot"

11 - Little John (fireplug shaped wrestler)
			Age: 20
			Relations: English
			Orientation:
			Cock Size:

12 - Nate (gymnast)
13 - Paul (wrestler)
14 - Eric
15 - Oliver (swims)
16 -
17 -
18 -
19 - free
20 - free
21 - free
22 - free

-----

TODO: Add Walk-in event about nudist players (some other people were already nude, so they're not that concerned)



]

FratEntryCooldown is a number that varies.[@Tag:NotSaved]

a postimport rule:
	if PAN Frat Brothers is not in PAN Frat Second Floor:
		now PAN Frat Brothers is in PAN Frat Second Floor;

Chapter 1 - NPCs

Table of GameCharacterIDs (continued)
object	name
PAN Frat Brothers	"PAN Frat Brothers"

PAN Frat Brothers is a man.
PAN Frat Brothers is in PAN Frat Second Floor.
understand "Angelo" as PAN Frat Brothers.
understand "River" as PAN Frat Brothers.
[Physical details as of game start]
ScaleValue of PAN Frat Brothers is 3. [human sized]
SleepRhythm of PAN Frat Brothers is 0. [0 - awake at all times, 1 - day active, 2 - night active]
Cock Count of PAN Frat Brothers is 1. [X cock]
Cock Length of PAN Frat Brothers is 8. [X Inches]
Ball Size of PAN Frat Brothers is 4.
Ball Count of PAN Frat Brothers is 2. [X balls]
Cunt Count of PAN Frat Brothers is 0. [X pussy]
Cunt Depth of PAN Frat Brothers is 0. [X Cunt]
Cunt Tightness of PAN Frat Brothers is 0. [X Cunt]
Nipple Count of PAN Frat Brothers is 2. [X nipples]
Breast Size of PAN Frat Brothers is 0. [X at the start]
[Basic Interaction states as of game start]
TwistedCapacity of PAN Frat Brothers is false. [can not take oversized members without pain]
PlayerMet of PAN Frat Brothers is false.
PlayerRomanced of PAN Frat Brothers is false.
PlayerFriended of PAN Frat Brothers is false.
PlayerControlled of PAN Frat Brothers is false.
PlayerFucked of PAN Frat Brothers is false.
OralVirgin of PAN Frat Brothers is false.
Virgin of PAN Frat Brothers is true.
AnalVirgin of PAN Frat Brothers is false.
PenileVirgin of PAN Frat Brothers is false.
SexuallyExperienced of PAN Frat Brothers is true.
Sterile of PAN Frat Brothers is true. [no kids, for now]
MainInfection of PAN Frat Brothers is "Human".
Description of PAN Frat Brothers is "[PAN Frat Brothers Desc]".
Conversation of PAN Frat Brothers is { "<This is nothing but a placeholder!>" }.
The scent of PAN Frat Brothers is "     The frat guys have a clean scent, underlaid with a hint of deodorant. Living in a place with working showers has its perks.".

to say PAN Frat Brothers Desc:
	say "     Various members of the PAN fraternity are gathered here, as the first floor seems to be a popular hang-out spot for them. Exactly who's present at any given time varies a bit, with guys coming and going to do things in their rooms, downstairs, or making beelines to the shared bathroom. ";
	if Daytimer is day:
		say "Still, you can find someone here at pretty much any time of the day, mostly in groups of twos or threes as they talk with one another, listen to music, watch TV, or the like. Plus some in-between bouts of cleaning by pledges and prep work for another night of partying to distract everyone from the chaos that has spread throughout the whole city, of course. Besides the frat guys, a few visitors are mixed in among the people you can see, mostly just friends they actually know, as compared to the random selection of partygoers swarming the frat house after darkness falls. You spot [bold type]River[roman type] among the group, ";
		if MainInfection of River_1 is "Human":
			say "his golden-blond head of short hair shining like a beacon on top of his fit swimmer's body.";
		else:
			say "his golden-blond head of shoulder-length hair shining like a beacon on top of his fit swimmer's body. Now that he's not quite human anymore, the guy somehow has gained an otherworldly beauty, with flawless, pale skin and a smooth, hairless body.";
	else:
		say "With the party in full swing, they're mostly standing around in twos or threes, drinking and talking to various hangers-on that flocked to the handsome studs. Some dancing is also going on, as well as flirting, if the frat guy over there leaning in to tell his female companion something while stroking her side is anything to guess of. Glancing around, you see [if PlayerMet of Angelo is true][bold type]Angelo[roman type], all smiles as usual as he unashamedly boasts of his newest conquests. Looking at his mid-length black curly locks, handsome expression and a well-trained body, you have little doubt that every word is true.  [else]a fairly [bold type]handsome guy[roman type] who unashamedly boasts of his newest conquests. Looking at his well-trained body and the head of mid-length black locks that he very stylishly brushes aside to smile at one of his listeners, you have little doubt that every word is true. [end if]Skinny jeans and a tight V-neck muscle-shirt finish out his look, with a barbell nipple piercing visible through the thin fabric covering his chest. As he notices your attention, he gives you an impish smile and a wink.";
	if Resolution of Free Drink > 1 and Resolution of Free Drink < 5: [early stage, light transformations]
		say "     Watching the frat brothers for a moment, you see that the effects of the special wine circulating through the parties in this frat house are becoming noticeable, as goatees are gaining fairly widespread popularity on a number of the guys['] faces. Picking up on the sound of hooves on the wooden floor, a quick glance downwards also reveals to you that at least one or two of them have advanced a bit further on their way to becoming satyrs, sporting split hooves instead of human feet now.";
	else if Resolution of Free Drink > 4 and Resolution of Free Drink < 8: [a few fully transformed]
		say "     With satyr wine circulating quite a bit during the recent parties, partially due to your own efforts to advance Kerr and Talov's well-meant plan of getting everyone to live more in the moment and have fun, the effects on the frat brothers are more than obvious. They're still a mixed crowd and mostly human, but a bunch of them are now bearded with stylish goatees. Two or three of the guys have fully transformed though, being through and through satyrs now, from their hooves up to the curved or curling horns on their heads. This doesn't appear to bother any of the brothers, as they seem to treat each other no different than before.";
	else if Resolution of Free Drink > 7: [half satyrs, half human-ish - stopping here to keep the variety going, as satyr supremacy could get boring]
		say "     The rampant use of satyr wine has made quite an impact on the fraternity, greatly helped along by to your own efforts to advance Kerr and Talov's well-meant plan of getting everyone to live more in the moment and have fun. Looking at the frat brothers coming and going, you guess that half of them have fully transformed into satyrs by now, from their hooves up to the curved or curling horns on their heads. This doesn't appear to bother any of the brothers, as they seem to treat each other no different than before. There is a bunch more bare skin on show though, as many go shirtless and just wear some loose shorts to cover their privates.";

Table of GameCharacterIDs (continued)
object	name
Angelo	"Angelo"

Angelo is a man.
[Angelo is in PAN Frat Second Floor.]
understand "Angelo" as Angelo.
[Physical details as of game start]
ScaleValue of Angelo is 3. [human sized]
SleepRhythm of Angelo is 0. [0 - awake at all times, 1 - day active, 2 - night active]
Cock Count of Angelo is 1. [X cock]
Cock Length of Angelo is 7. [X Inches]
Ball Size of Angelo is 4.
Ball Count of Angelo is 2. [X balls]
Cunt Count of Angelo is 0. [X pussy]
Cunt Depth of Angelo is 0. [X Cunt]
Cunt Tightness of Angelo is 0. [X Cunt]
Nipple Count of Angelo is 2. [X nipples]
Breast Size of Angelo is 0. [X at the start]
[Basic Interaction states as of game start]
TwistedCapacity of Angelo is false. [can not take oversized members without pain]
PlayerMet of Angelo is false.
PlayerRomanced of Angelo is false.
PlayerFriended of Angelo is false.
PlayerControlled of Angelo is false.
PlayerFucked of Angelo is false.
OralVirgin of Angelo is false.
Virgin of Angelo is true.
AnalVirgin of Angelo is true.
PenileVirgin of Angelo is false.
SexuallyExperienced of Angelo is true.
Sterile of Angelo is true. [no kids, for now]
MainInfection of Angelo is "Human".
Description of Angelo is "[Angelo Desc]".
Conversation of Angelo is { "<This is nothing but a placeholder!>" }.
The scent of Angelo is "     Angelo has a sexy, somewhat musky scent. Must be some exotic and expensive eau de cologne or so.".

to say Angelo Desc:
	say "     Placeholder, mostly using the NPC for the variables.";

Table of GameCharacterIDs (continued)
object	name
River_1	"River_1"
River_1	"River"

River_1 is a man.
[River_1 is in PAN Frat Second Floor.]
understand "River" as River_1.
printed name of River_1 is "River".
[Physical details as of game start]
ScaleValue of River_1 is 3. [human sized]
SleepRhythm of River_1 is 0. [0 - awake at all times, 1 - day active, 2 - night active]
Cock Count of River_1 is 1. [X cock]
Cock Length of River_1 is 9. [X Inches]
Ball Size of River_1 is 4.
Ball Count of River_1 is 2. [X balls]
Cunt Count of River_1 is 0. [X pussy]
Cunt Depth of River_1 is 0. [X Cunt]
Cunt Tightness of River_1 is 0. [X Cunt]
Nipple Count of River_1 is 2. [X nipples]
Breast Size of River_1 is 0. [X at the start]
[Basic Interaction states as of game start]
TwistedCapacity of River_1 is false. [can not take oversized members without pain]
PlayerMet of River_1 is false.
PlayerRomanced of River_1 is false.
PlayerFriended of River_1 is false.
PlayerControlled of River_1 is false.
PlayerFucked of River_1 is false.
OralVirgin of River_1 is false.
Virgin of River_1 is true.
AnalVirgin of River_1 is true.
PenileVirgin of River_1 is false.
SexuallyExperienced of River_1 is true.
Sterile of River_1 is true. [no kids, for now]
MainInfection of River_1 is "Human".
Description of River_1 is "[River Desc]".
Conversation of River_1 is { "<This is nothing but a placeholder!>" }.
The scent of River_1 is "     River has a clean, fresh scent.".

to say River Desc:
	say "     Placeholder, mostly using the NPC for the variables";


Section 2 - Talking with PAN Frat Brothers

instead of conversing the PAN Frat Brothers:
	if daytimer is day:
		say "     Without a party drowning out the voices of people talking, it is much easier to hold a conversation with the frat brothers, and talk about serious things. On the other hand, if you had more [']racy['] things to discuss, maybe waiting until after sundown, then everyone starts drinking would be a good idea. [bold type]What do you want to talk about?[roman type][line break]";
		say "[PANFratBro_Talkmenu_Day]";
	else:
		say "     Given that there's loud music blaring and a party is in full blast all around you, you don't think right now is the time to discuss anything serious. On the other hand, with the guys likely having had a few drinks each already, this would be the perfect time to bring up some more [']racy topics[']. [bold type]What do you want to talk about?[roman type][line break]";
		say "[PANFratBro_Talkmenu_Night]";

instead of fucking the PAN Frat Brothers:
	say "     This doesn't really seem like the time or place to just step up publicly and call out to the guys that want to fuck. Maybe you should approach a specific guy you're interested in and chat with him, then see where things go from there...";

to say PANFratBro_Talkmenu_Day:
	let DoneTalking be false;
	LineBreak;
	now sextablerun is 0;
	blank out the whole of table of fucking options;
	[]
	if PlayerMet of River_1 is false:
		choose a blank row in table of fucking options;
		now title entry is "Properly introduce yourself to River (the blond swim team captain)";
		now sortorder entry is 1;
		now description entry is "Start a conversation with the dude";
	[]
	if PlayerMet of River_1 is true:
		choose a blank row in table of fucking options;
		now title entry is "Get a reminder of his background info";
		now sortorder entry is 2;
		now description entry is "Ask River to repeat what he said before";
	[]
	if PlayerMet of River_1 is true:
		choose a blank row in table of fucking options;
		now title entry is "Get some general info about the frat from River";
		now sortorder entry is 3;
		now description entry is "Learn about the PAN fraternity";
	[]
	if PlayerMet of River_1 is true:
		choose a blank row in table of fucking options;
		now title entry is "Ask who's leading the frat";
		now sortorder entry is 4;
		now description entry is "Find out who's in charge";
	[]
	if PlayerMet of River_1 is true:
		choose a blank row in table of fucking options;
		now title entry is "Ask River if he wants to have some fun";
		now sortorder entry is 8;
		now description entry is "Try to sex up the swim team captain";
	[]
	choose a blank row in table of fucking options;
	now title entry is "Listen in on the two guys grumbling about something";
	now sortorder entry is 9;
	now description entry is "They seem a bit angry about something, so you want to find out what that is";
	[]
	repeat with y running from 1 to number of filled rows in table of fucking options:
		choose row y from the table of fucking options;
		say "[link][y] - [title entry][as][y][end link][line break]";
	say "[link]0 - Nevermind[as]0[end link][line break]";
	while sextablerun is 0:
		say "Pick the corresponding number> [run paragraph on]";
		get a number;
		if calcnumber > 0 and calcnumber <= the number of filled rows in table of fucking options:
			now current menu selection is calcnumber;
			choose row calcnumber in table of fucking options;
			let nam be title entry;
			now sextablerun is 1;
			if (nam is "Properly introduce yourself to River (the blond swim team captain)" or nam is "Get a reminder of his background info"):
				say "[River Introduction]";
			else if (nam is "Get some general info about the frat from River"):
				say "[River Frat Talk]";
			else if (nam is "Ask who's leading the frat"):
				say "[River Leader Talk]";
			else if (nam is "Ask River if he wants to have some fun"):
				say "[River Sex Offer]";
			else if (nam is "Listen in on the two guys grumbling about something"):
				say "[PAN Frat Brothers Maron Griping]";
			if DoneTalking is false:
				say "[PANFratBro_Talkmenu_Day]"; [looping back to continue talking]
			else:
				wait for any key;
		else if calcnumber is 0:
			now sextablerun is 1;
		else:
			say "Invalid Option. Pick between 1 and [the number of filled rows in the table of fucking options] or 0 to exit.";
	clear the screen and hyperlink list;

to say River Introduction:
	if PlayerMet of River_1 is false: [first time]
		say "     Walking towards River, you let your eyes roam over him, taking in the attractive young man's physique. He looks to be almost six foot tall, slender but muscled. Blond, curly-locked hair falls down to his shoulders, framing a handsome face with blue eyes. Around his neck, you catch a glimpse of a fine silver chain, ending in a little pendant in the form of a trident. As you arrive next to the spot where he's sitting, the PAN frat member looks up at you and says, 'Oh, hey there! [if Player is not defaultnamed][name of Player], wasn't it? [end if]Your friends Kerr and Talov should be downstairs, in the game room. Though I'm not sure if they'll be in a state to talk during the daytime. Those two know how to party hard, haha!' Thanking River for the guidance, you add that you actually wanted to talk to him right now, to properly introduce yourself beyond just the quickfire way in which Richard dropped your name to most of the frat guys. 'Oh, sure thing - have a seat, I love meeting new people,' the swim team captain says with a genuine smile, nodding to an armchair next to the sofa he's sitting on.";
		say "     The two of you have a nice little talk after that, exchanging some information about your backgrounds and interests. You learn that his full name is River Lund, with his grandfather having immigrated to the US from Norway after WW2. He jokes a little about his unconventional first name, explaining with an exasperated sigh, 'Mom is a bit of a hippy. Really, really into natural things... like a lot. So she thought why not name her children after a river, brook and sea. No one would ever make fun of that, right?' Rolling his eyes, but still with a smile on his face, he adds, 'My little brother was the luckiest of us... when he was born sis and I were already in kindergarten. Mom learned from the fact that the other kids in school were having a party with the whole 'shy kid having a weird name' thing, so bro still got called 'sea', but she decided to switch up the language used and took the Hawaiian term, Kai instead.'";
		WaitLineBreak;
		say "     As you decide to ask what he's studying, River opens up with a smile, eagerly telling you, 'I'm a junior studying marine biology! It's really fascinating - I mean, most of our world is ocean, and there's so much we don't know about the things going on beneath the waves. That's why I picked this university, you know. I mean, Arizona was a nice enough place to grow up, but one gotta be close to the ocean to study it!' Digging out his smartphone from a pocket, the very enthusiastic young man calls up a gallery folder with a few swipes of his finger, showing off one picture after another. 'This was last year during the summer, when we drove out with a boat to count sea lion cubs in the local colonies. You know, to monitor the population of the animals.' His picture collection really is very neat, seeing all those cute little baby animals with their big eyes, but also some of the fully grown ones that River seems to have positively interacted with, acting right to be allowed fairly close to their colony. It is clear that he's fully committed to what he's studying.";
		say "     After a little while, the topic of conversation drifts to the PAN fraternity, and how he got to be in it. River says, 'Just seemed like the thing to do in college. It's the time to try new things, right? Get to know people and all that. So I checked out what frats were on campus, went to a party or two at the more interesting ones, then finally pledged with PAN. Haven't regretted it one second, these are the best bro's one can have!' As he says this, River lets his gaze sweep over the other frat guys currently present, with his eyes staying a little longer on one or two. He's not obvious about it or anything, but you can pick up on a certain level of lust underlying those looks. He seems to have more than just a 'brotherly' interest in at least some of the studs living together with him in this house.";
		WaitLineBreak;
		say "     'Yeah, this is a great frat, and the guys are a good bunch - or at least most of [']em are. Though I gotta tell you that we usually don't have a party every night. That's just... for right now, because everyone's on edge with all that's happening, and they need to take their minds off it all. And what the hell else should we do, with a bunch of classes cancelled and going off-campus being pretty dangerous? We'd go a bit stir-crazy otherwise, haha! Especially PAN, as we always do a bunch of stuff out and about. Like rafting, on the Colorado river, during spring break, and a bunch of camping trips to the frat's private grove, over near the nature reserve up the coast. Those are always a blast.' Taking a deep breath, and then letting it out slowly, River ends with, 'Really hope this shit is gonna be dealt with soon, one way or another...'";
		now PlayerMet of River_1 is true;
	else: [repeats]
		say "     As you ask him to go over what you talked about before again, River chuckles and asks, 'You forgetful or something? There is such a thing as too much sex to be had - that can rot your brain, I'm tellin' ya. Kidding, kidding!' Giving him a slightly grumpy expression at his own joke, you pick up on your previous conversation again, exchanging information about your backgrounds and interests. You learn that his full name is River Lund, with his grandfather having immigrated to the US from Norway after WW2. He goes through the spiel about his unconventional first name again, explaining with an exasperated sigh, 'Mom is a bit of a hippy. Really, really into natural things... like a lot. So she thought why not name her children after a river, brook and sea. No one would ever make fun of that, right?' Rolling his eyes, but still with a smile on his face, he adds, 'My little brother was the luckiest of us... when he was born sis and I were already in kindergarten. Mom learned from the fact that the other kids in school were having a party with the whole 'shy kid having a weird name' thing, so bro still got called 'sea', but she decided to switch up the language used and took the Hawaiian term, Kai instead.'";
		say "     Deciding to ask for a reminder about what he's studying, River opens up with a smile, eagerly telling you, 'I'm a junior studying marine biology! It's really fascinating - I mean, most of our world is ocean, and there's so much we don't know about the things going on beneath the waves. That's why I picked this university, you know. I mean, Arizona was a nice enough place to grow up, but one gotta be close to the ocean to study it!' Digging out his smartphone from a pocket, the very enthusiastic young man calls up a gallery folder with a few swipes of his finger, showing off one picture after another. 'This was last year during the summer, when we drove out with a boat to count sea lion cubs in the local colonies. You know, to monitor the population of the animals.' His picture collection really is very neat, seeing all those cute little baby animals with their big eyes, but also some of the fully grown ones that River seems to have positively interacted with, acting right to be allowed fairly close to their colony. It is clear that he's fully committed to what he's studying.";
		WaitLineBreak;
		say "     After a little while, the topic of conversation drifts to the PAN fraternity, and how he got to be in it. River says, 'Just seemed like the thing to do in college. It's the time to try new things, right? Get to know people and all that. So I checked out what frats were on campus, went to a party or two at the more interesting ones, then finally pledged with PAN. Haven't regretted it one second, these are the best bro's one can have!' As he says this, River lets his gaze sweep over the other frat guys currently present, with his eyes staying a little longer on one or two. He's not obvious about it or anything, but you can pick up on a certain level of lust underlying those looks. He seems to have more than just a 'brotherly' interest in at least some of the studs living together with him in this house.";
		say "     'Yeah, this is a great frat, and the guys are a good bunch - or at least most of [']em are. Though I gotta tell you that we usually don't have a party every night. That's just... for right now, because everyone's on edge with all that's happening, and they need to take their minds off it all. And what the hell else should we do, with a bunch of classes cancelled and going off-campus being pretty dangerous? We'd go a bit stir-crazy otherwise, haha! Especially PAN, as we always do a bunch of stuff out and about. Like rafting, on the Colorado river, during spring break, and a bunch of camping trips to the frat's private grove, over near the nature reserve up the coast. Those are always a blast.' Taking a deep breath, and then letting it out slowly, River ends with, 'Really hope this shit is gonna be dealt with soon, one way or another...'";

to say River Frat Talk:
	say "     'You wanna know more about PAN? Sure, why not. I looked things up when trying to pick a frat, so I can tell you a bunch of trivia,' River tells you with a friendly smile brushing some of his blond locks out of his face and hooking them behind one ear. 'Okay then, let's start at the beginning. The frat was founded in 1896 by Robert Clark, after he came back from the first modern summer Olympics in Athens, with a shiny silver medal around his neck, for winning the discus throw. Just so you know, they didn't have gold medals back then, first place got silver, second bronze, third nothing at all. Imagine that - going to the Olympics and not even getting one of those 'and all I got was a stupid t-shirt' consolation prices, because T-shirts weren't invented yet either.' With a chuckle and a shrug, River continues, 'Anyways, we got that medal somewhere in the house, it's brought out for special occasions.'";
	say "     'So, Robert was pretty famous after his win, and had a bunch of ideas about brotherhood, athleticism and even an early form of environmentalism. As he was on a tour of being celebrated by high society, he kept telling them about his idea for an organization that would 'instill proper values in promising American youth'. Well, he was wildly effective with that idea, those rich folks threw a bunch of money his way. Even netted the frat two mountain lodges, up at Mammoth Lake, I can tell you those are really sweet to stay in! There's a regular trip there each year over winter break, lots of skiing and snowboarding. Anyways, there you go - that was the beginning of it all, and PAN's lasted ever since, holding strong as the best frat of Tenvale!' Beaming proudly, he waves a hand to indicate your surroundings, which do speak of the frat being fairly well-off, and respectful of its traditions. All in all though, you do get the impression that River might be a bit overly enthusiastic about his frat, making it out as the end all and best in everything, so you reserve some doubt about things being all sunshine and rainbows, all the way down.";
	WaitLineBreak;
	say "     'Hmm, what else can I tell you - ah, the house colors are green and gold. Those look pretty neat on our official T-shirts. And the various sports groups got special uniforms too, jockstraps for most of the guys, and we on the swim team got some speedos in the colors too. You should see the one I wear at competitions,' the last sentence River adds with a wink, then wiggles his eyebrows up and down. Clearing his throat and putting on a more serious expression again, he goes on to say, 'And the creed of PAN is 'Strength through Unity, Unity through Wisdom'. You see, good old Robert didn't just want to gather some jocks in a house, he wanted smart ones too. So that's two of the most important rules for the frat. You gotta play some sort of sports, and you have to keep your grades up. Works out fairly well in my experience. We keep busy together, and if someone needs help academically, you got brothers to tutor you and provide... motivation to improve your performance.' A smirk flickers over River's features as he says those last words, leaving you to wonder just what method of motivation the frat employs.";
	TraitGain "Frat Founding Trivia" for River_1; [olympian history - ammunition to argue for a wrestling contest for interim frat president rank]

to say River Leader Talk:
	if "Interim Frat President" is not listed in Traits of Richard:
		say "     As you ask River about who's in charge of the fraternity, the blond athlete seems to become a bit uncertain what to say, making a long face and pressing his lips together. He continues to hesitate, prompting you to give him a questioning look and making a gesture to go on and finally talk. This seems to shake River out of it, with him saying, 'Err, yeah... about that. Our frat president Nicholas, to be honest, he's really awesome! A fourth generation legacy brother, plus all strong and decisive, and... uhm, he's missing. As is Thiago, his right-hand man.' Curiosity about what's going on must have been obvious on your face, as River goes on to explain right away. 'So, yeah... the frat's got a grove, over near the nature reserve up the coast. There's a bunch of traditions around that. We have regular camping trips there and whatnot, and when a pledge is ready to become a full on brother, they plant a tree. It's a whole ceremony and all of that good shit.'";
		say "     'So, right before all of this weird shit started going down, Nic, Thiago and three of the pledges - Clay, Mad and Yis - all of them drove over to the grove. The guys were pretty close to their initiation, so they were supposed to prepare the grounds. Cut underbrush and clear the spots where their trees would be planted, stock the fridges in the on-site storage shed with drinks and food for the ceremony. Stuff like that, you know. Even got a message from Nick that morning.' With that said, River pulls out his smartphone, pulling up a messenger app and then angling it so you can see a chat history between River and Nicholas. There's some fairly normal texts going back and forth, ending at the message 'About to be all stocked up!', complete with a selfie-picture of a muscular young man giving the camera a thumbs-up. In the background, you can see several others carrying boxes into the open door of a shed.";
		WaitLineBreak;
		say "     Frowning as he looks down at the phone, River goes on to say, 'An hour or so later, the phones went down, and reports of people being jumped by creatures spread on campus. Things were pretty wild, that first day or two, until the Spartans established their perimeter patrols and whatnot. We're still hoping, but Nick and his group never came back from the grove.' Making a fist, then relaxing it again with a grunt, River adds, 'It's really frustrating, not knowing what happened to your brothers. Damn, it's just a 30 minute drive there, but reports from people who saw the wider city mentioned attacks on cars, and that lots of roads are blocked, or even ripped up or something. And a one-way 10 hour hike through 25 miles of infested cityscape to get to the grove doesn't seem like the wisest thing to do. We don't even know if they're still there. I mean, hopefully they are hunkered down there, with the supplies and camping stuff, but who knows...'";
		say "     'So, uhm... Han and I have been keeping things together here at the house, mostly because we're juniors, and captains of the swim and soccer teams. But yeah, keeping a team together and motivating them to give their all in sports is one thing, having to deal with being under siege on campus from whatever is crawling out there in the city, or even organizing an expedition to the grove... that's a whole different kind of beast. I really wish Nick was here with us, he'd know what to do!' [bold type]Listening to him, you get the impression that River would welcome someone taking over interim leadership of the frat. Something to remember for the future...[roman type][line break]";
		TraitGain "Frat Leadership Lost" for River_1;
	else:
		say "     'So yeah, Richard called everyone together and we had a talk about leadership. Funny how that suddenly happened after you and I discussed the current situation, eh?' River quips, giving you a bit of a lopsided smile while doing so. 'He had some solid arguments for what he wanted to do, and honestly, I was glad to hand off to him. Hell, I went to college to learn about whales, and maybe, just maybe, have a shot at the Olympics. Leading an expedition through the urban sprawl to encounter who knows what kind of dangers - that's just not for me.' Looking warily over to you, as if expecting you to accuse him of something, River then continues, 'I - I'm just not a fighter, alright?! I know my limits - which ones I can push, and which ones I can't. Doesn't mean I'm not fully behind Richard and will support them to my best ability. Really hope they'll find everyone and get them safely back here, once they're ready to set out.'";

to say River Sex Offer:
	if PlayerFucked of River_1 is false: [never had any sexual interaction with him]
		if SubjectPro of Player is "he" and Breast Size of Player < 2: [River prefers guys; powerbottom (he can make things work with transguys somehow)]
			say "     As you lean in and make a thinly vailed offer for some action between the sheets, River raises his eyebrows, then oh so casually lets his gaze sweep over your form. One corner of his mouth ever so slightly twitches upwards even though he tries to hide the reaction. ";
			if PlayerFriended of River_1 is false: [he doesn't know the player well]
				say "'I'm flattered,' the handsome young man says with a friendly smile, biting his lip before he goes on to add, '...but we barely know each other, in the end. No matter how charming or handsome a guy might be, just jumping into bed at the drop of a hat isn't my really my style. If it wasn't for whatever the fuck is going on in the city, I'd say we could go out first, there's lots of fun places downtown. But hey, maybe some opportunity to hang out with one another might pop up, eh? Who knows what the future might bring.'";
				say "     Even though it's a rejection, for now, River delivers his words with charm and a look of genuine openness for getting to know you in his eyes. Looks like he's interested, while at the same time being a bit more selective than your typical horny infected or random slut.";
			else:
				say "'I might just take you up on that,' the handsome young man says with a smile, then oh so casually reaches out to brush his fingertips along the side of your arm. 'Though for a first time between you and me, it feels like something a bit more private than a quick fumble in my room seems in order. I mean, I love the guys, but... err, I might be a little bit vocal, when a guy hits my spot.' A cute blush spreads over River's face, with him lowering his head a little and half-hiding his eyes behind a raised hand. 'When I hooked up once or twice before, some of the guys took up cheering along from the other side of the door. Not exactly how I wanna start something new if I can avoid it.'";
				say "     Pressing his lips together, River taps his chin thoughtfully, then says, 'How about this: I got the keys for the pool center, so I can train whenever, even after dark. So we could have our fun over there, when everyone's out.' Smiling and giving you a wink, he adds, 'If you're game, I'll bring all we'll need. You know, lube and [if Player is not male]a strap-on for you[else]stuff[end if].'";
		else: [females, fem-herms, neuter - he makes excuses]
			say "     As you lean in and make a thinly vailed offer for some action between the sheets, River raises his eyebrows, then oh so casually lets his gaze sweep over your form. 'I'm flattered,' he says with a friendly smile, only to go on to add, '...but we barely know each other, in the end. So I'm not the best person to ask for that.' Raising one hand in a part-apologetic, part consoling gesture, the handsome student then asks, [if PlayerFucked of Angelo is false]'Say, have you met Angelo? He might be more your wavelength... hm, don't think he's in the house right now, but he'll for sure be here for the party tonight.' [else]'Sure you can't wait a few hours until Angelo's back in the house later tonight? I'm sure he'd love to give you some attention.' [end if]";
	else:
		say "     WIP";

to say PAN Frat Brothers Maron Griping:
	say "     Strolling closer to two of the frat brothers that are standing a bit off to the side, you overhear, '...yeah, and then he said we needed to stop for a security check. I was all, 'Are you fucking serious? You know me, we had a lecture together last semester!' But he just stood there with a sneer on his face, then gave a nod to his two goons.' The other student replies, 'That's pure bullshit - they should be watching out for horny critters wandering onto campus and snatching up people to rape, not harass people that are clearly students!' 'Don't I know it. But no, Maron felt a burning need to see a 'bag check' of our stuff. The bigger one of his minions at least had the decency to look a bit embarrassed when he was towering over me to look into the backpack. The other guy, I think he calls himself Alpheus now, that asshole 'confiscated' a bottle of vodka from Paul's bag, and 'accidentally' dropped all of his papers too.'";
	say "     Sounds like there's some discontent brewing about the methods of the local Spartan enforcers. Thinking back to when you met Kerr and Talov, you do remember seeing three Spartans who stopped them too. Those could be the very ones that these frat members are griping about...";
	TraitGain "Maron Griping Heard" for PAN Frat Brothers;


to say PANFratBro_Talkmenu_Night:
	let DoneTalking be false;
	LineBreak;
	now sextablerun is 0;
	blank out the whole of table of fucking options;
	[]
	if PlayerMet of Angelo is false:
		choose a blank row in table of fucking options;
		now title entry is "Introduce yourself to the handsome Latino frat brother";
		now sortorder entry is 1;
		now description entry is "Start a conversation with the dude";
	[]
	if PlayerMet of Angelo is true and Player is not neuter and SubjectPro of Player is "he" and "Player Got Cohunes" is not listed in Traits of Angelo:
		choose a blank row in table of fucking options;
		now title entry is "Express some doubts about Angelo's story";
		now sortorder entry is 2;
		now description entry is "Most of what he told sure must have been pure exaggeration";
	[]
	if PlayerMet of Angelo is true and Player is not neuter and SubjectPro of Player is not "he" and "Player Got Cohunes" is not listed in Traits of Angelo:
		choose a blank row in table of fucking options;
		now title entry is "Tell Angelo you can handle the 'full' story of his exploits";
		now sortorder entry is 3;
		now description entry is "Make clear you're no princess that needs all that flowery talk";
	[]
	if PlayerMet of Angelo is true and Player is not neuter and "Player Got Cohunes" is listed in Traits of Angelo and "First Video Time" is not listed in Traits of Angelo:
		choose a blank row in table of fucking options;
		now title entry is "Challenge Angelo into 'proving' his boasts";
		now sortorder entry is 4;
		now description entry is "(Note: Your gender is important and will lock you into a male/female path.) Tease him into a sexy situation";
	[]
	if PlayerMet of Angelo is true and Player is not neuter and "Player Got Cohunes" is listed in Traits of Angelo and "First Video Time" is listed in Traits of Angelo:
		choose a blank row in table of fucking options;
		now title entry is "Suggest some more video time to Angelo";
		now sortorder entry is 5;
		now description entry is "Step into his room and watch some of his recordings";
	[]
	repeat with y running from 1 to number of filled rows in table of fucking options:
		choose row y from the table of fucking options;
		say "[link][y] - [title entry][as][y][end link][line break]";
	say "[link]0 - Nevermind[as]0[end link][line break]";
	while sextablerun is 0:
		say "Pick the corresponding number> [run paragraph on]";
		get a number;
		if calcnumber > 0 and calcnumber <= the number of filled rows in table of fucking options:
			now current menu selection is calcnumber;
			choose row calcnumber in table of fucking options;
			say "[title entry]: [description entry]?";
			if Player consents:
				let nam be title entry;
				now sextablerun is 1;
				if (nam is "Introduce yourself to the handsome Latino frat brother"):
					say "[Angelo Introduction]";
				else if (nam is "Express some doubts about Angelo's story"):
					say "[Angelo Pre Video Masculine]";
				else if (nam is "Tell Angelo you can handle the 'full' story of his exploits"):
					say "[Angelo Pre Video Feminine]";
				else if (nam is "Challenge Angelo into 'proving' his boasts"):
					say "[Angelo Video Time]";
					now DoneTalking is true;
				else if (nam is "Suggest some more video time to Angelo"):
					say "[Angelo Video Time]";
					now DoneTalking is true;
				if DoneTalking is false:
					say "[PANFratBro_Talkmenu_Night]"; [looping back to continue talking]
				else:
					wait for any key;
		else if calcnumber is 0:
			now sextablerun is 1;
		else:
			say "Invalid Option. Pick between 1 and [the number of filled rows in the table of fucking options] or 0 to exit.";
	clear the screen and hyperlink list;

to say Angelo Introduction:
	say "     Making your way over to the group of people standing in one corner of the large room, you overhear the handsome Latino dude say, '...sure I did her! And she was sweet as fuck!' Moving a little closer still and circling the gathering of people, you catch full sight of him from the side, allowing you to let your eyes wander up and down over the guy's body: He's about five foot eight, with a slender but fit build, fairly well-developed legs and thighs. The low-cut, black skinny jeans reveal just a bit of skin and the top of his crimson-red underwear. Your eyes are naturally drawn to his perky, rounded ass by that little splash of red. Above, a V-neck muscle shirt shows his chest off very well. His skin is a few shades darker than most of the other frat guys around, with curly locks framing his handsome face. Attentive dark-brown eyes flick back and forth over his audience while he bears a winning smile as he tells his boastful tale. Then, one of his friends snorts and shakes his head while exclaiming, 'No way! You can't have gotten Doctor Liz into bed that quickly! Hell, she only started in the medical center a week before this thing with the infection kicked off!'";
	say "     'I never said it was in a bed,' the first frat brother retorts with a smirk, earning him laughs, whistles and acknowledging nods from several others. Smiling, he looks around and wiggles his eyebrows at his friends, in the course of which he spots you. 'Hey ";
	if SubjectPro of Player is "he": [men/trans-males]
		say "dude, you're new! I'm Angelo. Welcome to story-time in my little corner of the house, haha! Why don't you stay a while and listen to my [italic type]completely true and accurate[roman type] tale?' While saying the last few words in a proud tone, he throws looks to some others who roll their eyes disbelievingly.";
		WaitLineBreak;
		say "     After introducing yourself in turn, curiosity gets the better of you. Joining the group of people around Angelo, you can't help but want to know how his tale went on. Seeing himself surrounded by avid listeners, the studly Latino grins and continues to say, 'So yeah, wasn't in a bed. I made my move that week when we were all being called in for health checks, hah! Took the last of the appointment slots on a Friday so there'd be no interruptions, then... did my magic. Had her smiling and a little bit blushing before we even stepped into the examination room. And inside... well, let's say I was prepared when she asked me to take some clothes off so she could check me out.' One of the onlookers snorts, poking his neighbor in the side, 'Yeah, its like Gel's pervy superpower. He can go from a normal outfit and all to absolutely naked in three seconds flat!'";
		say "     Smirking, Angelo continues, 'What can I say - snap-off briefs are your friend! Anyways, Lizzy'd turned away to make a note on my chart, then glanced back at me when she heard the belt buckle hit the floor. Let's just say she was properly impressed, you should have seen her face!' To underline the tale, the Latino brushes a hand down his front, letting his fingers play over the muscles clearly outlined by his skin-tight shirt. Then he cups the bulge of his pants and gives it a demonstrative squeeze. 'Little bit of flirting, complimenting, then showing off this awesome bod, and Angelo Junior, you know... that really hit the mark! A minute later we were kissing and I was exploring her mouth with my tongue. Then another three minutes, and I had her on the exam table, on her back with legs spread!' His excited tone of voice as he adds a few more saucy details seems to be enough for most to believe him, but there's still a few who seem skeptical.";
	else:
		say "babe, you're new! Because I sure would have noticed a sexy thing as yourself before otherwise!' With a flirty wink, he takes your hand and brings it to his lips for a light kiss, then adds, 'I'm Angelo. Welcome to story-time in my little corner of the house, haha! Why don't you stay a while and listen to my [italic type]completely true and accurate[roman type] tale?' While saying the last few words in a proud tone, he throws looks to some others who roll their eyes disbelievingly.";
		WaitLineBreak;
		say "     After introducing yourself in turn, curiosity gets the better of you. Joining the group of people around Angelo, you can't help but want to know how his tale went on. Focusing his attention to you, the studly Latino puts on a friendly smile and continues to say in his rich, charming voice, 'It almost seemed like fate. I met her when we were called in for checkups recently. Told the scheduler to put my appointment at the next open time, and he gave me a slot late in that same week. My appointment was on a humid Friday afternoon, over in the campus health center.' He smiles at you in a flirtatious manner as his voice rolls all of those R's in the tale in that oddly enticing way that makes a pleasant shiver go down your spine. In the corner of your view, you can vaguely see the other frat brothers exchanging some meaningful looks with each other, the corners of their mouths twitching a little as they suppress grins.";
		WaitLineBreak;
		say "     'The doctor welcomed me in the health center and took my info, then told me to step into the examination room. Once inside, she asked me to strip down...' As he says this, Angelo brushes a hand down his front, fingers playing over the muscles clearly outlined by his skin-tight shirt, then lightly grazing the bulge of his pants before pulling away again. You almost think you see a throb from within the skinny jeans. One of the listeners comments, 'Hah, Angel's got a superpower in that regard. He can go from a normal outfit and all to absolutely naked in three seconds flat!' The sexy Latino glances aside at the other guy, his gaze hardening for a second, prompting the frat brother to quickly shut up and clear his throat. 'We had a friendly talk and then she started to go through her checklist, listening to my heart and breathing. But before long I noticed that her hands were touching me more and more... it went beyond an examination after that.'";
		say "     'What can I say... Angelo Junior started rising to the occasion, I'm only a man, you know. With her wrapping her hand around it, the doctor then kissed me, pushing herself against my body. A gentleman doesn't really tell details.' With that, he leans towards you a little bit, smiling as he gives you a nod that drives your imagination to new heights. Angelo waits a moment for the mental images in your head to settle, then goes on to say in his charming voice, 'I can say that I did take good care of her after that. A little while later, when we were basking in the afterglow, I offered to take her out for dinner sometime. Then she told me that it wasn't really something appropriate to be between a doctor and patient, in public.' One of the frat brothers shakes his head in disbelief, commenting, 'So she just wanted you to be her dirty secret? Bro, that's unbelievable!' Angelo gives a slightly overacted sad nod to him, followed by a reply of, 'Yeah, that wasn't for me. I need something real, you know. Who cares if the world knows, if you meet your true soulmate?'";
		WaitLineBreak;
		say "     As the young Latino's story ends, you become aware of several of the other listeners around you having somewhat disappointed expressions. Seems like they wanted to have some more actual details, not the more flowery version that he addressed to you. With your imagination still working overtime, you can't help but feel curious about that too. With everything that you've seen and done so far in the city, getting the full, lewd details actually seems an oddly exciting option, if you think about it.";
	say "     [bold type]Angelo is clearly proud of his conquests, and this might just be an opportunity to have some fun. Though first you'll have to get him to open up a bit more...[roman type]";
	now PlayerMet of Angelo is true;

to say Angelo Pre Video Masculine:
	if "Player Lacks Cohunes" is not listed in Traits of Angelo: [normal]
		say "     Stepping up to Angelo in an opportune moment when his buddies have gone get some drinks, you clear your throat to get his attention, then proclaim that you have your doubts about his tale with that doctor, and especially that supportive boast that his buddy threw in. The hot-blooded Latino immediately picks up on the challenge to his masculinity and status as the local Don Juan, spearing you with a piercing look. 'Is that so, eh?' he exclaims in an unimpressed tone, throwing the nearest bystanders a confident smile before directing a challenging smirk right at you. 'We'll see about that! Come along, if you're not a pussy!' With that said, he gives your upper arm a light smack, then starts walking through the room. You follow, wanting to see where this will lead, and before long, the two of you have entered the large, communal bathroom of the frat-house. In there, Angelo makes a beeline to one of the three tiny side rooms with individual toilets. You pause for a second, wondering what he's planning, and Angelo looks back at you impatiently, waving for you to follow. Maybe he just wants to talk privately?";
		say "     Giving yourself a push, you join Angelo in the tiny room. As soon as you've stepped inside after him, the frat guy stretches past you to shut the door, flicking the lock shut. Finding yourself alone with Angelo in very tight quarters, leaving little if any personal space for either of you, you can't help but feel encroached upon, and somewhat put in your place by him as he's got control of the situation right now. With a serious, somewhat arrogant expression on his face, the young man looks right in your eyes and says, 'So, you think you can doubt my word, and make noise about it? Let me show you what I'm gonna do about that!' Before you can even think of a reply, the student brings his hands down to his beltline, and grabs the lower edge of his tight muscle-shirt. In a series of moves that make you gape at his flexibility, he strips down to bare skin in just a few seconds - which is doubly impressive as he has to wind his way out of skinny jeans, all the while skillfully avoiding braining you in the head with an elbow or other body parts.";
		WaitLineBreak;
		say "     Left with just the pair of crimson-red briefs around his hips, Angelo grins at you while giving a playful little thrust of his hips. Your gaze is automatically drawn down over his chest, taking in the V-shape of his abdominal muscles and following a thin treasure-trail of hair to his crotch. Satisfied in having your attention right where he wanted, Angelo then brings his hand to his crotch with a flourish and grabs hold of the fabric there, pulling sharply to the side, which snaps open the push-buttons along one side of his underwear. As the piece of clothing slips down along his muscled legs to fall to the floor, the athletic student smirks and says, 'Ooops, now how did that happen?' Framed by a neatly trimmed bush of pubic hair, his now-revealed cut cock gives a little twitch upwards from the excitement of exposing himself. Winking at you, Angelo he squares his shoulders a bit and pushes out his chest, standing before you in full naked glory and arrogant self-confidence.";
		say "     Having a completely unimpeded view of the Latino stud's body now, with him standing just about a foot or two in front of you, you can't help but let your gaze sweep over him. Smooth caramel-colored skin covers a nicely trained body, with his muscles clearly outlined beneath. Looks like he takes good care of himself, and shaves the body hair on his chest, arms and legs regularly, leaving only a treasure-trail starting at his belly button. Further, a shiny silver barbell piercing draws attention to his right nipple, making you stare at his pecs. As Angelo notices your attention, he grins and brings a hand up, pinching his un-pierced nipple a little to make it go hard and stick out to match. Letting your eyes wander down, you can see from the thickness of his leg muscles that the young man seems to be doing a bunch of running as one of his main exercises, and remember Richard mentioning that Angelo plays soccer.";
		WaitLineBreak;
		say "     So now you've gone from being in a tight squeeze with the Latino jock you challenged - to him proving that he actually has a ludicrous skill in speed-stripping. And he's challenging you in turn, as Angelo leans in towards you, naked as he is, expecting you to shrink back under the assumption that you're a run of the mill straight guy. He puts another level on top of it by reaching down and wrapping his fingers around the shaft of his cock, stroking it to fill out and harden. Angelo's cock is about seven inches long, but he handles it with supreme confidence, bringing with it the air of something demanding respect. An arrogant grin flashes over his face as he nods down to his crotch, waving his cock with all the air of an imperial scepter. You can't help but stare at it, from the neatly trimmed hair of his pubes, following the veins running down the shaft, all the way down to the shapely head of Angelo's cut cock. 'Thought my buddy was making shit up, eh? Tough luck, chico - I got all the skills! Your move!' he tells you with a smirk.";
		say "[Angelo Dick-smack Choice Masculine]";
	else: [returning after previous fail]
		say "     As you step forward to Angelo, he recognizes the challenging expression on your face and snorts. 'You starting this again? Found some stones for yourself, or something? We'll see about that! Come along, if you're not a pussy!' With that said, he gives your upper arm a light smack, then starts walking through the room. You follow, mentally preparing yourself for a repeat of what he did last time. Before long, the two of you have entered the large, communal bathroom of the frat-house. In there, Angelo makes a beeline to one of the three tiny side rooms with individual toilets. As soon as you've stepped inside after him, the frat guy stretches past you to shut the door, flicking the lock shut. 'I'm starting to think you might just want to check me out or something,' he says with a chuckle and underlying straight-guy arrogance.";
		say "     Before you can even think of a reply, the student brings his hands down to his beltline, and grabs the lower edge of his tight muscle-shirt. In a series of moves that make you gape at his flexibility, he strips down to bare skin in just a few seconds - which is doubly impressive as he has to wind his way out of skinny jeans, and at the same time avoids braining you in the head with an elbow or any other body part. So now you've gone from being in a tight squeeze with the Latino jock you challenged - to him proving that he actually has a ludicrous skill in speed-stripping. And he's challenging you in turn, as Angelo nods down to his crotch, where he's holding the base of a steadily hardening 7-inch cock. Getting another good look at it, you see that he practices man-scaping, having neatly trimmed his pubic hair. A thick vein runs down his shaft, across the top of the length, all the way to the shapely head of Angelo's cut cock. 'My buddy wasn't kidding, I can do this anytime without fail. I got all the skills, ya know?! Your move!' he tells you with a smirk.";
		say "[Angelo Dick-smack Choice Masculine]";

to say Angelo Dick-smack Choice Masculine:
	LineBreak;
	say "     [bold type]It is clear that this isn't sexual - not really, despite him almost rubbing up against you with an erection. No, Angelo's making a show of dominance right now. The question is how you'll react to it.[roman type][line break]";
	LineBreak;
	say "     ([link]Y[as]y[end link]) - Don't back down, whip out your own and smack it in top of his!";
	say "     ([link]N[as]n[end link]) - Bah, this is childish. You're out of here!";
	if Player consents: [dick-smack to prove yourself]
		LineBreak;
		say "     Picking what you think is the right thing to do, you [if Player is not barecrotch]bare your crotch, then [end if]";
		if Player is not male: [male pronouns, but no cock - so transguys]
			say "slide a hand to your clit. Taking it between your fingers, you shuffle even closer to Angelo and thrust your hips forward, smacking his dick lightly from above. He raises his eyebrows at your response, followed by a grin and a respectful nod, then the words, 'Gotta give it to you: You got balls!' He pauses for a second after that, glancing down at your feminine crotch and adding, 'Err... you know what I mean, right?' You can't help but tease him for a short moment, putting on an offended look while trying to keep a smirk off your face. As Angelo's eyebrows start to draw together in worry, you can't help but burst out in laughter. 'Hey, not funny dude!' he complains, lightly smacking your upper arm, but then moving on to grab your shoulder and giving it a friendly squeeze.";
			say "     'Well, it's good to know that you can give as well as you get. But believe me - its all true! I don't boast about things I didn't do!' the handsome stud tells you with a serious tone for the last words. [bold type]Making a mental note of the fact that you can likely use his pride to push further[roman type], you wait for him to get dressed again. As he tugs his clothing back into place, Angelo comments to you, 'Sorry if that made you a bit uncomfortable. I just had to know that you could hang, because me and the guys don't waste our time with pussies.' Eyes flicking down to your crotch for just a second, he comments with a flirty edge to his voice, 'Not that I don't like looking at some pussy,' giving you a smooth wink, before adding, '...just not someone acting like one.' Nodding to him, you then follow the Latino stud back into the main room of the second floor. As you step up to the group of his friends, Angelo lays an arm around your shoulder and loudly exclaims to them, 'Sorry to keep you guys waiting. Me and this loser had something to discuss. But really, he's a good guy. Anyone got a drink for the two of us?' As one of the other frat guys hands out two bottles of beer, Angelo clinks his against yours with a smile, then takes a pull.";
			ItemGain TodtGrains Beer by 1;
			TraitGain "Player = Transdude" for Angelo;
		else: [normal guys]
			say "slide a hand to your own [cock of player] manhood. After a little bit of stroking and rubbing to get it hard, you shuffle close to Angelo and thrust your hips forward, smacking his dick lightly from above. He raises his eyebrows at your response, followed by a grin and a respectful nod, then the words, 'Gotta give it to you: You got balls! It's good to know that you can give as well as you get. But believe me - its all true! I don't boast about things I didn't do!' the handsome stud tells you with a serious tone for the last words.";
			say "     [bold type]Making a mental note of the fact that you can likely use his pride to push further[roman type], you wait for him to get dressed again. As he tugs his clothing back into place, Angelo comments to you, 'Sorry if that made you a bit uncomfortable. I just had to know that you could hang, because me and the guys don't waste our time with pussies.' Nodding to him, you then follow the Latino stud back into the main room of the second floor. As you step up to the group of his friends, Angelo lays an arm around your shoulder and loudly exclaims to them, 'Sorry to keep you guys waiting. Me and this loser had something to discuss. But really, he's a good guy. Anyone got a drink for the two of us?' As one of the other frat guys hands out two bottles of beer, Angelo clinks his against yours with a smile, then takes a pull.";
			ItemGain TodtGrains Beer by 1;
			TraitGain "Player = Dude" for Angelo;
		TraitGain "Player Got Cohunes" for Angelo;
	else:
		LineBreak;
		say "     As you pull back, then fumble with the door, Angelo lets out an amused snort. Managing to get the door open, you stumble out into the communal bathroom, drawing the gaze of everyone already there. Angelo half-follows, stepping into the doorway with his hands grabbing its sides and leaning forward in complete confidence despite being naked as a jaybird. Accompanied by snorts and giggles from the onlookers, you slip back outside the bathroom with your tail between your legs.";
		TraitGain "Player Lacks Cohunes" for Angelo;

to say Angelo Pre Video Feminine:
	if "Player Lacks Cohunes" is not listed in Traits of Angelo: [normal]
		say "     Stepping up to Angelo in an opportune moment when his buddies have gone get some drinks, you clear your throat to get his attention, then proclaim that he didn't have to gloss over all the best parts of his tale with that doctor. You're not some innocent princess that'll faint if things get racy - but on the other hand, maybe he did gloss over it because it was all simply made up? His buddy throwing in that supportive boast was surely just meant to embellish the tall tale too. The hot-blooded Latino immediately picks up on the challenge to his masculinity and status as the local Don Juan, spearing you with a piercing look. 'So you think you're a bad girl, eh?' he exclaims in an unimpressed tone, throwing the nearest bystanders a confident smile before directing a challenging smirk right at you. 'We'll see about that! Come along, if you're not a little bitch!' With that said, he gives your upper arm a light smack, then starts walking through the room.";
		say "     You follow, wanting to see where this will lead, and before long, the two of you have entered the large, communal bathroom of the frat-house. In there, Angelo makes a beeline to one of the three tiny side rooms with individual toilets. You pause for a second, wondering what he's planning, and Angelo looks back at you impatiently, waving for you to follow. Maybe he just wants to talk privately? Giving yourself a push, you join Angelo in the tiny room. As soon as you've stepped inside after him, the frat guy stretches past you to shut the door, flicking the lock shut. You find yourself alone with Angelo in very tight quarters, leaving little if any personal space for either of you. With a serious, somewhat arrogant expression on his face, the young man looks right in your eyes and says, 'Women usually prefer the more flowery approach. You saying you just wanna be treated as one of the guys? And at the same time make noise about doubting my words? Let me show you what I'm gonna do about that!'";
		WaitLineBreak;
		say "     Before you can even think of a reply, the student brings his hands down to his beltline, and grabs the lower edge of his tight muscle-shirt. In a series of moves that make you gape at his flexibility, he strips down to bare skin in just a few seconds - which is doubly impressive as he has to wind his way out of skinny jeans, all the while skillfully avoiding braining you in the head with an elbow or other body parts. Left with just the pair of crimson-red briefs around his hips, Angelo grins at you while giving a playful little thrust of his hips. Your gaze is automatically drawn down over his chest, taking in the V-shape of his abdominal muscles and following a thin treasure-trail of hair to his crotch. Satisfied in having your attention right where he wanted, Angelo then brings his hand to his crotch with a flourish and grabs hold of the fabric there, pulling sharply to the side, which snaps open the push-buttons along one side of his underwear. As the piece of clothing slips down along his muscled legs to fall to the floor, the athletic student smirks and says, 'Ooops, now how did that happen?' Framed by a neatly trimmed bush of pubic hair, his now-revealed cut cock gives a little twitch upwards from the excitement of exposing himself. Winking at you, Angelo he squares his shoulders a bit and pushes out his chest, standing before you in full naked glory and arrogant self-confidence.";
		say "     Having a completely unimpeded view of the Latino stud's body now, with him standing just about a foot or two in front of you, you can't help but let your gaze sweep over him. Smooth caramel-colored skin covers a nicely trained body, with his muscles clearly outlined beneath. Looks like he takes good care of himself, and shaves the body hair on his chest, arms and legs regularly, leaving only a treasure-trail starting at his belly button. Further, a shiny silver barbell piercing draws attention to his right nipple, making you stare at his pecs. As Angelo notices your attention, he grins and brings a hand up, pinching his un-pierced nipple a little to make it go hard and stick out to match. Letting your eyes wander down, you can see from the thickness of his leg muscles that the young man seems to be doing a bunch of running as one of his main exercises, and remember Richard mentioning that Angelo plays soccer.";
		WaitLineBreak;
		say "     So now you've gone from being in a tight squeeze with the Latino jock you challenged - to him proving that he actually has a ludicrous skill in speed-stripping. And he's challenging you in turn, as Angelo leans in towards you, naked as he is, expecting you to shrink back under the assumption that you're just a shy flower of a woman and can't hack it like one of the guys. He puts another level on top of it by reaching down and wrapping his fingers around the erect shaft of his cock while giving you an appreciating look, full of undisguised lust. You can even see his dickhead throb a little, with a bead of pre-cum forming at the slit. Angelo's cock is about seven inches long, but he handles it with supreme confidence, bringing with it the air of something demanding respect. An arrogant grin flashes over his face as he nods down to his crotch, waving his cock with all the air of an imperial scepter. You can't help but stare at it, from the neatly trimmed hair of his pubes, following the veins running down the shaft, all the way down to the shapely head of Angelo's cut cock. 'Thought my buddy was making shit up, eh? Tough luck, chica - I got all the skills! Your move!' he tells you with a smirk.";
		say "[Angelo Dick-smack Choice Feminine]";
	else: [returning after previous fail]
		say "     As you step forward to Angelo, he recognizes the challenging expression on your face and snorts. 'You starting this again? Found some stones for yourself, or something? 'We'll see about that! Come along, if you're not a little bitch!' With that said, he gives your upper arm a light smack, then starts walking through the room. You follow, mentally preparing yourself for a repeat of what he did last time. Before long, the two of you have entered the large, communal bathroom of the frat-house. In there, Angelo makes a beeline to one of the three tiny side rooms with individual toilets. As soon as you've stepped inside after him, the frat guy stretches past you to shut the door, flicking the lock shut. 'You know you just have to ask if you wanna get me naked, right?' he says with a chuckle and underlying straight-guy arrogance.";
		say "     Before you can even think of a reply, the student brings his hands down to his beltline, and grabs the lower edge of his tight muscle-shirt. In a series of moves that make you gape at his flexibility, he strips down to bare skin in just a few seconds - which is doubly impressive as he has to wind his way out of skinny jeans, and at the same time avoids braining you in the head with an elbow or any other body part. So now you've gone from being in a tight squeeze with the Latino jock you challenged - to him proving that he actually has a ludicrous skill in speed-stripping. And he's challenging you in turn, as Angelo nods down to his crotch, where he's holding the base of a steadily hardening 7-inch cock. Getting another good look at it, you see that he practices man-scaping, having neatly trimmed his pubic hair. A thick vein runs down his shaft, across the top of the length, all the way to the shapely head of Angelo's cut cock. 'My buddy wasn't kidding, I can do this anytime without fail. I got all the skills, ya know?! Your move!' he tells you with a smirk.";
		say "[Angelo Dick-smack Choice Feminine]";

to say Angelo Dick-smack Choice Feminine:
	LineBreak;
	say "     [bold type]Even though Angelo's showing interest in you, you're not exactly sure that this is a sexual situation. He may be almost rubbing up against you with an erection, but you really think the Latino stud's making a show of dominance right now. The question is how you'll react to it.[roman type][line break]";
	LineBreak;
	say "     ([link]Y[as]y[end link]) - Grab him by the balls (gently but firmly) and stare him down!";
	say "     ([link]N[as]n[end link]) - Bah, this is childish. You're out of here!";
	if Player consents: [grab his balls]
		LineBreak;
		say "     Picking what you think is the right thing to do, you step forward and grab hold of his balls, all the while keeping your gaze securely locked to his own. Angelo's eyebrows rise in reaction to the move, showing that he didn't expect you to be this bold. His body starts to tense, preparing itself for a potentially painful squeeze, but you don't do anything of the type, just keeping a firm grasp of his family jewels as you stare him down with a confident grin on your face. Realizing what you're doing, he keeps eye-contact in a low-key battle of wills, before finally giving an acknowledging nod. 'Gotta give it to you: You got balls! Besides mine, I mean. It's good to know that you can give as well as you get. Just like one of the guys. But believe me - its all true! I don't boast about things I didn't do!' the handsome stud tells you with a serious tone for the last words.";
		say "     [bold type]Making a mental note of the fact that you can likely use his pride to push further[roman type], you wait for him to get dressed again. As he tugs his clothing back into place, Angelo comments to you, 'Sorry if that made you a bit uncomfortable. I just had to know that you could hang, because me and the guys don't waste our time with pussies.' Nodding to him, you then follow the Latino stud back into the main room of the second floor. As you step up to the group of his friends, Angelo lays an arm around your shoulder and loudly exclaims to them, 'Sorry to keep you guys waiting. Me and this chica had something to discuss. Keep your grubby hands off her, alright? Anyone got a drink for the two of us?' As one of the other frat guys hands out two bottles of beer, Angelo clinks his against yours with a smile, then takes a pull.";
		TraitGain "Player Got Cohunes" for Angelo;
		TraitGain "Player = Girl" for Angelo;
	else:
		LineBreak;
		say "     As you pull back, then fumble with the door, Angelo raises his hands and steps back. 'Relax, I'm not gonna do anything, I'm not that type of guy! I can see you're not actually a rough and tumble gal in the end.' There's a short pause as he rolls his eyes a little, shrugging off his annoyance at you chickening out like this. Then he takes up his 'normal' behavior of laying the charm on thick again, 'Nothing to be ashamed about, it's understandable if you'd rather have a friendly get-together later, eh? I'll make sure to treat you like the lady you are, how about that?' He finishes up with a winning smile and a wink. Meanwhile, you've managed to get the door open, and stumble out into the communal bathroom, drawing the gaze of everyone already there. Angelo half-follows, stepping into the doorway with his hands grabbing its sides and leaning forward in complete confidence despite being naked as a jaybird. 'Don't worry, sometimes this much man is hard to handle for any chica! We can try again later,' he quips, more for the audience than yourself. Accompanied by snorts and giggles from the onlookers, you slip back outside the bathroom with your tail between your legs.";
		TraitGain "Player Lacks Cohunes" for Angelo;

to say Angelo Video Time:
	if "First Video Time" is listed in Traits of Angelo:
		say "[bold type]<Writer's Note: As there currently are no additional sex scenes for Angelo, you'll get a repeat of the initial scene as a treat for now.>[roman type][line break]";
		LineBreak;
	say "     Chatting a little bit with the hangers-on near Angelo, you voice some doubts about his claims of fucking the sexy Doctor Liz right in her own examination room. It doesn't take much effort before one of the guys quietly moves over to Angelo and alerts him to what you're doing. The prideful young man picks up the gauntlet immediately, stepping up to deflect you throwing doubts at his claims. Holding your own, you glance left and right, tying in his friends and forcing him to respond to retain his status before the guys. You argue that sure, he might have balls, and the skills to just strip down in seconds like he claimed - but would a doctor, a professional, just drop her panties for him in a single instant? It's an unlikely story! You keep at it, challenging Angelo, then drive things to a point and call out that it's only his say-so after all, and he's got no proof...";
	say "     The frat's Don Juan jumps at those words, grinning widely. 'That's what you think...' he says, then pats your arm and indicates you should follow him. With a smirk, you reply that you're good without him wagging his dick at you again. Quelling the chuckle or two that bubbles up among his followers with a single look, Angelo rolls his eyes a little and tells you, 'That's not what I mean. You've proven you can hang. It's just that I wanna show you something.' Then he gives a casual wave to the other guys and says, 'Talk to you later. And you - ya coming? Or are you just gonna stand there and keep yammering?' Relenting, you follow Angelo, with the two of you climbing to the third floor, where he leads you down the northern hallway and into his room. It is nicely spacious for student accommodation, with high quality furniture, demonstrating the fairly well-off status of the PAN fraternity.";
	WaitLineBreak;
	say "     The room allows you a glimpse at the Latino's true self, in the way he decorates his private place. Besides some obligatory bikini babe posters on the walls, there's also two big band posters with Portuguese writing on them, for what looks to be a Brazilian rock band. An electric guitar hangs from a prime spot in the middle of the back wall, with loudspeakers to go with it wired into the corners of the room. There's a soccer ball lying around too, half-under a crumpled soccer jersey. Seems to you a little that while Angelo is a soccer player, other interests are more front and center for him. Other than that, the room is at least moderately tidy, at least as far as a college guy can be expected to be. Clean floors and with the blanket lying folded on the bed, just not exactly straight. Stepping further into the room, the Latino glances over to the chair at his desk, laden with a tall stack of folded laundry that most likely was placed there by a pledge and not sorted away by Angelo yet.";
	say "     With a shrug, Angelo waves over to the ground before the bed. 'Sit down, sit down. I'll just need to find the right one.' As you walk over and sit down, with your back against the side of the bed, the young man pulls out the bottom drawer of his dresser and takes the lid of a shoebox inside, then lets his finger sweep over the video camera tapes that are tightly packed in side it. 'Here we go!' Angelo says with a grin, victoriously raising a tape in one hand. Snatching up a video camera to go with it, he then bumps the drawer shut with his knee, and walks over to the television, connecting the camera to it and sliding the tape into the side flap, then pushing it closed with a click. Smirking at you, he presses the play button, which makes Angelo's grinning face appear on the TV, as well as his arm looming large as he seems to have adjusted the camera during the recording, glancing down at his smartphone displaying the video feed of the camera to check the angle.";
	WaitLineBreak;
	say "     There's some irregular, dark material around the edges of the image, fairly blurry - but you manage to recognize it as the fabric of a backpack, and the teeth of an open zipper. The viewpoint shifts a bit as video-Angelo adjusts the camera, revealing that he must have placed his backpack on a counter at the medical office or so, as you can see what appears to be an examination room and adjustable medical table. A good-looking woman in a lab-coat is on the other side of the room, with her back turned as she is just putting together a thin stack of forms on a clipboard. 'Okay Mr. Silva, we can start your checkup in a second,' she says, with him replying, 'Oh no, please just call me Angelo. I don't want to force such a beautiful woman like yourself into having to be formal with me.' She looks back at him with a smile playing over her lips and a little blush, showing his compliment struck home. 'Of course Angelo. Let me just check if all your personal data is correct...' Reading down the cover sheet on her clipboard, she puts little checkmarks besides everything that the student confirms, then finally turns to the next sheet and starts writing something on it at the top while saying, 'Could you please take off your outer clothing for the exam?'";
	say "     With your eyes focused on the screen, you watch as video-Angelo does his speed-strip routine, taking in the roundness of his ass as he slides his pants down, and the slight jiggle of his cheeks as he steps out of the clothing piled at his feet. The angle sadly isn't the best to feast your eyes on his naked body, and you unconsciously lean to the side a little, as if trying that would move your viewpoint. This earns you a side glance from the real Angelo, who gives an apologetic shrug. 'Sorry about having to watch just my naked butt on the screen. Didn't exactly have a cameraman to properly focus on her reaction or anything. It'll get better in a sec, I promise - haha!' With that said, the young man strolls over and sits on the ground beside you, then points at the screen. 'Now watch this. I just love her expression and the sound she made!' he says with a grin, just in time for the doctor to react to the clink of his belt buckle on the floor.";
	WaitLineBreak;
	say "     As she turns around, her eyes go wide and a little squeak of surprise escapes her lips as she finds herself confronted with the fully naked and quite handsome Latino. 'What can I say, I don't usually wear underwear. And Angelo Junior can't help but show his appreciation for such breathtaking women like yourself...' As the naked man on the screen turns a little, making his erection swing into view, while he talks with the doctor, the Angelo right next to you grins broadly. 'Believe me now?' he asks, glancing back and forth between you and the screen. You can see from the corner of your eye that he's got a noticeable bulge in his pants, and is rubbing the side of his hand casually against it. Looks like he's getting quite excited from the memory, his trophy video, proudly showing off his conquest, or a mixture of all of those things. Given that you're in his room, watching one of his sex tapes, and the fact that he's not shy at all about showing off his body, it doesn't take much longer before he peels off his shirt, then the sound of a zipper being lowered can be heard, with Angelo pulling out his cock and starting to jerk off.";
	LineBreak;
	if SubjectPro of Player is "he": [men/trans-males]
		say "     [bold type]What do you do now?[roman type][line break]";
		say "     [link](1)[as]1[end link] - Join him in self-pleasure, then attempt to grasp his cock at an opportune moment.";
		say "     [link](2)[as]2[end link] - Stroke yourself right along with him.";
		say "     [link](3)[as]3[end link] - Acknowledge that he did bag the sexy doctor after all, then quietly leave the room.";
		now calcnumber is 0;
		while calcnumber < 1 or calcnumber > 3:
			say "Choice? (1-3)>[run paragraph on]";
			get a number;
			if calcnumber is 1 or calcnumber is 2 or calcnumber is 3:
				break;
			else:
				say "Invalid choice. Type [link]1[end link] to pleasure yourself and stroke Angelo, [link]2[end link] to pleasure yourself or [link]3[end link] to leave.";
		if calcnumber is 1:
			LineBreak;
			say "     [if Player is not barecrotch]Quickly baring your own crotch, you [else]You [end if]move one hand to";
			if Player is male:
				say "grab hold of your [cock of Player] shaft, stroking up and down along its length and letting out breathy grunts as you masturbate. ";
			else if Player is female:
				say "lay on top of your pubic mound, then start to rub and lightly pinch your clit, letting out breathy pants as you stimulate yourself. ";
			say "A loud moan coming from the TV draws your attention up to the screen, where you can see video-Angelo just slide into the woman's pussy for the first time. Watching him work her body with the skillful experience of a true ladies['] man is a sight to see, as is the flexing of his muscular buttocks with every thrust. Though of course you've got something better than just a video, sitting right next to you with his dick in hand, jerking it with unhurried strokes. Casually glancing to the side, you look at his mostly naked body, letting your gaze wand over his dark skin and down to the hard cock in his hand. It is a long shot from the biggest you've seen before, especially recently, but... the boy sure knows how to use it, as the video still playing on the TV screen proves.";
			say "     Seems like you weren't as stealthy as you thought in checking Angelo out, as he turns his head to half look at you and half keep the TV in his field of vision. A grin spreads on his face as he says 'She was a wild minx to fuck, I can tell you that! Feeling those silky-smooth legs around my waist as I was thrusting into her, man, that was amazing! And the pussy... man, I think she must have been into gymnastics, yoga or something like that. Chicks who're fit and have muscle tone all over the place really know how to flex around ya, hah!' Listening to the young man's excited praise for the female doctor he fucked - and is fucking in the video - you ask him some leading questions about what he liked about being with her. He chuckles and answers, 'Oh, she had great boobs. Really jiggly as I was thrusting, haha!' Then, as Angelo is miming in the air with both hands how big she was in his grasp, you confidently reach over and take hold of his cock.";
			WaitLineBreak;
			if Player is male:
				say "     There is a little bit of tension in the air for a second, but as you begin to jerk the already quite horny student, and ask him to keep talking of the doctor's breasts, he relaxes pretty quickly. ";
			else:
				say "     There is a moment of silence in the air, as Angelo seems to contemplate asking for something more between you, letting his gaze wander over your body. You gloss over that possibility for now by starting to jerk the already quite horny student, and ask him to keep talking about the doctor's breasts. ";
			say "Sitting side by side, you keep one hand wrapped around his hard shaft, the other working on your own sex, stimulating both of you in unison. Once or twice over the next little while, he tries to get a hand back around his own shaft, but as you keep shooing it away, Angelo relents. From then on, he's fairly vocal in communicating his state of arousal, asking you to move faster, or grip his dick more firmly. You keep at your own pace, enjoying the chance to tease the Latino stud a little bit, mentioning that giving back some pleasure would be appreciated. He ";
			if SubjectPro of Player is "he": [men/trans-males]
				say "pauses for a second, hesitating from touching another dude, then gives himself a push to reach out for your crotch. 'Man, feels odd to be doing this to another dude,' he comments somewhat embarrassedly. [if Player is female]Slipping two fingers into your pussy, he relaxes before long as you at least have parts he's familiar with. [else]Wrapping his fingers around the [cock of player] shaft between your legs, he begins to jerk up and down. ";
			else:
				say "reaches out to touch your pussy without delay, smirking a little as he slips his fingers into you. ";
			say "From then on, you settle into a fun bout of pleasing each other, touching and stroking as you watch the video, and also watch Angelo's body. Your mutual stroking but still being nice by giving him what he asks when he pleads with truly urgent arousal in his voice. It doesn't take much longer before your double masturbation session reaches its inevitable conclusion of driving both of you over the edge to full-throated moans announcing your climax.";
			say "     Breathlessly [if player is male]holding your shaft in an iron grip as it begins to let loose long streaks of creamy cum to splat down on yourself, as well as a few onto Angelo's sheets, [else]frigging your clit and feeling your pussy go most and dripping, creating a small wet spot on Angelo's sheets, [end if]you ride out the pleasure-filled high of orgasm. Besides you, the Latino stud quickly cupped his erection with one hand, covering its throbbing dickhead. Then, once he stops twitching and grunting as the last of his seed has erupted from the piece of man-meat in your grasp, the young man does something surprising - he lifts his hand to his face, licking off the fresh cum from it. 'What? It's just protein!' he says as he sees you stare at him, then slurps up some more with a sweep of his tongue. 'The way I see it, it's a waste if it isn't going into a pussy. So this stuff goes right back into me if I'm not seeding a girl! Gotta keep up your energy to be ready when the time to strike comes, hah!'";
			WaitLineBreak;
			say "     Chuckling and keeping to yourself that it's a pretty gay thing to do, for a straight guy, you simply watch him finish off eating the cum. As he soon is finished, he glances over to you, then stretches himself across the bed to snatch up a box of tissues, handing it to you so you can clean up yourself. While you're doing that, Angelo nods to the TV screen, where his video-self is just enjoying himself being orally serviced, building up to a second wind of fucking the doctor again. With a snort, he comments, 'Too bad Lizzy's no longer around hereabouts, she was a wild fuck! Last I heard, she was carried off by a minotaur, happily rocking up and down on his shaft as they went.' Giving a shrug, the young man adds, 'Knew right away Lizzy was pretty thirsty for it when I heard from a buddy that she'd given his balls a bit of a fondle, when doing his checkup. So I took the bold approach, and it worked!'";
			say "     As you chuckle and give Angelo a thumbs-up to acknowledge his conquest, the frat member says in a bit more serious tone, 'Just so we understand each other... this didn't happen! We just watched a vid, no touching. I'm not gay!' At that statement, his eyes meet your own in a sharp expression, underlining that he's concerned about rumors getting started. Then he softens his seriousness a bit again and adds, 'I mean, just keep a lid on it, alright?' After seeing you nodding to acknowledge his request, the frat member adds, 'It's fun to relive some memories, so... if you wanna watch another vid or so in the future, just let me know, eh? I got plenty.' With that, you smile and slip out of the room, then walk back down to the second floor.";
		else if calcnumber is 2:
			LineBreak;
			say "     [if Player is not barecrotch]Quickly baring your own crotch, you [else]You [end if]move one hand to";
			if Player is male:
				say "grab hold of your [cock of Player] shaft, stroking up and down along its length and letting out breathy grunts as you masturbate. ";
			else if Player is female:
				say "lay on top of your pubic mound, then start to rub and lightly pinch your clit, letting out breathy pants as you stimulate yourself. ";
			say "A loud moan coming from the TV draws your attention up to the screen, where you can see video-Angelo just slide into the woman's pussy for the first time. Watching him work her body with the skillful experience of a true ladies['] man is a sight to see, as is the flexing of his muscular buttocks with every thrust. Though of course you've got something better than just a video, sitting right next to you with his dick in hand, jerking it with unhurried strokes. Casually glancing to the side, you look at his mostly naked body, letting your gaze wand over his dark skin and down to the hard cock in his hand. It is a long shot from the biggest you've seen before, especially recently, but... the boy sure knows how to use it, as the video still playing on the TV screen proves.";
			say "     Seems like you weren't as stealthy as you thought in checking Angelo out, as he turns his head to half look at you and half keep the TV in his field of vision. A grin spreads on his face as he says 'She was a wild minx to fuck, I can tell you that! Feeling those silky-smooth legs around my waist as I was thrusting into her, man, that was amazing! And the pussy... man, I think she must have been into gymnastics, yoga or something like that. Chicks who're fit and have muscle tone all over the place really know how to flex around ya, hah!' Listening to the young man's excited praise for the female doctor he fucked - and is fucking in the video - you keep pleasuring yourself while looking back and forth between him and the TV screen. As you soon start getting kinda close to coming, you realize that Angelo picked up on that too, and he's speeding up his own jerking to match. Side by side, your pants and moans come mostly in unison, until he pushes himself over the edge just a moment after your own orgasm breaks.";
			WaitLineBreak;
			say "     Breathlessly [if player is male]holding your shaft in an iron grip as it begins to let loose long streaks of creamy cum to splat down on yourself, as well as a few onto Angelo's sheets, [else]frigging your clit and feeling your pussy go moist and dripping, [end if]you ride out the pleasure-filled high of climax. Besides you, the Latino stud is tightly gripping his erection, holding the other hand over the throbbing dickhead. Then, once he stops twitching and grunting as the last of his seed has erupted from the piece of man-meat in his grasp, the young man does something surprising - he lifts the hand to his face, licking off the fresh cum from it. 'What? It's just protein!' he says as he sees you stare at him, then slurps up some more with a sweep of his tongue. 'The way I see it, it's a waste if it isn't going into a pussy. So this stuff goes right back into me if I'm not seeding a girl. Gotta keep up your energy to be ready when the time to strike comes, hah!'";
			say "     Chuckling and keeping to yourself that it's a pretty gay thing to do, for a straight guy, you simply watch him finish off eating the cum. As he soon is finished, he glances over to you,  then half-slides his chest onto the bed, to stretch and snatch up a box of tissues, handing it to you so you can clean up yourself. While you're doing that, Angelo nods to the TV screen, where his video-self is just enjoying himself being orally serviced, building up to a second wind of fucking the doctor again. With a snort, he comments, 'Too bad Lizzy's no longer around hereabouts, she was a wild fuck! Last I heard, she was carried off by a minotaur, happily rocking up and down on his shaft as they went.' Giving a shrug, the young man adds, 'Knew right away Lizzy was pretty thirsty for it when I heard from a buddy that she'd given his balls a bit of a fondle, when doing his checkup. So I took the bold approach, and it worked!' As you chuckle and give Angelo a thumbs-up to acknowledge his conquest, the frat member says, 'It's fun to relive some memories, so... if you wanna watch another vid or so in the future, just let me know, eh? I got plenty.' Nodding to him, you then slip out of the room and walk back down to the second floor.";
		else if calcnumber is 3:
			LineBreak;
			say "     Pushing yourself up from the floor, you turn to look at Angelo, who holds his gaze on the TV for a moment longer before glancing up at you. 'Told ya!' he says with a grin, never stopping the jerking movements of his hand. Nodding to him, you acknowledge that he did tell the truth and get it on with that doctor - a fact that is underlined by a breathy moan coming from the TV, where you can see video-Angelo just slide into the woman's pussy for the first time. 'She was a wild minx to fuck, I can tell you that! Too bad Lizzy's no longer around hereabouts. Last I heard, she was carried off by a minotaur, happily rocking up and down on his shaft as they went.' Giving a shrug, the young man adds, 'Knew right away Lizzy was pretty thirsty for it when I heard from a buddy that she'd given his balls a bit of a fondle, when doing his checkup. So I took the bold approach, and it worked!' With a grin, he nods to the screen, where the examination room is still in quite active use for extracurricular activities.";
			say "     As you chuckle and give Angelo a thumbs-up to acknowledge his conquest, the frat member says, 'It's fun to relive some memories, so... if you wanna watch another vid or so in the future, just let me know, eh? I got plenty.' Nodding to him, you tell him to enjoy his wank, then slip out of the room and walk back down to the second floor.";
	else: [female Players]
		say "     [bold type]What do you do now?[roman type][line break]";
		say "     [link](1)[as]1[end link] - Touch yourself right along with him.";
		say "     [link](2)[as]2[end link] - Acknowledge that he did bag the sexy doctor after all, then quietly leave the room.";
		now calcnumber is 0;
		while calcnumber < 1 or calcnumber > 2:
			say "Choice? (1-2)>[run paragraph on]";
			get a number;
			if calcnumber is 1 or calcnumber is 2:
				break;
			else:
				say "Invalid choice. Type [link]1[end link] to pleasure yourself, or [link]2[end link] to leave.";
		if calcnumber is 1:
			LineBreak;
			say "     [if Player is not barecrotch]Quickly baring your own crotch, you [else]You [end if]move one hand to lay on top of your pubic mound, then start to rub and lightly pinch your clit, letting out breathy pants as you stimulate yourself. A loud moan coming from the TV draws your attention up to the screen, where you can see video-Angelo just slide into the woman's pussy for the first time. Watching him work her body with the skillful experience of a true ladies['] man is a sight to see, as is the flexing of his muscular buttocks with every thrust. Though of course you've got something better than just a video, sitting right next to you with his dick in hand, jerking it with unhurried strokes. The fraternity Casanova's attention is fully on you too, as he feasts his eyes on your crotch, followed by him giving a nod to the TV. 'I can show how all of that feels. You'll love it, I can promise you that!' With that said, he starts to reach out towards your pussy, in an eager but intentionally slow and casual way.";
			say "     [bold type]How do you react to the horny Latino's approach?[roman type][line break]";
			say "     [link](1)[as]1[end link] - Allow him to finger you and jerk him off in turn.";
			say "     [link](2)[as]2[end link] - Softly reject Angelo, but acknowledge that he did bag the doctor and leave the room.";
			now calcnumber is 0;
			while calcnumber < 1 or calcnumber > 2:
				say "Choice? (1-2)>[run paragraph on]";
				get a number;
				if calcnumber is 1 or calcnumber is 2:
					break;
				else:
					say "Invalid choice. Type [link]1[end link] to let him finger you or [link]2[end link] to leave.";
			if calcnumber is 1:
				LineBreak;
				say "     A grin spreads on Angelo's face as his fingertips gently brush over your sensitive nether lips for the first time, then seek out the pleasure-button of your clit. 'Just imagine how it'd feel if we did the things there in the video. I know very well how to treat a woman.' As he says this, the young man's fingertip starts to rub in a circle around the edge of your clit, stimulating you very, very nicely. He keeps making connections to the video, stroking you in tandem with what you can see there, drawing sighs and moans that echo the doctor he was fucking. He leans closer and closer as he does so, whispering sweet words into your ears. He's trying to seduce you into letting him take control, to take you on a wild, sexual ride. But for now, you've still got your wits to yourself, so you decide to push back a little. As Angelo has both his hands busy, stroking your cheek  and side, you confidently reach over and take hold of his cock.";
				say "     His eyebrows rise a bit as you don't follow his plan, but given that he's still half-naked with a new partner, the fraternity's Don Juan seems to count it as a win and just goes with the changed situation. As he touches and strokes you, your hand begins to jerk the already quite horny student, and you tell him that you've got some things to show him too. His erection throbs in your grasp as you teasingly tell him to imagine sliding his shaft inside you. Sitting side by side, you keep one hand wrapped around his hard shaft, the other stroking the side of his arm as he works on your own sex, stimulating both of you in unison. Once or twice over the next little while, he tries to get a hand back around his own shaft, but as you keep shooing it away, Angelo relents. From then on, he's fairly vocal in communicating his state of arousal, asking you to move faster, or grip his dick more firmly. You keep at your own pace, enjoying the chance to tease the Latino stud even more.";
				WaitLineBreak;
				say "     From then on, you settle into a fun bout of pleasing each other, touching and stroking as you watch the video, and also watch Angelo's body. Your mutual pleasure builds higher and higher, until he eventually says in an urgent tone, 'I'm really close now!' It doesn't take much longer before your double masturbation session reaches its inevitable conclusion of driving both of you over the edge to full-throated moans announcing your climax. Breathlessly trembling and twitching as Angelo frigs your clit with an expert's touch, your pussy goes moist and dripping as you ride out the pleasure-filled high of orgasm. Besides you, the Latino stud quickly cupped his erection with one hand, covering its throbbing dickhead. Then, once he stops twitching and grunting as the last of his seed has erupted from the piece of man-meat in your grasp, the young man does something surprising - he lifts his hand to his face, licking off the fresh cum from it. 'What? It's just protein!' he says as he sees you stare at him, then slurps up some more with a sweep of his tongue. 'The way I see it, it's a waste if it isn't going into a pussy. So this stuff goes right back into me if I'm not seeding a girl! Gotta keep up your energy to be ready when the time to strike comes, hah!'";
				say "     Chuckling and keeping to yourself that it's a pretty gay thing to do, for a straight guy, you simply watch him finish off eating the cum. As he soon is finished, he glances over to you, then half-slides his chest onto the bed, to stretch and snatch up a box of tissues, handing it to you so you can clean up yourself. While you're doing that, Angelo nods to the TV screen, where his video-self is just enjoying himself being orally serviced, building up to a second wind of fucking the doctor again. With a snort, he comments, 'Too bad Lizzy's no longer around hereabouts, she was a wild fuck! Last I heard, she was carried off by a minotaur, happily rocking up and down on his shaft as they went.' Giving a shrug, the young man adds, 'Knew right away Lizzy was pretty thirsty for it when I heard from a buddy that she'd given his balls a bit of a fondle, when doing his checkup. So I took the bold approach, and it worked!' As you chuckle and give Angelo a thumbs-up to acknowledge his conquest, the frat member says, 'It's fun to relive some memories, so... if you wanna watch another vid or so in the future, just let me know, eh? I got plenty.' Nodding to him, you then slip out of the room and walk back down to the second floor.";
			else:
				LineBreak;
				say "     You intercept Angelo's reaching hand, gently but firmly pushing it away from your crotch as you shake your head at him. He takes this well enough, telling you in a charmingly smooth voice, 'I just had to try, it is difficult to keep one's hands to yourself when in the presence of such a beautiful woman.' A very well-trained smile with just a hint of a suggestive smirk to it leads over to his next words of, 'My offer stands, now and in the future. You know I'm not one to give up too easily, and I'd love to show you so many pleasures...' Seeing that he'll keep his attempts to charm you up relentlessly, for as long as you're here with him, and exposed to boot, you push yourself up from the floor and take a step away[if Player is not barecrotch], then quickly get dressed again. [else]. [end if]After a quick wave and goodbye to Angelo, you leave his room and move back to the second floor.";
		else:
			LineBreak;
			say "     Pushing yourself up from the floor, you turn to look at Angelo, who holds his gaze on the TV for a moment longer before glancing up at you. 'Told ya!' he says with a grin, never stopping the jerking movements of his hand. Nodding to him, you acknowledge that he did tell the truth and get it on with that doctor - a fact that is underlined by a breathy moan coming from the TV, where you can see video-Angelo just slide into the woman's pussy for the first time. 'She was a wild minx to fuck, I can tell you that! Too bad Lizzy's no longer around hereabouts. Last I heard, she was carried off by a minotaur, happily rocking up and down on his shaft as they went.' Giving a shrug, the young man adds, 'Knew right away Lizzy was pretty thirsty for it when I heard from a buddy that she'd given his balls a bit of a fondle, when doing his checkup. So I took the bold approach, and it worked!' With a grin, he nods to the screen, where the examination room is still in quite active use for extracurricular activities.";
			say "     As you chuckle and give Angelo a thumbs-up to acknowledge his conquest, the frat member says, 'It's fun to relive some memories, so... if you wanna watch another vid or so in the future, just let me know, eh? I got plenty.' Nodding to him, you tell him to enjoy his wank, then slip out of the room and walk back down to the second floor.";
		TraitGain "Player = Girl" for Angelo;
	TraitGain "First Video Time" for Angelo;
	[
	else:
		say "Repeat/Buildup Scenes";
	]


Section 3 - Sex

instead of fucking PAN Frat Brothers:
	if daytimer is day:
		say "     During the day, the guys seem fairly busy with their chores, coursework and whatnot. You somehow doubt that kicking off a bout of fucking right in the middle of their hangout spot would be well received.";
	else:
		if Resolution of Free Drink < 8:
			say "     Even though they're horny frat guys and somewhat drunk, just openly asking one or more of them to fuck here and now seems like a bit of a stretch. Things might be different if they somehow acquired a more fun-loving, untamed outlook in life...";
		else:
			say "[PAN_FratBrothers_SexMenu]";

to say PAN_FratBrothers_SexMenu:
	say "     [bold type]What do you want to do? [roman type][line break]";
	LineBreak;
	now sextablerun is 0;
	blank out the whole of table of fucking options;
	[]
	if Player is male:
		choose a blank row in table of fucking options;
		now title entry is "Bend a satyr brother over a sofa and fuck him";
		now sortorder entry is 1;
		now description entry is "Pound his satyr ass";
	[]
	Sort the table of fucking options in sortorder order;
	repeat with y running from 1 to number of filled rows in table of fucking options:
		choose row y from the table of fucking options;
		say "[link][y] - [title entry][as][y][end link][line break]";
	say "[link]0 - Nevermind[as]0[end link][line break]";
	while sextablerun is 0:
		say "Pick the corresponding number> [run paragraph on]";
		get a number;
		if calcnumber > 0 and calcnumber <= the number of filled rows in table of fucking options:
			now current menu selection is calcnumber;
			choose row calcnumber in table of fucking options;
			say "[title entry]: [description entry]?";
			if Player consents:
				let nam be title entry;
				now sextablerun is 1;
				if (nam is "Bend a satyr brother over a sofa and fuck him"):
					say "[PAN_FratBrothers_Sofa_Fuck]";
				now lastfuck of PAN Frat Brothers is turns;
				wait for any key;
		else if calcnumber is 0:
			now sextablerun is 1;
			wait for any key;
		else:
			say "Invalid Option. Pick between 1 and [the number of filled rows in the table of fucking options] or 0 to exit.";
	clear the screen and hyperlink list;

to say PAN_FratBrothers_Sofa_Fuck:
	say "...";

[------------------------------]


PAN Frat Bros ends here.
