Version 1 of Recordings by Wahn begins here.

"Adds an event where the player can find tapes"

Demon Chase is a situation.
The sarea of Demon Chase is "Outside".

when play begins:
	add Demon Chase to badspots of Hellspawn;
	add Demon Chase to badspots of Incest;

Instead of resolving a Demon Chase:
	say "     Walking through the trash-strewn streets of the inner city, you follow a meandering path, checking out anything that might perhaps be of some use. As you are stopping to investigate the trunk of a car that crashed into a light pole, only to find it empty, you suddenly hear the rapid patter of running footsteps on asphalt. Raising your head from looking into the open trunk, you don't have long to wait before the source of the noise comes shooting out of a nearby alley, claws scratching over the ground as he takes the corner at a full run. It is an anthro Golden Labrador, a young man from the looks of it, dressed in a colorful t-shirt and shorts, and he seems to be running for his life! The guy dashes down the road your way, a backpack bouncing left and right where it is loosely slung over one shoulder - until it isn't as the strap snaps, and the bag is sent crashing to the ground.";
	say "     The fleeing anthro glances over his shoulder and calls out, 'Fuck!' Yet by the time he does, he's already a dozen feet ahead of where the backpack dropped. His eyes widen when he sees you standing behind the car, and he shouts, 'RUN!'Slowing down for a step or two before focusing ahead of himself once more, he puts in an additional burst of speed. The reason for his panicked flight is revealed before you can do anything at all to react to his call: A lumbering brute of a purple demon barrels out of the original alley the canine came from, his mouth open in a teeth-filled snarl. You look down the street for the Labrador, but the guy has already fled into another alley it seems. That or maybe he's hiding somewhere.";
	WaitLineBreak;
	say "     With his immediate target no longer in sight, the large demon brute stomps forward to the middle of the street and shouts, 'I'll find you, stupid mutt! And when I do, you will know the real meaning of suffering!' He comes to stand over the dropped backpack, snatching it up from the ground with one clawed hand. 'So nice of you to leave me a memento, and with your scent all over it.' He then takes a deep sniff of the bag. 'I bet that you have something important in here too,' he adds, tightening his grip till you hear something crunch.";
	say "     [bold type]What do you want to do now?[roman type][line break]";
	LineBreak;
	say "     ([link]Y[as]y[end link]) - Take that demon down a peg!";
	say "     ([link]N[as]n[end link]) - Duck behind the car. Maybe he'll be too focused on the Labrador to care about you.";
	if player consents:
		LineBreak;
		say "     As you step from behind the car, the demon turns his attention to you and gives a malevolent smile. 'Fresh meat!' he growls amusedly, then throws the backpack straight at your head! You barely have time to duck, letting it sail past and smack against the wall of a building, landing in a crash afterwards. The demon moves in right behind his improvised projectile, ready to claw you to pieces.";
		challenge "Demon Brute";
		if fightoutcome < 20: [player won]
			say "     After another hard blow, the demon stumbles back and keels over, then turns into purple mist that wafts away, even though there is no breeze at all right now. You shrug at the creature making a getaway and turn back to the backpack. It is lying in a small, wet puddle, clearly made from whatever is leaking out of it. Carefully peeling the bag open, you find some soaked clothing, as well as several bottles of clean water, with the ones made from glass broken and several plastic ones punctured and leaking. Just one single bottle has survived intact, which you quickly add to your own backpack. Further down in the soggy pile are crackers (mushy), a few cans (punctured by demon claws and leaky), as well as more clothes, a few batteries, a now bent flashlight, as well as other small items. Seems like this was a carefully packed bug-out bag before getting the demon treatment.";
			say "     Since it is 'only' clean water that drenched the backpack, you have little further hesitation from opening the front zippers of the bag and sliding your hand into the flat pockets there. The first thing that you feel is a piece of wet paper - a photograph, from the looks of it. Looks fairly well-worn, as if often held in someone's hands. There are two young men on it, one with his arm laid around the other one's shoulders and both of them grinning wildly at the camera. Also in the pocket is the wallet and a key-chain of who you assume must have been the Labrador. Apparently, his name is 'Luther Hanks', and he's nineteen. The final two objects in the bag are small clear cases holding two compact video cassettes. The plastic has protected them from water damage, meaning that you can read the labels easily: 'Wayne's secret tape 1. 11/02/2007. For Luth's eyes only!' and 'Wayne's secret tape 2. 12/30/2007. For Luth's eyes only!'";
			say "     [bold type]The clothes and other stuff are soaked with water and whatever is leaking from the cans. Those won't be much use now. As for the rest...[roman type][line break]";
			LineBreak;
			say "     ([link]Y[as]y[end link]) - Keep a hold of it all.";
			say "     ([link]N[as]n[end link]) - Discard this stuff.";
			if player consents:
				LineBreak;
				say "     With a small nod to yourself, you transfer the intact items to your own pack, sliding the photograph into a pocket, together with the wallet, keys, and the tapes. Who knows, maybe it'd be interesting to find out what is on them. You just need a working camera to play them. For now, you're happy with the free bottle of clean water - that should serve as payment for saving Luther's stuff, if you run into him again.";
				LineBreak;
				say "[bold type]You gain 1 water bottle![roman type][line break]";
				increase carried of water bottle by 1;
				LineBreak;
				say "[bold type]Wayne's Tape 1 has been added to your tape inventory![roman type][line break]";
				add "Wayne's Tape 1" to tapes of player;
				LineBreak;
				say "[bold type]Wayne's Tape 2 has been added to your tape inventory![roman type][line break]";
				add "Wayne's Tape 2" to tapes of player;
			else:
				LineBreak;
				say "     With a shrug, you drop the wallet, keys, and the tape on the ripped bag and start walking down the street. Hey, at least you got a free bottle of clean water out of it...";
				LineBreak;
				say "[bold type]You gain 1 water bottle![roman type][line break]";
				increase carried of water bottle by 1;
		else if fightoutcome > 19 and fightoutcome < 30: [lost]
			say "     The demon chuckles loudly and kicks your legs out from under you, then licks drops of blood from his claws. 'Pathetic mortal, you're not even worth my cum. No, I'll save it all up for when I catch that mutt. He might just burst after a fuck or two, hahaha.' With that said, the demon brute kicks you in the stomach, smiling with evil glee as you curl up in a ball of pain. Then he snatches up the backpack again, pulling items from it and smashing them on the ground. Eventually, just the shredded fabric of the backpack itself is left, which the demon raises to his face and sniffs again. 'You can run, but you can't escape me forever!' the demon shouts, then sets out to chase his intended victim down.";
		else if fightoutcome is 30: [fled]
			say "     Taking off at a run, you hear the roars and shouts of 'Fucking coward!' from the large demon, followed by many more curses and threats. Still, you manage to get away, leaving the purple beast in your dust.";
	else:
		LineBreak;
		say "     As you hide, the demon continues his shouts and mocking comments, followed by the sounds of ripping fabric and things being crushed. Peeking out from behind the car, you see him slowly stalking down the street, leaving behind a trail of the destroyed possessions of the young canine. Eventually, just the shredded fabric of the backpack itself is left, which the demon raises to his face and sniffs again. 'You can run, but you can't escape me forever!' the demon shouts, then sets out to chase his intended victim down.";
	now Demon Chase is resolved;

to say FamilyFunTape1:
	say "     You quickly slide the tape into the camera, pushing down on the side panel till it locks into place with a *Click*. Then you fold out the small screen of the device, looking at it expectantly as you press 'Play' next. Darkness fills the display, stretching out second after second, making you wonder for a tiny moment if you have a dud of a recording or the tape broke. But then, the picture moves suddenly, showing a crumpled blanket stretched out in the soft light of an early morning. Seems like the recording camera had been lying on a bed. The view is jostled about a little bit, showing glimpses of what is clearly a young man's bedroom, until it stabilizes at a viewpoint of just about head height. The person holding the camera is revealed a second later, as he aims it at the mirror doors of his wardrobe.";
	say "     Slender and tall, the young man stands in front of the mirror in nothing but a pair of tight black trunks, revealing his body with a smirk. He pans the camera down, then up again, showing a lot of bare skin and the yet soft, sparse down of body hair brought by reaching adulthood. Ending at a grinning face framed by shoulder-length, brown hair, the guy says, 'Hey, Luther, it's Wayne. Obviously, hah! Hope you liked the little show. But that's not the only thing you are gonna get today. Since you'd never believe me if I just told you, I'm gonna prove that I really am brave enough to go for it.' He chuckles a little and wiggles his eyebrows, then turns to the door and walks out of the room into a hallway. Partially lit by low rays of sunlight, it stretches out for maybe twenty feet, with two side doors on the left, a railing and stairway down on the right, and a leaned-to door all the way at the end.";
	WaitLineBreak;
	say "     'It's just past six AM, sunrise having been a moment ago,' the whispered voice of Wayne tells you as he moves forward with quick, but almost silent, steps of his naked feet on the carpeted floor. You can see his hand reach out and give the door a light push, sending it swinging open slowly. 'Good thing that I oiled those hinges last week, eh?' comes the young man's next whisper, followed by him stepping into the room beyond. It is another bedroom, with a large double bed inside, occupied by a single person. A man is stretched out on his back, dozing peacefully. It isn't hard to spot the family resemblance of this guy and Wayne himself - similar features, partially hidden by a short beard, and the sleeping guy's hair show a few silver streaks. Only a few years past his prime, he is muscular and quite manly, also shown by the small tent of his morning wood standing up straight underneath the thin blanket.";
	say "     'Wait till you see it,' Wayne adds, his breathing audible as he put his mouth just above the microphone for an even quieter whisper. There is a little bit more jostling and a soft clatter as he puts the camera down on a dresser or something, aiming it at the bed. Coming into view a second later, the almost naked young man goes over to his father's bed and slowly lifts the blanket at one edge, sliding it off of the sleeping man. It doesn't take long before he reveals that the guy is naked, his erection standing straight up in plain sight, with nothing else to block your view. Glancing over to the camera, Wayne gives a thumbs-up, followed by holding his hand besides the cock that made him. It is a little longer than the palm plus stretched-out fingers, about eight or nine inches by your guess. And then, the young man slowly closes his fingers around the erect shaft.";
	WaitLineBreak;
	say "     Wayne holds his father's prick gently in his hand, glancing to the man to check if he is still asleep, then slowly starts to jerk it. Up and down he slides his fingers, making the loose foreskin roll over the dickhead in his grasp, then off again in almost hypnotic slowness. And then, he leans forward and gives the older man's dickhead a lick. Documented on the tape, you see how the fondling and jerking escalates to him starting to give his father a blowjob - still slow at first, but then with more and more enthusiasm as he seems to forget just where and with whom he is doing this. Even the deepest sleeper is not going to doze through something like [italic type]that[roman type], and you are not surprised to see the man stirring before much longer, followed by a groan and the words, 'What the fuck do you think you're doing, son?'";
	say "     Literally caught in the act, Wayne lets the dickhead slip out from between his lips and meets the eyes of the older man. 'I - um,' he stammers and looks down, right at the glistening, wet cock before his face. He clearly doesn't have any words to reply with, so he puts his lips over the erection instead and pushes down on it, deep-throating the large cock in one go. 'Nnnghh,' the half-sleep-drunk man on the bed grunts out in lust, followed by the exclamation, 'Damn, that's good!' He trembles in involuntary muscle twitches as his son inhales his cock, moving one hand to cup and grope his balls at the same time. Wayne goes on an all-out offensive, burying his nose in the pubes of his father as he takes him all the way, then bobbing up and down in a rapid tempo. By the time the older man has gotten control of himself and sat up, he's already been blown for several moments, fully awakening not only him, but also his basic urges.";
	WaitLineBreak;
	say "     'Well, fuck. You're good at that, son!' he grunts, one hand moving to run its fingers through Wayne's long hair. At first, it is mostly a gentle pat, but then the more urgent impulses of his lust take over. Fingers curl to grasp the young man's head, and his second hand also joins in, until he is holding his son tight, then rams the boy's head down on his shaft with a lewd groan. Passive acceptance of the blowjob is replaced by taking control, unfolding into a harsh face-fuck of Wayne. The older man gets his legs under him to kneel on the bed now, towering over his offspring as he violates his son's mouth. Not that the young man complains against such treatment - at some point, he wrenches his trunks down with trembling hands and starts to jerk off frantically. Given the intensity of their pairing, it isn't a great wonder that Wayne's father reaches the point of no return before much longer, hammering his hips forward with his balls slapping the younger man's chin and grunting deeply as he starts to unload right down Wayne's throat.";
	say "     As spurt after spurt of creamy cum are shot right into his stomach, Wayne finishes himself off too, his cock spurting long strings of seed to soak the bed sheets. Grunts, moans, and gasps fill the master bedroom for a little while as the two of them ride out their respective orgasms, until things calm down a little eventually. Panting in exhaustion, the older man pulls his son's head off of his shaft with both hands and draws him up from where he was on all fours. Looking him right in the eyes, tension rises as the man hesitates for long moment, before he suddenly kisses Wayne on the lips and says, 'That was, without a doubt, the best blowjob I've ever gotten. I - we - will talk about this later. But for now, let your old man sleep for god's sake!' Letting out a sigh of relief, Wayne chuckles and smiles at his father, then replies, 'Sure thing, dad, see ya later.' He gets his hair ruffled, along with another kiss to follow, then gets up from the bed and snatches up his briefs and the camera before hurrying out of the room.";
	WaitLineBreak;
	say "     You can't make out much for several moments, basically just the naked chest of the adventurous young man as he hides the camera from view and quickly leaves, closing the door behind himself with a click. He goes back to his own bedroom before turning the device around and looking straight at it to say, 'Fuck. That was... something else. He never woke up before. But then, I guess I've gotten too used to blowing you, Luth. Really wanted to taste him. Can't wait to show you this tape, provided I survive that 'talk' later on. Not that I worry too much about that - not after the reaction he had. But for now, Wayne out!' After that, the tape shows nothing but static, so you eventually rewind and eject it, putting it back into your tape collection.";

to say FamilyFunTape2:
	say "     You quickly slide the tape into the camera, pushing down on the side panel till it locks into place with a *Click*. Then you fold out the small screen of the device, looking at it expectantly as you press 'Play' next. Darkness fills the display, stretching out second after second, making you wonder for a tiny moment if you have a dud of a recording or the tape broke. But then, a grinning human face appears on the screen. It is a young man with shoulder-length, brown hair and a soft fuzz of a beard covering his fairly handsome face. 'Hey, Luth, it's Wayne again with another surprise video since you liked the last one so much. I don't have to tell you that things got... quite interesting here at home after the last time. Hell, you've tasted dad's cum on my lips a few times when we met to go to class together!' The young guy wiggles his eyebrows suggestively and runs the tip of his tongue over his lips in a seductive manner.";
	say "     He tilts the camera downwards next, giving you a long pan over his slender and tall body standing bare-ass naked in the middle of what must be his bedroom. Some curls of chest hair come into view first on the young adult, still pretty lightly dusted on his abs and forming a cute and sexy trail down towards his belly-button, then leading over to the bush of his pubes. Stopping at a fully erect cock, the camera shot shows him taking hold of his member, slowly pumping its length up and down a few times until a drop of pre forms at the cum-slit. Wayne wipes it off with his index finger, then raises his hand while following it up with the camera, until the edge of his tongue enters the picture. Licking the precum off, he smacks his lips and grins.";
	WaitLineBreak;
	say "     'Guess what I spent my Christmas money on and what has kept me busy the whole last week while you've been on the east coast visiting your grandparents. It sure had me thinking of your teasing fingers a lot, Luther!' With that said, Wayne tilts the view of the camera downwards again, aiming it at his bedside table this time. There is a bright-yellow-orange dildo there, standing upright through the help of a sucker on the underside. Interestingly, it isn't human in shape but looks rather reptilian in your opinion, with a tapering tip and little ridges all along the shaft, ending in a darker-red base that is sculpted to look like a dragon's genital slit with scales all around. 'Horny Dragon delivers surprisingly quickly. I had been worrying that it might take a while and that your Christmas tape gift wouldn't be ready before you come back, but... they came through.' He reaches out to pluck the sex toy from where it was and holds it up, showing that it is just a little longer than the width of his palm.";
	say "     'I've been training with this bad boy for the last few days. Can't wait to feel you inside of me too. But before that... you know whom I want to take my cherry,' Wayne says in a very eager tone and glances towards the door of his room before he adds, 'So, I hope this works out. And this way, you'll be right there with us to see it happen!' The young man sets the camera down on what must be a shelf or something, looking into it and adjusting the angle a little, before he then picks up a t-shirt from the bed and drapes it over the camera. After a few tucks and corrections, its view is unobstructed again. Stepping back, the young man focuses right into the camera and shows a thumbs up, then turns and bends forward, showing off his ass to you as he picks up a bottle of lube from under the bed.";
	WaitLineBreak;
	say "     Kneeling at the very edge of the bed, Wayne squirts a good dollop of lube on his draconic dildo, spreading that well over the rubbery shaft before aligning it with his rear end. You can hear some small moans of anticipation from the young guy, then he pushes in, popping the tapering dick-head past his pucker. With a pleased groan, he sinks the sex toy into his own ass, slowly working it back and forth. At some point, he pulls the dildo back out and allows the camera to capture the pink star of his asshole winking open and shut as it almost seems to be [']missing['] the rubbery shaft. After pushing his little friend back inside soon after, the young man stands up and gives the camera a wink, then puts on a pair of roomy boxer shorts that only barely hide the state of his arousal. 'Dad? Could you come help me with something please?' Wayne calls out loudly next and sits on the bed.";
	say "     It doesn't take all that long before a full-grown man appears at the door, walking into the room and saying, 'What's up, son?' It isn't hard to spot the family resemblance of this guy and Wayne himself - similar features, partially hidden by a short beard, and the new guy's hair show a few silver streaks. Only a few years past his prime, he is muscular and quite manly, also shown by the square shape of his jaw and the quite confident way he holds himself. The man takes seeing his offspring in his underwear in stride, the only visible reaction being that his eyebrows rise a little bit and a hint of a grin that passes over his lips. 'I wanted to ask you something,' Wayne begins and pats the edge of the bed next to him, drawing the older male in to sit beside him.";
	WaitLineBreak;
	say "     'You know how you've told me that I can come to you for anything I need? I got a... spot that's itching, a lot, and I thought that maybe you could take a look?' the young man tells his father, whose eyebrows rise, then pull together in concern. Immediately, Wayne's father replies, 'Of course! We're family, so I'll be there for you, even if it is something embarrassing. Just -' Even as he says this, the young man leans back and rolls over on the bed so that he is now stretched out on it face-down. Then he pushes his shorts down with both hands, revealing his bare butt, and the dildo still stuck up his rear end to his dad. 'Oh!' comes the matter of fact reply from the older male, looking at the unexpected sight. He slowly reaches out to touch the rubbery sex toy, fingers slowly closing around the base and pulling on it. Inch by inch, he withdraws the dildo from a lowly moaning Wayne, until he holds the yellow-orange toy in his hand.";
	say "     Twisting around a little to look over his shoulder, Wayne smiles as he sees his father stare at his hole, its pink opening presenting itself quite wet and inviting. Almost spellbound, the man puts the dildo down on the bed and reaches out with his hand again, brushing a finger over the back door of his son now. Groaning in pleasure at that first touch, Wayne raises his ass a little bit more and pushes back, which causes the exploring digit to sink partially into him. For a little while, no more words are spoken as the older family member finds himself exploring his son's back passage with one finger, clearly intrigued by the pleased sounds and motions that Wayne does in response. 'Yeah, it's there. Just a bit... deeper. Can you help me with that itch, dad? Please?' the young man pleads, and his father buries the whole length of his index finger in him, apparently wiggling it inside.";
	WaitLineBreak;
	say "     'It's still too short. Could you maybe use something a bit... longer? Please, dad, I need it!' Wayne pants out, clearly aroused by being fingered, but wanting more - much more. The older male can't help but move one hand to his own pants, having to adjust the growing bulge there as he clearly understands what his son is alluding to. 'You sure about that, kiddo? I mean, what we've been doing in the mornings is one thing, but this...' Wayne sits up at that moment, now kneeling on the bed and still with a finger up his butt, then half-turns to put his hands on the shoulders of the other man. Looking deep in his father's eyes, he says, 'Dad, I trust you without limits. I love you, and that's why I want you to be my first. Now, come on. Fuck me!' The last words are said in a teasing and eager tone, followed by a kiss between the two guys.";
	say "     That was the last little push that Wayne's father needed. The man stands up eagerly, sliding his t-shirt off of a broad-shouldered chest and throwing it aside. Kicking off his flannel pants and briefs right afterwards, the man reveals himself as a more muscular and hairier version of Wayne himself, complete with a respectably-sized cock erect between his legs. The man steps up behind his son as Wayne kneels at the edge of the bed, his ass raised high. Lining himself up with the young man's asshole, the mature hunk presses forward without any further delay, grunting in lust as he sinks into his son. 'Damn, that's one sweet ass. Tighter than any pussy I've ever had!' he says in a happy, somewhat breathless tone. At the same time, Wayne is murmuring under his breath, 'Fuck that's big. Good that I used a lot of lube.'";
	WaitLineBreak;
	say "     The two of them go through a few moments of gentle experimentation, between Wayne flexing his anal muscles and his father trying out slow thrusts and grinding against the younger man's ass - but that doesn't last long. Soon, the older man gets bolder - pulling out further and further and ramming himself home again, each thrust answered by a needy moan from his son. 'You like that, kiddo, don't you?' he asks in a demanding tone, and Wayne simply gives a lewd groan in reply. Laughing out loud, his father stops holding back at all after that, really starting to pound into Wayne. The bedroom of the young man is filled by grunts and moans, with the rhythmic sounds of balls slapping against Wayne's ass to accompany them. At the same time, the newly initiated bottom jerks himself off with frantic motions, taken on a roller-coaster of sensations by feeling the first real dick in his ass.";
	say "     It doesn't take much longer before Wayne lets out an urgent groan of, 'Dad, I'm gonna... gonna... cuuuMMMM!' He bucks his ass against the dominant male standing behind him, whole body trembling as a respectable load shoots through his cock to put white streaks all over his bedsheets. At the same time, the young man's inner muscles clench tight around the invading prick in his ass, really turning up the heat for the senior family member too. 'Yeah! Take it, you little slut!' Wayne's father shouts in an urgent tone just a few seconds later, hammering himself balls-deep as he begins to unload into the eighteen year old. From the position of the camera in the shelf, you actually see quite well between his legs, balls throbbing with each spurt of creamy cum that paints Wayne's insides white.";
	WaitLineBreak;
	say "     Staying pressed together like that for a little while, the father pulls his son's chest up to hug him from behind, then stretches his neck to kiss Wayne. 'That was intense,' he says in a very satisfied tone. 'I hope that you know that I'll want to tap this sweet ass more from now on? Would be a crime to not use such a fucking amazing boy-pussy!' Wayne chuckles, sticking out his tongue and meeting his father for a french kiss, then moans, 'Counting on it, dad!' The two of them hug and kiss for some more time before Wayne's father eventually pulls out and collects his clothes. Still naked, the man stops at the door and turns back to look at his son. 'I'll make breakfast in a little bit. Wear your jockstrap, then I'll bend you over the counter for round two!' And with that, he exits the room.";
	say "     Wayne stays lying on the bed for a little while, laughing happily in between panting breaths, then eventually sits up and looks right at the camera. 'So, Luth, this was my first time. With more to come, I guess. Hope you enjoyed the show. Can't wait to try this out with you too...' Grinning, the naked young man stands up and goes to turn off the recording after that.";

Intercepted Bike Courier is a situation.
The sarea of Intercepted Bike Courier is "Outside".

when play begins:
	add Intercepted Bike Courier to badspots of Feral;

instead of resolving a Intercepted Bike Courier:
	say "     As you wander the streets of the inner city, avoiding all sorts of roaming creatures and skirting around piles of trash and some burned-out cars, you come upon a dented bicycle. The front wheel is twisted into more or less a figure-eight shape, and ripped articles of clothing are scattered in front and on top of it. All of that isn't really extraordinary, but a feeling draws you in nonetheless, so you have a closer look: pulling aside a t-shirt crusty with dried cum reveals a bright red backpack lying on the bike, with the logo of the 'Flash Delivery' bike courier company emblazoned on its front. Looks like whatever creature got the courier was too busy fucking him to care one bit about his delivery pouch. With rising curiosity, you undo the zipper and rifle through the pack, finding an energy bar, a bottle of energy drink and a manila envelope inside.";
	LineBreak;
	say "[bold type]You gain 1 food![roman type][line break]";
	increase carried of food by 1;
	LineBreak;
	say "[bold type]You gain 1 soda bottle![roman type][line break]";
	increase carried of soda by 1;
	say "     The food and drink are quickly stuffed into your own pack, leaving the envelope. It is addressed to Olivia Koenig, at Liberty Avenue 69, with the clear instruction of 'Personal Delivery ONLY' penned in neat handwriting on it. From the feel of it, there is something more than paper inside the envelope. Might be a video cassette?";
	say "     [bold type]Do you want to open it and find out what might be inside?[roman type][line break]";
	LineBreak;
	say "     ([link]Y[as]y[end link]) - Sure! Who doesn't like to inspect a mystery package...";
	say "     ([link]N[as]n[end link]) - Just toss it.";
	if player consents:
		LineBreak;
		say "     Curiosity is stronger than any hesitation at opening other person's private mail, so you rip open the envelope with little further delay, shaking out a small video cassette and a folded piece of paper. The contents of the letter are:";
		say "     'Dear Ms. Koenig, as instructed I have followed your husband on his 'suspiciously long' trips to walk your dog. After two weeks of observation, I can honestly tell you that your fear that he might have an affair with another woman seems to be unfounded and he actually did spend all of the time hiking with the German shepherd. Clearly, Mr. Koenig is exceptionally fond of the animal, up to and including some unexpected acts performed between the two of them. I included the relevant tape in the envelope. Please do let me know how you want to proceed in this matter. Sincerely, R. Timmons, PI.'";
		LineBreak;
		say "[bold type]Francis Koenig Observation Video has been added to your tape inventory![roman type][line break]";
		add "Francis Koenig Observation Video" to tapes of player;
	else:
		LineBreak;
		say "     With a shrug, you drop the envelope on the ground and continue on your path.";
	now Intercepted Bike Courier is resolved;

to say HikingObservationVid:
	say "     You quickly slide the tape into the camera, pushing down on the side panel till it locks into place with a *Click*. Then you fold out the small screen of the device, looking at it expectantly as you press 'Play' next. The bright green of growing leaves on a warm sunny day greets you on the display, showing a scene that seems to belong on one of the hiking trails through the city's hinterland. Then a tanned hand reaches out into the frame, bending a branch aside to free the view, and the camera zooms at a location in the intermediate distance. A grassy meadow off-track from any trail comes into focus, and in it a fit twenty-something man, together with a pure-bred German shepherd dog excitedly fetching a tennis ball as it gets thrown several times. Fairly soon, this play-time leads over to the man pulling his backpack off his shoulders, removing a large picnic blanket from it and spreading it on the ground, with the dog barking happily and beating his tail wildly as he sees that happen.";
	say "     The next thing that happens is that the man pulls off his t-shirt, followed by the hiking boots, pants and then his underwear, leaving him fully nude next to the eager canine. He is smiling happily at his feral companion, crouching down to stroke the dog's shining fur and pulls his furry head close to kiss his muzzle. After making out with the animal for a little while, the man gets on all fours and applies lube to his ass, drawing a whisper of 'That's one kinky fucker' from the cameraman. Smiling over his shoulder, the man calls out a command to his German shepherd, which has the animal move in and start to lick his ass, soon followed by jumping up to mount his human master. You catch a flash of his bright red canine shaft as it spears into the man, being received with an ecstatic groan from the dog's owner.";
	WaitLineBreak;
	say "     Observing the pairing of man and beast in the meadow, you can easily tell that those two have a lot of experience doing this. It is obvious in the sure aim of the dog, the ecstatic expression of his owner and the way the animal keeps obeying commands even while having his dick sheathed in the human, lapping his master's sweaty back as he is told to pause once or twice. The man jerks himself off while letting his canine companion fuck him, then eventually calls out a command that seems to release all bounds from the furry beast. With a loud bark, the proud German shepherd just goes wild humping his mate, even clamping his teeth lightly on the back of the man's neck as he starts to buck against his ass, apparently breeding the man's clenching hole with his canine seed. The human isn't far behind either, jerking off frantically to join his feral mate in climax until he sprays his cum all over the blanket under them.";
	say "     The next fifteen minutes or so on the tape are filled with the man and animal entwined in the doggy style pose, with the German shepherd's side being petted and stroked by the knotted man, and the two of them sharing some licks. The fact that the animal doesn't try at all to dismount and go ass to ass with his partner is an additional indicator that this dog is well-trained in coupling with his human master. Only after some more time, apparently enough for the knot to go down, does the dog eventually pull out, immediately pushing his muzzle between the man's buttocks to lap up what cum leaks out of him. Then he is embraced by the man and drawn into another bout of making out with his human mate, followed by the two of them lying on the blanket and cuddling. The tape ends a little while later.";

Abandoned Uniform is a situation.
The sarea of Abandoned Uniform is "Outside".

instead of resolving a Abandoned Uniform:
	say "     Walking through the chaotic streets of the inner city, you are forced to keep an eye out for horny and aggressive creatures all around. At any time, an attack might come from the front, the sides, behind you, or even from above, given that there are flying infected around. All of this results in your attention being elsewhere as you pass one unassuming section of sidewalk and almost slip on a few shell casings scattered on the ground. Catching yourself on a street lantern, you look down and see that someone got off several shots, with more casings forming a little trail towards a nearby alley. Curiosity bids you to follow it, and just a few steps into the alley, you find something left behind the person who must have been the shooter: a shredded police uniform lies on the ground there, still bearing the nametag of 'L. Nielson'. Thankfully, it is free from blood-stains and appears to have simply been ripped apart by explosive growth its wearer went through.";
	say "     A dried puddle of cum on the ground allows a guess of a fairly typical sex-driven transformation, though who or what might have gotten the man is still a mystery. Or maybe not - as poking around a little reveals the shattered pieces of a bodycam. Looks like someone stepped on it, breaking the little device, but the little box its cables lead to is still clipped to the torn belt, holding a video tape, most likely filled with evidence of the last moments the cop spent as a human. Maybe it'll be an interesting thing to watch sometime, so you push the eject button and stuff the tape into your pocket.";
	LineBreak;
	say "[bold type]'Bodycam Tape - L. Nielson' has been added to your tape inventory![roman type][line break]";
	add "Bodycam Tape - L. Nielson" to tapes of player;
	now Abandoned Uniform is resolved;

to say BodycamTape_Nielson:
	say "     You quickly slide the tape into the camera, pushing down on the side panel till it locks into place with a *Click*. Then you fold out the small screen of the device, looking at it expectantly as you press 'Play' next. The first image visible is that of a sun-lit sidewalk, which Officer Nielson is walking along at a steady pace, looking left and right a little as he passes stores and people. A fair few of them greet him by name and wish him a good morning. Looks like he was a beat cop in that neighborhood, and a well-liked one too. As the man turns to go into a store, you pause the tape for a second and check out his reflection in the glass door: he was a fit guy, late twenties it seems, and good-looking in a mustachioed kind of way. The next minute or so shows him receiving a donut and cup of coffee on the house, thanking the owner for it and then starting to continue his way with both items in his hands.";
	say "     Just as Officer Nielson steps out of the store, an amused, somewhat teasing voice says from off-screen, 'Now isn't that typical! Les, how are we ever gonna get rid of the stereotype if you're parading down the street with a donut in hand!' Turning the other way, your cop brings a female colleague into his line of sight. The attractive woman has red hair and is smiling at him as she walks up quickly, barely giving you the time to pause the vid once more and read her nametag: 'A. Friedrich' She snatches half of the donut right out of your cop's hand, grinning at him over her as she keeps going and takes a bite. 'Hey Alexandra, that was mine!' he complains in a good-natured tone and gets a half-joked reply of, 'I'm just saving you from yourself. Can't catch any thieves when you go fat from too many donuts, Les! Have a nice day and see ya at lunch.'";
	WaitLineBreak;
	say "     The second beat cop's route takes her down a different street than Officer Nielson, leaving him to stroll along, sipping his coffee and eating the remnant of his donut. A fair bit of relatively boring patrolling follows, with the guy checking up on this or that store, chatting with all sorts of people, until he eventually gets a radio call from dispatch: 'Leslie, we got a report of some sort of disturbance on 5th street. The caller sounded totally out of their mind, something about a monster tearing up cars. Have a look and watch out for yourself, alright?' 'Roger,' Officer Nielson replies, and you can hear a little clicking sound, maybe from him undoing the catch of his holster. Hurrying in the indicated direction, he soon comes into earshot for the sounds of breaking glass and twisting metal. Rounding the next corner at a sprint, he literally stumbles to a halt at the scene presenting itself there.";
	say "     A towering minotaur is standing in the middle of the street next to a standing car, her bulky form looking somewhat ridiculous stuffed into a red dress ready to burst. Long blond hair hangs down from her horned head, and she is holding the driver's side door of the car that she ripped from its chassis. 'I'll teach you to honk at me, you freaking asshole,' the furious woman shouts at the top of her lungs, then gores the top of the car with one of her curved horns. Screaming in fear for his life, the driver half-crawls, half-falls out the passenger door of the car, then jumps up and runs in panic. The enraged minotaur seems about ready to run him down, when a warning shot into the air draws her attention to the cop whose viewpoint you are seeing. 'Don't move! I'll shoot!' the man shouts a command, still aiming at her while loudly saying into his radio, 'It really IS a monster! A frigging minotaur!'";
	WaitLineBreak;
	say "     Hearing herself being referred as a monster only fuels the minotaur's rage even more, and she bellows, 'No I'm not you bastard! I'm Kelly Richardson, soon to be a famous news reporter!' Stomping a hoof down hard enough to make the street shake, she focuses her gaze on Officer Nielson and growls, 'I'll show you!' A step towards him draws a shot from the cop, apparently aimed to only wound or incapacitate and giving her thigh a deep graze. Given the powerful regenerative powers the nanites give their hosts, you know that this is far from enough to make a minotaur even pause, and Kelly reacts with a full-out charge, holding the car door as a shield before her head and chest and storming towards Officer Nielson. He curses and retreats, firing bullet after bullet, leaving his gun empty by the time he reaches the alley you found his uniform in.";
	say "     Having to throw himself to the ground to duck the car door being flung at him, the camera records just a jumble of movement and the view of asphalt for a few seconds, then your cop turns around and sees Kelly standing over him. 'I could just stomp you to paste, little man!' the bitchy minotaur tells him, staring down in disdain, yet as she bends forward to stare at him with hostile intent, her nostrils flare wide as she registers a new scent. 'But you smell nice. Like a real man, nothing like that loser Carter. And I deserve a proper guy for once, not a wimp!' In an almost mind-boggling mood-swing, her anger is instantly replaced by lust, with Kelly using a large hand to push the officer's chest down, her other hand tearing away the fabric covering his crotch. 'What are you doing? Let go of me!' Officer Nielson gasps out and tries to push his chest up, but Kelly keeps him firmly pinned to the ground.";
	WaitLineBreak;
	say "     From his position on his back, you can't really make out much of what is happening, but you see the curved horns of the minotaur poke into view a few times. Seems like she's bending her head down, and the barely suppressed moan coming next from the cop tells you that she must be going down on him or something. His attempts to stop her quickly die down as the man can't help but let out moans and grunts, soon leading to Kelly's head coming back into view, with her looking down at Officer Nielson like a piece of meat. 'Knew you'd man up with a little encouragement. Get ready for the fuck of your life, you sexy hunk!' And with that, she stands up over him, ripping away the red dress and baring her naked minotaur form. She has a fair bit of muscular bulk, as well as full breasts and a wet and dripping pussy under a bush of pubic fur. A hungry look fills her eyes as Kelly simply mounts her captive, holding his dick up to slide it into her snatch.";
	say "     'Damn. What the fuck did I get myself into,' Leslie Nielson gasps under his breath as the nonhuman woman grinds against his stretched-out form, using him like an overgrown sex toy. She rocks back and forth, always using one hand to keep him pinned down while fucking herself on his shaft - until she suddenly switches gears and says, 'Don't just lie there like a sad sack. Lick my breasts and worship me!' Before he knows what is going on, she has wrenched him upwards against her chest, his head wedged between the breasts you can see curve at the edge of the camera's viewpoint. You can only make out impressions of what comes next, as most of what is on screen is blond fur and the curve of Kelly's breasts, moving back and forth as she grinds down on her captive and he is drawn into servicing her. As their coupling continues, you notice some changes in his hands and arms when they are visible, with the fabric of his uniform shirt starting to strain against the increasing bulk of his limbs.";
	WaitLineBreak;
	say "     The sounds of sex caught on tape build quickly as things get more and more intense, until Kelly lets out a lust-filled howl, shoving her partner away from her body as she is pushed to an orgasm. 'Fucking yes! That dick is a treasure! Just what I needed!' she shouts, grinning broadly to herself as she continues to rock back and forth. She pays no mind at all to the man writhing beneath her, being bathed in the copious femcum she leaks onto his crotch - which seems to push his transformation into overdrive. A pained groan escapes his lips, coupled with the crunching noises of reforming bone and flesh. Officer Nielson reaches up with an arm that splits the police shirt, black fur spilling out, and grunts, 'My head's killing me. Oh no, what's this?!'";
	say "     The man's now much broader and more furry hand comes into sight at the top of the screen, pulling on a horn it holds in its grasp. Realizing it is now part of him, the newly made minotaur stops trying to pull the horn off his head and pushes himself up to look at his own body. He looks at the muscle-packed arms and bulky frame of his chest in shock, feeling around as if to make sure that it really is him. 'I - I'm a minotaur!' he finally admits to himself in a baffled tone. 'Hm? You are what?' Kelly says, finally looking down at her captive as she is shaken out of her self-indulgent focus on her own orgasm before all else. 'Oh, interesting. Maybe I won't be just a reporter after all. 'Queen of the Minotaurs' has a nice ring to it! And you can be my first sex slave! What's your name anyways?'";
	WaitLineBreak;
	say "     Clearly enraged by her pompous and cold-hearted proclamation, the transformed policeman roars, 'I'm Officer Leslie Nielson of the Metropolitan Police Force! You've got another thing coming, you bitch, if you think I'll do anything for you after you've stolen my humanity. Get off me, you whore!' He bucks up against her and shoves the blonde minotaur off his body, leading to a struggle between the two of them, in the course of which his ripped clothes are shaken off his form, sending the bodycam tumbling to the ground. You catch a few more glimpses of them struggling from a tilted angle on the alley ground, mostly seeing Kelly's tree-trunk like legs and her pussy gushing some of the cop's apparently quite voluminous load of cum. And that is the last image on the tape too, as she steps onto the camera with a heavy hoof a second later.";


Abandoned Pizza Delivery Car is a situation.
The sarea of Abandoned Pizza Delivery Car is "Outside".

instead of resolving a Pizza Delivery Car:
	say "     Exploring the city, you come upon an abandoned pizza delivery car. The small red machine bears the logo of 'Tony's Pizza Shop' and is just large enough to hold one person, with a small heated compartment behind the driver for the food to be delivered. On the odd chance that there might be anything left inside, you search the vehicle, but sadly do not come across any food or drink items. What you find instead is a small dash-cam set up under the windshield, complete with a tape inside that seems to have run till its end. Curiosity demands that you take the video tape out and put it into your pack. Maybe there'll be something interesting to see on it?";
	LineBreak;
	say "[bold type]'Pizza Delivery Dash Cam Vid' has been added to your tape inventory![roman type][line break]";
	add "Pizza Delivery Dash Cam Vid" to tapes of player;
	now Abandoned Pizza Delivery Car is resolved;

to say PizzaCarDashcamVid:
	say "     You quickly slide the tape into the camera, pushing down on the side panel till it locks into place with a *Click*. Then you fold out the small screen of the device, looking at it expectantly as you press 'Play' next. The video starts with the view of a night-time parking lot, from which the driver sets out. You catch a glimpse of a glowing sign reading 'Tony's Pizza Shop', then the car is on the road, moving through the inner city. The new few minutes are fairly boring, nothing more than a little bit of traffic footage, until the delivery guy arrives at a private home and parks at the start of its driveway. The image shakes a little as he gets out and closes the car door, then grabs a pizza from the back. A moment later, you get the first glimpse of the pizza boy: he is a relatively tall and slender guy, with a goatee and shoulder-length hair.";
	say "     Ringing the doorbell, the young man stands around a minute or two, waiting. Then suddenly, a person opens the door: an anthro female cougar, dressed in nothing more than a semitransparent negligee. This video clearly is from right at the start of the nanite outbreak, as the pizza boy reacts with obvious shock to her looks, dropping the pizza box and turning to run to his car. He doesn't have any chance though, as the feline customer easily catches up with him and brings him down with a pounce on his back. The two of them go down on the front lawn of the house, with the delivery guy weakly struggling against the feline woman as she grinds against him a little and fondles him all over. Moments later, she's rolled him over onto his back, and is wrenching down his pants and undies, despite everything he tries to do against it. Held down by the apparently quite strong cougar, the bewildered young man finds his cock grasped by her and jerked with impatient haste.";
	WaitLineBreak;
	say "     As soon as the pizza guy gets hard, his sexually aggressive customer swings one leg over his hips, then impales herself on his shaft and rides him with very enthusiastic grinding movements of her hips. After a few more moments of flopping around, trying to push off or wiggle out under the inescapably direct woman, he eventually gives into having sex with her. You can see his hips starting to move, humping up against the feline in a rapid pace. He clearly enjoys fucking her, now that he seems to have pushed the small detail that he's being forced to out of his mind, and reaches out to grope her swaying breasts, pinching their nipples and finding himself pleasantly surprised as she starts to leak some milk. An eye-blink later, the young man has pulled the negligee off her upper body and thrown it aside, then starts to eagerly suckle.";
	say "     The frantic mating between the horny customer and her captive pizza boy quickly builds up an explosive climax, with her orgasming and clenching tight around his cock, leading to him hammering himself home and filling her womb with his potent human seed. For a little while, they enjoy the bliss of their shared orgasms, but all too soon, the cougar simply pulls off her captive and grabs her negligee and the pizza box before she vanishes into the house. Coming back a minute later, the woman pushes some bills into the baffled young man's hand and then goes inside and closes the door behind her. The pizza boy stays stretched out on his back for a little while longer, then gets to his feet too. You catch the sight of some slowly spreading patches of fur on his inner thighs and crotch, just before he pulls his clothes back into position and gets back into the car.";
	WaitLineBreak;
	say "     Apparently moving on autopilot and as he tries to make sense of his nonhuman encounter, the delivery guy drives off towards his next destination. Five minutes or so later, he is in yet another driveway in the same general area of the city. As he gets out of the car with another pizza in hand, the front door opens without him even needing to ring the bell, showing a college girl in some cute shorts and a tight t-shirt. She waits with money in hand and smiles at the young man, clearly eager to receive her pizza. Yet when he is about to hand it over and both of their hands are on the box, he gives her something else - a compliment or a naughty offer maybe, as the college girl blushes and looks at him with raised eyebrows. Apparently she likes what she sees, as a beaming smile follows, with her waving him inside. The last thing you see of the pizza boy for a good twenty minutes is his backside, specifically the cougar tail now sticking up behind the waistband of his pants.";
	say "     When the delivery guy eventually emerges from the house again, you mainly recognize him by his clothes, as the physical transformation into a male anthro cougar has progressed to its conclusion in the meantime. He actually looks quite dashing as a feline cat, and the long hair and goatee fit very well to the overall look. The fact that he is no longer human doesn't seem to faze him, and the guy gets back into the car and drives off again. Seems like the next delivery is further off, as it takes a good ten minutes until... he actually stops on the way in a street that looks familiar to you. A short distance ahead on a sidewalk, you can see two young women walking along, looking quite flashy in glittery party dresses. They do provide a quite nice image, especially since they have very exotic looks - some sort of feathered dinosaur maybe?";
	WaitLineBreak;
	say "     Just stopping the car in the middle of the road, the pizza guy gets out and grabs the remaining stack of pizzas he has left, then strides up to the two girls and chats them up. They appear delighted at his appearance, happily reaching out to stroke his fur. Before long, all three of them are talking with one another, followed by them walking off together. The rest of the tape is filled with a view of the empty street, only interrupted by a few (still human) passersby who do nothing but hurry past with somewhat distraught expressions on their faces.";


Dressing Room Spycam is a situation.
The sarea of Dressing Room Spycam is "High".

instead of resolving a Dressing Room Spycam:
	say "     Checking out one of the more upscale boutiques that dot the streets of the High Rise District, you find yourself standing in the midst of empty clothing racks and displays. Apparently, someone had decided to clean out not only the little fridge for complimentary drinks and snacks, but also all of the designer garments. It's funny how people can prioritize the strangest things even in the midst of an apocalypse. Strolling through the empty shop, you see a few items left here or there, but they have all been stained or torn somehow. Just as you are about to leave, you spot something inside one of the dressing booths that catches your attention. The tiny, enclosed room is thoroughly splattered in dried cum, but the aftermath of a gang-bang isn't actually all that surprising these days. What is, on the other hand, is that one of the ceiling panels above has been opened, and you can see a camera that has been positioned up there.";
	say "     Looking up at the device, you see a fiber-optics attachment to its lens, suggesting that it was supposed to be hidden from sight - and likely would have remained that way if the panel to obscure it had been replaced. Curiosity pushes you to collect a few of the ruined garments from the rest of the store and throw them down on the sticky mess inside of the dressing room, allowing you to enter and climb up to reach the camera. Checking the small device out, you find that it doesn't respond to your inputs as you press the buttons on the sides. Only the spring-loaded eject button for the tape works, at least giving you access to what the camera recorded last. Apparently, it ran out of power after being left on for too long. Since there's no sign at any kind of loading cable, and electricity is hard to come by these days anyways, you discard the camera and just keep hold of the tape. Who knows, it might contain some explanation what happened here.";
	LineBreak;
	say "[bold type]'Dressing Room Spycam Vid' has been added to your tape inventory![roman type][line break]";
	add "Dressing Room Spycam Vid" to tapes of player;
	now Dressing Room Spycam is resolved;

to say DressingRoomSpycamVid:
	say "     You quickly slide the tape into the camera, pushing down on the side panel until it locks into place with a *Click*. Then you fold out the small screen of the device, pressing 'Play' and looking at it expectantly. The video starts with the face of a rather average guy looking right into the camera as he holds it in his hands. There is a look of concentration on his face as he seems to adjust something, followed by a satisfied smile. Shaky movement follows, with the camera mostly capturing tilted views of walls, a curtain, and the ceiling while the camera guy climbs onto the dressing room bench. Thankfully, he soon has opened up a ceiling panel and sets the camera down inside the suspended ceiling. After some close-up impressions of his fingers when he nudges the fiber optics cable to properly aim at the center of the dressing room, the guy starts to reach for the ceiling panel that he pushed aside earlier.";
	say "     Just as he's about to replace the panel, the curtain at the entrance of the booth is suddenly wrenched aside, revealing a beautiful woman in a tight black dress with a furious expression on her face. 'I knew it! You fucking pervert!' Frightened from being caught, the voyeur loses his balance and falls down, landing against the side wall of the booth with a loud thud. He hastily picks himself up again and tries to flee by pushing past the woman (who you'd wager is the store attendant). To your surprise, she proves quite strong for a relatively petite thirty-something woman, grabbing the guy by the arm and stopping him cold. 'Oh no you don't, asshole!' she growls at him, then adds, 'I'm sick and tired of fuckers like you!' Looking closely at the camera screen, you can see the muscles of her bicep flex and expand as the woman restrains the voyeur, his frantic attempts to wrench free doing little to weaken her grasp.";
	WaitLineBreak;
	say "     Things start to get interesting when, starting from an ancient-looking arm band on the woman's upper arm, the store worker's pale skin undergoes a rippling change. Within moments, her skin darkens to a deeply sun-bronzed hue - still human, but looking quite a bit tougher than it did before. At the same time, her build begins to change, becoming more muscular and broad shouldered, as well as a fair bit taller. Her captive stares in shock as she transforms right before his very eyes, and he stats to beg for her to let him go. The woman laughs harshly at his whimpering pleas and grabs the guy by the back of the neck with her still-growing hand. 'Hell no! I was just gonna call the cops on your sorry ass, but now I feel like punishing you myself would be even better!' With that, she reaches down to adjust a bulge in her dress, just at crotch height.";
	say "     'What the fuck! You're a man?!' the captive voyeur shouts, causing the mutant (who by now has grown to tower over him) to lift him off his feet and give him a bone-rattling shake. 'No, I'm not. I'm something better, you little pissant!' she replies, cupping a breast with her free hand, then reaching down to pull up her dress, revealing an impressively large uncut cock. 'Guys like you can only push women so far before we show you who the [']weak['] gender really is! Do you have any idea how much strength it takes and how painful it is to push out a baby from your body? Of course not!' The tall Amazonian woman shoves her captive against the wall face-first, pinning him down securely as she tears off his jeans. 'And you thought that you were so clever. [']Browsing['] while giving me more than obvious sidelong looks the whole time,' she adds, then spits into her hand and starts to spread the wetness along her erection.";
	WaitLineBreak;
	say "     'I finally got sick of it and faked getting [']busy['] at the computer to see what you would do, and right away, you rush to the dressing room closest to the female section, without as much as a single thing you want to try on.' She slaps her thick shaft noisily between his bare buttocks, drawing whimpers and burbling pleas to let him go from her captive. 'I don't think so! You have a lot to pay for, and your penance will start with this!' With that, the hermaphrodite thrusts into his ass, battering right past any hope of resistance from his too-tight ring. His shocked groan and her bellow of satisfaction meld into one sound of lust and arousal, and as the herm starts to fuck her captive, the noise attracts some attention. Soon, a young woman that looks about eighteen years old comes into view, stepping up to glance into the dressing room and immediately going wide-eyed at the scene unfolding before her. She turns to run away, but she's held back by the Amazonian woman reaching out and grabbing her by the arm.";
	say "     'Wait! Why don't you stay, sister?! I'm doing this for you, for all of us!' She then recounts what she caught the guy doing, which turns the mood of the newcomer from shock and confusion to righteous anger. 'You know what? You're right. Fuck this asshole harder! He deserves everything you got.' She underlines this by stepping up a little and giving the man a stinging slap on the buttocks. After a few more harsh thrusts, the Amazonian pauses with her cock balls deep inside of her captive, then turns her head to give the newcomer a salacious grin. 'You're a woman to my taste!' she says as she reaches out to slide her arm around the customer, drawing her into a long and lustful kiss that brings a blush to her cheeks.";
	WaitLineBreak;
	say "     As she makes out with the Amazonian, the younger woman's skin begins to thicken and darken until it's the same tanned hue as her newfound friend. She gradually grows a taller and more muscular, her breasts swelling to plump fullness as they kiss, and it eventually becomes clear that she's grown a formidable trouser snake beneath her clothing. The store attendant cups the bulge of her now fellow herm's crotch and laughs happily, then turns her full attention back to her victim. She really goes all out on him now, pistoning her long and thick shaft in and out of his gripping hole. Fucking him vigorously, the Amazonian shows no mercy to her cock-sleeve captive, and soon, she reaches a point where the urge to cum grows too strong to hold back any longer. With one last, deep thrust, she sinks herself all the way into his ass and lets out low grunts as she floods his rear with her seed. Holding the man tightly by his hips while she breeds him, the transformed woman savors the power that she holds over him to the fullest.";
	say "     After her orgasm runs its course, the hermaphrodite pulls out of her captive, chuckling at the gush of cum that accompanies her dick. 'He's all yours now, baby girl,' the woman tells her young convert, who gleefully pushes down her pants to free a weighty cock that dangles in the open. Not wasting a moment, her hard rod is immediately lined up with the captured voyeur's ass, then thrust into his squelching insides. Yet before she can start to fuck him properly, the distant ringing of the entrance bell makes both Amazonians pause. 'Gotta greet the customers,' the first one says and pulls down her dress to smooth it over her softening erection. She is just about to leave when her eager lover pulls her into a quick kiss, followed by the question, 'What's your name anyways, my warrior queen? I'm Maia.' Stroking the younger woman's cheek, she replies, 'You can call me Easca, baby doll. Enjoy your fuck now. I will be right back.'";
	WaitLineBreak;
	say "     Several moans are heard in the background, and a couple minutes later, Easca returns to the dressing room while Maia is still fucking their captive, bringing along yet another surprised female who gets drawn into their circle. And another. And another. Mutual love and sisterhood is established between a good dozen women and herms, who share their male cum dumpster equally among them. Some come back for seconds or even thirds before they are done. By the end of his time getting railed by all of these strong and big-dicked herms, the voyeur is literally drenched in their cum. Using the remains of his clothes to wipe their toy down, Maia eventually discovers that underneath the creamy splatters, the ordeal managed to transform him. Sun-bronzed and apparently weather-beaten skin covers the male's now fairly muscular physique. Even so, his body is a far cry from his towering mistresses, more suited to the role of a serf or manual laborer than a warrior.";
	say "     Easca grabs her captive by the chin and makes him look her in the eye as she asks, 'Have you learned your lesson, little man?' He meekly nods to her, which makes the powerful Amazonian laugh out loud. 'Good. You may keep serving me and my kin, to drain our balls whenever we desire. I'll call you Agori, so everyone will know your status.' Throwing him the cum-soaked rags of his clothes to tie around his waist as a loincloth, the band of Amazonian warriors sets out for parts unknown, followed by their still rather sticky male slave. The rest of the tape's content are fairly boring, as all you can see is the cum-splattered dressing room, its contents slowly drying. Just to be sure that there is nothing interesting left to see, you speed forward through it all, but the room remains empty up till the time that the camera runs out of power a number of hours later.";


Drone Wreckage is a situation.
The sarea of Drone Wreckage is "High".

instead of resolving a Drone Wreckage:
	say "     Looking around while exploring the High Rise District, you walk into one of the side alleys behind a number of looted stores. As you turn the corner, a scraping noise can be heard from somewhere ahead, alerting you to the presence of someone or something. Warily moving forward, you edge your way sideways to look behind a big dumpster standing a little distance down the alley and find a small-ish latex fox there, gnawing on a severely mangled technological device. From the looks of it, the creature must have dragged it here to feast on the rubber and plastic components in peace. As soon as the fox spots you, it lets out a frightened screech and flees, sprinting to a nearby storm drain. With a squeak of deforming latex, it then forces its flexible body through the narrow opening into the drain and vanishes into the underground passage.";
	say "     Left behind in the alley, you check out the device that the latex fox was feeding on. It has a lightweight frame and a white, plastic casing that has been mostly gnawed off, and after a little puzzling around, you realize just what you are looking at. It is a traffic observation drone, part of a prestige project that City Hall rolled out some months ago. This particular example has suffered quite a bit, even before being chewed upon. You can see one of the struts that originally held its plastic propellers bent almost at a right angle. Checking over the wreckage, you manage to salvage a tape marked with the identification number of the drone (#006) and a date that is right around the start of the nanite outbreak. Unable to find any other identifying information, you put the tape in your pocket and make a mental note to watch it later. Maybe there's something that could be of use to you on it?";
	LineBreak;
	say "[bold type]'Traffic Drone #006 Footage' has been added to your tape inventory![roman type][line break]";
	add "Traffic Drone #006 Footage" to tapes of player;
	now Drone Wreckage is resolved;

to say TrafficDrone#006Vid:
	say "     You quickly slide the tape into the camera, pushing down on the side panel until it locks into place with a *Click*. Then you fold out the small screen of the device, pressing 'Play' and looking at it expectantly. The video starts with a view of numerous quad-copter drones, each painted white and sitting in its own box-like loading cradle. The walls of the room are literally covered in the framework required to store and refuel the drones, and you see the red and green lights of their loading indicators blink as the drone you are riding lifts off and turns quickly. Then it shoots forward to clear an automated hatch on the building's outside wall, capturing a glimpse of a fenced-in lot with a number of tiny meter-maid cars before it gains height and zooms off over the city.";
	say "     From the drone's lofty view-point, you have a beautiful view of the sun cresting the horizon and the city lying peacefully below, just awakening from its slumber. Clearly, this must be during the first days of the outbreak, as you can see the hustle of traffic and pedestrians walking around, not to mention the absence of wrecks and fires. Soon, your viewpoint takes position over a street crossing, the drone coming to a comfortable hover and focusing on a intersection of a main road and a connecting one-way street. Thanks to the wide-angle view of the drone, you can clearly see both roadways, as well as the sidewalks and building fronts running along them. This puts you in the perfect position to spot an anthro dalmatian, lazily leaning against the wall of a building in the one-way street and smoking. A pair of low-riding jeans are his only article of clothing, drawing the eye to his muscular arms and chest.";
	WaitLineBreak;
	say "     Down the main road, another person comes into sight some minutes later: a jogger in running shoes, shorts and a sleeveless exercise shirt, listening to music with a pair of ear-buds. As you see him jogging in the direction of the street crossing, you can't help but imagine how things might work out and are almost tempted to fast forward a bit, but then decide not to, unwilling to miss anything. Knowing the realities of life in the city, you have a fairly good idea what will the outcome will be, but the slowly rising tension pulls you in to watch with bated breath nonetheless. Things stay calm for a minute or two longer, with the dalmatian for the most part just leaning against the wall with a bored expression and blowing smoke. Then, when the jogger is almost at the street corner, the canine seems to catch a whiff of the sweaty man's scent on the wind.";
	say "     Flicking the cigarette away, the anthro canine pushes himself off the wall with a grin. Rolling his shoulders, he starts forward towards the incoming human, his body full of energy and anticipation. The slow build-up of the scene is replaced by a startling burst of action as the human man turns the corner and faces the anthro. For a second or two, he continues to jog as normal, but then does a double-take when he realizes that the person coming towards him is not human. Starting to slow down and calling out, 'What the hell?' The man's surprise is just the opportunity the dal needed, and the canine rushes him in a burst of speed, simply clotheslining his victim with a muscled arm. The jogger immediately falls down onto the concrete sidewalk, stunned and immobilized.";
	WaitLineBreak;
	say "     Laughing at his target after the ambush, the dalmatian crouches down over him, then pins the man to the ground with a hand on his throat. Leaning forward, he gives the jogger a possessive lick on the face and barks out, 'You're mine now. Darius's little bitch!' His other hand reaches into a pocket of the jeans and pulls out a red leather collar, which the canine fastens tightly around his captive's throat. He then lets go of the man and stands up, watching him with a gleeful expression. The jogger groans in obvious distress, writhing on the ground, and you think you can hear the words, 'So hot!' from him as he starts to claw at his t-shirt, ripping its fabric off his heaving chest. The man's toned abs are drenched in sweat, and from one moment to the next, a series of three extra pairs of nipples form on them to supplement the ones on his pecs.";
	say "     Shocked by this development, he clutches himself and feels over his chest, only to freak out even more as he sees dotted white fur creep up his arms. 'What is this?' the transforming jogger shouts out, then whimpers when a bone-crunching noise heralds the formation of a muzzle pushing itself out from his face. 'Quit your yammering,' Darius the dalmatian barks out, looking down at the man he infected and adding, 'Let's see how everything else is shaping up.' Crouching down to the weakly struggling man, he wrenches the jogger's shorts and undies down his legs, stripping him naked. 'Someone's hung for a white guy,' he comments with a chuckle as the man's painfully erect shaft is revealed. It throbs hard, launching a final volley of cum-spurts to splatter the jogger's chest, then shrinks down rapidly, soon reduced to nothing more than the little button of a clit at the top of the pussy that now dominates his crotch. 'Ooh, all gone now,' Darius laughs about the transformation, then puts his hand on his victim's newly formed female slit.";
	WaitLineBreak;
	say "     As fur continues to spread further and further over his body, the jogger whines and barks, still trying to figure out how to talk with his new muzzle. The rapid progression of his physical changes soon starts to affect his limbs, which shift and re-form into a canine configuration, complete with paws. After just a few minutes of transformation, you can't really see much left of the human male that turned the corner. He's soon almost fully a female dal, and from the looks of it, able to walk both on four or two legs. 'Becoming a sweet and proper bitch, hah!' the dalmatian says gleefully, rubbing his paw-hand over the crotch of his captive and pushing him/her to whine loudly again - in lust, this time. 'Yeah, you like that, I can tell!' Darius laughs as he pushes a finger inside the female canine's nether lips, feeling the resistance of her hymen and grinning broadly.";
	say "     'Just need two things to make you complete - an alpha to claim you, and a name,' the dalmatian male tells his victim. He hurriedly unzips the front of his pants and pulls out an erect canine shaft, that thick red rocket twitching in the air. Lining himself up with the wet spade of his newly made bitch, he thrusts into her with a satisfied growl, ramming his long cock home and making her squeal with helpless need. Bottoming out inside the female anthro, Darius comments in a mixture of arousal and amusement, 'I'll call you Hannah! You squeal like that prissy white slut when I bent her over the very first time she came to buy some Adderall from me. Sure was fun to knock her up!' With that, he starts to pump in and out of Hannah, giving her deep thrusts of his mighty bone and popping the knot in and out of her pussy.";
	WaitLineBreak;
	say "     Darius gives his new bitch a fast and hard pounding, right there on the sidewalk of the street corner. You might be used to such sights these days, but the driver of a car coming down the street is visibly shocked, so much so that he just keeps staring at the two of them and misses the turn he wanted to take, crashing his car into a pole with a startling crunch. The dalmatian male raises his head from where he was lapping Hannah's breasts and looks at the wreck, then shouts, 'Way to ruin the mood, asshole!' Raising his middle finger at the older man weakly moving behind the steering wheel, Darius pulls out of Hannah, which she protests with a confused, horny whine. 'Heel. I'll breed you at home in my crib,' the dominant dal tells her as he gets up and stuffs his cock back into his pants, then walks off, soon followed be the collared female dalmatian on all fours.";
	say "     The intersection stays silent for a number of minutes, with the driver of the crashed car apparently having passed out, until an incoming ambulance can be heard, then seen. It stops with squealing tires before paramedics rush to pry the wounded man from his car, quickly putting him on a stretcher and wheeling him into theirs. As they jump in the back with him and drive off, you catch a glimpse of a jaguar tail sticking out the back of one of the paramedic's uniforms. The drone's recording continues for a little while longer after this, until the flapping of what sounds like huge wings from off-screen gets louder and louder, followed by just the snow of an unfilled tape right after.";

to say DariusHannahVid1: [Note: This is a pre-infection video of Darius fucking the college student Hannah]
	say "     You quickly slide the tape into the camera, pushing down on the side panel until it locks into place with a *Click*. Then you fold out the small screen of the device, pressing 'Play' and looking at it expectantly. The video starts with a close-up view of a grinning black man, bent forward to turn on the recording camera that seems to be lying on a shelf or something, giving it a view from a raised position. The room looks to be a kitchen, with a broad kitchen counter that has several little baggies of pulls and powders laid out on it. 'Let's see if she's as dumb a slut as my homie told me,' he says with a chuckle, then steps back, showing that he is a quite broad-shouldered and well-muscled dude, dressed only in a pair of jeans and with his chocolate-brown chest bare. The black man leans against a wall and waits for a few minutes, until you can hear knocking from a little ways off. From the tinny sound, maybe against a metal screen door.";
	say "     Leaving the picture for a moment, the dark-skinned man returns a little while later, followed by a young blond woman in a tank top and short shorts. Judging from her looks, the makeup, artfully styled [']wild['] shoulder-length hair and her somewhat nervous demeanour, you'd guess she is a college student and this might be her first visit. 'So, what brings you to my door Hannah? Darius is sure to have whatever you need,' the black guy tells her with a winning grin, wiggling his eyebrows at the white girl. 'I um... I need something for my ADHD,' she replies cautiously and he laughs out loud. 'So, a baggy of Addy, eh? You don't have to give any excuses with me, you know. Come here.' Walking over to the kitchen counter, the drug dealer grabs a bag and holds it out to her, only to tug it away when she reaches out to take it. 'Payment first. Four hundred,' he tells her with a smirk on his lips.";
	WaitLineBreak;
	say "     Hannah looks at the black man with a surprised expression and replies, 'But - but your friend said it's only three hundred. I don't have that much on me.' Drawing the bag further away from her hand, Darius shakes his had with a sigh. 'Aw, too bad. That's not enough. Guess he must have accidentally quoted the discount for friends to you. See ya next time then. Or... do you wanna be my friend too and get your stuff right now?' You can see Hannah bite her lip and think, with Darius stepping up to her and saying in a very charming voice, 'Come on, it'll be lot of fun. You know you're eager to learn if the rumors about black dudes are true. All white girls do. And you can save quite a bit of money that way.' The black man holds out the bag temptingly to her while his free hand strays down and touches the side of her thigh.";
	say "     'I don't know,' she replies somewhat breathlessly, then whimpers as he leans in and licks her earlobe after whispering, 'Admit that you want it.' Hannah hems and haws a few moments more, then replies, 'It's a really bad time right now. Can I maybe just blow you?' Darius gives her a mildly amused look and shakes his head. 'Nope. And I don't wanna strap on a fucking condom either. They're too small for my dick. If you're so worried, I'll just pull out at the end, alright babe?' He doesn't wait for an answer, instead pulling her head to his with a hand on her neck and kissing Hannah full on the lips. The kiss escalates into making out with her, his hands roaming over the young woman's body and stroking her sexy curves. Before long, her top is pulled up over her head and thrown aside, followed by her bra. 'Nice little handfuls,' Darius comments about her breasts, cupping them and leaning down to suck their nipples.";
	WaitLineBreak;
	say "     The black man spends a little while playing around with Hannah's boobs, then proceeds to open the button of her shorts, shoving them down her legs together with her panties. 'You've got a beautiful pussy, babe!' Darius says in a loud and boisterous tone and buries his nose in the bush of her pubes, sucking in her clit between his lips. 'Oh my god!' Hannah gasps, her hands grasping the drug dealer by the shoulders to keep her balance. The black man keeps going down on her for a minute or two, then suddenly stands up and says, 'Time for you to be introduced to the black mamba!' Unzipping his jeans and letting them drop to reveal his thick schlong of a black cock, the man revels in Hannah's gasp at his size and her question of 'Will that even fit?' 'Sure it will. Might stretch ya pussy a bit but it'll definitively go in,' Darius replies jokingly and leads his pliable partner over to the kitchen counter.";
	say "     Turning the young woman around and bending her over it, he doesn't waste any more time in lining himself up with her sex. With a smooth thrust, the black man rams deep into her, making Hannah squeal in shock at the sudden penetration. From that moment on, she is in for a wild ride, as he doesn't pause or stop for even a second, just hammering her pussy again and again. Darius clearly enjoys showing the young woman just how deep his massive cock really reaches, and Hannah clearly enjoys the hard fuck from the sounds she makes. Her arms scramble against the kitchen counter as she tries to find a good way to brace herself against his thrusts, sending bags of drugs flying all over the ground, not that either of them cares about that. It doesn't take long before the aroused college student is pushed to her first orgasm, howling in lust as her pussy gushes femcum around Darius.";
	WaitLineBreak;
	say "     'Yeah, you white bitches just can't hold back when you feel a real man inside you,' the muscular drug dealer grunts amusedly, powering right through Hannah's orgasm and pounding her without pause. Her squeals of climax give way to whimpers as he drives on the roller-coaster of her arousal, starting her towards a new high right away. Sweat beads the skin of the two humping partners and runs down Darius's forehead as he builds towards his own sweet release, clearly enjoying the moments in which he thrusts balls deep into her quite a bit. 'Feel that babe? By black cock knocking against the door to your special place?' Hannah simply gasps from the repeated thrusts against her cervix, long past the spot where she can string together any intelligible words. After another deep penetration or two, Darius then grunts out urgently, his shaft throbbing deep inside her as it starts to spew out his potent seed to flood Hannah's womb.";
	say "     The young woman's eyes go wide as she feels him shooting inside her, and the sensations push her right over the edge with him, moaning and whimpering as a second orgasm rocks through her body. Darius humps into her with some little reflexive movements in rhythm with his blasts of cum, holding on to Hannah tightly as he breeds the white college girl. The two of them stay closely entwined for a long while, breathing hard and with him deep inside her pussy. Eventually, Hannah says, 'You told me you were gonna pull out!' Darius laughs amusedly and shrugs his broad shoulders, 'Yeah, what can I say. Changed my mind. But hey, since we're [']extra special['] friends now, I'll give you the Addy for two hundred. That offer stands as long as I get to tap this hot little pussy of yours.' As she opens her mouth to say something, he gives the young woman's earlobe a nibble and gropes her breast, expertly distracting her again.";
	WaitLineBreak;
	say "     'Come on, let's freshen up a bit.' Pulling out of his newest fuck, Darius leads Hannah off to the side next, leaving the view of the camera. You can hear a shower start in the background, soon followed my rhythmic thumping against a wall. Sounds like the young woman is getting another round of sex in his shower. A little while later, the interracial couple come back into view, with the black man casually naked as he watches her pick up her clothing and get dressed. The baggy of drugs she wanted changes hands for two hundred dollars, followed by him drawing her against his naked chest for a hungry kiss. 'Looking forward to next time,' he says with a grin after pulling back from her, then he leads Hannah to the door and returns to turn off the camera.";

to say DariusHannahVid2: [Note: This is a post infection video of Darius fucking a jogger that he turned into a dalmatian bitch and now _calls_ Hannah (not identical with the student from before)]
	say "     You quickly slide the tape into the camera, pushing down on the side panel until it locks into place with a *Click*. Then you fold out the small screen of the device, pressing 'Play' and looking at it expectantly. The video starts with a close-up view of a grinning anthro dalmatian, bent forward to turn on the recording camera that seems to be set up on a tripod. 'Perfect. Wouldn't want to miss capturing the memory of your first real breeding, eh Hannah?' the muscular male says as he turns around, then steps out of the way to reveal a naked dalmatian bitch with a red collar. She is sitting on a mattress on the floor, her shape slightly less humanoid than the tall man with bare chest and only a pair of jeans on his body. From the looks of it, Hannah is able to walk on all fours as easily as on her hind legs. The woman glances up at the male with a somewhat frightened expression, her lips twitching and muzzle opening as she goes through a few whines and canine sounds before figuring out how to speak as a dog-like being.";
	say "     'Whhh-What happened?' she asks in a helpless tone, a paw-hand distractedly stroking over the furred side of her leg. 'God, I feel weird. Everything is so fuzzy and strange. I was... jogging, yes that was it. And I ran into you, then...' The dalmatian man crotches down next to her, reaching out to cup the curve of her small but shapely breasts and stroking the additional nipples running down her front. 'I claimed you and showed you what you were made for really. A sweet bitch for Darius, your man!' he says with a broad grin while Hannah can't help but let out a needy moan. 'What? But, but... no, I'm not a woman... and not Hannah,' she whines in confusion. 'Sure looks like you're a bitch,' Darius replies and swipes over the wet slit between her legs, then raises his hand so she can see lines of sticky goop stretching between the fingers. 'And you followed my right home like a good pet after I warmed you up a bit.'";
	WaitLineBreak;
	say "     'I-I don't know. Something about this is wrong, I -' Hannah starts to say, only to be stopped by Darius grabbing her by the back of the neck and drawing her into a forceful kiss. His long tongue invades her muzzle and wrestles hers down, establishing dominance in even this little slice of interaction between them. 'Believe it. You're a bitch. My bitch. And now you're gonna get bred good!' Darius barks commandingly at her, then pulls the female dalmatian up from her sitting position, easily moving the woman into a new position in her lust-bedazzled state. Once she is on all fours, her ass and raised tail turned right towards the camera, Darius spreads her folds with his fingers and shows the woman's swollen pussy off. He spreads her wet and dripping nether lips and licks over them, then comments, 'Yeah Hannah, you're ripe for a good fuck.'";
	say "     With that said, the man quickly rises and undoes the button and zipper of his jeans, wrenching them down to reveal his hard bone of a canine shaft. Stepping over his sex pet, the muscular dalmatian grabs Hannah by the hips and lines himself up, then thrusts into her with a quick jab. 'Fuck! Hope you stay this tight even after taking my knot, girl!' Not interested in waiting any longer or going slow, Darius hammers mercilessly into his bitch, the red rocket between his legs plunging in and out of her sex. This includes the already somewhat enlarged bumps of his knot, bulging out from the shaft at the base of his cock, which he pops past her opening with sharp jabs again and again. The two canines fill the room with barks, moans, grunts and howls as Darius introduces his new bitch to her present and future duties of serving as his private cock-holster.";
	WaitLineBreak;
	say "     Eventually, the dominant male slows down a little and starts to say something that you can't quite catch since he lets out a grunt right away. Looks like Hannah rocked back against his shaft in her eagerness for more fucking and squeezed him, breaking the horny man's train of thought until he grabs her tightly and makes the dalmatian stop. 'You sure are eager, slut. Now turn around. I wanna get your face on vid when you get filled with your first litter. Clearly unwilling to withdraw his cock from the warm and tight hole of his bitch, Darius and Hannah move while still connected intimately, soon facing the camera head on. You can see the change that the hard fucking has had on the dalmatian woman immediately - all doubt and insecurity seems to be blown away from her, with the bitch now literally panting loudly for more dick.";
	say "     Darius looks right at the camera and grins broadly, then focuses back on his fuck toy and starts to rut her hard and deep, going all out in a wild fuck. As wound up as they already were before, it doesn't take all that long before the point of no return is reached and he grinds against her ass hard while his knot swells up to its full size and locks the two of them together. Hannah whimpers and squeals under him, overwhelmed by the sensations of being stretched around his canine cock and the deluge of doggy cum flooding her insides. Letting out a victorious howl, Darius humps against her with short thrusts, coinciding with each further spurt of his seed into Hannah's depths. As his orgasm runs its course, he eventually slumps down onto her back, his arms wrapping around the canine woman's chest as he holds onto her loosely and gropes her breasts.";
	WaitLineBreak;
	say "     'You're mine bitch, as are the pups I just put into you,' Darius grunts in satisfaction, his muzzle right next to one of Hannah's ears. Her blissed-out expression betraying the strong effect that being bred has had on her, the spotted woman can't do much more than whine submissively in reply, which makes her alpha laugh and grin. The two of them stay together for that for some more time, with Darius whispering more things into his knotted bitch's ear until he eventually gets soft enough to pull out of her. His red canine shaft swings left and right between his legs, dripping cum, as he walks up to the camera and then turns it off.";
	
Lost Explorer is a situation.
The sarea of Lost Explorer is "Warehouse".

instead of resolving a Lost Explorer:
	say "     Roaming the expansive warehouse district in search of anything that might aid your survival in this fallen city, your exploration leads you into a section that has been largely abandoned. Wrecked buildings and long-dead factories dominate your surroundings, creating a fairly creepy ambiance. On top of that, the area seems eerily quiet, missing the usual groans and grunts of creatures rutting in the distance. Maybe there just isn't anything interesting here to attract the post-human denizens of the city, or maybe something is lurking and waiting? You dispell those concerns and soldier on, determined to find some salvage while you're here. Crumbling walls, rusted metal, and countless spray-paint tagsare everywhere you look, and [if daytimer is day]even in daylight, the whole area seems tailor-made for a horror movie[else]in the dim moonlight, the whole area appears tailor-made for a horror movie[end if].";
	say "     Your sense of hopeful exploration wears thinner and thinner as you check out yet another empty building after at least an hour of searching the area. Not even homeless people have occupied these places, and whatever may once have been here has long been looted or willfully destroyed. But just as you are about to give up on this endeavor, a glimpse of crimson draws your attention to an old factory building across the cracked and rubble-covered road. Stepping out of the disappointing ruin, you look up at the factory and see a helmet dangling crookedly from an exposed piece of rebar that sticks out sideways from a landing on the second floor. It looks fairly modern and new, the material still gleaming under the light, and a compact helmet cam has been attached at the front. Letting your gaze wander down, you notice scattered shreds of clothing littering the ground below. Looks like the owner of that helmet didn't fare too well.";
	say "     [bold type]What do you want to do now?[roman type][line break]";
	LineBreak;
	say "     ([link]Y[as]y[end link]) - Investigate the scene in detail.";
	say "     ([link]N[as]n[end link]) - Better get out of here. Whatever did this might still be around.";
	if player consents:
		LineBreak;
		say "     Walking towards the remains of clothing, you realize they're almost directly beneath where the helmet is dangling. If you had to guess, you'd say that the person they belonged to was on the upper floor of the abandoned factory, then seems to have jumped down from there, losing the helmet in the process. It didn't do [ObjectPro of player] much good though, since they were caught shortly after judging by the large patch of dried cum. Glancing up at the helmet swinging back and forth in the wind, you see that the camera on it should have captured what went on. Curiosity drives you to find a bare concrete set of stairs a little deeper in the building and take it up to the second floor, then move towards the drop that the other explorer tumbled down. On the way there, you notice some bootprints that [SubjectPro of player] left in the dust, as well as the unmistakable impression of paws.";
		say "     The helmet actually isn't all that easy to get to, dangling from the end of a two foot protrusion of steel rebar, so you have to lean out over the drop to reach it. As you try to reach it, the strap snagged on the rod slips a little away from you, threatening to make the whole thing fall down onto the ground below. Snatching at it desperately, you barely manage to catch one of the straps and avoid your prize smashing on the concrete, then pull back to sit down for a second at the edge of the platform. The helmet you rescued from its precarious position is indeed fairly new, with a tag on the inside declaring its owner to be 'Mason Reed'. It looks nice and sturdy and should be useful as head protection. As for the camera at its front end, that doesn't seem to react to any of the buttons on it you push, except for the spring-loaded eject of its tape. Hm, must have run out of power.";
		LineBreak;
		say "     Pocketing the tape for good measure and with the helmet under one arm, you leave the abandoned factory after a little while longer, during which you find numerous additional tracks of paws crisscrossing the interior of the building. Clearly, this is the territory of some sort of predator, so you deem it best not to stay too long. As you go, you can't help but wonder who the owner of this helmet was and when it was left there. Might have been since before the infection, since clearly not many people come here who could have found it. The contents of the tape might reveal some information about that, if you find a way to play it.";
		say "[bold type]You gain an urban explorer helmet![roman type][line break]";
		increase carried of urban explorer helmet by 1;
		say "[bold type]'Urban Explorer Helmet Cam Vid #1' has been added to your tape inventory![roman type][line break]";
		add "Urban Explorer Helmet Cam Vid #1" to tapes of player;
	else:
		LineBreak;
		say "     Sometimes caution is the best way to stay alive. Not falling into the temptation of exposing yourself, you creep backwards from where you are, keeping an eye out for anyone or anything that might jump at you. A little while later you're back in the more populated parts of the warehouse district.";
	now Lost Explorer is resolved;

to say UrbanExplorerVid1:
	say "     You quickly slide the tape into the camera, pushing down on the side panel until it locks into place with a *Click*. Then you fold out the small screen of the device, pressing 'Play' and looking at it expectantly. The video starts with a view of cracked concrete, little patches of grass growing in between the aged stone. Then the helmet the recording camera was attached to is turned around and a young man's face comes into view, looking intently at it and murmuring under his breath, 'Today's trip to explore the Bradley Manufacturing Plant is a go. This is Mason Reed speaking, and I'll be taking you on this trip into the past.' With a smile on his goatee'd face, he puts the helmet on and secures its straps, which moves your viewpoint to standing human height, looking out over the abandoned area where you found this tape.";
	say "     The camera only jostles a little with each step Mason takes, and the young man seems well experienced in using such devices to document his trips, stopping regularly to take in slow pans over his surroundings. All in all, he seems to be a fairly chatty person, happily pointing out many facts about the area he is walking through, as well as identifying some spray-painted tags that were made by specific people he could name. Over the next hour or so, the urban explorer slowly wanders the grounds of the former factory and marvels at the inner beauty of the empty shell of bygone industrialism. From the abandoned production lines that put together boxy radio sets, to a view over the patchy rooftop to watch the sunset, it is an interesting bit of footage, worth watching in its own right - but you know there is more to it, remembering just where and how you got hold of Mason's helmet.";
	WaitLineBreak;
	say "     After watching the sun vanish below the horizon and the red of its last rays fade, Mason pulls a compact flashlight from his pocket, then starts on the way back down through the abandoned factory. 'Wandering these old places after dark is always a bit freaky,' he says in a daredevil tone, letting the light dance over rusty machines. 'Maybe we'll see a ghost. In the old days, there was barely any worker safety, so you can generally expect there to have been deadly accidents over the years. Who knows how many men are still haunting the place where they lost their lives, bound to the thought that they have to fulfill their quota, no matter the cost.' With that said, your urban explorer falls silent and wanders past the production line, directing his flashlight here and there to highlight things and whisper what part of the factory it was. Eventually, Mason walks down a set of stairs to the second floor of the building and continues to play up the haunted air of it all, talking in hushed tones as he walks over the dust-laden factory floor.";
	say "     Knowing that something is coming for him creates a nerve-wracking experience, and you hold your camera tightly as a creak of metal makes the urban explorer freeze in his steps. 'What the hell? Is someone there?' he says in a somewhat breathless voice and turns around, shining his light over the fairly open production floor. 'Must have been a rat,' the young man starts to tell himself, but before the last word is even out of his mouth, a sliver of movement becomes visible a little distance away. From behind one production line, a pair of what looks like black-furred tentacles rise into sight, complete with gripping pads that show a dim, green glow of bioluminescence. The creature they belong to uses the two appendages to brace itself for a leap on top the machine, revealing itself to be a large feline with glowing green eyes. Letting out a low growl, it focuses on Mason, then jumps forward from its raised position, tearing over the concrete floor to pounce on your urban explorer.";
	WaitLineBreak;
	project the Figure of ShadowBeast_icon;
	say "     'Fuck! Fuck! Fuck!' Mason calls out in disbelief as he whirls around to run, his feet flying over the ground. The creature hunting him barely makes a sound as its paws touch the ground, and were it not for the horrified glimpse over the young man's shoulder that revealed it directly behind him, you'd have guessed that it was still far off. In his panicked flight through the darkness, Mason is driven right towards the end of the second floor that you remember from finding the tape. By the time he tries to take a corner to reach a nearby stairwell down to ground level, he finds out the hard way that he's moving far too fast. The helmeted explorer's boots scratch over the dusty floor and find it fairly slippery, the fleeing man's momentum enough to propel him right over the edge. The next moments are fairly chaotic, but from what you can tell, he grazed the rebar rods on the way down, with one catching a loop of his helmet and another ripping Mason's jacket halfway through.";
	say "     Making a choking sound, Mason's hands fly upwards to release the helmet's fastening, and he tumbles to the ground, the increased strain on his jacket enough to shred the garment completely. The helmet (and your viewpoint) swings wildly for a few moments, making it hard to see anything clearly, but by the time it comes to hang at a crooked angle, you see Mason on all fours, trying to clear his head by shaking it and scrambling to his feet. Then another growl from off-screen makes him freeze in the half-crouch of standing up. 'Hey, wait! Slow down kitty! What are you even, some exotic pet or something? I - I'm not something to eat! Mason steak isn't on the menu!' Hands raised in a defensive position, the young man focuses on the creature that comes into view a moment later, prowling forward on silent paws, its tentacles raised to strike.";
	WaitLineBreak;
	say "     The churr of what seems like feline laughter comes from the advancing cat-beast, and Mason replies with the hopeful words, 'So, you don't wanna eat me? Great, why don't I just go that way and you-' The rest of what he wanted to say is interrupted by a lightning-quick tentacle strike, wrapping the gripping pad at its end around his ankles and wrenching them out from under Mason. A shocked shout escapes his lips as he falls on his back, then finds himself pinned beneath the large cat, one tentacle still holding his legs while the other pushing an arm to the ground. Mason raises the one free hand he has, but the tentacled beast bares its fangs and growls, as if to warn him that it would be a stupid idea to try to resist. And so, the young man lets his arm drop back to the ground, trembling in trepidation of what may happen next.";
	say "     Satisfied, the large feline on top of him lowers its head to sniff Mason's body, giving his neck and face a lick or two before catching the collar of his shirt between its teeth and tearing the garment off. 'Oh my god,' the pale-skinned human swears, twitching as he is tempted to try freeing himself, but his captor just continues to do nothing more than lapping at his sweaty skin, not showing any sign of actually wanting to hurt the man. Then the feline carefully unsheathes his claws to slide them under Mason's jeans, scoring the fabric and ripping it away in short notice. Soon, Mason is almost completely naked and more than a little befuddled from this development, especially as the feline starts to lap at his crotch. 'Hey! That's sensitive you know, and why are you - oh!' he says, having caught sight of something under the feline's body. You make an educated guess that it's the creature's hard cock by the way Mason blushes all over.";
	WaitLineBreak;
	say "     Stunned by the amorous beast's revealed intentions, the urban explorer doesn't react as his captor suddenly lets go, then circles around to stand over him, warm chest-fur brushing over the human's naked skin. For a few seconds, silence stretches out between the two of them as glowing green cat-eyes meet the gaze of Mason's amber eyes, until the young man says in a voice that sounds both amused as well as fatalistic, 'Well, fuck. I guess this is happening no matter what I say, eh?' Churred laughter confirms his guess, followed by several licks along his face. You can see the young man bunch his fists, then relax them again, eventually raising his hands to pat the cat's side. Soon, he slides them up to stroke the fur around his captor's neck and rubs under his throat, apparently willing to comply and ready to get on the big beast's good side.";
	say "     'Man, you really like this, don't you?' Mason says after a little while of rubbing the now-purring feline's fur, looking down between the two of them. 'Damn, that's a big piece of meat you got there. Leaky, too. Must be pretty pent up, huh?' he asks nervously, earning an aroused churr and a nod of its feline head. The tentacled beast bends its two appendages down to hook under his captive human's legs, pulling them up and spreading them. Soon, Mason is stretched out in classic missionary position under his definitely unusual partner. 'Could you go slow please? I haven't had sex since my roommate left for semester break, and even if I had... that's one monster cock you got there. Hell, it's got those little barbs and everything!' Mason says in a somewhat apprehensive tone, but it's clear that he's become more than a little aroused by now.";
	WaitLineBreak;
	say "     Reaching down between his legs, Mason takes hold of the feline's shaft and lines it up with his opening, and the large beast slowly pushes into him, purring through and through as he sheathes himself in the human. 'Fuuuckkkkk! I feel stuffed,' the urban explorer groans. He lets out far less intelligible sounds of lust as his captor draws back and scrapes his inside with the soft spines along his shaft, proceeding to fuck him with wild and beastly delight. It is an almost entrancing sight to see the feline take his human partner, humping and licking, as well as caressing him with his tentacles, all while the man moans in helpless lust, his arms wrapped around the sleek body of his black-furred top, holding on for dear life. Things get so intense that you at first don't even notice the college-aged human start to transform during their lovemaking, black fur sprouting along his arms and rapidly enveloping them before sweeping down towards his chest.";
	say "     With the topping cat in the way as it humps and licks Mason, you only catch a few glimpses of the human's head, which soon pushes out in a muzzle. Their relentless mating continues without pause and becomes more and more intense, building up to an explosive climax. Thrusting deep into his new mate, the feral cat twitches visibly with each throb of his seed into the bowels of the transforming young man, and in that very moment, a twin pair of tentacles bursts out of Mason's back right beneath the shoulder blades. Tentacles entwining in what seems to be a loving embrace, the two black-furred creatures stay together on the ground, riding out their orgasms. Things quiet down for several minutes after that, with the video only showing them lying there together, purring and breathing deeply, until the feral cat eventually dismounts his partner.";
	WaitLineBreak;
	say "     As Mason is revealed to your view completely, you realize that he passed out in exhaustion from the combined transformation and orgasm. While he did transform, this was far from a total conversion to match his feral partner. He may be feline and match the beast in black fur and some bio-luminescent patches, but the young man is still anthro in appearance, with recognizable arms and legs meant for bipedal locomotion. None of this seems to matter much to the urban explorer's sated captor, and the large beast bends its head down to groom Mason's chest, where his fur is a sticky mess from his own load and the pre leaked on him earlier. After a thorough cat-wash of his new convert, the tentacled cat lifts the dozing young anthro with his surprisingly strong appendages and slings him across his back, carrying his freshly fucked plaything to parts unknown.";
	say "     The rest of the video is filled with several more hours of the same view, with nothing more interesting happening than a rat eventually dashing past, so you rewind after fast-forwarding through it and eject the tape.";



Recordings ends here.
