Version 1 of Satyr Frat by Wahn begins here.
[ Version 1 - Initial Event ]

[ SatyrFratPartyStage                                                  ]
[  0: Free Drink event not done yet                                    ]
[  1: player helped in the free drink event (punched Richard)          ]
[  2: player helped in the free drink event (fought incubi - won)      ]
[  3: player helped in the free drink event (fought incubi - fled)     ]
[  4: player helped in the free drink event (fought incubi - lost)     ]
[  5: player helped in the free drink event (BJ for Richard)           ]
[  6: player helped in the free drink event (got fucked by Richard)    ]
[ 99: player declined helping the satyrs                               ]

[ SatyrFratRichardRelationship                                         ]
[  0: not met                                                          ]
[  1: friendly encounter (know his name)                               ]
[  2: sexual encounter (know his name)                                 ]
[  3: fucked in public (know his name)                                 ]
[  4: satyr transformed                                                ]
[ 98: neutral encounter (do not know his name)                         ]
[ 99: unfriendly encounter (do not know his name)                      ]

[ SatyressStage                                                        ]
[  0: not existent                                                     ]
[  1: created in the frat-house, roaming the campus                    ]

SatyrFratPartyStage is a number that varies.
SatyrFratRichardRelationship is a number that varies.
SatyressStage is a number that varies.

to say Satyr Frat Party:
	now battleground is "void";
	say "     You walk over the campus with the two satyrs, chatting a bit as you go along. Their names are Kerr and Talov, with Kerr having a bit more masculine features and thicker brown hair and Talov being pretty slender, with red hair and an almost shaved-looking chest. The two of them are pretty mellow and friendly, going on and on how much fun the party will be. Seems to you as if they stopped more than just once to drink cups of wine on the way too. After a while, Kerr asks you to take his place pushing the barrel for a moment, then skips ahead, scouting out where you're going. When he comes back a moment later, he says, 'We've got a small problem... they've got someone standing guard.' Seeing your questioning expression at this, he continues, 'Well, it's like this - we're the surprise guests... in that no one knows we're coming. The frat-boys have been partying for a while, so they are tipsy and distracted enough not to care too much if we join them... but that guy back there looks like he drew the short straw. Totally sober and alert.'";
	LineBreak;
	say "     Already having downed a few cups themselves, your two satyr compatriots seem a bit indecisive in how to deal with this little problem. You doubt they'll manage their plan on infiltrating the frat party on their own. Do you want to help them out?";
	if player consents:
		LineBreak;
		say "     Telling Kerr and Talov that you'll deal with things, you walk ahead of them and soon see a young man standing guard in front of a frat house in which a roaring party is going on. He's tall and pretty handsome too, dressed in a black Phi Alpha Nu t-shirt and jeans. From the looks of his muscled body, he's obviously an athlete - which throws the option of just attacking him out of the window. A prolonged brawl right in front of the house would surely be noticed even by the wildest partying crowd, and a jeering crowd of onlookers is exactly what your satyr friends don't need.";
		LineBreak;
		say "     You could try knocking him out with a sucker-punch [link](1)[as]1[end link] - if it's all over in a second, no one might notice. Or you could try to get him out of position with some quick lying [link](2)[as]2[end link]. And of course, there's always the option of just charming the pants off the young man [link](3)[as]3[end link] - he definitively won't be thinking of guarding anything while you take care of him...";
		now calcnumber is 0;
		while calcnumber < 1 or calcnumber > 3:
			say "Choice? (1-3)>[run paragraph on]";
			get a number;
			if calcnumber is 1 or calcnumber is 2 or calcnumber is 3:
				break;
			else:
				say "Invalid choice. Type [link]1[end link] to punch him out, [link]2[end link] to talk your way through this, or [link]3[end link] to have sex with him.";
		if calcnumber is 1:[knockout]
			LineBreak;
			let bonus be (( the Strength of the player minus 10 ) divided by 2);
			let diceroll be a random number from 1 to 20;
			say "You roll 1d20([diceroll])+[bonus]: [diceroll + bonus] (Strength-Check vs 18)";
			increase diceroll by bonus;
			LineBreak;
			if diceroll is greater than 17:
				say "     Walking up to the young human man in a relaxed, nonthreatening manner, you greet him and... land a hard punch right in his face. Unprepared for this sudden violence, the frat-member just crumples to the ground. That went surprisingly smooth. You have a quick look over to the house, but none of the partying people seems to have noticed your very short altercation. Grabbing the knocked-out student under the arms, you start dragging him out of sight, around the corner of the frat-house's garage. As you do so, Kerr and Talov pass you with their barrel, rolling it towards the entrance of the building. You can tell from Kerr's expression that he's a bit surprised at your violent solution to this situation.";
				say "     After you finish dragging your unconscious victim around the corner and put him on the ground behind a tall bush, you unobtrusively check for the satyrs. Looks like they made it into the building alright. With a smile at the thought of the two of them joining the party and handing out wine left and right, you walk away from the frat-house - for now. Maybe you should return here sometime later and see how this [bold type]party[roman type] develops...";
			else:
				say "     Walking up to the young human man in a relaxed, nonthreatening manner, you greet him and... land a punch right in his face. Unprepared for this sudden violence, the frat-member stumbles backwards, but quickly catches himself. Uh-oh... that just made him angry. Using the moment in which the muscled guy shakes off the slight daze you gave him as a head-start, you dash away down the street, quickly followed by the yelling and cursing young man. This might not have been such a bright idea after all - he almost catches you several times, proving the speed and stamina a trained athlete can muster. Only when you jump over a hedge just after turning a corner do you get rid of him, as he dashes past your hiding spot.";
				say "     Phew, that was close. Though at least you can be sure that you gave Kerr and Talov enough time to make their way into the frat house. Maybe you should return here sometime later and see how this [bold type]party[roman type] develops...";
			now SatyrFratPartyStage is 1;
			now SatyrFratRichardRelationship is 99;
			now Let's Party is not resolved;
		if calcnumber is 2:[lying]
			LineBreak;
			say "     Running up to the young human man on quick hooves, you do a bit of play-acting as if you're out of breath, then pant that you saw a group of incubi climbing over the fence behind the house. The athletic young man's eyes widen in alarm and he says 'What?! Where? And who are -' Quickly interrupting him before he can really think about anything, you tell him to come quickly and run past the garage of the frat-house, turning the corner towards the backyard. And it works - the frat party guardian follows you a moment later, leaving his post to check out your imaginary incubi.";
			say "     Though as it turns out, they're not as imaginary as you thought - there actually are two incubi climbing over the fence! What a coincidence. Dropping down into the garden, they take up poses that show off their inhumanly perfect bodies and await you and the frat-member behind you calmly. 'Didn't I say there'd be a delicious banquet of studs in here? I'll take the left one,' one of them says to the other, then they attack...";
			challenge "Incubus";
			if fightoutcome >= 20 and fightoutcome <= 29:[lost]
				say "     After the incubus finishes with you, he's suddenly punched out by the frat guy, who finished off his own attacker in the meantime. The young man helps you back to your feet, meanwhile closely watching the incubi pick themselves up and flee. When the two of you walk back to the front of the house afterwards, he says 'Thanks for the warning and... er, help. I'm Richard by the way.' He's too intent in getting back to his post to do more than have a short chat on the way, but you get the impression that he's a pretty friendly and nice guy. As you come to the front of the house, your satyr compatriots are nowhere in sight - seems like they made it into the building alright. Getting another bit of thanks from Richard, you say your goodbyes and walk away. Maybe you should return here sometime later and see how this [bold type]party[roman type] develops...";
				now SatyrFratPartyStage is 4;
			else if fightoutcome >= 30:[fled]
				say "    Sometimes it's best to flee - this isn't really your fight after all. As you dash off, you see that the frat guy has finished off his own incubus. He lunges at yours as the demon tries to run after you, bringing both of down to sprawl on the ground, wrestling with each other. And that's the last you see of the fight, as you turn a corner and move further away. A bit of a dick move to leave the young man to fight alone, though at least you can be sure that you gave Kerr and Talov enough time to make their way into the frat house. Maybe you should return here sometime later and see how this [bold type]party[roman type] develops...";
				now SatyrFratPartyStage is 3;
			else if fightoutcome >= 10 and fightoutcome <= 19:        [won]
				say "     After finishing off the incubus, you look around and see the frat guy standing over his own opponent. The young man claps your shoulder in camaraderie and keeps a close watch on the bruised incubi as they pick themselves up and flee. When the two of you walk back to the front of the house afterwards, he says 'Thanks for the warning and help. I'm Richard by the way.' He's too intent in getting back to his post to do more than have a short chat on the way, but you get the impression that he's a pretty friendly and nice guy. As you come to the front of the house, your satyr compatriots are nowhere in sight - seems like they made it into the building alright. Getting another bit of thanks from Richard, you say your goodbyes and walk away. Maybe you should return here sometime later and see how this [bold type]party[roman type] develops...";
				now SatyrFratPartyStage is 2;
			now SatyrFratRichardRelationship is 1;
			now Let's Party is not resolved;
		if calcnumber is 3:[sex]
			LineBreak;
			say "[SatyrFratSex]";
			now SatyrFratRichardRelationship is 2;
			now Let's Party is not resolved;
		if SatyrFratPartyStage > 0 and SatyrFratPartyStage < 99:
			change the south exit of Greek Street to Satyr Frat Dummy Room;
			change the north exit of Satyr Frat Dummy Room to Greek Street;
	else:
		LineBreak;
		say "     Maybe it's for the best that the two of them won't manage to pass their infective wine to dozens of frat members here on the campus. With a well-meant suggestion of just taking their wine barrel and enjoying the contents themselves, you leave the satyrs and turn your attention back to more important matters.";

to say SatyrFratSex:
	if cocks of player > 0:
		say "     Walking up to the young human man in a relaxed, nonthreatening manner, you greet him and start a conversation. As it turns out, his name is Richard and he just started out here in Tenvale College on a sports scholarship this semester. He's a running back in the football team and joined the Phi Alpha Nu fraternity as a legacy member, just like his father before him. Nevertheless, he's still low on the totem pole - which explains why he's out here on guard duty and not enjoying himself with all the others inside. He's got a bit of a wistful look in his eye as he tells you about it, finishing 'I'd love to party with the guys... err, and all the hot chicks we've got over. Yeah, love the babes on campus. Definitively.'";
		say "     That last bit was said a bit too hurriedly, a blurt of words only making clearer what he wanted to hide. And catching his eyes stray down your body for a second confirms it a moment later - so Richard has some interest there for both sides of the fence. Perfect, for what you're planning. Keeping him talking about what he likes in women and his past conquests, you get the football-player in a receptive mood, then smoothly compliment him on what great shape he's in. Things progress to him showing off his muscles, then you feeling and... gently stroking them, just a little bit at first, then ever bolder. Soon you're standing very close beside the young man, one hand on the growing bulge in his pants. In the most charming tone you can manage, you tell him...";
		LineBreak;
		say "     [link](1)[as]1[end link] That you want to give him a blowjob.[line break]     [link](2)[as]2[end link] That you want him to fuck you.";
		now calcnumber is 0;
		while calcnumber < 1 or calcnumber > 2:
			say "Choice? (1-2)>[run paragraph on]";
			get a number;
			if calcnumber is 1 or calcnumber is 2:
				break;
			else:
				say "Invalid choice. Type [link]1[end link] to blow him or [link]2[end link] to get fucked.";
		if calcnumber is 1:[BJ]
			say "     As wound up as you've got the athletic student, he eagerly and immediately agrees and lets himself be led around the corner of the frat-house's garage, to a nice secluded spot between several high bushes. Looking back before joining him there, you see your two satyr compatriots, grinning broadly at how you're dealing with the frat party guardian. While they start rolling their barrel on towards the goal, you pull Richard close and give him a deep kiss. His eyes widen at actually being intimate with [if cunts of player is 0]another male[else]a herm[end if] for the first time and he freezes for a second, then quickly gets over his shock and happily replies in kind. As you make out with the young man, your hands quickly undo his button and zipper, opening the way to the quite impressive tent showing at the front of his boxer shorts.";
			say "     He moans between your kisses as you slide your hands under the band of his shorts, fondling his balls and jerking him off with the other hand. Then you kneel down, pulling down his pants and shorts as you go along, freeing his well-sized manhood to dangle just before your nose. Very nicely hung, your young running back. Eager to get going, you take hold of his shaft and slowly lick up the underside of Richard's shaft, making him pant loudly in lust. Soon arriving at the tip of his manhood, you play your tongue over it, teasing his slit for a moment, then slide your lips over his cock and sink them down along its length.";
			WaitLineBreak;
			say "     While bobbing up and down on Richard's shaft, you use your hands to play with his balls, stroking and fondling to give your partner even more pleasure. At one point, you even snake a hand through between his legs, seeking out the round and firm globes of his butt to give them a good squeeze, then moving on what lies between them. Richard's pants come even quicker as you rub a finger around his pucker, which culminates in a pleasantly surprised gasp as you push it in a moment later, probing his virgin hole. Nice and tight, and you can make this strong male give a very cute little squeal when you rub his prostate. Definitively something to remember for later - though for now, you decide it'd be better to just concentrate on the blowjob.";
			say "     With you so eagerly going down on him, as well as touching and stroking his body, it's no big wonder that Richard soon gets closer and closer to orgasming. His pants and moans rise in volume and frequency until he finally gives a breathless grunt of 'I'm coming!' and blasts of his cum start filling your mouth. You feel the pleasant taste of his seed on your tongue for a moment, then swallow it down as more and more pulses out of his cock. 'That was *pant* amazing!' Richard gets out after getting himself under control again, before accepting a kiss that lets him taste his own cum a moment later.";
			WaitLineBreak;
			say "     After a bit more pretty nice making out with the student, you leave to pull his pants back up, unobtrusively checking for the satyrs in the meantime. Looks like they made it into the building alright. With a smile, you playfully grope Richard's butt one last time, then bid him farewell and watch as he walks back to his post. Maybe you should return here sometime later and see how this [bold type]party[roman type] develops...";
			now SatyrFratPartyStage is 5;
		else if calcnumber is 2:[Fuck]
			setmonster "human";
			choose row monster from the table of random critters;
			say "     As wound up as you've got the athletic student, he eagerly and immediately agrees and lets himself be led around the corner of the frat-house's garage, to a nice secluded spot between several high bushes. Looking back before joining him there, you see your two satyr compatriots, grinning broadly at how you're dealing with the frat party guardian. While they start rolling their barrel on towards the goal, you pull Richard close and give him a deep kiss. His eyes widen at actually being intimate with [if cunts of player is 0]another male[else]a herm[end if] for the first time and he freezes for a second, then quickly gets over his shock and happily replies in kind. As you make out with the young man, your hands quickly undo his button and zipper, opening the way to the quite impressive tent showing at the front of his boxer shorts.";
			say "     He moans between your kisses as you slide your hands under the band of his shorts, fondling his balls and jerking him off with the other hand. Then you kneel down, pulling down his pants and shorts as you go along, freeing his well-sized manhood to dangle just before your nose. Very nicely hung, your young running back. Eager to get going, you take hold of his shaft and slowly lick up the underside of Richard's shaft, making him pant loudly in lust. Soon arriving at the tip of his manhood, you play your tongue over it, teasing his slit for a moment, then slide your lips over his cock and sink them down along its length.";
			WaitLineBreak;
			say "     While bobbing up and down on Richard's shaft, you use your hands to play with his balls, stroking and fondling to give your partner even more pleasure. At one point, you even snake a hand through between his legs, seeking out the round and firm globes of his butt to give them a good squeeze, then moving on what lies between them. Richard's pants come even quicker as you rub a finger around his pucker, which culminates in a pleasantly surprised gasp as you push it in a moment later, probing his virgin hole. Nice and tight, and you can make this strong male give a very cute little squeal when you rub his prostate. Definitively something to remember for later - though for now, you want to get fucked yourself.";
			say "     Pulling your lips off his nice and wet shaft with a pop, you pant that it's time for him to fuck you, quickly dropping your gear and clothes to the ground before bending over for Richard. Wiggling your butt invitingly is all it takes for the young man to step up to you and put the tip of his shaft against your hole. With a lustful grunt, he thrusts right in, plunging his manhood deep into you. 'Man, that feels as good as any pussy I ever fucked - maybe better!' he pants as he wraps his arms around your chest from behind. Being fucked by this very eager young man, you delight in flexing your inner muscles and listening to the moaned and gasped reactions you get as you do. With this being his first time, with a [if cunts of player > 0]herm[else]man[end if] that is, it's no big wonder that Richard soon gets closer and closer to orgasming. His pants and moans rise in volume and frequency until he finally gives a breathless grunt of 'I'm coming!' and pounds his cock into your hole one last time as it starts blasting spurt after spurt of cum.[mimpregchance]";
			WaitLineBreak;
			say "     You can feel his manhood twitch and pulse with more and more of his seed being deposited into you, leaving you with a pretty nice and full sensation. Holding on to you and leaning his head against your back, Richard gets out 'That was *pant* amazing!' You pull off his still hard cock with a wet slurp, then turn around and give him a deep kiss. After spending some more time making out with the student, you leave him to pull his pants back up, unobtrusively checking for the satyrs in the meantime. Looks like they made it into the building alright. With a smile, you playfully grope Richard's butt one last time, then bid him farewell and watch as he walks back to his post. Maybe you should return here sometime later and see how this [bold type]party[roman type] develops...";
			now SatyrFratPartyStage is 6;
	else if cunts of player > 0:
		say "     Walking up to the young human man in a relaxed, nonthreatening manner, you greet him and start a conversation. As it turns out, his name is Richard and he just started out here in Tenvale College on a sports scholarship this semester. He's a running back in the football team and joined the Phi Alpha Nu fraternity as a legacy member, just like his father before him. Nevertheless, he's still low on the totem pole - which explains why he's out here on guard duty and not enjoying himself with all the others inside. He's got a bit of a wistful look in his eye as he tells you about it, finishing 'I'd love to party with the guys... err, and all the hot chicks we've got over. Yeah, love the babes on campus. Definitively.'";
		say "     That last bit was said a bit too hurriedly, a blurt of words only making clearer what he wanted to hide. His eyes wander down over your body and check it out, confirming that Richard has some interest there for both sides of the fence. Perfect, for what you're planning. Keeping him talking about what he likes in women and his past conquests, you get the football-player in a receptive mood, then smoothly compliment him on what great shape he's in. Things progress to him showing off his muscles, then you feeling and... gently stroking them, just a little bit at first, then ever bolder. Soon you're standing very close beside the young man, one hand on the growing bulge in his pants. In the most charming tone you can manage, you tell him...";
		LineBreak;
		say "     [link](1)[as]1[end link] That you want to give him a blowjob.[line break]     [link](2)[as]2[end link] That you want him to fuck you.";
		now calcnumber is 0;
		while calcnumber < 1 or calcnumber > 2:
			say "Choice? (1-2)>[run paragraph on]";
			get a number;
			if calcnumber is 1 or calcnumber is 2:
				break;
			else:
				say "Invalid choice. Type [link]1[end link] to blow him or [link]2[end link] to get fucked.";
		if calcnumber is 1:[BJ]
			say "     As wound up as you've got the athletic student, he eagerly and immediately agrees and lets himself be led around the corner of the frat-house's garage, to a nice secluded spot between several high bushes. Looking back before joining him there, you see your two satyr compatriots, grinning broadly at how you're dealing with the frat party guardian. While they start rolling their barrel on towards the goal, you pull Richard close and give him a deep kiss. His eyes widen at the sudden intimacy and he happily replies in kind. As you make out with the young man, your hands quickly undo his button and zipper, opening the way to the quite impressive tent showing at the front of his boxer shorts.";
			say "     He moans between your kisses as you slide your hands under the band of his shorts, fondling his balls and jerking him off with the other hand. Then you kneel down, pulling down his pants and shorts as you go along, freeing his well-sized manhood to dangle just before your nose. Very nicely hung, your young running back. Eager to get going, you take hold of his shaft and slowly lick up the underside of Richard's shaft, making him pant loudly in lust. Soon arriving at the tip of his manhood, you play your tongue over it, teasing his slit for a moment, then slide your lips over his cock and sink them down along its length.";
			WaitLineBreak;
			say "     While bobbing up and down on Richard's shaft, you use your hands to play with his balls, stroking and fondling to give your partner even more pleasure. At one point, you even snake a hand through between his legs, seeking out the round and firm globes of his butt to give them a good squeeze, then moving on what lies between them. Richard's pants come even quicker as you rub a finger around his pucker, which culminates in a pleasantly surprised gasp as you push it in a moment later, probing his virgin hole. Nice and tight, and you can make this strong male give a very cute little squeal when you rub his prostate. Definitively something to remember for later - though for now, you decide it'd be better to just concentrate on the blowjob.";
			say "     With you so eagerly going down on him, as well as touching and stroking his body, it's no big wonder that Richard soon gets closer and closer to orgasming. His pants and moans rise in volume and frequency until he finally gives a breathless grunt of 'I'm coming!' and blasts of his cum start filling your mouth. You feel the pleasant taste of his seed on your tongue for a moment, then swallow it down as more and more pulses out of his cock. 'That was *pant* amazing!' Richard gets out after getting himself under control again, before accepting a kiss that lets him taste his own cum a moment later.";
			WaitLineBreak;
			say "     After a bit more pretty nice making out with the student, you leave to pull his pants back up, unobtrusively checking for the satyrs in the meantime. Looks like they made it into the building alright. With a smile, you playfully grope Richard's butt one last time, then bid him farewell and watch as he walks back to his post. Maybe you should return here sometime later and see how this [bold type]party[roman type] develops...";
			now SatyrFratPartyStage is 5;
		else if calcnumber is 2:[Fuck]
			setmonster "human";
			choose row monster from the table of random critters;
			say "     As wound up as you've got the athletic student, he eagerly and immediately agrees and lets himself be led around the corner of the frat-house's garage, to a nice secluded spot between several high bushes. Looking back before joining him there, you see your two satyr compatriots, grinning broadly at how you're dealing with the frat party guardian. While they start rolling their barrel on towards the goal, you pull Richard close and give him a deep kiss. His eyes widen at the sudden intimacy and he happily replies in kind. As you make out with the young man, your hands quickly undo his button and zipper, opening the way to the quite impressive tent showing at the front of his boxer shorts.";
			say "     He moans between your kisses as you slide your hands under the band of his shorts, fondling his balls and jerking him off with the other hand. Then you kneel down, pulling down his pants and shorts as you go along, freeing his well-sized manhood to dangle just before your nose. Very nicely hung, your young running back. Eager to get going, you take hold of his shaft and slowly lick up the underside of Richard's shaft, making him pant loudly in lust. Soon arriving at the tip of his manhood, you play your tongue over it, teasing his slit for a moment, then slide your lips over his cock and sink them down along its length.";
			WaitLineBreak;
			say "     While bobbing up and down on Richard's shaft, you use your hands to play with his balls, stroking and fondling to give your partner even more pleasure. At one point, you even snake a hand through between his legs, seeking out the round and firm globes of his butt to give them a good squeeze, then moving on what lies between them. Richard's pants come even quicker as you rub a finger around his pucker, which culminates in a pleasantly surprised gasp as you push it in a moment later, probing his virgin hole. Nice and tight, and you can make this strong male give a very cute little squeal when you rub his prostate. Definitively something to remember for later - though for now, you want to get fucked yourself.";
			say "     Pulling your lips off his nice and wet shaft with a pop, you pant that it's time for him to fuck you, quickly dropping your gear and clothes to the ground before bending over for Richard. Wiggling your butt invitingly is all it takes for the young man to step up to you and put the tip of his shaft against the moist lips of your pussy. With a lustful grunt, he thrusts right in, plunging his manhood deep into you. 'Man, that feels great!' he pants as he wraps his arms around your chest from behind. Being fucked by this very eager young man, you delight in flexing your inner muscles and listening to the moaned and gasped reactions you get as you do. With him being pretty aroused, it's no big wonder that Richard soon gets closer and closer to orgasming. His pants and moans rise in volume and frequency until he finally gives a breathless grunt of 'I'm coming!' and pounds his cock into your hole one last time as it starts blasting spurt after spurt of cum.[impregchance]";
			WaitLineBreak;
			say "     You can feel his manhood twitch and pulse with more and more of his seed being deposited into you, leaving you with a pretty nice and full sensation. Holding on to you and leaning his head against your back, Richard gets out 'That was *pant* amazing!' You pull off his still hard cock with a wet slurp, then turn around and give him a deep kiss. After a bit more pretty nice making out with the student, you leave to pull his pants back up, unobtrusively checking for the satyrs in the meantime. Looks like they made it into the building alright. With a smile, you playfully grope Richard's butt one last time, then bid him farewell and watch as he walks back to his post. Maybe you should return here sometime later and see how this [bold type]party[roman type] develops...";
			now SatyrFratPartyStage is 6;
	else:
		say "     Walking up to the young human man in a relaxed, nonthreatening manner, you greet him and start a conversation. As it turns out, his name is Richard and he just started out here in Tenvale College on a sports scholarship this semester. He's a running back in the football team and joined the Phi Alpha Nu fraternity as a legacy member, just like his father before him. Nevertheless, he's still low on the totem pole - which explains why he's out here on guard duty and not enjoying himself with all the others inside. He's got a bit of a wistful look in his eye as he tells you about it, finishing 'I'd love to party with the guys... err, and all the hot chicks we've got over. Yeah, love the babes on campus. Definitively.'";
		say "     That last bit was said a bit too hurriedly, a blurt of words only making clearer what he wanted to hide. His eyes wander down over your body and check it out, confirming that Richard has some interest there for both sides of the fence. Perfect, for what you're planning. Keeping him talking about what he likes in women and his past conquests, you get the football-player in a receptive mood, then smoothly compliment him on what great shape he's in. Things progress to him showing off his muscles, then you feeling and... gently stroking them, just a little bit at first, then ever bolder. Soon you're standing very close beside the young man, one hand on the growing bulge in his pants. In the most charming tone you can manage, you tell him that you want to give him a blowjob.";
		WaitLineBreak;
		say "     As wound up as you've got the athletic student, he eagerly and immediately agrees and lets himself be led around the corner of the frat-house's garage, to a nice secluded spot between several high bushes. Looking back before joining him there, you see your two satyr compatriots, grinning broadly at how you're dealing with the frat party guardian. While they start rolling their barrel on towards the goal, you pull Richard close and give him a deep kiss. His eyes widen at the sudden intimacy and he happily replies in kind. As you make out with the young man, your hands quickly undo his button and zipper, opening the way to the quite impressive tent showing at the front of his boxer shorts.";
		say "     He moans between your kisses as you slide your hands under the band of his shorts, fondling his balls and jerking him off with the other hand. Then you kneel down, pulling down his pants and shorts as you go along, freeing his well-sized manhood to dangle just before your nose. Very nicely hung, your young running back. Eager to get going, you take hold of his shaft and slowly lick up the underside of Richard's shaft, making him pant loudly in lust. Soon arriving at the tip of his manhood, you play your tongue over it, teasing his slit for a moment, then slide your lips over his cock and sink them down along its length.";
		WaitLineBreak;
		say "     While bobbing up and down on Richard's shaft, you use your hands to play with his balls, stroking and fondling to give your partner even more pleasure. At one point, you even snake a hand through between his legs, seeking out the round and firm globes of his butt to give them a good squeeze, then moving on what lies between them. Richard's pants come even quicker as you rub a finger around his pucker, which culminates in a pleasantly surprised gasp as you push it in a moment later, probing his virgin hole. Nice and tight, and you can make this strong male give a very cute little squeal when you rub his prostate. Definitively something to remember for later - though for now, you decide it'd be better to just concentrate on the blowjob.";
		say "     With you so eagerly going down on him, as well as touching and stroking his body, it's no big wonder that Richard soon gets closer and closer to orgasming. His pants and moans rise in volume and frequency until he finally gives a breathless grunt of 'I'm coming!' and blasts of his cum start filling your mouth. You feel the pleasant taste of his seed on your tongue for a moment, then swallow it down as more and more pulses out of his cock. 'That was *pant* amazing!' Richard gets out after getting himself under control again, before accepting a kiss that lets him taste his own cum a moment later.";
		WaitLineBreak;
		say "     After a bit more pretty nice making out with the student, you leave to pull his pants back up, unobtrusively checking for the satyrs in the meantime. Looks like they made it into the building alright. With a smile, you playfully grope Richard's butt one last time, then bid him farewell and watch as he walks back to his post. Maybe you should return here sometime later and see how this [bold type]party[roman type] develops...";
		now SatyrFratPartyStage is 5;

Let's Party is a situation. Let's Party is resolved.
The sarea of Let's Party is "Campus".
when play begins:
	add Let's Party to badspots of guy;       [frat boys]
	add Let's Party to badspots of girl;      [sorority girls]

Instead of resolving a Let's Party:
	SatyrFratPartyVisit;
	
instead of going south from Greek Street while (SatyrFratPartyStage > 0 and SatyrFratPartyStage < 99):
	SatyrFratPartyVisit;
	
to SatyrFratPartyVisit:
	if daytimer is day: 
		say "     When you make your way to Phi Alpha Nu you see a lot of passed out people in the yard. You realize that the party is on hold for now, as everyone is getting over their killer headaches. It might be best for you to return at night when everyone's alive and awake.";
	else:
		say "     Making your way back to the Phi Alpha Nu frat house, you find that the party is still going on - and it's wilder than ever. There is no trace of [if SatyrFratRichardRelationship > 97]the guy who was guarding the entrance before[else]Richard[end if], maybe he joined the crowd inside at some point. In a bit of a partying mood yourself as you think back to the support you gave to those friendly satyrs, you walk up to the large house, up the stairs and into the open entrance door. Inside, the frat party is in full swing, with handsome guys and gals moving to the beat of loud music, drinks in their hands as they have fun dancing and talking. You do notice a definite prevalence of goatees among the men... might be that type of beard is 'in' right now - or the result of smuggling in two satyrs with a whole barrel full of changing wine.";
		say "     While your eyes are still wandering over the crowd of attractive young adults, someone calling your name draws your attention suddenly. It's Kerr, standing behind an improvised bar on the other side of the room. After gleefully filling two more plastic cups with drinks and handing them to already somewhat buzzed students, he waves you closer. Talov, the other satyr you met before, isn't in sight as you walk up to the bar - at least not until you're right at it and lean in to talk to Kerr - which is when you notice the two curved horns poking up in front of Kerr's crotch. Rhythmically moving horns, as their owner's head bobs up and down on his friend's hard shaft. Gripping Talov by the horns and giving their sensitive base a teasing rub, the standing satyr says, 'Hey T, our friend is back.' Creating a deliberate loud pop that can be heard even above the loud music, Talov pulls off the cock in his mouth and stands up, licking his lips demonstratively before giving you a beaming smile.";
		WaitLineBreak;
		say "     'Hey, nice to see you.' and 'Glad you could make it here again!' the two satyrs say loudly almost at the same time, immediately chuckling at the jumble of words that creates. A moment later, Talov gives Kerr a light slap on the brown-furred butt and tells him, 'You get back to the drinks. I'll talk with [if player is female]her[else]him[end if].' As his friend gets back to filling plastic cups with booze, the red-headed satyr gives his butt a leering stare for a moment, then he turns to you and leans over the bar so he can talk without shouting. 'Thanks for helping to get us in here. It's a fun party. But it could still be better... there's a few holdouts and we really could use someone to wind up the crowd a bit more. Wanna join us and make sure that this will be absolutely legendary?'";
		LineBreak;
		if player consents:
			LineBreak;
			say "[SatyrFratSexMenu]";
		else:
			LineBreak;
			say "     Replying that you can't, not right now, and that you only wanted to see how they were doing, you excuse yourself and leave the somewhat disappointed Talov standing at the bar. Making your way back to the entrance, you leave the crowd of young adults and the beat of their music behind and get back to the center of the campus.";

to say SatyrFratSexMenu:
	say "Replying that you're of course in on that, you turn around and let your gaze wander over the room. There's definitively a lot of possibilities here. Now where to start...";
	now sextablerun is 0;
	blank out the whole of table of fucking options;
	[]
	choose a blank row in table of fucking options;
	now title entry is "Arrange a drinking competition with some dudes";
	now sortorder entry is 1;
	now description entry is "Try to drink a few hunky guys under the table";
	[]
	choose a blank row in table of fucking options;
	now title entry is "'Accidentally' spill a drink over a guy and help him 'clean up' in the shower";
	now sortorder entry is 2;
	now description entry is "Have some fun with a frat guy once you got his clothes off";
	[]
	choose a blank row in table of fucking options;
	now title entry is "'Accidentally' spill a drink over a young woman and help her 'clean up' in the shower";
	now sortorder entry is 3;
	now description entry is "Have some fun with a sorority girl once you got her clothes off";
	[]
	if SatyrFratRichardRelationship < 90:
		choose a blank row in table of fucking options;
		now title entry is "Get it on with Richard - publicly";
		now sortorder entry is 4;
		now description entry is "Pull the guy down on a sofa right here in the room and have your way with him";
	[]
	choose a blank row in table of fucking options;
	now title entry is "Get Richard to the bar and down some satyr wine with him";
	now sortorder entry is 5;
	now description entry is "See what happens with the cute guy as he drinks the heady liquid";
	[]
	if SatyressStage > 0 and cocks of player > 0:
		choose a blank row in table of fucking options;
		now title entry is "Get it on with a sexy satyress - publicly";
		now sortorder entry is 6;
		now description entry is "Pull one of the satyress-babes in here down on a sofa right here in the room and have your way with her";
	[]
	if cocks of player > 0:
		choose a blank row in table of fucking options;
		now title entry is "Pick up a sexy sorority girl and fuck her";
		now sortorder entry is 7;
		now description entry is "Charm your way into a hot young student's panties";
	[]
	sort the table of fucking options in sortorder order;
	repeat with y running from 1 to number of filled rows in table of fucking options:
		choose row y from the table of fucking options;
		say "[link][y] - [title entry][as][y][end link][line break]";
	say "[link]100 - Nevermind[as]100[end link][line break]";
	while sextablerun is 0:
		say "Pick the corresponding number> [run paragraph on]";
		get a number;
		if calcnumber > 0 and calcnumber <= the number of filled rows in table of fucking options:
			now current menu selection is calcnumber;
			choose row calcnumber in table of fucking options;
			say "[title entry]: [description entry]?";
			if player consents:
				let nam be title entry;
				clear the screen and hyperlink list;
				now sextablerun is 1;
				if nam is "Arrange a drinking competition with some dudes":
					say "[SatyrFratSex1]";
				if nam is "'Accidentally' spill a drink over a guy and help him 'clean up' in the shower":
					say "[SatyrFratSex2]";
				if nam is "'Accidentally' spill a drink over a young woman and help her 'clean up' in the shower":
					say "[SatyrFratSex3]";
				if nam is "Get it on with Richard - publicly":
					say "[SatyrFratSex4]";
				if nam is "Get Richard to the bar and down some satyr wine with him":
					say "[SatyrFratSex5]";
				if nam is "Get it on with a sexy satyress - publicly":
					say "[SatyrFratSex6]";
				if nam is "Pick up a sexy sorority girl and fuck her":
					say "[SatyrFratSex7]";
				wait for any key;
		else if calcnumber is 100:
			say "Break off?";
			if the player consents:
				now sextablerun is 1;
				say "     You change your mind, and tell Talov that you only wanted to see how they were doing, then excuse yourself and leave the somewhat disappointed satyr standing at the bar. Making your way back to the entrance, you leave the crowd of young adults and the beat of their music behind and get back to the center of the campus.step back from the SatyrFratNPC, shaking your head slightly as he gives a questioning look.";
				wait for any key;
			else:
				say "Pick between 1 and [the number of filled rows in the table of fucking options] or 100 to exit.";
		else:
			say "Invalid Option. Pick between 1 and [the number of filled rows in the table of fucking options].";
		clear the screen and hyperlink list;

to say SatyrFratSex1: [drinking]
	say "     Snatching a freshly filled drink from the bar in front of Kerr, you shout out 'Phi Alpha Nu Forever!' and down the cup, drawing a loud cheer from everyone in the room. Now that you've got their attention, you go through a little spiel of praising their accomplishments (getting things mostly right by bringing up what you see on trophies and flags on the wall) - but also insinuating that they may or may not be able to hold their liquor. Before long, you've got three studly hunks of football players stepping forward to defend the frat's honor... and you guide em straight to the bar where a widely grinning Kerr is lining up shot glasses and cutting limes. As he fills one after another of them with golden-yellow Tequila, all four of the contestants take your places at the counter and get ready to drink.";
	say "     Surrounded by an excited and active crowd, you look at each other, three human guys and you - then the chant of 'Drink! Drink! Drink!' raises among the students. That's your cue - putting some salt on your hand and licking it off, you throw back the first shot with a single move, then hammer the glass down and bite into a slice of lime. Fire-water trickles down your throat as the sour taste hits our mouth, making you twitch and grunt out loud as warmth spreads through your insides. Yeah, that's just like it! Rolling your head from side to side, you reach out to take the next glass. Shot after shot is filled and hammered back and soon, the first of your four is out of the race, swaying for a moment before onlookers have to catch him to keep him from collapsing on the floor. With that guy half-dragged and half-stumbling to a couch, it's down to three now.";
	let bonus be (( the Stamina of the player minus 10 ) divided by 2);
	let diceroll be a random number from 1 to 20;
	say "You roll 1d20([diceroll])+[bonus]: [diceroll + bonus] (Stamina-Check vs 18)";
	increase diceroll by bonus;
	LineBreak;
	if diceroll is greater than 17: [win]
		say "     Even as the drinking continues unabated, you manage to hold your ground admirably... much better than your two neighbours whose faces redden more and more, their competitive jeers about winning getting pretty slurred in the end. Then finally, the guy to your left thunks down on the counter with his head, spilling his shot and starting to snore loudly as he hangs over the bar. Turning from him to your other drinking buddy, you're surprised by finding yourself right face to face with him, bumping into his nose with yours as he has stumbled right up to you. Suddenly his lips press against yours as he gives you a drunken smooch - which has the crowd laugh and give whistles. Since this is what you set out to do anyways, you just go with it, replying to his kiss and wrestling his tongue with yours while your hand snakes down to rub the football player's crotch.";
		say "     The making out and groping does give the crowd around you some ideas - you can see some people pairing up from the corner of your eye while you continue to kiss your college athlete. One arm around the young man, you start guiding him out of the circle of onlookers - who congratulate you and give you pats on the back. But before you can start wondering what you'll do with him once you got him in a bedroom alone, he mumbles, 'Unnngh... I thschink I... got to sitttt. Down.' Seems like this hunk is a bit too out of it to have fun with after all, so you gently lower him to a sofa to rest until his head stops spinning.";
	else: [lose]
		say "     Ungh, after that last shot, everything kinda seems to sway around you and you have trouble making out the glass on the counter in front of you. Why would Kerr fill three of them at the same time? Reaching out, you try to grab one of them - but strangely you can't... just grasping right through it - and then, you knock over the real glass and spill all the tasty Tequila. You contemplate licking it up for a second, then the thought 'Wait - what did I want to do again?' shoots through your head. Getting people wound up and partying - that's what it was! Deciding to start right away with the drinking competitor next to you, you stumble forward and throw your arms around his neck, then give the human athlete a resounding smooch on the lips.";
		say "     The guy is surprised at the sudden tongue-wrestling action he finds himself in, but he decides to go with the flow and just makes out with you a bit. You don't register too much of what's going on around - just his lips on yours - but something tells you that your plan was a success. Might be the cheering and congratulations your kissing partner is getting. After some more moments, he guides you away from the bar - to do what, you don't know. And you never will, as a seductive voice calls out to him, 'You're such a champ, Tyler! Wanna celebrate your victory up in your room?' Whoever it is, they seem to have really hit the right tone with him, as you find yourself lowered on to a sofa and then your stud is gone, off to enjoy himself with someone else.";
	LineBreak;
	say "     With the drinking competition done now, you hang out a while longer on one of the sofas in the frat house, then finally get up. Can't party all day, sadly, so you make your way to the entrance and walk back to the campus center.";

to say SatyrFratSex2:
	setmonster "Satyr";
	choose row monster from the table of random critters;
	say "     Leaning in close over the counter, you ask him where the next shower in here is - as it turns out, just down one short hallway behind the door at the end. Equipped with that important knowledge for your plan, you let Kerr fill two plastic cups. One with the most sticky and sweet drink he has in his repertoire, the other with pure, undiluted satyr wine. Holding both cups in your hands, you then set out to find a mark. Moving through the big living room, then the adjoining kitchen, it doesn't take long till you spot a handsome stud of a college jock - leaning against a wall with a pretty indifferent expression towards all the people enjoying themselves all around. Perfect.";
	say "     You let your feet carry you towards the guy, then 'accidentally' stumble when you get next to him. Splashing the young man with the contents of both cups, you're even fairly accurate - hitting his chest with the satyr wine and his face and neck with the soda. 'What the hell? Eww - I'm all sticky - and you got this crap in my eyes,' your hapless victim shouts, wiping at his face with both hands and keeping his eyes clenched. Apologizing profusely, you take him by the arm and say that you'll of course help him clean up, then guide the student down the hall and into the thankfully empty bathroom. Locking the door behind you so you're not disturbed, you tell the college athlete to stand still for a moment and get a shower running, nice and warm, then get into the cabin right with him.";
	WaitLineBreak;
	say "     While the frat member holds his head under the spray and rubs the stickiness off his face, you grab hold of his shirt. With the excuse of 'getting that stained thing off him', you pull the wet fabric up and over his head, revealing the young man's muscular chest. What it also reveals is that the satyr wine is already showing some effect - even with external application. From what you can see, this guy kept himself shaved of body hair, though that is changing fast now. Before your very eyes, hair sprout from his skin, forming a light layer of chest hair and looking almost identical to Kerr's manly curls. Blinking his by now mostly washed out eyes, the athlete looks down at his chest in befuddlement, then at you and the shirt in your hands.";
	say "     'What the -' ...is as far as you let the young man get before going in for the kill - silencing him with a long and deep kiss while pressing your body against his. There is a short moment of hesitation and surprise in which his eyes widen in shock, then he's past the point of no return and starts to eagerly reply to your tongue wriggling in his mouth. As you give him kiss after kiss, there is a small tingle against your skin - caused by a rapidly growing goatee on your college jock's chin. Bringing a hand up to stroke over the soft hair, you tell him it suits him well (which it actually does) and continue to make out with him while your hands get busy on his pants.";
	WaitLineBreak;
	say "     Undoing the button of your transforming stud's jeans, you slide a hand inside them, feeling around for his family jewels. Oho - he's already a bit more than half-hard for you and a nice little handful of balls to go with it - no, can strike that 'little' from your mind as you feel them shift under your fingers, becoming fuller, bigger and more than a little furry. Wanting to see if his cock changed too, you proceed to lower the zipper of his pants and slide them down, revealing a nice and hard - but still completely human cock. Hm, seems like you'll have to get your college boy's juices flowing to speed things along.";
	if cocks of player > 0:
		say "     Do you want to let him fuck you ([link]Y[as]y[end link]), or would you rather pound the guy in the ass yourself ([link]N[as]n[end link])?";
		if player consents:
			say "     After stroking your new friend's cock for a second, you take a step away from him and quickly strip, just throwing your gear and clothes aside in your eagerness to get it on with the handsome guy. And he's more than just a little willing to do so, as he is watching your naked body with a hungry gaze and his manhood stands fully erect by now. 'I don't know what's happening, but it feels great!' the jock pants loudly and steps forward, wrapping his arms around you. Your lips meet as eager hands wander over your body, then the horny college stud pulls you under the warm flow of the still-running shower. Being kissed and stroked by a handsome guy, your arousal skyrockets and soon, you moan for him to take you - right here, right now, against the shower wall.";
			WaitLineBreak;
			say "     'Oh yeah, baby,' the guy gives a breathless pant, then his strong arms start to slide down the sides of your body, following every curve. He hooks his hands under your thighs and lifts you up, holding you with your back pressed against the tiled wall. The transforming student's lips brush against yours in the very moment that his pre-cum dripping erection nudges against your asshole - and a second later, he's balls-deep inside your butt and giving you an amazing kiss at the same time. The wet and wild coupling that follows is a constant assault on your senses, with your handsome stud pounding your butt in a lustful frenzy and you barely getting in a second to take a breath during an epic make-out session with the guy.";
			say "     While the exact order of things is slightly hazy in your recollection, you clearly remember the moment as small and nubby horns push out of the athlete's forehead - with him barely even noticing. At one point after that, the sound of hooves on the tiled floor of the shower becomes noticeable for the first time, soon followed by the interesting feeling of having a cock change shape inside your body. Suddenly having that goat-like shaft rubbing your inner walls drives you to new heights quickly ...and before much longer, you come hard - together with a by now completely transformed frat member.[mimpregchance]";
			WaitLineBreak;
			say "     Breathing heavily as his cock pulses with blast after blast of fertile seed shooting into your insides, just like your own [cock of player] shaft splashes your cum all over your chest, the newly minted satyr holds on to you for a while yet, then eventually gives you a last kiss and lowers you back on your own feet slowly. 'Wow! That was am-az-ing! I'd have gone on more of these parties if I had known that sexy babes just drag you into a room and fuck your brains out!' he tells you with a goofy grin on his face. A moment after that, his brows suddenly draw together in puzzlement and he looks down, really noticing his now furred legs for the first time. 'Wait - what's this? Hooves? Kewl! I've got to show this to Dave and Bobby, they won't believe their eyes!'";
			say "     With that said, the student gives you a quick kiss on the cheek and with little more than a 'Thanks dude', he's out of the door to join the partying crowd again. As he never thought to stop for his clothes or even a towel, you bet that he'll be quite a surprise for his friends - as a wet and naked satyr with cum still dripping from his goat-like cock. Well, Kerr and Talov wanted you to mix things up - Mission Accomplished you'd say!";
			WaitLineBreak;
			say "     Unlike your over-excited stud, you do dry yourself off and put your clothes back on before you make your way out of the bathroom. Back in the main room of the frat house, you don't see the new satyr you helped create - but the thumbs-up and grin that Talov shows tells you that he made a nice big splash. Content with a job well done, you walk back towards the entrance and leave - for now. A voice inside you tells you to just stay, but you can't - you've got to work at it if you want to survive in this ever-changing crazy world.";
		else:
			say "     After stroking your new friend's cock for a second, you take a step away from him and quickly strip, just throwing your gear and clothes aside in your eagerness to get it on with the handsome guy. And he's more than just a little willing to do so, as he is watching your naked body with a hungry gaze and his manhood stands fully erect by now. 'I don't know what's happening, but it feels great!' the jock pants loudly and steps forward, wrapping his arms around you. Your lips meet as eager hands wander over your body, then the horny college stud pulls you under the warm flow of the still-running shower. Being kissed and stroked by a handsome guy, your arousal skyrockets and soon, you moan that you want to fuck him - right here, right now, against the shower wall.";
			WaitLineBreak;
			say "     'I'm not gay - or... I wasn't... wait -,' the guy says with confusion in his voice as he really thinks about what you've been doing for the first time since you got him all alone. Not willing you let this handsome stud slip out of your grasp, you quickly push him against the wall and kiss him again, then let your hands wander down over the muscled curves of his body. Hooking your hands under his thighs, you lift the frat guy up, holding him with his back pressed against the tiled wall. The transforming student's lips brush against yours in a followup kiss just as your pre-cum dripping erection nudges against his asshole. An eye-blink later, you're thrusting deep into his butt and giving him an amazing kiss at the same time. The wet and wild coupling that follows is a constant assault on your senses, with his clenching hole around your shaft, those soft lips against yours and comfortably warm water spraying down over you.";
			say "     While the exact order of things is slightly hazy in your recollection, you clearly remember the moment as small and nubby horns push out of the athlete's forehead - with him barely even noticing - well, how could he... with his eyes rolled back as he gasps at an especially deep thrust you did. Not long after that, his legs become much more furry under your hands and you can see human feet change to hooves from the corner of your eye. Interestingly, the young man's cock is the last thing to go, the last little bit of humanity he kept to the end - until it suddenly shifts as well, re-forming into a goat's penis. The sensation of completing his transformation is what drives him over the edge, and with a breathless moan, the frat member starts shooting cum all over his own chest. You're not long after him yourself, as the student's twitching and flexing asshole gives the last little push you needed.";
			WaitLineBreak;
			say "     Breathing heavily as your cock pulses with blast after blast of fertile seed shooting into his insides, you hold the newly minted satyr for a while longer, then eventually give him a last kiss and lower him to stand back on his own two... hooves. 'Wow! That was am-az-ing! I - I guess I'm bi after all. Maybe I should have gone on more of these parties - who knew a handsome guy would just drag you into a room and fuck your brains out!' he tells you with a goofy grin on his face. A moment after that, his brows suddenly draw together in puzzlement and he looks down, really noticing his now furred legs for the first time. 'Wait - what's this? Hooves? Kewl! I've got to show this to Dave and Bobby, they won't believe their eyes!'";
			say "     With that said, the student gives you a quick kiss on the cheek and with little more than a 'Thanks dude', he's out of the door to join the partying crowd again. As he never thought to stop for his clothes or even a towel, you bet that he'll be quite a surprise for his friends - as a wet and naked satyr with cum still dripping out of his furry butt. Well, Kerr and Talov wanted you to mix things up - 'Mission Accomplished' one could say!";
			WaitLineBreak;
			say "     Unlike your over-excited stud, you do dry yourself off and put your clothes back on before you make your way out of the bathroom. Back in the main room of the frat house, you don't see the new satyr you helped create - but the thumbs-up and grin that Talov shows tells you that he made a nice big splash. Content with a job well done, you walk back towards the entrance and leave - for now. A voice inside you tells you to just stay, but you can't - you've got to work at it if you want to survive in this ever-changing crazy world.";
	else:
		if cunts of player > 0:
			say "     After stroking your new friend's cock for a second, you take a step away from him and quickly strip, just throwing your gear and clothes aside in your eagerness to get it on with the handsome guy. And he's more than just a little willing to do so, as he is watching your naked body with a hungry gaze and his manhood stands fully erect by now. 'I don't know what's happening, but it feels great!' the jock pants loudly and steps forward, wrapping his arms around you. Your lips meet as eager hands wander over your body and the horny college stud pulls you under the warm flow of the still-running shower. Being kissed and stroked by a handsome stud, your arousal skyrockets and soon, you moan for him to take you - right here, right now, against the shower wall.";
			WaitLineBreak;
			say "     'Oh yeah, baby,' the guy gives a breathless pant, then his strong arms start to slide down the sides of your body, following every curve. He hooks his hands under your thighs and lifts you up, holding you with your back pressed against the tiled wall. The transforming student's lips brush against yours in the very moment that his erection nudges apart your nethers - and a second later, he's balls-deep inside your pussy and giving you an amazing kiss at the same time. The wet and wild coupling that follows is a constant assault on your senses, with your handsome stud pounding deep into your pussy in a lustful frenzy and you barely getting in a second to take a breath during an epic make-out session with the guy.";
			say "     While the exact order of things is slightly hazy in your recollection afterwards, you clearly remember that sometime after your first orgasm, small and nubby horns pushed out of the athlete's forehead - and that he barely even noticed, being so totally focused on fucking you. At some point after that, the sound of hooves on the tiled floor of the shower became noticeable for the first time, soon followed by the interesting feeling of having a cock change shape inside your body. The changed sensations of suddenly having that goat-like shaft fucking your pussy drove you to new heights quickly and before much longer, you came again - together with a by then completely transformed frat member.[fimpregchance]";
			WaitLineBreak;
			say "     Breathing heavily as his cock pulses with blast after blast of fertile seed shooting into your womb, the newly minted satyr holds on to you for a while yet, then eventually gives you a last kiss and lowers you back on your own feet slowly. 'Wow! That was am-az-ing! I'd have gone on more of these parties if I had known that sexy babes just drag you into a room and fuck your brains out!' he tells you with a goofy grin on his face. A moment after that, his brows suddenly draw together in puzzlement and he looks down, really noticing his now furred legs for the first time. 'Wait - what's this? Hooves? Kewl! I've got to show this to Dave and Bobby, they won't believe their eyes!'";
			say "     With that said, the student gives you a quick kiss on the cheek and with little more than a 'Thanks babe', he's out of the door to join the partying crowd again. As he never thought to stop for his clothes or even a towel, you bet that he'll be quite a surprise for his friends - as a wet and naked satyr with cum still dripping from his half-hard goat-like cock. Well, Kerr and Talov wanted you to mix things up - 'Mission Accomplished' one could say!";
			WaitLineBreak;
			say "     Unlike your over-excited stud, you do dry yourself off and put your clothes back on before you make your way out of the bathroom. Back in the main room of the frat house, you don't see the new satyr you helped create - but the thumbs-up and grin that Talov shows tells you that he made a nice big splash. Content with a job well done, you walk back towards the entrance and leave - for now. A voice inside you tells you to just stay, but you can't - you've got to work at it if you want to survive in this ever-changing crazy world.";
		else:
			say "     After stroking your new friend's cock for a second, you take a step away from him and quickly strip, just throwing your gear and clothes aside in your eagerness to get it on with the handsome guy. And he's more than just a little willing to do so, as he is watching your naked body with a hungry gaze and his manhood stands fully erect by now. 'I don't know what's happening, but it feels great!' the jock pants loudly and steps forward, wrapping his arms around you. Your lips meet as eager hands wander over your body, then the horny college stud pulls you under the warm flow of the still-running shower. Being kissed and stroked by a handsome guy, your arousal skyrockets and soon, you moan for him to take you - right here, right now, against the shower wall.";
			WaitLineBreak;
			say "     'Oh yeah, baby,' the guy gives a breathless pant, then his strong arms start to slide down the sides of your body, following every curve. He hooks his hands under your thighs and lifts you up, holding you with your back pressed against the tiled wall. The transforming student's lips brush against yours in the very moment that his pre-cum dripping erection nudges against your asshole - and a second later, he's balls-deep inside your butt and giving you an amazing kiss at the same time. The wet and wild coupling that follows is a constant assault on your senses, with your handsome stud pounding your butt in a lustful frenzy and you barely getting in a second to take a breath during an epic make-out session with the guy.";
			say "     While the exact order of things is slightly hazy in your recollection, you clearly remember the moment as small and nubby horns push out of the athlete's forehead - with him barely even noticing. At one point after that, the sound of hooves on the tiled floor of the shower becomes noticeable for the first time, soon followed by the interesting feeling of having a cock change shape inside your body. Suddenly having that goat-like shaft rubbing your inner walls drives you to new heights quickly ...and before much longer, you come hard - together with a by now completely transformed frat member.[mimpregchance]";
			WaitLineBreak;
			say "     Breathing heavily as his cock pulses with blast after blast of fertile seed shooting into your insides, the newly minted satyr holds on to you for a while yet, then eventually gives you a last kiss and lowers you back on your own feet slowly. 'Wow! That was am-az-ing! I'd have gone on more of these parties if I had known that sexy babes just drag you into a room and fuck your brains out!' he tells you with a goofy grin on his face. A moment after that, his brows suddenly draw together in puzzlement and he looks down, really noticing his now furred legs for the first time. 'Wait - what's this? Hooves? Kewl! I've got to show this to Dave and Bobby, they won't believe their eyes!'";
			say "     With that said, the student gives you a quick kiss on the cheek and with little more than a 'Thanks dude', he's out of the door to join the partying crowd again. As he never thought to stop for his clothes or even a towel, you bet that he'll be quite a surprise for his friends - as a wet and naked satyr with cum still dripping from his goat-like cock. Well, Kerr and Talov wanted you to mix things up - 'Mission Accomplished' one could say!";
			WaitLineBreak;
			say "     Unlike your over-excited stud, you do dry yourself off and put your clothes back on before you make your way out of the bathroom. Back in the main room of the frat house, you don't see the new satyr you helped create - but the thumbs-up and grin that Talov shows tells you that he made a nice big splash. Content with a job well done, you walk back towards the entrance and leave - for now. A voice inside you tells you to just stay, but you can't - you've got to work at it if you want to survive in this ever-changing crazy world.";

to say SatyrFratSex3:
	setmonster "Satyress";
	if SatyressStage is 0:
		repeat with y running from 1 to number of filled rows in table of random critters:
			choose row y in table of random critters;
			if name entry is "Satyress":
				now monster is y;
				now area entry is "Campus";
				now non-infectious entry is false;
				break;
		now SatyressStage is 1;
	choose row monster from the table of random critters;
	say "     Leaning in close over the counter, you ask him where the next shower in here is - as it turns out, just down one short hallway behind the door at the end. Equipped with that important knowledge for your plan, you let Kerr fill two plastic cups. One with the most sticky and sweet drink he has in his repertoire, the other with pure, undiluted satyr wine. Holding both cups in your hands, you then set out to find a mark. Moving through the big living room, then the adjoining kitchen, it doesn't take long till you spot a blond beauty of a sorority girl - leaning against a wall with a pretty indifferent expression towards all the people enjoying themselves all around. Perfect.";
	say "     You let your feet carry you towards the young woman, then 'accidentally' stumble when you get next to her. Splashing the attractive student with the contents of both cups, you're even fairly accurate - hitting her chest with the satyr wine and her face and neck with the soda. 'You klutz! Eww - I'm all sticky - and you got this crap in my eyes,' your hapless victim shouts, wiping at her face with both hands and keeping her eyes tightly clenched. Apologizing profusely, you take her by the arm and say that you'll of course help to clean up, then guide the student down the hall and into the thankfully empty bathroom. Locking the door behind you so you're not disturbed, you tell the sorority girl to stand still for a moment and get a shower running, nice and warm, then get into the cabin right with her.";
	WaitLineBreak;
	say "     While the young woman holds her head under the spray and rubs the stickiness off her face, you grab hold of her shirt. With the excuse of 'getting that stained thing off her', you pull the wet fabric up and over her head, revealing the young woman's shapely chest and two perky breasts held by a black bra. The undergarment is of course also soaked through, so you quickly release its clasp at the back and let it fall away, freeing her rounded orbs to swing freely in an enticing show. Another thing you notice is that the satyr wine is already showing some effect - even with external application. It's slight at first, some minor blemishes of her skin vanishing and the nipples growing a tiny but, but the effects spreads further and further rapidly. Blinking her by now mostly washed-out eyes, the sorority girl looks down at her chest in befuddlement, then at you and the shirt in your hands.";
	say "     'What the -' ...is as far as you let the young woman get before going in for the kill - silencing her with a long and deep kiss while pressing your body against hers. There is a short moment of hesitation and surprise in which her eyes widen in shock, then she's past the point of no return and starts to eagerly reply to your tongue wriggling in her mouth. As you give her kiss after kiss, there is a small movement that you make out from the corner of your eyes - which turns out to be the two little horns starting to sprout from her forehead. Bringing a hand up to stroke over the nubby protrusions and rubbing the pleasantly sensitive spot at their base, you tell her they're a good look (which they really are, complimenting her beautiful features) and continue to make out with her while your hands get busy on her pants.";
	WaitLineBreak;
	say "     Undoing the button of your transforming girl's jeans, you slide a hand inside them, feeling around for her sex. Oho - she's already pretty wet down there, growing arousal making itself known by causing her pussy lips to swell and part a little, preparing her body for sex. The soft brush of hair against your hand tells you that there's something else going on in her pants too. Wanting to check it out, you proceed to lower the zipper of her pants and slide them down, revealing that a coat of fur is spreading downwards from her hips - a bit hesitantly though, and fairly thin. Hm, seems like you'll have to get your sorority girl's juices flowing to speed things along.";
	if cocks of player > 0:
		say "     ([link]Y[as]y[end link]) Fuck her.";
		say "     ([link]N[as]n[end link]) Finger her some more.";
		if player consents:
			say "     After stroking over your new friend's sensitive clit for a second, you take a step away from her and quickly strip, just throwing your gear and clothes aside in your eagerness to get it on with the beautiful woman. And she's more than just a little willing to do so, as she watches you strip with a hungry gaze. 'I don't know what's happening, but it feels great!' the sorority girl pants loudly and steps forward, wrapping her arms around you. Your lips meet as eager hands wander over your body, then the horny college student pulls you under the warm flow of the still-running shower. Being kissed and stroked by a handsome girl, your arousal skyrockets and soon, you moan that you want to fuck her - right here, right now, against the shower wall.";
			WaitLineBreak;
			say "     'That's - pretty fast. I mean... I don't even know your name and -,' the girl says with some hesitation in her voice as she really thinks about what you've been doing for the first time since you got her all alone. Not willing you let this pretty woman slip out of your grasp, you quickly push her against the wall and kiss her again, then let your hands wander down over the curves of her body. Hooking your hands under her thighs, you lift the sorority girl up, holding her with his back pressed against the tiled wall. The transforming student's lips brush against yours in a follow-up kiss just as your pre-cum dripping erection nudges against her moist pussy. An eye-blink later, you're thrusting deep into her womanly passage and giving her an amazing kiss at the same time. The wet and wild coupling that follows is a constant assault on your senses, with her clenching hole around your shaft, those soft lips against yours and comfortably warm water spraying down over you.";
			say "     While the exact order of things is slightly hazy in your recollection, you clearly remember the moment a little goat-tail forms above her ass, just where you're holding her with one of your hands. The young woman barely even notices - well, how could she... with her eyes rolled back as she gasps at an especially deep thrust you did. Not long after that, her legs become much more furry under your hands and you can see human feet change to hooves from the corner of your eye. Interestingly, the young woman's pussy stays its familiar shape, a holdout of humanity below her belt-line. The sensation of completing her transformation is what drives the newly made satyress over the edge, and with a breathless moan, the sorority girl starts squirting femcum all over your crotch. You're not long after her yourself, as the student's twitching and flexing pussy gives the last little push you needed.";
			WaitLineBreak;
			say "     Breathing heavily as your cock pulses with blast after blast of fertile seed shooting into her insides, you hold the newly minted satyr for a while longer, then eventually give her a last kiss and lower her to stand back on her own two... hooves. 'Wow! That was am-az-ing! I - WOW! Maybe I should have gone on more of these parties - who knew a handsome guy would just drag you into a room and fuck your brains out!' she tells you with a goofy grin on her face. A moment after that, her brows suddenly draw together in puzzlement and she looks down, really noticing her now furred legs for the first time. 'Wait - what's this? Hooves? Kewl! I've got to show this to Jenny and Bobby, they won't believe their eyes!'";
			say "     With that said, the student gives you a quick kiss on the cheek and with little more than a 'Thanks [if cunts of player > 0 and cocks of player is 0]dudette[else]dude[end if]', she's out of the door to join the partying crowd again. As she never thought to stop for her clothes or even a towel, you bet that she'll be quite a surprise for her friends - as a wet and naked satyr with cum still dripping out of her furry butt. Well, Kerr and Talov wanted you to mix things up - 'Mission Accomplished' one could say!";
			WaitLineBreak;
			say "     Unlike your over-excited satyress, you do dry yourself off and put your clothes back on before you make your way out of the bathroom. Back in the main room of the frat house, you don't see the new satyr you helped create - but the thumbs-up and grin that Talov shows tells you that she made a nice big splash. Content with a job well done, you walk back towards the entrance and leave - for now. A voice inside you tells you to just stay, but you can't - you've got to work at it if you want to survive in this ever-changing crazy world.";
		else:
			say "     [SatyressShowerFingering]";
	else:
		say "     [SatyressShowerFingering]";

to say SatyressShowerFingering:
	say "     After stroking over your new friend's sensitive clit for a second, you take a step away from her and quickly strip, just throwing your gear and clothes aside in your eagerness to get it on with the beautiful woman. And she's more than just a little willing to do so, as she watches you strip with a hungry gaze. 'I don't know what's happening, but it feels great!' the sorority girl pants loudly and steps forward, wrapping her arms around you. Your lips meet as eager hands wander over your body, then the horny college student pulls you under the warm flow of the still-running shower. Being kissed and stroked by a pretty girl, your arousal skyrockets and soon, you moan and put a hand on her pussy, dipping in a finger between her open lips.";
	WaitLineBreak;
	say "     'That's - pretty fast. I mean... I don't even know your name and -,' the girl says with some hesitation in her voice as she really thinks about what you've been doing for the first time since you got her all alone. Not willing you let this pretty woman slip out of your grasp, you quickly push her against the wall and kiss her again, then let your hands wander over the curves of her body, stroking and caressing. A few moments later you're back at her crotch, rubbing the sensitive clit of her pussy, then slipping several fingers inside while your thumb remains on the magic button. Finger-fucking her and making out like there's no tomorrow, you press the young woman with her back against the tiled wall. The transforming student's lips part to let your tongue into her mouth and the two of you french kiss deeply. The wet and wild fun-time that follows is a constant assault on your senses, with her clenching opening warm end wet around your fingers, those soft lips against yours and comfortably warm water spraying down over you.";
	say "     While the exact order of things is slightly hazy in your recollection, you clearly remember the moment a little goat-tail forms above her ass, just where you're holding her with one of your hands. The young woman barely even notices - well, how could she... with her eyes rolled back as she gasps at you stroking over an especially sensitive spot deep inside her pussy. Not long after that, her legs become much more furry as the blond curls of her coat fully form. A quick glance down reveals that her human feet change to hooves at about the same time. Interestingly, the young woman's pussy stays its familiar shape, a holdout of humanity below her belt-line. The sensation of completing her transformation is what drives the newly made satyress over the edge, and with a breathless moan, the sorority girl starts squirting femcum all over your hand.";
	WaitLineBreak;
	say "     Breathing heavily as your cock pulses with blast after blast of fertile seed shooting into her insides, you hold the newly minted satyr for a while longer, then eventually give her a last kiss and lower her to stand back on her own two... hooves. 'Wow! That was am-az-ing! I - WOW! Maybe I should have gone on more of these parties - who knew a handsome [if cunts of player > 0 and cocks of player is 0]woman[else]guy[end if] would just drag you into a room and get you off like THAT!' she tells you with a goofy grin on her face. A moment after that, her brows suddenly draw together in puzzlement and she looks down, really noticing her now furred legs for the first time. 'Wait - what's this? Hooves? Kewl! I've got to show this to Jenny and Bobby, they won't believe their eyes!'";
	say "     With that said, the student gives you a quick kiss on the cheek and with little more than a 'Thanks [if cunts of player > 0 and cocks of player is 0]dudette[else]dude[end if]', she's out of the door to join the partying crowd again. As she never thought to stop for her clothes or even a towel, you bet that she'll be quite a surprise for her friends - as a wet and naked satyr in a still very aroused state. Well, Kerr and Talov wanted you to mix things up - 'Mission Accomplished' one could say!";
	WaitLineBreak;
	say "     Unlike your over-excited satyress, you do dry yourself off and put your clothes back on before you make your way out of the bathroom. Back in the main room of the frat house, you don't see the new satyr you helped create - but the thumbs-up and grin that Talov shows tells you that she made a nice big splash. Content with a job well done, you walk back towards the entrance and leave - for now. A voice inside you tells you to just stay, but you can't - you've got to work at it if you want to survive in this ever-changing crazy world.";

to say SatyrFratSex4: [Bj for Richard]
	if SatyrFratRichardRelationship < 4: ['regular Richard']
		setmonster "human";
		say "     Letting your eyes wander over the crowd of partying students, you spot your perfect mark - Richard, the hunk you encountered when you helped your satyr friends get in here. He's standing over near one of the sofas in the room, moving to the beat of the music. Not wanting to risk anyone else honing in on the handsome guy, you quickly grab a cup of satyr wine and make your way over to him, dodging between the frat guys and girls in between. As you suddenly step up close to Richard, his eyes go wide and cheeks go red as he remembers your last encounter, then he catches himself and readily accepts the plastic cup from you. In between taking short nips, then larger swallows from the potent drink, he says, 'Hey, thanks! Er... nice to see you again. I got bored waiting for the guy to relieve me because he never came - guess guard duty isn't all that important if no one else cares, hm?'";
		if SatyrFratRichardRelationship is 2:
			say "     You exchange some sentences of small talk about the party with Richard, then casually lean in against him and place your hand on his crotch, right on the noticeable bulge he's already sporting thanks to the satyr wine. He falls silent for a second, moaning quietly as you openly rub his erection through the pants. As you're not even trying to hide what you're doing, it doesn't take long before a [one of]sorority girl[or]frat guy[at random] dancing nearby calls out, 'Seems like Richard is really enjoying the party!' The muscular student turns crimson red in the face, then clears his throat and stutters to you, 'Let - let's go to my room upstairs and -' And that's how far you let him get before pulling his head to yours and giving him a deep kiss. While he's distracted with your tongue wiggling against his own, you slide your hand inside his pants and take hold of his hardon.";
		else:
			say "     You exchange some sentences of small talk about the party with Richard, then casually lean in against him and place your hand on his crotch, right on the noticeable bulge he's already sporting thanks to the satyr wine. He falls silent for a second, moaning quietly as you openly rub his erection through the pants. As you're not even trying to hide what you're doing, it doesn't take long before a [one of]sorority girl[or]frat guy[at random] dancing nearby calls out, 'Seems like Richard is really enjoying the party!' A wide grin spreads over the muscular student's face as he looks over to the commenter and replies, 'Oh yeah - you should try it sometime. Lots of fun in public!' And that's how far you let him get before pulling his head to yours and giving him a deep kiss. While he's distracted with your tongue wiggling against his own, you slide your hand inside his pants and take hold of his hardon.";
		WaitLineBreak;
		say "     In between your continuing stimulation and the satyr wine unfolding its effects more and more, Richard is more than ready to fuck you right on this very spot. By the time you pull back and allow him to take moaned breaths again, he helps eagerly when you start undoing his pants. An eye-blink later, the young man's erect cock is proudly dangling in view of anyone caring to look, causing a series of whoops and hollers from the watching party-goers. One hand wrapped around the ultimate joy-stick to control a man, you proceed to slowly walk Richard backwards until he reaches the nearby sofa. Giving a soft but firm push against his chest, you make him sit, then sink down on your knees and start bobbing your head with its lips wrapped around his hard pole.";
		say "     The shout, 'Hey look, Richard's getting a BJ,' is repeated several times, bringing more and more onlookers and turning the sexually charged atmosphere in here decidedly hotter. There's a few calls of, 'Hey [if cunts of player > 0]baby[else]stud[end if], you're gonna do me next, right?' and 'Way to go, Richard - scoring at your first party!' - but as you pull off his manhood with a loud pop and start to take off your own clothes, something of a shocked silence falls over the would-be commenters. When you're completely naked and start to climb on top of the sofa - and Richard, one guy gasps, barely audible above the loud music, 'No way! Is [if cunts of player > 0]she[else]he[end if] gonna - WOOOW!' A mixed cheer and aroused sigh goes through the crowd as you sink your [if cunts of player > 0]pussy[else]asshole[end if] down on Richard's nice and wet cock in one fell swoop.";
		WaitLineBreak;
		say "     Once fully impaled on his hot and hard shaft, you lean down to give Richard a hungry kiss that leads over to a breathtaking make-out session. Sharing kiss after kiss while you can feel the beat of his heart though the erect manhood deep inside you makes you blank out everything around and totally concentrate on pleasing Richard. 'So good! So tight! Yeah!' he gasps out in between more kisses as you start rotating your hips and slide up and down on his shaft. After a while of fucking yourself with the athlete's cock, he suddenly wraps his arms tightly around your chest, then partly rises and turns the two of you around, putting you under him, with your back to the cushions now. You've got a second to register the shout of, 'Yeah, show [if cunts of player > 0]her[else]him[end if] what a real Phi Alpha Nu member is like!', then your mind explodes in bliss as Richard's cock pounds into you all the way until his balls slap your crotch.";
		say "     'Man, I love your hot hole around my shaft!' he grunts with lust in his voice, then pulls back and thrusts in again... and again... and again, really hammering you with a relentless rhythm that has you howling and twitching from the sensations it gives you. Being fucked by this very eager young man, you delight in his impressive stamina, keeping you in a state of almost constantly rising arousal. Each time he starts moving in again, you flex your inner muscles and listen to the moaned and gasped reactions that follow, playfully working at being the best he ever had. With this being a totally hot public fuck, it's no big wonder that Richard soon gets closer and closer to orgasming. His pants and moans rise in volume and frequency until he finally gives a hoarse bellow of 'I'm coming!' and pounds his cock into your hole one last time as it starts blasting spurt after spurt of cum. Your own orgasm was just teetering on the brink itself, so you join Richard in climax as feeling the first splash of his seed inside you pushes you over the edge too.[impregchance]";
		WaitLineBreak;
		say "     Breathlessly lying under the college age hunk that you just had very public sex with, you look down over yourself, [if cocks of player > 0]splattered all over chest with your own cum[else if cunts of player > 0]all sweaty and dripping femcum from your pussy[else]all sweaty as you are[end if], then up at the still panting and widely grinning Richard and finally at the crowd of people in the room. With the show being over now, they mostly turned back to dancing, although you can see several couples making out, as well as a blowjob between two guys going on over there in the corner. Mission accomplished, one could say...";
		say "     Richard stays inside you for a while longer, enjoying the feeling of being so close to you and sharing a few kisses, then he eventually pulls out with a sigh and says, 'You were simply amazing, baby. Wow, really.' After proceeding to help you clean up by offering his t-shirt as an impromptu towel, he later bids you farewell and goes upstairs to clean himself up too.";
		if SatyrFratRichardRelationship < 3:
			now SatyrFratRichardRelationship is 3;
	else: [satyr-transformed Richard]
		setmonster "Satyr";
		say "     Letting your eyes wander over the crowd of partying students, you spot who you're looking for right away - Richard, the hunk you encountered when you helped your satyr friends get in here. He's looking very fine in his new satyr self - standing tall on two brown-furred legs ending in hooves. His only article of clothing is the pair of navy blue trunks covering his hips, barely enough to cover his modesty as they're quite tight, especially over his crotch and the well-sized dick outlined there in the fabric. Richard's head with its magnificently curved horns nods to the beat of the music as he stands over near one of the sofas in the room. With a smile on your face, you dodge between the crowd of dancing frat guys and girls in between and go for your mark, putting an arm around his shoulders before the cute guy even knows you're there. A beaming smile spreads on his face as he looks at you, then says, 'Hey babe! Wanna party with me again?'";
		say "     You exchange some sentences of small talk about the party with Richard, then casually lean in against him and place your hand on his crotch, right on the noticeable bulge his dick is making in those trunks. He falls silent for a second, moaning quietly as you openly rub his erection through the pants - then he replies by sliding a hand behind your neck and pulling you in for a steaming hot kiss. As neither of you is even trying to hide the groping and making out, it doesn't take long before a [one of]sorority girl[or]frat guy[at random] dancing nearby calls out, 'Seems like Richard is really enjoying the party!' A wide grin spreads over the muscular satyr's face as he looks over to the commenter and replies, 'Oh yeah - you should try it sometime. Lots of fun in public!' Then he demonstratively goes for an even deeper kiss with you, tongue exploring your mouth while he bends you over with a hand on your ass. In the meantime, you slide your hand down to his hips, pulling the flexible fabric of his trunks down to reveal the student athlete's erection.";
		WaitLineBreak;
		say "     In between the continuing tongue-wrestling and you stroking Richard's cock, you feel your lust soar along with his - and soon he gives an urgent grunt of 'Wanna fuck!?' in a second when your lips aren't jammed together. Still making out in a wild rush, you push him backwards a little with an eye on a nearby sofa, the next place for urgent love-making in sight. As the two of you stumble through the dancing crowd, bumping various people out of the way, the initial complaints quickly give way to whoops and hollers as more and more party-goers become aware of your state of un-dress and sexual arousal. One hand wrapped around the ultimate joy-stick to control a man, you jerk Richard off a little while moving, then soon reach the sofa and give him a push to fall back on it. Immediately sinking to your knees between the soft-furred legs of your satyr partner, you start bobbing your head with its lips wrapped around his hard pole.";
		say "     The shout, 'Hey look, Richard's getting a BJ,' is repeated several times, bringing more and more onlookers and turning the sexually charged atmosphere in here decidedly hotter. There's a few calls of, 'Hey [if cunts of player > 0]baby[else]stud[end if], you're gonna do me next, right?' and 'Way to go, Richard - building up quite a score for your first party!' - but as you pull off his manhood with a loud pop and start to take off your own clothes, something of a shocked silence falls over the would-be commenters. When you're completely naked and start to climb on top of the sofa - and Richard, one guy gasps, barely audible above the loud music, 'No way! Is [if cunts of player > 0]she[else]he[end if] gonna - WOOOW!' A mixed cheer and aroused sigh goes through the crowd as you sink your [if cunts of player > 0]pussy[else]asshole[end if] down on Richard's nice and wet cock in one fell swoop.";
		WaitLineBreak;
		say "     Once fully impaled on his hot and hard shaft, you lean down to give Richard a hungry kiss that leads over to a breathtaking make-out session. Sharing kiss after kiss while you can feel the beat of his heart though the erect manhood deep inside you makes you blank out everything around and totally concentrate on pleasing Richard. 'So good! So tight! Yeah!' he gasps out in between more kisses as you start rotating your hips and slide up and down on his shaft. After a while of fucking yourself with the athlete's cock, he suddenly wraps his arms tightly around your chest, then partly rises and turns the two of you around, putting you under him, with your back to the cushions now. You've got a second to register the shout of, 'Yeah, show [if cunts of player > 0]her[else]him[end if] what a real Phi Alpha Nu member is like!', then your mind explodes in bliss as Richard's cock pounds into you all the way until his balls slap your crotch.";
		say "     'Man, I love your hot hole around my shaft!' he grunts with lust in his voice, then pulls back and thrusts in again... and again... and again, really hammering you with a relentless rhythm that has you howling and twitching from the sensations it gives you. Being fucked by this very eager young satyr, you delight in his impressive stamina, keeping you in a state of almost constantly rising arousal. Each time he starts moving in again, you flex your inner muscles and listen to the moaned and gasped reactions that follow, playfully working at being the best he ever had. With this being a totally hot public fuck, it's no big wonder that Richard soon gets closer and closer to orgasming. His pants and moans rise in volume and frequency until he finally gives a hoarse bellow of 'I'm coming!' and pounds his cock into your hole one last time as it starts blasting spurt after spurt of cum. Your own orgasm was just teetering on the brink itself, so you join Richard in climax as feeling the first splash of his seed inside you pushes you over the edge too.[impregchance]";
		WaitLineBreak;
		say "     Breathlessly lying under the college age hunk that you just had very public sex with, you look down over yourself, [if cocks of player > 0]splattered all over chest with your own cum[else if cunts of player > 0]all sweaty and dripping femcum from your pussy[else]all sweaty as you are[end if], then up at the still panting and widely grinning Richard and finally at the crowd of people in the room. With the show being over now, they mostly turned back to dancing, although you can see several couples making out, as well as a blowjob between two guys going on over there in the corner. Mission accomplished, one could say...";
		say "     Richard stays inside you for a while longer, enjoying the feeling of being so close to you and sharing a few kisses, then he eventually pulls out with a sigh and says, 'You were simply amazing, baby. Wow, really.' After proceeding to help you clean up by licking your chest clean, he later bids you farewell and goes upstairs to wash up himself too.";
			
to say SatyrFratSex5:
	setmonster "Satyr";
	if SatyrFratRichardRelationship < 4:
		if carried of Pan's Special Reserve < 1:
			say "     Letting your eyes wander over the crowd of partying students, you spot who you're looking for right away - Richard, the hunk you encountered when you helped your satyr friends get in here. He's standing over near one of the sofas in the room, moving to the beat of the music. With a smile on your face, you dodge between the crowd of dancing frat guys and girls in between and go for your mark, putting an arm around his shoulders before the cute guy even knows you're there. Eyes going wide and cheeks reddening as he looks over to you and remembers your last encounter, he gives a friendly smile and says, 'Hey! Er... nice to see you again. I got bored waiting for the guy to relieve me because he never came - guess guard duty isn't all that important if no one else cares, hm?'";
			say "     You couldn't agree more and invite him to share a drink with you, guiding the readily following student back to the bar a moment later. The two satyrs behind the counter greet you with wide grins, with both Kerr and Talov's eyes undressing your friend with their eyes. Richard sits down on a bar-stool just like you do, somewhat surprised at the unabashed lusty looks he is getting from the duo, then you lean in and loudly order wine for the two of you. 'Sure thing, coming right up,' one of the satyrs replies in a cheerful tone, filling first one, then another red plastic cup from the seemingly endless wine-barrel they brought along. A moment later, he hands the drinks off to you and Richard, giving the frat boy a wink as he does so.";
			WaitLineBreak;
			say "     Bringing your cup to your lips, you nip lightly as you casually watch Richard take a swallow, followed by a larger one as he tastes the potent drink. 'Mmmh, this is good stuff,' the young man comments as he finishes the cup in short notice, only to have it refilled by a widely smiling Kerr for another round of drinking. This time, you're right with him, chugging your own wine to get into the partying mood and chatting a bit with Richard as you do so. The wine keeps flowing freely as you talk, until your friend eventually says, 'You know what...' and raises his hand to his forehead. The two satyr barmen and yourself half-expect him to grow his first nubby horns now - after all the transformative wine he just drank - but Richard only wipes some sweat off his face and then gives you a flirty grin. 'I feel like I got to do something! Wanna dance, babe?'";
			say "      While it's not exactly what you expected, you're of course more than ready to join the handsome dude and as you stand up, Richard pulls his shirt off in a quick move, trowing it for Talov to catch. 'Hold on to that - thanks,' he adds without waiting for a reply, then turns and steps towards the partying crowd. The satyr shares a grin with you as he brings the bunched up fabric to his face and takes a long sniff of Richard's manly scent. Then you're off too, following your shirtless human hunk and joining him in his rhythmic moves, doing your best to touch and rub up against him and even sharing a steamy kiss or two.";
			WaitLineBreak;
			say "     For a while, the two of you just let go of everything else, simply dancing and enjoying yourselves in the midst of all the like-minded and more or less drunk students. It is quite a bit of fun, but also a little exhausting, so you eventually make your way back to the bar. Richard takes back his shirt and pulls it on, then squeezes your shoulder and says, 'Thanks, that was great! Gotta rest for a bit now...' With a last charming smile, he walks over to the sofa on the far wall. As you watch him go, swaying a bit in his drunken state and finally plopping down on the cushions, Talov leans in to you over the bar counter. 'Man, that boy really can put away the wine - I'd have thought we had another satyr bro after the first two cups, but no...'";
			say "     Looking over at Richard, he strokes his goatee in contemplation, then adds, 'You know what? Since our tasty wine doesn't hit the spot for Richard... I have an idea what might. To get a stud like him on the team might be worth getting into a little bit of trouble, don't you agree?' The handsome satyr looks at you, then almost immediately says, 'Sure you do. Who wouldn't, eh? Okay then, now listen closely... our boss, Pan - the big kahuna, you know... he's got the very best stuff. And if one were to take just the right path through that museum of yours... there is an entrance to one of the [bold type]divine wine-cellar[roman type]s. If you sneak in there and tap a barrel, just a little bit, that prime grape juice would surely work wonders with Richard.' Talov's renewed lusty look over at the dozing student is interrupted by someone calling for more drinks and the satyr quickly gets back to filling more cups. 'Good luck, I'm sure you can do it,' he calls to you over the noise, then starts serving a group of rowdy frat-guys.";
			if Divine Wine-Cellar is resolved:
				now Divine Wine-Cellar is not resolved;
		else: [player got the good stuff]
			say "     Letting your eyes wander over the crowd of partying students, you spot who you're looking for right away - Richard, the hunk you encountered when you helped your satyr friends get in here. He's standing over near one of the sofas in the room, moving to the beat of the music. With a smile on your face, you dodge between the crowd of dancing frat guys and girls in between and go for your mark, putting an arm around his shoulders before the cute guy even knows you're there. Eyes going wide and cheeks reddening as he looks over to you and remembers your last encounter, he gives a friendly smile and says, 'Hey! Er... nice to see you again. I got bored waiting for the guy to relieve me because he never came - guess guard duty isn't all that important if no one else cares, hm?'";
			say "     You couldn't agree more and invite him to share a drink with you, guiding the readily following student back to the bar a moment later. The two satyrs behind the counter greet you with wide grins, with both Kerr and Talov's eyes undressing your friend with their eyes. Richard sits down on a bar-stool just like you do, somewhat surprised at the unabashed lusty looks he is getting from the duo, then you lean in and loudly ask for an empty cup since you got something special for your friend. 'Sure thing, coming right up,' one of the satyrs replies in a cheerful tone, setting down a red plastic cup and also filling another from the seemingly endless wine-barrel they brought along. As he sets the wine cup on the counter in front of you, you're already pouring Richard's drink from the little bottle you got from the museum.";
			WaitLineBreak;
			say "     Kerr gives you a beaming grin and a little nod as Richard takes his cup and you do yours, bumping them against one another before taking a swallow of the red liquid inside. You quickly feel the desire for a wild night of partying rise inside you as the sweet wine runs down your throat. Richard in the meantime can't seem to get enough of his drink, as he keeps going with the red cup, greedily swallowing gulp after gulp, then even licking off the last drop from the rim with the tip of his tongue. Setting down the cup on the counter a moment later, he turns to look at you with a happy grin on his face and quite round eyes, saying in a half-panted tone, 'Wow. That was... I...' Words fail the young man and he simply pushes up from the bar-stool he was sitting on, hooking a hand behind your head to give you a deep kiss that goes on and on.";
			say "     You can taste a few drops of the special wine on your partner's lips as you make out, its amazing flavour making it clear to you why the muscular student has such an immediate reaction to it. You too want more of it, right away, and what you also want is Richard - wrestling his tongue with yours and sharing each other's breaths. When the two of you eventually pull apart a little to stare into each other's eyes, your hunky friend pants, 'Thank you. That was just the best I've ever drunk! I'm so... um... is it getting hot in here?' He pulls on his shirt a little to fan himself, then quickly slips it off in a single move, revealing his nicely muscled upper body. Richard puts a hand to his chest and murmurs, 'My heart is racing... and those pants itch!' - followed by him hastily undoing the button of his jeans and kicking off his shoes with frantic haste.";
			WaitLineBreak;
			say "     As the athletic student bends over to push his pants down to the ground and wrenches his legs free of their encasement, you see his firm buttocks shown off very nicely in a pair of navy blue trunks. Then suddenly, the tightly stretched fabric starts to bulge a little at the height of his tailbone, pushing out noticeably until Richard reaches behind him with a baffled expression. The young man slides a hand under the elastic band of his undies, then tugs them down over his newly acquired little goat's tail. Twisting his upper body to look at it, he gasps out, 'What the- ?! Ooohh!' And with that, he stumbles right into your arms as his legs start to grow fur all over in an incredibly rapid transformation. You keep the shifting student upright, holding on to his feverishly hot naked chest as the crackle and pop of re-forming bones fills the air.";
			say "     Looking down over Richard's form, you can see that it just took mere moments for him to grow the full-on satyr package, with the typical double-jointed legs and a pair of hooves (still stuck in short white sports socks which he kicks off as you watch). His body is still as attractive and toned as ever, its muscles quite obvious even under the short fur as they tremble a little then settle down in their new configuration. Quickly sorting out how to stand on these new legs, the young man pulls away a little from you (still keeping a hand on your shoulder, just to be sure) and inspects himself with wonder. Raising one leg a little and rotating it to look at it from all sides, stretching his hoof experimentally this way and that, Richard pants in a rapid pace and gasps out, 'That's pretty neat! I think I - unghh!' He is interrupted by a pair of horns that burst out of the unruly mass of curly hair on his head, just above the forehead. They grow longer with every second and curl as they do so, only stopping when they have completed one full spiral to give an impressive look to Richard's new satyr self. Due to their size and position, you can't help but think how... useful they would be as handholds for a blowjob.";
			WaitLineBreak;
			say "     By the time the transformations were finally complete - the last being a neat little tuft of beard forming on Richard's chin - Kerr and Talov have also come out from behind the bar counter and are standing around their new brother, looking at him with eager anticipation. Grunting deeply, the changed student straightens again to his full height (having bent over and held his head earlier) and looks up - right at you, with a strangely intensive gaze. He doesn't say anything, instead just huffing deeply though his nose, and you can see his underwear showing a massive bulge at the front, wet where the cockhead of his erection is leaking precum already. 'It's transformation rut! He needs to fuck,' Kerr calls over to you as Richard takes a first step forward.";
			LineBreak;
			say "     What are you going to do now?";
			say "     ([link]Y[as]y[end link]) Tear off your clothes and bend over the bar counter.";
			say "     ([link]N[as]n[end link]) Pull back from the horny satyr and let the other two deal with satisfying him.";
			if player consents: [player gets fucked]
				LineBreak;
				say "     Quickly baring your body and throwing the clothing into a pile a little down the counter, you bend over the bar and spread your legs, then look over your shoulder at Richard. The incredibly horny young man is standing right behind you, lust flaring in his eyes as he bumps your ass with his crotch, then pulls his navy blue underwear down from where it is stretched over the raging erection between his legs. His manhood is quite respectable in length and has some girth to it - likely another gift of his transformation. In his lust-addled state Richard doesn't wait for more than a few seconds before he lines himself up with your [if cunts of player > 0]nether lips[else]asshole[end if], then thrusts forward hard, sinking himself into your body. You let out a shocked gasp as he penetrates you without any real preparation - other than the copious amounts of pre-cum leaking from his cum slit and smeared all over the cockhead.";
				say "     Richard takes you hard and deep straight away, grunting in lust as he pounds your ass in a rapid tempo, making you groan and pant as his prick rubs and nudges just the right sensitive spots inside you. Thus you are easily pushed to an intense high of arousal, easily forgetting the rough entrance as he proceeds with his relentless assault with the hard pole of his manhood. While you're reduced to mainly just holding on to the counter, moaning and whimpering in lust, Talov and Kerr aren't idle either - and you can see Kerr grin at you from your right, having taken just the position you are in. He shoots you a happy wink, then moans out loud as his partner enters him from behind - with almost as much intensity as Richard on you, but then they're a well-honed team and likely fuck each other several times a day.";
				WaitLineBreak;
				say "     All four of you moan, grunt and shout loudly as you fuck, much to the amusement of the gathered crowd of partying students, who come closer to watch and cheer the action on. A wild coupling between the satyrs and yourself is quite a show, especially with one of them pretty out of control and humping away with bestial intensity against your rear. In the midst of your lusty haze, you even catch sight of more than a few people touching themselves - or each other - as they observe Richard's introduction into satyr-dom. With the action being so intense, it is little wonder that you're pushed closer and closer to your impending climax in a rapid tempo, moaning loudly as you grip the bar counter with white knuckles. Then you reach the point of no return, and [if cocks of player > 0]your wildly swinging cock (from the hard thrusts against your ass) sprays long strings of creamy white cum all over the side of the counter and the floor[else if cunts of player > 0]your well-fucked pussy starts squirting femcum all over the floor under you[else]your body trembles and shivers as a breathtaking orgasm fills your every last bit with tingly pleasure[end if]. The orgasm rocking your body also makes your inner muscles tense and tremble, squeezing Richard's erection in rhythmic convulsions - almost as if he was being jerked off inside your passage. That extra stimulation is what finally gives the rutting student the rest, and he hammers into you one last time with a bellowed grunt, then unloads a deluge of cum into his partner. As his balls throb and pulse, gushing forth their full load and reducing some of the pressure he felt after shifting, Richard lets out a relieved sigh and sinks down on top of your back, just holding on and slowly catching his breath.";
				if cunts of player > 0:
					say "[fimpregchance]";
				else:
					say "[mimpregchance]";
				say "     With closed eyes, you relish in your orgasm and every further pulse of Richard's satyr cock inside you, as well as the feeling of his broad chest pressing against on your back. As you lay there, trying to catch your breath, the moans from Kerr and Talov still fucking next to rise to a new level of intensity and urgency, then they both grunt and huff more or less at the same time. No doubt they just came, filling a satyr butt with fresh cum and splattering the bar counter with the other's seed. The sounds of sex between the four of you slowly die away and the music playing starts to be the loudest thing in the room once more. Now that the action is mostly over, the watching crowd goes back to dancing for the most part, but a few guys and gals who got more than a little aroused do move off to find a room to have some fun in - or not, as one sorority girl goes down on her friend right on one of the sofas down here.";
				WaitLineBreak;
				say "     After resting a little while with Richard still balls-deep inside you and lying on your back, you eventually pat his hip with your hand. You can't help yourself and squeeze his furry butt too, after which the newly transformed satyr stands up and helps you to your feet in turn. 'Wow, I was REALLY horny after that tasty wine. And being a satyr sure feels great. Thanks, this sure was a lot of fun!' Richard tells you and kisses your cheek, then is welcomed to his new life by the other two satyrs, with quite a bit of touching, back-slapping and friendly groping. Eventually he walks over to where his underwear ended up in a crumpled pile on the ground, pulling the navy blue trunks up over his hips.";
				say "     His cute little tail still stands out at the back, keeping the elastic band a bit bent downwards. At the same time, on the front end he has to push his now quite prominent manhood to one side to keep it in the pants. Richard sure makes one hunky satyr. You grin happily at what you did but before you can leave Richard makes one more comment. 'Hey! If you want to come see me outside of here, just come to my room at the dorms! My place is to the east as soon as you enter. Fair warning though, I'll only be there in the day.' He tells you before returning to party. Seeing there's nothing else to do, you pick up your clothes, get dressed and leave.";
				change the east exit of Tenvale College Male Dorms to Richard's Room; [connecting the location to the travel room]
				change the west exit of Richard's Room to Tenvale College Male Dorms; [connecting the location to the travel room]
			else: [let the bar-satyrs take Richard's dick]
				LineBreak;
				say "     As you retreat to a safer distance, out of the immediate reach of the sex-mad satyr, Talov gladly steps up in front of Richard and tugs his underwear down at the front, revealing the young man's towering erection. He stokes it appreciatively with his hands, then quite willingly lets a grunting Richard turn him around with strong hands, bending the grinning barman over the counter. With his erection leading the way, Richard is quite close behind him in an eye-blink, aiming his cock between the other satyr's furry buns. There is not even the slightest hint of hesitation as he slams himself into Talov, taking his ass by storm and thrusting rapidly and deeply into the ecstatically moaning man. The traces of white on Richard's pounding shaft tell you that the naughty bar-satyrs must have fucked each other quite recently too - most likely while serving drinks at the same time. Good thing for Talov really, as he sure can use the extra lubrication to last through this relentless anal assault.";
				say "     Meanwhile, his partner Kerr hasn't been idle either - instead stepping up behind Richard and crouching down, pulling the student's blue undies down even further and revealing all of his shapely behind. It is obvious from the satyr's face with what relish he spreads the student's buns and moves in with an outstretched tongue, licking and poking Richard's back door. The three of them moan, grunt and shout loudly as they fuck, much to the amusement of the gathered crowd of partying students, who come closer to watch and cheer the action on. A wild coupling between three satyrs is quite a show, especially with one of them pretty out of control and humping away with bestial intensity and you can see more than a few people touching themselves - or each other - as they observe Richard's introduction into satyr-dom.";
				WaitLineBreak;
				say "     With the action being so intense, it is little wonder that Talov reaches his point of no return before much longer, moaning out loud and gripping the bar counter with white knuckles. His wildly swinging cock (from the hard thrusts against his ass) sprays long strings of creamy white cum all over the side of the counter and the floor. The orgasm rocking the bottoming satyr's body also makes his inner muscles tense and tremble, squeezing Richard's erection in rhythmic convulsions - almost as if he was being jerked off inside the other man's ass. That extra stimulation is what finally gives the rutting student the rest, and he hammers into Talov one last time with a bellowed grunt, then unloads a deluge of cum into his partner. As his balls throb and pulse, gushing forth their full load and reducing some of the pressure he felt after shifting, Richard lets out a relieved sigh and sinks down on top of Talov, just holding on to him and slowly catching his breath.";
				say "     As the only one who hasn't come yet, Kerr stands up behind the panting duo leaning on the counter and moves in behind Richard, then lines his erection up with the young man's furry crack. Laying the cock lengthwise between their new satyr-brother's buns, he starts to grind against him with obvious pleasure, hands caressing Richard's buns while he does so - until Kerr soon reaches his own orgasm and starts to shoot cum all over Richard's butt and lower back. Now that the action is mostly over, the watching crowd goes back to dancing for the most part, but a few guys and gals who got more than a little aroused do move off to find a room to have some fun in - or not, as one sorority girl goes down on her friend right on one of the sofas down here.";
				LineBreak;
				say "     Looking at the fucked-out satyrs, you grin at a job well done but before you can leave, a blissed-out Richard shouts to you. 'Hey! If you want to see me outside of the frat, just come to my room at the dorms. It's to the east as soon as you enter the building!' He tells you before returning to post-coitus cuddling with the other two satyrs. Seeing that you don't have anything else to do, you head out and on your way.";
				change the east exit of Tenvale College Dorms to Richard's Room; [connecting the location to the travel room]
				change the west exit of Richard's Room to Tenvale College Dorms; [connecting the location to the travel room]
			now SatyrFratRichardRelationship is 4;
	else if SatyrFratRichardRelationship > 3:
		say "     Letting your eyes wander over the crowd of partying students, you spot who you're looking for right away - Richard, the hunk you encountered when you helped your satyr friends get in here. He's looking very fine in his new satyr self - standing tall on two brown-furred legs ending in hooves. His only article of clothing is the pair of navy blue trunks covering his hips, barely enough to cover his modesty as they're quite tight, especially over his crotch and the well-sized dick outlined there in the fabric. Richard's head with its magnificently curved horns nods to the beat of the music as he stands over near one of the sofas in the room. With a smile on your face, you dodge between the crowd of dancing frat guys and girls in between and go for your mark, putting an arm around his shoulders before the cute guy even knows you're there. A beaming smile spreads on his face as he looks at you, then says, 'Hey babe! Wanna party with me again?'";
		say "     You couldn't agree more eagerly and invite him to share a drink with you, guiding the readily following student back to the bar a moment later. The two satyrs behind the counter greet you with wide grins, with both Kerr and Talov's eyes undressing your friend with their eyes. Richard sits down on a bar-stool just like you do, returning a wink at the unabashed lusty looks he is getting from the duo, then you lean in and loudly order wine for the two of you. 'Sure thing, coming right up,' one of the satyrs replies in a cheerful tone, filling first one, then another red plastic cup from the seemingly endless wine-barrel they brought along. A moment later, he hands the drinks off to you and Richard, playfully stroking the frat boy's arm as he does so.";
		WaitLineBreak;
		say "     Bringing your cup to your lips, you nip lightly as you casually watch Richard take a swallow, followed by a larger one as he tastes the potent drink. 'Mmmh, this is good stuff,' the young man comments as he finishes the cup in short notice, only to have it refilled by a widely smiling Kerr for another round of drinking. This time, you're right with him, chugging your own wine to get into the partying mood and chatting a bit with Richard as you do so. The wine keeps flowing freely as you talk, until your friend eventually says, 'You know what...' and raises a hand to his head, stroking the side of one of his two ram's horns. The two satyr barmen and yourself lean in with interest, making the handsome young man chuckle and he gives a flirty grin. 'I feel like I got to do something! Wanna dance, or have some naked fun right here and now?'";
		LineBreak;
		say "<<<<<Sadly, this is the end of Richard's content so far. Check in again at some future point and see what you can do with him then.>>>>>[line break]";
		say "<<<<<This might include: Sexy Dancing, offering him your ass, bending Richard over the counter, getting Kerr and Talov involved, ... (we'll see what it will be).>>>>>";
				
to say SatyrFratSex6: [Fucking a satyress]
	setmonster "Satyress";
	say "     Letting your eyes wander over the crowd of partying students, you spot a bare-breasted sorority girl sporting a pair of cute little horns on her forehead. Looks like the satyress strain of the nanite infection you inadvertently helped create his spreading well. After snatching up two cups of satyr wine from the counter in front of Talov, you move closer to the laughing and dancing young woman, winding your way past several people who are making out and casually grind against one another. This gives you time to take in her curly [one of]blond[or]ginger[or]brown[or]auburn[at random]hair and check out the fur on two long hoofed legs and her shapely behind with its cute tail. That babe is definitively a looker. Before much longer, you're up close with her, holding out your alcoholic ice-breaker as you introduce yourself and chugging back a swallow from the second cup as she takes it.";
	say "     With the satyr wine stoking the fires of lust and arousal in both of you, there is little need of more than a few moments of breathless small-talk before the satyress runs a hand up the side of your chest and steps a little bit closer. Her lips meet yours and the two of you share an eager kiss, followed by you suggesting some more vigorous action and her giving a pleasant little giggle and happy nod. As she wraps her arms around your neck and starts making out, you slowly push her backwards a little, leading the young woman in the direction of a nearby sofa. Step by step getting closer to your goal, you slide a hand down her chest and brush it over her crotch, feeling the sensitive folds of her sex.";
	WaitLineBreak;
	say "     In between the continuing tongue-wrestling and you stroking the satyress - realization flashes for a second that you don't even know her name - the feelings of lust and arousal in you soar along with her own - and soon she gives an urgent sigh of 'I wanna fuck' in a second when your lips aren't jammed together. Still making out in a wild rush, you push her on towards the sofa you had been aiming for anyways, eager to get to the next place for urgent love-making in sight. As the two of you stumble through the dancing crowd, bumping various people out of the way, the initial complaints quickly give way to whoops and hollers as more and more party-goers become aware of your state of un-dress and sexual arousal. One hand between your partner's legs, two fingers buried in her moist snatch, the two of you soon reach your destination and with a little push, she falls back to sit on it. Immediately sinking to your knees between the soft-furred legs of your satyr partner, you start lapping at her pussy, making the transformed sorority girl grip the pillows and shout in pleasure.";
	say "     Calls of, 'Hey look, they're doing it over here!,' are repeated several times, bringing more and more onlookers and turning the already sexually charged atmosphere of the frat party decidedly hotter. There's a few calls of, 'Hey [if cunts of player > 0]baby[else]stud[end if], you're gonna do me next, right?' and 'She's a screamer, wish I was the lucky guy to tap that!' - but as you pull away from her pussy and start to take off your own clothes, something of a shocked silence falls over the would-be commenters. When you're completely naked and start to climb on top of the sofa, one guy gasps, barely audible above the loud music, 'No way! Is [if cunts of player > 0]she[else]he[end if] gonna - WOOOW!' A mixed cheer and aroused sigh goes through the crowd as you start sinking your rock-hard [cock of player] manhood into her...";
	LineBreak;
	say "     ([link]Y[as]y[end link]) - Pussy.";
	say "     ([link]N[as]n[end link]) - Ass.";
	if player consents:
		LineBreak;
		say "     Rubbing your cock up and down over the wet and dripping nether lips of the beautiful satyress, you make her whimper in pleasure and anticipation. Then nudge her folds apart a little with the cockhead and slide into her [if cock length of player > 24]slowly[else if cock length of player > 12]smoothly[else]with ease[end if], making your partner tremble with excitement, giving little coo's and pants of pleasure. The musky scent of aroused satyress grows stronger as you soon bottom out and her raised tail wags almost like a dog's, brushing against your legs. A clear signal of her happiness at this mating - as does the eager way in which she wraps her furry hooves around your ass, pushing against it to make you fuck her for real. Best not to keep such a sexy girl waiting any longer, so you start pulling back, groaning lustfully as her pussy stretched around your shaft slides along its sides. You wait a second when only your cockhead is left inside, teasingly pulling up a bit with your erection, rubbing the underside of her clit - and then you surprise her with a sudden deep plunge that has both of you shouting in lust, continuing on with rapid pounding right after feeling your crotch hit hers in a satisfying thump.";
		WaitLineBreak;
		say "     The naked half-goat woman is a very eager partner to get fucked, vocally telling you and everyone in earshot that she likes it hard and how good your [cock of player] shaft fells in her pussy. Her sexy body writhes under your touch and she is constantly grinding her hips up against your crotch. As you continue to hammer into her most, welcoming hole, the satyress teases you on and on and even reaches up to pull you into a hungry kiss or two, proving that she lives to have fun. It is with great pleasure that you enjoy the fruits of your 'hard work' in creating the first satyress right in this frat-house, sliding in and out of another sexy young woman now turned into a mythological being. With this being a totally hot public fuck, a whole crowd of people around cheeking you on, it is no wonder that soon, you feel a certain tightness rise in your balls. After several breathtaking moments of riding the satyress['] tight pussy, you drive your cock deep inside and fill her with your load. Spurt after spurt of fertile seed paints her inner walls white in a hopeful attempt to knock the willing sorority girl up.";
		say "     The sexy student you're fucking isn't far behind - as she fingers her clit in a frantic pace to finish herself off. Mere moments later, she is squirting femcum, splashing your crotch and soaking the sofa under her hips as it trickles down between her legs. Thrashing wildly as the orgasm rocks her body hard, the young woman wraps her arms around you, hungrily making out with the one who gave her this ecstatic feeling. Once she calms down a bit eventually and your own cock has finished throbbing with new spurts of cum, you pull out slowly, letting your softening member rest in its now sensitive state. Meanwhile, the satyress reaches between her legs and fingers herself some more, creating a bit of a mess on the sofa with your creamy load [if cock width of player > 20]flowing[else if cock width of player > 12]running[else if cock width of player > 6]leaking[else]trickling[end if] out her slightly gaping pussy. Biting her lip in pleasure as she touches herself, the young woman then focuses on you and gives a wink and says, 'Thanks! I really needed that. Wouldn't mind doing that again soon!' And with that said, she jumps up from the sofa, giving you a peck on the cheek in passing as she dashes off towards the stairs, no doubt to wash up after the sweat-driving fun of sex.";
		WaitLineBreak;
		say "     You're left standing alone above the messy sofa, watching your sex-partner's perky butt as she goes upstairs with its sweat-matted shape bouncing quite nicely. The crowd around you mostly turns back to dancing, but it looks like a few guys and gals do feel inspired by your bold public sex to pair up and get it on... if a bit less right in the middle of things. Then suddenly, you feel a hand squeezing your shoulder - it's Talov, the red-headed satyr bartender, grinning wildly at you. 'That was one amazing job you did with her! Really got the party going and showed off your stuff, you stud,' he tells you in a husky tone, giving your butt a little grope as he does so. The friendly satyr's other hand offers you a clean towel an eye-blink later, allowing you to clean up at least a little, then spreading the piece of cloth on the sofa to soak up what it can.";
	else:
		LineBreak;
		say "     Rubbing your cock up and down over the wet and dripping nether lips of the beautiful satyress, you make her whimper in pleasure as you get your dick good and wet for what will come next. Then you shift your hips and press the cockhead against the sweet little pink pucker between her buttocks and sink yourself in [if cock length of player > 24]slowly[else if cock length of player > 12]smoothly[else]with ease[end if], making your partner tremble with excitement, giving little coo's and pants of pleasure. The musky scent of aroused satyress grows stronger as you soon bottom out and her raised tail wags almost like a dog's, brushing against your legs. A clear signal of her happiness at this mating - as does the eager way in which she wraps her furry hooves around your ass, pushing against it to make you fuck her for real. Best not to keep such a sexy girl waiting any longer, so you start pulling back, groaning lustfully as her tightly stretched ring slides over your shaft. You wait a second when only your cockhead is left inside, teasingly pulling against her pucker just weak enough not to pop out - and then you surprise her with a sudden deep plunge that has both of you shouting in lust, continuing on with rapid pounding right after feeling your crotch hit her ass in a satisfying thump.";
		WaitLineBreak;
		say "     The naked half-goat woman is a very eager partner to get fucked, vocally telling you and everyone in earshot that she likes it hard and how good your [cock of player] shaft fells inside her ass. Her sexy body writhes under your touch and she is constantly grinding her hips up against your crotch. As you continue to hammer into her tightly gripping hole, the satyress teases you on and on and even reaches up to pull you into a hungry kiss or two, proving that she lives to have fun. It is with great pleasure that you enjoy the fruits of your 'hard work' in creating the first satyress right in this frat-house, sliding in and out of another sexy young woman now turned into a mythological being. With this being a totally hot public fuck, a whole crowd of people around cheeking you on, it is no wonder that soon, you feel a certain tightness rise in your balls. After several breathtaking moments of riding the satyress['] hot ass, you drive your cock deep inside and fill her with your load. Spurt after spurt of fertile seed paints her inner walls white in a futile attempt to knock the sorority girl's ass up.";
		say "     The sexy student you're fucking isn't far behind - as she fingers her clit in a frantic pace to finish herself off. Mere moments later, she is squirting femcum, splashing your crotch and soaking the sofa under her hips as it trickles down between her legs. Thrashing wildly as the orgasm rocks her body hard, the young woman wraps her arms around, hungrily making out with the one who gave her this ecstatic feeling. Once she calms down a bit eventually and your own cock has finished throbbing with new spurts of cum, you pull out slowly, letting your softening member rest in its now sensitive state. Meanwhile, the satyress reaches between her legs and fingers herself some more, creating a bit of a mess on the sofa with your creamy load [if cock width of player > 20]flowing[else if cock width of player > 12]running[else if cock width of player > 6]leaking[else]trickling[end if] out her stretched ass. Biting her lip in pleasure as she touches herself, the young woman then focuses on you and gives a wink and says, 'Thanks! I really needed that. Wouldn't mind doing that again soon!' And with that said, she jumps up from the sofa, giving you a peck on the cheek in passing as she dashes off towards the stairs, no doubt to wash up after the sweat-driving fun of sex.";
		WaitLineBreak;
		say "     You're left standing alone above the messy sofa, watching your sex-partner's perky butt as she goes upstairs with its cum-matted shape bouncing quite nicely. The crowd around you mostly turns back to dancing, but it looks like a few guys and gals do feel inspired by your bold public sex to pair up and get it on... if a bit less right in the middle of things. Then suddenly, you feel a hand squeezing your shoulder - it's Talov, the red-headed satyr bartender, grinning wildly at you. 'That was one amazing job you did with her! Really got the party going and showed off your stuff, you stud,' he tells you in a husky tone, giving your butt a little grope as he does so. The friendly satyr's other hand offers you a clean towel an eye-blink later, allowing you to clean up at least a little, then spreading the piece of cloth on the sofa to soak up what it can.";

to say SatyrFratSex7: [Fucking a sorority girl]
	say "     Letting your eyes wander over the crowd of partying students, you spot a perfect candidate to get your rocks off with - a really cute [one of]blond[or]redhead[or]brown-haired gal[or]auburn-haired gal[at random], clad in only a tight top leaving her belly bare and a short not even reaching halfway to her knees. The young woman is dancing to the music with a mostly empty red cup of satyr wine in her hand and clearly seems ready for some fun, as you see her playfully grope two separate frat-guys in just a few moments on the dance-floor. Luckily for you, guy number one is too focused on the dance beat to notice (or possibly drunk) and the athletic jock that she approached next quickly gets pulled away and into a steaming hot kiss - by another of his frat-brothers. All of which leaves you to arrive at just the right moment, carrying two more satyr wine cups you picked up at the bar. As you give the young woman your most charming smile and offer a cup, she drains the one in her hand instantly and flings the plastic cup aside, accepting your gift happily.";
	say "     Leaning in to be understood over the drone of the music, you introduce yourself while she nips at her new drink, followed by spontaneously darting in to kiss you. A moment after which her lips press against yours, you taste the drops of wine on them and her questing tongue, stimulating you to eagerly reply, swapping spit for what seems like ages. Then at some point, she pulls back and gives a most charming smile, together with the words, 'I'm [one of]Ann[or]Brenda[or]Hong[or]Li[or]Jenny[or]Olivia[or]Laura[or]Erica[or]Viv[or]Cloe[or]Tara[at random]. Let's dance!' She draws you into a very tight, almost sexual dance, grinding herself against your front and stroking your body with both hands. It is great fun to just be with her on the dance-floor, moving with the music, touching and being touched - but at some point the young woman puts her hand on your crotch, appreciatively squeezing the bulge having grown there. Giggling as she slips a slender hand into your pants immediately afterwards, she gropes for your member and says just loud enough to be heard over the music, 'Wanna show me what you can do with that?'";
	WaitLineBreak;
	say "     More than eager to oblige, you tell the young woman that and follow her as she takes your hand and leads the way out of the dancing crowd towards one of the less lively corners of the room. Before you know it, she and you are making out like there is no tomorrow against a wall, kissing and being kissed with breathtaking intensity. While your tongues wrestle with one another, you decide to check the sexy young woman's assets in turn and slip a hand under her skirt - to find out that she's not wearing any underwear at all, as you directly touch her moist nether lips. After a moment's pause of surprise - during which your lust flares up brightly - you start fondling her, drawing a little squeal and moan from the sexy minx. Her hips move almost of their own volition towards you, grinding forward to get your fingers deeper into her. Clearly, this young woman is more than willing to be fucked - right here, right now!";
	say "     Opening the front of your pants, you pull out the rock-hard [cock of player] shaft you call your own, stroking its length demonstratively. The student squeals in glee as she sees it and takes a deep pull from her wine-cup, leaving you to decide what you wanna go for...";
	LineBreak;
	say "     ([link]Y[as]y[end link]) - Pussy.";
	say "     ([link]N[as]n[end link]) - Ass.";
	if player consents:
		LineBreak;
		say "     Sliding the front of her skirt up with one hand, you look at the very inviting sight awaiting you there, with slightly swollen and open pussy lips, glistening wetly from her arousal. Without any further delay, you bend your knees a little and slide two hands under her thighs, lifting the young woman as you press her against the wall - to thrust forward with your hips when she's in the proper position, sinking yourself halfway into her snatch with a deep grunt. Your attractive partner gives out a loud gasp of satisfaction as she is penetrated like that, wrapping her arms and legs around you as well as attracting some attention from the closer party-goers. 'They're doing it right here!', 'This is so hot!' and 'I gotta capture that on my smart-phone!' are just a few of the comments your coupling earns from the small crowd of onlookers forming around - not that you really care, with the sexy woman you're fucking in a rapid tempo taking all of your attention.";
		say "     The feeling of that silky smooth skin under your fingers as you hold open her legs, thrusting in and out of a tight, warm and very satisfying pussy, her lips on yours with the taste of satyr wine and strawberry lipstick, the way her fingers grip your shoulders tightly with each new penetration, ... - All of those sensations burn themselves into your memory while you fuck, humping more or less in rhythm with the blaring music in the room. Judging from the breathless kisses and gasped moans, your partner isn't disappointed at having gotten you as her stud either, and together you grind and thrust against one another with intense dedication. As such things go, your wild fuck against the wall quickly builds to a screaming climax, with your manhood being thrust as deep as it can go and blasting her womb with all the fertile semen your balls have to give. The throbbing of a cock against her clit is enough to push the sexy student over the edge right along with you, and she lets out breathless screams as her pussy goes wet with femcum.";
		WaitLineBreak;
		say "     The two of you stay like that - her pressed to the wall and you balls-deep inside her pussy - long enough for the crowd of onlookers to disperse mostly. Eventually, when you have enough of the relatively gentle making out during which your shared orgasms wind down, you pull your softening cock out of her pussy and gently lower her to the ground, coming to stand on those shapely legs and pulling her skirt back in position over them. She even manages to look halfway respectable again - if one ignores the happy 'yeah, I just got fucked' expression, the sheen of perspiration all over her skin and the little trickle of your cum visible on the inside of her thighs. No matter what, she's quite happy at the time spent with you and gives you a beaming smile, followed by another kiss on the lips. 'You were amazing,' she coos contently, then says her goodbyes and wanders towards the way upstairs, in all likelihood to clean up a little...";
	else:
		LineBreak;
		say "     Running your hands down the young woman's sides, you let them wander all the way to her shapely behind, then turn her around and pull the skirt up. 'Ooohh,' she lets out with a giggle as you hand strokes up and down her crack, followed by the sorority girl bracing herself against the wall, bent over and with her rear stuck out for you. Clearly, this young lady isn't a novice when it comes to such things. The horny student's pink pucker looks so invitingly that you bend your knees a little and line yourself up just the right way, only stopping for a moment to slick your dick up with her femcum before you press in against her ass. As you grunt deeply when your cockhead pops in, your attractive partner gives out a loud gasp of satisfaction as she is penetrated like that, pushing her ass back to take more of your shaft. Of course, this also attracts some attention from the closer party-goers. 'They're doing it right here!', 'This is so hot!' and 'I gotta capture that on my smart-phone!' are just a few of the comments your coupling earns from the small crowd of onlookers forming around - not that you really care, with the sexy woman you're fucking in a rapid tempo taking all of your attention.";
		say "     The feeling of that silky smooth skin under your fingers as you hold apart her buttocks, thrusting in and out of a tight, warm and very satisfying asshole, the scent of hair hair as you lean forward and nibble on her earlobe, the way her fingers reach back for you, often gripping your side as she indicates to go faster or slower, ... - All of those sensations burn themselves into your memory while you fuck, humping more or less in rhythm with the blaring music in the room. Judging from the gasped moans, your partner isn't disappointed at having gotten you as her stud either, and together you grind and thrust against one another with intense dedication. As such things go, your wild fuck against the wall quickly builds to a screaming climax, with your manhood being thrust as deep as it can go and blasting her asshole with all the fertile semen your balls have to give. The throbbing of a cock against sensitive spots in her ass is enough to push the sexy student over the edge right along with you, and she lets out breathless screams as her pussy goes wet with femcum, dripping onto the floor between her legs...";
		WaitLineBreak;
		say "     The two of you stay like that - her bent forward, leaning against the wall and you balls-deep inside her ass - long enough for the crowd of onlookers to disperse mostly. Eventually, when you have enough of the relatively gentle stroking and petting during which your shared orgasms wind down, you pull your softening cock out of her asshole and give her room to stand up straight and smooth down her skirt to cover the curves of her butt. She even manages to look halfway respectable again - if one ignores the happy 'yeah, I just got fucked' expression, the sheen of perspiration all over her skin and the little trickle of your cum visible on the inside of her thighs. No matter what, she's quite happy at the time spent with you and gives you a beaming smile, followed by another kiss on the lips. 'You were amazing,' she coos contently, then says her goodbyes and wanders towards the way upstairs, in all likelihood to clean up a little...";

Table of Game Objects (continued)
name	desc	weight	object
"Pan's Special Reserve"	"A tiny bottle holding rich, red wine. Its contents come right from the party-god Pan's private wine-cellar. Quite a special and precious drink you got there."	1	Pan's Special Reserve

Pan's Special Reserve is a grab object. It is part of the player. Understand "wine" as Pan's Special Reserve. Pan's Special Reserve is infectious. The strain of Pan's Special Reserve is "Satyr".

The usedesc of Pan's Special Reserve is "[SpecialWineUsing]";

to say SpecialWineUsing:
	say "Taking out the small bottle of wine, you pull the cork keeping it sealed and let the precious liquid breathe, smelling its aroma while you wait. Something about it fills you with the feeling of boundless energy, like you could dance away all night and day, give yourself to endless revels and never stop enjoying yourself. With a last look at the rich, red wine, you take a mouthful and feel the sweet, heady liquid run down your throat - gasping as it overwhelms your taste-buds and you feel a comfortable warmth fill your body and mind. With another, and another gulp, you thirstily drink the rest right away, as the amazing wine's allure is too tempting to hold back even a little. Arousal flares up brightly in your mind and you [if cocks of player > 0]realize that you've become fully erect in barely an eye-blink[else if cunts of player > 0]realize that your pussy is very, very wet and swollen, ready to be fucked hard[else]feel your skin tingle for someone else's touch[end if]. It's about time you found someone to fuck!";
	decrease thirst of player by 20;
	infect "Satyr";
	infect "Satyr";
	infect "Satyr";
	infect "Satyr";
	infect "Satyr";
	if thirst of player < 0:
		now thirst of player is 0;

instead of sniffing Pan's Special Reserve:
	say "The wine is aromatic and quite powerful. Something about it fills you with the feeling of boundless energy, like you could dance away all night and day, give yourself to endless revels and never stop enjoying yourself.";

Divine Wine-Cellar is a situation.
The sarea of Divine Wine-Cellar is "Museum".
when play begins:
	add Divine Wine-Cellar to badspots of guy; [male satyr]
	add Divine Wine-Cellar to badspots of furry; [satyr involved]
	now Divine Wine-Cellar is resolved;

[ JaksEncounters                                            ]
[  0: not met                                               ]
[  1: met Jaks                                              ]
[  2: gave Jaks a BJ                                        ]
[  3: fucked by Jaks                                        ]

JaksEncounters is a number that varies. 
LastJaksEncounter is a number that varies. LastJaksEncounter is usually 2500.

Instead of resolving a Divine Wine-Cellar:
	now battleground is "void";
	if debugactive is 1:
		say "DEBUG -> JaksEncounters: [JaksEncounters], LastJaksEncounter: [LastJaksEncounter] <- DEBUG[line break]";
	setmonster "Satyr";
	if LastJaksEncounter - turns < 10:
		say "     You move through the rooms of the museum along the path your satyr friend Talov explained, but something seems a bit off and you end up in an abandoned stone-age exhibit. Hmm... maybe the strangeness in the museum shifts over time? Seems like you can't get where you want to go right now. Better try it again sometime later, maybe you'll have more luck then.";
	else:
		if JaksEncounters is 0:
			say "     You follow the path your satyr friend Talov explained to you - through the several rooms of the Egyptian exhibit, then turning around and walking back the way you came, but with other rooms taking the place of the previous ones. Passing through a Babylonian garden, then coming to a re-built ancient trading barge filling a very large room, you scale the side of the ship and walk down the steep ladder of its forward hold - only to find yourself coming down into an underground passage, half natural cave half humanly built. A few steps ahead, the tunnel opens into a larger room lit by the flickering light of open flames, and you can already see a number of wine-barrels from your position.";
			say "     Quietly moving forward, you check out the expansive wine cellar going on and on, with further passages leading to more rooms next to this one. Man, this Pan dude really got a collection. Nearby, there is a large table laden with various vintner's tools as well as a small crate full of sample-sized bottles and cork stoppers. Just what you needed - you appropriate one, freezing in your movements and swallowing a curse as the rest of them clink against one another and the sound echos through the cavernous room. Better hope that no one heard it. No matter what, it'll be a good idea to get out of here quick! Since the labels on the wine casks are in ancient Greek anyways, you pick one of the barrels at random and kneel down in front of it, holding your little bottle under the tap and opening it to let the rich red grape-juice fill it.";
			WaitLineBreak;
			say "     'Now who do we have here?!' a deep voice says from behind you, making you flinch and start to turn - only to have a strong hand grab your shoulder in a vice-like grip, holding you tight. 'Don't spill it! You gotta have respect for the god's gifts youngster,' the voice continues, to reveal itself belonging to a statuesque satyr with magnificent horns as he leans forward to close the tap gently. Oops - looks like you almost let the precious wine splatter the floor as you were about to pull the little bottle away from it in your shock. As you blush a little at the handsome, bearded man's intense and somewhat disappointed gaze, he plucks the glass bottle from your hands and closes it with a stopper. Straightening to stand tall on his two hooves, towering over you in a picture of masculinity, the satyr puts a hand on his hip and raises an eyebrow. 'I don't know your face. You must be new around here, eh? Well - I'm Jaks. Go on then, tell me your name... and you better also have a good reason for me not to just kick you out for daring to raid the boss's cellars.'";
			say "     From your position kneeling on the ground, Jaks looks really quite built and strong, and he's got more of an amused expression than an angry one... so you don't think violence is an answer here. Instead, you introduce yourself and tell him:[line break]";
			LineBreak;
			say "     [link](1)[as]1[end link] - That you're sorry. (making a quick exit afterwards)[line break]";
			say "     [link](2)[as]2[end link] - Nothing - just rub his furry balls and 'convince' him to overlook your little intrusion with a bit of tongue-work.[line break]";
			say "     [link](3)[as]3[end link] - That you want him to fuck you. That should convince him to turn a blind eye on one little sample bottle of fine wine.[line break]";
			now calcnumber is 0;
			while calcnumber < 1 or calcnumber > 3:
				say "Choice? (1-3)>[run paragraph on]";
				get a number;
				if calcnumber is 1 or calcnumber is 2 or calcnumber is 3:
					break;
				else:
					say "Invalid choice. Type [link]1[end link] to just make an exit, [link]2[end link] to give Jaks a blowjob or [link]3[end link] to get fucked.";
			if calcnumber is 1: [exit]
				LineBreak;
				say "     Accompanied by some fast-talked apologies for your intrusion, you pick yourself up from the floor. You can't help but glance over at the bottle in Jaks hand, having almost had what you came for, but the satyr closes his large hand around it more tightly and shakes his head. 'Hmh. In my youthful days we knew how to properly raid a wine-cellar. Or at least what to do when caught. Oh well, maybe you'll learn eventually. Okay - scram. Get out of here!' Shaking his head, the muscled satyr waves you off, a laugh on his lips as you dash away and climb the ladder again.";
				if JaksEncounters is 0: [not met]
					now JaksEncounters is 1; [met Jaks]
			else if calcnumber is 2: [BJ]
				LineBreak;
				say "     You keep your mouth closed, but show the muscled satyr a lusty smile as you raise a hand to brush it over the curly fur of his legs, running it along the inside of his thighs to reach his nice and round balls. As you cup Jaks full orbs and start to stroke them, the tall man lets out a pleased grunt and spreads his furry legs a little for easier access. 'Mmmh, 'tell' me more, my friend,' he adds in a lusty tone, grabbing the upper edge of the large barrel with his free hand and leaning over you a little more. The handsome satyr's manhood fills out in mere moments, standing as a proud pole over the hairy balls you're rolling gently in your hand. Licking your lips as you see a shining drop of pre-cum form at his slit, you move a bit closer and encircle the satyr's cockhead with your lips, giving a gentle suck that draws a deep moan from him.";
				say "     'Just like that,' the satyr tells you in a content hum, then reflexively stops a hoof on the stone floor as you move on to lap his cum factories before running your tongue-tip up the underside of his shaft. His breathing comes faster due to the randy male's soaring arousal, and he lets out a pleased grunt as you finally slide your lips over his cockhead again, then go lower and lower, taking in his thick shaft. Jaks truly has a magnificent piece of equipment, well-sized and with just the right girth, plus two quite prominent veins giving it an interesting look - and you don't stop till its all the way down your throat, with your nose pressing into the satyr's crotch, every breath taking in his masculine aroma and egging on your own arousal more and more.";
				WaitLineBreak;
				if cocks of player > 0:
					say "     Before long, you have your own pants pushed down far enough to free the erection now proudly swinging between your legs, stroking it rhythmically as you go down on the other male. ";
				else if cunts of player > 0:
					say "     Before long, you have your own pants pushed down far enough to allow free access to your crotch, letting you rub your clit rhythmically as you go down on the strong male. ";
				else:
					say "     Before long, you have your own pants pushed down far enough to allow free access to your crotch, letting you rub its sensitive flesh rhythmically as you go down on the strong male. ";
				say "Meanwhile, your partner gives lust-filled moans and grunts, as well as hoof-stomps, and you can tell that he's getting quite close. It's clear what that means - time to go all out! With a happy grin around the thick shaft in your mouth, you snake a hand between Jaks legs and seek out his quivering pucker with a finger, then push your digit inside him as you start to rapidly bounce your head up and down on his pole. 'Ngghh! YEAH. Oh dear Pan! You're... ngh, ngh ... you're GOOD at this! Yes! I'm close, really... close! GAH - Take my cum!' Jaks shouts and grunts loudly as you massage his prostate, then the satyr's tasty seed starts to pulse down your throat right into your stomach - until you pull back a bit and let him gush into your mouth, that is. The creamy, nutty bounty of his twitching balls covers your tongue and paints your tonsils white, to be eagerly swallowed a second later.";
				say "     As Jaks slowly winds down after giving you a stomach-full of his seed, you pull off his pole and take a few deep gasping breaths, then proceed to take care of your own arousal, ";
				if cocks of player > 0:
					say "jerking off in a rapid pace until you feel the familiar tightening in your balls and just hold on for dear life, feeling your manhood pulse as burst after burst of cum covers the stone floor in white streaks. ";
				else if cunts of player > 0:
					say "frigging your sensitive clit in a rapid pace until you feel the familiar up-welling of an orgasm, squirting femcum over your fingers and having it drip on the stone floor. ";
				else:
					say "frigging your sensitive crotch in a rapid pace until you feel the familiar up-welling of an orgasm, trembling all over as you kneel on the stone floor. ";
				say "Afterwards, you stand up on somewhat shaky knees and put your clothes back in order, then find your new friend standing over you with a satisfied smile on his face. 'That sure was one convincing argument,' he says with a chuckle, then holds out the little bottle to you in a little flourish. 'Here, take it. You earned it. Now get out of here, I got duties to perform, you know...' Giving him your thanks, you pocket the sample bottle of wine, then make your way down the short tunnel and to the stairs. Not long after, you're back in the lobby of the museum.";
				increase carried of Pan's Special Reserve by 1;
				if JaksEncounters < 2: [no BJ before]
					now JaksEncounters is 2; [gave him a BJ]
			else if calcnumber is 3: [fuck]
				LineBreak;
				say "     Standing up and looking the hunky satyr in the eye, you make the offer of giving up your [if cunts of player > 0]pussy[else]ass[end if] to him, resulting in Jaks looking down over your form appreciatively. A little movement at the corner of your view draws your attention - and you realize that it's his manhood rapidly filling out to a full erection as you glance down. 'I gladly accept,' the horny satyr says in a very satisfied tone, leaning in and sliding an arm around your chest to pull you in for a kiss. His curly beard tickles pleasantly as you make out with him, tongues wrestling with one another. Coming up for air a long moment later, the satyr sets down the little wine bottle carefully, then grabs hold of you with both hands. Jaks hefts you up, allowing you to encircle his hips with both legs as he goes on to kiss you again and again, then carries you over to the table.";
				say "     Impatiently shoving the wooden tools (hammers, and taps and whatnot) off the table, making them clatter to the stone floor, your satyr partner lowers you to the tabletop in a gentle manner, then proceeds to peel off the clothes and gear you're wearing. Soon, you're naked all the way, revealing your [bodytype of player] form to his appreciative gaze and Jaks strokes you with his hands, caressing and squeezing just the right spots. Trembling under his ministrations, you writhe and quiver in pleasure, then soon feel something firm and hot poke your inner thigh. Looking down, the well-sized manhood of this hunky satyr reveals itself as the culprit, and you give a soft moan at the thought of feeling it inside you. Jaks smiles at where your attention lies and leans in for a peck, then says in a husky whisper, 'I'm really looking forward to giving you a ride on it...'";
				WaitLineBreak;
				say "     The muscled satyr then crouches down suddenly, bringing his head to the height of your hips as they lay on edge of the table. An eye-blink later, you can feel his talented tongue licking you, seeking out the [if cunts of player > 0]moist pussy already waiting for his touch[else]trembling pucker already waiting for his touch[end if]. Lapping away - first slowly, then with increased energy - Jaks teases you a short while and gets you wet with his spit, then eventually stands up and aligns his manhood with your body. 'Better hold on well,' he jokes, guiding your legs to encircle his hips once more and nodding as you brace against the wall with your arms. The grinning satyr blows you a kiss, then presses his hips forward, [if cunts of player > 0]sliding his thick shaft right into your depths[else]building a little pressure against the iris of your butthole before the muscle yields to allow him to slide in. His thick shaft sinks into your depths and stretches the passage wide, giving you a pleasantly full feeling[end if].";
				say "     Bottoming out after penetrating you slowly but surely, the horned hunk grunts, 'Yeah! You feel great babe!' Then he proceeds to pull back and thrusts in again, starting to fuck you in a steady pace. The wine-cellar fills with the sounds of sex - grunts and moans from the two of you, as well as the thump of the table hitting the wall on Jaks harder thrusts, together with the clink of the other bottles in their crate still standing on the table. Your partner really knows how to treat [if cunts of player > 0]a woman[else if cocks of player > 0]a man[else]his sexual partners[end if], hitting just the right spots deep inside you with every last thrust and also rotating his hips a little to wake ever new sensations as he penetrates deeply.";
				WaitLineBreak;
				say "     Time loses all real meaning as the pleasure he fills you with dominates your mind, with moment after moment being filled with ecstasy. Thus, you don't really know how long he fucked you (nor do you really care) before your arousal eventually boils over and you shout out in completion, [if cocks of player > 0]your manhood twitching and pulsing as spurt after spurt of cum shoots out and splatters your chest in long streaks[else if cunts of player > 0]your pussy twitching as femcum squirts from between its stretched-open folds[else]your body trembling and twitching as an orgasm rocks your whole being[end if]. As you flop down on the table, still reeling from your explosive climax, Jaks humping becomes even more intense, with him clearly liking the way your muscles squeeze his manhood. It does only take a few more moments before he lets out a satisfied bellow, thrusting all the way into you one last time and pumping quite a load of his seed into your depths. The satyr leans over you to kiss you as his cock still pulses with more and more cum, and he keeps making out with you until his climax eventually winds down.";
				if cunts of player > 0:
					say "[fimpregchance]";
				else:
					say "[mimpregchance]";
				say "     Pushing himself up from the table with both strong arms, Jaks looks down at you with a cheeky grin on his face, then says, 'Pleasure having you here as a visitor. I wouldn't mind if you came along more often.' He pulls his spent cock from your body slowly and gently, wiping off a bit of cum sticking to the cockhead with a finger and then slurping it off with his tongue. The satyr helps you down from the table and waits for you to put your clothes in order, then holds out the little bottle to you in a little flourish. 'Here, take it. You earned it. Now get out of here, I got duties to perform, you know...' Giving him your thanks, you pocket the sample bottle of wine, then make your way down the short tunnel and to the stairs. Not long after, you're back in the lobby of the museum.";
				increase carried of Pan's Special Reserve by 1;
				if JaksEncounters < 3: [not fucked before]
					now JaksEncounters is 3; [fucked by Jaks]
			now LastJaksEncounter is turns;
		else: [return visit]
			say "     Once more, you follow the path your satyr friend Talov explained to you - through the several rooms of the Egyptian exhibit, then turning around and walking back the way you came, but with other rooms taking the place of the previous ones. Passing through a Babylonian garden, then coming to a re-built ancient trading barge filling a very large room, you scale the side of the ship and walk down the steep ladder of its forward hold - only to find yourself coming down into an underground passage, half natural cave half humanly built. A few steps ahead, the tunnel opens into a larger room lit by the flickering light of open flames, and you can already see a number of wine-barrels from your position.";
			say "     Quietly moving forward, you check out the expansive wine cellar going on and on, with further passages leading to more rooms next to this one. Man, this Pan dude really got a collection. Nearby, there is a large table laden with various vintner's tools as well as a small crate full of sample-sized bottles and cork stoppers. And standing in front of it, the proud satyr Jaks is currently carving a new tap - or repairing a broken one, you're not quite sure which. No matter what, it doesn't seem like you have any chance at all of sneaking in this time... so you give a shrug and just step out into the room and say hello. 'Now who do we have here?! Ah, you again,' the satyr greets you in a deep voice, smiling a little and raising his eyebrow. 'Can't keep away from the good stuff, eh? Well, sorry to rain on your stealthy raid, but I got some work to do here. No sneaking off with the boss's wine today,' he says, then adds with a wink, 'Or did you just want to visit a certain satyr for some fun?'";
			LineBreak;
			say "     Jaks looks really quite built and strong, and he's got more of an amused expression than an angry one... so you don't think violence is an answer here. Instead, you reply:[line break]";
			LineBreak;
			say "     [link](1)[as]1[end link] - That you're sorry to disturb him. (making a quick exit afterwards)[line break]";
			say "     [link](2)[as]2[end link] - Nothing - just step up and rub his furry balls. 'Convince' him to overlook your little intrusion with a bit of tongue-work.[line break]";
			say "     [link](3)[as]3[end link] - That you want him to fuck you. That should convince him to turn a blind eye on taking one little sample bottle of fine wine.[line break]";
			now calcnumber is 0;
			while calcnumber < 1 or calcnumber > 3:
				say "Choice? (1-3)>[run paragraph on]";
				get a number;
				if calcnumber is 1 or calcnumber is 2 or calcnumber is 3:
					break;
				else:
					say "Invalid choice. Type [link]1[end link] to just make an exit, [link]2[end link] to give Jaks a blowjob or [link]3[end link] to get fucked.";
			if calcnumber is 1: [exit]
				LineBreak;
				say "     Accompanied by some fast-talked apologies for your intrusion, slink away from him and turn to leave. The satyr says to your back, 'Hmh. In my youthful days we knew how to properly raid a wine-cellar. Or at least what to do when caught. Oh well, maybe you'll learn eventually. Okay - scram. Get out of here!' Shaking his head, the satyr laughs as you dash away and climb the ladder again.";
			else if calcnumber is 2: [BJ]
				LineBreak;
				say "     You keep your mouth closed, but show the muscled satyr a lusty smile as you raise a hand to brush it over the curly fur of his legs, running it along the inside of his thighs to reach his nice and round balls. As you cup Jaks full orbs and start to stroke them, the tall man lets out a pleased grunt and spreads his furry legs a little for easier access. 'Mmmh, cheeky aren't you,' he says in a lusty tone, putting his tools down on the table and turning around to lean back against its edge. The handsome satyr's manhood fills out in mere moments, standing as a proud pole over the hairy balls you're rolling gently in your hand. Licking your lips as you see a shining drop of pre-cum form at his slit, you crouch down in front of him and encircle the satyr's cockhead with your lips, giving a gentle suck that draws a deep moan from him.";
				say "     'Just like that,' the satyr tells you in a content hum, then reflexively stops a hoof on the stone floor as you move on to lap his cum factories before running your tongue-tip up the underside of his shaft. His breathing comes faster due to the randy male's soaring arousal, and he lets out a pleased grunt as you finally slide your lips over his cockhead again, then go lower and lower, taking in his thick shaft. Jaks truly has a magnificent piece of equipment, well-sized and with just the right girth, plus two quite prominent veins giving it an interesting look - and you don't stop till its all the way down your throat, with your nose pressing into the satyr's crotch, every breath taking in his masculine aroma and egging on your own arousal more and more.";
				WaitLineBreak;
				if cocks of player > 0:
					say "     Before long, you have your own pants pushed down far enough to free the erection now proudly swinging between your legs, stroking it rhythmically as you go down on the other male. ";
				else if cunts of player > 0:
					say "     Before long, you have your own pants pushed down far enough to allow free access to your crotch, letting you rub your clit rhythmically as you go down on the strong male. ";
				else:
					say "     Before long, you have your own pants pushed down far enough to allow free access to your crotch, letting you rub its sensitive flesh rhythmically as you go down on the strong male. ";
				say "Meanwhile, your partner gives lust-filled moans and grunts, as well as hoof-stomps, and you can tell that he's getting quite close. It's clear what that means - time to go all out! With a happy grin around the thick shaft in your mouth, you snake a hand between Jaks legs and seek out his quivering pucker with a finger, then push your digit inside him as you start to rapidly bounce your head up and down on his pole. 'Ngghh! YEAH. Oh dear Pan! You're... ngh, ngh ... you're GOOD at this! Yes! I'm close, really... close! GAH - Take my cum!' Jaks shouts and grunts loudly as you massage his prostate, then the satyr's tasty seed starts to pulse down your throat right into your stomach - until you pull back a bit and let him gush into your mouth, that is. The creamy, nutty bounty of his twitching balls covers your tongue and paints your tonsils white, to be eagerly swallowed a second later.";
				say "     As Jaks slowly winds down after giving you a stomach-full of his seed, you pull off his pole and take a few deep gasping breaths, then proceed to take care of your own arousal, ";
				if cocks of player > 0:
					say "jerking off in a rapid pace until you feel the familiar tightening in your balls and just hold on for dear life, feeling your manhood pulse as burst after burst of cum covers the stone floor in white streaks. ";
				else if cunts of player > 0:
					say "frigging your sensitive clit in a rapid pace until you feel the familiar up-welling of an orgasm, squirting femcum over your fingers and having it drip on the stone floor. ";
				else:
					say "frigging your sensitive crotch in a rapid pace until you feel the familiar up-welling of an orgasm, trembling all over as you kneel on the stone floor. ";
				say "Afterwards, you stand up on somewhat shaky knees and put your clothes back in order, then find your new friend standing over you with a satisfied smile on his face. 'I do look forward to having young bucks and does visiting,' he says with a chuckle, then holds out a little bottle of wine to you in a flourish. 'Here, take this. You earned it. Now get out of here, I got duties to perform, you know...' Giving him your thanks, you pocket the sample bottle of wine, then make your way down the short tunnel and to the stairs. Not long after, you're back in the lobby of the museum.";
				increase carried of Pan's Special Reserve by 1;
				if JaksEncounters < 2: [no BJ before]
					now JaksEncounters is 2; [gave him a BJ]
			else if calcnumber is 3: [fuck]
				LineBreak;
				say "     Stepping up and looking the hunky satyr in the eye, you make the offer of giving up your [if cunts of player > 0]pussy[else]ass[end if] to him, resulting in Jaks looking down over your form appreciatively. A little movement at the corner of your view draws your attention - and you realize that it's his manhood rapidly filling out to a full erection as you glance down. 'I gladly accept,' the horny satyr says in a very satisfied tone, leaning in and sliding an arm around your chest to pull you in for a kiss. His curly beard tickles pleasantly as you make out with him, tongues wrestling with one another. Coming up for air a long moment later, the satyr sets down the little wine bottle carefully, then grabs hold of you with both hands. Jaks hefts you up, allowing you to encircle his hips with both legs as he goes on to kiss you again and again, then carries you over to the table.";
				say "     Impatiently shoving the wooden tools (hammers, and taps and whatnot) off the table, making them clatter to the stone floor, your satyr partner lowers you to the tabletop in a gentle manner, then proceeds to peel off the clothes and gear you're wearing. Soon, you're naked all the way, revealing your [bodytype of player] form to his appreciative gaze and Jaks strokes you with his hands, caressing and squeezing just the right spots. Trembling under his ministrations, you writhe and quiver in pleasure, then soon feel something firm and hot poke your inner thigh. Looking down, the well-sized manhood of this hunky satyr reveals itself as the culprit, and you give a soft moan at the thought of feeling it inside you. Jaks smiles at where your attention lies and leans in for a peck, then says in a husky whisper, 'I'm really looking forward to giving you a ride on it...'";
				WaitLineBreak;
				say "     The muscled satyr then crouches down suddenly, bringing his head to the height of your hips as they lay on edge of the table. An eye-blink later, you can feel his talented tongue licking you, seeking out the [if cunts of player > 0]moist pussy already waiting for his touch[else]trembling pucker already waiting for his touch[end if]. Lapping away - first slowly, then with increased energy - Jaks teases you a short while and gets you wet with his spit, then eventually stands up and aligns his manhood with your body. 'Better hold on well,' he jokes, guiding your legs to encircle his hips once more and nodding as you brace against the wall with your arms. The grinning satyr blows you a kiss, then presses his hips forward, [if cunts of player > 0]sliding his thick shaft right into your depths[else]building a little pressure against the iris of your butthole before the muscle yields to allow him to slide in. His thick shaft sinks into your depths and stretches the passage wide, giving you a pleasantly full feeling[end if].";
				say "     Bottoming out after penetrating you slowly but surely, the horned hunk grunts, 'Yeah! You feel great babe!' Then he proceeds to pull back and thrusts in again, starting to fuck you in a steady pace. The wine-cellar fills with the sounds of sex - grunts and moans from the two of you, as well as the thump of the table hitting the wall on Jaks harder thrusts, together with the clink of the other bottles in their crate still standing on the table. Your partner really knows how to treat [if cunts of player > 0]a woman[else if cocks of player > 0]a man[else]his sexual partners[end if], hitting just the right spots deep inside you with every last thrust and also rotating his hips a little to wake ever new sensations as he penetrates deeply.";
				WaitLineBreak;
				say "     Time loses all real meaning as the pleasure he fills you with dominates your mind, with moment after moment being filled with ecstasy. Thus, you don't really know how long he fucked you (nor do you really care) before your arousal eventually boils over and you shout out in completion, [if cocks of player > 0]your manhood twitching and pulsing as spurt after spurt of cum shoots out and splatters your chest in long streaks[else if cunts of player > 0]your pussy twitching as femcum squirts from between its stretched-open folds[else]your body trembling and twitching as an orgasm rocks your whole being[end if]. As you flop down on the table, still reeling from your explosive climax, Jaks humping becomes even more intense, with him clearly liking the way your muscles squeeze his manhood. It does only take a few more moments before he lets out a satisfied bellow, thrusting all the way into you one last time and pumping quite a load of his seed into your depths. The satyr leans over you to kiss you as his cock still pulses with more and more cum, and he keeps making out with you until his climax eventually winds down.";
				if cunts of player > 0:
					say "[fimpregchance]";
				else:
					say "[mimpregchance]";
				say "     Pushing himself up from the table with both strong arms, Jaks looks down at you with a cheeky grin on his face, then says, 'Pleasure having you here as a visitor. I wouldn't mind if you came along more often.' He pulls his spent cock from your body slowly and gently, wiping off a bit of cum sticking to the cockhead with a finger and then slurping it off with his tongue. The satyr helps you down from the table and waits for you to put your clothes in order, then holds out a little bottle of fine wine to you in a flourish. 'Here, take this. You earned it. Now get out of here, I got duties to perform, you know...' Giving him your thanks, you pocket the sample bottle of wine, then make your way down the short tunnel and to the stairs. Not long after, you're back in the lobby of the museum.";
				increase carried of Pan's Special Reserve by 1;
				if JaksEncounters < 3: [not fucked before]
					now JaksEncounters is 3; [fucked by Jaks]
			now LastJaksEncounter is turns;

Satyr Frat ends here.
