Version 2 of Seraphim by Wahn begins here.
[Version 2 - Actual Monster now with full infection and fight texts]

[ HP of Gabriel                                                              ]
[   0: not around yet                                                        ]
[   1: Elijah has been corrupted                                             ]
[   2: player saw Gabriel appear and ask for Elijah                          ]
[   3: player had a run-in with Gabriel before                               ]
[   4: Gabriel got fucked - now has genitals                                 ]
[   5: Gabriel got fucked - repeat                                           ]

[ Intelligence of Gabriel - commands for interaction with David              ]
[   0: everything goes                                                       ]
[  21: friendship only                                                       ]
[  41: sex only                                                              ]
[  99: interaction forbidden                                                 ]

[ Charisma of Gabriel - interaction with David (David's side)                ]
[   0: never talked                                                          ]
[  10: player made Gabriel suck off David                                    ]
[  11: talked after BJ, encouraged it                                        ]
[  30: David ran off after the player 'caught' him touching Gabriel          ]
[  31: talked after touching, encouraged it                                  ]
[  50: David and Gabriel kissed without player intervention                  ]
[  51: talked after kiss, encouraged it                                      ]
[  70: sex blocked from David's side, might become friends                   ]

[ Libido of Gabriel - cumslut training                                       ]
[   0: not offered yet                                                       ]
[   1: training stage 1: player made him lick up his cum, then a BJ/Fuck     ]
[  10: training stage 2: desperate for cum - sucks player of while they sleep]
[  11: training stage 2: allowed to suck sleeping player                     ]
[  12: training stage 2: forbidden from sucking sleeping player              ]
[  99: postponed                                                             ]
[ 100: refused                                                               ]

[ Stamina of Gabriel - last cum dose                                         ]

[ Energy of Gabriel - talk tracking                                          ]
[   0: never talked to him                                                   ]


Section 1 - Victory/Defeat Sex

to say SeraphDefeated:
	say "     Crumpling to his knees in exhaustion, Gabriel pants, 'You are far stronger than you are supposed to be. I yield, as I would have to harm you significantly if I met this with equal force.' He pulls the flaming sword from his hip and sets it down on the ground with calm movements, then looks at you with a concerned expression, 'You really should let me help you. Don't you see that resistance only hurts yourself?'";
	LineBreak;
	say "     Well, now that you've won this fight, what do you want to do?";
	say "     ([link]Y[as]y[end link]) - Take advantage of the angel.[line break]";
	say "     ([link]N[as]n[end link]) - Just leave.[line break]";
	if Player consents:
		LineBreak;
		if HP of Gabriel < 4: [didn't have sex before]
			say "     Excited by the opportunity of having this magnificent creature at your mercy, you lean over him and start pulling off his armor piece by piece, then soon move on to undo the fastenings of his robe. 'What are you doing?', Gabriel asks as you pull open his clothes and bare his muscled chest, then as you are undoing a golden belt-buckle, he adds, 'I am a protector - I wasn't created for what you seem to expect from me.' And it's true... pulling down the soft white fabric of his pants, you reveal a totally sexless smooth crotch. Gabriel says, 'Now you see. There is nothing I can do for you. You should -' Before he can add another word, you put a finger on his lips and shush him, all the while giving the angel a salacious grin that makes a hint of doubt in his confident expression appear.";
			if Player is male:
				say "     Even without genitals on his own body, there are lots of possibilities for fun with this pretty hunk - a whole lot more than the innocent virgin could even imagine. Your cock goes hard inside your pants from the idea of feeling those soft lips of his stretched around your shaft - but no, there is a greater prize to be had right now... between the two shapely buns of Gabriel's ass. How often does the opportunity of popping an angel's cherry present itself, after all. You continue unwrapping your beaten opponent some more until he's almost completely naked, just his white pants still pooled at his knees and covering the lower legs, then get a grip on the back of his head and pull him in for a surprise kiss that makes his eyes go round.";
				WaitLineBreak;
				say "     After making out with Gabriel for some very enjoyable moments, exploring his mouth with your tongue and finding yourself delighted by the confused and clueless reactions of a person who has never been kissed, you take a second to catch a breath, leaving the angel to pant loudly and look at you in wonder. As it's best to forge while the iron is hot - and the hottie still reeling from all the new sensation, you immediately proceed to grab him by the arm and pull Gabriel forwards. As he finds himself on all fours before you a moment later, a flash of realization at what will happen next spreads over Gabriel's face, causing his cheeks to turn red in embarrassment. Giving him a grin, you then stand up and walk around the angel to stand behind him.";
				say "     Quickly undoing your own pants and freeing your by now rock-hard erection, you kneel down behind the virgin hunk, then grab both of his well-rounded butt-cheeks with your hands and pull them apart, squeezing tightly as you do so. The nice and pink pucker between his shapely buns looks very inviting and you stretch your thumb to rub lightly over it, provoking a breathless little pant from your captive, which leads over into silent moaning as you proceed to stroke over the bumps and wrinkles of his pucker in teasing slowness. Gathering a bit of spit and smearing that on his back door to help lube the way, you then push your index finger against Gabriel's hole, slowly increasing pressure and wiggling it a bit until his muscle yields and you can slip right in.";
				WaitLineBreak;
				say "     Your winged hunk can't help but gasp and moan as you explore his pretty tight, virgin hole with your probing digit, stroking sensitive spots. It's quite a bit of fun to see what noises you can let him make if you for example... wiggle your fingertip like so - which makes Gabriel give a half-panted squeak of arousal - or bend your finger to rub another specific spot... which draws a full-throated moan out of him and makes his toes curl up. In fact, you find yourself distracted quite a bit with this fun game, stroking him and adding another finger, then a third, until you eventually remember there is another exciting thing you can do with the angel.";
				say "     As you pull your fingers from Gabriel's hole, the muscled guy pants loudly and his pucker winks at you as he tries to prepare himself for whatever new way you'll touch him next - though he falls into shocked silence as not a finger but rather the tip of your cock nudges his opening and sinks inside. There is an instinctive tightening of his muscles around your unexpected invasion - but you're already halfway inside him, making him only squeeze down on your shaft in a most stimulating manner that feels pretty great. Giving Gabriel a moment to get used to the hot and hard pole now inside his body, you revel in the tightness of his passage around your cock, then eventually tell him to relax and start to press even deeper.";
				WaitLineBreak;
				say "     Before long, you bottom out inside the handsome angel and lean forward to lick him between his wings and nibble his ear, then - in a whisper - ask him if your [cock of Player] cock feels good inside him. There is a short moment of silence in which you first think he won't answer, then you can hear a low, 'Yes... its wrong, but... I like it.' And he really does - after getting over the first shock of finding himself being fucked, Gabriel turns out to be a very receptive - and vocal - partner, gasping and moaning loudly while his inner muscles grip your thrusting shaft. You give the angel a good and long pounding, really laying into him with deep thrusts that make him gasp in lust, and eventually drive the winged hunk to his first orgasm, trembling and twitching all over.";
				say "     The sensations of Gabriel's anal muscles flexing around your cock, in addition to the satisfaction of picking his cherry, push you over the edge too in short notice and you thrust in deep one last time until your crotch meets his cheeks with a satisfying slap. Balls-deep in the no-longer virgin angel, you unload everything that you have from your balls, blasting your thick, creamy cum into him. Spurt after spurt fills Gabriel up as he moans and pants like a good bottom-boy should.";
				WaitLineBreak;
				say "     When your orgasm finally winds down, you pull out of the angel and wipe the last bit of cum sticking to your prick off on his buttcheeks, then pull up your pants and grab all the gear that you put down before having sex. With a spring in your step - from having fucked such a hottie, and a virgin no less - you walk down the street, leaving the cum-dripping angel to pick himself up on his own.";
				NPCSexAftermath Gabriel receives "AssFuck" from Player;
			else:
				say "     Even without genitals on his own body, there are lots of possibilities for fun with this pretty hunk - a whole lot more than the innocent virgin could even imagine. [if Player is female]Your pussy gets wet from the thought of having him licking you down there [else]You get pretty excited from the thought of him licking your sensitive skin on the crotch [end if]- but no, to break him in to sex for good, you'll concentrate on something else right now... with it between the two shapely buns of Gabriel's ass. Also, how often does the opportunity of popping an angel's cherry present itself? You continue unwrapping your beaten opponent some more until he's almost completely naked, just his white pants still pooled at his knees and covering the lower legs, then get a grip on the back of his head and pull him in for a surprise kiss that makes his eyes go round.";
				WaitLineBreak;
				say "     After making out with Gabriel for some very enjoyable moments, exploring his mouth with your tongue and finding yourself delighted by the confused and clueless reactions of a person who has never been kissed, you take a second to catch a breath, leaving the angel to pant loudly and look at you in wonder. As it's best to forge while the iron is hot - and the hottie still reeling from all the new sensation, you immediately proceed to grab him by the arm and pull Gabriel forwards. As he finds himself on all fours before you a moment later, a flash of realization at what will happen next spreads over Gabriel's face, causing his cheeks to turn red in embarrassment. Giving him a grin, you then stand up and walk around the angel to stand behind him.";
				say "     You kneel down behind the virgin hunk, then grab both of his well-rounded butt-cheeks with your hands and pull them apart. Squeezing their firm flesh appreciatively as you do so, the nice and pink pucker between his shapely buns is revealed, looking very inviting. You stretch your thumb to rub lightly over it, provoking a breathless little pant from your captive, which quickly leads over into silent moaning as you proceed to stroke over the bumps and wrinkles of his pucker in teasing slowness. Gathering a bit of spit and smearing that on his back door to help lube the way, you then push your index finger against Gabriel's hole, slowly increasing pressure and wiggling it a bit until his muscle yields and your fingertip can slip right in.";
				WaitLineBreak;
				say "     Your winged hunk can't help but gasp and moan as you explore his pretty tight, virgin hole with your probing digit, stroking sensitive spots. It's quite a bit of fun to see what noises you can let him make if you for example... wiggle your fingertip like so - which makes Gabriel give a half-panted squeak of arousal - or bend your finger to rub another specific spot... which draws a full-throated moan out of him and makes his toes curl up. Before long, as you continue fondling the handsome angel, you lean forward to lick him between his wings and nibble his ear, then - in a whisper - ask him if he likes what you're doing. There is a short moment of silence in which you first think he won't answer, then you can hear a low, 'Yes... its wrong, but... I like it.'";
				say "     And he really does - after getting over the first shock of having his ass played with, Gabriel turns out to be a very receptive - and vocal - partner, gasping and moaning loudly while his inner muscles grip your questing fingers. You stimulate the angel more and more, really finding all his pressure points and tickling them and eventually drive the winged hunk to his first orgasm, trembling and twitching all over. When you eventually pull out your fingers, he even moves with you a little bit, trying to keep them inside - just like a good bottom-boy should.";
				WaitLineBreak;
				say "     Standing up, you go and grab all the gear that you put down before deciding to have fun with Gabriel, then walk away, leaving the worn out and still panting angel to pick himself up on his own.";
			now HP of Gabriel is 4;
			now Cock Count of Gabriel is 1;
			now Cock Length of Gabriel is 9;
			now Ball Size of Gabriel is 3;
		else if HP of Gabriel is 4: [had sex before]
			say "     Excited by the opportunity of having this magnificent creature at your mercy, you lean over him and start pulling off his armor piece by piece, then soon move on to undo the fastenings of his robe. 'Again?', Gabriel asks as you pull open his clothes and bare his muscled chest, then as you are undoing a golden belt-buckle, he adds, 'I've been feeling... different, since last time. My body... changed.' And it's true - pulling down the soft white fabric of his pants, you reveal that where previously there was only sexless smoothness, now a respectably sized manhood dangles between his legs. Gabriel looks down at his cock a bit sheepishly, then says, 'The tiny machines that infuse everything around here added this to me. It is... irregular. I wasn't created for -' Before he can add another word, you put a finger on his lips and shush him, all the while giving the angel a salacious grin.";
			if Player is male: [males and herms]
				say "     Continuing to strip Gabriel all the way until he's bare-ass naked, you lay out his clothes on top of each other, then gently press against the angel's chest, pushing him to lie back on the soft layer of fabric. He looks pretty amazing, stretched out on the ground before you in his well-built beauty and with white wings stretched to the sides - so much so that you can't help but want to feel his lips on yours. Leaning over the naked male, you put your hands on his upper arms to brace yourself and pin him down, then give him a deep and hungry kiss. And... quite interestingly, Gabriel replies in kind, the feelings you've just awoken leading him to actively participate in a very nice making-out session.";
				say "     You'd love to continue snogging with the handsome male for quite a while - but at one point, a sudden feeling of being poked in the stomach distracts you from him. Looking down, you see that it's Gabriel's cock, by now fully hard and ready for action. Reaching out to take hold of his manhood, you stroke the angel, making him arch his back and moan loudly from all the novel sensations he is going through. The youthful male's breathing soon comes faster and faster and a clear drop of pre forms at the slit of his cockhead, glistening in the light - which is exactly when you suddenly stop and pull your hand away.";
				WaitLineBreak;
				say "     The angel looks up at you with a surprised expression, panting quickly in built-up arousal as his eyes jump between your hand and the erect pole standing proudly over his crotch. Gabriel's deep need to get off is painfully obvious on that unlined face of his, but as second after second ticks by and you don't react, he clears his throat and says in a pleading voice, 'Please... can - can you continue with...' Giving a wide smile at the angel, you do take hold of his cock again - but only with two fingers and your thumb, slowly, very slowly stroking up and down. As you continue this merciless teasing for a minute, then two, Gabriel gets pretty tense and even reaches out to grab his own cock - which you stop by clearing your throat and pushing his hand aside.";
				say "     Eventually, when he's all twitchy and can't suppress needy little whimpers at each touch anymore, you do ask if he wants you to show him another technique that is sure to him off - to which he almost screams, 'Yes, please! Anything!' You can't help but grin at having reduced the proud angel to this, lying before you in all his naked beauty and begging for you to take him - which is exactly what you plan to do. Quickly standing up and stripping off your clothes, you're kneeling between his legs a moment later and slide both hands up the inside of Gabriel's thighs. Taking hold of his legs, you raise and spread them to bare his tight little pucker, the view of which makes your hard cock pulse in anticipation.";
				WaitLineBreak;
				say "     Without any further delay, you line up your erection with your captive angel's winking hole, then thrust in deep into his warm and tight chute. There is a breathless groan from Gabriel at the sudden invasion, leading over to lust-filled moaning as you proceed until you bottom out inside him. Giving him a short moment to get used to it - you then pull most of the way back out and start fucking the angel's hole with hard and deep thrusts. Gabriel just feels amazing to be in, with a yielding yet very tight hole and anal muscles that seem to know instinctively when to flex around your shaft. As wound up as you got him and with your own satisfaction of how nicely this is working out, it doesn't take all that long until the two of you approach your respective orgasms.";
				say "     Coming more or less at the same time, you sink your manhood deep and blast the first spurt of your creamy cum into Gabriel, while he grips the fabric of his clothes on the ground tightly with both hands and sprays a quite respectable load into the air to splat down all over his chest and neck. It's pretty cute how he moans and pants as you fill him up - just like a good bottom-boy should. You can't help but think how awesome it would be to just... keep him, having an eager little slut to breed whenever you want to. Though you guess you'd have to break him in a bit more before that.";
				WaitLineBreak;
				say "     When your orgasm finally winds down, you pull out of the angel and wipe the last bit of cum sticking to your prick off on his buttcheeks, then go and grab your clothes and gear, putting it all back on. With a spring in your step - from having fucked such a hottie - you walk down the street, leaving the cum-dripping angel to pick himself up on his own.";
				NPCSexAftermath Gabriel receives "AssFuck" from Player;
			else: [females and neuter]
				say "     Continuing to strip Gabriel all the way until he's bare-ass naked, you lay out his clothes on top of each other, then gently press against the angel's chest, pushing him to lie back on the soft layer of fabric. He looks pretty amazing, stretched out on the ground before you in his well-built beauty and with white wings stretched to the sides - so much so that you can't help but want to feel his lips on yours. Leaning over the naked male, you put your hands on his upper arms to brace yourself and pin him down, then give him a deep and hungry kiss. And... quite interestingly, Gabriel replies in kind, the feelings you've just awoken leading him to actively participate in a very nice making-out session.";
				say "     You'd love to continue snogging with the handsome male for quite a while - but at one point, a sudden feeling of being poked in the stomach distracts you from him. Looking down, you see that it's Gabriel's cock, by now fully hard and ready for action. Reaching out to take hold of his manhood, you stroke the angel, making him arch his back and moan loudly from all the novel sensations he is going through. The youthful male's breathing soon comes faster and faster and a clear drop of pre forms at the slit of his cockhead, glistening in the light - which is exactly when you suddenly stop and pull your hand away.";
				WaitLineBreak;
				say "     The angel looks up at you with a surprised expression, panting quickly in built-up arousal as his eyes jump between your hand and the erect pole standing proudly over his crotch. Gabriel's deep need to get off is painfully obvious on that unlined face of his, but as second after second ticks by and you don't react, he clears his throat and says in a pleading voice, 'Please... can - can you continue with...' Giving a wide smile at the angel, you do take hold of his cock again - but only with two fingers and your thumb, slowly, very slowly stroking up and down. As you continue this merciless teasing for a minute, then two, Gabriel gets pretty tense and even reaches out to grab his own cock - which you stop by clearing your throat and pushing his hand aside.";
				say "     Eventually, when he's all twitchy and can't suppress needy little whimpers at each touch anymore, you do ask if he wants you to show him another technique that is sure to him off - to which he almost screams, 'Yes, please! Anything!' You can't help but grin at having reduced the proud angel to this, lying before you in all his naked beauty and begging for you to take him - which is exactly what you plan to do. Quickly standing up and stripping off your clothes, you're kneeling over him a moment later, with knees left and right of Gabriel's hips. Then, without any further delay, you reach down to take hold of his erection and lower your hips a bit. [if Player is female]There is the magic moment when the tip of his cock first nudges your nether lips, making both of you moan in lust, then his manhood slides into your dripping wet and swollen pussy, filling you quite nicely and rubbing many sensitive spots deep inside[else]There is the magic moment when the tip of his cock first nudges your crack, making both of you moan in lust, then with a little help, his manhood presses directly against your pucker. Having prepared yourself and relaxed properly, it doesn't take long until your muscle yields to the pressure and Gabriel's cock slides right into your tight hole, filling you quite nicely and rubbing many sensitive spots deep inside[end if].";
				WaitLineBreak;
				say "     Leaning over your captive angel and pinning his arms down with your hands to show that you're still the one in control, you gyrate your hips and ride him hard, raising yourself up and then slamming down again to take all of his prick at once. Gabriel accepts you holding him down without any problems, panting loudly as he's being fucked, though at some point, he can't help himself and starts to buck his hips up and down. Seems like he's not completely submissive (yet?) - but then, he doesn't have to be, as his own movements add a nice little bit of fun to your coupling. Your sexy angel feels amazing inside you, with his cock having both the length and girth to really get to the good spots...";
				say "     As wound up as you got him and with your own satisfaction of how nicely this is working out, it doesn't take all that long until the two of you approach your respective orgasms. Coming more or less at the same time, you lower yourself on his pole all the way, trembling as your femcum squirts out and soaks his pubes, while Gabriel grips the fabric of his clothes on the ground tightly with both hands and sprays a quite respectable load into your body, squirting directly into your womb as his cockhead is tightly pressed against your cervix. As the warmth of his seed fills you more and more, you can't help but think how awesome it would be to just... keep him, having an eager little slut to breed you whenever you want him to. Though you guess you'd have to break him in a bit more before that.";
				WaitLineBreak;
				say "     When your orgasm finally winds down, you pull away from the angel, his cock leaving your body with a wet slurp and a small gush of cum. Then you go and grab your clothes and gear, putting it all back on. With a spring in your step - from having fucked such a hottie - you walk down the street, leaving the cum-dripping angel to pick himself up on his own.";
				NPCSexAftermath Player receives "PussyFuck" from Gabriel;
			now HP of Gabriel is 5;
		else if HP of Gabriel is 5: [saw Gabriel's genitals before]
			say "     Excited by the opportunity of having this magnificent creature at your mercy, you lean over him and start pulling off his armor piece by piece, then soon move on to undo the fastenings of his robe. 'Again?', Gabriel asks as you pull open his clothes and bare his muscled chest, then as you are undoing a golden belt-buckle, he adds, 'I must admit... I have been thinking about what you've been doing with me. It is... strangely exciting.' A moment later, your actions reveal the physical manifestation of Gabriel's submissive desires - an already half-hard cock, dangling between his legs. The angel looks down at his cock a bit sheepishly, then says, 'It does feel nice, but at the same time it is... irregular. I wasn't created for -' Before he can add another word, you put a finger on his lips and shush him, all the while giving the shy guy a salacious grin.";
			if Player is male: [males and herms]
				say "     Continuing to strip Gabriel all the way until he's bare-ass naked, you lay out his clothes on top of each other, then gently press against the angel's chest, pushing him to lie back on the soft layer of fabric. He looks pretty amazing, stretched out on the ground before you in his well-built beauty and with white wings stretched to the sides - so much so that you can't help but want to feel his lips on yours. Leaning over the naked male, you put your hands on his upper arms to brace yourself and pin him down, then give him a deep and hungry kiss. And Gabriel replies in kind, the feelings your previous interactions have awoken leading him to actively participate in a very nice making-out session.";
				say "     You'd love to continue snogging with the handsome male for quite a while - but at one point, a sudden feeling of being poked in the stomach distracts you from him. Looking down, you see that it's Gabriel's cock, by now fully hard and ready for action. Reaching out to take hold of his manhood, you stroke the angel, making him arch his back and moan loudly from all the still rather new sensations he is going through. The youthful male's breathing soon comes faster and faster and a clear drop of pre forms at the slit of his cockhead, glistening in the light - which is exactly when you suddenly stop and pull your hand away.";
				WaitLineBreak;
				say "     The angel looks up at you with a surprised expression, panting quickly in built-up arousal as his eyes jump between your hand and the erect pole standing proudly over his crotch. Gabriel's deep need to get off is painfully obvious on that unlined face of his, but as second after second ticks by and you don't react, he clears his throat and says in a pleading voice, 'Please... can - can you continue with...' Giving a wide smile at the angel, you do take hold of his cock again - but only with two fingers and your thumb, slowly, very slowly stroking up and down. As you continue this merciless teasing for a minute, then two, Gabriel gets pretty tense and even reaches out to grab his own cock - which you stop by clearing your throat and pushing his hand aside.";
				say "     Eventually, when he's all twitchy and can't suppress needy little whimpers at each touch anymore, you tell Gabriel that you can keep this up all day - and also that he knows how to get his sweet release. Your massively aroused captive gives a few panting breaths, then silently pleads, 'Fuck me.' Acting like you didn't hear him, you just continue with your merciless teasing a moment longer, until Gabriel says, 'Fuck me. Please.' a bit louder, in answer to which you casually whistle and say that he should speak up. Eventually, after another minute or so of slow, slow jerking on his shaft, he gives an aroused wail of, 'Take me! Please! I need to feel you in me!' You can't help but grin at having reduced the proud angel to this, lying before you in all his naked beauty and begging for a fuck - which is exactly what you plan to do now. Quickly standing up and stripping off your clothes, you're kneeling between his legs a moment later and slide both hands up the inside of Gabriel's thighs. Taking hold of his legs, you raise and spread them to bare his tight little pucker, the view of which makes your hard cock pulse in anticipation.";
				WaitLineBreak;
				say "     Without any further delay, you line up your erection with your captive angel's winking hole, then thrust in deep into his warm and tight chute. There is a breathless groan from Gabriel at the sudden invasion, leading over to lust-filled moaning as you proceed until you bottom out inside him. Giving him a short moment to get used to it - you then pull most of the way back out and start fucking the angel's hole with hard and deep thrusts. Gabriel just feels amazing to be in, with a yielding yet very tight hole and anal muscles that seem to know instinctively when to flex around your shaft. As wound up as you got him and with your own satisfaction of how nicely this is working out, it doesn't take all that long until the two of you approach your respective orgasms.";
				say "     Coming more or less at the same time, you sink your manhood deep and blast the first spurt of your creamy cum into Gabriel, while he grips the fabric of his clothes on the ground tightly with both hands and sprays a quite respectable load into the air to splat down all over his chest and neck. It's pretty cute how he moans and pants as you fill him up - just like a good bottom-boy should. You can't help but think how awesome it would be to just... keep him, having an eager little slut to breed whenever you want to. After imagining some very nice scenes starring this cutie and yourself, you bring your eyes into focus again... and notice the narrow little storefront of a nearby sex shop for the first time. Especially the sign 'Custom Leather-Work' does draw your attention.";
				LineBreak;
				say "     Do you want to use the opportunity to duck in there and see if you can find something that fits Gabriel?";
				if Player consents:
					LineBreak;
					say "     After waiting some moments until your orgasm finally winds down, you pull out of the angel and wipe the last bit of cum sticking to your prick off on his buttcheeks, then go and grab your clothes and gear, putting it all back on. With a spring in your step, you walk down the street to the store, leaving the cum-dripping angel to pick himself up on his own while you browse some wares. The store has been partially ransacked before, as is evident by the many empty spots in the shelves and a pile of what must have been all the lube bottles they had stockpiled, bone-dry and empty. Almost looks like something drank them all out - who or what would do such a thing? But no matter... the creature or creatures are long gone, leaving you with quite a chaos to look through.";
					say "     Thankfully, prodding around here and there fore a minute or three does indeed reveal a mannequin-like plastic bust, still with a very well made collar tight around its neck. It's just perfect for your little feathered bitch - complete with a few decorative spike studs and a ring for a leash at the front end. Holding your prize in hand, you emerge from the store to find Gabriel just adjusting his robe and then closing its belt. The angel's eyes widen as he realizes you didn't leave but are coming back, then his eyebrows draw together in wonder at the collar you hold up demonstratively. He doesn't resist as you put the piece of soft leather-work on him, only raising a hand to feel its tightness when you close the little buckle to fasten the collar around his neck. Again pre-empting a question from Gabriel, you tell him that it looks very nice and you'd like to see him wear the collar all the time now. After giving the calm threat of not letting him get off - at all - when you next have him in your grasp, you leave the angel standing in the empty street and get back to other matters.";
					now HP of Gabriel is 6;
				else:
					LineBreak;
					say "     No, now isn't the time for that. Maybe another time. When your orgasm finally winds down, you pull out of the angel and wipe the last bit of cum sticking to your prick off on his buttcheeks, then go and grab your clothes and gear, putting it all back on. With a spring in your step - from having fucked such a hottie - you walk down the street, leaving the cum-dripping angel to pick himself up on his own.";
				NPCSexAftermath Gabriel receives "AssFuck" from Player;
			else: [females and neuter]
				say "     Continuing to strip Gabriel all the way until he's bare-ass naked, you lay out his clothes on top of each other, then gently press against the angel's chest, pushing him to lie back on the soft layer of fabric. He looks pretty amazing, stretched out on the ground before you in his well-built beauty and with white wings stretched to the sides - so much so that you can't help but want to feel his lips on yours. Leaning over the naked male, you put your hands on his upper arms to brace yourself and pin him down, then give him a deep and hungry kiss. And Gabriel replies in kind, the feelings your previous interactions have awoken leading him to actively participate in a very nice making-out session.";
				say "     You'd love to continue snogging with the handsome male for quite a while - but at one point, a sudden feeling of being poked in the stomach distracts you from him. Looking down, you see that it's Gabriel's cock, by now fully hard and ready for action. Reaching out to take hold of his manhood, you stroke the angel, making him arch his back and moan loudly from all the novel sensations he is going through. The youthful male's breathing soon comes faster and faster and a clear drop of pre forms at the slit of his cockhead, glistening in the light - which is exactly when you suddenly stop and pull your hand away.";
				WaitLineBreak;
				say "     The angel looks up at you with a surprised expression, panting quickly in built-up arousal as his eyes jump between your hand and the erect pole standing proudly over his crotch. Gabriel's deep need to get off is painfully obvious on that unlined face of his, but as second after second ticks by and you don't react, he clears his throat and says in a pleading voice, 'Please... can - can you continue with...' Giving a wide smile at the angel, you do take hold of his cock again - but only with two fingers and your thumb, slowly, very slowly stroking up and down. As you continue this merciless teasing for a minute, then two, Gabriel gets pretty tense and even reaches out to grab his own cock - which you stop by clearing your throat and pushing his hand aside.";
				say "     Eventually, when he's all twitchy and can't suppress needy little whimpers at each touch anymore, you tell Gabriel that you can keep this up all day - and also that he knows how to get his sweet release. Your massively aroused captive gives a few panting breaths, then silently pleads, 'Fuck me.' Acting like you didn't hear him, you just continue with your merciless teasing a moment longer, until Gabriel says, 'Fuck me. Please.' a bit louder, in answer to which you casually whistle and say that he should speak up. Eventually, after another minute or so of slow, slow jerking on his shaft, he gives an aroused wail of, 'Take me! Please! I need to feel you around my cock!' You can't help but grin at having reduced the proud angel to this, lying before you in all his naked beauty and begging for you to take him - which is exactly what you plan to do. Quickly standing up and stripping off your clothes, you're kneeling over him a moment later, with knees left and right of Gabriel's hips. Then, without any further delay, you reach down to take hold of his erection and lower your hips a bit. [if Player is female]There is the magic moment when the tip of his cock first nudges your nether lips, making both of you moan in lust, then his manhood slides into your dripping wet and swollen pussy, filling you quite nicely and rubbing many sensitive spots deep inside[else]There is the magic moment when the tip of his cock first nudges your crack, making both of you moan in lust, then with a little help, his manhood presses directly against your pucker. Having prepared yourself and relaxed properly, it doesn't take long until your muscle yields to the pressure and Gabriel's cock slides right into your tight hole, filling you quite nicely and rubbing many sensitive spots deep inside[end if].";
				WaitLineBreak;
				say "     Leaning over your captive angel and pinning his arms down with your hands to show that you're still the one in control, you gyrate your hips and ride him hard, raising yourself up and then slamming down again to take all of his prick at once. Gabriel accepts you holding him down without any problems, panting loudly as he's being fucked, though at some point, he can't help himself and starts to buck his hips up and down. Seems like he's not completely submissive (yet?) - but then, he doesn't have to be, as his own movements add a nice little bit of fun to your coupling. Your sexy angel feels amazing inside you, with his cock having both the length and girth to really get to the good spots...";
				say "     As wound up as you got him and with your own satisfaction of how nicely this is working out, it doesn't take all that long until the two of you approach your respective orgasms. Coming more or less at the same time, you lower yourself on his pole all the way, trembling as your femcum squirts out and soaks his pubes, while Gabriel grips the fabric of his clothes on the ground tightly with both hands and sprays a quite respectable load into your body, squirting directly into your womb as his cockhead is tightly pressed against your cervix. As the warmth of his seed fills you more and more, you can't help but think how awesome it would be to just... keep him, having an eager little slut to breed you whenever you want him to. After imagining some very nice scenes starring this cutie and yourself, you bring your eyes into focus again... and notice the narrow little storefront of a nearby sex shop for the first time. Especially the sign 'Custom Leather-Work' does draw your attention.";
				LineBreak;
				say "     Do you want to use the opportunity to duck in there and see if you can find something that fits Gabriel?";
				if Player consents:
					LineBreak;
					say "     After waiting some moments until your orgasm finally winds down, you pull away from the angel, his cock leaving your body with a wet slurp and a small gush of cum. With a spring in your step, you walk down the street to the store, leaving the sweaty and somewhat sticky angel to pick himself up on his own while you browse some wares. The store has been partially ransacked before, as is evident by the many empty spots in the shelves and a pile of what must have been all the lube bottles they had stockpiled, bone-dry and empty. Almost looks like something drank them all out - who or what would do such a thing? But no matter... the creature or creatures are long gone, leaving you with quite a chaos to look through.";
					say "     Thankfully, prodding around here and there fore a minute or three does indeed reveal a mannequin-like plastic bust, still with a very well made collar tight around its neck. It's just perfect for your little feathered bitch - complete with a few decorative spike studs and a ring for a leash at the front end. Holding your prize in hand, you emerge from the store to find Gabriel just adjusting his robe and then closing its belt. The angel's eyes widen as he realizes you didn't leave but are coming back, then his eyebrows draw together in wonder at the collar you hold up demonstratively. He doesn't resist as you put the piece of soft leather-work on him, only raising a hand to feel its tightness when you close the little buckle to fasten the collar around his neck. Again pre-empting a question from Gabriel, you tell him that it looks very nice and you'd like to see him wear the collar all the time now. After giving the calm threat of not letting him get off - at all - when you next have him in your grasp, you leave the angel standing in the empty street and get back to other matters.";
					now HP of Gabriel is 6;
				else:
					WaitLineBreak;
					say "     When your orgasm finally winds down, you pull away from the angel, his cock leaving your body with a wet slurp and a small gush of cum. Then you go and grab your clothes and gear, putting it all back on. With a spring in your step - from having fucked such a hottie - you walk down the street, leaving the cum-dripping angel to pick himself up on his own.";
				NPCSexAftermath Player receives "PussyFuck" from Gabriel;
		else if HP of Gabriel is 6:
			say "     Excited by the opportunity of continuing Gabriel's training, you lean over him and start pulling off his armor piece by piece, then soon move on to undo the fastenings of his robe. 'Again? Ooohh...' the angel sighs in a needy voice as you pull open his clothes and bare his muscled chest, then as you are undoing a golden belt-buckle, he adds, 'I couldn't stop thinking about what you've been doing with me. The collar was a constant reminder, and... I got quite excited as I imagined you, and me...' A moment later, your actions reveal the physical manifestation of Gabriel's submissive desires - an already half-hard cock, dangling between his legs. The angel looks down at his cock a bit sheepishly, then says, 'I - I am ready for your pleasure... Do you want to -' Before he can add another word, you put a finger on his lips and shush him, all the while giving the shy guy a salacious grin.";
			WaitLineBreak;
			if Player is male: [males and herms]
				say "     Continuing to strip Gabriel all the way until he's bare-ass naked, you wrap all the gear in a bundle with his clothes, then swing that over your shoulder and walk down the street. The winged hunk gapes after you, opening and closing his mouth in shock a few times, then finally gets over his paralysis and hurries after you. It's a sight to behold - those flawless muscles of his body moving in concert without a stitch of clothing to hide them. You can't help but grin as you watch Gabriel come closer quickly, finally taking position by your side and starting to shyly ask, 'Didn't you want to -' A commanding shush stops the words still in his mouth, making the angel fall quiet as you lead him through the streets of the red light district.";
				say "     Before long, your little party has drawn the attention of more than a few inhabitants of the area, with wolf whistles and comments like 'Oooh, look at that ass' and 'Wanna show me what you can do with that pole, fly-boy?' Cute, how pink Gabriel can turn in the face, clearly embarrassed but held back from even trying to cover himself with his hands by your command. Eventually, you choose one of the available porn stores and enter it, starting to browse what hasn't been looted yet - though you soon notice that Gabriel didn't come with you. The naked angel is still standing right at the entrance of the store, looking with big eyes at an emptied out stand of porn DVDs. The discs may be gone, but the quite explicit cardboard mock-up still stands - and has more than a little bit of effect on Gabriel's manhood, making it stand straight too.";
				WaitLineBreak;
				say "     A sharp whistle from you stops Gabriel's hand from creeping any closer to his crotch, and also serves to frighten the angel out of his aroused haze. Both hands whipping to his side as he instinctively stands to attention, he shame-facedly looks down as you remind him that he may not touch himself. A moment later, the angel meekly follows you again as you pass all the empty shelves and step over strewn about lube bottles. They're all empty too, leaving you to wonder if maybe something drank the contents. It's not as unlikely as one might think, not these days. Soon, a door at the back draws your attention, saying 'Workshop' and 'Custom Items' on it. Trying the doorknob, you find that it is locked, but thankfully a short search behind the store's counter reveals a key.";
				say "     Unlocking and entering the porn store's workshop, you find yourself in a mid-sized room filled with leather-working tools, a low fuck-bench with restraints and... jackpot! There's a sturdy frame bolted to the back wall, holding up a well-crafted sex sling. Just the right thing for your little angel. You draw Gabriel close and give him a deep kiss, putting your tongue into the male's mouth as he trembles in arousal. Then you walk him towards the sling and give him a little push to fall right into it. The needy expression on his face and a sighed, 'Please, take me now. I need it,' almost makes you pound him right then - but no, you're not quite done. Snatching a set of matching leather cuffs from the workbench, you fasten them around Gabriel's wrists and ankles, then strap him in to the harness fully - now totally subject to your every whim.";
				WaitLineBreak;
				say "     Collared, cuffed and dangling naked in a sex sling - Gabriel is truly a sight to behold now. Time to finish re-shaping this formerly sexless divine warrior to the new purpose you have in mind for him. In moments, your clothes and gear are off your body and piled on the workbench, and you're stepping up to Gabriel, following the lead of your erect cock. There is a needy whimper from him as your cockhead brushes over his hole and he even raises his butt a bit to push against you and get it inside - but you still hold back, teasing him with your manhood while at the same time lazily stroking his. 'Unnngh - please fuck me. Please!' he soon begs, painfully aroused and unable to do anything about it, strapped in as he is.";
				say "     You leave your sexy pet to suffer for a few moments longer, then lean over him and thrust in deep, reveling in the angel's lust-filled gasp as you penetrate him. Giving Gabriel a rough kiss, you proceed to fuck him with rapid thrusts without pause, really taking it out on the guy - and the beauty of it is, he just begs for more. Having accepted his properly submissive place, Gabriel stays rock hard the whole time, with the proudly standing erection leaking drops of precum to drip on his rippling abs. He just feels amazing to be in too, with a yielding yet very tight hole and anal muscles that seem to know instinctively when to flex around your shaft. As wound up as you got him and with your own satisfaction of how nicely this is working out, it doesn't take all that long until the two of you approach your respective orgasms.";
				WaitLineBreak;
				say "     ...which is when you pause again, although it is hard to control your own roaring libido. Breathing hard, you ask if he doesn't enjoy this a whole lot more than the pointless quest he was on - and he literally screams, 'YES!' After making him squirm and twitch in need with a slow grind of your hips against his butt, you tell him he could have such fun all the time - if he only accepted you as his master. That you'll take care of his needs if he becomes your slut. Again, the reply of the near delirious angel is, 'YES! Take me, my master! I'm yours!' Just what you wanted to hear, so you start fucking him again, eager to plant your claim on this sexy pet in the form of a creamy filling.";
				say "     Pounding into Gabriel hard, it's not long before you come more or less at the same time, sinking your manhood as deep as it will go and blasting the first spurt of your seed into him while Gabriel moans incoherently, the muscles in his arms tensing as he pulls on his restraints. His cock jerks and pulses as it sprays a quite respectable load into the air to splat down all over his chest and neck. It's pretty cute how he moans and pants as you fill him up - just like a good bottom-boy should. And he's all yours now - to keep and have as an eager little slut you can breed whenever you want to.";
				WaitLineBreak;
				say "     Slowly winding down from your orgasm, you make out a moment longer with Gabriel, then eventually pull your softening manhood out of his cream-filled asshole. After enjoying the sight of your cum slowly oozing out of his winking pucker for a moment, you move over to the workbench to clean up and get dressed, leaving your angelic sex pet to wind down from the hottest fuck in his life, still strapped in and oh so deliciously helpless. After ducking out into the store to find a fitting item, you do come back and undo the straps holding Gabriel to the sex sling - but tell him to keep the leather cuffs on. 'Yes master,' he replies immediately, then goes to grab his bundle of gear and clothes - only to be stopped short when you command that he should stay naked, so that everyone can see the signs of his submission - cum between his butt-cheeks and the white splatter over his front.";
				say "     And with that said, you clip the leash you just got from the store to his collar, then lead the angel out of the room, still just carrying the bundle and totally naked. The way back to the library is a lot of fun - as you strut down the road with your new pet in tow, lots of people and creatures give you interested looks and wolf whistles. Thankfully, no one decides they want a piece of Gabriel themselves - maybe your current confident aura is enough to keep them just watching, not pouncing your naked pet. When you soon arrive back at the library, you tell the angel that is his new home and he shouldn't leave the building without you. 'I won't, master,' he obediently agrees, and follows you inside.";
				NPCSexAftermath Gabriel receives "AssFuck" from Player;
				WaitLineBreak;
				say "     Letting the angel off his leash, you find that he still follows you quite closely - a new pet, eager to learn from his master. Getting shown the library upper floor and ground level, he thanks you for your permission to roam the building and read when he wants to, then he follows down the flight of stairs into the library bunker. While you have him set down his gear on one of the beds right next to yours, wanting to get him settled in and ready for easy access, a mocking voice suddenly stops Gabriel in his tracks, 'Now what do we have here? A needy slut, covered in dried cum. The look suits you, Gabe.'";
				say "     It's Elijah, leaning against a wall behind you in a lazy pose, arms crossed over his chest as he gives the naked Gabriel a shameless leer. Whirling around to face his lost friend, Gabriel's eyes go wide as he takes in Elijah's black wings and aura of domineering masculinity and arrogance. He wails. 'Elijah! What happened to you?!' The other angel just chuckles darkly, then says, 'I found out what fun you can have if you're not just another sexless sock-puppet, always serving a 'higher purpose'. What should have been allowed to us from the start. The feeling of a tight hole or pussy stretched around your cock is just priceless, don't you think? Oh wait - seems like you're more on the receiving team.'";
				say "     Elijah's pointed stare at the cum on Gabriel's chest and the part of your load that trickled down the inside of his legs makes the angel flush bright red, looking down over himself in shame. Then he stammers, 'I - I... yes. I like it. I need it. My master said he'd fuck me all the time from now on.' The other angel just gives you an approving nod, 'Nice work training the little slut. Seems you've got Gabe turned into a subby pet, don't you. I'll have to tap that ass myself too sometime...' Before you can reply anything, Elijah then saunters out of the room, going up, most likely to hunt down something to fuck outside.";
			else if Player is female: [females and neuter]
				say "     Continuing to strip Gabriel all the way until he's bare-ass naked, you wrap all the gear in a bundle with his clothes, then swing that over your shoulder and walk down the street. The winged hunk gapes after you, opening and closing his mouth in shock a few times, then finally gets over his paralysis and hurries after you. It's a sight to behold - those flawless muscles of his body moving in concert without a stitch of clothing to hide them. You can't help but grin as you watch Gabriel come closer quickly, finally taking position by your side and starting to shyly ask, 'Didn't you want to -' A commanding shush stops the words still in his mouth, making the angel fall quiet as you lead him through the streets of the red light district.";
				say "     Before long, your little party has drawn the attention of more than a few inhabitants of the area, with wolf whistles and comments like 'Oooh, look at that ass' and 'Wanna show me what you can do with that pole, fly-boy?' Cute, how pink Gabriel can turn in the face, clearly embarrassed but held back from even trying to cover himself with his hands by your command. Eventually, you choose one of the available porn stores and enter it, starting to browse what hasn't been looted yet - though you soon notice that Gabriel didn't come with you. The naked angel is still standing right at the entrance of the store, looking with big eyes at an emptied out stand of porn DVDs. The discs may be gone, but the quite explicit cardboard mock-up still stands - and has more than a little bit of effect on Gabriel's manhood, making it stand straight too.";
				WaitLineBreak;
				say "     A sharp whistle from you stops Gabriel's hand from creeping any closer to his crotch, and also serves to frighten the angel out of his aroused haze. Both hands whipping to his side as he instinctively stands to attention, he shame-facedly looks down as you remind him that he may not touch himself. A moment later, the angel meekly follows you again as you pass all the empty shelves and step over strewn about lube bottles. They're all empty too, leaving you to wonder if maybe something drank the contents. It's not as unlikely as one might think, not these days. Soon, a door at the back draws your attention, saying 'Workshop' and 'Custom Items' on it. Trying the doorknob, you find that it is locked, but thankfully a short search behind the store's counter reveals a key.";
				say "     Unlocking and entering the porn store's workshop, you find yourself in a mid-sized room filled with leather-working tools, a well-crafted sex sling and... jackpot! There's a sturdy fuckbench with restraints standing in front of the back wall. Just the right thing for your little angel. You draw Gabriel close and give him a deep kiss, putting your tongue into the male's mouth as he trembles in arousal. Then you walk him towards the bench and give him a little push to fall right onto it. The needy expression on his face and a sighed, 'Please, take me now. I need it,' almost makes you mount him right then - but no, you're not quite done. Snatching a set of matching leather cuffs from the workbench, you fasten them around Gabriel's wrists and ankles, then strap him in to the bench - making him now totally subject to your every whim.";
				WaitLineBreak;
				say "     Collared, cuffed and bound to a fuckbench - Gabriel is truly a sight to behold now. Time to finish re-shaping this formerly sexless divine warrior to the new purpose you have in mind for him. In moments, your clothes and gear are off your body and piled on the workbench, and you're stepping up to Gabriel, eyes firmly riveted to his erect shaft. There is a needy whimper from him as you step over him and brush the are between your legs over his cockhead. He even raises his butt a bit to push against you and maybe sink his shaft into you - but you still hold back, just teasing his erection with a few light touches. 'Unnngh - please fuck me. Please!' he soon begs, painfully aroused and unable to do anything about it, strapped in as he is.";
				say "     You leave your sexy pet to suffer for a few moments longer, then lower yourself a little bit more, letting his cock press in against the opening off your [if Player is female]pussy[else]asshole[end if] - then sink inside. The angel gives a lust-filled gasp as you allow him to penetrate, and you even have to give him a little swat to stop his reflexive thrust up. Leaning over Gabriel, you give him a rough kiss, then proceed to ride his pole with rapid intensity, really giving using him hard - and the beauty of it is, he just begs for more. Having accepted his properly submissive place, Gabriel moans and whimpers as you make use of his proudly standing erection, making your hole pretty slick with his precum. As wound up as you got him and with your own satisfaction of how nicely this is working out, it doesn't take all that long until the two of you approach your respective orgasms.";
				WaitLineBreak;
				say "     ...which is when you pause again, although it is hard to control your own roaring libido. Breathing hard, you ask if he doesn't enjoy this a whole lot more than the pointless quest he was on - and he literally screams, 'YES!' After making him squirm and twitch in need through slowly sliding up and down his shaft a few times, you tell him he could have such fun all the time - if he only accepted you as his [if Player is female]mistress[else]master[end if]. That you'll take care of his needs if he becomes your slut. Again, the reply of the near delirious angel is, 'YES! Take me, my [if Player is female]mistress[else]master[end if]! I'm yours!' Just what you wanted to hear, so you start fucking him again, eager to milk the first of many loads to come from this sexy dude.";
				say "     Bouncing up and down on Gabriel's hard cock, it's not long before you come more or less at the same time, your inner muscles trembling around his shaft while Gabriel moans incoherently, the muscles in his arms tensing as he pulls on his restraints. An eye-blink later, his cock jerks and pulses inside you as it sprays a quite respectable load [if Player is female]right into your womb[else]deep into your ass[end if]. It's pretty cute how he moans and pants as he fills you up - just like a good slave-boy should. And he's all yours now - to keep and have as an eager little slut you can ride whenever you want to.";
				if Player is female:
					NPCSexAftermath Player receives "PussyFuck" from Gabriel;
				else:
					NPCSexAftermath Player receives "AssFuck" from Gabriel;
				WaitLineBreak;
				say "     Slowly winding down from your orgasm, you make out a moment longer with Gabriel, then eventually pull off his softening manhood, leaking creamy cum and femcum onto his crotch. After enjoying the sight of your sweaty and cum-stained angel fuckpet for a moment, you move over to the workbench to clean up and get dressed, leaving the submissive angel to wind down from the hottest fuck in his life, still strapped in and oh so deliciously helpless. After ducking out into the store to find a fitting item, you do come back and undo the straps holding Gabriel to the bench - but tell him to keep the leather cuffs on. 'Yes [if Player is female]mistress[else]master[end if],' he replies immediately, then goes to grab his bundle of gear and clothes - only to be stopped short when you command that he should stay naked, so that everyone can see his submission - a perfect naked body and your mixed fluids drying on his crotch.";
				say "     And with that said, you clip the leash you just got from the store to his collar, then lead the angel out of the room, still just carrying the bundle and totally naked. The way back to the library is a lot of fun - as you strut down the road with your new pet in tow, lots of people and creatures give you interested looks and wolf whistles. Thankfully, no one decides they want a piece of Gabriel themselves - maybe your current confident aura is enough to keep them just watching, not pouncing your naked pet. When you soon arrive back at the library, you tell the angel that is his new home and he shouldn't leave the building without you. 'I won't, [if Player is female]mistress[else]master[end if]' he obediently agrees, and follows you inside.";
				WaitLineBreak;
				say "     Letting the angel off his leash, you find that he still follows you quite closely - a new pet, eager to learn from his master. Getting shown the library upper floor and ground level, he thanks you for your permission to roam the building and read when he wants to, then he follows down the flight of stairs into the library bunker. While you have him set down his gear on one of the beds right next to yours, wanting to get him settled in and ready for easy access, a mocking voice suddenly stops Gabriel in his tracks, 'Now what do we have here? A needy slut, covered in dried cum. The look suits you, Gabe.'";
				say "     It's Elijah, leaning against a wall behind you in a lazy pose, arms crossed over his chest as he gives the naked Gabriel a shameless leer. Whirling around to face his lost friend, Gabriel's eyes go wide as he takes in Elijah's black wings and aura of domineering masculinity and arrogance. He wails. 'Elijah! What happened to you?!' The other angel just chuckles darkly, then says, 'I found out what fun you can have if you're not just another sexless sock-puppet, always serving a 'higher purpose'. What should have been allowed to us from the start. The feeling of a tight hole or pussy stretched around your cock is just priceless, don't you think?'";
				say "     Elijah's pointed stare at the cum and femcum staining Gabriel's crotch makes the angel flush bright red, looking down over himself in shame. Then he stammers, 'I - I... yes. I like it. I need it. My [if Player is female]mistress said she'd[else]master said he'd[end if] fuck me all the time from now on.' The other angel just gives you an approving nod, 'Nice work training the little slut. Seems you've got Gabe turned into a subby pet, don't you. I'll have to tap that ass myself too sometime...' Before you can reply anything, Elijah then saunters out of the room, going up, most likely to hunt down something to fuck outside.";
			move Gabriel to bunker;
			move player to bunker;
			now PlayerControlled of Gabriel is true;
			repeat with y running from 1 to number of filled rows in Table of Random Critters:
				choose row y in Table of Random Critters;
				if Name entry is "Seraphim":
					now MonsterID is y;
					now area entry is "Nowhere";
					break;
		now PlayerFucked of Gabriel is true;
	else:
		LineBreak;
		say "     You decide to just go, leaving Gabriel to pick himself up on his own.";

to say SeraphVictorious:
	if HP of Player > 0: [player submits]
		say "     As you submit, Gabriel presses his glowing hand against your forehead, causing you to scream in pain from the sensations of a fiery fingers rifling through your mind. They drag questionable things you have done in the past to its forefront and shine a light on them, banishing whatever justification you thought you had before. Then he lets go and helps you sit down to hold your head and process what just happened. 'There - this is enough for now or I would break your mind. Ponder these acts and better yourself. Return when you are ready for more. I will patrol these streets for demons until you are back.'";
	else: [player loses]
		say "     As you collapse in defeat, Gabriel presses his glowing hand against your forehead, causing you to scream in pain from the sensations of a fiery fingers rifling through your mind. They drag questionable things you have done in the past to its forefront and shine a light on them, banishing whatever justification you thought you had before. Then he lets go and leaves you to crumple on the floor. 'There - this is enough for now or I would break your mind. Ponder these acts and better yourself. Return when you are ready for more - and be sure that I will hunt you down if you do not.'";

to say SeraphDesc:
	if HP of Gabriel is 2:
		setmongender 1;
		say "     Turning around a street corner, you suddenly find yourself face to face with the angel you saw search for Elijah earlier - and hacking apart or interrogating demons while doing that. The divine warrior's handsome face turns to you and his eyes widen as he recognizes you from the incubus's description, then he says, 'Hello Mortal, you may call me Gabriel. I heard you have had a hand in the disappearance of my brother in arms Elijah. Explain yourself!'";
		now PlayerMet of Gabriel is true;
		LineBreak;
		say "     [link](1)[as]1[end link] - Just tell him what you did.[line break]";
		say "     [link](2)[as]2[end link] - Make up a convincing lie.[line break]";
		say "     [link](3)[as]3[end link] - Run away.[line break]";
		now calcnumber is 0;
		while calcnumber < 1 or calcnumber > 3:
			say "Choice? (1-3)>[run paragraph on]";
			get a number;
			if calcnumber is 1 or calcnumber is 2 or calcnumber is 3:
				break;
			else:
				say "Invalid choice. Type [link]1[end link] to admit everything, [link]2[end link] to lie or [link]3[end link] to run away.";
		if calcnumber is 1: [admitting]
			say "     Steeling your nerves for the likely reaction from this divine warrior, you come clean and admit how you corrupted Elijah, turning him into a vain and lust-filled shadow of his former self. Gabriel's eyes harden with every word you speak and his right hand strays to the grip of his flaming sword, closing halfway around it, then he shakes his head and says, 'No, even as vile and despicable as you are, you are still of those I was made to protect. I long to be done with you and hasten to save my brother from the pit you've pushed him in, but duty comes first, always. You WILL be cleansed you from your sins even if I have to BURN it out of you - and then you WILL assist me in saving Elijah.'";
			say "     A pale-white glow appears around Gabriel's hands and the angel's expression hardens. 'This will not be without pain - and you deserve nothing less. Do not struggle against me, it is only to your best,' he says, then steps forward and reaches out for you.";
		else if calcnumber is 2: [lying]
			say "     Cold sweat runs down your back as you try to come up with some convincing story that doesn't enrage someone armed with a flaming sword... but as you open your mouth to speak, the angel raises his hand. 'Don't bother lying - guilt hangs around you like a rotten stench. I can see that dark influences have affected you and nothing you say can be believed.' His right hand strays to the grip of his flaming sword, closing halfway around it, then he shakes his head and says, 'No, corrupted as you are, you are still of those I was made to protect. Since a proper interrogation is out of the question, I will have to do this the hard way - cleansing you from your sins bit by bit until you are ready to assist me in saving Elijah.'";
			say "     A pale-white glow appears around Gabriel's hands and the angel's expression hardens. 'This will not be without pain, but it is for your best. Do not struggle against me,' he says, then steps forward and reaches out for you.";
		else if calcnumber is 3: [running]
			say "     You turn and run - only to find Gabriel standing before you some moments later, folding his wings after a short dash through the air. He's got you on mobility, that's for sure. 'Halt! Your actions prove your guilt - and now I can see that dark influences have affected you and nothing you say can be believed.' His right hand strays to the grip of his flaming sword, closing halfway around it, then he shakes his head and says, 'No, corrupted as you are, you are still of those I was made to protect. Since a proper interrogation is out of the question, I will have to do this the hard way - cleansing you from your sins bit by bit until you are ready to assist me in saving Elijah.'";
			say "     A pale-white glow appears around Gabriel's hands and the angel's expression hardens. 'This will not be without pain, but it is for your best. Do not struggle against me,' he says, then steps forward and reaches out for you.";
	else if HP of Gabriel is 3:
		setmongender 1;
		say "     You run into an angel on the seedy streets of the red light district - and it's one you know... Gabriel. He turns his head to look you up and down, then says, 'I still sense some darkness in your soul. Please do not resist - this is only to help you.' With that, he steps forward, white light glowing around his raised hand.";
	else if HP of Gabriel is 4:
		setmongender 3;
		say "     You run into an angel on the seedy streets of the red light district - and it's one you know... intimately. Gabriel looks at you and hesitates a second, biting his lip, then says, 'I still sense some darkness in your soul. Please do not resist - this is only to help you.' With that, he steps forward, white light glowing around his raised hand.";
	else if HP of Gabriel is 5:
		setmongender 3;
		say "     You run into an angel on the seedy streets of the red light district - and it's one you know... intimately. After all, he's only a real man because of your actions. Gabriel looks at you and hesitates a second, biting his lip, then says, 'I still sense some darkness in your soul. Please do not resist - this is only to help you.' With that, he steps forward, white light glowing around his raised hand.";
	else if HP of Gabriel is 6:
		setmongender 3;
		say "     You run into an angel on the seedy streets of the red light district - and it's one you know... intimately. Gabriel still wears the tight leather collar you put onto him, and you can see his face flush as he gulps at your presence. A small bulge appears at the front of his pants, but for now, he manages to control himself, biting his lip before saying, 'I - I must do my duty. Cleanse you from your wickedness. Please do not resist - this is only to help you.' With that, he steps forward, white light glowing around his raised hand.";

Section 2 - Creature Insertion

Table of Random Critters (continued)
NewTypeInfection (truth state)	Name	Enemy Title	Enemy Name	Enemy Type	Attack	Defeated	Victory	Desc	Face	Body	Skin	Tail	Cock	Face Change	Body Change	Skin Change	Ass Change	Cock Change	str	dex	sta	per	int	cha	sex	HP	lev	wdam	area	Cock Count	Cock Length	Ball Size	Nipple Count	Breast Size	Male Breast Size	Cunt Count	Cunt Length	Cunt Tightness	Libido	Loot	Lootchance	Scale (number)	Body Descriptor (text)	Type (text)	Magic (truth state)	Resbypass (truth state)	non-infectious (truth state)	DayCycle	Altcombat (text)	BannedStatus (truth state)
--	--	--	--	--	--	--	--	--	--	--	--	--	--	--	--	--	--	--	--	--	--	--	--	--	--	--	--	--	--	--	--	--	--	--	--	--	--	--	--	--	--	--	--	--	--	--	--	--	--	--;

When Play begins:
	Choose a blank row from Table of Random Critters;
	now NewTypeInfection entry is false;
	now Name entry is "Seraphim";
	now enemy title entry is "";
	now enemy Name entry is "Gabriel";
	now enemy type entry is 1; [unique enemy]
	now attack entry is "[one of]The Seraphim calls out, 'Surrender! This just prolongs your pain. It will be over quickly if you do not struggle.' Then he smites you with a faintly glowing hand.[or]Your angelic opponent calls out, 'Stop fighting, foolish mortal - I only want to help you!' Then he gives you a hard punch in the face, a mixture of regret and annoyance on his face.[or]Hooking a foot behind your leg, the Seraphim pulls it out from under you. As you crash down on the ground, he calls out, 'Surrender, I do not wish to hurt you more than necessary.'[at random]";
	now defeated entry is "[SeraphDefeated]";
	now victory entry is "[SeraphVictorious]";
	now desc entry is "[SeraphDesc]";
	now face entry is "quite beautiful, with chiseled features bare of even the slightest imperfection. A full head of shoulder-length and slightly curled brown hair frames the picture of a handsome male";
	now body entry is "that of a well-built and muscular human being, toned and strong. It is garbed in a robe of pure white, flowing fabric. Two large wings sprout from your back, bearing white feathers";
	now skin entry is "[one of]pale, flawless[or]pristine[or]perfect[at random]";
	now tail entry is "You have a round, firm bubble butt, just waiting to be grabbed.";  [ Ass/Tail. Write as a full sentence (with period) or leave blank for none. ]
	now cock entry is "[one of]amazing[or]perfect[or]human-like[at random]";
	now face change entry is "your facial muscles seem to ripple under the skin, rearranging themselves into perfectly sculpted male features. Shoulder-length locks of brown hair form to frame your handsome visage"; [ format as "Your face feels funny as (your text)." ]
	now body change entry is "it is reshaped into a very well-built form, leaving you with a toned and strong human-like body. A moment later, a pair of large white wings unfold behind your back, leaving you to wonder if you might fly once you've figured out how they actually work. Then finally, there is a short ringing in the air behind you, as if from hundreds of tiny bells, leaving you to find a neatly folded white robe on the ground as you turn around. Slipping into the silk-soft item of clothing, you just feel right";
	now skin change entry is "it seems to soften and smooth out, creating the impression of timeless youth. Any blemishes and unwanted hair are wiped away with a wonderfully pleasant sensation that leaves you with perfect skin";
	now ass change entry is "it tightens up into a firm, round bubble butt";
	now cock change entry is "it becomes human-like, uncut and well-proportioned";
	now str entry is 20;                  [ These are now the creature's stats... ]
	now dex entry is 18;                  [ ...and are only altered onto the player via Shifting or the Mighty Mutation feat ]
	now sta entry is 16;                  [ These values may be used as part of alternate combat.]
	now per entry is 14;
	now int entry is 16;
	now cha entry is 18;
	now sex entry is "Male";              [ Infection will move the player towards this gender. Current: 'Male' 'Female' 'Both' ]
	now HP entry is 85;
	now lev entry is 13;                  [ Monster level. (Level x 2) XP for victory. (Level / 2) XP for losing. ]
	now wdam entry is 12;                 [ Monster's average damage when attacking. ]
	now area entry is "Nowhere";          [ "Outside" "Mall" "Park" "Beach" etc... Check an existing creature in the area. ]
	now Cock Count entry is 1;                 [ number of cocks if sex is 'Male' or 'Both' ]
	now Cock Length entry is 9;
	now Ball Size entry is 6;            [ Size of balls ]
	now Nipple Count entry is 2;               [ Number of nipples. ]
	now Breast Size entry is 0;           [ Size of breasts infection will try to attain ]
	now Male Breast Size entry is 0;      [ Breast size for if Sex="Male", usually zero. ]
	now Cunt Count entry is 0;                 [ number of pussies if sex is 'Female' or 'Both' ]
	now Cunt Length entry is 6;
	now Cunt Tightness entry is 4;
	now libido entry is 25;               [ Amount player Libido will go up if defeated ]
	now loot entry is "";                 [ Loot monster drops, ]
	now lootchance entry is 0;            [ Chance of loot dropping 0-100 ]
	now scale entry is 3;                 [ Number 1-5, approx size/height of infected PC body: 1=tiny, 3=avg, 5=huge ]
	now body descriptor entry is "angelic";
	now type entry is "angel";
	now magic entry is false;
	now resbypass entry is false;
	now non-infectious entry is false;
	now DayCycle entry is 0;        [ 0 = Up at all times; 1 = Nocturnal (night encounters only); 2 = Diurnal (day encounters only) ]
	now altcombat entry is "default";
	now BannedStatus entry is false;

Table of New Infection Parts (continued)
Name	Body Weight	Body Definition	Androginity	Head Change	Head Description	Head Adjective	Head Skin Adjective	Head Adornments	Hair Length	Hair Shape	Hair Color	Hair Style	Eye Color	Eye Adjective	Mouth Length	Mouth Circumference	Tongue Adjective	Tongue Color	Tongue Length	Torso Change	Torso Description	Torso Adjective	Torso Skin Adjective	Torso Adornments	Torso Color	Torso Pattern	Breast Adjective	Breast Size	Male Breast Size	Nipple Count	Nipple Color	Nipple Shape	Back Change	Back Adornments	Back Skin Adjective	Arms Change	Arms Description	Arms Skin Adjective	Locomotion	Legs Change	Legs Description	Legs Skin Adjective	Ass Change	Ass Description	Ass Skin Adjective	Ass Width	Tail Change	Tail Description	tail skin adjective	Asshole Length	Asshole Tightness	Asshole Color	Cock Change	Cock Description	Cock Adjective	Cock Color	Cock Count	Cock Girth	Cock Length	Ball Description	Ball Count	Ball Size	Cunt Change	Cunt Description	Cunt Adjective	Cunt Color	Cunt Count	Cunt Length	Cunt Tightness	Clit Size
--	--	--	--	--	--	--	--	--	--	--	--	--	--	--	--	--	--	--	--	--	--	--	--	--	--	--	--	--	--	--	--	--	--	--	--	--	--	--	--	--	--	--	--	--	--	--	--	--	--	--	--	--	--	--	--	--	--	--	--	--	--	--	--	--	--	--	--	--	--;

When Play begins:
	Choose a blank row from Table of New Infection Parts;
	now Name entry is ""; [matching infection name to Table of Random Critters]
	now Body Weight entry is 5; [scale of 1-9 for body weight]
	now Body Definition entry is 5; [scale of 1-9 for body definition]
	[Body Adjective is generated out of the body weight and body definition and can be used in scenes - one word descriptive adjective: skinny/slender/lithe/average/fit/muscled/pudgy/husky/jacked]
	now Androginity entry is 5; [1-9 scale of male to female]
	[Gender Adjective is generated out of androginity]
	now Head Change entry is ""; [partial sentence that fits in: "Your head and face [one of]tingle[or]go flush[or]vibrate with odd pleasure[or]go cold[or]feel oily[at random] as [head change entry]."]
	now Head Description entry is ""; [partial sentence that fits in "Your face and head resemble that of [head description of Player] with [eye color of Player], [eye type of Player] eyes and an overall [gender appearance of Player] appearance."]
	now Head Adjective entry is ""; [one word descriptive adjective (avian/canine/...)]
	now Head Skin Adjective entry is ""; [one word descriptive adjective]
	now Head Adornments entry is ""; [partial sentence that fits in "Before moving on from your head, you give your [head adornments of Player] a proud glance followed by a light caress."]
	now Hair Length entry is 2; [hair length in inches]
	now Hair Shape entry is ""; [one word shape descriptor (curly/straight/...)]
	now Hair Color entry is ""; [one word color descriptor]
	now Hair Style entry is ""; [one word style descriptor (ponytail/mohawk/buzzcut/...)]
	now Eye Color entry is ""; [one word color descriptor]
	now Eye Adjective entry is ""; [one word descriptive adjective (slitted/round/...)]
	now Mouth Length entry is 3; [inches deep for face fucking; maximum possible will be double this number (when deep throating)]
	[Mouth Length Adjective  is generated by a function and can be used in scenes too - "petite, shallow, average, deep, bottomless"]
	now Mouth Circumference entry is 3;
	[Mouth Circumference Adjective is generated by a function and can be used in scenes too - "tiny, small, normal, wide, gaping"]
	now Tongue Adjective entry is ""; [one word descriptive adjective (wide/slobbery/...)]
	now Tongue Color entry is ""; [one word color descriptor]
	now Tongue Length entry is 3; [length in inches]
	now Torso Change entry is ""; [partial sentence that fits in: "Your torso [one of]tingles[or]goes flush[or]vibrates with odd pleasure[or]goes cold[or]feels oily[at random] as [Torso Change entry]."]
	now Torso Description entry is ""; [partial sentence, fitting in "Looking down at yourself, you appear [Body Adjective of Player], [Gender Adjective of Player] and your torso is [torso description of Player]."]
	now Torso Adjective entry is ""; [one word descriptive adjective (avian/canine/...)]
	now Torso Adornments entry is ""; [(pouch/udders/...); partial sentence to fit: "You take a moment to feel your [torso adornments of Player]."]
	now Torso Skin Adjective entry is ""; [one word descriptive adjective (furry/scaled/...)]
	now Torso Color entry is ""; [single word color adjective for the dominant color of the skin/fur/feathers/scales]
	now Torso Pattern entry is ""; [single word color adjective for the dominant pattern of the skin/fur/feathers/scales]
	now Breast Adjective entry is ""; [adjective(s) example: round, pointy, perky, saggy, bouncy. This would serve as either a general appearance of a infections breasts or possibly something that may be effected by a item or NPC.]
	now Breast Size entry is 0; [cup size as number, counting Flat Pecs = 0, A = 1, B = 2, ...]
	now Male Breast Size entry is 0; [cup size as number, counting Flat Pecs = 0, A = 1, B = 2, ...]
	now Nipple Count entry is 2; [count of nipples]
	now Nipple Color entry is ""; [one word color descriptor]
	now Nipple Shape entry is ""; [shape example: any shape will do as long as it has a baseline with a current infection or item]
	now Back Change entry is ""; [partial sentence that fits in: "Your back [one of]tingles[or]goes flush[or]vibrates with odd pleasure[or]goes cold[or]feels oily[at random] as [Back Change entry]."]
	now Back Adornments entry is ""; [partial sentence to fit: "Your back tickles with the feeling of movement caused by [back adornments of Player]."]
	now Back Skin Adjective entry is ""; [one word adjective (feathered/furred/scaly/...)]
	[Limbs Adjective is generated by a function and can be used in scenes too - "rail-thin, slender, sinewy, average, firm, muscular, flabby, meaty, rippling"]
	now Arms Change entry is ""; [partial sentence that fits in: "Your arms [one of]tingle[or]go flush[or]vibrate with odd pleasure[or]go cold[or]feel oily[at random] as [Arms Change entry]."]
	now Arms Description entry is ""; [partial sentence to fit: "Your [Limbs Adjective of Player] arms are [Arms Description of Player]."]
	now Arms Skin Adjective entry is ""; [one word adjective (feathered/furred/scaly/...)]
	now Locomotion entry is ""; [one word adjective: (bipedal/quadrupedal/serpentine/sliding)]
	now Legs Change entry is ""; [partial sentence that fits in: "Your legs [one of]tingle[or]go flush[or]vibrate with odd pleasure[or]go cold[or]feel oily[at random] as [Legs Change entry]."]
	now Legs Description entry is ""; [partial sentence to fit: "As your inspection goes even lower, you come to the two [Body Adjective of Player] legs supporting you. They are [legs description of Player]."]
	now Legs Skin Adjective entry is ""; [one word adjective (feathered/furred/scaly/...)]
	now Ass Change entry is ""; [partial sentence that fits in: "Your ass [one of]tingles[or]goes flush[or]vibrates with odd pleasure[or]goes cold[or]feels oily[at random] as [Ass Change entry]."]
	now Ass Description entry is ""; [partial sentence to fit: "Using your hands you feel your behind enjoying the sensation of your [Ass Width Adjective of Player], [ass description of Player]."]
	now Ass Skin Adjective entry is "";  [one word adjective (feathered/furred/scaly/...)]
	now Ass Width entry is 3; [ass width from 1-5]
	[Ass Width Adjective generated by function out of ass width]
	[Ass Adjective generated by function out of body definition and ass width]
	now Tail Change entry is ""; [partial sentence that fits in: "Your tail [one of]tingles[or]goes flush[or]vibrates with odd pleasure[or]goes cold[or]feels oily[at random] as [Tail Change entry]."]
	now Tail Description entry is ""; [partial sentence to fit: "Just below your lower back sprouts a [tail description of Player], which you move back and forth with glee."]
	now Tail Skin Adjective entry is ""; [one word adjective (feathered/furred/scaly/...)]
	now Asshole Length entry is 7; [inches deep for anal fucking;]
	[Asshole Length Adjective is generated by a function and can be used in scenes too - "petite, shallow, average, deep, bottomless"]
	now Asshole Tightness entry is 3;
	[Asshole Tightness Adjective is generated by a function and can be used in scenes too - "tiny, small, tight, wide, gaping"]
	now Asshole Color entry is ""; [one word color descriptor]
	now Cock Count entry is 0;
	now Cock Girth entry is 0;
	[Cock Girth Adjective is generated by a function and can be used in scenes too: thin/slender/average/thick/monstrous]
	now Cock Length entry is 0; [length in inches]
	now Cock Adjective entry is ""; [one word adjective: avian/canine/...]
	now Cock Change entry is ""; [partial sentence that fits in: "Your groin [one of]tingles[or]goes flush[or]vibrates with odd pleasure[or]goes cold[or]feels oily[at random] as [Cock Change entry]."]
	now Cock Description entry is ""; [partial sentence to fit: "You have a [Cock Girth Adjective of Player], [Cock Length of Player]-inch-long [cock adjective of Player] [one of]cock[or]penis[or]shaft[or]maleness[at random] that [cock description of Player]."]
	now Cock Color entry is ""; [one word color descriptor]
	now Ball Count entry is 0;
	now Ball Size entry is 0; [size of balls 1-5: "acorn-sized", "coin-sized", "egg-sized" "goose-egg sized", "ostrich-egg sized"]
	[Ball Size Adjective is generated by a function and can be used in scenes too]
	now Ball Description entry is ""; [partial sentence to fit: "Underneath it hangs a pair of [Ball Size Adjective of Player] [ball description of Player]."]
	now Cunt Count entry is 0;
	now Cunt Length entry is 0;
	now Cunt Tightness entry is 0;
	[Cunt Tightness Adjective is generated by a function and can be used in scenes too: extremely tight/tight/well-used/open/gaping]
	now Cunt Adjective entry is ""; [one word adjective: avian/canine/...]
	now Cunt Change entry is ""; [partial sentence that fits in: "Your groin [one of]tingles[or]goes flush[or]vibrates with odd pleasure[or]goes cold[or]feels oily[at random] as [Cunt Change entry]."]
	now Cunt Description entry is ""; [partial sentence to fit: "You have a [Cunt Tightness Adjective of Player] [one of]cunt[or]pussy[or]vagina[or]cleft[at random] that is [cunt description of Player]."]
	now Cunt Color entry is ""; [one word color descriptor]
	now Clit Size entry is 0; [Size of Clit (1-5); very small/small/average/large/very large]


Section 3 - NPC

Table of GameCharacterIDs (continued)
object	name
Gabriel	"Gabriel"

Gabriel is a man.
[physical details as of game start]
ScaleValue of Gabriel is 3. [human sized]
Cock Count of Gabriel is 0.
Cock Length of Gabriel is 0.
Ball Size of Gabriel is 0.
Ball Count of Gabriel is 0.
Cunt Count of Gabriel is 0.
Cunt Length of Gabriel is 0.
Cunt Tightness of Gabriel is 0.
Nipple Count of Gabriel is 2.
Breast Size of Gabriel is 0.
[Basic Interaction states as of game start]
PlayerMet of Gabriel is false.
PlayerRomanced of Gabriel is false.
PlayerFriended of Gabriel is false.
PlayerControlled of Gabriel is false.
PlayerFucked of Gabriel is false.
OralVirgin of Gabriel is true.
Virgin of Gabriel is true.
AnalVirgin of Gabriel is true.
PenileVirgin of Gabriel is true.
SexuallyExperienced of Gabriel is false.
MainInfection of Gabriel is "Seraphim".

The description of Gabriel is "[Gabrieldesc]".
The icon of Gabriel is Figure of Gabriel_icon.
The conversation of Gabriel is { "Mew!" }.

to say Gabrieldesc:
	if debugactive is 1:
		say "     DEBUG: Libido of Gabriel: [Libido of Gabriel][line break]";
	say "     Gabriel is tall and well-built, looking an early 20 years old. He has an unlined, very pretty face with azure eyes, crowned by a full head of curly brown hair that falls down to his shoulders. Being your submissive pet now, he always wears the collar, wrist-cuffs and leather anklet straps you picked out for him, combined with a very tight set of jeans. As he isn't allowed to go outside, he simply goes barefoot all the time too, just like he leaves his chest bare for you to enjoy some very handsomely sculpted abs. Two large white wings are folded together behind the angel's back, which tend to spread out a bit and move animatedly when he's talking to you.";

instead of sniffing Gabriel:
	say "Gabriel is surrounded by the faint smell of sandalwood.";

Section 4 - Conversation

Instead of conversing the Gabriel:
	if Energy of Gabriel is 0:
		say "     As you approach to talk to him, Gabriel raises a hand to his chest and gives you a somewhat shy look. 'Hello again, m-[master],' he pants out looking down over himself, then up at you. 'I put on the clothes you chose for me before,' the tamed angel adds in a somewhat unsure tone, 'Or should I have stayed naked maybe?' That said, he spreads his arms as if to show off his outfit, from the black leather wrist and ankle cuffs with their shiny silver rings to tie him down, as well as a skin-tight pair of jeans that really shows off all his curves. Other than this, he is naked and barefoot, showing his nicely tanned body and chest. Stroking your hand down his side in an appreciative touch, you tell the Seraphim that he doesn't have to worry about it. Sometimes unwrapping a very enticing present is almost more fun than just finding it presented openly all the time. He takes your encouragement with relief and answers with a happy smile and leans in for you to touch him some more";
		increase Energy of Gabriel by 1;
	say "[GabrielTalkMenu]";

to say GabrielTalkMenu:
	LineBreak;
	say "What do you want to talk with Gabriel about?";
	now sextablerun is 0;
	blank out the whole of table of fucking options;
	[]
	choose a blank row in table of fucking options;
	now title entry is "Just chat a bit";
	now sortorder entry is 1;
	now description entry is "Talk about what comes to mind";
	[]
	choose a blank row in table of fucking options;
	now title entry is "Ask him about his past";
	now sortorder entry is 2;
	now description entry is "Learn more about where he came from and their stance about the nanite apocalypse";
	[]
	if (Libido of Gabriel > 0 and Libido of Gabriel < 99) and carried of orc cum > 0:
		choose a blank row in table of fucking options;
		now title entry is "Offer him a bottle of orc cum to drink";
		now sortorder entry is 3;
		now description entry is "Let your cum-slut in training have a taste of the good stuff";
	[]
	if (Libido of Gabriel > 0 and Libido of Gabriel < 99) and carried of centaur cum > 0:
		choose a blank row in table of fucking options;
		now title entry is "Offer him a bottle of centaur cum to drink";
		now sortorder entry is 4;
		now description entry is "Let your cum-slut in training chug some horse-power";
	[]
	if (Libido of Gabriel > 0 and Libido of Gabriel < 99) and carried of wolf cum > 0:
		choose a blank row in table of fucking options;
		now title entry is "Offer him a bottle of wolf cum to drink";
		now sortorder entry is 5;
		now description entry is "Let your cum-slut in training chug some wolf cum";
	[]
	if (Libido of Gabriel > 0 and Libido of Gabriel < 99) and carried of demon seed > 0 and player is male:
		choose a blank row in table of fucking options;
		now title entry is "Offer him a bottle of demon seed to drink";
		now sortorder entry is 6;
		now description entry is "Let your cum-slut in training chug some demon cum";
	[]
	sort the table of fucking options in sortorder order;
	repeat with y running from 1 to number of filled rows in table of fucking options:
		choose row y from the table of fucking options;
		say "[link][y] - [title entry][as][y][end link][line break]";
	say "[link]0 - Nevermind[as]0[end link][line break]";
	while sextablerun is 0:
		say "Pick the corresponding number> [run paragraph on]";
		get a number;
		if calcnumber > 0 and calcnumber <= the number of filled rows in table of fucking options:
			now current menu selection is calcnumber;
			choose row calcnumber in table of fucking options;
			say "[title entry]: [description entry]?";
			if Player consents:
				let nam be title entry;
				now sextablerun is 1;
				if (nam is "Just chat a bit"):
					say "[GabrielTalk1]";
				else if (nam is "Ask him about his past"):
					say "[GabrielTalk2]";
				else if (nam is "Offer him a bottle of orc cum to drink"):
					say "[GabrielTalk3]";
				else if (nam is "Offer him a bottle of centaur cum to drink"):
					say "[GabrielTalk4]";
				else if (nam is "Offer him a bottle of wolf cum to drink"):
					say "[GabrielTalk5]";
				else if (nam is "Offer him a bottle of demon seed to drink"):
					say "[GabrielTalk6]";
				else if (nam is "His interactions with David"):
					say "     You lead Gabriel into one of the side rooms for a private chat. The beautiful angel you've turned into your private sex toy obeys immediately, coming to stand in front of you at attention. Looking into those innocent eyes, you reach out to run a hand up and down his toned chest while you think about what you want to tell him about his future interactions with David.";
					say "[GabrielDavidInteractionChoice]";
				wait for any key;
				say "[GabrielTalkMenu]"; [looping back for more talk]
		else if calcnumber is 0:
			now sextablerun is 1;
			say "     You step back from the tamed Seraphim, shaking your head slightly as he gives a questioning look.";
			wait for any key;
		else:
			say "Invalid Option. Pick between 1 and [the number of filled rows in the table of fucking options].";
	clear the screen and hyperlink list;

to say GabrielTalk1:
	say "     As you start a conversation, Gabriel innocently asks, '[one of]Will you be having sex with me again soon? It's my new purpose, isn't it?' [or]Should the cock between my legs be hard and erect quite this often? It is very distracting.' [or]I can't help but feel the need to be touched by you again, [master]. Will you play with me soon?' [at random]Chuckling, you pat his shoulder and smile, then draw Gabriel into a little non-consequential discussion.";

to say GabrielTalk2:
	say "     As you turn the topic of conversation back to where he came from, before running into you and being beaten into submission, Gabriel's expression goes a little blank and he blushes. It's cute how he looks to the side a little and rubs the back of his neck, even as he says, 'I- I'm sorry [master], but I can barely even remember, to be honest. I know I was one of many, created with a purpose and to serve. Whom and for what is so very blurry. And does it even really matter, if my new task is to pleasure you?' He clearly wants to tell you more, but can't, creating an embarrassing situation for your sex pet. As he starts to stammer a little after that, you quickly distract him by pinching his nipples, getting his mind back on track for more enjoyable things.";

to say GabrielTalk3:
	say "     When you pull out the small plastic bottle with its milky white contents and hold it out to Gabriel, the young man accepts it with wide eyes. 'Is this... for me? I thank you, [master]. Presents and personnel possessions are not something done where I come from.' You simply grin at him, playing up your generosity before eventually adding that you want to see him drink it. As Gabriel takes off the cap and sniffs the contents of the bottle, he automatically licks his lips hungrily. 'This is for my training, isn't it [master]? I live to serve and obey.' With that said, he sets the bottle at his lips and starts to chug down the contents, greedily swallowing it in gulp after heavy gulp. As potent as orc cum usually is, you don't have long to wait before Gabriel shows himself to be visibly affected, his eyes going very round and his cheeks reddening. Drunk with natural aphrodisiacs and lust, he giggles a little, then leans in towards you and plants a kiss on your cheek, followed by his arms wrapping around your body.";
	say "     'You're just the best [master] I ever had, giving me treats and all that.' As he proceeds to nuzzle you, licking and touching, you realize that Gabriel isn't so much embracing you but rather holding onto you, as his knees went weak from the potent effects of the orc cum. Seems like the stuff was a bit too strong for him, and he can barely even stand right now. While the armful of bubbly, lust-drunk Seraphim is fun for a little while, he's a bit too out of it to do anything more right now. Reducing him to a drunk slut takes a little bit away from his willing submission, as anyone would service you in this state. In the end, you take him to one of the unused cots and lower Gabriel down onto it, wanting to let him sleep off his buzz.";
	LineBreak;
	say "[bold type]You lose 1 orc cum![roman type][line break]";
	decrease carried of orc cum by 1;
	now Stamina of Gabriel is turns; [last cum dose]
	if Libido of Gabriel < 10:
		increase Libido of Gabriel by 2; [big increase through the overdose]

to say GabrielTalk4:
	say "     When you pull out the small plastic bottle with its milky white contents and hold it out to Gabriel, the young man accepts it with wide eyes. 'Is this... for me? I thank you, [master]. Presents and personnel possessions are not something done where I come from.' You simply grin at him, playing up your generosity before eventually adding that you want to see him drink it. As Gabriel takes off the cap and sniffs the contents of the bottle, he automatically licks his lips hungrily. 'This is for my training, isn't it [master]? I live to serve and obey.' With that said, he sets the bottle at his lips and starts to chug down the contents, greedily swallowing it in gulp after heavy gulp. Finishing the bottle off in no time at all, he keeps it at his lips for some time, eager to get the last drops out of it. 'Mmmh, that's some tasty stuff! Makes me feel like I could lift a car!' Gabriel comments with a broad grin on his face, chucking the bottle aside casually.";
	say "     As the angel stands there and makes a fist with one hand, you see his bicep ripple and flex, literally growing larger than it had been a second before. Seems like this type of drink does have an actual physical effect on your little angel. Gabriel seems to be enjoying the way his shoulders broaden and get more beefy, and he flexes his muscles demonstratively. Then suddenly, a strange expression crosses his face and he claws at his pants, undoing the button and zipper with frantic haste and shoving them down. The massive equine cock that flops into view as he does so solves the question of what is going on. From the looks of it, Gabriel's cock has transformed into a true monster of a cock, almost fitting to hang under a centaur with its roughly 20 inches in length. It is a very dark brown in color too, almost black, more fitting to an African American than the tanned, white man before you.";
	WaitLineBreak;
	say "     Before you can so much decide what to do now, Gabriel has already wrapped his hands around the shaft of his new manhood, stroking it furiously in a two-handed grip. A pair of suitably large black-skinned balls swing in rhythm with his jerking beneath the equine cock, looking ready to send forth a whole deluge of cum. 'I want more!' Gabriel growls hungrily and goes for the next closest source of equine seed that he can find - his own swollen cock! He bends forward and pauses his jerking off long enough to catch the flared head of his equine prick between his lips, then suckles on his own cock and plays his tongue over it. You observe in spell-bound fascination as the angel strokes and blows himself, which rapidly pushes him over the edge, leading to a quite messy finish. As Gabriel's whole body writhes when he reaches the point of no return, the dickhead slips from his lips and erupts with a foot-long splurge of cum that splashes down literally six feet away.";
	say "     A second spurt of cum adds on to the puddle of cum, after which Gabriel gets himself under control a bit more and manages to cup his lips over the throbbing shaft again. You can see his cheeks bulge as the next blast of cum fills his mouth, only to be hungrily swallowed to make room for the next, followed by further and further cumshots until his orgasm eventually ebbs off. Finally, your angelic pet raises his head again, giving a manly burp and a broad grin. 'Love the taste of this stuff!' he tells you happily, even as he is milking the last little bits of cum from his slowly softening erection. Yet as Gabriel goes on to slurp up the white goop sticking to his fingers, you realize that his cock isn't so much softening but rather shrinking. It appears that while centaur cum has a quite strong effect on your toy-boy, this is only temporary and wears off with his next orgasm.";
	WaitLineBreak;
	say "     Gabriel notices the return to his regular stature a little while later as he sucks the last cum off his fingers. 'Aw, too bad,' he says with a shrug, only slightly disappointed at this turn of events, then turns to you and gives you a happy smile. 'Thank you [master]! I don't think I had a favorite drink before, not even sure if I had to drink and all that, but if I had to choose one - this is it!' And with that said, he goes down on all fours, lowering his head to the ground so he can lick up the rest of his huge load from the floor. As you watch how greedily the Seraphim goes for the creamy cum, you can't help but wonder what further fun might be had with this. Sure, you could just push his training in being a cum-slut by giving him regular doses of centaur cum, but the transformation effect could also be a fun side to explore with Gabriel sexually.";
	LineBreak;
	say "[bold type]You lose 1 centaur cum![roman type][line break]";
	decrease carried of centaur cum by 1;
	NPCSexAftermath Gabriel receives "OralCock" from Gabriel;
	now Stamina of Gabriel is turns; [last cum dose]
	if Libido of Gabriel < 10:
		increase Libido of Gabriel by 2; [big increase, fav cum drink]

to say GabrielTalk5:
	say "     When you pull out the small plastic bottle with its milky white contents and hold it out to Gabriel, the young man accepts it with wide eyes. 'Is this... for me? I thank you, [master]. Presents and personnel possessions are not something done where I come from.' You simply grin at him, playing up your generosity before eventually adding that you want to see him drink it. As Gabriel takes off the cap and sniffs the contents of the bottle, he automatically licks his lips hungrily. 'This is for my training, isn't it [master]? I live to serve and obey.' With that said, he sets the bottle at his lips and takes a pull from the creamy goop inside. Smacking his lips after swallowing, he gives you an appreciative nod and adds, 'Good stuff, got a bit of a wild and earthy taste.'";
	say "     Your angelic pet polishes off the whole bottle of cum in short notice, swallowing its contents in large gulps until only a trickle remains, which he patiently lets drip onto his outstretched tongue. Finally, he puts the bottle cap back on and stands the bottle on the ground, next to one of the cots where it shouldn't be in the way. 'I liked it,' Gabriel tells you with a smile, then suddenly gets a peculiar expression on his face. The angel leans forward and looks at you with eyes that now show speckles of amber in their usual blue irises, then sniffs the air testingly. '[Master], you look a bit funny right now, less colorful, but at the same time... nnngh, that smell around you is really hard to resist. Without waiting to ask, he steps forward a little more and buries his face in the crook of your neck, sniffing your skin with deep breaths, followed by more sniffing and even him licking the side of your neck.";
	WaitLineBreak;
	say "     You indulge Gabriel for a little while, letting him experience is newly canine senses since they mostly focus on him getting off to your sweat and pheromones anyways from the looks of it. Stroking the long brown hair on his head, you then pull him into a demanding kiss, making out a little until your toy-boy is breathless and looking at you eagerly. Finally telling him that he can get more tasty cum if he stays an obedient pet, you earn a look of deep devotion. No doubt, if he had a tail, he'd be wagging up a storm by now. Gabriel's more dog-like behavior continues for a little while longer, until finally the effects of the cum seem to wear off, with the color of his eyes being the easiest indicator to spot for it.";
	LineBreak;
	say "[bold type]You lose 1 wolf cum![roman type][line break]";
	decrease carried of wolf cum by 1;
	now Stamina of Gabriel is turns; [last cum dose]
	if Libido of Gabriel < 10:
		increase Libido of Gabriel by 1; [normal increase, regular cum drink]

to say GabrielTalk6: [demon seed]
	say "     When you pull out the small plastic bottle with its milky white contents and hold it out to Gabriel, the young man accepts it with wide eyes. 'Is this... for me? I thank you, [master]. Presents and personnel possessions are not something done where I come from.' You simply grin at him, playing up your generosity before eventually asking him what he thinks is in the bottle. As Gabriel takes off the cap and sniffs the contents, he automatically licks his lips hungrily. 'This is for my training, isn't it [master]? Smells dangerous, forbidden even. I shouldn't drink this, that I'm sure of!' You amusedly watch how tightly he's gripping the bottle, trying to keep from raising it to his lips, against all cum-slut desires that you've been meaning to instill into him. With a grin, you nod at your fucktoy, then sharply order him to try. A second or two of hesitation later, the first swallow of the potent demon seed passes Gabriel's lips, drunk down greedily almost immediately.";
	say "     The demon brute's cum has an immediate effect on Gabriel, who can't help but gasp out a whorish moan and move a hand to his crotch, rubbing the bulge springing up in his pants. Taking the bottle out of his hands, you tip it a little, drawing him to stretch out his tongue and wait with open mouth. Pouring more cum onto his tongue, you watch it trickle into the angel's mouth, covering his taste buds with the forbidden fluid. Gabriel grunts in arousal as he swallows it all, then asks for more, which you draw out a little, letting him beg and grovel before you feed him even more. In swigs and gulps, the tamed Seraphim finishes off the bottle, getting desperately horny in the progress. Panting audibly, he's totally focused on the bottle you wave before his eyes, licking its opening as if to tease out some more cum from it. He looks after it as you casually throw the empty bottle aside, turn turns back to you, his eyes now showing as glossy black orbs.";
	WaitLineBreak;
	say "     'Nnnghh,' Gabriel groans and his hands move to grab your arms tightly, almost painfully. A somewhat unhinged expression flashes over his handsome features as the young man growls, 'I need more!' Slapping his hands aside roughly, you bury your fingers in his long hair and wrench his head backwards a little, reminding him in a harsh tone who's the master between the two of you. This makes your fuckpet's eyes go wide, with him gasping out, 'Sorry [master], it's just - I feel wild, dangerous now. Like I could just take anything I want, when I want! But I know I'm yours, so this must be wrong!' You can see clearly that he's battling with himself, varied expressions crossing his face until he finally focuses that eerie black gaze back on you. '[Master]! Forgive the weakness of my will, I almost gave in to the voices! I need to be punished! Take me! Let me choke on your prick as you drive it home!' With that said, Gabriel falls to his knees before you and gives you an intense look even as he opens his mouth to receive you.";
	say "     You can feel lust, envy, wrath and other dark emotions bubble around behind those black eyes of your angelic pet, yet somehow his slavish devotion to you keeps them in check, if only barely. It isn't hard to see how the same stuff made Elijah into what he is now and you can't help but wonder if Gabriel would have turned out the same if you hadn't broken him to your will first, or if something about the handsome man's character would have resisted nonetheless. No matter which, he's your pet now and his sexual aggression is turning inwards, making him a whore for punishment. Pushing any other thoughts, you stroke your [cock of Player] shaft and then ram its hard length down the angel's throat, giving your slut just what he needs right now. Bottoming out in a single forceful thrust, you only stop when Gabriel's nose is buried in your crotch and even then grind his head against you with both hands.";
	WaitLineBreak;
	say "     It almost seems that the young man is trying to choke himself, clamping his hands tightly on your legs and holding on in an iron grip even as your prick is cutting off his oxygen. The muscles in his throat bob and flex around your dickhead, giving you some quite enjoyable moments and almost making you forget that Gabriel does indeed need to breathe. Only the fact that the grip of his clenched fingers weakens so much that one hand slips a little draws you back to the realities at hand and you wrench the red-faced man off your dick, having to hold him by the hair so he doesn't collapse as he gasps desperately for air. Even so, he's back to staring up at you in no time at all, panting out between breaths, 'Fuck my face, [master]! Punish your slut! Use me like the whore I am!' A smirk plays over your mouth as you then proceed to do exactly that, ramming the angel's mouth back onto your cock and basically using him like a giant fleshlight.";
	say "     Slamming in and out of the warm and tight throat of your angelic pet, you sometimes pause for a little while and choke him a little bit more, but you never allow things to go quite as far as during the first time. Gabriel takes everything that you dish out gleefully, and at some point you realize that he's jerking himself off furiously. The fact that the handsome man revels in your sexual punishment ramps your own lust up another few notches and before long, you can feel a familiar tightness rise in your balls. Digging both of your hands into the long hair of your cum-slut, you hold him tightly and when you're just about to reach climax, you pull him off almost all the way, allowing your first splash of cum to cover his tongue, followed by many more as you feed him your load and Gabriel swallows it down greedily. Almost at the same time, he pushes himself over the edge with his jerking, spraying cum over the ground just in front of you.";
	WaitLineBreak;
	say "     By the time your orgasm has run its course, it becomes obvious that the demon seed's effect on Gabriel is far more temporary than Elijah's seems to have been, possibly because he fought off its power and didn't internalize it. This leaves you with a somewhat cum-smeared and breathless blue-eyed Seraphim kneeling before you, looking up with wide eyes. 'I'm sorry [master], I don't know what came over me when I drank that stuff. I - I thank you for reminding me of my place.' Wiping off a stray bit of cum from his lip and then pushing your finger into Gabriel's mouth to let him suck it off, you grin and tousle his hair as you remind him that he's yours, now and forever.";
	say "[bold type]You lose 1 demon seed![roman type][line break]";
	decrease carried of demon seed by 1;
	now Stamina of Gabriel is turns; [last cum dose]
	if Libido of Gabriel < 10:
		increase Libido of Gabriel by 2; [big increase, special cum drink]

Section 5 - Fucking

instead of fucking Gabriel:
	if (lastfuck of Gabriel - turns < 5):
		say "     Gabriel lowers his head submissively and says 'Forgive me, [if Player is purefemale]mistress [else]master [end if]but I need a break...'";
	else:
		now sextablerun is 0;
		blank out the whole of table of fucking options;
		[]
		choose a blank row in table of fucking options;
		now title entry is "Suck Gabriel's cock";
		now sortorder entry is 1;
		now description entry is "Give him a blow-job";
		[]
		if Player is male:
			choose a blank row in table of fucking options;
			now title entry is "Have him suck your cock";
			now sortorder entry is 2;
			now description entry is "Get a blow-job";
		[
		if Player is female:
			choose a blank row in table of fucking options;
			now title entry is "Let Gabriel fuck your pussy";
			now sortorder entry is 3;
			now description entry is "Let your angel pet breed you";
		][
		choose a blank row in table of fucking options;
		now title entry is "Let Gabriel fuck your ass";
		now sortorder entry is 4;
		now description entry is "Let the tame angel fill your ass with his seed";
		]
		if Player is male:
			choose a blank row in table of fucking options;
			now title entry is "Take Gabriel's ass";
			now sortorder entry is 5;
			now description entry is "Fill the tame angel's ass with your cock";
		[]
		choose a blank row in table of fucking options;
		now title entry is "Let Elijah have a ride on Gabriel";
		now sortorder entry is 6;
		now description entry is "Watch the fallen angel pound your slave";
		[]
		sort the table of fucking options in sortorder order;
		repeat with y running from 1 to number of filled rows in table of fucking options:
			choose row y from the table of fucking options;
			say "[link][y] - [title entry][as][y][end link][line break]";
		say "[link]0 - Nevermind[as]0[end link][line break]";
		while sextablerun is 0:
			say "Pick the corresponding number> [run paragraph on]";
			get a number;
			if calcnumber > 0 and calcnumber <= the number of filled rows in table of fucking options:
				now current menu selection is calcnumber;
				choose row calcnumber in table of fucking options;
				say "[title entry]: [description entry]?";
				if Player consents:
					let nam be title entry;
					clear the screen and hyperlink list;
					now sextablerun is 1;
					if nam is "Suck Gabriel's cock":
						say "[GabrielSex1]";
					else if (nam is "Have him suck your cock"):
						say "[GabrielSex2]";
					else if (nam is "Let Gabriel fuck your pussy"):
						say "[GabrielSex3]";
					else if (nam is "Let Gabriel fuck your ass"):
						say "[GabrielSex4]";
					else if (nam is "Take Gabriel's ass"):
						say "[GabrielSex5]";
					else if (nam is "Let Elijah have a ride on Gabriel"):
						say "[GabrielSex6]";
					now lastfuck of Gabriel is turns;
					wait for any key;
			else if calcnumber is 0:
				now sextablerun is 1;
				say "     You step back from the submissive angel, shaking your head slightly as he gives a questioning look.";
				wait for any key;
			else:
				say "Invalid Option. Pick between 1 and [the number of filled rows in the table of fucking options].";
		clear the screen and hyperlink list;

to say GabrielSex1: [Suck Gabriel's cock]
	say "     Just walking up to Gabriel, you stroke both hands over his hairless chest, enjoying the feel of all the little ridges and bumps his trained muscles provide. The angel gives an aroused sigh as your fingers find his nipples, lightly pinching and rubbing them, followed by a louder moan as you put an arm over his shoulder, gripping the youthful-looking male's long hair tightly and pulling him into a demanding kiss. Your tongue explores his mouth and wrestles with Gabriel's, then you suddenly draw his head aside and give him a little love-bite - or rather a mark of ownership - on the side of his neck, before going back to making out with him pretty roughly.";
	say "     And the beauty of it all is... your little angel likes it, fully tamed to your desires now and clearly showing so with the bulge of his erection pressing against your closely entwined bodies. 'Oooh yes, master,' he gives a happy little groan when you leave him time to catch his breath a short while later, then simply moans into your mouth as you press it on his again. You revel in his complete submission for a few moments, then decide that you want to taste the sweet nectar of his balls today and guide him over to one of the many beds standing in rows down here.";
	WaitLineBreak;
	say "     Throat bobbing as he reflexively swallows from excitement over what you might do to him next, Gabriel looks at you with an eager, willing to please expression. You can't help but smile as you put your hand on his muscled chest and push him over, making your tamed angel fall on the bed behind him, catching himself on soft wings and panting in starting arousal. Immediately following up your man-handling of the sexy submissive, you catch hold of his arms, stretching them over his head to stick through the bars of the bed-frame headboard, where you hook his wrist-cuffs together, tying Gabriel down. There is a little moan from the handsome brown-haired guy as he pulls on his bindings and the metal clasp between them clatters against the framing struts. You can see a definite throb inside his tight pants at the crotch, telling you how much your pet enjoys the situation you put him in.";
	say "     Looking down upon the stretched-out Seraphim, you let your eyes roam over his muscled chest and then get on the bed with him, putting one hand on his crotch. 'Mmmh...' he sighs needily as you rub over the tent in his pants, only to pull back again, then tease him with fleeting touches that wind him up more and more before you finally pop open the button and pull down his zipper. Your angelic slave gives a worshipful moan of 'Oooh, thank you master,' as you free his raging boner from its confinement, allowing the perfectly shaped cock to stand straight. As you close a hand around it a moment later and give it a slow jerk, a drop of precum forms at the very tip. He's clearly quite aroused and ready for you to have fun with. Oh yeah, Gabriel really did turn out well. Just the sex pet you always wanted.";
	WaitLineBreak;
	say "     Running a hand over his defined abs and up to playfully pinch one of his nipples, you decide it's about time to start the real action. Cupping Gabriel's balls and gently rolling them between your fingers, you take hold of his shaft with the other hand and bend forward to lick over the cockhead, drawing a gasp from your pet. His pre-cum is amazingly tasty, almost like sweet ambrosia, and you quickly proceed to sink your lips down over more of his cock, bobbing up and down. Soon you're taking his whole dick, deep-throating the handsome angel all the way down to his crotch, nose pressed into his pubes and breathing in his clean, manly scent.";
	say "     You proceed to give your subby pet a first-class blowjob, filling the bunker with grunts, moans as well as slurping noises, really going to town on him until you can hear Gabriel's pants come faster and faster, signaling that he's getting close. And then, you pull your mouth of his prick with a wet pop, leaving the wet and glistening pole to stand on its own. There is a moment of metal clattering against metal as the boundlessly aroused male tries to pull his arms down and finish himself off - only to be stopped by his cuffs. Smiling down at Gabriel, you tell him to be a good pet and stay absolutely still, which gets you a pleading look and a tense little nod. Leaning in again, you softly blow against his erection, then give it a painfully slow lick up the left side before finally plunging your mouth down over it once more.";
	WaitLineBreak;
	say "     Before you're more than halfway down, Gabriel bucks on the bed and calls out in a loud moan, painting your tonsils with streaks of rich and creamy cum. Pulling back a little, you take everything he has to give on your tongue, tasting and savoring its taste before you swallow, then suckle on his manhood to milk even the last drop out of it. As the last spurts slowly ebb off and finally stop, you keep a mouthful of cum instead of swallowing it, then lean over Gabriel and run a hand through his long hair, sharing a deep kiss with him and pushing his own seed into his mouth. As the perfect slave-boy that you've tamed him into, he eagerly accepts your gift, tongue wiggling against yours and moaning into your mouth as he tastes his own cum. When you finally pull back and allow Gabriel to catch his breath, the angel gives you the happy smile of one very fulfilled slave-boy.";
	NPCSexAftermath Player receives "OralCock" from Gabriel;

to say GabrielSex2: [player gets BJ]
	say "     Just walking up to Gabriel, you stroke both hands over his hairless chest, enjoying the feel of all the little ridges and bumps his trained muscles provide. The angel gives an aroused sigh as your fingers find his nipples, lightly pinching and rubbing them, followed by a louder moan as you put an arm over his shoulder, gripping the youthful-looking male's long hair tightly and pulling him into a demanding kiss. Your tongue explores his mouth and wrestles with Gabriel's, then you suddenly draw his head aside and give him a little love-bite - or rather a mark of ownership - on the side of his neck, before going back to making out with him pretty roughly. And the beauty of it all is... your little angel likes it, fully tamed to your desires now and clearly showing so with the bulge of his erection pressing against your closely entwined bodies.";
	say "     'Oooh yes, [master],' he gives a happy little groan when you leave him time to catch his breath a short while later, then simply moans into your mouth as you press it on his again. You revel in his complete submission for a few moments, then decide that you want to make use of his sweet mouth today and press down on both of his shoulders. Instantly reacting to the wordless command, Gabriel falls to his knees before you, then looks up with a worshipful expression - which prompts you to pull out your [cock of Player] shaft to smack lightly against his chiseled cheekbones. Gabriel just endures it without complaint, even offering you his other cheek and rubbing up a bit against your erection. ";
	if OralVirgin of Gabriel is true:
		say " His lips brush over your cock, opening just far enough to take it into his mouth, then tries to go deeper only to gag a little when it hits the back of his throat. Confused, the young man pulls back. You tap his head lightly and make him look up, explaining that he needs to get you properly wet first.";
		say "     Sticking his tongue out and eagerly following your instructions, Gabriel licks at the head of your shaft, then works his way along the sides. Soon, your erection is wet with his saliva and as he wraps his fingers around it, they slide up and down the shaft much more easily than before. The handsome angel tries taking you into his mouth again after that, having a much easier time now that you can just slide in smoothly. He works back and forth along your length with only a second or two of gagging before he finally figures out how to relax his throat muscles and your whole shaft slots into place inside him. Running your fingers through the long hair of your sex pet, you press his face against your crotch firmly, making him huff the scent of your body and feel your prick throb inside him. Gruffly telling the man that this is what he was made for, you keep him like that for a little while, then eventually let go and allow him to pull off and gasp for breath.";
	else:
		say "After a moment more of this, his lips brush over your cockhead, then spread and stretch to engulf it, slowly starting to slide down the erect shaft.";
	WaitLineBreak;
	say "     Looking down at the tamed Seraphim as he eagerly begins to bob up and down on your cock, you realize that the front of his tight jeans is open too by now, with a respectable piece of man-meat poking out and resting in one of his strong hands. Quite a little ego boost, to see that the handsome guy is jerking his own shaft because servicing you is now a definite turn-on for him. Oh yeah, Gabriel really did turn out well. Just the sex pet you always wanted. Deciding that it's time to let him really have it now, you run your hands through the angel's long, soft hair and tell him what a good boy he is, which gets answered only by a content hum around your erection being almost balls-deep in his mouth. And then, you suddenly grip his head very tightly again and hold it as you thrust forward, only stopping when Gabriel's nose is buried right in your pubes and poking against the skin of your crotch with its tip.";
	say "     You proceed to face-fuck your subby angel, filling the bunker with grunts, moans as well as slurping noises, simply going to town on him until you can feel the need to cum rise as a familiar tingling in your balls. With a last quick thrust of your hips, you bury your shaft deep in Gabriel's throat, just in time to send the first blast of cum directly into his stomach, followed by the next, and the next. After the first few spurts, you pull back a bit to cover Gabriel's tongue with the rest of your load, then tell him to show it to you. And indeed, Gabriel does so - happily sticking out a tongue covered in creamy cum. As you pat his head, telling him what a good boy he has been, the angel gives a happy little groan, then suddenly starts panting and twitching - as he reached his own climax just at that moment, hand tightly gripped around the cock between his legs. Gabriel's cum forms a little puddle between your legs, spilled happily by one fulfilled slave-boy.";
	if Libido of Gabriel is 0: [first time BJ]
		WaitLineBreak;
		say "     With the Seraphim looking up at you and licking his lips to get even the tiniest drop of cum, you can't help but smile at his antics. Then a thought comes to your mind: It could be fun to train your angelic toy into being a total cum-slut, really pushing him to crave a man's seed beyond all bounds.";
		say "[GabrielCumSlutTraining1]";
	else if Libido of Gabriel is 99: [postponed before]
		WaitLineBreak;
		say "     Seeing the Seraphim licking even the tiniest droplet of cum off his lips, you can't help but be reminded of the idea to train your angelic toy into being a total cum-slut, really pushing him to crave a man's seed beyond all bounds.";
		say "[GabrielCumSlutTraining1]";
	now Stamina of Gabriel is turns; [last cum dose]
	NPCSexAftermath Gabriel receives "OralCock" from Player;

to say GabrielCumSlutTraining1:
	say "     [link](1)[as]1[end link] - Go for it - make him lick his cum off the ground for a start.[line break]";
	say "     [link](2)[as]2[end link] - Not right now, maybe later.[line break]";
	say "     [link](3)[as]3[end link] - Nah, not your style. Discard the idea.[line break]";
	now calcnumber is 0;
	while calcnumber < 1 or calcnumber > 3:
		say "Choice? (1-3)>[run paragraph on]";
		get a number;
		if calcnumber is 1 or calcnumber is 2 or calcnumber is 3:
			break;
		else:
			say "Invalid choice. Type [link]1[end link] to start Gabriel's cumslut training, [link]2[end link] to postpone for now or [link]3[end link] to reject the idea.";
	if calcnumber is 1: [train]
		LineBreak;
		say "     Gripping your little angel's jaw tightly with your hand, you tilt his head up and look deeply into his blue eyes, then tell him that he's not done yet. Gabriel's eyes widen and just for a second he glances down at your cock, followed by licking his lips. 'Do you want another round, [master]?' comes his innocent question, to which you reply that any man's seed is a precious thing and he shouldn't waste it. He still doesn't get it, until you finally point down to the ground between your feet and clear your throat impatiently. Making a small apologetic noise, Gabriel goes down to all fours immediately after that, lowering his head to lick at the spilled cum. He's almost painfully eager to fulfill your every demand, up to and including eating cum off the concrete floor of the bunker.";
		say "     Seeing such slavish obedience by a half-naked, handsome angel, you can't help but grow hard again, your [cock of Player] shaft filling out to its full length within moments. With this being such a perfect opportunity to show him the rewards of being a good little cum-slut, the only question is where you want to deposit your next load...";
		LineBreak;
		say "     ([link]Y[as]y[end link]) - Down his slutty throat of course![line break]";
		say "     ([link]N[as]n[end link]) - Into his sweet and tight asshole.[line break]";
		if Player consents: [BJ]
			LineBreak;
			say "     You continue watching for a little while longer as Gabriel licks up and swallows the last of his own cum, awaiting him with a hard and erect cock at eye-level as he looks up afterwards. Given that he's internalized his role as your fuck-toy, there is little surprise in that he immediately reacts to this by engulfing your erection with his lips, taking you deep in his mouth and suckling happily on your shaft. It feels great to be inside the warm, wet cavern of his once again and you start thrusting in and out rapidly, enjoying what pleasure the young man can give you. Those soft lips around your length, the questing tongue that traces each vein on the erection, together with him sucking hard and giving you worshipful looks through those baby-blue eyes, all of that makes Gabriel just the perfect cocksucker.";
			say "     Having come before, you don't feel quite the same urge to cum into him as before, instead even giving him a little while to simply worship your cock, relaxing the grip on his head to allow him to move instead of just hammering into him. As you do so, you stress to your sex pet that he must work on perfecting his technique and become the best cocksucker he can be. Gabriel gives you a happy, 'Mmhmmm!' hummed around the piece of man-meat between his lips and proceeds to try out some new things with his tongue. One of those has you moaning out loud within a second, hand gripping him tightly by the hair and grinding his face against your crotch from the sheer pleasure. He reacts by simply sucking even harder, driving you over the edge mere seconds later. A volley of cum blasts shoots down his throat, joining all the other seed the angel has already eaten today.";
			WaitLineBreak;
			say "     Only when your orgasm eventually ebbs off do you actually let go of his head, allowing him to pull off your erection. Gabriel does so slowly and carefully, his lips wrapped tightly around the shaft all the way. When he finally pulls off your dickhead, the sexy male does so with a slurp, smacking his lips happily and giving you a broad smile. 'Thank you for sharing your seed with me, [master]. I'm starting to see now what you meant about cum being precious and that it should never be wasted. I'll be ready so you can give it all to me, alright?' Chuckling about his devotion, you brush the tip of your index finger over his wet lips, then slide it in between them, letting Gabriel suck a little on your digit while you stroke his shoulders and naked chest, telling him what a good boy he is.";
			now Stamina of Gabriel is turns; [last cum dose]
		else: [assfuck]
			say "     Making your way behind Gabriel as he continues to lick up and swallow his own cum, you stroke the length of your erection and then crouch down to his level. With his face down against the ground, your sexy hunk of a fucktoy literally has to raise his ass in a very inviting way. It's no trouble at all to line yourself up with his back door and slam into him from behind with a harsh thrust that has the angel rearing up with a gasp, only to be pushed down again by your hands, face-planting into the puddle of cum. With your hands grasping his shoulders tightly and holding Gabriel down, you're just grinding against his ass, reveling in the sensation of his hole tightly gripping your shaft. Giving little thrusts to underline each word, you tell him that this is what he's made for - eating cum, lying in a pool of it and taking it up the ass like the needy cum-slut he is.";
			say "     Already broken in to obedience and getting a vigorous fuck to boot, Gabriel's responses to your statements are simply long, drawn-out moans that speak of his desire to be dominated. He definitively is a happy slut of a sex pet for you and even flexes his ass muscles in just the right way as you tell him to, milking your cock inside his tight chute. It only takes a little while longer before this drives you over the edge, erupting into the angel's bowels with your cock buried balls-deep inside. Spurt after spurt of creamy seed floods his inner passage, painting it white and once more confirming your claim on Gabriel as your sex pet. While your cock is still filling him with more and more cum, you draw the man up into embracing him from behind and whisper into his ear that he's pleased his [master]. Then you wipe your finger over his cum-slick cheek and make him lick it off before pushing him back down to finish cleaning off his spilled seed.";
			NPCSexAftermath Gabriel receives "AssFuck" from Player;
			now Stamina of Gabriel is turns; [last cum dose]
		now Libido of Gabriel is 1; [started the cumslut training]
	else if calcnumber is 2: [postpone]
		LineBreak;
		say "     Shrugging to yourself, you file away the idea for another time maybe. Meanwhile, your tamed Seraphim is still kneeling before you and staring worshipfully at your [cock of Player] cock, none the wiser that you just made a decision about his future. Tousling his hair, you then move to get dressed again, followed by ordering the young man to keep himself ready for further pleasure when you want it.";
		now Libido of Gabriel is 99; [postponed training]
	if calcnumber is 3: [refuse]
		LineBreak;
		say "     Where did that thought even come from? You shake your head and jostle it from your mind, never to be seen again. Meanwhile, your tamed Seraphim is still kneeling before you and staring worshipfully at your [cock of Player] cock, none the wiser that you just made a decision about his future. Tousling his hair, you then move to get dressed again, followed by ordering the young man to keep himself ready for further pleasure when you want it.";
		now Libido of Gabriel is 100; [rejected training]

to say GabrielSex3: [player pussy fucked]
	say " ";
	NPCSexAftermath Player receives "PussyFuck" from Gabriel;

to say GabrielSex4: [player ass fucked]
	say " ";
	NPCSexAftermath Player receives "AssFuck" from Gabriel;

to say GabrielSex5:
	say "     Just walking up to Gabriel, you stroke both hands over his hairless chest, enjoying the feel of all the little ridges and bumps his trained muscles provide. The angel gives an aroused sigh as your fingers find his nipples, lightly pinching and rubbing them, followed by a louder moan as you put an arm over his shoulder, gripping the youthful-looking male's long hair tightly and pulling him into a demanding kiss. Your tongue explores his mouth and wrestles with Gabriel's, then you suddenly draw his head aside and give him a little love-bite - or rather a mark of ownership - on the side of his neck, before going back to making out with him pretty roughly.";
	say "     And the beauty of it all is... your little angel likes it, fully tamed to your desires now and clearly showing so with the bulge of his erection pressing against your closely entwined bodies. 'Oooh yes, master,' he gives a happy little groan when you leave him time to catch his breath a short while later, then simply moans into your mouth as you press it on his again. You revel in his complete submission for a few moments, then decide that you want to make use of his tight ass today and reach down to grope the firm buns of his shapely butt.";
	WaitLineBreak;
	say "     Instantly reacting to the wordless command, Gabriel lets out an aroused moan and gives you a worshipful expression - then moves over to his bed and starts to strip. The tame angel slides both hands down over his naked chest, stroking firm muscles and teasing the nipples, then they come to rest on the crotch of his pants. He gives a seductive sway of his hips and rubs his tight package before starting to pop the buttons... one, two, three, four - revealing the beautiful male's perfect manhood, standing hard and ready from his anticipation. With a quick shove, the tight jeans on your winged pet fall down onto the floor and he is naked before you - except the collar and cuffs that mark him as your property, of course. With an eager and needy look on his face, Gabriel lies down upon his bed, his white wings serving as an extra layer of downy bedding.";
	say "     The sight of this handsome man waiting for you in submissive pose instantly gets you rock hard, with him even spreading his legs and holding them open to reveal a rosy pucker for his master to take. You quickly pull out your [cock of Player] shaft and stroke it while walking up to him, then climb on the bed yourself and lean over Gabriel. First caressing his face, stroking its angular cheekbones and perfect skin, you then push two fingers into his mouth and watch as he obediently sucks on them. Next, you bring your hand down between his legs and brush over the tight pucker waiting for you there, teasing him for a second before pressing in with the wet digits and sliding into his tight chute. Gabriel squirms and twitches in arousal as you finger him, but soon his hungry hole demands something more to fill it, and a deep moan leaves his mouth, followed by the words, 'Please, fuck me. I need it.'";
	WaitLineBreak;
	say "     Looking down at the tamed Seraphim and taking in the worshipful, needy look in his eyes, you look down after a moment and realize that while his manhood is fully erect and leaking a steady trickle of pre-cum on his awe-inspiring abs, the angel doesn't make any moves to jerk himself of. No, his hands stay where they are, holding himself open for you as he acts just as a good servant-boy should. It is quite a little ego boost, to see that this handsome guy is horny and dripping, just waiting for you to take. Oh yeah, Gabriel really did turn out well. Just the sex pet you always wanted. You decide it is time let him really have it now and run your hands through Gabriel's long, soft hair, then tell him what a good boy he is and give him a deep kiss full on the lips.";
	say "     While your tongues wrestle with each other, your right hand takes hold of the [cock of Player] cock between your legs and lines it up with the seraphim's love-hole, then you thrust into him deep. Gabriel moans into your mouth loudly as you penetrate him fully and your balls slap against his cheeks, then gives a satisfied little whimper as you pull back, only to ram into him again. Giving your partner a rough kiss, you proceed to fuck him with rapid thrusts without pause, really taking it out on the guy - and the beauty of it is, he just begs - or rather screams lustfully - for more. Always more, and harder, and deeper. Having accepted his properly submissive place, Gabriel stays rock hard the whole time, with the proudly standing erection leaking drops of precum to drip on his rippling abs. He just feels amazing to be in too, with a yielding yet very tight hole and anal muscles that seem to know instinctively when to flex around your shaft. As wound up as you got him and with your own satisfaction of how nicely this is working out, it doesn't take all that long until the two of you approach your respective orgasms.";
	WaitLineBreak;
	say "     Pounding into Gabriel hard, you enjoy using his back door to its fullest while at the same time sharing sloppy kisses in a frenzied bit of making out. And when you finally cross the point of no return, it is with your prick buried in him all the way, depositing your seed deep and renewing the claim you have on this winged subby slut. As you fill him up, warm cum splashing over his inner walls, Gabriel moans incoherently, aroused beyond all self-control by satisfying his master. His cock jerks and pulses as this pushes him into climax and it sprays a quite respectable load into the air to splat down all over his chest and neck. Such a cute and oh so willing pet you have - the perfect bottom-boy, and all yours to keep and breed whenever you want to.";
	say "     As your orgasm winds down afterwards, with you still panting to catch your breath, Gabriel looks up at you and says, 'Thank you master. That was amazing. I'm pleased to be yours.' With a happy little groan, his head sinks back to rest on the bed and the angel dozes off in exhaustion. You stay as you are a moment longer, looking closely at the attractive form of his muscled body, relaxed as he is now, then eventually pull out slowly and stand up. Leaving your fulfilled slave-boy behind, sweaty and cum-stained as he is, you go to collect your gear again and get dressed. Fucking your pet is fun, but now it is time to get back to the tricky task of surviving in this crazy city...";
	NPCSexAftermath Gabriel receives "AssFuck" from Player;

to say GabrielSex6:
	say "     Just walking up to Gabriel, you stroke both hands over his hairless chest, enjoying the feel of all the little ridges and bumps his trained muscles provide. The angel gives an aroused sigh as your fingers find his nipples, lightly pinching and rubbing them, followed by a louder moan as you put an arm over his shoulder, gripping the youthful-looking male's long hair tightly and pulling him into a demanding kiss. Your tongue explores his mouth and wrestles with Gabriel's, then you suddenly draw his head aside and give him a little love-bite - or rather a mark of ownership - on the side of his neck, before going back to making out with him pretty roughly.";
	say "     And the beauty of it all is... your little angel likes it, fully tamed to your desires now and clearly showing so with the bulge of his erection pressing against your closely entwined bodies. 'Oooh yes, master,' he gives a happy little groan when you leave him time to catch his breath a short while later, then simply moans into your mouth as you press it on his again. You revel in his complete submission for a few moments, then decide that you want to watch Elijah make use of his tight ass today. Reaching down to grope the firm buns of Gabriel's shapely butt, you ask him to say what he's here for - and what his ass is meant for.";
	WaitLineBreak;
	say "     Biting his lip before letting out a low moan, the collared angel pants, 'I'm yours master. Ready... ready to be used. Fucked. I -' While he's still talking, you slide your hand inside his jeans, wiggling it in over the seraphim's smooth-skinned buttocks and dipping a finger into his tight little hole. 'Nnnggh! Yes! I need it! Finger my ass, fuck my ass!' Just what you wanted to hear. Using your other hand to hold Gabriel by the back of his neck, you give him another hot kiss, then tell him he's about to have a lot of fun. After pushing your probing finger especially deep and stroking over his prostate to make the subby slut gasp, you pull your hand out of his pants and give your angelic pet a slap on the ass, ordering him to follow you.";
	say "     Leading the tame angel though the bunker, it doesn't take long before you're walking up to where Elijah is leaning against a wall, casually paging through a gay porn magazine. He holds it sideways for a moment to leer at a fold-out section, then looks up as you clear your throat. 'Well well... what do we have here,' the fallen angel says with a chuckle, tossing aside his magazine to take in Gabriel's half-naked form. As Elijah uses his black-feathered wings to push off from the wall and saunters over towards Gabriel, your pet gives you a somewhat pleading look and sighs as he sees the glee dancing in your eyes at arranging this encounter. His voice breaks a little as he looks back at the quickly approaching man and says, 'Elijah. We're friends, and...'";
	WaitLineBreak;
	say "     The fallen angel interrupts him, 'Oh sure, I'll be VERY friendly with you. Love the new look, Gabe. You always dressed a bit stuffily. This is just PERFECT for you.' With that, Elijah brushes a hand over Gabriel's naked chest, hooking a finger under the leather collar you put on him and playing with the ring for clasping on a leash. Your angelic pet looks a little distressed and presses his lips together, yet can't hold back a moan as Elijah puts a hand on his crotch and gives a hard squeeze. Then the dark angel turns to look at you says, 'So, bringing your little winged slut to me, wound up and with a hard-on... I can see where this is going. I've got free rein with him?' The callous way in which he posed the last question makes you raise your eyebrow, prompting Elijah to add, '...without bruising him up too much. Fine, okay?'";
	say "     As you nod, Elijah chuckles darkly and drags Gabriel after him with two fingers hooked under his collar, then pushes the angel to stumble against the nearest wall. He's up close behind his former best friend before Gabriel can do much more than catch himself, pressing the enslaved angel against the hard concrete and grinding his crotch into Gabriel's ass. 'I'm gonna enjoy taking you,' you hear the predatory fallen angel grunt into his helpless victim's ear, answered by a whimper that holds arousal and despair in equal measure. Arms snaking around the collared seraphim's body, Elijah opens his jeans at the front, then wrenches them down to Gabriel's ankles - deliberately leaving them there to hobble the submissive male.";
	WaitLineBreak;
	say "     'Going commando - that's a good slut! Faster access for your masters!' the dark angel taunts Gabriel, then reaches between his legs and grabs the tamed seraphim's hard cock. He gives it a few jerks, then slaps your pet on the ass - just hard enough to leave a visible hand-print. 'Look at how hard you are - you really can't wait to be fucked, can you? Tell me, bitch!' Elijah's hands on his body and the forceful demand clearly speaks to the submissive you've trained Gabriel to be - and the soft-spoken angel whimpers needily, 'Fuck me, please. I - I want your cock in me.' While undoing the buckles on his high boots and the front of his leather pants, Elijah says with a growl, 'This really is what you were meant to be. Always so eager to hang out and follow my lead. And thanks to these mortals folly with their out of control nano-machines, we're finally complete!'";
	say "     Having discarded his boots by now, Elijah finishes kicking off his pants too, then steps up behind Gabriel and smacks his perfect shaft against the other angel's buttocks. 'Time to put this hard rod up your ass,' he adds a moment later, one hand milking Gabriel's cock, then smearing the copious amount of pre-cum the needy bottom's cock is leaking on his own shaft. Only a few heartbeats later, Elijah lines himself up with the trembling hole of his old friend and thrusts in hard, mercilessly hammering into the other male. Gabriel whimpers at the force of the initial penetration, but almost instantly afterwards, moans start coming from his mouth as his arousal spikes at being used like this. Moving a few steps to the side, you see the enraptured expression on his face - pressed against the wall as it is - and his cock is hard as ever, smearing trails on pre-cum on the wall as Elijah pushes into him rhythmically.";
	WaitLineBreak;
	say "     The fallen angel fucks your sweet pet with barely restrained intensity, pounding Gabriel against the wall with harsh thrusts that make their bodies meet with slapping noises. Your submissive captive's beautiful white wings, sign of his divine origin that they are... serve Elijah as nothing but handholds as he fucks into him hard, muscled arms slid under them and hands gripping around the top edge. And throughout all that, Gabriel can't help but moan, scream and gasp in lust, totally broken in to being your needy slut by now. After a while of truly breathtaking butt-fucking, Elijah grabs a handful of Gabriel's long hair and pulls the other angel's head towards him, giving his former best friend a demanding kiss - all the while still pounding him with circling movements of his hips.";
	say "     Eventually pulling back from invading Gabriel's mouth with his tongue, Elijah chuckles as the angel gasps for breath. Then the black-haired Adonis calls out, 'Who's fucking you, slut? Go on, tell the world. Scream for me!' He intensifies his deep penetrations into Gabriel's well-tenderized butt just as the other male starts to reply, producing the long shouted string of, 'Eli- AH! Ahhhh! Fucck!! ELIJAH! NNGHH! Fuck me! Elijah is fu- AHHH - fucking me and I love it!' Hearing his name being gasped in between Gabriel's needy moans arouses the dark angel to no end and he spreads his black wings to the fullest extent of their terrible beauty, flapping them slowly as he buries his manhood into the tight embrace of your pet's hole, then starts pumping a heavy load of potent seed into him. 'Take it, butt-slut!' the dark angel groans as his whole body trembles with spurt after spurt being deposited into Gabriel.";
	WaitLineBreak;
	say "     As Elijah is still giving slow thrusts into Gabriel, grunting and mumbling as he rides his orgasm, you spot the collared angel leaning his head against the wall, pressing against the cold stone with his forehead. He bites his lip and gives a needy whimper, then whimpers, 'This is who I am now.' And with that said, his cock twitches and a first spurt of angelic seed streaks against the bare wall, forming a white splash on the gray rock. Having once more given in to his new role in life, Gabriel is rocked by his orgasm and continues to cream the wall for a long moment, then he just leans against the wall in breathless exhaustion.";
	say "     Meanwhile, catching his stride again after his climax, Elijah pulls out of Gabriel with little fanfare, even laughing out loud at the sight of his helpless bottom's gaping and creamy hole and the gasp he gives at the sudden emptiness. He slaps Gabriel on the bare buttocks one last time, leaving a reddened imprint of his hand, then turns away from the fucked-out and exhausted angel. Looking at you with a smile at how aroused the show of their coupling has made you, Elijah saunters over to his own bunk, totally unconcerned about his own nudity or the tail of cum-droplets he leaves as he goes along. 'Wouldn't mind if you brought the bitch over regularly,' he says with a sidelong glance at you, then throws himself on the bed to lounge around in lazy satisfaction.";
	NPCSexAftermath Gabriel receives "AssFuck" from Elijah;

instead of going down from Grey Abbey Library while (Libido of Gabriel > 4 and Gabriel is in Bunker and player is male and Lastfuck of Gabriel - turns > 8 and a random chance of 1 in 3 succeeds): [cumslut, in the bunker, male player, not fucked that day, 33% chance]
	move player to Bunker;
	if debugactive is 1:
		say "     DEBUG: Gabriel Cumslut WALKIN[line break]";
	say "     As you come down the stairs into the bunker and enter the main room of your underground refuge, a very interesting sight awaits you. Roughly a dozen feet in front of the door, a pad made of folded blankets has been laid out on the floor, with your captive Seraphim pet kneeling on it. He is completely naked, providing a real feast for the eyes with his lithe, well-muscled body and the sizable cock that he is slowly stroking up and down. He's looking down at it right now, swiping up a glistening droplet of pre-cum with his index finger and bringing that up to lick off with a blissful expression. As he does so, he raises his gaze and catches sight of you, startling him to straighten up from the fairly relaxed position he was holding up till now. Eager to present himself, he pushes out his chest and stretches his pretty white wings to the sides, spreading their feathers wide.";
	say "     '[Master], I've been waiting for you. I - I need to taste you, feel your cum sliding down my throat! Please, [master]!' comes his plea, delivered in a slightly breathy tone. He flexes his arms and chest a little to give you a nice show, followed by pinching his own nipples. A needy moan escapes Gabriel's mouth as his nipples harden and a little throb of pre leaks from his cum-slit to drip down onto the blanket. After all the work you've put into breaking and training him to be a good little slut, the sexy angel really gets off on submitting now. You can't help but feel a grin spreading over your face as you walk closer, every step followed by his eager gaze until you're standing right in front of him. Reaching out to stroke over your subby slut's chest, then brushing your fingers up along his collarbone and neck, you grab a handful of his long, soft hair and pull his head back to look into Gabriel's eyes.";
	say "     [bold type]What do you want to do to Gabriel now?[roman type][line break]";
	say "     [link](1)[as]1[end link] - Praise him for being a good little cum-slut and fill his mouth with your cock!";
	say "     [link](2)[as]2[end link] - If he wants cum so bad, he can suck his own dick! Push him into position and make him do it.";
	say "     [link](3)[as]3[end link] - Tell him that he's a good little pet, but that you're not in the mood right now.";
	say "     [link](4)[as]4[end link] - Gruffly remind him that he gets cock when you decide that he deserves it and leave him with unfulfilled desires.";
	now calcnumber is 0;
	while calcnumber < 1 or calcnumber > 4:
		say "Choice? (1-4)>[run paragraph on]";
		get a number;
		if calcnumber is 1 or calcnumber is 2 or calcnumber is 3 or calcnumber is 4:
			break;
		else:
			say "Invalid choice. Type [link]1[end link] to face-fuck Gabriel, [link]2[end link] to make him suck himself, [link]3[end link] to tell him you're not in the mood or [link]4[end link] to punish him for being uppity.";
	if calcnumber is 1: [fuck his mouth]
		LineBreak;
		say "     Smiling down into young-looking man's face, you meet his gaze and are pleased to see his worshipful expression as you praise him for taking your training to heart. He licks his lips as you say that you want him to be your little cum-slut bitch boy, caressing his cheek with your free hand and then giving him two fingers to suckle on for a little while. 'Mmmhmmm!' Gabriel hums happily around your digits in his mouth, and you can see his dick throbbing again, dripping more pre just from his eager desire to be with you. You allow him to slurp on your fingers a little, then eventually pull them back out of the angel's mouth, with him leaving it open and waiting for you to fill it again. Eyes raised in a hopeful expression, he watches as you quickly free yourself from any clothing and gear that may be in the way. As your [cock of Player] shaft wags before his eyes, Gabriel leans forward and immediately captures it between his lips, letting the tip of his tongue play over the head.";
		say "     Given that he was literally a nonsexual being before you got hold of him, it is slightly amazing just how eagerly and skillfully the Seraphim now goes down on your erection. Gabriel's lips stretch around your shaft as he slides more length into his mouth and lets his tongue play over your girth, paying special attention to the veins running down along it. With a slurping noise and the pleasant sensation of suction all around your dick, your cumslut soon swallows the last inches of your prick. As he nuzzles your crotch and lets his throat muscles play over your cock, you realize that you've been pretty passive and let him do his own thing, which doesn't quite fit your roles of [master] and sex pet. To rectify this, you move your second hand to brush through Gabriel's hair too, clamping them both around his head in a tight grip. Taking control, you withdraw your manhood from his sucking mouth and keep him from stretching his head after it, then thrust yourself in between the waiting lips of his open mouth, going all the way until you bottom out in one fell swoop.";
		WaitLineBreak;
		say "     Gabriel has a very nice, welcoming mouth and throat, being able to take your deep push without even a hint of gagging. His inner muscles play over your cock in a very right way as you proceed to face-fuck your subby pet in rapid-fire strokes, balls slapping against his chin in a staccato of sounds interspersed with the groans and moans he manages to gasp out in between. Despite (or maybe because of) the fact that you're using him harshly and violate his mouth without leaving Gabriel any further choice in the matter, the corners of the angel's mouth are drawn into an ecstatic smile and you can see past his face that he's stroking his dick in the same rhythm that you pound his face with.";
		LineBreak;
		say "     [bold type]Do you want to allow Gabriel to keep jerk off?[roman type][line break]";
		LineBreak;
		say "     ([link]Y[as]y[end link]) - Sure, he's jerking off to your face-fuck after all.";
		say "     ([link]N[as]n[end link]) - No, command him to put his arms behind his back.";
		if Player consents: [let him jerk]
			LineBreak;
			say "     Unconcerned about Gabriel's self-pleasure, you concentrate on your own fun of face-fucking the attractive man and give him some more deep thrusts, one after the other. It just feels so good to have his throat contract around your dick every time he swallows, Adam's Apple bouncing up and down as he does so. Given such delightful sensations, it doesn't take all that much longer before the urge to cum builds sharply in your balls, and so you call out to your pet that you'll give him his reward now, grinding hard against his face to sink as much of your length as you can into him. With a deep grunt, you blast the first splash of cum straight into Gabriel's stomach, followed by another and another that trickles down his throat. Yet a good cumslut doesn't just need to be filled, he also needs to love the taste of cum, so you soon pull back, withdrawing your shaft until only the very tip is inside the angel's mouth, with the further spurts of seed painting his tongue white.";
			say "     Filling your happy little sub's mouth with cum is the last little push he needed to reach his own orgasm, so with a needy groan, Gabriel closes his fingers around his erection in a vice-tight grip and starts to erupt like a geyser, catching most of the cum in his cupped other hand. The two of you ride out your respective orgasms, in the course of which you relax your grip on the angel's head. This is just the opportunity he was waiting for, as Gabriel brings up his hand and lets the cum slide off it and onto your erection, then inhales its whole length all on his own, slurping hard on your cock to suck off his own seed. Withdrawing soon after, he lets out a happy, 'Thank you [master]!' and licks his lips to catch even the last droplet of cum to eat.";
		else: [no jerking!]
			LineBreak;
			say "     Gruffly deciding to cut down on Gabriel's self-pleasure, give his hair a sharp tug and then remind your pet that you control what he does, not him. His eyes widen and he gives you a submissive murmur around the cock between his lips, immediately obeying the command to put his hands behind his back right after. Glancing down, you see his erection throbbing as it swings between his legs. Almost looks like he's getting even harder from you dominating him like this. Chuckling, you focus your concentration back on face-fucking the attractive man, giving him some more deep thrusts, one after the other. It just feels so good to have his throat contract around your dick every time he swallows, Adam's Apple bouncing up and down as he does so. Given such delightful sensations, it doesn't take all that much longer before the urge to cum builds sharply in your balls, and so you call out to your pet that you'll give him his reward now, grinding hard against his face to sink as much of your length as you can into him.";
			say "     With a deep grunt, you blast the first splash of cum straight into Gabriel's stomach, followed by another and another that trickles down his throat. Yet a good cumslut doesn't just need to be filled, he also needs to love the taste of cum, so you soon pull back, withdrawing your shaft until only the very tip is inside the angel's mouth, with the further spurts of seed painting his tongue white. Filling your happy little sub's mouth with cum is the last little push he needed to reach his own orgasm, so with a needy groan, Gabriel stiffens before you, the muscles of his arms trembling as he forces himself to not to reach for his cock. Humping his hips forward reflexively, his cock starts to erupt like a geyser, spraying long streaks of angelic cum over the concrete floor of the bunker. The two of you ride out your respective orgasms, in the course of which you relax your grip on the angel's head, allowing him to pull off and give you a beaming smile after licking the last droplets of cum from his lips. Afterwards, he lets out a happy, 'Thank you [master]!'";
		NPCSexAftermath Gabriel receives "OralCock" from Player;
		now Stamina of Gabriel is turns; [last cum dose]
		if Libido of Gabriel < 10:
			increase Libido of Gabriel by 1;
	else if calcnumber is 2: [make him self-suck]
		LineBreak;
		say "     Smiling down into young-looking man's face, you meet his gaze and are pleased to see his worshipful expression as you praise him for taking your training to heart. He licks his lips as you say that you want him to be your little cum-slut bitch boy, caressing his cheek with your free hand and then giving him two fingers to suckle on for a little while. 'Mmmhmmm!' Gabriel hums happily around your digits in his mouth, and you can see his dick throbbing again, dripping more pre just from his eager desire to be with you. You allow him to slurp on your fingers a little, then eventually pull them back out of the angel's mouth, with him leaving it open and waiting for you to fill it again. Eyes raised in a hopeful expression, an expression of surprise crosses his face as you state that you won't be fucking his face just now. Clearing your throat, you explain that you want him to be a total cumslut, not just hungry for your seed, but any and all he can get - including his own.";
		say "     With a sharp command, you make Gabriel lay down on his back, then hook your hands under his knees and pull them up, higher and higher till his hips have been raised high and his erect cock is literally swinging in the air just a little above his own face. The fact that your sex-pet has an additional pair of limbs is especially useful right now, as he can brace himself on the ground with his wings while his arms take over holding the legs from you. Pleased with the way that he demonstrates a nice amount of flexibility and his complete willingness to obey orders, you slap his ass lightly and then cup his balls, giving them light squeezes. 'Nnngh, that feels nice master!' Gabriel moans out, happy to just be fondled by you. Yet that's not all you've planned for him, so you plant your hands right on his buttocks and press down on them firmly, pushing him further into a curled-up position that brings his dick to brush against his lips.";
		WaitLineBreak;
		say "     Panting hard through his nose, Gabriel huffs the aroma of his own pre-cum, then licks it off the dickhead and smacks his lips hungrily. Then he stretches his neck just a little further and takes the dickhead into his mouth, giving it a slurp that leads over into a happy groan. You continue to press down on his ass, bending him just a little bit further before it seems like you've reached the end of his flexibility. It is enough for him to start sucking on himself in earnest, able to take in not quite half of his own length and sucking hard on it. It is a fun sight to see what you can make your sex-pet do, but even though he's able to please himself, you think it'd take a while till he gets off, what with half his cock not getting any caresses at all. You decide to help him out this time, wrapping your fingers around the angel's erection and squeezing it, jerking him off.";
		say "     Suckling on his own cock and knowing exactly how to maximize his pleasure, as well as having his [master] touching his naked body and cock, it's to little surprise that Gabriel rapidly approaches an orgasm, with the breathing through his nose becoming faster and just a little ragged. You make a move to drive him over the edge by grasping his balls, rolling them between your fingers and giving nice little squeezes while at the same time jerking him hard. Then the point of no return is reached and with a grunt, Gabriel's whole body stiffens and you can see his balls throb as they send forth spurt after spurt of angelic seed to cover his tongue. Telling the subby angel to open his mouth, you watch with a grin as he relaxes his lips around his manhood and its mushroom head comes into sight, pulsing a little as a fresh splash of cum is sprayed into Gabriel's mouth.";
		WaitLineBreak;
		say "     Counting the shots of cum, you keep massaging and stroking Gabriel's cock and balls to coax out even more. Only then his orgasm eventually ebbs off and the man starts giving you pleading looks to give his now sensitive manhood a little rest do you relent, letting go with a last caress. Afterwards, you leave Gabriel free to stretch out on his back once more, finally relaxing from his ass over head position. Taking in the blissful expression on his face and seeing some slight movements of his cheeks, you just know that he's swishing his cum around in his mouth, reveling in the taste. Then his Adam's Apple starts to bob as he swallows a first little bit, in which you interrupt Gabriel by clearing your throat loudly and demand that he show you first. The handsome angel bows his head submissively, then stretches out his tongue and shows the white cum on it, creating a few little strings to his upper lips. Praising your cum-slut for giving you such a nice show, you allow him his full treat now and Gabriel hungrily swallows, followed by an earnest, 'Thank you [master]!'";
		NPCSexAftermath Gabriel receives "OralCock" from Gabriel;
		now Stamina of Gabriel is turns; [last cum dose]
		if Libido of Gabriel < 10:
			increase Libido of Gabriel by 1;
	else if calcnumber is 3: [reject him gently]
		LineBreak;
		say "     Smiling down into young-looking man's face, you meet his gaze and are pleased to see his worshipful expression as you praise him for taking your training to heart. He licks his lips as you say that you want him to be your little cum-slut bitch boy, caressing his cheek with your free hand and then giving him two fingers to suckle on for a little while. 'Mmmhmmm!' Gabriel hums happily around your digits in his mouth, and you can see his dick throbbing again, dripping more pre just from his eager desire to be with you. You allow him to slurp on your fingers a little, then eventually pull them back out of the angel's mouth, with him leaving it open and waiting for you to fill it again. Eyes raised in a hopeful expression, his expression falls as you then proceed to tell him that you're not in the mood to fuck his face right now. With a sob, he asks, 'Is - is there something wrong [master]? With me? Being not desirable for you enough? Please, I will do anything, and-'";
		say "     Stroking Gabriel's cheek, you gently shush him, telling the attractive and incredibly submissive hunk that he's just the pet you always wanted and that he shouldn't worry about it. Sometimes, the mood for enjoying intimacy with even the most amazing just isn't there, and you tell him that you'll keep him at the forefront of your mind when you feel like fucking a sweet little cum-slut again. Your words calm his distress and Gabriel nods to you while biting his lip, then says shyly, 'I'll be ready for when the time comes then, [master].' With that, he gets up from where he waited on his knees for you, gathering his blankets and trotting towards the bed that is his. The angel's wings droop a little from their usual straight and slightly raised position, showing that he's still sad about not getting any love or cum.";
	else if calcnumber is 4: [reject him harshly]
		LineBreak;
		say "     Giving the angel's hair a sharp tug that makes him wince in pain, you frown at him and demand that he tell you what the relationship between you two is. 'I - I'm yours, [master]. You claimed me with sex and I obey you!' he replies, at times hesitating and with a tremble in his voice. Huffing in disapproval, you go on to say that you didn't tell him to arrange this little pad and wait for you like this. He's supposed to serve, not to make decisions on his own after all! Paling visibly at your rejection, Gabriel opens his mouth a few times as if to say something, but can't bring out any words, so in the end he just looks down and sniffles. Waving a hand in a curt movement to dismiss him, you watch as he gathers up his blankets and trots towards the bed that is his. The angel's wings droop significantly further down than their usual straight and slightly raised position, showing that he's stricken and sad about your anger and not getting any sex or cum.";

after resting while ((Player is bunkered or Player is booked) and Player is male and Gabriel is in Bunker and Libido of Gabriel > 9 and Libido of Gabriel < 99 and Stamina of Gabriel - turns > 15): [everyone present, cum slut training stage 2, 2 days not fed]
	if Libido of Gabriel is 10: [first time]
		say "[FirstTimeGabrielSleepBJ]";
	else if Libido of Gabriel is 11: [allowed to suck player during sleep]
		say "     As you drift up from the depths of sleep, you become aware of a quite pleasurable sensation coursing through your body. Still shaking off last vestiges of dreams that melt away like fog in the sun, you move your hand towards the source of the slurping noises down at your crotch and soon feel the soft curls of Gabriel's long hair under your fingers. He's bobbing up and down on your shaft in an urgent tempo while massaging your balls, giving you a clear sign that your angelic cum-slut is desperate for your seed. Feeling a little lazy right now, you only open your eyes a tiny bit to allow them to get used to the light while just leaving your hand on Gabriel's head and letting him continue at his fast pace. It doesn't take all that long before your angelic slut's enthusiastic efforts drive you past the point of no return. Reflexively humping upwards, you force your whole length down his throat and blast the first big spurt of cum directly into his stomach.";
		say "     Gabriel quickly pulls back, keeping just your head between his lips to catch any following cum shots on his tongue, with whorish moans speaking of his pleasure in doing so. The well-tamed sex slave caresses your body and suckles on your cock until the last spurts of your orgasm have ebbed off, then pulls off your dick and gives its head a careful kiss. You push yourself up on your elbows to look at the ecstatic and oh so very naked male, who then opens his mouth to show the white froth of your seed and his spit, drawing strings in the air as he stretches his tongue out to show it to you. Without losing one drop, he demonstratively swallows your cum, then suddenly starts to twitch and tremble. Following the movement of his hands, you realize that he just came from being allowed to feed on your seed!";
		WaitLineBreak;
		say "     Gabriel is sure to catch his own load in the palm of his hand, both not to make a mess as well as enabling him to slurp the white spunk up with his tongue. He moans happily as he does so, though not as much as when he was feeding on the sperm of his [master]. You've definitively created a happy little cum-slut in your sex pet, and you caress him once again to express your pleasure about his progress before you start to get up. He happily fulfills the role as a servant too, bringing your clothes and gear up to you as you get dressed, all the while being very nice eye-candy as he nakedly moves around.";
		NPCSexAftermath Gabriel receives "OralCock" from Player;
		now Stamina of Gabriel is turns; [last cum dose]
	else if Libido of Gabriel is 12: [forbidden to suck the player during sleep, but desperate enough to do it anyways]
		say "     As you drift up from the depths of sleep, you become aware of a quite pleasurable sensation coursing through your body. Still shaking off last vestiges of dreams that melt away like fog in the sun, you move your hand towards the source of the slurping noises down at your crotch and soon feel the soft curls of Gabriel's long hair under your fingers. He's going down on you, even after you specifically told him not to do so in the future! The angelic cum-slut is bobbing up and down on your shaft in an urgent tempo while massaging your balls, giving you a clear sign that your angelic cum-slut is desperate for your seed. Annoyance pushes aside the arousal burning in your veins and you grab a handful of your sex-pet's hair to wrench him away from your erection. Pushing yourself up into a half-sitting position and freezing Gabriel in motion with a wordless stare, your eyebrows draw together, followed by one of them rising in a demand for an explanation.";
		say "     '[Master]! Please, please forgive me,' the seraphim wails, tears starting to well up in his eyes. 'I was weak, the hunger for your sweet nectar just became too powerful! Punish me as you will later, but could you find it in your heart to give me your seed? I feel empty without it!' Bringing his hands together in front of himself, Gabriel is now literally begging for you to shoot a load down his throat.";
		LineBreak;
		say "     [bold type]How do you react?[roman type][line break]";
		say "     [link](1)[as]1[end link] - Indulge him, and let him sate his need likewise in the future. It's not like waking up to a blowjob isn't fun.";
		say "     [link](2)[as]2[end link] - Scold him not to do so again, but allow him this taste of your cum.";
		say "     [link](3)[as]3[end link] - Punish Gabriel and forbid doing this, now and in the future.";
		now calcnumber is 0;
		while calcnumber < 1 or calcnumber > 3:
			say "Choice? (1-3)>[run paragraph on]";
			get a number;
			if calcnumber is 1 or calcnumber is 2 or calcnumber is 3:
				break;
			else:
				say "Invalid choice. Type [link]1[end link] to get morning blowjobs, [link]2[end link] to discourage morning blowjobs or [link]3[end link] to forbid morning blowjobs.";
		if calcnumber is 1: [allow]
			LineBreak;
			say "     Grabbing a handful of his brown curls, you give them a sharp tug and remind Gabriel that he's your sex-pet and shouldn't get used to having ideas of his own. He gulps and whimpers apologetically, with an earnest expression on his face. Still as you expect that he'll be unable to control himself in the future, being the cum-slut that you made him into, you wait a moment longer for the lesson to sink in, then finally relent and tell him that he may wake you up in the future, like he did today. Something about his happy smile tells you that he'll likely do it every day, unless you give him his daily dose of creamy seed some other way first. Having given your command, you nod for the angelic slut to continue and then lay back with your hands behind your head. Gabriel immediately gets back to the frantic bobbing from earlier, slurping on your shaft and letting out needy groans as he goes down on you. His hands move to caress your thighs and cup your balls at the same time, quickly inflaming the still sizzling fires of your lust.";
			say "     It doesn't take all that long before your angelic slut's enthusiastic efforts drive you past the point of no return. Reflexively humping upwards, you force your whole length down his throat and blast the first big spurt of cum directly into his stomach. Then he pulls back, keeping just your head between his lips to catch any following cum shots on his tongue, with whorish moans speaking of his pleasure in doing so. The well-tamed sex slave caresses your body and suckles on your cock until the last spurts of your orgasm have ebbed off, then pulls off your dick and gives its head a careful kiss. You push yourself up on your elbows to look at the ecstatic male, who then opens his mouth to show the white froth of your seed and his spit, drawing strings in the air as he stretches his tongue out to show it to you. Without losing one drop, he demonstratively swallows your cum, then suddenly starts to twitch and tremble. Following the movement of his hands, you realize that he just came from being allowed to feed on your seed!";
			WaitLineBreak;
			say "     Gabriel is sure to catch his own load in the palm of his hand, both not to make a mess as well as enabling him to slurp the white spunk up with his tongue. He moans happily as he does so, though not as much as when he was feeding on the sperm of his [master]. You've definitively created a happy little cum-slut in your sex pet, and you caress him once again to express your pleasure about his progress before you start to get up. He happily fulfills the role as a servant too, bringing your clothes and gear up to you as you get dressed, all the while being very nice eye-candy as he nakedly moves around.";
			NPCSexAftermath Gabriel receives "OralCock" from Player;
			now Stamina of Gabriel is turns; [last cum dose]
			now Libido of Gabriel is 11; [sleep sucking allowed]
		else if calcnumber is 2: [scold]
			LineBreak;
			say "     Grabbing a handful of his brown curls, you give them a sharp tug and remind Gabriel that he's your sex-pet and shouldn't get used to having ideas of his own. He gulps and whimpers apologetically, nodding as you tell him that unasked-for blowjobs are not allowed in the future. He seems ready to beat a hasty retreat from his less than amused [master], but you keep your hold of him and add that you actually do want to make use of him right now. With that said, you plant both hands on the young-looking man's head and jerk it down against your crotch, burying your [cock of Player] shaft in his mouth. Happy to get back to sucking on your dick, the cum-slut takes all of your length readily, slurping on your shaft and letting out pleased little grunts as you guide him to bob on your cock. His hands move to caress your thighs and cup your balls while he goes down on you, quickly inflaming the still sizzling fires of your lust.";
			say "     It doesn't take all that long before your angelic slut's enthusiastic efforts drive you past the point of no return and you push his head down forcefully to take in the whole length of your cock, blasting spurt after spurt of cum down his throat. Gabriel tries to pull back a little to taste your seed on his tongue, but you just hold firm and gruffly explain that this isn't supposed to be fun for him, just taking care of the problem he created. You can feel his Adam's apple bobbing in his disappointment of not even getting a little of your cum. When your orgasm has run its course, you withdraw from his mouth in a swift pull, leaving his sucking lips with a plop. Then you shove him to the side and start to get dressed, preparing yourself for another day of surviving in the city.";
			NPCSexAftermath Gabriel receives "OralCock" from Player;
			now Stamina of Gabriel is turns; [last cum dose]
			now Libido of Gabriel is 12; [sleep sucking forbidden]
		else if calcnumber is 3: [forbid]
			LineBreak;
			say "     Grabbing a handful of his brown curls, you wrench the tamed angel back from your cock and give him a stern talking-to. With him soon being almost in tears, you declare that he will not be getting what he wanted because of his disobedience. Instead, you keep a tight grip on his hair and jerk off, quickly pushing yourself over the edge and blasting cum all over his glorious curls to give him a somewhat patchy appearance. With a dire warning that he may not remove the cum until it's well and truly dried, you send him scurrying away.";
			now Libido of Gabriel is 12; [sleep sucking forbidden]
	NPCSexAftermath Gabriel receives "OralCock" from Player;
	now Stamina of Gabriel is turns; [last cum dose]

after resting while ((Player is bunkered or Player is booked) and Player is male and Gabriel is bunkered and Libido of Gabriel > 9 and Libido of Gabriel < 12 and Stamina of Gabriel - turns > 7): [everyone present, cum slut training stage 2, 1 day not fed]
	if Libido of Gabriel is 10: [first time]
		say "[FirstTimeGabrielSleepBJ]";
	else if Libido of Gabriel is 11: [allowed to suck player during sleep]
		say "     As you drift up from the depths of sleep, you become aware of a quite pleasurable sensation coursing through your body. Still shaking off last vestiges of dreams that melt away like fog in the sun, you move your hand towards the source of the slurping noises down at your crotch and soon feel the soft curls of Gabriel's long hair under your fingers. He's bobbing up and down on your shaft in a steady rhythm, from time to time pulling off to let his tongue wander up the side of your shaft, tease the head of your dick around the rim or lap at your balls. Your angelic cum-slut is apparently hungry for your seed, but also wants to please his [master] as well as he can. Feeling a little lazy right now, you only open your eyes a tiny bit to allow them to get used to the light while just leaving your hand on Gabriel's head and giving him caressing pats as he continues at his own pace. Even so, it doesn't take all that long before your angelic slut's quite enthusiastic efforts drive you past the point of no return. Reflexively humping upwards, you force your whole length down his throat and blast the first big spurt of cum directly into his stomach.";
		say "     Gabriel quickly pulls back, keeping just your head between his lips to catch any following cum shots on his tongue, with whorish moans speaking of his pleasure in doing so. The well-tamed sex slave caresses your body and suckles on your cock until the last spurts of your orgasm have ebbed off, then pulls off your dick and gives its head a careful kiss. You push yourself up on your elbows to look at the ecstatic and oh so very naked male, who then opens his mouth to show the white froth of your seed and his spit, drawing strings in the air as he stretches his tongue out to show it to you. Without losing one drop, he demonstratively swallows your cum, then suddenly starts to twitch and tremble. Following the movement of his hands, you realize that he just came from being allowed to feed on your seed!";
		WaitLineBreak;
		say "     Gabriel is sure to catch his own load in the palm of his hand, both not to make a mess as well as enabling him to slurp the white spunk up with his tongue. He moans happily as he does so, though not as much as when he was feeding on the sperm of his [master]. You've definitively created a happy little cum-slut in your sex pet, and you caress him once again to express your pleasure about his progress before you start to get up. He happily fulfills the role as a servant too, bringing your clothes and gear up to you as you get dressed, all the while being very nice eye-candy as he nakedly moves around.";
		NPCSexAftermath Gabriel receives "OralCock" from Player;
		now Stamina of Gabriel is turns; [last cum dose]
	NPCSexAftermath Gabriel receives "OralCock" from Player;
	now Stamina of Gabriel is turns; [last cum dose]

to say FirstTimeGabrielSleepBJ:
	say "     As you drift up from the depths of sleep, you become aware of a quite pleasurable sensation coursing through your body. Still shaking off last vestiges of dreams that melt away like fog in the sun, you don't understand at first why you're so horny right now, until you hear a slurping nose coming from the area of your crotch. Blinking open eyes that take a moment to adapt to the light, you glance down and see a head bobbing up and down on your erect cock. It is framed in long hair with brown curls that brushes over your skin with sensual softness every time the person goes down on you. Recognizing the source of your surprise blowjob as a fully naked Gabriel isn't hard, even before you bring your hands to rest on his head and pull it up to look him in the eyes. Panting in needy arousal, the tamed seraphim licks his lips as he shyly meets your gaze, then hastily tries to explain: '[Master], I - I wanted to give you an especially pleasant waking experience.'";
	say "     Something makes you feel there is more to it than that, so you just continue to stare at him, raising an eyebrow expectantly. Gabriel's alabaster skin flushes a little as he realizes he's been caught out in not giving you the whole truth, followed by him pleadingly adding, 'I - oh, forgive me, please! In truth, I just couldn't resist any longer. The craving! I just can't! I need your cum! It's been so long since you gave it to me!' His frantic breath washes over the spit-slickened shaft of your cock as your enslaved angel looks down in shame, or just possibly hunger, at your erect cock. Seems like your cumslut training is having the intended effect on Gabriel. The only question is if you want to allow him this level of autonomy, with him just choosing to suck you off on his own accord.";
	LineBreak;
	say "     [bold type]How do you react?[roman type][line break]";
	say "     [link](1)[as]1[end link] - Allow it. He's pleasing you quite nicely actually.";
	say "     [link](2)[as]2[end link] - Scold him not to do so again. Well, after getting you off this time.";
	say "     [link](3)[as]3[end link] - Punish Gabriel and forbid doing this, now and in the future.";
	now calcnumber is 0;
	while calcnumber < 1 or calcnumber > 3:
		say "Choice? (1-3)>[run paragraph on]";
		get a number;
		if calcnumber is 1 or calcnumber is 2 or calcnumber is 3:
			break;
		else:
			say "Invalid choice. Type [link]1[end link] to get morning blowjobs, [link]2[end link] to discourage morning blowjobs or [link]3[end link] to forbid morning blowjobs.";
	if calcnumber is 1: [allow]
		LineBreak;
		say "     Running your hands through the soft, brown curls of Gabriel's hair, you caress him possessively and praise him for anticipating his [master]'s desires. That he's craving regular cum is exactly what you had planned for your obedient sex pet after all. He looks ecstatic at your touch and relieved that you understand his needs, more moaning than saying, 'Anything for you, [master]!' With you having decided to be generous with him, you expressly give him permission to wake you up just like he did today. Something about his happy smile tells you that he'll likely do it every day, unless you give him his daily dose of creamy seed some other way first. Having given your command, you nod for the angelic slut to continue and then lay back with your hands behind your head. Gabriel very happily gets back to the gentle sucking from earlier, slurping on your shaft and letting out pleased little grunts as he bobs up and down on it. His hands move to caress your thighs and cup your balls while he goes down on you, quickly inflaming the still sizzling fires of your lust.";
		say "     It doesn't take all that long before your angelic slut's enthusiastic efforts drive you past the point of no return. Reflexively humping upwards, you force your whole length down his throat and blast the first big spurt of cum directly into his stomach. Then he pulls back, keeping just your head between his lips to catch any following cum shots on his tongue, with whorish moans speaking of his pleasure in doing so. The well-tamed sex slave caresses your body and suckles on your cock until the last spurts of your orgasm have ebbed off, then pulls off your dick and gives its head a careful kiss. You push yourself up on your elbows to look at the ecstatic male, who then opens his mouth to show the white froth of your seed and his spit, drawing strings in the air as he stretches his tongue out to show it to you. Without losing one drop, he demonstratively swallows your cum, then suddenly starts to twitch and tremble. Following the movement of his hands, you realize that he just came from being allowed to feed on your seed!";
		WaitLineBreak;
		say "     Gabriel is sure to catch his own load in the palm of his hand, both not to make a mess as well as enabling him to slurp the white spunk up with his tongue. He moans happily as he does so, though not as much as when he was feeding on the sperm of his [master]. You've definitively created a happy little cum-slut in your sex pet, and you caress him once again to express your pleasure about his progress before you start to get up. He happily fulfills the role as a servant too, bringing your clothes and gear up to you as you get dressed, all the while being very nice eye-candy as he nakedly moves around.";
		NPCSexAftermath Gabriel receives "OralCock" from Player;
		now Stamina of Gabriel is turns; [last cum dose]
		now Libido of Gabriel is 11; [sleep sucking allowed]
	else if calcnumber is 2: [scold]
		LineBreak;
		say "     Grabbing a handful of his brown curls, you give them a sharp tug and remind Gabriel that he's your sex-pet and shouldn't get used to having ideas of his own. He gulps and whimpers apologetically, nodding as you tell him that unasked-for blowjobs are not allowed in the future. He seems ready to beat a hasty retreat from his less than amused [master], but you keep your hold of him and add that you actually do want to make use of him right now. With that said, you plant both hands on the young-looking man's head and jerk it down against your crotch, burying your [cock of Player] shaft in his mouth. Happy to get back to sucking on your dick, the cum-slut takes all of your length readily, slurping on your shaft and letting out pleased little grunts as you guide him to bob on your cock. His hands move to caress your thighs and cup your balls while he goes down on you, quickly inflaming the still sizzling fires of your lust.";
		say "     It doesn't take all that long before your angelic slut's enthusiastic efforts drive you past the point of no return and you push his head down forcefully to take in the whole length of your cock, blasting spurt after spurt of cum down his throat. Gabriel tries to pull back a little to taste your seed on his tongue, but you just hold firm and gruffly explain that this isn't supposed to be fun for him, just taking care of the problem he created. You can feel his Adam's apple bobbing in his disappointment of not even getting a little of your cum. When your orgasm has run its course, you withdraw from his mouth in a swift pull, leaving his sucking lips with a plop. Then you shove him to the side and start to get dressed, preparing yourself for another day of surviving in the city.";
		NPCSexAftermath Gabriel receives "OralCock" from Player;
		now Stamina of Gabriel is turns; [last cum dose]
		now Libido of Gabriel is 12; [sleep sucking forbidden]
	else if calcnumber is 3: [forbid]
		LineBreak;
		say "     Grabbing a handful of his brown curls, you wrench the tamed angel back from your cock and give him a stern talking-to. With him soon being almost in tears, you declare that he will not be getting what he wanted because of his disobedience. Instead, you keep a tight grip on his hair and jerk off, quickly pushing yourself over the edge and blasting cum all over his glorious curls to give him a somewhat patchy appearance. With a dire warning that he may not remove the cum until it's well and truly dried, you send him scurrying away.";
		now Libido of Gabriel is 12; [sleep sucking forbidden]

after of going to Bunker while (David is bunkered and Gabriel is bunkered and Charisma of Gabriel is 0):
	if debugactive is 1:
		say "     DEBUG: David/Gabriel Talk Walkin[line break]";
	say "     As you enter the bunker, you see David and Gabriel stand not too far away, next to one of the side walls of the underground refuge. They're talking, with the male soldier's back turned your way and you overhear David say, 'Wait, you mean -?' 'Yes, I'm the [master]'s servant. Before, I was someone else, something else. [SubjectProCap of Player] fought and won against me, held me down and changed me. Now I belong to [ObjectPro of Player].' Gabriel pats the leather restraint cuffs resting around his wrists, then lowers his hands to rest just above his crotch as he bends his head. 'B-but that's slavery! No one can own other people!' David replies in a shocked tone, only to find the angel reaching out to cover his mouth with a gentle touch of his fingers. 'My kind was made to serve, to follow the grand plan to perfection. But how could I do so after having been changed? Impure thoughts in my head and the urges of this new flesh between my legs, they mark me as an abomination. I bear the mark of the [master], so now I serve [ObjectPro of Player].'";
	say "     David gapes at the convoluted logic that Gabriel just laid out, unsure what to say. The silence is filled by Gabriel a few heartbeats later, who switches topics to submissively ask, 'You are a guest of the [master] here, are you not? Shall I service you too?' The tame angel's gaze flicks over to meet your own as he does so, while David bursts out with, 'WHAT? No, wait! What brought this on? I-I'm not demanding that you do anything!' Forgetting his argument about slavery to tightly grab the seraphim's hand as it moves forward to brush against his crotch, the confused soldier bends Gabriel's arm to the side hastily, then freezes in motion as he realizes he's manhandling the angel.";
	LineBreak;
	say "     [bold type]How do you react?[roman type][line break]";
	say "     [link](1)[as]1[end link] - Give Gabriel a commanding nod and mime a blowjob.";
	say "     [link](2)[as]2[end link] - Loudly clear your throat and 'Catch' David with his hands on Gabriel.";
	say "     [link](3)[as]3[end link] - Just stand back and see how the man gets himself out of the situation.";
	now calcnumber is 0;
	while calcnumber < 1 or calcnumber > 3:
		say "Choice? (1-3)>[run paragraph on]";
		get a number;
		if calcnumber is 1 or calcnumber is 2 or calcnumber is 3:
			break;
		else:
			say "Invalid choice. Type [link]1[end link] to make Gabriel blow David, [link]2[end link] to 'catch' David with his hands on Gabriel or [link]3[end link] to stand back and watch.";
	if calcnumber is 1: [BJ]
		LineBreak;
		say "     Giving your angelic cock-slut a meaningful look, you point your finger at him, then down to the ground and mime him sucking a cock. A simple little nod tells you that your command has been understood and Gabriel gently extracts himself from David's grasp, then sinks to his knees before the man. 'I live to please,' he coos softly as he looks up at David, hands working on the button and zipper of his pants. 'W-wait,' the soldier protests weakly, yet doesn't do anything beyond that to prevent Gabriel from pulling out his cock. The next thing coming out of his mouth is a soft moan as the angel licks over his dickhead, followed by engulfing the shaft with his lips. David relents to just placing his hands on Gabriel's head, running his hands through his hair as the other male goes down on him expertly, lips and tongue creating intensely pleasurable sensations for the standing soldier.";
		say "     'Fuuck, that's good,' David groans out as he is serviced by Gabriel, with the angel eagerly bobbing on his cock. Your sex pet gives him the very best attention he can muster, showing off some tricks with his tongue that he learned since you broke him in for sex. Given such exceptional service from a being totally focused on the pleasure of his partner, it doesn't take all that long for David to be brought to the brink of orgasm. 'I'm pretty close! You might wanna pull off now!' the panting soldier grunts out, yet Gabriel just continues with his motions, maybe even sucking a bit harder than before. Then the point of no return is reached, with David letting out a masculine grunt as his hips hump forward, grinding his dick into Gabriel's throat and burying the angel's nose in his pubes. The first few spurts of cum shoot right down into Gabriel's stomach, followed by him pulling back to catch anything after that on his tongue.";
		WaitLineBreak;
		say "     After the soldier's orgasm has run its course, your angelic pet swishes the man's load around in his mouth for a second, then swallows it demonstratively, showing off his clean tongue afterwards. David stares down at him with wide eyes for a few seconds, then says under his breath, 'Damn, that was something else. You've got skills, Gabe!' Still licking his lips, Gabriel rises to his feet and replies, 'Thank you for the kind words. If I can serve you in any way, just ask,' Gabriel tells his new friend happily. With the words, 'Sure. I - I gotta go. See ya later,' the soldier then hurries off, maybe to make sense of what just happened between them.";
		say "     Watching the soldier go, you wave Gabriel over to yourself and take him to one of the side rooms for a private chat. The beautiful angel you've turned into your private sex toy obeys immediately, coming to stand in front of you at attention. Looking into those innocent eyes, you reach out to run a hand up and down his toned chest while you think about what you want to tell him about his future interactions with David.";
		say "[GabrielDavidInteractionChoice]";
		now Charisma of Gabriel is 10; [player made Gabriel suck off David]
	else if calcnumber is 2: [catch]
		LineBreak;
		say "     Hearing you close behind him without any warning makes David flinch and whirl around in shock, which creates a bit of a tangle as he still is holding on to Gabriel's arm. Shocked embarrassment colors his face red as the two of them almost fall over and only catch themselves by clutching on to each other and Gabriel giving a frantic beat or two of his wings. 'Er, I- we were just talking. This isn't what it looks like.' A smirk plays over your features as you give him a knowing nod, then glance down to where David's hand is holding on to Gabriel's thigh. His blush deepening, the soldier extracts himself from the all too intimate touching, then rushes off with the words, 'I got to go!'";
		say "     Watching the soldier go, you wave Gabriel over to yourself and take him to one of the side rooms for a private chat. The beautiful angel you've turned into your private sex toy obeys immediately, coming to stand in front of you at attention. Looking into those innocent eyes, you reach out to run a hand up and down his toned chest while you think about what you want to tell him about his future interactions with David.";
		say "[GabrielDavidInteractionChoice]";
		now Charisma of Gabriel is 30; [David ran off after the player 'caught' him touching Gabriel]
	else if calcnumber is 3: [watch]
		LineBreak;
		say "     'S-sorry, I didn't mean to grab you that hard! You just surprised me,' David bursts out and snatches his hand away as if it was touching a hot stove. Gabriel's expression falls and his wings droop behind his back, followed by the question, 'Am I unappealing for the [master]'s guest that touching me repulses him?' He seems to have internalized his role as your subby sex pet far enough that the rejection actually starts tears welling up in his eyes. 'No, no, no! That's not what I meant,' comes the hasty reply from the soldier, who grabs Gabriel's upper arms in a lighter touch this time and tries to make him stand up straight again. As a first tear starts to trickle down the flawless alabaster face of the angel, David quickly wipes it away with a finger and pants out, 'You're a very beautiful man, it's just that-' His next words are stilled as Gabriel acts on one of the impulses that boils up inside him, leaning forward to kiss the human soldier on the mouth.";
		say "     Soft lips brush against each other, seemingly unloading all the tension that built up between the two men, and the moment seems to stretch on and on. It goes so far that David's raised hand moves to cradle the back of Gabriel's head, buried in his soft brown curls as the two of them share share each other's breath. Then time seems to re-start and they pull apart, with Gabriel smiling at the soldier and David replying in kind. 'Thank you for the kind words. If I can serve you in any way, just ask,' Gabriel tells his new friend happily. With the words, 'Sure. I - I gotta go. See ya later,' the soldier then hurries off, maybe to make sense of what just happened between them.";
		WaitLineBreak;
		say "     Watching the soldier go, you wave Gabriel over to yourself and take him to one of the side rooms for a private chat. The beautiful angel you've turned into your private sex toy obeys immediately, coming to stand in front of you at attention. Looking into those innocent eyes, you reach out to run a hand up and down his toned chest while you think about what you want to tell him about his future interactions with David.";
		say "[GabrielDavidInteractionChoice]";
		now Charisma of Gabriel is 50; [David and Gabriel kissed without player intervention]

to say GabrielDavidInteractionChoice:
	LineBreak;
	say "     [bold type]What are your commands in regards to Gabriel and David's relationship?[roman type][line break]";
	say "     [link](1)[as]1[end link] - He's free to befriend David, up to and including sex.";
	say "     [link](2)[as]2[end link] - He can befriend David, but must not let the man touch him.";
	say "     [link](3)[as]3[end link] - You want him to be nothing but a slut. He can have sex with David, but isn't allowed to hang out otherwise.";
	say "     [link](4)[as]4[end link] - Forbid him to interact with David at all.";
	now calcnumber is 0;
	while calcnumber < 1 or calcnumber > 4:
		say "Choice? (1-4)>[run paragraph on]";
		get a number;
		if calcnumber is 1 or calcnumber is 2 or calcnumber is 3 or calcnumber is 4:
			break;
		else:
			say "Invalid choice. Type [link]1[end link] to let Gabriel befriend and fuck David, [link]2[end link] to let Gabriel befriend David, [link]3[end link] to let him fuck around with David or [link]4[end link] to forbid them to interact.";
	if calcnumber is 1:
		say "     Reaching out to caress Gabriel's cheek and smiling at the angel, you tell him that he may hang out with David and be friendly with him. Or fuck around with him, like the good little sex pet you made him into. A happy little smile plays over his flawless features, leading over into Gabriel coyly biting his lower lip as he imagines doing more than just hang out with David. And even if he doesn't, the young-looking man clearly has some hope of having a friend to keep him company in the quiet hours down here in the bunker while you're out. 'Thank you, [master]! Thank you so much,' he says in an upbeat tone, then stretches his arms out to give you a hug. In the generous mood you are in, you let him do it and squeeze him right back, though not without groping the sexy hunk a little at least. As you go back into the main room of the bunker with him afterwards, he walks with a happy little spring in his step.";
		now Intelligence of Gabriel is 1; [everything goes]
	else if calcnumber is 2:
		say "     Reaching out to caress Gabriel's cheek and smiling at the angel, you tell him that he may hang out with David and be friendly with him. Nothing more though, as he's your sex pet and you're the one who decides when he gets fucked. A happy little smile plays over his flawless features at the hope of having a friend to keep him company in the quiet hours down here in the bunker while you're out. 'Thank you, [master]! Thank you so much,' he says in an upbeat tone, then stretches his arms out to give you a hug. In the generous mood you are in, you let him do it and squeeze him right back, though not without groping the sexy hunk a little at least. As you go back into the main room of the bunker with him afterwards, he walks with a happy little spring in his step.";
		now Intelligence of Gabriel is 21; [friendship only]
	else if calcnumber is 3:
		say "     Lowering your hand to cup Gabriel's crotch and giving it a squeeze, you smirk at the angel and tell him that you want him to be a slutty sex pet in all his interactions with David. They shouldn't hang out with each other though, unless it involves him getting his face or ass pounded by a hard dick. The seraphim takes in a shallow breath, letting out a quiet moan as he imagines himself being used that way, but the look in his eyes speaks of sadness as he nods to you. 'Of course, [master]. By your command,' he says quietly, then slinks out of the room back into the main chamber of the bunker, his wings drooping a bit. You follow after him closely.";
		now Intelligence of Gabriel is 41; [sex only]
	else if calcnumber is 4:
		say "     Putting on a stern expression, you tell Gabriel that he's forbidden from talking to David, or doing anything physically with him. The seraphim looks at you with sad eyes, then takes a slow breath and presses his lips together. 'Of course, [master]. By your command,' he says quietly, then slinks out of the room back into the main chamber of the bunker, his wings drooping a bit. You follow after him closely.";
		now Intelligence of Gabriel is 99; [interaction forbidden]


after of going to Bunker while (David is bunkered and (Charisma of Gabriel is 10 or Charisma of Gabriel is 30 or Charisma of Gabriel is 50)): [he needs to talk about Gabriel]
	if debugactive is 1:
		say "     DEBUG: David/Gabriel Talk Walkin Aftermath[line break]";
	say "[DavidGabrielTalkAftermath]";

after of going to Parade Ground while (David is in Parade Ground and (Charisma of Gabriel is 10 or Charisma of Gabriel is 30 or Charisma of Gabriel is 50)): [he needs to talk about Gabriel]
	if debugactive is 1:
		say "     DEBUG: David/Gabriel Talk Walkin Aftermath[line break]";
	say "[DavidGabrielTalkAftermath]";

to say DavidGabrielTalkAftermath:
	project the figure of David_clothed_icon;
	if Charisma of Gabriel is 10:
		say "     As you approach David, a serious expression crosses his face and he clears his throat. 'Listen, I think we need to talk about Gabriel. I had a word with him and -' he pauses for a second there, blushing as he thinks back to the blowjob you arranged to follow that discussion, then continues to say, 'And he said you... did things to him. Is that true?'";
	else if Charisma of Gabriel is 30:
		say "     As you approach David, a serious expression crosses his face and he clears his throat. 'Listen, I think we need to talk about Gabriel. I had a word with him and -' he pauses for a second as he remembers the embarrassing scene of you 'catching' him with an arm on the arm of a flirtatious Gabriel, then continues to say, 'And he said you... did things to him. Is that true?'";
	else if Charisma of Gabriel is 50:
		say "     As you approach David, a serious expression crosses his face and he clears his throat. 'Listen, I think we need to talk about Gabriel. I had a word with him and -' he pauses for a second as he remembers the kiss between him and Gabriel that ended the discussion, then continues to say, 'And he said you... did things to him. Is that true?'";
	LineBreak;
	say "     [bold type]What do you reply?[roman type][line break]";
	say "     [link](1)[as]1[end link] - Just lay it out bluntly: You fought Gabriel, fucked him and took him as your sex pet.";
	say "     [link](2)[as]2[end link] - Give David a 'softened' version of how you came to be Gabriel's master.";
	say "     [link](3)[as]3[end link] - Reject any blame for Gabriel's mental state and say you just took him in.";
	now calcnumber is 0;
	while calcnumber < 1 or calcnumber > 3:
		say "Choice? (1-3)>[run paragraph on]";
		get a number;
		if calcnumber is 1 or calcnumber is 2 or calcnumber is 3:
			break;
		else:
			say "Invalid choice. Type [link]1[end link] to tell the truth, [link]2[end link] to lie a moderate amount or [link]3[end link] to lie a lot.";
	if calcnumber is 1:
		say "     With a shrug, you begin laying out the facts for David: You ran into Gabriel in the Red Light District, with him being quite confrontative from the start. Things escalated in short order and you fought him and won. Then when he was on his knees, beaten and weak, you took the opportunity to enjoy yourself with him, which had some physical and mental effects. This went on for several clashes between the two of you, until you finally had enough and put a collar on him. Now he's your sex pet, and you certainly enjoy his services while having one less dangerous enemy roaming around that is after you.";
		say "     David frowns at the reality of Gabriel's fate that you explain to him, his eyebrows drawing together as you get to having sex with the defeated angel and then pushing him into servitude. As you finish, he takes a deep breath, then lets it out slowly, finally shaking his head as if to clear it. 'That's pretty fucked up, if I have to be honest. Horrible, what this plage makes people do. It just worms its way into your head, isn't that right?' David says, then looks at you questioningly, to which you sway your head in a half-nod, not commenting any further on it. 'I know you're a good person, having saved me from a gruesome fate in the hands of that demon, so please, try to fight your impulses! As for Gabriel, I fear what's done is done, isn't it? Maybe therapy or something after all of this will help him. I'll try to be a friend to him in the meantime.' With nothing more to say for now, David walks some distance away from you, a thoughtful expression on his face. [bold type]You're quite sure he'll reject any sexual matters concerning Gabriel from now on.[roman type][line break]";
		now Charisma of Gabriel is 70; [David will no longer participate in sex with Gabriel, might become a friend though]
	else if calcnumber is 2:
		say "     Putting a consoling hand on David's arm, you clear your throat and begin an only somewhat made-up tale: You ran into Gabriel in the Red Light District, and like so many creatures roaming around, he was hostile and attacked. With litlte choice but to defend yourself - several times too - you fought him off and won, and in doing so all of the lust and sex out there just got to you in the end. You somewhat shame-facedly admit that you fucked around with the angel after beating him off, and that this caused him to glomp onto you as his absolute lord and master. All of his former aggressiveness and fight just went out of him after that, so you had little choice but to take him in. With Gabriel being so obsessed about his [master], you thought it best to indulge him in his fantasy.";
		say "     David frowns at the reality of Gabriel's fate that you explain to him, pressing his lips together as you get to succumbing into having sex with the defeated angel and the way that made Gabriel see you afterwards. As you finish, he takes a deep breath, then lets it out slowly, finally shaking his head as if to clear it. 'The reality of how this plage messes with people's heads just makes me cringe sometimes. Both in your case, as well as Gabriel's. Do you think he can be cured somehow?' In a serious tone, you tell him that you really hope it'll be possible once all of you get out of here. Therapy can work wonders and all that. But for now, it might be best to not complicate matters with Gabriel any further. He's stable in his assumed role as your servant, so everyone should treat him accordingly and not give him any undue stress by contradicting it. 'Oh. Ooooh,' David says, his eyes widening a bit as he takes in the thought, possibly applying it to yourself too in the privacy of his mind. He puts an earnest expression on his face, then nods, 'Okay, if that's how it must go, I will do my best to play along.'";
		say "[DavidGabrielTalkAftermath2]";
	else if calcnumber is 3:
		say "     Pressing your lips together and shaking your head, you let out an artfully delivered sigh and give David's arm a consoling squeeze. Then you lay it on thick: You don't really know what happened to Gabriel out in the wild streets, but you ran into him in the state he is now, sexually abused and still dripping with cum all over him. Bending over the unconscious man lying in the street, you checked on him, which is when he opened his eyes and focused on you with an unhinged expression on his face. Kinda like imprinting with animal babies, suddenly you were his master in Gabriel's mind and he kept begging for your orders. He didn't seem capable of surviving out in the streets on his own, so you took him in for his own good. Faking embarrassment, you admit that you even had to indulge his fantasies physically since Gabriel is just so obsessed about serving his [master].";
		say "     David eats up your words, getting a bit pale as you paint a picture of Gabriel's mind shattering under his previous experiences. 'I - oh god, that is horrible! Do you think he can be cured somehow?' In a serious tone, you tell him that you really hope it'll be possible once all of you get out of here. Therapy can work wonders and all that. But for now, it's best to not complicate matters with Gabriel any further. He's stable in his assumed role as your servant, so everyone should treat him accordingly and not give him any undue stress by contradicting it. Doing an fairly good job in spinning this web of lies, you get David so far that he quietly nods and promises, 'Okay, if that's how it must go, I will do my best to play along.' He gulps as he says this, but then presses his lips together and puts a determined look on his face.";
		say "[DavidGabrielTalkAftermath2]";

to say DavidGabrielTalkAftermath2:
	WaitLineBreak;
	say "     Clearing his throat after staring into space for a moment, David turns back to you. 'Listen, since we're lying everything on the table about Gabriel right now, I got to bring up that ";
	if Charisma of Gabriel is 10: [BJ]
		say "he did give me a blowjob. Just sprung it on me, all of a sudden, and I - I couldn't resist. Didn't resist. Does that make me a horrible person? I'm contributing to him slipping deeper into his sex slave role! [if thirst of David is 20 and Libido of David > 68 and Libido of David < 91]And I cheated on both Brutus and you with him too!' [else if thirst of David is 20]And I cheated with him on you too!' [else if Libido of David > 68 and Libido of David < 91]And I cheated with him on Brutus too!' [else]And I cheated with him on my girlfriend.' [end if][line break]";
		LineBreak;
		say "     [bold type]What do you tell David in response?[roman type][line break]";
		say "     ([link]Y[as]y[end link]) - Gabriel internalized his sex slave role completely. David should indulge him to not distress the poor angel.";
		say "     ([link]N[as]n[end link]) - Maybe he should just be a platonic friend to Gabriel. That'll be the best for everyone.";
		if Player consents: [encourage a relationship beyond friends]
			LineBreak;
			say "     David looks at you thoughtfully as you explain that from your viewpoint, it might just be best to indulge Gabriel's urges and ideas of serving others. At least David can be a friend as well as a source for pleasure to Gabriel, much better than if the angel got rejected walked out of the library in confusion, to end up who knows where. As for the 'cheating', that's not really applicable with all of the madness that rules the city these days. People do what they must and everyone will surely understand in the end.";
			now Charisma of Gabriel is 11; [talked after the BJ, encouraged it]
		else:
			LineBreak;
			say "     David looks at you thoughtfully as you explain that from your viewpoint, it might be best if he kept things platonic from now on. Having a friend to rely on might be just what Gabriel needs. As for the 'cheating', that's not really applicable with all of the madness that rules the city these days. People do what they must and everyone will surely understand in the end.";
			now Charisma of Gabriel is 70; [David will no longer participate in sex with Gabriel, might become a friend though]
	else if Charisma of Gabriel is 30: [almost BJ]
		say "he was kinda coming on to me when you walked in on us. Kinda innocent but also lusty. And I think I wouldn't have resisted much longer. Does that make me a horrible person? I'm contributing to him slipping deeper into his sex slave role! [if thirst of David is 20 and Libido of David > 68 and Libido of David < 91]And I almost cheated on both Brutus and you with him too!' [else if thirst of David is 20]And I almost cheated with him on you too!' [else if Libido of David > 68 and Libido of David < 91]And I almost cheated with him on Brutus too!' [else]And I almost cheated with him on my girlfriend.' [end if][line break]";
		LineBreak;
		say "     [bold type]What do you tell David in response?[roman type][line break]";
		say "     ([link]Y[as]y[end link]) - Gabriel internalized his sex slave role completely. David should indulge him to not distress the poor angel.";
		say "     ([link]N[as]n[end link]) - Maybe he should just be a platonic friend to Gabriel. That'll be the best for everyone.";
		if Player consents: [encourage a relationship beyond friends]
			LineBreak;
			say "     David looks at you thoughtfully as you explain that from your viewpoint, it might just be best to indulge Gabriel's urges and ideas of serving others. At least David can be a friend as well as a source for pleasure to Gabriel, much better than if the angel got rejected walked out of the library in confusion, to end up who knows where. As for the 'cheating', that's not really applicable with all of the madness that rules the city these days. People do what they must and everyone will surely understand in the end.";
			now Charisma of Gabriel is 31; [talked after the flirting, encouraged it]
		else:
			LineBreak;
			say "     David looks at you thoughtfully as you explain that from your viewpoint, it might be best if he kept things platonic from now on. Having a friend to rely on might be just what Gabriel needs. As for the 'cheating', that's not really applicable with all of the madness that rules the city these days. People do what they must and everyone will surely understand in the end.";
			now Charisma of Gabriel is 70; [David will no longer participate in sex with Gabriel, might become a friend though]
	else if Charisma of Gabriel is 50: [kiss]
		say "we kissed. It felt really, really nice. Does that make me a horrible person? He's vulnerable and confused, so isn't this contributing to him slipping deeper into his sex slave role? [if thirst of David is 20 and Libido of David > 68 and Libido of David < 91]And I kinda cheated on both Brutus and you with him too!' [else if thirst of David is 20]And I kinda cheated with him on you too!' [else if Libido of David > 68 and Libido of David < 91]And I kinda cheated with him on Brutus too!' [else]And I kinda cheated with him on my girlfriend.' [end if][line break]";
		LineBreak;
		say "     [bold type]What do you tell David in response?[roman type][line break]";
		say "     ([link]Y[as]y[end link]) - Having a loving influence in his life right now will do Gabriel good! And under the special circumstances for everyone here, cheating isn't really a concept that he should worry about right now.";
		say "     ([link]N[as]n[end link]) - Maybe he should just be a platonic friend to Gabriel. That'll be the best for everyone.";
		if Player consents: [encourage a relationship beyond friends]
			LineBreak;
			say "     David looks at you thoughtfully as you explain that from your viewpoint, a kiss and a more 'romantic' relationship might be just what Gabriel needs. Maybe they can find a bit of peace in each other. As for the 'cheating', that's not really applicable with all of the madness that rules the city these days. People do what they must and everyone will surely understand in the end.";
			now Charisma of Gabriel is 51; [talked after the kiss, encouraged it]
		else:
			LineBreak;
			say "     David looks at you thoughtfully as you explain that from your viewpoint, it might be best if he kept things platonic from now on. Having a friend to rely on might be just what Gabriel needs. As for the 'cheating', that's not really applicable with all of the madness that rules the city these days. People do what they must and everyone will surely understand in the end.";
			now Charisma of Gabriel is 70; [David will no longer participate in sex with Gabriel, might become a friend though]


[
after of going to Bunker while (David is bunkered and Gabriel is bunkered and Charisma of Gabriel > 0 and Libido of Gabriel > 9 and (Intelligence of Gabriel is 1 or Intelligence of Gabriel is 41)): [Gabriel + David present, have met, Gabriel Cumslut Stage 2, sex allowed]
	if debugactive is 1:
		say "     DEBUG: David/Gabriel Cumslut Walkin[line break]";
]

Seraphim ends here.
