Version 1 of Shag Shack by Wahn begins here.

"Adds a brothel to the mall area of Flexible Survival."

WhoringExperience is a number that varies.
BryceFucked is a number that varies.
RyanFucked is a number that varies.
SethFucked is a number that varies.
ZieraFucked is a number that varies.
NatalieFucked is a number that varies.
CliveFuck is a number that varies.
DylanSucked is a number that varies.
DylanFucked is a number that varies.
ArcherFucked is a number that varies.
CassandraFucked is a number that varies.

Section 1 - Jerome

Table of GameCharacterIDs (continued)
object	name
Jerome	"Jerome"

Jerome is a man.
The description of Jerome is "[JeromeDesc]".
The conversation of Jerome is { "Pay up!" }.
Jerome is in Shag Shack Entrance.

the scent of Jerome is "Jerome smells mainly of cheap aftershave, with a hint of fish underneath. He is a shark after all.".

To say JeromeDesc:
	if debugactive is 1:
		say "DEBUG -> HP of Jerome: [HP of Jerome], libido of Jerome: [libido of Jerome] <- DEBUG[line break]";
	say "     Jerome is an anthro shark dressed in a snazzy business suit and with a Rolex watch on his wrist. As you look at him, the guy accepts various items from horny customers walking up to him with lustful intent - mostly clearly visible due to leading the way with hard cocks. After passing on the articles of food, drink and other valuables to a flunky, the shark nods to his wolverine guards and the eager John is allowed to go in and have his pick of the local 'talent'. Meanwhile, Jerome becomes aware of your attention and gives you a broad smile - filled with dozens and dozens of overlapping razor-sharp teeth - seemingly daring you to step up.";

Instead of conversing the Jerome:
	if HP of Jerome is 0:
		say "     'Hey there friend,' the grinning shark tells you in a very chummy and direct way. 'Come in, come in - only the best sluts for you to get your rocks off with. You can pay in food, clean water or a bottle of orc cum. Or if you want to get the special offer lifetime membership - bring us a new hot piece of ass and you can go in anytime you want! It's a bargain, believe me!'";
		increase HP of Jerome by 1; [got his initial spiel]
	else:
		say "[JeromeTalkMenu]";

to say JeromeTalkMenu:
	LineBreak;
	say "What do you want to talk with Jerome about?";
	now sextablerun is 0;
	blank out the whole of table of fucking options;
	[]
	choose a blank row in table of fucking options;
	now title entry is "Just chat a bit";
	now sortorder entry is 1;
	now description entry is "Try to get to know him";
	[]
	choose a blank row in table of fucking options;
	now title entry is "Ask him about the price for entry again";
	now sortorder entry is 2;
	now description entry is "Ask the shark what he wants";
	[]
	if carried of water bottle > 0 and HP of Jerome is 1:
		choose a blank row in table of fucking options;
		now title entry is "Pay for entry with a bottle of clean water";
		now sortorder entry is 3;
		now description entry is "Hand a bottle of clean water to Jerome";
	[]
	if carried of food > 0 and HP of Jerome is 1:
		choose a blank row in table of fucking options;
		now title entry is "Pay for entry with some food";
		now sortorder entry is 4;
		now description entry is "Hand food to Jerome";
	[]
	if carried of orc cum > 0 and HP of Jerome is 1:
		choose a blank row in table of fucking options;
		now title entry is "Pay for entry with a bottle of orc cum";
		now sortorder entry is 5;
		now description entry is "Hand your bottle of orc cum to Jerome";
	[]
	if carried of orc cum > 0 and HP of Jerome is 1:
		choose a blank row in table of fucking options;
		now title entry is "Inquire about getting a lifetime membership";
		now sortorder entry is 6;
		now description entry is "Do you want to chat to Jerome about finding him a new whore";
	[]
	if HP of Jerome is 10: [lifetime member]
		choose a blank row in table of fucking options;
		now title entry is "Stroll in and have your pick of the 'talent'";
		now sortorder entry is 7;
		now description entry is "Get frisky with one of Jerome's 'entertainers'";
	[]
	if player is female:
		choose a blank row in table of fucking options;
		now title entry is "Ask about whoring yourself out";
		now sortorder entry is 8;
		now description entry is "Whore yourself in the Shag Shack and get paid";
	[]
	sort the table of fucking options in sortorder order;
	repeat with y running from 1 to number of filled rows in table of fucking options:
		choose row y from the table of fucking options;
		say "[link][y] - [title entry][as][y][end link][line break]";
	say "[link]0 - Nevermind[as]0[end link][line break]";
	while sextablerun is 0:
		say "Pick the corresponding number> [run paragraph on]";
		get a number;
		if calcnumber > 0 and calcnumber <= the number of filled rows in table of fucking options:
			now current menu selection is calcnumber;
			choose row calcnumber in table of fucking options;
			say "[title entry]: [description entry]?";
			if player consents:
				let nam be title entry;
				now sextablerun is 1;
				if (nam is "Just chat a bit"):
					say "[JeromeTalk1]";
				if (nam is "Ask him about the price for entry again"):
					say "[JeromeTalk2]";
				if (nam is "Pay for entry with a bottle of clean water"):
					LineBreak;
					say "[bold type]You lose 1 water bottle![roman type][line break]";
					decrease carried of water bottle by 1;
					say "[JeromeTalk3]";
				if (nam is "Pay for entry with some food"):
					LineBreak;
					say "[bold type]You lose 1 food![roman type][line break]";
					decrease carried of food by 1;
					say "[JeromeTalk3]";
				if (nam is "Pay for entry with a bottle of orc cum"):
					LineBreak;
					say "[bold type]You lose 1 orc cum![roman type][line break]";
					decrease carried of orc cum by 1;
					say "[JeromeTalk4]";
				if (nam is "Inquire about getting a lifetime membership"):
					say "[JeromeTalk5]";
				if (nam is "Stroll in and have your pick of the 'talent'"):
					say "[JeromeTalk6]";
				if (nam is "Ask about whoring yourself out"):
					say "[JeromeTalk7]";
				wait for any key;
		else if calcnumber is 0:
			now sextablerun is 1;
			say "     You step back from the anthro shark, shaking your head slightly as he gives a questioning look.";
			wait for any key;
		else:
			say "Invalid Option. Pick between 1 and [the number of filled rows in the table of fucking options].";
	clear the screen and hyperlink list;

to say JeromeTalk1: [chat]
	say "     As you try to enter a conversation with Jerome, the shark soon waves you off as he realizes you're not out to buy negotiable affections from his talent. Seems he's mainly interested in his own profit at the moment.";

to say JeromeTalk2: [prices]
	say "     The shark steps up close and gives you a very chummy smile as he says, 'You can pay in food, clean water or a bottle of orc cum. Or if you want to get the special offer lifetime membership - bring us a new hot piece of ass and you can go in anytime you want! It's a bargain, believe me!'";

to say JeromeTalk3: [pay with food/water]
	say "     Smiling sharply, the shark accepts your payment and drops it into a sturdy box next to his feet - which is already overflowing with other supplies. 'Thank you - Have your pick from among the sluts back there and enjoy your stay,' he says, then nods to one of the wolverines to let you through. Afterwards, he calls out, Kaden!' A slender tomcat dressed in black pants hurries over, his chest bare except for a shirt collar with black bow-tie and white cuffs. Someone must have raided a stripper gear store to get him that uniform. 'Drag that to the storeroom and get me a new box,' Jerome says in a commanding tone, getting a reply of, 'Sure boss!'";
	say "[ShagShackSexMenu]";

to say JeromeTalk4: [pay with orc cum]
	say "     Smiling sharply, the shark accepts your payment and calls out, 'Kaden!' A slender tomcat dressed in black pants, a shirt collar with black bow-tie and white cuffs hurries over. Someone must have raided a stripper gear store to get him that uniform. Kaden accepts the bottle and listens to Jerome's instructions of, 'Microwave this and then give all the girls and boy-sluts a dose.' After that, the cat-boy hurries away, clutching the bottle like something precious. Meanwhile, Jerome returns his affection to you and says, 'Thank you. Have your pick from among the sluts back there and enjoy your stay.' With that, he nods to one of the wolverines to let you through.";
	say "[ShagShackSexMenu]";

to say JeromeTalk5: [become a lifetime member]
	say "     <WIP>Sorry, this option isn't available yet. Please check back at another time<WIP>";

to say JeromeTalk6: [lifetime member]
	say "     Confidently walking up to the wolverines guarding the entrance, you tell them you're a lifetime member. The anthro mustelid glances up and down over you suspiciously, then asks, 'Boss?' After Jerome gives him a confirming nod, you're let through to take your pick of the available partners.";
	say "[ShagShackSexMenu]";

to say JeromeTalk7: [player being a whore]
	say "     'Oho,' the shark says with a smile, showing several rows of serrated teeth. 'We got a volunteer with us today,' Jerome shouts out loud a second later, waving his flunky Kaden over to take you to the 'bargain bin'. 'As a newbie, you won't be paid out as much as my star performers, just so you know. But if you're willing to be used for a while, it'll still be worth the effort, trust me.' The shark tries to smile softly at you but even so, his sharp teeth show a little, creating an air of menace. Then suddenly, you don't see anything at all anymore, as Kaden ties a blindfold around your head from behind you. 'Get her ready for the customers,' you hear Jerome say to his employee, and as the cat-boy guides you away from the shark, he whispers in your ear, 'Don't be angry at me, it's just how he does business.' You can almost see in your head the malicious smile of the brothel owner as you are led to your fuck-pad for the next while";
	say "     You feel hands undressing you of your gear and clothes, leaving your body stark naked - and not knowing anything about what is going on around you due to the blindfold. Then suddenly, a warm washcloth brushes over your body, cleaning your [bodytype of player] legs and back first, then moving on to your chest. Rubbing you with the wet cloth and giving your body a few gropes, the person washing you (Kaden? Or someone else?) soon moves on to your crotch, giving it a good and wet going-over. By the time he (or she?) is finished, you feel a little cold as the air touches your damp skin. Then someone else - clearly not the person who caressed you so gently earlier - pulls your arms behind your back and binds them together. You start to complain, but are quickly gagged by experienced hands. Looks like Jerome's customers are only interested in your pussy, from these preparations. After your 'bath' you are lifted up and put in a pretty tightly fitting box with your raised legs strapped in beside your body - letting only your hips on view for the customers.";
	WaitLineBreak;
	say "     [if WhoringExperience is 0]'Hey guys!' You hear a loud guy with a throaty voice shout in the room, 'There is new meat in the bargain bin.' [else]'The whore came back for more,' the loud guy says and several others laugh as they gravitate towards you. 'Don't worry baby, we also missed you and we are going to show how much,' the first dude goes on to say, putting his hand on your buttocks. [end if]You hear the steps of multiple persons coming closer to you, even if you can't see anything. Your others senses seem sharper now, and your body reacts to the handicap by putting you in a heightened awareness state of fight-or-flight. Not that you actually can do either, with your body bound in place. The expectation of what is to come makes you sweat, wondering if you did the right thing in taking this deal. Well... too late to change your mind now. You will have to endure everything fate has in store for you.";
	let randomnumber be a random number from 1 to 2;
	if randomnumber is:
		-- 1:
			say "     You feel a warm and relatively flat object touch your [bodytype of player] pussy, leaving a trace of wetness behind. That must be an equine cock from what you can tell, with the typical blunt dickhead. Your body shivers as you become a little afraid of how big he might be - although maybe it isn't exactly fear but rather anticipation. Thankfully, your first client is a nice one, at least it seems so as he gently teases your vagina, making sure that you are lubed enough to take the huge member prodding your nether lips. The friendly horse rubs up against you, touching and caressing in every way he can without truly penetrating you. Your pussy-lips are hot-dogged sending jolts of pleasure every time your clit is pushed around, making you moan and drool around your gag.";
			WaitLineBreak;
			say "     When he finally starts to push into you, your equine customer proves to be quite gentle - almost to the point of being a lover, fucking you in an relatively tender way. His long dick stimulates every nook and cranny of your cunny, his flared tip kissing the entrance of your womb and making jolts of pleasure travel up your spine. You feel every vein he has on his cock, pulsing with every heartbeat. Blindfolded as you are, you do your best to imagine the expression of this man, painting him as a handsome [one of]Palomino[or]Mustang[or]Andalusian[or]Thoroughbred[or]Percheron[at random] in your mind. Only at the end does the guy get a little bit rough, as he grunts deeply when he feels his climax coming and shoves his dick fully inside you, penetrating your cervix to rest his long shaft all the way in your womb. And an eye-blink later, it erupts with his fertile seed, painting your womb in white splashes. The force of his thrust slams you against the back wall of the box, leaving you lost between knowing if you should feel pain or pleasure.";
		-- 2:
			say "     You feel the warm, pointy tip of a cock rub against your [bodytype of player] pussy, leaving a trace of wetness behind. This must be a feline cock, judging from the soft nubs you feel around the rim of his dickhead. You don't have any time to wonder about the guy who is about to fuck you, as he just goes right ahead and pushes his whole shaft inside your pussy - without a moment's care for your own enjoyment. No, he just thrusts into you hard, bottoming out in a single thrust and giving a satisfied grunt as he does so. Then the guy starts to withdraw, the little spines on his cock rubbing against the insides of your pussy. With no real preparation, you're dry around his shaft at first, creating a less than pleasant sensation - but your pained groans are silenced by the gag in your mouth.";
			WaitLineBreak;
			say "     The egotistical cat pounds away at you mercilessly, only intent on his own pleasure. For him, you are just a slut, here to satisfy his needs. His spined shaft pull on the walls of your vagina as he withdraws it, then rubs them again every time he slams back into you. The size of this guy isn't the problem, but the way he uses his dick is making tears roll down your face and mix with the drool from your gagged screams of pain. Then finally, with a deep push into your depth, his cock throbs inside your pussy, pushing the nubs on its length against your inner walls each time. The spoiled cat grunts deeply as he taints your swollen vagina with his seed making your mind almost break with all this pain and the pleasure you simply can't help feeling despite it all.";
	say "     When you first customer is finished with you, you don't even have time to rest as another one takes his place instantly, eager for sloppy seconds. And that is the way you are used for... you don't know how long - human cocks, knotted dicks, latex penises, even an enlarged clit is used to fuck you at some point, and you lose count of how many beings got off in, and on, your body. Your vagina is squelching with cum, your womb stretched like a balloon from the churning mixture of baby batter inside. Eventually, you are pulled out of the fuck-box and as they take you away to be cleaned up, you're pretty sure you leave a wet trail of cum on the way. Some guy who works for Jerome cleans you up with a fresh washcloth, but not before taking a go himself and adding his own cum to your sloppy pussy. Seems like that's one of the 'perks' of his job here.";
	WaitLineBreak;
	if WhoringExperience is 0: [first time]
		say "     'Well, well, well,' you hear the voice of Jerome coming from the side after you've been wiped down, and someone's hands pull the blindfold from around your eyes. 'Had fun on your first day at work?' your 'boss' asks and smiles with a mouth that has far too many sharp teeth - he obviously knows how hard you were used in your stint as one of his whores. 'You are always welcome back to work in here some more. In fact... some of the old customers had some good things to say about the new girl.' The carnivore leers at you and gives a satisfied nod. 'Ask Kaden for your cut on the way out. If you want more, come back and stay for another few rounds. If you get really popular, there will be more in it for you too.' With a wink, he strides away, eager to collect payment from new Johns coming in all the time.";
		say "[ShagShackWhoringPayment]";
	else if WhoringExperience > 0 and WhoringExperience < 3: [repeat whore]
		say "     'Guess someone can't get enough of this place, or should I say that you took a taste to be used like that?' The shark laughs at you while pulling the blindfold from your head and the first thing you see is his teeth-filled mouth drawn into a broad smile. 'Keep that up and I might hire you for good.' You try to glare back at him but your face probably looks more like an exhausted whore than an angry adventurer. 'You are welcome back whenever you want some work, if you open your legs we always pay.' He gives you a nod and a wink, then adds, 'Kaden has your cut as normal. Still - you are quite popular, so why not just stay here for good and work for me? We got it all here - security, all the sex you can handle, and there are some other perks too, you know...' With that said, the shark leaves you to ponder his offer and goes back to greeting new customers at the entrance.";
		say "[ShagShackWhoringPayment]";
	else: [expert whore, 4+ fucks]
		say "     'HAHAHA,' you hear the bellowed laugh of Jerome, coming steadily closer. 'Good job. You're becoming one of my favorites whores!' The shark laughs at you while pulling the blindfold from your head making you see his winning smile. 'Keep that work and I might hire you for real.' You are used to the way he treats you by now, but sometimes it still is a bit hard to take. 'You are always welcome back, and you know it. OH! Some of my patrons are asking you by name... Well, asking for you by pussy, but still might be worth your while.' Finally he gives you a nod. 'Kaden has your cut as normal. Still - you are quite popular, so why not just stay here for good and work for me? We got it all here - security, all the sex you can handle, and there are some other perks too, you know...' With that said, the shark leaves you to ponder his offer and goes back to greeting new customers at the entrance.";
		say "[ShagShackWhoringPayment]";
	increase WhoringExperience by 1;

to say ShagShackWhoringPayment:
	say "     After picking up your gear and clothes and getting dressed, you search out Kaden, Jerome's cat-boy flunky. The slender young man stands at a table in the back, sorting out a boxful of items that visitors traded in for services. As you step up and demand to get paid, he pulls a little black book out of his pocket, paging through it and looking up at you, then down at one page specifically. 'Ah, there you are. You did a fair bit of duty with several guys, so I'm allowed to give you a payout. Please don't ask for more - Jerome would skin me if I gave away too much of his profit...' After digging around in the box for a seconds, the cat-boy hands you ";
	if WhoringExperience < 3: [regular rewards]
		let randomnumber be a random number from 1 to 4;
		if randomnumber is:
			-- 1:
				say "[one of]two cans of beans[or]a plastic baggie with two hunks of mystery-meat jerky[or]a pair of fresh melons[or]two baseball-sized cherries[or]a weighty Christmas fruit-cake[or]two packets of breakfast cereal[at random].";
				say "[bold type]You gain 2 food![roman type][line break]";
				increase carried of food by 2;
			-- 2:
				say "a soda bottle and a slightly stale packet of crackers.";
				say "[bold type]You gain 1 food and 1 soda![roman type][line break]";
				increase carried of food by 1;
				increase carried of soda by 1;
			-- 3:
				say "[one of]two bottles of clean water. Carbonated, of a name brand even[or]two bottles of lukewarm water - at least they've got an intact safety seal[or]two bottles of asparagus water. The wilted green plant-piece swimming inside looks not particularly appetizing, but the water itself should still be drinkable[or]two bottles of clean water. It isn't carbonated, of a store brand[at random].";
				say "[bold type]You gain 2 water bottles![roman type][line break]";
				increase carried of water bottle by 2;
			-- 4:
				say "[one of]a bag of chips[or]a bag of spicy chips[or]a bag of cheese and onion chips[or]a bag of chips flavored like a popular candy snack. WTF? Some combinations just shouldn't exist[at random].";
				say "[bold type]You gain 1 chips![roman type][line break]";
				increase carried of chips by 1;
	else: [better rewards for repeat whoring]
		let randomnumber be a random number from 1 to 4;
		if randomnumber is:
			-- 1:
				say "[one of]two bottles of clean water that actually look in good shape, and two cans of peaches[or]two cans of canned meat that appear to be in an ok state and two water bottles that look clear enough to reflect light without problem[at random].";
				say "[bold type]You gain 2 food and 2 water bottles![roman type][line break]";
				increase carried of food by 2;
				increase carried of water bottle by 2;
			-- 2:
				say "an assortment of rations that might help you for days.";
				say "[bold type]You gain 4 food![roman type][line break]";
				increase carried of food by 4;
			-- 3:
				say "a small white box with medical supplies, it looks a little bit aged but from a small inspection the contents are still intact.";
				say "[bold type]You gain 1 medkit![roman type][line break]";
				increase carried of medkit by 1;
			-- 4:
				say "a small container with some pills, from what you know this will raise the libido of anyone who takes it.";
				say "[bold type]You gain 1 libido pill![roman type][line break]";
				increase carried of libido pill by 1;

the fuckscene of Jerome is "     As you make an amorous offer to the shark, Jerome laughs and shakes his head. 'Much as I'd love to, I'm busy with business. Can I interest you in having a go with my 'talent' in there instead?'".

to say ShagShackSexMenu:
	say "     Which member of Jerome's 'entertainment staff' do you want to pick and have some fun with?";
	choose row monster from the Table of Random Critters;
	now sextablerun is 0;
	blank out the whole of table of fucking options;
	[]
	if player is male:
		choose a blank row in table of fucking options;
		now title entry is "Fuck Eliza - a pretty black woman";
		now sortorder entry is 1;
		now description entry is "Step up to her after the last customer pulls out and have a go with the whore";
	[]
	if player is male:
		choose a blank row in table of fucking options;
		now title entry is "Fuck Kaden - Jerome's cat-boy flunky";
		now sortorder entry is 2;
		now description entry is "Just grab the slender tomcat as he hurries past and bend him over for a fuck";
	[]
	choose a blank row in table of fucking options;
	now title entry is "Ride Simba - a transformed male soldier tied spread-eagle to a bed";
	now sortorder entry is 3;
	now description entry is "Climb on the hunky man and give him a good humping";
	[]
	choose a blank row in table of fucking options;
	now title entry is "Be pounded by Zane - an incubus stud";
	now sortorder entry is 4;
	now description entry is "Get a demon dick inside you";
	[]
	if player is male:
		choose a blank row in table of fucking options;
		now title entry is "Fuck Sasha - Jerome's hog-tied mink cum-dumpster";
		now sortorder entry is 5;
		now description entry is "She's on a bench down the end of the row of beds. Choose any hole!";
	[]
	choose a blank row in table of fucking options;
	now title entry is "Submit to Shirley - a sexy bombshell of an ape";
	now sortorder entry is 6;
	now description entry is "Serve her for a nice time";
	[]
	choose a blank row in table of fucking options;
	now title entry is "Be bred by Ty - a slender human male";
	now sortorder entry is 7;
	now description entry is "Go human for your cum";
	[]
	if player is male:
		choose a blank row in table of fucking options;
		now title entry is "Have a go fucking Penny - a rottweiler bitch into pet play";
		now sortorder entry is 8;
		now description entry is "Play with the sexy puppy";
	[]
	choose a blank row in table of fucking options;
	now title entry is "Give Bryce the wolftaur a blowjob";
	now sortorder entry is 9;
	now description entry is "Time to blow off a furry hunk";
	[]
	if player is male and PlayerMet of Azari is false:
		choose a blank row in table of fucking options;
		now title entry is "Spend time with the caged feral fox";
		now sortorder entry is 10;
		now description entry is "Have some fun with a male Latex Fox gone feral";
	[]
	if player is male:
		choose a blank row in table of fucking options;
		now title entry is "Stand at attention for Levi, the tiger soldier";
		now sortorder entry is 11;
		now description entry is "Get ready for some discipline by the hunk of a tiger";
	[]
	if player is male:
		choose a blank row in table of fucking options;
		now title entry is "Spend time with Ryan, a cute fennec fox";
		now sortorder entry is 12;
		now description entry is "Fuck the attractive young [if RyanFucked is 0]man[else]cuntboy[end if]";
	[]
	choose a blank row in table of fucking options;
	now title entry is "Service Edward, the trans rooster";
	now sortorder entry is 13;
	now description entry is "Get on your knees in front of the cock";
	[]
	choose a blank row in table of fucking options;
	now title entry is "Be massaged by Seth, a giant snake";
	now sortorder entry is 14;
	now description entry is "Enjoy a sexual massage by the large reptile";
	[]
	if player is purefemale:
		choose a blank row in table of fucking options;
		now title entry is "Spend some time with Ziera, a centauress";
		now sortorder entry is 15;
		now description entry is "Enjoy a sexual massage by the large reptile";
	[]
	if player is male:
		choose a blank row in table of fucking options;
		now title entry is "Obey Mysti, the otter dominatrix";
		now sortorder entry is 16;
		now description entry is "Get used and slapped about by an otter with a mean streak";
	[]
	choose a blank row in table of fucking options;
	now title entry is "Investigate Natalie's latex-splattered mattresses fort";
	now sortorder entry is 17;
	now description entry is "Seek out the latex mistress and get pleasurably stretched";
	[]
	choose a blank row in table of fucking options;
	now title entry is "Use toys with Clive, the ballsy goblin";
	now sortorder entry is 18;
	now description entry is "Let the goblin Clive fill your ass with toys";
	[]
	if player is male:
		choose a blank row in table of fucking options;
		now title entry is "Have some fun with the heavily muscled minotaur, Dylan";
		now sortorder entry is 19;
		now description entry is "See what the big guy proposes";
	[]
	if ArcherFucked is 0: [initial scene only right now]
		choose a blank row in table of fucking options;
		now title entry is "Submit to the musky hound, Archer the Great Dane";
		now sortorder entry is 20;
		now description entry is "Enter his sweetly smelling room";
	[]
	choose a blank row in table of fucking options;
	now title entry is "Spend Time with Alyona, a herm feline war veteran";
	now sortorder entry is 21;
	now description entry is "Have a bit of fun with the kitty";
	[]
	choose a blank row in table of fucking options;
	now title entry is "Experience Cassandra, a Muse with unconventional techniques";
	now sortorder entry is 22;
	now description entry is "Enjoy some music and a 'show'";
	[]
	choose a blank row in table of fucking options;
	now title entry is "Have fun with Gus, a male stork";
	now sortorder entry is 23;
	now description entry is "Spend some time with a slender avian";
	[]
	sort the table of fucking options in sortorder order;
	repeat with y running from 1 to number of filled rows in table of fucking options:
		choose row y from the table of fucking options;
		say "[link][y] - [title entry][as][y][end link][line break]";
	say "[link]0 - Nevermind[as]0[end link][line break]";
	while sextablerun is 0:
		say "Pick the corresponding number> [run paragraph on]";
		get a number;
		if calcnumber > 0 and calcnumber <= the number of filled rows in table of fucking options:
			now current menu selection is calcnumber;
			choose row calcnumber in table of fucking options;
			say "[title entry]: [description entry]?";
			if player consents:
				let nam be title entry;
				now sextablerun is 1;
				if nam is:
					-- "Fuck Eliza - a pretty black woman":
						say "[ShagShackSex1]"; [by Wahn]
					-- "Fuck Kaden - Jerome's cat-boy flunky":
						say "[ShagShackSex2]"; [by Wahn]
					-- "Ride Simba - a transformed male soldier tied spread-eagle to a bed":
						say "[ShagShackSex3]"; [by Wahn]
					-- "Be pounded by Zane - an incubus stud":
						say "[ShagShackSex4]"; [by Wahn]
					-- "Fuck Sasha - Jerome's hog-tied mink cum-dumpster":
						say "[ShagShackSex5]"; [by]
					-- "Submit to Shirley - a sexy bombshell of an ape":
						say "[ShagShackSex6]"; [by Wahn]
					-- "Be bred by Ty - a slender human male":
						say "[ShagShackSex7]"; [by Wahn]
					-- "Have a go fucking Penny - a rottweiler bitch into pet play":
						say "[ShagShackSex8]"; [by Aureas]
					-- "Give Bryce the wolftaur a blowjob":
						say "[ShagShackSex9]"; [by Qazarar]
					-- "Spend time with the caged feral fox":
						say "[Azari_Start]"; [by Dys]
					-- "Stand at attention for Levi, the tiger soldier":
						say "[ShagShackSex11]"; [by Weaveroflight]
					-- "Spend time with Ryan, a cute fennec fox":
						say "[ShagShackSex12]"; [by Mizu]
					-- "Service Edward, the trans rooster":
						say "[ShagShackSex13]"; [by Wasp]
					-- "Be massaged by Seth, a giant snake":
						say "[ShagShackSex14]"; [by Prometheus]
					-- "Spend some time with Ziera, a centauress":
						say "[ShagShackSex15]"; [by CrimsonAsh]
					-- "Obey Mysti, the otter dominatrix":
						say "[ShagShackSex16]"; [by Fwuffymouse]
					-- "Investigate Natalie's latex-splattered mattresses fort":
						say "[ShagShackSex17]"; [by Mirvanna]
					-- "Use toys with Clive, the ballsy goblin":
						say "[ShagShackSex18]"; [by EnFin]
					-- "Have some fun with the heavily muscled minotaur, Dylan":
						say "[ShagShackSex19]"; [by Vinickus]
					-- "Submit to the musky hound, Archer the Great Dane":
						say "[ShagShackSex20]"; [by Mendo]
					-- "Spend Time with Alyona, a herm feline war veteran":
						say "[ShagShackSex21]"; [by Shay]
					-- "Experience Cassandra, a Muse with unconventional techniques":
						say "[ShagShackSex22]"; [by Hierophant]
					-- "Have fun with Gus, a male stork":
						say "[ShagShackSex23]"; [by Hyliad]
				wait for any key;
		else if calcnumber is 0:
			now sextablerun is 1;
			say "     As you pass Jerome on the way out, he gives you a look with one raised eyebrow, then says, 'No refunds.'";
			wait for any key;
		else:
			say "Invalid Option. Pick between 1 and [the number of filled rows in the table of fucking options].";
	clear the screen and hyperlink list;

to say ShagShackSex1: [Eliza]
	say "     As you walk up to the black beauty, Eliza is being savagely pounded by a [one of]muscular horseman[or]slender mall-rat[or]hermaphrodite gryphon[or]beanpole of a male stork[or]somewhat chubby anthro frog[or]horny golden retriever[or]naga taking both her holes at the same time[at random]. He has her on her knees, ass raised high while holding her arms bent behind her back. This presses her face, upper body and breasts down against the stained mattress she is on, giving her partner full control over her body. Soon, the John comes with a lust-filled grunt, grinding his crotch against her as he sends throb after throb of cum deep into her body. As soon as he is done, he pulls out unceremoniously and gives Eliza's shapely ass a satisfied slap, then wanders off with his half-hard dick still dripping cum.";
	if a random chance of 1 in 2 succeeds:
		say "     Stepping forward and freeing your own manhood, your gaze is locked upon her well-bred pussy, you are momentarily interrupted by Jerome's slender tomcat flunky moving up to her and sticking the needle of a red syringe into her arm and slowly pressing the plunger. He is about to move away again when you grab his arm and have a look at what he just injected the woman with. His syringe has writing on its side, reading 'US ARMY - Immunity Booster'. The feline guy is a bit flustered at you becoming physical and says, 'Hey - let me go. This is just to keep her human, alright? Eliza is very popular just the way she is and we don't want her to change.' With that said, he winds himself out of your grip and dashes off.";
	else:
		say "     Stepping forward and freeing your own manhood, your gaze is locked upon her well-bred pussy, you are momentarily interrupted by Jerome's slender tomcat flunky moving up to her and pouring a tiny bottle full of a creamy white substance down her throat, which she eagerly swallows. He is about to move away again when you grab his arm and have a look at what he just gave the woman. His little bottle has a handwritten tag on the side, reading 'Refresher'. The feline guy is a bit flustered at you becoming physical and says, 'Hey - let me go. This is orc cum, just microwaved for a few seconds and diluted. Has some amazing regenerative capabilities, among other things. Eliza is very popular just the way she is and we don't want her to stretch out from all the fucking.' With that said, he winds himself out of your grip and dashes off.";
	WaitLineBreak;
	say "     Stepping up behind the human woman, you put your hands on the very well-rounded buns of her black ass, squeezing those soft cheeks appreciatively. Never having left her ass-up position with both arms behind her back, the ebony-skinned beauty moans into the mattress, lost in the arousal and sensations of a constant string of sex acts she is put through. Thinking back, you don't think you've actually ever seen her not being used by someone for more than five minutes in the time you've been in here. And why wouldn't any guy slide his dick into such a sexy goddess? You're certainly going to do so, lining your cock up with her slightly gaping hole right this very moment!";
	say "     Slick with the cum of who knows how many other men and herms, it is easy to sink your manhood into Eliza's pussy, which is still surprisingly tight for one of the most popular whores in here. Her inner passage is nice and snug around your [cock of player] shaft and the black woman trembles in arousal, giving a loud moan as you penetrate deeply. She has been fucked so much today that someone's creamy load starts to squelch out around your shaft when you're all the way inside her snatch. That's one hot, sloppy hole on Eliza!";
	WaitLineBreak;
	say "     Pulling back out to start fucking the dark-skinned whore for real, you look down at your erection, covered in the frothy white cum that her last suitor freshly churned up. You wrap your hand around its length and feel how slippery it is covered in this very special kind of lube, then thrust right back into Eliza's welcoming depths. Something about her is just made to be taken hard - maybe it's the generous curves of her butt wobbling so nicely each time your hips meet, the woman's very enthusiastic moans or your own ambition to surpass all those that fucked her before. No matter which, you really pound into the ebony-skinned beauty with a rapid rhythm of thrusts.";
	say "     Sheathing yourself in her trembling body, you drive Eliza wild every time you bottom out, her gasps of pleasure steadily rising. Soon, they culminate in an orgasmic shout that is loud even half-muffled by the mattress her face is pressed against - and in that moment, you learn why no one can resist to cum in her amazing pussy! Tight as she felt before, now her inner muscles flex and squeeze your cock even more, as if jerking you off right in her squelching pussy! It feels so great that you even stop moving your hips, instead just grinding hard against the woman's ass in an effort to get more of your cock in there.";
	WaitLineBreak;
	say "     Eliza's special skills push all the right buttons in you - hard - and before much longer, you let out a satisfied grunt that signals your impending orgasm. Then your balls throb and send forth a first blast of sperm to shoot into her depths, followed by another and another to mix with the deposits of your predecessors. Flooding the expert whore with your potent load, you can't help but wonder if Jerome has her on some sort of birth control or if her womb is receptive and stewing with a dozen species worth of sperm. You can't help but fantasize about Eliza with her belly large and swollen with a child inside - or maybe a foal, or some puppies, or who knows what.";
	say "     Cock still buried deep in the freshly bred snatch of your chosen whore, you're pulled out of your post-orgasmic haze by a pat on your arm. Looking back over your shoulder, you see that [one of]a grinning gorilla[or]an impatient cougar[or]a cave-man with long dreadlocks[or]a whirring and clicking mechanical man[or]a semitransparent goo-person[or]a broad-shouldered hawk-man[or]a very well hung minotaur[or]a living statue made from black rock[at random] with his hard cock in hand is waiting to have his turn on her too. With a grunt, you pull out, wiping your length against the still panting woman's buttocks - a nice contrast of white cum on her black skin - then stand up and grab your clothes. While you're getting dressed, Eliza is already being taken by her new John, his cock covered in your own load.";

to say ShagShackSex2: [Kaden]
	say "     Keeping an interested eye on the cat-boy as he comes and goes from the entrance room to do tasks for Jerome, you pass him up as he has just finished putting away a big box of the whorehouse's earnings. As you grab hold of his soft-furred arm to stop him from walking past, Kaden looks at you in surprise and says, 'Hey - let me go. I've got things to do for the boss.' With a grin on your face, you tell him that for the next little while all he should worry about is pleasing you. He starts to reply, 'But I'm not one of t-' then stiffens and lets out a shocked pant as you grab the somewhat loose skin at the back of his neck.";
	say "     Like a real kitty, the cat-boy instantly becomes much more pliable and obedient as you push the right button for his instincts. With a firm grasp on his neck, you walk the slender tomcat over to an unused bed further back in a corner of the room (just in case Jerome or someone else might object to you taking liberties with his regular staff). Standing in front of the yet unstained mattress, you hold the anthro cat close to your chest and wrap an arm around him, hand sliding down to rub his crotch. With some petting and fondling, a bulge quickly starts to grow under the fabric, tenting out his pants quite nicely. You can already tell that this kitty isn't a small one.";
	WaitLineBreak;
	say "     Kaden's pants are pretty tight, so you can't slide your hand under his belt-line, so at some point you have to let go of his neck to open his button and zipper, plus the extra button at the top of the tailhole at the back. This frees the anthro feline to say, 'I'm not a whore! Jerome trusts me to be his assistant and I just take care of...' By then, you're with the pants, you forcefully shove them down, revealing his bare furry butt and stiff erection. Nice and naughty kitty, going commando like that! '...of everything that needs to be done back here,' your slender captive says and tries to step out between you and the bed. He doesn't get far, hobbled by his own pants and with you closing your arms around him from behind a few seconds later.";
	say "     Moving your face close to one of his pointy ears while your hands stroke his furry chest, you whisper to the cat-boy that you're back here now, a paying customer, and that what needs to be done right now is him - by you. He opens his muzzle to object but before anything comes out you grab his cock and start stroking it, reducing him to just panting loudly. It doesn't take long for a bit of jerking and fondling his balls to show an effect, and before much longer he changes his tune. 'Nnngh - ah fuck it, fine.' With that said, Kaden lets himself fall forward onto the bed, landing on his hands and knees.";
	WaitLineBreak;
	say "     Giving you a glance over his shoulder, the slender tomcat pants out, 'Help me get the pants off then - and check the front right pocket.' He gives a wiggle of his cute little butt and the lower legs that are still sticking out over the edge of the bed. Grinning at the newfound enthusiasm of your sexy kitty, you pull the pants down and off his slender legs. You're about to drop them, then remember what he said and reach into the pocket, finding a number of tiny squeeze-packages of lube. Throwing them on the bed beside him, you start undressing yourself, hastily throwing off your gear and clothes in your eagerness to fuck this kitty.";
	say "     By the time you're naked, he is sitting on the bed with spread legs, a torn lube-package lying on the mattress while he rubs the slippery goop over his tailstar. You watch in eager anticipation as he starts to insert a finger and lubes up his hole for you, then lies back with both hands his legs spread and open. Who could resist that invitation?! Moving onto the bed yourself, you kneel in front of the slender cat-boy and take a hold of your rock-hard erection to guide it against his waiting pucker. With a satisfied grin on your face, you push past the slight resistance of his hole and sink into him.";
	WaitLineBreak;
	say "     Clearly familiar with the mechanics of anal sex, Kaden pushes out against your first thrust and makes it easy to penetrate him fully, letting out a moan as you bottom out and your balls press against his buttocks. As a reward, you wrap your fingers around his own erection, gently squeezing the hard length and teasing the soft little nubs on his spined manhood. From then on, you stroke him in the same rhythm of your thrusts into his tight and gripping asshole, pushing the both of you to higher and higher arousal. Kaden is a very vocal and receptive bottom, gasping and trembling noticeably each time you push the button of his prostate with your thrusting shaft.";
	say "     Pounding the cat-boy's tight little rump makes you think that he's wasted as just being Jerome's assistant, clearly having such excellent qualification to be a world-class boy-toy. But then... he did have a pocket full of lube and was quick to use it on himself - maybe the cheeky little cat is just something of a special treat for those with the will to push past his objections. The expert way he squeezes your cock with his inner muscles is quite telling, now that you think about it. No matter if your assumption is correct or not, Kaden is one sexy fuck - and taking his tight ass drives you ever closer to a breathtaking climax at a rapid pace.";
	WaitLineBreak;
	say "     Reaching the point of no return, you grunt deeply, thrusting hard against the sweet cat-boy's furry buns. With your [cock of player] shaft buried balls-deep, you erupt into him, painting his chute white with your creamy cum. The throb of your cock with every spurt of semen into him pushes lightly against his prostate again and again... and soon is enough to push the anthro feline off the cliff of his sky-high arousal. With a lusty yowl, Kaden bucks against you and grinds his hips up and down, his erection erupting with spurts of cum that arches into the air and splats down on his furry chest. His insides clench around your length as he comes, making the already snug hole even tighter and giving you another little boost of lust even as your cum-shots ebb off.";
	say "     With a grin on your face, you pull out of the panting cat-boy and reach up to stroke him affectionately behind the ears. Then you leave him to catch his breath, grabbing your clothes and quickly getting dressed before you walk out of the open brothel and into the entrance area.";

to say ShagShackSex3: [Simba]
	say "     Walking into what appears to have been the more high-priced corner of the former mattress store, you come upon an actual four-poster bed with an excellent - if now somewhat cum-stained - mattress laid out on it. And on top of that, a glorious hunk of an anthro lion is stretched out, his wrists and ankles held by black leather cuffs that are securely tied to the bed. Camo pattern pants and a jacket lie crumpled on the floor, clear indications that this is a soldier - as are the dog tags hanging around his neck. The man's feline cock is hard as rock, standing upright over the small bush of longer pubes on his golden-furred body. He is panting with an open muzzle, head leaning back and eyes closed.";
	say "     Eager to feel the sexy guy against - and inside - your body, you quickly pull off your gear and clothes, throwing them into a small heap next to the bed (on the far side of course, so anyone wanting to grab something would have to walk past). Then you step up on the pleasantly soft yet at the same time nicely firm mattress. Movement on the bed draws the attention of the guy you want to have sex with and he opens his eyes, then raises his maned head to look at you, gaze wandering over your naked form. 'Another one?!' he says in a somewhat groggy tone of voice, then chuckles to himself and adds, 'Maaan, this is the craziest and sexiest dream I ever had. First the fucking lion thing and now this!'";
	WaitLineBreak;
	say "     You do notice that his gaze is a little unfocused as he switches up glancing down at his own dog tags, then the soft fur covering his body and back at you. He seems almost drunk and is obviously very, very horny - humping his hips into the air while giving your nakedness appreciative growls. Stepping over the guy, you look down on his well-defined physique and then crouch, straddling his flat abs. His fur is soft under your hands as you let them roam over his chest, feeling up his muscles. Then you see the name on his dog tags - Simba King. Wow. Some parents just inflict the craziest word combinations on their kids as wordplay. Oddly fitting that he got specifically this infection out of the situation here.";
	say "     Leaning forward, your hands braced on two rock-hard abs, you plant a kiss on Simba's muzzle and find it eagerly returned. Warm breath washes over your face and neck as he gives an aroused growl and licks you, all the while grinding his crotch and abs against your own. 'Fuuuck yeah,' your sexy lion grunts at feeling your body rub on his. His pecs bulge as he strains against his cuffs, trying to pull free and grab you for a hard pounding - but the bindings hold, leaving this big cat at your mercy. Unable to resist the desires that such power brings with it, you proceed to rub yourself against his humping body, slowly creeping backwards bit by bit until his erect manhood starts to touch your buttocks.";
	WaitLineBreak;
	say "     Gleefully, you slide your buttocks up and down against Simba's erection and revel in feeling the hot pole lengthwise in your butt-crack. You even give him a squeeze or two, flexing your muscles to wedge his prick between your buns and driving the anthro lion wild with lust. But as much as playing with him is - at some point, it just isn't enough anymore and you reach back to take hold of him. Long and hard, it feels very nice between your fingers, as do soft spiky bumps along its length - perfect to stimulate anyone this king of the wilds fucks. Which will include you in a few seconds. He feels almost lubed, what with the pre-cum he has been oozing from his dickhead and you spreading that up and down his cock with your rubbing.";
	if player is female:
		say "     Then the big moment comes - you position yourself over him, lining your pussy up with his cock and... Simba hammers himself home with a horny roar. Damn, that was quick! You're too lost in the sensations of having almost a foot of thick lion cock thrust into your vagina to do anything but let out a lewd moan. Seems like this is what you get for teasing a poor tied-up kitty - and it is a hell of a lot of fun! Before you have more than a second or three to get to terms with the sudden penetration, he pulls back again... which scrapes the soft spines on his erection against your inner walls in a truly breathtaking followup.";
		say "     Reduced to helpless moans in arousal, you sink yourself down on the feline soldier's cock to feel him back inside, then squeeze your inner muscles around his manhood. Simba is more than pleased with your reaction and the two of you start to fuck like wild beasts - or at least you are, riding a safely secured horny lion. The moans, grunts and sometimes roars between the two of you draw many a glance from other 'clients' and brothel staff alike. Between the wild gyrations caused by Simba's admirable stamina, you barely have the time to have a clear thought, and before much longer, an orgasm approaches rapidly. Bucking hard against your lion stud's crotch as you come, your whole body trembles around him, pushing him over the edge right with you.";
		WaitLineBreak;
		say "     Thick throbs of cum gush into your insides as Simba finally can't hold back anymore, erupting hard into your pussy. His seed feels nicely warm and filling, heightening your own pleasure at mating with this hunk of a lion. You simply take everything he gives you, still straddling his hips and stretching your upper body out on his soft-furred shape. Tied up as he is, the lion can't wrap his arms around you - or roll the two of you over for a second fuck, who knows what he would do after all. What he can do is purr - loud as an idling motor and feeling very pleasant as it vibrates through your own chest. 'Best dream ever...' you can hear him murmur as he dozes off in exhaustion after a little while.";
	else:
		say "     Then the big moment comes - you position yourself over him, lining your asshole up with his cock and... Simba hammers himself home with a horny roar. Damn, that was quick! You're too lost in the sensations of having almost a foot of thick lion cock thrust into your back door to do anything but let out a lewd moan. Seems like this is what you get for teasing a poor tied-up kitty - and it is a hell of a lot of fun! Before you have more than a second or three to get to terms with the sudden penetration, he pulls back again... which scrapes the soft spines on his erection against your inner walls in a truly breathtaking follow-up.";
		say "     Reduced to helpless moans in arousal, you sink yourself down on the feline soldier's cock to feel him back inside, then squeeze your inner muscles around his manhood. Simba is more than pleased with your reaction and the two of you start to fuck like wild beasts - or at least you are, riding a safely secured horny lion. The moans, grunts and sometimes roars between the two of you draw many a glance from other 'clients' and brothel staff alike. Between the wild gyrations caused by Simba's admirable stamina, you barely have the time to have a clear thought, and before much longer, an orgasm approaches rapidly. Bucking hard against your lion stud's crotch as you come, your whole body trembles around him, pushing him over the edge right with you.";
		WaitLineBreak;
		say "     Thick throbs of cum gush into your insides as Simba finally can't hold back anymore, erupting hard into your ass. His seed feels nicely warm and filling, heightening your own pleasure at mating with this hunk of a lion. You simply take everything he gives you, still straddling his hips and stretching your upper body out on his soft-furred shape. Tied up as he is, the lion can't wrap his arms around you - or roll the two of you over for a second fuck, who knows what he would do after all. What he can do is purr - loud as an idling motor and feeling very pleasant as it vibrates through your own chest. 'Best dream ever...' you can hear him murmur as he dozes off in exhaustion after a little while.";
	say "     Eventually, you push yourself up from the soft, warm and purring guy and slide yourself off his softening prick. Giving the sated kitty a friendly pat on the side, you then get up from the bed and start to dress. It doesn't take long after that for Kaden, Jerome's cat-boy assistant, to arrive with a little bucket of water in his hand. 'Let's get you ready for your next visitor, big guy,' he tells Simba in a companionable tone. Getting no reply, Kaden then starts to gently wash the soldier, making sure his cum doesn't dry in that silky soft crotch fur and dabbing a big sponge over the muscular frame of the tied-up lion...";

to say ShagShackSex4: [Zane the incubus]
	setmonster "Incubus";
	choose row monster from the Table of Random Critters;
	say "     Walking between the rows of beds and mattresses, you come to one that is unoccupied right now. Though clearly not for long, judging from the still-wet puddle of cum on the ground next to it. The 'owner' of this fuck-pad is casually leaning against the wall right next to it, confidently presenting his naked body to anyone looking his way. It is an incubus, and a handsome one at that - well-toned body, a studly face and red hair, accentuated very nicely by his horns, large red leathery wings and tail. His cock stands erect and ready, with the attractive stud demonstratively stroking up and down along its length. 'Hey there baby,' he calls out to you in an oh so smooth and enticing voice. 'I can see you wanna spend some time with the best fuck in this place. Good pick, Zane will take care of your needs.'";
	say "     With that said, the handsome man pushes himself off the wall with his wings and saunters towards you, his cock swinging side by side as he sways his hips. Next you know, Zane's hand is sliding slowly up your arm in a teasing stroke, then down your side and around as he pulls you into an embrace. An attractive masculine scent fills your nostrils as he pushes his naked form up against yours, his hard cock brushing against your hip. Then the incubus leans his head close and looks deep into your eyes, his mouth pulling into a smile that reveals slightly elongated canines. 'Trust me,' he says in his rich voice and plants a hot kiss on your lips that makes you swoon, 'Just lay back and enjoy.'";
	WaitLineBreak;
	say "     Guided by the otherworldly seducer holding you in his arms, you soon feel your legs bump softly against the edge of the bed, followed by Zane gently pushing you down to sit on it. The demon looks down at you with a wide grin that promises great pleasure - and also holds a clear undertone of predatory hunger... but somehow, you can't seem to care for anything but being with him right now. Leaning over you, he strokes your cheek before moving on to touch your body, peeling your clothes and gear off with an expert's grace and speed. It doesn't take long at all before you are as naked as he is, your stuff forming a small pile next to the bed. 'You're one sexy beast, aren't you,' he says with a smile and runs his fingers over your body - touching, stroking and teasing.";
	say "     You can't help but pant out loud at the stimulation your demonic lover gives you, building up arousal in your body until he lays a hand on your chest and pushes you back to lie on the bed. You stretch out on the sheets and feel their soft fabric against your back - damn, is that silk? Where did Zane get all this? The question is easily forgotten a moment later, when he nudges your legs apart with an eager touch and crouches down before you, bringing his head close to your crotch. With his hands stroking the insides of your thighs, he lifts them effortlessly to put them over his shoulders, then leans in to start licking you.";
	WaitLineBreak;
	if player is female: [female and herm]
		say "     A swipe of the demon's tongue brushes over your pussy and draws a pleased sigh from you, followed by another and another as Zane demonstrates his skillful tongue. A shiver of arousal goes through your whole body at a flick of its tip over your sensitive clit, followed by slow circling touches around it and more direct stimulation. His tireless oral service soon has the intended effect of getting you wet and dripping with female juices, your pussy aching to be fucked... and Zane is only too happy to proceed to that. Taking hold of your legs to hold them up and spread wide, the sexy demon rises from his crouch in front of the bed - bringing his perfect shaft of erect maleness into full view. He revels in the attention you give him, your hungry gaze wandering over his toned body and the cock you yearn for now.";
		say "     After a little while of basking in your lusty looks, a glistening drop of pre forms at the tip of Zane's cock, showing that he is ready and eager to take you. And indeed he does - moving his hips to line himself up with your slightly swollen and open nether lips, then sliding right into your body, his prick pleasantly warm against your inner walls. He is a demon after all, and it seems they run hot. Penetrating you deeply in a smooth stroke at just the right speed, he sinks his cock in all the way until his balls brush against your crotch. 'You feel amazing babe,' the sex demon pants out in a lusty tone and gives you a peck on the lips. He rests his throbbing shaft inside your pussy for a few seconds more, then starts to slide in and out.";
		WaitLineBreak;
		say "     Zane fucks you with swift and deep strokes, varying the angle of thrust as he does so to increase your pleasure and hit pleasure-spots you barely knew you had. Writhing under his toned body, your arousal soaring higher and higher from his touching, thrusting, kissing and all-round pleasuring you, you barely manage to form intelligible thoughts. But then... you don't have to think, or worry, or do anything right now except lay on the silken bedsheets and enjoy yourself. Picking such an amazing professional to fuck you was a truly amazing idea! Groaning out loud at another deep thrust, you give yourself fully to the handsome demon, closing your eyes to let him do what he will with you.";
		say "     The next little while is a blissful haze in your memory afterwards, filled with touches and sensations that are so very, very good. The incubus teases you to a point just at the cusp of an intense climax, then holds you there for what feels like an eternity before he finally goes all out. With his full balls smacking against your crotch in a rapid tempo, he fucks you even harder than before, and the demon's hard cock shoots you past the point of no return in a few heartbeats. Letting out a lustful shout, you twitch around his erection, your whole body trembling and shaking in pleasant tingles. Zane starts to unload deep into your pussy just seconds later, either showing that he had extreme self-control to keep himself from cumming up till now, or that the pleasure at seeing you get you off gave him the last push he needed himself.";
		WaitLineBreak;
		say "     Lying on the bed, you enjoy getting bred by the sexy demon, his cock pulsing spurt after spurt of hot cum into your innermost depths. And he doesn't just fuck off afterwards either, instead keeping his only slowly softening shaft inside you. He even gives little thrusts and grinds a bit against you to prolong your own orgasm, propping up the waves of pleasure and making them ebb off that much slower. Eventually, you sink back on the soft bed and even softer sheets, totally spent and filled with total satisfaction. 'Told you you'd like it,' Zane tells you as he leans in to give you a kiss and broad grin. With that said, he gently pulls out of you and stands up. 'Feel free to rest a bit on the bed, good sex is exhausting. I'll be back after getting cleaned up. Got a needy slut in here who just loves giving tongue-baths and slurp up pussy juices from my cock!'";
		say "     After the smiling incubus saunters away, you stay on your back for a while longer, basking in the pleasant feelings still fresh in your body and mind. Only after fully catching your breath and riding out the last tingles of your orgasm do you slowly get out of bed and get dressed. All in all, picking the incubus prostitute was more than worth it![fimpregchance]";
	else: [male and neuter]
		say "     A swipe of the demon's tongue runs up the crack between your buttocks, brushing over your pucker and drawing a pleased sigh from you, followed by another and another as Zane demonstrates his skillful tongue. A shiver of arousal goes through your whole body as he pushes in against the muscle, followed by circling touches around it and more direct stimulation of actually working his tongue inside you. His tireless oral service soon has the intended effect of getting your back door relaxed and slippery for the upcoming fuck... and Zane is only too happy to proceed to that. Taking hold of your legs to hold them up and spread wide, the sexy demon rises from his crouch in front of the bed - bringing his perfect shaft of erect maleness into full view. He revels in the attention you give him, your hungry gaze wandering over his toned body and the cock you yearn for now.";
		say "     After a little while of basking in your lusty looks, a glistening drop of pre forms at the tip of Zane's cock, showing that he is ready and eager to take you. And indeed he does - moving his hips to line himself up with your trembling muscle, then pushing in until your ring yields to his erection and the dick-head pops inside. After that, Zane slides deeper into your body, his prick pleasantly warm against your inner walls. He is a demon after all, and it seems they run hot. Penetrating you in a smooth stroke at just the right speed, he sinks his cock in all the way until his balls brush against your crotch. 'You feel amazing babe,' the sex demon pants out in a lusty tone and gives you a peck on the lips. He rests his throbbing shaft inside your hole for a few seconds more, then starts to slide in and out.";
		WaitLineBreak;
		say "     Zane fucks you with swift and deep strokes, varying the angle of thrust as he does so to increase your pleasure and hit pleasure-spots you barely knew you had. Writhing under his toned body, your arousal soaring higher and higher from his touching, thrusting, kissing and all-round pleasuring you, you barely manage to form intelligible thoughts. But then... you don't have to think, or worry, or do anything right now except lay on the silken bedsheets and enjoy yourself. Picking such an amazing professional to fuck you was a truly amazing idea! Groaning out loud at another deep thrust, you give yourself fully to the handsome demon, closing your eyes to let him do what he will with you.";
		say "     The next little while is a blissful haze in your memory afterwards, filled with touches and sensations that are so very, very good. The incubus teases you to a point just at the cusp of an intense climax, then holds you there for what feels like an eternity before he finally goes all out. With his full balls smacking against your crotch in a rapid tempo, he fucks you even harder than before, and the demon's hard cock shoots you past the point of no return in a few heartbeats. Letting out a lustful shout, you [if player is male]let loose with a barrage of cum-spurts from your own hard cock, splattering your chest with your sticky white load[else]twitch around his erection [end if]while your whole body trembles and shakes in pleasant tingles. Zane starts to unload deep into your asshole just seconds later, either showing that he had extreme self-control to keep himself from cumming up till now, or that the pleasure at seeing you get you off gave him the last push he needed himself.";
		WaitLineBreak;
		say "     Lying on the bed, you enjoy getting bred by the sexy demon, his cock pulsing spurt after spurt of hot cum into your innermost depths. And he doesn't just fuck off afterwards either, instead keeping his only slowly softening shaft inside you. He even gives little thrusts and grinds a bit against you to prolong your own orgasm, propping up the waves of pleasure and making them ebb off that much slower. Eventually, you sink back on the soft bed and even softer sheets, totally spent and filled with total satisfaction. 'Told you you'd like it,' Zane tells you as he leans in to give you a kiss and broad grin. With that said, he gently pulls out of you and stands up. 'Feel free to rest a bit on the bed, good sex is exhausting. I'll be back after getting cleaned up. Got a needy slut in here who just loves giving tongue-baths and slurp up the remaining cum from my cock!'";
		say "     After the smiling incubus saunters away, you stay on your back for a while longer, basking in the pleasant feelings still fresh in your body and mind. Only after fully catching your breath and riding out the last tingles of your orgasm do you slowly get out of bed and get dressed. All in all, picking the incubus prostitute was more than worth it![mimpregchance]";

to say ShagShackSex5: [Sasha the cum-dump]
	say "     Moving along the rows of mattresses you come to the end of the line, where you almost walk straight past the diminutive figure on the bench. Trussed up on it like a thanksgiving turkey is a yuppie mink, who has clearly fallen on hard times. The petite socialite is lying on her back on the thin wooden bench, her head hanging off the end with nothing to rest it on. She looks somewhat uncomfortable having her arms bound together at the wrist beneath the bench. Resting near the perky C-cup, exposed breasts, are her knees which have been pulled up and tied together in such a way as to allow easy access to her gaping ass and cunt.";
	say "     It is clear she has zero mobility, but full visibility of anyone who may decide to plow her ass or pussy, both of which have clearly seen a terrific amount of use. Below her exposed ass rests a bucket to catch any cum that pours from the overfilled holes after fucking. She looks up at you as you stop to check out her bared assets, smiling invitingly as she does so. Her makeup is smudged and her once golden blonde hair appears matted and dirty. 'Hey there big boy, come for your turn at Sasha the cum dumpster?' she asks. Grinning, you nod and disrobe. With your cock already standing to attention, you use the pre leaking from its tip to moisten your member and provide for some extra slickness while considering which hole to use.";
	say "[SashaSexMenu]";

to say SashaSexMenu:
	LineBreak;
	now sextablerun is 0;
	blank out the whole of table of fucking options;
	[]
	if player is male:
		choose a blank row in table of fucking options;
		now title entry is "Fuck Sasha in her dripping pussy";
		now sortorder entry is 1;
		now description entry is "Enjoy sloppy seconds (well, fifths more likely) with the whore";
	[]
	if player is male:
		choose a blank row in table of fucking options;
		now title entry is "Fuck Sasha in her gaping asshole";
		now sortorder entry is 2;
		now description entry is "Enjoy sloppy seconds (well, thirds more likely) with the whore";
	[]
	if player is male:
		choose a blank row in table of fucking options;
		now title entry is "Fuck Sasha in her eager mouth";
		now sortorder entry is 3;
		now description entry is "Feed the tied-up whore another load";
	[]
	sort the table of fucking options in sortorder order;
	repeat with y running from 1 to number of filled rows in table of fucking options:
		choose row y from the table of fucking options;
		say "[link][y] - [title entry][as][y][end link][line break]";
	say "[link]0 - Nevermind[as]0[end link][line break]";
	while sextablerun is 0:
		say "Pick the corresponding number> [run paragraph on]";
		get a number;
		if calcnumber > 0 and calcnumber <= the number of filled rows in table of fucking options:
			now current menu selection is calcnumber;
			choose row calcnumber in table of fucking options;
			say "[title entry]: [description entry]?";
			if player consents:
				let nam be title entry;
				now sextablerun is 1;
				if (nam is "Fuck Sasha in her dripping pussy"):
					say "[SashaSex1]";
				else if (nam is "Fuck Sasha in her gaping asshole"):
					say "[SashaSex2]";
				else if (nam is "Fuck Sasha in her eager mouth"):
					say "[SashaSex3]";
				wait for any key;
		else if calcnumber is 0:
			now sextablerun is 1;
			say "     You step back from the tied-up mink, shaking your head slightly as she gives a disappointed look.";
			wait for any key;
		else:
			say "Invalid Option. Pick between 1 and [the number of filled rows in the table of fucking options] or 0 to exit.";
	clear the screen and hyperlink list;

to say SashaSex1: [Pussy Fuck]
	say "     Deciding to take that succulent looking baby-maker, you move to Sasha's dripping cunt and slide your cock up and down the slut's slick velvety folds. The mink moans in pleasure, and you can almost feel the heat radiating from her cunt in anticipation of the fucking to come. Readying yourself, a lust-filled groan passes your lips as the [cock of player] shaft between your legs glides easily into the anthro's gaping pussy. The wet heat of the sweltering cave seems to soak into you as you bottom out. The mink moans with pleasure as her soft, silken pussy envelops your turgid cock. The sensation of your balls coming to rest against a twitching taint, signals that you have plunged yourself to the root.";
	say "     With your cock buried to the hilt, you grab the mink by the hips and begin fucking the slutty anthro in earnest. Sasha gives gasps of pleasure each time you bottom out in her dripping tunnel. While not the tightest cunt you've ever had the pleasure of fucking, it certainly is experienced. She uses every trick she knows to grip and wring your [cock of player] rod in what is a surprisingly animated cunt! It feels like you're fucking a high tech onahole, and Sasha clearly knows how to get the most out of any cock.";
	WaitLineBreak;
	say "     You groan and pant with lust, fucking the incredible slit harder and deeper as the satin soft pussy writhes around your cock. The mink woman is panting and crying out in pleasure as she manipulates your rod inside her. Thrusting with an inflamed eagerness you rapidly approach orgasm, and with a roar of ecstasy, cum erupts inside the lusty anthro's hungry pussy. Hips thrust flush against Sasha's pelvis, your seed pours into her waiting, clenching cunt. Your balls ache as the whore's heavenly vagina continues to work its magic on your cock, milking you for every drop of cum you posses.";
	say "     Shaking in the aftershock of your orgasm, you collapse on top of Sasha, your head resting comfortably on the moaning slut's pillow-like chest. 'Well lover, was is good for you?' she asks innocently as her soft walls suck one last spurt of semen from your throbbing pecker. Nodding, you slide out of the puffy lips, followed closely by a stream of steaming cum which pours into the bucket below. Thanking Sasha again, you collect your gear and head for the door.";

to say SashaSex2: [Anal Fuck]
	say "     Eager for a bit of anal spelunking, you move to Sasha's winking asshole and press your cock up against it, feeling it give just a little at the pressure. She moans in pleasure, and you can almost feel the heat radiating from the slutty anthro's cunt in anticipation of the anal fucking to come. Readying yourself, a lust-filled groan passes your lips as the [cock of player] shaft between your legs glides easily into Sasha's gaping asshole. The penetration is made easier by the copious amounts of cunt-juice dripping down from her neglected pussy. Both of you shudder with pleasure as the well-used asshole gives way to the pulsing cock claiming its depths. The feeling of your balls coming to rest against warm and furry cheeks, signals that you have sunk yourself to the root.";
	say "     With your cock buried to the hilt, you grab Sasha by her bound hips and begin fucking the horny woman's well-used ass in earnest. She gives gasps of pleasure each time you bottom out in the anthro's deep colon. While not the tightest asshole you've ever had the pleasure of fucking, it certainly is eager. Sasha uses every trick she knows to grip and wring your [cock of player] pole. It feels like you're fucking a high tech onahole, and the mink clearly knows how to get the most out of any cock.";
	WaitLineBreak;
	say "     You groan and pant with lust, fucking the incredible hole harder and deeper as the rectal muscles writhe and spasm around your cock. The lusty anthro is panting and crying out in pleasure as she manipulates your rod inside the engorged walls of her hot anus. Rapidly approaching orgasm, and with a roar of ecstasy, you unload your pulsing balls inside Sasha's clenching cock holster. Hips thrust flush against the soft pelvis, your seed pours into her waiting colon. Your balls ache as the whore's ass continues to work its magic on your cock, milking you for every drop of cum you posses.";
	say "     Shaking in the aftershock of your orgasm, you collapse on top of Sasha, your head resting comfortably on the moaning slut's pillow-like chest. 'Well lover, was is good for you?' she asks innocently as her tight anal walls suck one last spurt of semen from your throbbing pecker. Nodding, you slide out of the warm anal cavern, followed closely by a stream of steaming cum which pours into the bucket below. Thanking Sasha again, you collect your gear and head for the door.";

to say SashaSex3: [Oral Fuck]
	say "     It would be great to feel the anthro suck the cum out of your eager pecker, so you move to Sasha's drooling mouth and press your cock up against her pouty lips. It feels like the right choice when the woman's eager tongue slips out to circle the tip of your pre-leaking head. She moans in pleasure at the taste, and you can feel the heat of Sasha's breath as an eager mouth attempts to pull your rock hard member into it. It is easy to slide your [cock of player] shaft into such a willing cock holster, and Sasha's throat provides no resistance to the steady advance of your tool. You groan with pleasure as she provides the perfect amount of suction to your cock. Your balls come to rest against her nose, signaling that you have pushed as deeply as you're going to get for now.";
	say "     With your cock buried to the hilt, you grab Sasha by her exposed tits and begin fucking the whore's mouth in earnest. She gags each time you bottom out, but it doesn't deter you. The cock-hungry mink is certainly eager and she uses every trick she knows to suck and wring your [cock of player] rod for all she's worth. It feels like your cock is attached to a high powered milker as Sasha slurps and sucks on the tool like it's the only thing that matters in the world, and to the slutty anthro, it probably is.";
	WaitLineBreak;
	say "     You groan and pant with lust, fucking Sasha's incredible mouth harder and deeper as the woman's throat and tongue writhe around your cock. The mink is panting and moaning in pleasure around your throbbing tool. Rapidly approaching orgasm, and with a roar of ecstasy, you unload inside Sasha's welcoming gullet. Hips thrust flush against the smiling face of your hooker, seed pours into her open esophagus. Your balls ache as she continues to suck and nurse on your cock, milking you for every delicious drop of cum you posses.";
	say "     Shaking, you collapse on top of Sasha with your cock still nestled in her mouth. She gags and coughs up a glut of cum around your cock before you come back to your senses. Sliding out of Sasha's throat, you are impressed that not a drop is spilled. You apologize for forgetting you were still inside her throat, and thank the willing prostitute for everything, before collecting your gear and heading for the door.";

to say ShagShackSex6: [Shirley the ape]
	say "     Walking between the rows of beds and mattresses, you come to the corner of the brothel that doesn't have any whores that let themselves be pounded into the mattress or tied up. No, the 'performers' over here are far more confident - following incoming customers with hungry looks as they lean against the walls or lounge on their beds. Seems like they actually chose to work here, enjoying the nonstop sex and relative security from the chaos outside. A sexy female ape standing nearby draws you in with a lusty grin, followed by a wave of her furry arm to come closer. 'Hey there sexy,' she says in almost a purr and strokes her hand over the faux-hawk of hair on her head. 'You wanna have fun with Shirley, I can tell!'";
	say "     The bombshell of a woman got that right, that's for sure. Moderate in height with lightly muscled arms and legs, she has a pretty face in the almost-human way of an anthro chimp, with a fur-covered body to match. Her bright red tank top is stretched tight over a very generous pair of breasts and you can even make out the bumps of nipple piercings through the thin fabric. Further down, Shirley's flat and toned stomach is in full sight thanks to the belly-free top, showing a gleaming silver belly button piercing. The finishing touch to the outfit is a skimpy pair of black panties - made from a semitransparent material that shows off everything, including the fact that her nether lips are wet and ready in anticipation.";
	WaitLineBreak;
	say "     As you come to stand before her, the chimp reaches out and slides a hand behind your head, pulling you close for a demanding kiss. Her amber eyes gaze deep into yours as the dominant woman pushes her tongue between your lips in a French kiss, then eventually pulls back and smiles broadly at you. 'Yeah, I know what you want,' she purrs enticingly, then slides her fingers under the red top and pushes it up to bare her breasts. They are very nice and full, with stiff nipples that have large brown aureoles. Stud-piercings glisten at both nipples, drawing your gaze instantly. 'Go on. Suck them,' comes the command of the sexy ape as she pulls your head closer and down.";
	say "     More than ready to follow Shirley's instructions, you brush your lips over the warm skin of her breasts, then close them over the bump of a nipple and suck. A pleased sigh comes from the dominant ape and she strokes the back of your neck, telling you to go on. Nothing seems more natural than to suckle on the erect little nub, running the tip of your tongue over its firm flesh and tracing the harder outline of the piercing going through it. Both hands cupping her breasts, fondling and squeezing them, you switch up from one to the other with your sucking, servicing the horny woman and giving her obvious pleasure.";
	WaitLineBreak;
	say "     After a little while of enjoying your efforts, Shirley pushes you a little back from her breasts and smiles at you as she says, 'That's a good [if player is female]girl[else]boy[end if]. On your knees now - you may pull my panties off... with your teeth.' Helped along by a gentle push, you kneel in front of the sexy ape, bringing your face to the same height as her crotch. With your nose just an inch or two from the soaked material of the mesh undies, you can literally smell the heady scent of her arousal, drawing you closer. Brushing up against the wet fabric, you rub your face against it and Shirley's swollen folds underneath, taking deep breaths as you do so.";
	say "     Quite a heady aroma full of pheromones that makes you want more and more. Soon, you do as you were told and catch the rim of her panties between your lips, then teeth, and eagerly pull them down with your head. You do help a little with your hands at the back side, sliding the fabric straps over her firm behind with your hands to allow the underwear to fall to the ground. Looking up at the glorious female, your gaze wanders from her pussy over the flat stomach to those shapely boobs, then stop at her grinning face. 'Well done sweetie,' she purrs, lifting her leg to shake off the panties completely. She pats your shoulder with the hand-like foot on that leg and adds, 'Onto the bed now, you earned it!'";
	WaitLineBreak;
	say "     Seeing Shirley stride over to the bed, pulling her red top off completely in the progress and throwing it aside, you almost stumble in your eagerness to follow. Along the way to the bed, you strip in haste, throwing pieces of clothing and gear on the floor with every step. Naked by the time you arrive at the bed, you are greeted by the sexy simian woman who strokes your body appreciatively. Then she rubs herself up against you, breasts brushing over your chest as she turns the two of you - followed by a surprisingly strong push that sends you falling back on the bed. Landing softly, with your arms spread wide from a try to catch yourself, you're in exactly the right position for her to climb on top, her hands grasping your forearms to pin them to the bed.";
	say "     'I've been waiting for a happy little sub to have fun with,' she says with a grin and leans her head down, licking your cheek. 'You'll see how good it feels to give yourself to me.' With that said, she ";
	if player is male: [male and herm]
		say "pulls up one of her legs and closes a hand-like foot around the erect length of your manhood, stroking its length. 'Oh yeah, this'll be fun!' Shirley adds in a gleeful tone, then lowers herself on your cock, sinking her wet and dripping pussy over its firm pole. You moan in unison with her as you feel the nether lips spread around your dickhead, followed by the envelopment of her warm and tight pussy. Then the chimp's inner muscles flex around you, giving your cock a welcoming squeeze as the dominant simian grins down at you. 'Fuuuck! I like feeling that [cock of player] dick of yours!'";
		WaitLineBreak;
		say "     Keeping her hold on you, arms pinned down on the mattress, Shirley starts to ride your dick, grinding her hips against yours and bouncing up and down on the erection. The sensations of her fucking herself on your cock are breathtaking - literally, as you can't help but gasp and moan constantly from feeling her inner walls rub your shaft. Your partner gleefully grins down at you as she gyrates her hips and gives your manhood an extra-tight little squeeze from time to time, intermixed with lusty kisses she plants on your mouth. Such stimulating treatment doesn't stay without consequences and you can feel yourself get closer and closer to orgasm - winding you up so much that you struggle against Shirley's hold at one point.";
		say "     The desire to grab her as you thrust into the wet pussy on this sexy ape is almost overwhelming and you can't help but buck under her, trying to do just that. But no, she retains her firm grip on your arms, keeping them spread-out and pinned... and you can just see it in her face how much she enjoys her power over you. The female ape even slows her gyrations on your dick for a moment, teasing you mercilessly before she relents and gets back to enthusiastically riding your bucking hips. It doesn't take much longer of this before you reach the point of no return and let out a deep grunt as your cock starts to erupt into her, throb after throb of cum filling the simian bombshell of a woman.";
		WaitLineBreak;
		say "     Shirley actually lets go of one of your arms at that point, bringing her hand to her own clit and frigging it frantically as she groans, 'Fuck yeah! I can feel you inside me - filling me up! So goood!' Her obvious pleasure at having your spurting cock inside her together with rubbing her magic button serve very well to push the ape to a screaming orgasm, dominating this corner of the brothel for a moment. More than a few other customers look over towards the two of you, wishing they could be the boy-toy that the sexy woman was riding right now.";
		say "     The tight confines of her pussy suddenly feel even slicker as the ape comes and her femcum starts to flow, covering your shaft and even forming a small trickle that drips down onto your crotch. Grinding against your body without pause, Shirley rides her orgasm out and takes every last bit of pleasure she can from you, smiling happily down at your panting form beneath her. 'You've been a very good boy,' she says in a sexy purr, then leans forward and plants a demanding kiss on your lips, making out with you until the last throbs of cum ebb off inside her. After that, she still keeps straddling you for a little while, relishing in just pinning you to the bed and feeling the power she has over you.";
		WaitLineBreak;
		say "     Eventually, Shirley slides herself off your softening shaft and flops on the bed, lying on her back. 'You may go now,' the ape grunts in a more than content tone and pats your side. Seems like your time with this simian mistress is over and there is no chance for a nonstop fuck-fest to go on right now. Of course, that doesn't mean you can't come back another time and get a fresh dose of the ape's sex appeal and discipline...";
	else: [female and neuter]
		say "moves herself up over your body, bringing her crotch right over your face. 'Lick me,' Shirley says next in a clear command, grinding her pussy against you. Obediently serving the sexy ape, you do stick out your tongue and lap over her sex, then deeper between the wet and dripping nether lips. 'Yesss,' she moans in pleasure, as you work your tongue to service Shirley, switching up between wiggling it in her pussy and suckling on the sensitive clit above. Then you suddenly feel a touch against your own crotch, stroking it. Did someone else climb on the bed with you? No - you realize that it is the ape's hand - she must have switched to holding one of your arms with a hand-like foot at some point and is now leaning back to touch you.";
		say "     The sexy ape repays your eager service by rubbing your sensitive parts, with the amount of stimulation she gives you directly proportional to how good you take care of her. Thus your shared coupling of oral sex and fondling results in a rapid build-up of arousal and lust, until she eventually grinds her crotch against you hard, then shudders in orgasm. Femcum starts to flow, trickling over your tongue to reach your taste buds, then eagerly swallowed by yourself. Grinding against your body without pause, Shirley rides her orgasm out and takes every last bit of pleasure she can from you, smiling happily down at your panting form beneath her. 'You've been a very good pet,' she says in a sexy purr and keeps straddling you for a little while, relishing in just pinning you to the bed and feeling the power she has over you.";
		WaitLineBreak;
		say "     Eventually, Shirley stops straddling your chest and holding your head between her thighs, then and flops on the bed, lying on her back. 'You may go now,' the ape grunts in a more than content tone and pats your side. Seems like your time with this simian mistress is over and there is no chance for a nonstop fuck-fest to go on right now. Of course, that doesn't mean you can't come back another time and get a fresh dose of the ape's sex appeal and discipline...";

to say ShagShackSex7: [Ty the human breeder]
	setmonster "Human";
	choose row monster from the Table of Random Critters;
	say "     Walking between the rows of beds and mattresses, you come to the corner of the brothel that doesn't have any whores that let themselves be pounded into the mattress or tied up. No, the 'performers' over here are far more confident - following incoming customers with interested looks as they lean against the walls or lounge on their beds. Seems like they actually chose to work here, enjoying the nonstop sex and relative security from the chaos outside. A slender human male leans against a wall nearby and attracts your attention with the simple fact that he is still fully human, with no sign of any physical change on him at all. Due to everyone else changing wildly these days, his 'regular' appearance makes him exceptional all of itself.";
	say "     Not that the young guy isn't attractive either - tall and quite slender, he is dressed in shorts and a black t-shirt with the logo of some band on it. His fairly handsome face shows boyish charm as he smiles at you from under a somewhat tousled blond page-boy haircut. 'Hey there,' the young man greets you with a wave, then steps up and gives you his hand to shake. 'I'm Ty, nice to meet you. Erm... I hope it's the first time at least - gotta admit that it's a bit hard to keep track with everyone else shifting so often,' he tells you, blushing a little bit and raising an arm to scratch the back of his neck. 'Anyways - to answer the usual questions: Yup, I'm a hundred percent pure human. Haven't changed one bit. And I can give you what you want - pretty much every kid I fathered was human. Down to the blue eyes in most cases too. Even those that hatched from eggs and whatnot.'";
	WaitLineBreak;
	say "     Ty brushes a strand of blond hair out of his face and gives you a friendly smile, underlain by a definite amount of lust. Seems like he hit the jackpot during the nanite apocalypse - not changing at all and becoming a sought-after commodity because of that. Joining the crew of this brothel has been good for him too, providing protection and as much sex as a young man can stand - and his balls produce cum for. You get a very laid-back and friendly vibe from him... explaining why the slender guy is a very popular baby-daddy in these parts by now. Hell - you picked him to have fun with yourself.";
	say "     Stepping up to the attractive blond male, you put a hand on his crotch and feel the bulge he has there - respectably sized, that's for sure. He reacts in kind, touching and stroking your body, then leaning in to give you a peck on the lips. As your lips part again a few heartbeats later, Ty whispers more to himself than you, 'I can't believe I'm doing all of this sometimes. Hell, before you came in I had [one of]an anthro tiger[or]a freaking caveman[or]a dragon-lady[or]a giraffe[or]a living statue[or]a feral-looking dog[or]a cute cat-girl[or]an actual dolphin[or]a goo-person[at random]... which was pretty cool, actually.' Putting your hand back on his crotch and squeezing it a little, you pull him out of his reverie, focusing Ty's attention back on yourself. He gives you another cute blush, then nods toward the nearby bed and says, 'Let's have some fun!'";
	WaitLineBreak;
	say "     Following the young human, you watch Ty as he pulls off his t-shirt and casually throws it aside, revealing his slender chest and flawless white skin. Seems like his usual customers love seeing an example of the humanity they themselves lost, as he drops his shorts and then gives a little twirl in just a skimpy pair of briefs, showing his body off to you. 'Touch me if you want,' he tells you with a smile and reaches out to take your hand, setting it on his hips. Happy to do so, you let your hands wander over his body, stroking over smooth skin and teasing the young man's small pink nipples a little, then eventually returning your hands to his hips and hooking your fingers under the underwear that is Ty's only remaining article of clothing.";
	say "     The young man grins as you pull the briefs down, revealing his respectably sized manhood that had been showing as an elongated bulge. Freed from its confines, the erect cock swings up to stand proudly over Ty's pair of well-developed balls. His crotch is hairless - smoothly shaved, like the rest of his body, completing the image of a modern American male. The blond guy wraps his hand around his cock and strokes it a few times in deliberate slowness, showing off his best piece proudly. 'Time for you to join me,' he adds in a cheerful tone a moment later, then starts to tuck at your clothes and helps you strip down to your [skin of player] skin. With the two of you now standing naked in front of his bed, Ty lets his gaze wander up and down over you.";
	WaitLineBreak;
	if player is female: [female + herm]
		say "     Eyes drawn towards your crotch and the folds of your pussy, Ty leans forward and places his hand on you in a gentle stroke. His fingers trace the outline of your pussy, brushing against the nether lips and even dipping slightly between them, then move on to your clit, rubbing it in circling movements that make your knees go weak from arousal. You can't help but moan out loud and hold on to his shoulders with your hands. 'Yeah, I know what you need,' he Ty says with a chuckle and guides you to get on the bed, lying back with your legs spread wide. With a confident smile on his face that speaks of a man in his element, the blond young man climbs on the bed right after you and gets on all fours, then leans down to get his face close to your crotch.";
		say "     The naked human male gives you a boyish grin and says, 'Just relax and enjoy,' before licking over your sex in a slow stroke of his tongue. He clearly is quite experienced in pleasing women, having had many visitors of all sorts of species since he started working here. You moan in pleasure as he laps at your pussy, teasing the nether lips for a little while, then pushing his wiggling tongue in between them and exploring your womanhood. Finally, he moves on to the sensitive clit up above, brushing the tip of his tongue over it again and again, then even closing his lips around the little bump and giving it a few gentle sucks.";
		WaitLineBreak;
		say "     You can't really tell how long he keeps at it with his oral stimulation, writhing on the bed as pleasant sensations rock your body. One thing you definitively know - you're enjoying of every last moment of it. There is something so sexy about just giving in fully to an eager partner, relaxing on a big double bed as he pleases your body... oh fuck, you don't want it to end! Eventually Ty does pull back from you after a last glorious lick from bottom to top of your sex, leaving you panting and hungry for more. Yet before you can raise your head and voice those desires, there is something else at your crotch - a warm shape brushing against your skin.";
		say "     Pushing yourself up on your elbows, you see that Ty is kneeling between your legs now, hard cock in hand and lining himself up. Then he inches forward again, nudging your folds apart with the tip of his cock and sliding in between them. The young man lets out a satisfied grunt as he pushes into your body, filling your pussy with his glorious cock - its mushroom head spreading your passage around it. Smoothly, he penetrates you all the way until his balls are resting against your crotch and the head of his erection nudges your cervix just a little bit. Being inside you balls-deep now, the slender young man leans forward to make out with you while you get used to the size of his cock, then starts slow thrusts a little while later.";
		WaitLineBreak;
		say "     Ty goes on to push himself upright again, looking down lustfully at your naked body as he slides in and out of your pussy. 'You're one sexy babe,' he tells you in an aroused tone and puts two fingers back on your clit, rubbing it in turn with every thrust of his cock. Stimulating you inside and out like that, the young man proceeds to go faster and faster afterwards, building up a good tempo for fucking. You can't help moaning like a bitch in heat as your blond-haired lover soon pounds into you at a rapid pace, hammering your pussy again and again. His long cock rubs your inner walls so very good, brushing against many sensitive pleasure-spots that make you tremble in lust. The energetic male fucks you like a man possessed and practically goes wild as you try squeezing your inner muscles around his cock. 'Fuck. Fuck! FUUUCK! This feels great!' he shouts in a full-throated voice, his hands hooking under your thighs to hold on to you for even harder thrusts.";
		say "     His gaze is full of lust as it takes in your naked body while he ruts it, panting breathlessly from the strenuous exercise. After a little while longer of wild, no-holds-barred fucking, you can feel your young buck getting close - he keeps ramming his shaft in as far as it will go, then pauses for a second or two, during which time you can feel his erection throb with pre-cum leaking into your depths. Being almost at the point of no return yourself, you hunger for every further thrust into your pussy, relishing in the push of his hard shaft against innermost barrier too - damn, he could almost be fucking your womb. In this lust-drunk state, you soon decide that his amazing cock should just stay inside you for good and fill you out so very well - so you clamp your legs around his hips and pull him in tight, at the same time as squeezing his erection with your inner muscles.";
		WaitLineBreak;
		say "     'NNnnghhh! So good!' the human male gasps out in an urgent tone, followed by an almost shouted grunt. Ty's grasp on your legs tightens as he holds on for dear life and grinds his hips against your crotch while his cock erupts deep in your pussy. Spurt after heavy spurt of cum paints your insides white and starts to trickle into your womb. Only a few heartbeats after Ty, the sensations drive you over the edge too, [if player is male]and your manhood sprays long strings of cum all over your chest[else]and you tremble under him, your pussy dripping femcum[end if]. Ty and yourself ride out your joint orgasms together - holding on to one another, touching and stroking while you pant for breath and one of you is bred with a quite big load of virile cum.";
		say "     His hand slides down to your belly an comes to rest just over your navel, then the young man says, 'Fuck yeah. I love this job. Hope that knocked you up baby. And if it didn't... come back for another round. It's satisfaction guaranteed from yours truly. I'll gladly keep pounding you till you swell with my kid - and afterwards too...' He stays inside you and keeps his hand on you for a little while longer, then slowly extracts his softening cock from your pussy, watching with interest how it gapes open in the shape of his cock and starts leaking some of his copious amount of cum.";
		WaitLineBreak;
		say "     No longer impaled on Ty's slender but long erection, you lie on the soft sheets as you try to catch our breath. Your freshly-bred pussy keeps leaking cum for a little while longer, then you feel something brush over it - a towel, held by Ty that he uses to gently clean you up, wiping away sweat and cum. He smiles down at you as he does this and sometimes strokes your curves too, clearly enjoying this wind-down of the action. Finishing up by leaning over you and planting another kiss on your lips, he then stands up again and gets dressed - watched by you as you push yourself up on your elbows. Once the slender guy is clothed in his usual attire, he helps you up from the bed with an offered hand. 'That was fun,' Ty says with a smile and pats your shoulder before adding, 'I wouldn't mind another round or three. But please, do clear up things with Jerome first, okay? This is my job after all, and I'm not allowed to give freebies...'";
		if player is impreg_able: [can become pregnant]
			say "[fimpregchance]";
			if player is impreg_now: [has become pregnant]
				add "Human Carrier" to feats of player; [human baby, no matter what]
	else: [male + neuter]
		say "     Noticing your[if player is male] dick and the[end if] absence of any sort of pussy, he raises an eyebrow and says, 'Oh? Normally I get those horny women who want to get a cute pink-skinned baby. I mean...' [if player is mpreg_ok]You interrupt him with a raised hand, telling the young man with a broad grin that one doesn't necessarily need a pussy to get pregnant. His eyes go a little bit wider as he looks at you and says, 'Ooooooh! I don't know why I am surprised... hell, I've fucked all sorts of people by now. So what's a little guy on guy action besides that.'[else]You interrupt him with a raised hand, telling the young man with a sly smile that you couldn't resist feeling the cock of such a sweet dude like him up your ass. 'Oooh! I - er, I'm glad you think so. Got a few gay friends actually, though I never really did anything with them except getting a blowjob once. But now... hell, I've fucked all sorts of species by now, so what's a little guy on guy action besides that.'[end if] With a chuckle, Ty guides you to get on the bed on all fours, ass raised a little.";
		say "     The naked human male swings by his 'neighbor' in the brothel, borrowing a bottle of lube, then moves to kneel on the bed behind you. With a click, he opens the bottle and squeezes out a dollop of slippery goo on his fingers, then dabs that between your buttocks. Stroking his slick fingers over your pucker, he feels the wrinkled ring experimentally, circling it with a fingertip, then goes on to push against it gently. He pauses for a second as you gasp when your muscle relents and allows him in. 'Does that feel okay?' comes the typical question of a novice to anal sex, to which you give an eager moan in reply. This gives Ty greater confidence in fingering you and he goes on to sink his whole digit into your body, up to the knuckles.";
		WaitLineBreak;
		say "     Ty goes on to finger your insides, pushing in and out faster now and bending it to stroke sensitive spots. He seems glad that the treatment meets your approval and is smiling as you turn your head to look back at him, then tell him he can actually use more than one finger. Blushing, the young man's eyes go wide as he replies, 'Oh! Of course!' Happy to follow your request, he fills your hungry hole with two fingers, then three after a little while of playing around with your gradually stretching asshole. Finally, when you're well and truly lubed up and your pucker as relaxed as it is gonna get, you groan out for him to take your ass right away.";
		say "     Eager fingers guide his erect human cock forward and Ty rests his manhood between the buns of your rear end, looking down at it and your naked body. 'I could definitively get used to this,' the young man says as he lines himself up with your hole, then pushes in, stretching the readily expanding muscle around his cock. 'Fuuuck yeah!' he grunts as his cock sinks deeper into the warm and tight embrace of your inner passage. Ty's restraint wears thin at that point and he gives in to the relatively novel sensations of fucking someone's ass and thrusts hard, bottoming out the rest of the way in one quick movement that makes his balls smack against your body.";
		WaitLineBreak;
		say "     You can't help moaning like a bitch in heat as your blond-haired lover proceeds to pound into you at a rapid pace, hammering into you again and again. His long cock grinds against your prostate with each thrust, pushing your arousal hard and prompting you to lower your front end even further as you brace against the energetic young man as he fucks you like a man possessed. 'Fuck. Fuck! FUUUCK! This feels great!' he shouts in a full-throated voice as you squeeze your inner muscles around his cock. Then Ty leans forward and wraps his arms around you from behind, embracing and touching your naked body as he ruts it, panting breathlessly against your back.";
		say "     After a little while longer of wild, no-holds-barred fucking, you can feel your young buck getting close - he keeps ramming his shaft in as far as it will go, then pauses for a second or two, during which time you can feel his erection throb with pre-cum leaking into your depths. Being almost at the point of no return yourself, you hunger for every further thrust into your ass, relishing in the push of his hard shaft against your prostate. In this lust-drunk state, you soon decide that his amazing cock should just stay inside you for good and fill you out so very well - so you clamp your hole tight as a vise around Ty's erection on his next deep thrust.";
		WaitLineBreak;
		say "     'NNnnghhh! So tight!' the human male gasps out in an urgent tone, followed by an almost shouted grunt. Ty's arms tighten around your chest as he holds on for dear life and grinds his hips against you while his cock erupts deep up your back passage. Spurt after heavy spurt of cum paints your insides white and the young guy's shaft throbs hard against your prostate with every one of them. Only a few heartbeats after Ty, the sensations drive you over the edge too, [if player is male]and your manhood sprays long strings of cum all over the sheets of his bed, adding on to various other cum-stains.[else]and you tremble in his embrace as your whole body is rocked by your orgasm.[end if]";
		say "     Ty and yourself ride out your joint orgasms together - holding on to one another, touching and stroking while you pant for breath and one of you is bred with a quite big load of virile cum. [if player is mpreg_ok]His hand slides down to your belly an comes to rest just over your navel, then the young man says, 'Fuck yeah. I love this job. Hope that knocked you up dude. And if it didn't... come back for another round. Its satisfaction guaranteed from yours truly. I'll gladly keep pounding you till you swell with my kid - and afterwards too...' [else]His hand slides down to your crotch and gently wraps around your spent cock, giving it a few gentle strokes as the young adult says, 'Fuck yeah. I love this job. All the pussy I can fuck, and sexy dudes too. Damn, does it always feel this great? Guess I should have taken Kamir up on the offer last new year's eve...' [end if]He keeps holding you like that for a little while longer, then slowly extracts his softening cock from your ass, watching with interest how its hole gapes for a few seconds, then squeezes shut before opening again, 'winking' several times like that before it settles down to staying mostly closed.";
		WaitLineBreak;
		say "     No longer impaled on Ty's slender but long erection or held in his arms, you sink forward on the bed, panting into the soft sheets as you try to catch our breath. Your freshly-bred ass stays raised as it was for a little while longer, then you roll over and lie on your back, propped up on raised elbows to watch Ty rub himself off with a soft towel before holding it out for you to use too. While you yourself clean up as much as you can, the young man gets dressed in his usual attire, then helps you up from the bed with an offered hand afterwards. 'That was fun,' he says with a smile and pats your shoulder before adding, 'I wouldn't mind another round or three. But please, do clear up things with Jerome first, okay? This is my job after all, and I'm not allowed to give freebies...'";
		if player is impreg_able: [can become pregnant]
			say "[mimpregchance]";
			if player is impreg_now: [has become pregnant]
				add "Human Carrier" to feats of player; [human baby, no matter what]

to say ShagShackSex8: [Penny]
	project the Figure of Penny_icon;
	say "     Walking towards the place where the anthro rottweiler has her bedding on the wide open sales floor of the former mattress store, you see her previous client (a [one of]slender crane) put on a his white briefs[or]massive black bear) pull up his heart-covered boxers[or]manly lion) put on a small black speedo[or]scaly herm drake) hike up her silky red g-string[at random] then pat the freshly fucked canine on the head. Wagging her stubby black tail and staying in character for pet-play, the canine bitch gives a friendly lick in response. With a mild chuckle the customer leaves her after that, giving you a thumbs-up as you walk past. Left behind, the rottweiler sits on the floor near the base of a queen-sized mattress with a doggy bowl and a canine dildo with an inflatable knot close by. Around her neck, she has a spiked dog collar which is hooked to a long leash tied around one of the bed-posts. The name Penny is emblazoned on the dog tag.";
	say "     When the John is far enough away, the attractive woman pushes herself up from the pose on all fours for a moment, stretching her arms and legs and looking around until she spots Jerome's assistant. Then the domestic canine calls out, 'Kaden I'm parched, can I get another refresher?' The cat-boy heads over and pours about half a bottle of creamy white orc cum into her bowl, then leaves after getting his hair tousled by the thankful prostitute. Dropping back to all fours, Penny leans down and starts to lap up the viscous fluid. After a couple of gulps her muscles visibly tighten up for a second then relax as she lets out a small moan. With the somewhat turned-around position in which she sits down next, you get a prime view of her naked form - heavy D cup breasts swaying in the air and a curvy booty. As you start to walk over, the black and brown coated rottweiler perks up an ear to follow the sound.";
	WaitLineBreak;
	say "     When you approach Penny's mattress, she greets you with a happy woof and a wag of her small tail. Then she pads closer on all fours and gives your body a thorough sniffing, focusing heavily on your crotch. It seems like she puts on the act of being a slutty pet when she is with a customer. Sitting on the mattress you begin to pet her black and brown fur coat. As your hands graze her ample breasts, she gives your forearm a couple of licks to encourage further touching. Happy to comply, you begin to grope and squeeze her breasts and trace a finger around the aureoles of the of the nipples. Letting out some satisfied moans at getting groped, the aroused rottie tilts her hips to give you a better view of her spade-like canine pussy. One of your hands strokes down the small of the turned-on doggy's back, over her shapely buttocks and around the canine's damp cunt.";
	say "     With a salacious grin on your face, you ask if she likes being a nice puppy and having her masters touch her - and Penny immediately nods her head and gives an affirmative bark. Teasing the bitch by running your fingers just along the outside of the heated folds of her sex, you playfully state that your puppy seems to be perfectly happy with just this amount of stimulation. Chuckling at the way Penny holds her breath when you stroke towards her clit, then stop before touching it, you add that she surely has no need for more. Turning her head to look firmly into your eyes, Penny begins wiggling her waist, yaps a couple of times in an imploring fashion that reminds you of a dog impatiently waiting for their master to go for a walk.";
	WaitLineBreak;
	say "     Not wanting to deny this needy bitch's needs any longer, you insert two of your fingers inside her and stroke her inner passage. The dog slut's warm pussy clenches down on your digits quite tightly, which is surprising given her line of work. Starting off with a slow sensual pace, you slide your fingers in and out of her damp cunny. As you increase the speed of your motions the black and brown coated femme starts to have trouble keeping her composure. Panting with her tongue lolling out the side of her mouth, she rocks against your touch, eager for more. Seeing the canine tart moaning due to the skillful use of your hands, your cock starts rise. Noticing this, Penny's eyes fixate on your [cock of player] rod and she whimpers, pawing the air to show she wants it. With a broad grin on your face, you pull your hand from her pussy and ask if the doggie wants a bone to lick. Letting out a couple of needy whines and chuffs as a reply, your pet for hire shows her desires with great exuberance.";
	say "     Removing any gear or clothing from the lower half of your torso, you spread your legs and tell the bitch that she should start going down on you if she wants her treat. Licking her lips, the anthro rottweiler bounds forward and laps over your crotch, then focuses on the length of your dick. Beginning with a couple of swirling licks on the tip of your cock, Penny draws strings of pre-cum into the air that connect your rod with her tongue. Next, she does slow licks up and down the underside of your shaft from the base to the head. This starts to take longer as you grow more and more erect. Before long, the sexy bitch also switches up with focusing on your [ball size], lapping and sucking each nut individually. [if player is female]Noticing you have more than just your rod that needs attention, she licks and laps at the folds of your pussy. [end if]But as good as that feels, your cock is aching for attention from the dog's mouth.";
	WaitLineBreak;
	say "     Placing two hands on the curvaceous rottie you guide her head back to the tip of your shaft. With your hands on the back her head, the eager bitch starts to fellate you. By the way she goes deeply around your cock from head to base you can tell that this doggy whore has had plenty of experience. Your sexy canine bobs her head up and down with smooth motions and lets her tongue play over your shaft. Exhaling short panted breaths, you murmur what a good girl she is and stroke the top of her head. This affectionate praise causes Penny to smile and give a very garbled woof in response. A small trickle of femcum runs down the inside of her digitigrade hind-legs and you can smell the scent of canine arousal hanging heavily in the air. Leaning in close to the leaking Rottweiler's ear, you whisper that she surely will want the bone she is sucking buried in her welcoming hole. With a loud slurp, the prostitute stops sucking your penis and hops on the mattress.";
	say "     Having assumed the proper position for breeding, Penny has her hindquarters raised high, showing off her spade-like canine pussy that is clearly aching to be stuffed. Eager to do just that, you line your slick shaft up with her eager and willing cunny, then thrust forcefully into the bitch. The Rottweiler's short tail is wagging furiously as you do so, showing just how turned on the doggy femme is. Rocking your hips, you speed up the pace and Penny starts to howl and moan like the needy bitch that she is. As you bottom out your partner has a little trouble keeping up the act of being a simple-minded pet and starts to clamp one paw-hand over her own muzzle, trying to keep in any lustful shouts of how much she likes this and to fuck her harder.";
	WaitLineBreak;
	say "     Chuckling at the rottie bitch's antics, you decide to turn up the heat even more - shifting your hips to a new angle, you pound into her as fast as you can. Jackhammering your cock into the well-fucked pussy, you can tell that an orgasm is close for the rottie whore by the way her pussy is pulsing. Then with one last final thrust, the doggy slut climaxes. Fem-cum covers your dick and drips onto the mattress. Your curvy partner's body trembles, her thighs quiver, and her breaths come at a staggered pace. Dropping her head to rest against the well-worn mattress, she catches her breath by panting loudly, her tongue hanging out of the side of her mouth. Softly petting her back haunches, you can feel any tension in her muscles release. Massaging the woman's wet cunt you ask confidently if she enjoyed getting her bone - and the panting dog responds with a garbled bark of approval.";
	say "     While this is all going on, your cock is rock hard and begging for release. You could just keep going and fill her with another load to mix with those of her previous customers, or... looking down at her doggy bowl you come up with a different idea. Pulling your cock out of her wet snatch, you hop off the bed and grab the metal bowl, holding it under your [cock size desc of player] rod as you jerk yourself off. Turning around to stare at you because you stopped fucking so suddenly, Penny cocks her head and utters a curious but fatigued chuff. Well lubricated by the potent amount of femcum coating your shaft, stroking goes a rapid and thorough pace. Feeling a tingling in your balls, you get close to blowing your load - then come hard, throbbing thick spurts of cum right into the bowl. Soon it is filled with your [cum load size of player] load, after which you set the bowl down on the ground for Penny.";
	WaitLineBreak;
	say "     Pulling on the leash that ties Penny's collar, you prompt the dog to come over to you, making her sit next to the cum-filled bowl. With an impish grin, you tell her that dinner is served, and the pet rottweiler immediately lowers her head down to the bowl and slowly begins lick up your sperm. Based on the technique she uses to make the act a sexy show, she's really into such kinky acts too. After lapping the bowl clean, the pet anthro for hire takes a seat on the mattress next to you, allowing you to pet her while you recover from your orgasm. Once you feel rested enough to head back out into the city, you pat her head and tell her what a good girl she has been, then wave goodbye to the canine. With a beaming smile the sated doggy gives amicable bark and raises a paw to do a little wave.";

to say ShagShackSex9: [Bryce the wolftaur]
	setmonster "Wolftaur";
	choose row monster from the Table of Random Critters;
	if BryceFucked is 0: [no sexual contact with the taur before]
		say "     Walking among the many mattresses filling the floor, you find one with an inhabitant that catches your eye. Standing astride the mattress is a tall wolftaur, his large, canine lower body stretching behind him, complete with a distinctly wolf-like tail. His upper body is covered in soft gray fur, with a face that is definitely more lupine than human. Easily visible between his legs is a very large knotted canine dick, clearly erect. As you look back up, you meet his eyes - it seems he noticed your stares. The wolftaur grins at you and speaks. 'I think you've found what you're looking for. The name's Bryce. Care to join me?'";
		say "     You nod as you move up to the wolftaur, still enamored with his appearance. He gently takes a hold of you, bringing you fully onto the mattress and embracing you, the warm fur brushing tantalizingly against your skin. 'Since you seemed so interested in my cock, maybe you should give it a closer look?' he whispers, his mouth mere inches from your ear. His hands gently guide you along the path you would have taken regardless, as you fall to your knees atop the mattress, bringing your eyes level with the prize hanging below him.";
	else if BryceFucked > 0: [player blew him off before, or did other things]
		say "     Walking among the many mattresses filling the floor, you see a familiar face. Standing astride the mattress is a tall wolftaur, his large, canine lower body stretching behind him, complete with a distinctly wolf-like tail. His upper body is covered in soft gray fur, with a face that is definitely more lupine than human. Easily visible between his legs is a very large knotted canine dick, clearly erect. As you look back up, you meet his eyes - it seems he noticed your stares. Bryce grins at you and speaks. 'If it isn't my favorite cocksucker come to visit again. Care to join me?'";
		say "     You nod as you move up to the wolftaur, just as enamored with his appearance as before. He gently takes a hold of you, bringing you fully onto the mattress and embracing you, the warm fur brushing tantalizingly against your skin. 'Time to give a little more attention to my cock, isn't it?' he whispers, his mouth mere inches from your ear. His hands gently guide you along the path you would have taken regardless, as you fall to your knees atop the mattress, bringing your eyes level with the prize hanging below him.";
	WaitLineBreak;
	say "     Your arousal begins to peak, and you decide that your hands shouldn't be away from Bryce's glorious shaft any longer. You touch it gently, feeling the heat of his member, then begin to wrap your fingers around it. To your simultaneous dismay and delight, its girth is too great for you to grasp with a single hand. You simply cover as much of it as you can with your hands, before beginning to rub up and down the length, feeling the size between your palms, and feeling the shaft twitch and bob in response to your actions.";
	say "     You move one of your hands further down the wolftaur's member, until you reach the large ball-sack below it. Beginning to speed up your motions, doing as much as you can with the one hand remaining on his canine dick, you fondle his balls with the other, enjoying the full feeling between your fingers. 'I'm sure you have more you want to do down there, from how interested you were. Go ahead, suck my dick,' you faintly hear Bryce speak from above you. It doesn't take any more encouragement than that.";
	WaitLineBreak;
	say "     You move your head further under his tauric body, until his massive cock hangs close, the tip only the slightest distance from your face. Finally your mouth joins your hands in worshipping the canine member, the tip filling your mouth while you work the rest of the shaft and balls manually. You close your eyes and focus further, working your stretched lips further down the dick, the feeling in your mouth getting fuller even as your progress slows. Not long after that you come to your limit, the cock halfway down your throat, and you are unable to fit anymore of the shaft in as your nose bumps against his bulging knot.";
	say "     Determined to see this through, however, you begin to bob up and down fervently on as much of the shaft as you can fit into your mouth, still avidly supporting yourself with your hands, alternating each one between rubbing the knot and feeling up his heavy orbs. Soon you begin to feel his canine dick throbbing more and more, and a motion in his balls to match. Bracing for the peak you can see coming, you shove your face down his cock as far as you can go again, your lips meeting the knot. Not a moment later you feel his balls contract, as pulses of hot canine cum shoot down your throat repeatedly, the heady scent of his arousal and release filling your nose just as Bryce's sticky load fills your stomach.";
	WaitLineBreak;
	say "     When his orgasm ends, you pull back off of his canine cock, giving the tip one last parting lick, before climbing back up to your feet. Bryce looks at you, seemingly very pleased with your performance. 'You did very well at that, better than I've seen in a good while. Feel free to come back any time you're in the shack.' You find yourself smiling as you walk back out, the satisfying feeling of the load you swallowed the sole reminder of your enjoyable encounter.";
	if BryceFucked is 0: [no sexual contact before]
		now BryceFucked is 1; [player gave him a BJ before]
	PlayerEat 15;

[to say ShagShackSex10: [Feral Male Latex Fox]
	[See Dys/Feral Latex Fox.i7x]
]
to say ShagShackSex11: [Levi, by Weaveroflight]
	say "     Near the back of the store, you notice the familiar camouflage fatigues you've seen the army wear around here. What's filling them, however, isn't an average soldier. In place of a human male, you see a broad-shouldered tiger standing at attention, arms folded behind his back. His eyes instantly lock onto yours from across the room. They narrow at you, seemingly issuing a challenge. Steeling your nerves, you walk towards him. His gaze never wavers as you walk over, yellow-slitted eyes following your every move and twitch. When you finally make your way past the other disheveled beds full of moaning and writing creatures, his grin turns predatory. His teeth are sharp and angular, and his gaze is hungry. You avert your eyes, finding it hard to maintain eye contact with him.";
	say "     You scan over his bed, military-made somehow, even in the throngs of a whore house. No wrinkles, sheets tightened to a crisp, flat surface. If it wasn't for the dubious stains, you would wonder if the bed was untouched, but there is no mistaking the discoloration of the fabric. This bed has seen some use. 'Eyes up front,' he says with a calm, but dangerous, voice. Your head snaps back to look at his face. That grin is still there. 'I have a very particular way of pleasing my lovers. Few leave without a smile on their face,' he says, then pauses to look you up and down, seemingly stripping you of clothes with just his imagination. 'Even less leave able to walk straight. Do you understand what that means?' You dumbly shake your head. He chortles and shakes his head. 'It means that I'm in charge, and you do as I say, soldier.' He pauses again, removing his hat, before tossing it to the side. His ears perk up and swivel slightly, taking in most of the sounds around him with ease, before turning towards you. 'Now Strip.'";
	WaitLineBreak;
	say "     You are hesitant to listen to him, but something in his eyes says you don't want to ignore a command, so you begin taking off your clothes, albeit slowly. He rolls his eyes and marches up to you, claws taking your clothes and ripping them off, carefully slicing the cloth at the right places. You can't help but getting a bit angry with him for that. Your stuff is yours, and now you'll have to fix it. However, you notice that all it will take is some tape, or glue, maybe a bit of thread. He didn't tear into it like a wild beast, but rather just cut a strap here and there. Soon, due to his meticulous cutting, your clothes are pooled around you in record time. It seems as if the tiger has no patience. But after your clothes are off, he paces around you slowly. You swear that you can hear a faint growl from him. 'Stand up straight,' he reprimands with a slap to your bare ass. You jump and straighten your form. Coming up from behind, he pushes a boot between your legs and spreads them apart a little farther.";
	say "     'You need to have proper form if you're going to have me fuck you, and that starts with how you stand.' He chuckles as he nudges your feet just far enough to be uncomfortable, which causes you to squirm. He presses his body flush to yours and drags his clawed hands down your sides to grip tightly at your hips. He leans his head further in and runs his tongue over your ear. 'Sit still, soldier. No squirming.' You still yourself to the best of your abilities, and he purrs. 'Good job. Now, hands above your head.' You promptly do as he commands as his hands run up your side, claws dragging into your skin and scraping just hard enough to cause the sting of pain to follow his paws. 'That's a good job, soldier. I want you to hold that position, and do not drop your arms. You are not to cover or hide anything from me or anyone else here. If you do, this is over, and you'll have to try again later. Do you understand?' You open your mouth to speak, but before you can get any real words out, he wraps his hand over your mouth.";
	WaitLineBreak;
	say "     'Don't speak. It detracts from the moment. You will nod, and the only sounds you're going to make are strangled cries of pleasure.' You don't wait for the question that you know is at the end of that sentence and nod, knees already feeling weak. You can feel the grin against your ear. His mouth moves down to your neck and bites into the crook where you neck meets your shoulder. You gasp against his hand, and he takes the opportunity to invade your mouth with two of his fingers. They are long and nimble as he uses them to explore your mouth. They push against your cheeks, to the roof of your mouth, and play with your tongue. Every so often, he plunges them dangerously close to the back of your mouth, making you gag slightly. Every time you do, he laughs with a deep chuckle but doesn't push them in further. Due to the rest of his hand holding your mouth open, you aren't able to swallow, and your saliva begins to build, coating his fingers and dribbling down your chin.";
	say "     His other hand wraps around your chest and cups your [breast size desc of player] chest, claws harshly pinching your nipple. He twists it, and you let out moans that you can't control past your pried open lips. You feel the heat rush to your face, and you are sure it is tinted a bright-pink. Every noise comes out only slightly muffled by the tiger's hand, and since it is so firmly opening your mouth, you can't close it to try and hide anything. You can feel the looks of some of those around you, but you know that you're also getting hard at the sensation, your [cock size desc of player] [cock of player] cock stiffening despite your embarrassment. He whispers praises into your ear softly. 'That's a good soldier. Such a pretty thing, and so good at following directions. You want a reward?' You nod your head quickly, vaguely realizing how good every piece of praise makes you feel. Your chest swells and pushes into his touch, wanting to prove that you are a good soldier.";
	WaitLineBreak;
	say "     He pulls his fingers from your mouth and pushes you forward. You don't have time to react. The clothes around your feet, along with your balance already being messed up by your stance, cause you to tumble into the bed. 'Don't move,' he states plainly behind you before you have a chance to correct yourself. You can hear his heavy and purposeful steps slowly walking up to you. You swear that you can feel his presence looming over you before he even touches you. He places his claw-tipped hands on your inner thighs and pushes them apart. His claw-like nails dig into your flesh, causing a wince of pain, but you can't help but shudder as you feel the strong hands grip you tighter. He pulls you closer to the edge of the bed so that your legs are draped off the side, your cock is pressed harshly against the bed's corner, and your arms splayed out,. He takes both of his hands, one still drenched in saliva, and runs them up the back of your thighs, finally coming to rest on your ass. He lets out a low growl before kneading the mounds of flesh together.";
	say "     'Oh, that ass looks so good on you, soldier,' he praises. His thumbs dip down into the crevice of your ass and along the outside ring of your hole. Claws dip in and tease your entrance, causing you to gasp and shiver. You feel him shake in a silent chuckle. 'I can see that you're tense. Don't worry, I won't give you my cock until you're begging for it.' He laughs deeply and pushes one thumb against your entrance, massaging your ring roughly. This causes you to sigh deeply and actually begin to relax. His thumb plunges into you and pulls against your inner muscles. You let out a deep sigh as he twists it a bit to begin loosening you up. He pulls it out as quick as he put it in and gives your ass a hard swat, causing you to jump slightly. His hand goes back to your hole, but this time, he plunges his two saliva-coated fingers into you roughly and with little patience. His other hand collects your wrists, one at a time, and pins them behind your back. 'We wouldn't want you going anywhere while I work you through your physical training, now would we?'";
	WaitLineBreak;
	say "     Before you get a chance to ask what he means, he drags his fingers against your walls and slams them back in, crooking them into a spot that has you seeing white. You let out a groan of pleasure as his fingers massage what you are pretty sure is your prostate at this point. He leans down, putting pressure on your arm, and bites down into your neck rough enough to make you let out an involuntary cry mixed with both pleasure and pain, but he seems careful not to break the skin. He lets out a low growl and begins to push his fingers in and out aggressively while making sure to angle it to roughly pass your prostate every time. You cry out, squirming under him as your cock grinds into the bed. His fingers continue slamming in as he nibbles up your neck and to your ear, blowing hot air into it. 'Now, all you have to do is beg for it. Tell me you want it, and I'll give you a fuck you won't forget.' You can feel him grin against your ear as he twists his wrist and pushes in and out, not giving you a chance to think. All your brain is telling you is that it wants more, and it is absolutely screaming at you.";
	if player is dominant:
		say "     You simply growl at him and push your hips back against him. Enough is enough, and if you were paying him to fuck you, he might as well get on with it. It's not to say that you haven't enjoyed it so far, but he was pushing his luck. The tiger chuckles at your sudden, but probably inevitable, change in attitude. 'Fine, if that's how you want it, I guess we better get on with it, right?' You don't answer and only push back more aggressively against his fingers.";
	else if player is submissive:
		say "     You whimper and grind against his fingers with what little leeway you have. 'P-Please fuck me, sir! I'll do whatever you want,' you almost sob out. He's hitting all of your buttons, and you want, no, you need him to be inside of you. The tiger grins. 'And what do you want me to do?' A simple question for sure, but your mind races with so many opportunities and so many chances to do so many things. You shake your head. Those can come later. For now, you know what you need. 'I need you to fuck me! Slam your cock into me and make me your bitch!' He gives a wide and toothy grin before leaning down. 'Well, if you really want it, I will.'";
	else:
		say "     You give a low groan and try to push back, but find yourself unable to move much due to his hands. You don't know what to say really, but you know that you were supposed to try. 'I-I want you to fuck me, please.' Your ears pin in shame as the words leave your lips, but it does cause your cock to harden. He shrugs. 'Good enough for a try, soldier, but I'll expect better from you in the future.' You sigh in relief.";
	WaitLineBreak;
	say "     He removes his fingers and leans further in. You hear his zipper pull down and the ruffle of clothes. He nudges just close enough so that you can feel his warm cock sandwiched between your cheeks. It feels large, larger than you expected at least. It's hard to get a judgment on length, but it's easily as thick as the tiger's wrist. He gives a few experimental thrusts, the tip of his cock caught on the edge of your entrance that teases you with the possibility of entrance. You try to move your ass to catch it better, but he takes his hand that isn't holding your wrists and presses it down into your lower back. This causes your back to arch and your ass to stick out, limiting your movement. 'I choose the pace, so sit still,' he hisses into your ear. You open your mouth to respond but close it quickly and simply nod. You remember the rules. He bites hard onto your ear, likely as punishment for moving, and wiggles his hips slightly, moving the tip of his cock to your hole. 'Take a deep breath in, count to three, and then let it out.'";
	say "     It sounds like a simple enough, yet weighted, order. You take a deep breath in, and the next three seconds pass slowly. Each moment is drawn out as he simply rests his cock against your ass. Suddenly, as soon as you get to three and exhale, he punches his rod deep into you. You gasp out loud as he takes you roughly, his cock bottoming out in you in one thrust. You feel like that you were right about the thickness. The length isn't anything to sneeze at either, feeling like at least nine inches, maybe ten, was stuffed into your poor back door. Before you get a chance to take another breath in, he's pulling out, and you feel the barbs for the first time. Unlike feral cats, they aren't bony, but rather more like soft cartilage, making it feel rather interesting, pleasurable even. It certainly wasn't what you were expecting, and it made your ass clench around him, and your whole body shakes and shudders when the barbs drag across your prostate. He laughs. 'There's the look I was hoping for!' He suddenly thrusts back in and drags out slowly again just to draw a long moan from you.";
	WaitLineBreak;
	say "     He doesn't waste any time after that. He begins to build up speed at a quick rate, and soon, the smack of flesh upon flesh is heard over even your own moans. You can feel his balls slapping against your taint, your own balls still smashed against the bed. Your cock grinds over the soft fabric of the bed, and you squirm in his grasp, letting out a rapid succession of moans matching the pace of his wild fucking. Each time he pulls out, the barbs rake over your abused prostate, and you see white. His hand on your back presses into your skin, and you can feel his claw-tipped fingers dig into you slightly, causing you to wince and your hole to tighten. He purrs in delight as you clamp down around him, causing you to feel every pulse of his rod. He leans down as he continues to jackhammer your hole and bites down on the back of your neck. Growling into your skin, he angles himself to pound directly into your prostate rather than against it. You cry out in pleasure, the unexpected action bringing you close to orgasm.";
	say "     You cry out that you're close, hips humping into the sheets then back against him. He purrs in response, mouth still latched onto the back of your neck. His thrusts become shorter, trying to focus all of the pressure onto that pleasurable spot inside of you. It doesn't take long for this to tip you over the edge as your cock begins to pulse. Your [cum load size of player] load is fired directly into the sheets, causing them to become slick with cum. His thrusting doesn't stop, making your oversensitive cock run against the slick material. The pleasure almost makes you curl in on yourself as your moans get louder and your hole spasms around his cock. He lets go of your neck and lets out a roar that heralds the arrival of his climax. You can feel his cock pulse as it fires several jets of cum straight into you. It easily fills up your ass and spills out around his cock as he stays inside you, panting lightly. He begins to lick the mark he left on the back of your neck and purrs.";
	WaitLineBreak;
	say "     He pulls out of you with a groan, and the barbs scrape you the whole way out making you shudder. He steps away and wipes himself off a bit before leaning over and helping you up. Your legs wobble slightly, and you find yourself panting. 'You did a good job, soldier. Come see me another time if you want. I'd be more than happy to get you down in my bed again.' With that, he leaves you be and begins remaking his bed. [if player is dominant]While he bends over to fix his bed, you notice that Levi has a nice, round ass trapped in those BDU pants. Maybe some day soon you'll get a chance to get the tiger to become a nice kitty for you. [else]You simply nod, unsure of what else there is to say. [end if]Walking away with a slight limp, you notice that he was right. A smile spreads across your face.";

to say ShagShackSex12: [Ryan, by Mizu]
	if RyanFucked < 4:
		if RyanFucked is 0:
			say "     As you move through the myriad of beds and mattresses, a flash of something brightly colored catches your eye. As you move closer to inspect it, it moves, resolving itself into the form of a short, bright-eyed fennec fox clutching one of the cum-encrusted pillows in front of himself and watching the rest of the room. His breathing is unsteady, and as you close in, you discover that the young anthro is unclothed, a spot of sandy orange in an otherwise gray and off-white room. Deciding to give the little fox some company, you settle down on the opposite end of the bed. When the mattress moves under your weight, he turns around with a startled gasp, immediately blushing bright-pink under his fur and clutching his pillow a little harder.";
			say "     'I-I'm, sorry, ah... I... I didn't see you there. Sir,' the fox babbles, shivering. With a faint smile, you tell him to relax and watch as the fennec's large ears flatten. He does his best to take a few deep breaths, and when he looks up to speak to you again, his voice is a little steadier. 'My... name's Ryan, sir,' he tells you, his eyes fixing on your face. 'I'm... new here.' You smile and reach out with a hand to gently rub at one of his ears. You tell him that it's a pleasure to meet such a cutie, and you watch him shudder at both the touch and the praise. Now that you're this close, you can easily tell that the little fox is horny as hell - whether due to his surroundings, or something to do with the nanites, you can't quite tell.";
			WaitLineBreak;
			say "     Your voice teasing, you motion to the pillow and ask slyly if Ryan would like some help with that? Blushing furiously, yet with his eyes filled with need, Ryan gives a little nod. 'Y-Yes... please, sir,' he answers huskily. Grinning, you shuffle a little closer to him and wrap an arm around his small shoulders, tugging him up against you. In return, his death grip on the pillow loosens, and gently, you tug it away. The fabric shifts, showing off exactly why Ryan is so nervous - between his legs isn't the cock you expected, but a tight, furry cunt. It's already slick, hot, and slightly red. It dawns on you that he must be in heat and too shy to realize it. Putting a hand on his thigh and getting a shudder out of the fennec, you ask him if he knows what's happening to him.";
			say "     At your words, Ryan flushes, becoming even pinker. 'Well, I... I got, um... fucked by one of those monsters out there, and...' he swallows, 'ever since, I've just been... so... so horny. Nothing will do. I've tried my fingers, and-' You shush him, putting a finger on his lips. Swiftly, you move in and press your lips to his own, a muffled moan escaping from his throat. His body turns to putty in your arms, and you shift him around, lying him back on the bed, facing you. You tell him not to worry and that you know just how to fix it for a while...";
		else:
			say "     As you move through the myriad of beds and mattresses, a familiar flicker of color causes you to turn. Quietly, Ryan the fennec fox waits for permission to approach you, his paws clasped in front of himself and with a shy smile on his face. 'Hello again,' he greets you, softly, and at your gesture of approval, steps within your reach. Grinning widely, you reach out and tug him close, stroking over his large ears with your fingers. He shudders in your grip, and the scent of his arousal hits your nose. Chuckling, you push him away, just a bit, and peer down to his lower body. He's wearing feminine underwear, but there's a damp patch at the front, reeking of Ryan's juices. Teasingly, you ask him if he was waiting for you.";
			say "     Ryan squirms a little at the question and then gives a little nod. 'A-A little, sir...' he admits, slightly breathlessly. 'I've had a... couple of patrons since the last time I saw you, but you're the one that really... put the fire out, so to speak.' He swallows nervously, averting his gaze. You laugh softly and stroke a hand down his belly, making him gasp and suck his fuzzy tummy in a little. So he'd like some more help with his heat, would he? You'd hate to leave the little fox alone to deal with it... You run your fingers around the hem of his undies, and with a small, eager grunt, Ryan presses his hips into your hand. 'Y-Yes, please, sir. I-I need help again. I r-really need you inside me.' You smile and lead him to one of the nearby beds, telling him to strip for you, while you loosen your pants. Bashfully, Ryan nods and tugs his thin panties down and off, settling back on the bed and baring his soft, furry body to you, ready for you to fuck.";
		WaitLineBreak;
		say "     You slide your fingers around the little fox's thighs and lower your mouth to his now-drooling, eager cunt. Teasingly, you give a little kiss to the top of his pussy and listen as he groans out in need. His claws dig a little into the mattress below. A couple more kisses and a sly little lick makes him whine. 'S-Sir...' he moans as you draw back, licking your lips. Ryan tastes good, not too sweet, and the smell of his arousal is making you lightheaded. Gently, you nuzzle at his thigh and reach into your pants to pull out your rapidly stiffening cock. As you stand, towering over the tiny fennec on the bed, you let your pants fall around your ankles. Now bare from the waist down, you look into Ryan's glassy eyes and start rubbing the shaft of your cock up against his aching folds.";
		say "     'O-Oh, god, I...' Ryan manages, his voice thick with need. You lower yourself over him and silence him with your lips. Quickly, his arms wrap around you. Ryan pulls you towards him, his tongue eagerly and shamelessly meeting with yours. You kiss for a few long moments, and your hands slide down the fennec's sides, making him gasp, wriggle, and breathe out into your mouth. Ticklish fox. Grinning, you nibble on Ryan's lower lip, still hot-dogging his cunt with your cock. The heat down there is almost too much to bear, so when Ryan begs you breathlessly to enter him, you're only too happy to obey.";
		WaitLineBreak;
		say "     Gently, but steadily, you push your rod between Ryan's folds, letting out a small grunt of pleasure. Ryan arches his back, letting out a low, loud moan. You fix your hands around his slender hips, and when your cock has reached its hilt, you start to drive in and out slowly and firmly. With every thrust, Ryan lets out a needy whimper, his mouth slightly open, his eyes fogged over with pleasure. His arms are clutching around you with the same force as the stained pillow from before. You lower your lips and give his jaw a gentle bite, causing his claws to dig into your back.";
		say "     His cunt is as hot as an open flame. Effortlessly, you thrust in and out, the fennec ridiculously tight around you. You can feel the walls of his pussy drag against the sides of your shaft, Ryan shuddering with delight every time you move in and out. Unable to help yourself, you pick up the pace. The sounds of your lovemaking echo through the room. The fox, by now, is almost wild with lust, moaning out for you every time you shove yourself inside of him. He keeps his death grip on you and buries his nose in your shoulder, muffling his needy screams. All too soon, you can feel his body shudder in a telltale fashion, and he begs, 'S-Sir, I-I'm getting close, oh please, oh please oh please!' You keep a steady pace, not even close to done yourself.";
		WaitLineBreak;
		say "     With a choked up wail of pure bliss, you feel Ryan tense up underneath you. His pussy squeezes around your cock, forcing you to grunt in pleasure as the stimulation increases. As he cums, his juices lube up his cunny even more, filling your nose with the smell of his sex. Still, you keep up your steady thrusting. You can feel his orgasm drip down your balls and against his tailhole. Breathing heavily and trying desperately to recover, Ryan redoubles his grip on you, but you're relentless. Overstimulated, the fox begins to squirm. His needy moans are replaced with ragged whining and whimpering, but he still bucks up against you, eager for more.";
		say "     Before long, you're getting close yourself. You quicken your thrusts, your teeth finding Ryan's jaw again. You wrap your arms around him yourself and suddenly hoist him up, holding him there with his cunt clamped around your shaft. The tiny fox is almost weightless, and with both of you holding him up, you begin to pump into his womb in earnest. The results of his previous orgasm start to drip down your leg. As you fuck him, Ryan begins to moan again, his claws digging into your shoulders, his ears flattening. He makes a few strangled noises, as if trying to speak, but all that comes out is slutty panting and whining.";
		WaitLineBreak;
		say "     Eventually, and with a deafening sound of pleasure, it all proves too much. You sink your cock as far as it will go into the slutty bitch you're holding, and as he groans, you empty your balls inside of him. The orgasm rages through you like a tsunami, causing your limbs to tremble and tense. Contentment wells through every part of you for a few long moments, and dimly, you realize that Ryan is going through something similar. Mindlessly, you hold onto one another as you ride it out.";
		say "     Your vision finally clears, leaving you tired and shaky. Ryan is still weakly holding onto you, and with a tired smile, you give him a kiss on the cheek. The exhausted fox barely reacts, and with a soft chuckle, you lift him onto the bed. His pillow goes underneath his head, and you slowly draw out of his cunny, letting him leak onto the mattress. Still though, he clutches you, and looking down at him, you realize that you haven't the heart to draw away - and really, what damage would a brief nap do? You settle down behind him and cuddle up with him, making him give a small sound of contentment.";
		WaitLineBreak;
		say "     Slowly, you wake. Ryan is still fast asleep next to you, but as you begin to move, you feel him shift and turn his head to you. Sleepy eyes meet your own. 'Thank you, sir,' he says, and you lean down to affectionately kiss his nose. You tell him that it was your pleasure. Though unwilling to leave the warmth of the bed, you decide that you've been here long enough. Carefully, so as not to disturb the sleepy fennec, you untangle yourself from him and go in search for your pants. Putting them back on, you give him one last look and smile as you leave the brothel.";
	else if RyanFucked > 3:
		if RyanFucked is 4:
			say "     You look around the myriad of beds and mattresses, looking for that now very familiar flash of color. To your surprise, you don't find it immediately and have to wander around all the cum-stained beds and sexed-up occupants. As you slowly gaze around the room, you hear a recognizable moan from the corner. Curious, you go over to investigate, and to your amusement and surprise, you see the sandy-orange fox on his hands and knees. Standing behind him and roughly pounding into his cunt is a powerful-looking dragon. From the cum leaking down his legs and pooling on the mattress below, you guess he's been at it for hours, with potentially dozens of partners. You circle the bed and kneel down in front of him, playfully greeting him despite the fact that he's being plowed like a bitch.";
			say "     At the sight of your face, Ryan gives a soft squeak of shock, and his face immediately blooms bright-red. 'S-Sir!' he manages, gasping. You reassure him that it's fine, and that you hope he's having fun. At your teasing tone, Ryan groans again and nods. 'Y-Yes... oh... oh god, yes...' With another playful smile, you reach down and loosen your pants. It seems he might be a little busy back there, but perhaps he'd be willing help you out in his own way. You gently press your rapidly stiffening cock against his lips, and he resists for only the merest moment, out of shyness if nothing else. The dragon gives an almighty thrust, and as Ryan instinctively opens his mouth to moan, you shove your cock into his mouth. You tell him that he's a good boy and stroke across his ears affectionately.";
			WaitLineBreak;
			say "     Still blushing like a whore, Ryan slowly, inexpertly begins to suckle on your shaft. You quickly stiffen inside him and encouragingly continue petting his ears, even as his partner pounds into his cunt. It doesn't take long for the fox to get into it, rocking back and forth along your rod in time with the thrusts at his pussy. His mouth is warm around your cock, and the little sounds he makes every time his insides get hammered makes it all the more amazing. You move one hand to the back of his head, directing and controlling his muzzle. You can feel your pre leak out onto his tongue - eagerly, the slut drinks it down.";
			say "     As Ryan services you, the dragon picks up the pace. Quickly, he beats his dick into the fox's pussy, and before long, with a thunderous, booming growl, he dumps his seed into Ryan's belly. Cum blasts from Ryan's nethers to join the rest dripping down his legs and on the bed beneath him. The fox pulls off of your cock to moan his appreciation, and with a faint grin to you, the dragon pulls out. 'All yours, lover boy,' he tells you, giving the fennec a pat on the rump. Dripping with cum, Ryan looks up at you, licking his lips, and suddenly tugs you down onto the bed properly.";
		else:
			say "     You look around at the myriad of beds and mattresses, now knowing not to rely just on your eyes, but your ears, too. Your observation very swiftly pays off. In the corner, on a bed, is your slutty, little fox friend. His legs are spread, and cum is pooling around his hips and belly button. He licks some stray seed off of his lips as you watch, peering over the shoulder of a [one of]lust-crazed husky[or]enormous bear[or]hermaphrodite gryphon[or]smirking coyote[or]horny otter[at random] slamming into his cunt. His eyes are glassy with pleasure, but they sharpen as he sees you. A genuine smile spreads across his face, and he whispers, 'Sir?' With a smile, you undo your pants and climb onto the bed next to him. His partner continues unabated, merely offering you a raised eyebrow and a smirk.";
			say "     Without speaking, you fix your lips to Ryan's and steadily make out with him as he gets fucked by another. The little whore can't help but moan into your mouth, showing his utter delight at the situation. The smell of his arousal is intoxicating, and soon, you've wrapped your hand around your own cock, stroking it lewdly. Noting this, as sex-addled as he is, Ryan's warm, tiny paw soon joins your own, stroking you firmly. You shiver, and as you start to grind into his paw, you feel his partner stiffen. With a grunt of pleasure, they finish inside Ryan's abused little pussy, before drawing out, cum threading between their cock and the fox's cunt. You draw away from Ryan's lips to watch. The looming animal grins at you and wipes off their cock on the vulpine's ass, before giving it an affectionate slap and making the fennec squeak. Now able to summon up a shred of dignity, the fox turns a little pink upon looking at you. Your cock still rock hard, you settle back on the bed and gaze at the messy boy, patting your lap. You know that he's got one more in him. Trying not to look eager - and failing - Ryan gets up onto all fours again.";
		WaitLineBreak;
		say "     You watch as the horny, little slut clambers onto your body, his pussy dripping. Despite the dozens of others he must have had before you came, his cunt is still red and needy. You smile at him and grip his sides as he rests his paws on your shoulders. He shuffles up and presses his wet cunt up against the base of your cock. He smiles down at you, leaning down to give your nose a small nip. You smile back, content to let Ryan go at his own pace. As he settles and finds a comfortable position, you run your fingers through his fur. The parts of him that aren't wet with cum are soft and warm. Ryan moves his muzzle from your nose to your lips, and when he starts kissing you, he lowers his nethers on top of your stiff, ready shaft.";
		say "     His cunt slides down your rod effortlessly, slick with cum and the horny fennec's arousal. His clenching walls stimulate you, making you shudder with pleasure, the wave spreading from your hips all the way down to your fingertips. Pleased at the reaction, Ryan tugs on your bottom lip with his teeth and in a heavy, thick breath, he begs you, 'Please, fuck me... please, sir.' You transfer your hands from his sides to his hips and grip them firmly. Shivering with anticipation, Ryan buries his nose in your shoulder, licking softly at your throat.";
		WaitLineBreak;
		say "     Only too happy to oblige, your fingers tighten on the cuntboy's hips. Slowly, steadily, you rock upwards with your hips, plunging your cock into his depths. Ryan rides you easily, squeezing around your cock while he breathes out heavily. His arms slip up and curl around your shoulders. With every thrust, he breathes out again. His cunt is hot around you, and his claws scratches gently at your back. You can easily feel the hot spunk of his previous lovers run down your balls and slip in between your cheeks. Lightly, he nibbles at your throat, and you begin to speed up.";
		say "     One of your hands shifts around to Ryan's firm, tight ass. Gripping it softly, you begin to fuck the little bitch in earnest. Your other hand comes up to hold him securely against you. Knowing that you've got him, Ryan starts riding you more recklessly. He bounces on your cock, eager whimpers escaping his mouth, your bodies fitting together flawlessly. Soon, the scent of your own pre starts leaking from Ryan's pussy, and he moans as he catches it. 'Oh... god, yes, please... please, breed me...' he groans into your throat, and in response, you buck up savagely. His voice chokes as he makes a sound in between a squeal and a gasp, and you laugh.";
		WaitLineBreak;
		say "     Embarrassed by your laughter, the fox buries his nose deeper into your shoulder. Still rocking firmly inside him, you begin to sensually rub around the fox-boy's ass, dragging your fingers in between his cheeks. He tenses and makes a rough sound as your fingers find his tailhole. Softly, you massage it, dragging forth another moan. His tail curls around your wrist, keeping your hand right there. Thusly secured, Ryan gives a little bite to your shoulder and starts to bounce. Each thrust brings a wave of pleasure up your body, and with a loud moan yourself, you find it hard to keep your composure.";
		say "     The little fennec is unrelenting. You arch your back and bare your throat, your vision wavering from bliss. You thrust up into him, and eagerly, he matches you, throatily begging you for more. You can feel your pre slipping out around your shaft, leaking more and more the closer you get to climax - and it's coming all too soon. The smells, the sensations, the sounds his sex makes against yours. You notice Ryan's movements becoming more erratic, so you tighten your grip on him. In turn, he tightens his on you, his claws digging painfully into you - but at this point, it only adds to the pleasure. Finally, after what seems like an eternity of riding on the brink, the fox sinks his teeth into the top of your shoulder sharply and cums.";
		WaitLineBreak;
		say "     His pussy squeezes around your cock, massaging it, stroking it. A rush of his fluids runs out over your balls, and he lets out a long, animalistic moan, muffled by your body. Just as passionately, you buck up into his folds, all of the sensations proving to be too much for you. A heavy, bestial groan exits your lips as you cum inside of your lover, your balls tightening and your cock pulsing. Rope after rope fills up Ryan's womb. Your seed bursts from his cunny, joining the drying pool on the mattress below.";
		say "     Gradually, the lightning leaves your body, and you come to, cradling the exhausted vulpine in your arms. You're both breathing hard, and carefully, you move your arms to be more secure around Ryan's body. You cuddle him close and stroke across his fur softly. A faint mumble catches your attention, and you tilt your head, leaning closer to hear. 'Thank you... sir...' he murmurs again, almost too quiet to hear. You tell him that you're always happy to help and give the side of his head a small kiss. It isn't long before you realize that he's fallen asleep, and, being rather exhausted from the lovemaking yourself, you decide to join him.";
		WaitLineBreak;
		say "     When you wake, Ryan already has his eyes open. Smiling down at you kindly, he gives you a brief kiss to your lips, which deepens after a moment. He does pull away, though, and nuzzles at your cheek. 'I know you have places to be, sir,' he says, softly. 'You should go. But promise me that you'll come back soon, ok?' As you sit up, the fox still on your lap, you nod. Beaming at you, Ryan nonetheless squeaks as you lift him up, setting him down on the bed. With another kiss to his nose, you stand, retrieve your pants, and wave as you head out towards the door.";
	if RyanFucked < 5:
		increase RyanFucked by 1;

to say ShagShackSex13: [Edward the rooster, by Wasp]
	say "     Walking between the rows of beds and mattresses, you eventually spot your mark lazily resting back on the edge of his mattress. A tall, lanky rooster is sitting with his back to you, giving you an impressive view of his slender muscles moving underneath the sleek sheen of his feathers as he slowly works something in front of him. Soft moans continue to ring out from his beak until you make your way to his front, where, upon spotting your movement, the rooster locks eyes with you. Removing a wet, feathery finger from between his legs, he slips it inside his beak and slurps it clean, before pulling it out with a lewd pop.";
	say "     The rooster sighs. 'It's about time someone showed up to take care of me.' He takes the same wet finger from before and twirls it in the air, 'Why don't you show me the uh... you know, the goods?' A look of confusion crosses over your face. Weren't you supposed to be the one giving commands here? Nevertheless, you do a quick turnaround for the bird, thoughtfully pausing to give him time to focus on your more interesting assets. Returning to face the bird, you're rewarded with a slow shake of his head, his short, red comb swaying with the motion. 'Well, it's not bad, per se, but I think I have something specific in mind today.' That wet feather points downwards, and as the avian-morph spreads his talons, you finally get a good look at what he's packing. Or rather, isn't packing. A drooling slit sits between the feathery thighs and that raspy voice speaks once more, 'Come on, now, get that sweet face of yours down here, and get to work, already.'";
	WaitLineBreak;
	say "     Gulping softly, you lower yourself to your knees, getting a closer look at the glistening slit. The rooster must have sensed your hesitance because you hear a low, 'What, you've never seen a cloaca before?', and the next thing you know, those feathers wrap around the back of your head, guiding your nose right into his downy crotch feathers. As you breathe in from the shock of the movement, your nostrils fill with his avian musk, and suddenly, everything seems foggy and distant. You forget the shack and the other patrons. You forget the sticky floor and the pain in your knees on the tiles. That heady scent draws you in with an intensity that would have shocked you were it not so hard to think straight. You breathe in more of the rich musk, and it leaves you nearly incoherent. That low, raspy voice speaks again, giving you a single directive: 'Lick.'";
	say "     Without a thought, your tongue quickly slides into the opening and laps at the rooster's pre, dragging it into your maw. The taste explodes in your mouth, and it's all you can do not to shove the rest of your face into the wet cloaca to get as much of it as possible. You barely feel it as the feathers tighten their grip against the back of your head as the rooster grinds against your forceful lapping, but the loud gasps and moans cut through the fog and drive your lusts to their peak. Without even realizing, your hand reaches into your pants and starts to [if player is male]jack yourself off[else if player is female]massage your own slit[else]knead into your own crotch[end if] with a desperate need. You're too far gone to know quite how long you've been at it, but the subtle tightening of the fingers and steadily rising pitch of Edward's moans tell you that the end is fast approaching.";
	WaitLineBreak;
	say "     Sure enough, the feathery fingers pull you in as the rooster's hips push forward, and with a loud cry piercing your lust-addled mind, a thick flood of bird cum splashes into your mouth. Seeing stars, you back off from the rooster's crotch, allowing the thick cum to continue to shoot out, landing on your face and chest. [if player is male]Your hand numbly pumps your cock until your own orgasm rips through your body, making you twitch on the mattress store floor. [else if player is female]Your hand numbly thrusts into your cunt until your own orgasm rips through your body, making you twitch on the mattress store floor. [end if]The stars turn into fuzz, and the fuzz turns into blackness. The last thing you remember hearing is that raspy voice telling you... something that you can't quite make out as you slip out of consciousness.";
	say "     You come to as you feel a light slapping against the side of your face. Eyes fluttering open, your vision focuses on the face of the shack's feline assistant, Kaden. Looking around, you notice the blatant absence of the rooster that just face-fucked you. 'Hey, you're awake!' Kaden's voice snaps you out of your revelry, 'You've been out for a couple hours, which, after Edward, actually isn't that bad. My first time with him, I ended up losing a whole day.' Chuckling slightly at the cat-boy's confession, you accept his help getting up, and after he passes you a towel, you take a few moments to wipe up the mess your new friend left behind. Once you're ready, you adjust your clothes, gather your gear, and head back to the front of the brothel, a musky aftertaste lingering on your taste-buds, a slight buzz thrumming in your mind.";

to say ShagShackSex14: [Seth, by Prometheus]
	say "     Wandering to one of the far corners of the former mattress store, you see a blueish-gray mattress surrounded by candles. Beside it, a large snake is patiently coiled, observing you. The creature stirs as you come close, slithering towards you calmly. 'When you are ready, disrobe and lie face down on the bed,' he says soothingly. You comply, carefully placing the little you are wearing in a tidy pile in the corner before lying down. Hearing his body sliding across the floor, you turn your head and study him. Down his back from head to tail, he is covered in bronze scales with intermittent black splotches. As he turns to face you with soft, black eyes, you see that his scales are of a creamy color down his front. 'Don't you trust me?' he chuckles, his tongue flickering out for a moment teasingly.";
	say "     You rest your face back onto the mattress and await your treatment from the snake-man. You do not have to wait long before you feel his cool scales slide over your buttocks and begin weaving up your back. While he is fairly heavy, it is not uncomfortably so, more like the feeling you might get from a firm hug than being restrained. Seth's motions on your back begin to loosen your muscles, and you slip further into relaxation, the products of days of struggle melting away and replaced with a sense of calm and security. You groan in satisfaction, and you hear Seth chuckle.";
	WaitLineBreak;
	say "     Seth begins to focus his movements on different areas of your back. One moment he is wriggling exquisitely on your upper back, loosening your shoulders, and the next minute his body is weaving up the lumbar region of your spine, before he shifts back to the bottom again. 'Enjoying the massage?' the ophidian masseur asks, already knowing the answer from the pleased groans and sighs that have been spilling from your mouth. You grunt in affirmation, having never felt anything like what you have just experienced. 'Turn over please,' he requests next, sliding off of your back and waiting to the side.";
	say "     You roll over, ready for your chest to feel the same bliss that you were given on your back. As you turn, you see two pink appendages beginning to protrude from a slit on Seth's body. Currently, they are small with what you suspect is only the tip being shown to your roving eyes. Noticing where your gaze has ended up, Seth laughs. 'I enjoy what I do. The feeling of my body writhing against another, the pleasure I can bring to them through massages and... other interactions. But we'll get to that later. Lie on your back, and I'll finish the massage before either of us gets too excited.' Tilting your head in acceptance, you lie back, waiting in anticipation for what your torso will feel like after he has caressed it and imagining what else he can do with his body afterwards.";
	WaitLineBreak;
	if breasts of player > 0:
		if player is male:
			say "     Seth slithers over your leg, the tips of his penises leaving a thin film of fluid on your shin and between your thighs. Glancing at your hardening [cock of player] cock, he curls his tail around and traces his way up from scrotum to urethra with the tip. Content with his teasing, he slithers over your groin, purposefully rubbing his side against your shaft and coating himself with the small amount of pre oozing from it. He then weaves his way up your stomach and over your chest, sliding through the valley of your breasts. The scales of his underside feel cool against your skin, and you shiver with anticipation.";
			say "     He begins to sway on top of your torso, his body rubbing the sensitive skin of your breasts and navel. Every so often, his tail grazes its way up your penis before flicking off to the side, gradually getting more and more coated in the precum that is beginning to be more copiously produced. Your stomach muscles begin to loosen, as do those of your chest. You feel that it will be easier to breathe once the masseur isn't pressed against your body. He circles his head around and rubs his cheek against the swell of your breast, his tongue flicking out to taste the sweat on your nipple. He swaps breast and gives the same treatment to the other, the lightness of his tongue's touch sending quivers throughout your form and converging on your groin.";
			WaitLineBreak;
			say "     You can feel his twin cocks pressing up against your tummy, their slime smearing across its surface. Seth's movements are also becoming less precise, and his breathing catches occasionally. 'I think your massage is complete, don't you? How about we move onto the next part of what you paid for, the sex.' You readily agree as your body tingles, the massage having awoken feelings within you that magnify your arousal. He shifts around until his penises are in front of your face so that you can admire them in all their glory. Each is almost seven inches long with fluid dripping out of their ends, coating each shaft liberally. You bring your hand up and run it down the side of one, collecting the precum on your fingers. He shivers at the stimulation and makes a few short thrusts. When you bring your fingers to your mouth and lick them, the flavor isn't particularly strong, but it is distinct enough that you make sure to clean them thoroughly.";
			say "     Moistening your mouth in preparation, you signal that he may bring his twin organs to your mouth. He lowers himself until they are resting against your lips before thrusting them through into the warmth and wetness of your mouth. As they enter, you lick around the head of each penis, the combined girth of them stretching your lips sideways. Each twitches intermittently in your mouth, the pleasure you are returning to Seth showing in his face and movements. You content yourself to give him control of the speed and angle of thrusting, resting your head against the mattress as he gains speed and force. You feel a wetness on your breast and guess that it is his tongue as it meanders around, brushing against your nipple every so often. This slight touch titillates you more than one would have thought.";
			WaitLineBreak;
			say "     With a slurp, Seth pulls his members from your mouth and settles back between your thighs. 'As excellent as your mouth is, I'm eager to try another hole before our session is over,' he remarks. He gestures beneath your erection at your anus. 'May I?' Eager to feel him in you, you comply readily, spreading your legs and lifting your shaft out of his way. The giant snake slithers forward and aligns his cock with your rear. You guide his lower member in, allowing the other to rub up against your [cock of player] shaft. Thrusting forth, Seth pushes nearly half his length in, only to withdraw, leaving only the tip inside of you, before thrusting in even further. As he does so, his other penis rubs pleasantly against your own, the mucus covering it allowing it to slide effortlessly between your bodies.";
			say "     Each time he thrusts, your body is pushed into the mattress slightly, the absence of springs being fortuitous. Gasps break from both of your mouths as the pleasure increases from your coupling. The weight of his body against your own holds your thrusting genitals tightly enough that they don't slide apart, your combining fluids easing any friction that might be caused by scale on skin. Seth increases his tempo, bringing his mouth to yours, exchanging kisses as his phallus penetrates deeply into your bowels. As the arousal mounts further and further, these kisses become more common, his tongue looping your own, its tip tickling your palate.";
			WaitLineBreak;
			say "     Hissing, Seth rises from your body, orgasming within you and spraying cum over your body, a few shots reaching your face. The feeling of his cock throbbing in your anus and the sperm filling your bowels sends you over the edge just after him. Your own semen mixes with his on your body, before he quickly brings his mouth down to take your shaft inside. He swallows as you ejaculate down his throat, his tongue coaxing out extra to make sure you get the full experience. Relaxing in satisfaction and contentment, you wipe a finger through the spooge that is oozing across your chest and bring the finger to your mouth, tasting the combined essence of yourself and the snake.";
			say "     Reaching behind the head of the mattress, Seth grabs a glass jar and brings it to the bottom of the mattress. Pulling your bodies so that your anus is above the rim, he pulls out of you, catching the stream of cum that flows out in the jar and making sure that none soils the mattress. 'I'll allow you to tidy yourself before leaving,' he informs you. 'Just don't drip anywhere[if SethFucked is 0]. I have hated cleaning since having to do so for the snakes at the zoo. I used to work as the snake handler, and it was a relief when I got promoted to overseeing the snake massages[end if].' Carefully wiping the remaining spooge off of your body and into the jar, you pick up your clothes and dress yourself again. 'Come back soon!' Seth calls after you as you leave. 'I enjoyed that.'";
		else:
			say "     Seth slithers over your leg, the tips of his penises leaving a thin film of fluid on your shin and between your thighs. Glancing at your dripping cunt, he curls his tail around and traces his way up from anus to clitoris with the tip, slightly parting your lips. Content with his teasing, he slithers over your groin, purposefully rubbing his underbelly through your gash and coating himself with the small amount of lubricant oozing from it. He then weaves his way up your stomach and over your chest, sliding through the valley of your breasts. The scales of his underside feel cool against your skin, and you shiver with anticipation.";
			say "     He begins to sway on top of your torso, his body rubbing the sensitive skin of your breasts and navel. Every so often, his tail grazes its way through your pussy before flicking off to the side, gradually getting more and more coated in the wetness that is beginning to be more copiously produced. Your stomach muscles begin to loosen, as do those of your chest. You feel that it will be easier to breathe once the masseuse isn't pressed against your body. He circles his head round and rubs his cheek against the swell of your breast, his tongue flicking out to taste the sweat on your nipple. He swaps breast and gives the same treatment to the other, the lightness of his tongue's touch sending quivers throughout your form and converging on your groin.";
			WaitLineBreak;
			say "     You can feel his twin cocks pressing up against your tummy, their slime smearing across its surface. Seth's movements are also becoming less precise, and his breathing catches occasionally. 'I think your massage is complete, don't you? How about we move onto the next part of what you paid for, the sex.' You readily agree as your body tingles, the massage having awoken feelings within you that magnify your arousal. He shifts around until his penises are in front of your face so that you can admire them in all their glory. Each is almost seven inches long with fluid dripping out of their ends, coating each shaft liberally. You bring your hand up and run it down the side of one, collecting the precum on your fingers. He shivers at the stimulation and makes a few short thrusts. When you bring your fingers to your mouth and lick them, the flavor isn't particularly strong, but it is distinct enough that you make sure to clean them thoroughly.";
			say "     Moistening your mouth in preparation, you signal that he may bring his twin organs to your mouth. He lowers himself until they are resting against your lips before thrusting them through into the warmth and wetness of your mouth. As they enter, you lick around the head of each penis, the combined girth of them stretching your lips sideways. Each twitches intermittently in your mouth, the pleasure you are returning to Seth showing in his face and movements. You content yourself to give him control of the speed and angle of thrusting, resting your head against the mattress as he gains speed and force. You feel a wetness on your breast and guess that it is his tongue as it meanders around, brushing against your nipple every so often. This slight touch titillates you more than one would have thought.";
			WaitLineBreak;
			say "     With a slurp, Seth pulls his members from your mouth and settles back between your thighs. 'As excellent as your mouth is, I'm eager to try another hole before our session is over,' he remarks. He gestures at both your oozing pussy and your anus. 'May I?' Eager to feel him in you, you comply readily, further opening your legs and spreading your vaginal lips apart. The giant snake slithers forward and aligns his cocks with your inviting holes. You guide his lower member into your asshole, allowing the other to rub up against your gash and clitoris. Thrusting forth, Seth pushes nearly half his length in before withdrawing, leaving only the tip inside you. Settling to allow you to insert his other penis into your pussy, you anticipate the pleasure you will feel with the two rods separated by only a thin wall of flesh. Now that he can double penetrate you, Seth resumes his thrusting, getting both cocks in completely.";
			say "     You can feel them pulsing in your intimate areas as he accelerates and slows down to vary the pleasure. Each time he thrusts, your body is pushed into the mattress slightly, the absence of springs being fortuitous. Gasps break from both of your mouths as you couple him as he penetrates your pussy and ass simultaneously, feeling his own cocks through your body. Seth increases his tempo, bringing his mouth to yours, exchanging kisses as his phallus penetrates deeply into your bowels and cunt. As the arousal mounts further and further these kisses become more common, his tongue looping your own, its tip tickling your palate.";
			WaitLineBreak;
			say "     Hissing, Seth rises from your body, orgasming in both your pussy and ass. He writhes slightly at the feeling of his penises stimulating each other as they swell and shrink, pumping his seed into your body. The feeling of his cock throbbing in your anus and pussy and the sperm filling your inner passages sends you over the edge just after him. The clenching of your anal and vaginal walls around his shafts prolongs Seth's orgasm, coaxing any spare semen from him to be spent within your body. Relaxing in satisfaction and utterly spent, you rub a hand over your tummy and bulging labia, imagining the serpent's sperm swimming through your body.";
			say "     Reaching behind the head of the mattress, Seth grabs a glass jar and brings it to the bottom of the mattress. Pulling your bodies so that you are above the rim, he pulls out of you, catching the stream of cum that flows out of your holes in the jar and making sure that none soils the mattress. 'I'll allow you to tidy yourself before leaving,' he informs you. 'Just don't drip anywhere[if SethFucked is 0]. I have hated cleaning since having to do so for the snakes at the zoo. I used to work as the snake handler, and it was a relief when I got promoted to overseeing the snake massages[end if].' Carefully wiping the remaining spooge from your groin into the jar, you pick up your clothes and dress yourself again. 'Come back soon!' Seth calls after you as you leave. 'I enjoyed that.'";
	else:
		if player is male:
			say "     Seth slithers over your leg, the tips of his penises leaving a thin film of fluid on your shin and between your thighs. Glancing at your hardening [cock of player] cock, he curls his tail around and traces his way up from scrotum to urethra with the tip. Content with his teasing, he slithers over your groin, purposefully rubbing his side against your shaft and coating himself with the small amount of pre oozing from it. He then weaves his way up your stomach and over your chest, his belly causing tingles from your nipples. The scales of his underside feel cool against your skin, and you shiver with anticipation.";
			say "     He begins to sway on top of your torso, his body rubbing the sensitive skin around your nipples and navel. Every so often, his tail grazes its way up your penis before flicking off to the side, gradually getting more and more coated in the precum that is beginning to be more copiously produced. Your stomach muscles begin to loosen, as do those of your chest. You feel that it will be easier to breathe once the masseuse isn't pressed against your body. He rubs his cheek against your own, his tongue flicking out to taste your lips before exploring behind your ear and the curve of your jaw. The lightness of his tongue's touch sends quivers throughout your form and converges on your groin.";
			WaitLineBreak;
			say "     You can feel his twin cocks pressing up against your tummy, their slime smearing across its surface. Seth's movements are also becoming less precise, and his breathing catches occasionally. 'I think your massage is complete, don't you? How about we move onto the next part of what you paid for, the sex.' You readily agree as your body tingles, the massage having awoken feelings within you that magnify your arousal. He shifts around until his penises are in front of your face so that you can admire them in all their glory. Each is almost seven inches long with fluid dripping out of their ends, coating each shaft liberally. You bring your hand up and run it down the side of one, collecting the precum on your fingers. He shivers at the stimulation and makes a few short thrusts. When you bring your fingers to your mouth and lick them, the flavor isn't particularly strong, but it is distinct enough that you make sure to clean them thoroughly.";
			say "     Moistening your mouth in preparation, you signal that he may bring his twin organs to your mouth. He lowers himself until they are resting against your lips before thrusting them through into the warmth and wetness of your mouth. As they enter, you lick around the head of each penis, the combined girth of them stretching your lips sideways. Each twitches intermittently in your mouth, the pleasure you are returning to Seth showing in his face and movements. You content yourself to give him control of the speed and angle of thrusting, resting your head against the mattress as he gains speed and force. You feel a wetness on your nipple and guess that it is his tongue as it meanders around, leaving a thin trail of saliva. This slight touch titillates you more than one would have thought.";
			WaitLineBreak;
			say "     With a slurp, Seth pulls his members from your mouth and settles back between your thighs. 'As excellent as your mouth is, I'm eager to try another hole before our session is over,' he remarks. He gestures beneath your erection at your anus. 'May I?' Eager to feel him in you, you comply readily, spreading your legs and lifting your shaft out of his way. The giant snake slithers forward and aligns his cock with your rear. You guide his lower member in, allowing the other to rub up against your [cock of player] shaft. Thrusting forth, Seth pushes nearly half his length in, only to withdraw, leaving only the tip inside of you, before thrusting in even further. As he does so, his other penis rubs pleasantly against your own, the mucus covering it allowing it to slide effortlessly between your bodies.";
			say "     Each time he thrusts, your body is pushed into the mattress slightly, the absence of springs being fortuitous. Gasps break from both of your mouths as the pleasure increases from your coupling. The weight of his body against your own holds your thrusting genitals tightly enough that they don't slide apart, your combining fluids easing any friction that might be caused by scale on skin. Seth increases his tempo, bringing his mouth to yours, exchanging kisses as his phallus penetrates deeply into your bowels. As the arousal mounts further and further, these kisses become more common, his tongue looping your own, its tip tickling your palate.";
			WaitLineBreak;
			say "     Hissing, Seth rises from your body, orgasming within you and spraying cum over your body, a few shots reaching your face. The feeling of his cock throbbing in your anus and the sperm filling your bowels sends you over the edge just after him. Your own semen mixes with his on your body, before he quickly brings his mouth down to take your shaft inside. He swallows as you ejaculate down his throat, his tongue coaxing out extra and making sure you get the full experience. Relaxing in satisfaction and contentment, you wipe a finger through the spooge that is oozing across your chest and bring the finger to your mouth, tasting the combined essence of yourself and the snake.";
			say "     Reaching behind the head of the mattress, Seth grabs a glass jar and brings it to the bottom of the mattress. Pulling your bodies so that your anus is above the rim, he pulls out of you, catching the stream of cum that flows out in the jar and making sure that none soils the mattress. 'I'll allow you to tidy yourself before leaving,' he informs you. 'Just don't drip anywhere[if SethFucked is 0]. I have hated cleaning since having to do so for the snakes at the zoo. I used to work as the snake handler, and it was a relief when I got promoted to overseeing the snake massages[end if].' Carefully wiping the remaining spooge off your body into the jar, you pick up your clothes and dress yourself again. 'Come back soon!' Seth calls after you as you leave. 'I enjoyed that.'";
		else:
			say "     Seth slithers over your leg, the tips of his penises leaving a thin film of fluid on your shin and between your thighs. Glancing at your dripping cunt, he curls his tail around and traces his way up from anus to clitoris with the tip, slightly parting your lips. Content with his teasing, he slithers over your groin, purposefully rubbing his underbelly through your gash and coating himself with the small amount of lubricant oozing from it. He then weaves his way up your stomach and over your chest, his belly causing tingles from your nipples. The scales of his underside feel cool against your skin, and you shiver with anticipation.";
			say "     He begins to sway on top of your torso, his body rubbing the sensitive skin around your nipples and navel. Every so often, his tail grazes its way through your pussy before flicking off to the side, gradually getting more and more coated in the wetness that is beginning to be more copiously produced. Your stomach muscles begin to loosen, as do those of your chest. You feel that it will be easier to breathe once the masseuse isn't pressed against your body. He rubs his cheek against your own, his tongue flicking out to taste your lips before exploring behind your ear and the curve of your jaw. The lightness of his tongue's touch sends quivers throughout your form and converges on your groin.";
			WaitLineBreak;
			say "     You can feel his twin cocks pressing up against your tummy, their slime smearing across its surface. Seth's movements are also becoming less precise and his breathing catches occasionally. 'I think your massage is complete, don't you? How about we move onto the next part of what you paid for, the sex.' You readily agree as your body tingles, the massage having awoken feelings within you that magnify your arousal. He shifts around until his penises are in front of your face so that you can admire them in all their glory. Each is almost seven inches long with fluid dripping out of their ends, coating each shaft liberally. You bring your hand up and run it down the side of one, collecting the precum on your fingers. He shivers at the stimulation and makes a few short thrusts. When you bring your fingers to your mouth and lick them, the flavor isn't particularly strong, but it is distinct enough that you make sure to clean them thoroughly.";
			say "     Moistening your mouth in preparation, you signal that he may bring his twin organs to your mouth. He lowers himself until they are resting against your lips before thrusting them through into the warmth and wetness of your mouth. As they enter, you lick around the head of each penis, the combined girth of them stretching your lips sideways. Each twitches intermittently in your mouth, the pleasure you are returning to Seth showing in his face and movements. You content yourself to give him control of the speed and angle of thrusting, resting your head against the mattress as he gains speed and force. You feel a wetness on your nipple and guess that it is his tongue as it meanders around, leaving a thin trail of saliva. This slight touch titillates you more than one would have thought.";
			WaitLineBreak;
			say "     With a slurp, Seth pulls his members from your mouth and settles back between your thighs. 'As excellent as your mouth is, I'm eager to try another hole before our session is over,' he remarks. He gestures at both your oozing pussy and your anus. 'May I?' Eager to feel him in you, you comply readily, further opening your legs and spreading your vaginal lips apart. The giant snake slithers forward and aligns his cocks with your inviting holes. You guide his lower member into your asshole, allowing the other to rub up against your gash and clitoris. Thrusting forth, Seth pushes nearly half his length in before withdrawing, leaving only the tip inside you. Settling to allow you to insert his other penis into your pussy, you anticipate the pleasure you will feel with the two rods separated by only a thin wall of flesh. Now that he can double penetrate you, Seth resumes his thrusting, getting both cocks in completely.";
			say "     You can feel them pulsing in your intimate areas as he accelerates and slows down to vary the pleasure. Each time he thrusts, your body is pushed into the mattress slightly, the absence of springs being fortuitous. Gasps break from both of your mouths as you couple him as he penetrates your pussy and ass simultaneously, feeling his own cocks through your body. Seth increases his tempo, bringing his mouth to yours, exchanging kisses as his phallus penetrates deeply into your bowels and cunt. As the arousal mounts further and further these kisses become more common, his tongue looping your own, its tip tickling your palate.";
			WaitLineBreak;
			say "     Hissing, Seth rises from your body, orgasming in both your pussy and ass. He writhes slightly at the feeling of his penises stimulating each other as they swell and shrink, pumping his seed into your body. The feeling of his cock throbbing in your anus and pussy and the sperm filling your inner passages sends you over the edge just after him. The clenching of your anal and vaginal walls around his shafts prolongs Seth's orgasm, coaxing any spare semen from him to be spent within your body. Relaxing in satisfaction and utterly spent, you rub a hand over your tummy and bulging labia, imagining the serpent's sperm swimming through your body.";
			say "     Reaching behind the head of the mattress, Seth grabs a glass jar and brings it to the bottom of the mattress. Pulling your bodies so that you are above the rim, he pulls out of you, catching the stream of cum that flows out of your holes in the jar, making sure that none soils the mattress. 'I'll allow you to tidy yourself before leaving,' he informs you. 'Just don't drip anywhere[if SethFucked is 0]. I have hated cleaning since having to do so for the snakes at the zoo. I used to work as the snake handler, and it was a relief when I got promoted to overseeing the snake massages[end if].' Carefully wiping the remaining spooge from your groin into the jar, you pick up your clothes and dress yourself again. 'Come back soon!' Seth calls after you as you leave. 'I enjoyed that.'";

to say ShagShackSex15: [Ziera, by CrimsonAsh]
	if ZieraFucked is 0:
		say "     Moving through the former mattress store, you spot near the back corner of the room a fenced-in pen with a few hay bales stacked in it. From a distance you see a young centauress nervously fidgeting and pacing around her small open area. She has dark brown hair tied in a ponytail and naked C-cup breasts, which she covers with crossed arms. Her tauric half is chestnut-colored, well-groomed and her long equine tail swishes back and forth behind her. Her pretty face looks up in your direction as she spots you making your way towards her. You notice unlike many workers here, she and her workspace are clean and spotless.";
		say "     Straightening up as you enter her pen the cute centauress drops her arms and lets her modest breasts bounce free. 'H-hey sweetie, I k-knew you couldn't resist me,' she sputters out shyly defying her own words, then grabs her breasts with inexperienced fingers and cups them for your viewing. You begin stripping off your own clothes as she plays with her breasts and as you do she bites her bottom lip as more of you is exposed. 'Y-you're very pretty...' she says as she blushes and sheepishly trots from side to side. You smile and tell the nervous taur girl that she's quite the lovely filly herself and ask about her surprisingly clean workspace. 'I-I never could take male clients myself, ever since... well, since all this started, but it definitely helps with cleanup!' she says, shuffling uncomfortably.";
	else if ZieraFucked is 1:
		say "     Once again, moving through the former mattress store, you spot near the back corner of the room a familiar fenced in pen. From a distance you see the young centauress, Ziera, nervously fidgeting and pacing around her small open area. She has her dark brown hair tied in a ponytail and naked C-cup breasts of which she covers with crossed arms. Her tauric half is chestnut colored, well groomed and her long equine tail swishes back and forth behind her. Her pretty face looks up in your direction as she spots you making your way towards her. You notice unlike many workers here, she and her workspace are clean and spotless.";
		say "     Straightening up as you enter her pen, the cute centauress smiles as she sees her favorite customer and drops her arms to her side letting her modest breasts bounce free. 'H-hey I'm glad you came back,' she says shyly, then grabs her breasts with inexperienced fingers and cups them for your viewing. You tell her you're glad you came back and she blushes lightly. You begin stripping off your own clothes as she plays with her breasts, and as you do she bites her bottom lip as more of you is exposed. 'Wow... still so pretty,' she says as she blushes and sheepishly trots from side to side. You smile and tell the nervous taur girl that she's still quite the lovely filly herself, she giggles with a hint of naughtiness and gives you a quick peck on the lips.";
	WaitLineBreak;
	say "     Finishing stripping, you give her a lust-filled smile and order her to turn around, which she does after a deeper shade of red flows across her soft face. She turns around, her hooves clopping as she does and presents her damp winking horse nether-lips to you, followed shortly by a heavy waft of her musky mare-scent. You can feel it having an unusual effect on you as you breathe her sweet smell - your pussy lips dampen and quiver, while an uncanny need to feast on her mare cunt rises in you. Bringing her long pale arm back, she grazes her taint with her fingers before dipping into her dark lips practically beckoning you to follow your desires.";
	say "     Needing no more instruction than that, you dive forward, dropping to your knees behind the lovely centaur and bury your face into her now dripping mare pussy. As you make contact with her sweet lips, it's like electric on your own womanhood. With every lick you can feel your own sensitive lips quiver more and more. Letting out a loud neigh from the contact, Ziera grabs her breasts and pushes her rear back against your face, her tail now swishing around wildly as you eat out her drooling mare pussy. 'Oh wow, you're-ahh! Good at that.' She moans as she brushes the tips of her fingers across the top of your head. Thrusting your own fingers downward, you find yourself soaked and dripping onto the clean floor below. Grinding across your engorged clit, you dig into your wet hole, moaning into the Ziera's sweet lips.";
	WaitLineBreak;
	say "     Breathing heavily into the soaked mare, you absorb more and more of her musky taste until your head starts to spin in pleasurable bliss. Barely needing to touch yourself, your sex quivers and gushes almost violently. You are barely able to keep coherent enough to continue eating out the sexy centauress. Now neighing and whinnying loudly, Ziera seems to be in much a similar state herself as she moves her hands up to her rump, softly kneading and spreading her large equine cheeks apart. 'I-Ohh! I'm really close, please don't stop!' Without even realizing, you move your free hand to brush across her own palm, gripping her rump before moving to gently press into her dark anal ring with a finger.";
	say "     Seeming to have an especially sensitive anus, Ziera lifts her forelegs up a few feet and lets out a low shriek of pleasure. 'Oh my, that's so naughty!' Responding entirely on impulse, you lift your lips from her juicy slit to her anal ring and run your tongue along her clean taint. You lick up and down her tight hole before slipping your tongue inside her bitter-sweet walls. You feel a spray of juice hit your chest as her winking pussy spasms and you can tell she's on the verge of climaxing. Doing the only thing you can, you dive right back inside her sopping wet marehood and thrust a thumb inside her spit slick anus.";
	WaitLineBreak;
	say "     Seeming to do the trick, Ziera moans loudly, 'I-I-I'm c-cumming!' She lets out one last whinny as a torrent of sticky mare juice sprays out of her juicy horse cunt and splatters across your face. Her normal juice was tasty but as you get a wave of her climax you nearly black out, your senses going into overdrive as the nanobot laced mare juice triggers your own orgasm. Gushing out around your fingers, you squirt onto the floor below as you're hit with an incredibly intense climax. Your cunt clamps tightly around your fingers as the mare does the same around your probing tongue. Moaning into her lips, your finger presses deeper into her anal ring and she spasm more as a final spurt of mare juice covers your face.";
	say "     Coming down from both your orgasms, Ziera is huffing loudly and swerving slightly, barely able to stay on her hooves. 'Wow... so good.' She huffs out in between breaths as she rubs her sweat slicked forehead. Still dizzy and woozy from the Centaur's tasty juices, you move back from her snatch to examine her freshly eaten mare lips They are still winking and climax still drips from them onto the now soaked floor below. You find your entire front soaked and you reek of mare musk. Turning back around to face you, she looks at her mess, 'Oh wow, did I do all that?' she asks as she starts to regain her composure. You stand to shaky knees as she rubs the back of her neck and looks downwards away from your gaze, a faint blush across her face. 'Umm, do come back, this was a lot of fun,' she coyly says as she briefly makes eye contact with you before giving you a peck on the cheek and turning away. 'I really have to clean this up, but do visit me again. I don't get a lot of customers,' she says before retrieving a mop from nearby to clean up her mess. You note her horse lips still quivering as you smile, collect your things, and make your way to the exit with a skip in your step.";

to say ShagShackSex16: [Small otter dominatrix, by Fwuffymouse]
	setmonster "Sea Otter";
	choose row monster from the Table of Random Critters;
	say "     Sitting near a wall on a high barstool is a short, slim otteress that is watching you with steely eyes mostly hidden under the brim of a small, black leather cap. Her gaze follows you, and she slaps a riding crop against her tiny paw. She's almost the shape of an ordinary otter, with a diminutive, sleek body and only the barest suggestion of breasts hidden under her small leather vest. The tiny dominatrix is more dressed than most of the people here and apparently well-equipped to handle a specific sort of customer. You stop, not yet sure if you're that sort of customer. A sour look crosses her face as you pause, and the slap of leather against wood shocks you to attention.";
	say "     'Stop staring, runt!' barks the mustelid. Gaze snapping downward, you stammer an apology. She snarls again, demanding that you kneel before her. As you comply, the sleek domme brings the crop down across your arm. The otter is poised above you, suddenly seeming much bigger than you remember. The commanding, little woman growls again, ordering you to apologize again, properly. [if player is submissive]'I'm sorry, mistress, forgive me!' you cry, letting your submissive instincts take over. She seems satisfied, bringing the crop down to your cheek and gently tapping it against your face[else]'I'm sorry, mistress,' you mutter, and you get a quick, sharp slap of leather against your other arm.[end if]";
	say "     [bold type]the slinky little dominatrix scoots on the barstool and presents you with one of her paws. [bold type]Give her a foot-worship?[roman type][line break]";
	LineBreak;
	say "     ([link]Y[as]y[end link]) - Kiss her feet.";
	say "     ([link]N[as]n[end link]) - Politely decline.";
	if player consents:
		LineBreak;
		say "     Taking the otteress's largest toe up into your mouth, you get a whiff of her foot scent. It's not an unpleasant smell, just a bit musty. You let your tongue roll about her largest toe for a while before pulling back and moving down the line, cleaning off each of the four tiny toes on the small domme's paw. She pulls it out of your mouth and plants the other on your face, forcefully rubbing that little paw about your face and softly growling at you to do a better job on this one. You take it into your mouth and start licking over the creases and between the soft pads. Again, you pay attention to the toes, slurping greedily at them and making certain to get every spot.";
		say "     Good, pup, now strip down, get on the bed, and lie on your back,' she commands. [if player is submissive]Sitting up and avoiding looking her in the eye, you lie onto her mattress and stare up at the ceiling and wait patiently. The otteress hops onto the mattress beside you and slaps her riding crop against your belly several times, causing you to yelp with each meeting of leather on skin.[else]You do as you're ordered, catching a glance at her hard, silver eyes on your way up. Once you're situated, the otteress jumps onto the mattress and slaps you several times on the belly and thighs with her riding crop, HARD. 'Mind your greedy eyes, whelp!'[end if]";
	else:
		say "     You softly shake your head, and the little dominatrix scoffs. 'Suit yourself, wimp. Get on the bed, strip down, and lie on your back,' she commands. [if player is submissive]Sitting up and avoiding looking her in the eye, you lie onto her mattress and stare up at the ceiling and wait patiently. The otteress hops onto the mattress beside you and slaps her riding crop against your belly several times, causing you to yelp with each meeting of leather on skin.[else]You do as you're ordered, catching a glance at her hard, silver eyes on your way up. Once you're situated, the otteress jumps onto the mattress and slaps you several times on the belly and thighs with her riding crop, HARD. 'Mind your greedy eyes, whelp.'[end if]";
	say "     The sleek, little mustelid mounts your body, looking down at your face. Keeping your own gaze off the pint-sized dominatrix, you feel her shift, reaching back and rubbing her paw over the crotch of your clothing. [if player is herm]The commanding otter sighs, muttering something about how much fun it is to put people like you in their place[else if player is male]Shaking her head, the commanding otter tut-tuts and mutters something about 'typical males'[else if player is female]The commanding otter sighs disdainfully, muttering something about how she'll enjoy breaking you[end if].";
	say "     Her abrasive remarks sting almost as bad as the riding crop she's been whipping you with. The small hand departs your groin, and the slinky, little domme stands up on your chest, turning around above you and lightly rapping you on the scalp with her riding crop. Your gaze locks on her backside, still covered in a black bikini bottom that's been modified with a string tie to hold it above her large, rudder-like tail. She brings herself down over your face, rubbing her pussy over your nose; the thin layer of fabric between your nostrils and her wet snatch doesn't keep the smell of her arousal from assaulting your senses.";
	WaitLineBreak;
	say "     The dominant little otter keeps you waiting, teasingly rubbing her groin over you and making rude comments. To her, you're a slutty runt; easily submitting to her and letting her screw with you. You're weak, stupid, and only good enough to be a toy for her. The sting of her words sinks in, and you can only sigh out a quiet [italic type]please[roman type]. The pint-sized domme lifts herself up slightly, dangling her delightful backside over you while she pulls at the string tied over her tail. The knot slips loose, and the unsupported fabric falls away. Pulling the swimsuit bottom the rest of the way off, she pays hardly any regard to the effects of treading on your chest. ";
	say "     The small dominatrix lowers her body down onto your face again, roughly pressing the wet folds of her snatch onto your mouth and growling at you to get to work. The scent washes over you again, and you start eating her out. Grinding wide sea mammal hips over your face, she keeps barking orders at you. You're demanded to go deeper, to suck her clit, [if anallevel is 3]and to kiss her tailhole[else]and to stop moving so damn much and work[end if]. 'Fucking dumb whelp, I've half a mind to [if player is herm]plug you into a milker and leave you there, you stupid thing[else if player is male]keep that stupid cock of yours trapped[else if player is female]jam my tail in that stupid cunt of yours[end if],' snarls the pint-sized dominatrix, thrusting her hips over your face. ";
	WaitLineBreak;
	say "     The otter dominatrix slows her grinding, sighing as she tenses up in orgasm. 'Eat it, you stupid twerp,' she growls. Her feminine juices spray out over your face and coat it in the demanding half-pint's honey. Gasping at the sudden flood, you nonetheless do your best to swallow what you can. She sighs, standing back up and turning around. With an unceremonious plop, her netherlips are once again pressing at your mouth. While you pause to catch your breath, the sleek sea mammal grumbles out, 'Get back to work, stupid. I'm not through with you'. Her tone is matter of fact, as though she was reprimanding a child. As far as she's concerned, you may as well be a fool in need of a few very hard lessons. Even lessons like that seem fairly attractive to you at this point, as your [cock of player] dick flexes.";
	say "     Your tongue goes straight back to work, sliding into her sopping cunny as you work to please her. The brothel is so distant right now, and all you care about is giving this lovely mistress as much pleasure as she wants. Your cock's being ignored, sure, but making this lady feel good is more important. Again and again, you kiss at her clit and drive your slick, wriggling tongue into her depths. The sexy otteress is just as intent on masturbating herself on her toy as you are on pleasing her. She catches, nay, [italic type]takes[roman type] your gaze and locks you in her dominant stare. You're paralyzed, drowning in those powerful, silver eyes of hers, even as she starts to drown you in yet more of her fem-cum.";
	WaitLineBreak;
	say "     The demanding sea mammal stands up, walking down over your torso and kneeling on your belly. Tiny paws grasp at your waistband, and she's quickly got your leggings just far enough down to expose your leaking cock. [if cock length of player < 6]'Should have known, tiny dicks like yours only get off on abuse,' she comments, chuckling without even bothering to touch your cock[else if cock length of player < 8]'Nothing special, huh? If this were a fish, I'd throw it back,' she says, waving your hard shaft about[else if cock length of player < 12]'Hmm, could be better. You might be able to impress someone with low standards,' she comments, holding your stiff shaft in her paws[else if cock length of player < 18]'Hmm, not too shabby, but you aren't fooling anyone. Nobody with a dick this big has the guts to use it,' she comments snidely, rubbing your hard cock with her paws[else]The otteress hefts your shaft, which is comparable to the length of her body, and busts out laughing! 'You're a freak, a god damned sideshow act! Did nobody tell you that this'd just scare people off? No wonder you're so dumb. All of your blood's left your head!' she says through laughter. Turning around, the pint-sized dominatrix presses her sleek, leather-clad body against your shaft[end if]. Regardless of her less-than-stellar opinion of your equipment, your mistress decides to humor you and presses her lithe body against yours, laying on your chest. She slides herself back, lining herself up over your cock and sliding down over it. With slow twisting of her hips and those commanding eyes of hers locked with your own, the small dominatrix intends to draw your desperation out as long as she wants. Her tight, velvety insides squeeze your length as it slides fully into her.";
	say "     Your [cock of player] almost seems to vanish into her, and the tiny otter's inner walls squeeze your shaft well enough that her sensual gyrations aren't really necessary. It doesn't take long before you cum inside her, your [if cock width of player > 10]absurdly large load flowing into the pint-sized girl's cunt. No matter how much you put out, her slim body captures it all. Her belly bulges a bit as your cum sprays inside her. The otteress's normally hard facade drops for a second, replaced by surprise. Shaking her head, the stuffed otter pulls off of your cumming shaft. 'Fucking cow!' she yells, whipping you several more times across the chest and legs before roughly gripping your shaft and pointing it at your face to let the remains of your excessive load spray onto your head and body. [else]cum squirting into the pint-sized domme's body. The otteress shoots you a cold look, one of disappointed anger. 'Finished already, runt? Too bad, I wasn't,' she barks, sliding off your shaft and standing aside you. [end if]That crop of hers strikes your chest and thighs a few more times, which is starting to feel pretty damn good to your wasted and used body. You're treated to a look of smug satisfaction from your mistress, and she merely clicks her tongue and motions for you to get up. 'Now, what'd I tell you, punk? These eyes tell all, and you're the kind of boy that's all too willing to let a little gal like me use you all she wants, right?' Not letting you answer, she continues, 'Now, get off of my bed. There's too many folks in need of a beating, and I don't have time to cuddle.' As you turn from the bed and start to leave she whips you across the ass, and you jump, breaking into a jog that leaves a couple of idle patrons chuckling.";

to say ShagShackSex17: [Natalie, by Mirvanna]
	if NatalieFucked is 0: [first meeting]
		say "     Surveying the room is fun and all, but you are into exploring and moving quickly into the thick of things. Looking around, you find a large mattress-fort in one corner, built out of quite a few of them stacked, standing, and leaning into the structure. Suddenly, as you are still taking it all in, a strong set of powerful jaws close on your neck and shoulder, inhibiting your movement in a secure grasp but not tight enough to do you any harm. You are guided back into a strong set of muscular, dark-spotted arms. 'Hello there,' a voice says, followed by a jet-black tongue flicking up and along your ear, coating it in equally black saliva - not that you are seeing much of it out of the corner of your eye. You can make out the grinning muzzle of one of those numerous herm hyenas that are in the streets, although this one isn't entirely like the others...";
		say "     'Where are my manners? Come sit with me, little tasty one. I've already bitten, so what's left to be afraid about?' You feel her arms slowly and sensually slide down your front, tempting you closer. One paw shamelessly [if player is male]gives your cock a squeeze firm enough that you'll be feeling its imprint for some time[else]slides around to squeeze your ass firm enough that you'll wear a mark for some time[end if]. Meanwhile, the other takes hold of your arm to prevent you from escaping as the huge hyena drags you into the fort and onto a latex-soaked mattress, splattering more latex about everywhere as the springs wheeze under the pressure";
		WaitLineBreak;
		say "     Your captor looks a bit like a latex fox and a hyena fused together, her entire body the same rubbery, inky-blank as the foxes, yet with some darker spots, prominent muscles, and the glinting teeth of a hyena. An erection that looks large enough to need multiple foremen to put up awaits you in her lap. The foundation is plenty solid, a huge, bulbous double knot waiting at the base, ready to stretch out those daring enough to take it. She pulls you closer by the arm until [if player is male]your cock [else]your face [end if]is pressed right against the hot spire. You can feel it throb. 'I'm Natalie,' she says lustfully, 'and the pleasure is all mine.' Exhaling slow and deep, her hot breath washes over you as she undresses you with eager determination. Her voluminous breasts jiggle over you, and she half-pulls, half-tears off your remaining clothes, using her teeth as much as her large paws. Black, latex droplets form at her teats, continuously rolling down the curves and dripping all over you and coating your front.";
		say "     At the same time, you are being drenched by her cock too. Watching latex-cum bubble forth from it in a ludicrous volume, it is easy to see how the mattress has gotten soaked the way it is. You feel the delightfully warm, liquid latex covering your skin, stretching and tightening across your body like an embrace, much like the muscular, spotted arms around you. She guides you to place your lips on her cock-tip, giving you little choice but to kiss it firmly. You stroke your tongue through the black ooze, dipping in the urethra slightly, making Natalie yowl in surprise and pleasure. She strokes your head encouragingly to continue and draws you a bit closer to that heat-radiating shaft.";
		WaitLineBreak;
		say "     Her heavy, slightly squeaky paws grip your cheeks lovingly, and she growls with hunger and fervor, bringing your lips down over her spire's tip, using you like a fuck-toy. 'You'll do just fine... Make sure you visit our fine establishment plenty!' She tugs you down further, ramming her cock all the way into your throat for emphasis. 'Because you may have chosen the venue... but I chose you...' Her pre-cum now spills almost directly into your belly, coating your insides in that same thick, hot, slippery goop. 'And I don't choose bitches lightly...' Her claws press into your jowls, the huge, predatory, latex herm bobbing your head roughly up and down her shaft with lewd squeaks and slurps that bring more than a few people to the mattress fort's entrance, looking in at you and the latex hyena. Never for long though, as few want to meet her hungry gaze and draw the attention you currently are getting - which makes you wonder what you've walked yourself into.";
		say "     Natalie's breath is getting ragged as she clearly enjoys you a lot, yipping mid-pant every time you get your tongue in the right spot. Tentatively, you stroke her knot, and she presses firmly against you, knocking you sideways onto the sticky mattress while she starts fucking your throat in earnest. You try to move your hand to see better, but she grabs your hand and puts it right back on her heavy balls, squeezing it against them until you get the idea and stroke those sloshing cum-factories for your mistress. That huge cock somehow pushes into your belly, making you feel stretched and distended, although that may just be the sheer volume of latex-infused cum that you've swallowed. 'Aaah... almost there, dear bitch,' Natalie groans as she closes her eyes. Without them, her teeth and claws are the only bit of light on her.";
		WaitLineBreak;
		say "     Taking some initiative, you do what you can to stretch your lips wider, eager to take the knot that has been slapping your face for some time and dripping with delicious spunk that you don't want to be missing out on. You bounce from the wheezing springs of the mattress, propelling you forward and suddenly engulfing that gourd, locking lips to the latex sheath stinking of hyena musk and rubber. Your efforts are rewarded with Natalie's roar, the hyena disgorging thick ropes of blackened, tainted jizz into your belly, which inflates comically from her output. Her balls throb hard as they launch their contents into you, and you swear that you can feel rubbery tadpoles in your gut with how thick and hot the sperm is. Spots dance across your vision, and you try to wiggle your nose out of that plush hyena sheath, squeaking in more ways than one. Then the world goes dark, and the latex hyena grins above you.";
		say "     You awaken a little while later. Apparently, someone was taking care of you, as you are currently lying on an only slightly used mattress outside of the fort. A cup of sweet-smelling aromatic tea has been placed on the ground next to it. Must have been one the other Shag Shack workers being nice to Natalie's latest captive. From head to toe, you are encrusted with black latex, her goop having dried and covering your body like a second skin. Groaning and feeling hung over, you sit up, reaching down to take the tea. As you take the first sip, you glance down to your naked chest and see that traced aggressively in the latex coating is the word 'MINE!' The lettering sprawls from your chest to your full belly - maybe a warning to other brothel residents? Evidently, Natalie likes you, although she is back in the shadows of her fort right now. You take your time to drink the tea, then slowly peel off the layer of latex and drop it in large pieces before picking up your clothes and gear from a pile on the ground.";
		PlayerDrink 15;
		increase NatalieFucked by 1; [first meeting resolved]
	else if NatalieFucked is 1: [player has met Natalie]
		say "     You poke around the fort you saw Natalie at earlier. She is close. Somehow, you know that; maybe you are getting better at sensing danger? Certainly not avoiding it. But maybe the insanely hot breath on the back of your neck is the giveaway. 'Hello, pet...' Her paws cups your waist firmly, pressing you against her squeaky, yet moist, underside. Suddenly, you're flung airborne! Crashing into the (fortunately soft!) mattress, you splatter latex on the walls and nearby mattresses from the last time you'd played with her. She is quickly atop you, and you can feel her strong paw clenching your butt firmly. 'So glad that you're back, saves a lot of chasing and dragging. Not that I don't enjoy it.'";
		say "     Natalie doesn't wait for a prompt. You feel her girthy length pressing between your cheeks, hot and eager. Black latex coats over and between your crack, giving a strange feeling as you tense your cheeks. Once she's done hotdogging your rump, her large paw slaps it, spreading latex slime all over your thighs. Searching beneath you, Natalie's thick, rubbery claws poke at your pucker, then drift over to your snatch. 'Oh-ha-HA!... you've been holding out on your mistress. This needs a LOT more of me in it.' Natalie growls lustfully, her teeth catching the scruff of your neck and giving you a slight shake of punishment. [if player is female]Natalie swirls her rubbery claw against your clit, before immediately running it over until you moan for her[else]Natalie playfully tugs her rubbery claw within your sphincter to stretch you out, readying you for her shaft, toying with you until you moan for her[end if].";
		WaitLineBreak;
		say "     Releasing her grip, Natalie huffs. 'You'll do nicely.' Placing one paw on the back of your head, she grinds your face into the latex-cum coating the mattress, positioning herself and rubbing her cock's tip around your entrance. Her excitement is clear, her dribbling cock spilling its slick fluid over your entrance and thighs in a continuous, hot ooze from her tip. She sinks herself in slowly, letting just her ebon, tapered cockhead penetrate, then slams her weight forward with a feral roar. She is too thick to fully penetrate in just one thrust, however, so most of that energy slams the mattress forward against the wall with you along for the ride. You cling to the squeaky springs, but you are unable to turn your head with the latex hyena's heavy paw still grinding you into her cum stains. Your precious [if player is female]vagina feels like it's being split apart, and yet she's still eagerly slamming her hips against yours to get more of that rubbery monster into your depths[else]pucker feels like it's being split apart, and yet she's still eagerly slamming her hips against yours to get more of that rubbery monster into your bowels[end if].";
		say "     Her precum oozes inside, feeling hot in your lower belly where it pools around the head of her shaft, making Natalie's movements slicker as she thrusts. It's still not enough however... at least not for her. Suddenly, she clamps her teeth again to your shoulder. You're locked in place, unable to squirm, as she squeezes you tightly. You feel every bit of her shaft journey up through you and where it distends your belly. She tugs herself back suddenly, sending a string of black goop out behind you and her, along with her shaft fully into the open air. You hear the latex slime splatter wetly over the mattress behind and the floor, then she slams in again, yowling through her clenched teeth as she vigorously repeats pulling out to the tip and slamming in as hard as her strength will allow. It's as if her goal was to paint the room with splatters of her precum as much as fuck you, each pull back sending latex pre everywhere.";
		WaitLineBreak;
		say "     You struggle to get your elbows beneath yourself, but you are immediately slapped back down into the mattress spread-eagle, Natalie yowling as she throws her head back and hips forward. Her shaft throbs, twitching each time she sends a massive rope of her black seed into you. This time, you are certain that you are able to feel each individual oversized sperm, the slippery latex tadpoles squirming about as they distend your belly. You awkwardly manage to slip a hand against your belly. Natalie sees it, grasps it in her own, and pushes it against your still-filling bloated stomach tightly, although this time, the yeen is panting too hard to make a comment. Black seed springs [if player is female]out of the sides of your cunt[else]around the cock in your ring[end if], along with a few of her squirming sperm. Natalie gives a tug backwards, teasing that she might attempt to tear it out now. You close your eyes, realizing that you'd be stuck tied to her for at least the next half hour and might as well rest. Natalie is a good, hot blanket to your mattress, if a very sticky and squeaky one.";
		say "     You wake to Natalie carefully tugging her cock free of you. Judging from the light, it's been hours, and she is still hard. Fortunately, the latexy slime lubes her exit, and with a squelch and a brief backflow of cum from her cock leaving, she is free. Curious, you pretend to still be asleep, seeing what the dominatrix gets up to when she isn't stalking and fucking. You watch as she moves quickly between the mattresses, but she then moves swiftly out of sight. Listening intently, you hear the sounds of water being boiled. She sets a cup beside you, then leaves again, making you even more curious about her apparent soft side. Once she's gone, you get up, only to immediately spill the cup by accidentally sliding the mattress it was on.";

to say ShagShackSex18: [Clive the hole stretcher, by EnFin]
	setmonster "Goblin";
	choose row monster from the Table of Random Critters;
	say "     Besides one wall, you see a sex swing hanging almost to the floor by chains from the ceiling. It looks somewhat roughly constructed, probably built by the equally rough-looking goblin beside it. You assume the swing is so low to accommodate its owner's stature. As you get closer, the small creature notices you and stands proudly beside the swing on top of a wooden box to boost his height a couple of feet and wave you over. He has the usual leathery and mud-green skin of other goblins, and he was fully exposed, save a pair of goggles resting on his temples, a pair of black rubber gloves, and black rubber briefs. His underwear is filled by a large pair of testes, with the sides peeking from the stretched material, which stand out from his diminutive frame. A small indent in the upper part of the rubber hinted at a prick, but it is barely noticeable compared to the melon-sized globes being pushed forward.";
	if CliveFuck is 0:
		say "     The goblin's grin exposes tiny, pointed teeth and a metal tongue piercing as he addresses you. 'So, you wanting some of Clive's magic touch, are ya? Well, there's a reason they keep little, old me around,' he says, slapping one of his massive balls with emphasis at the word little. 'Working here sure beats scrounging and sneaking out in the about, and Clive even gets to tinker and experiment with all of Clive's toys.' Enthusiasm beams from Clive as he hops from the box and opens it to reveal all sorts of strange contraptions with phallic shapes, all slicked from recent use. He turns to watch your surprised reaction at his bizarre collection with an even wider grin than before. He starts pulling some of the items out and onto the swing beside you while speaking. 'Clive's toys are great for filling asses, and Clive knows just how to make it feel extra good. So, what can Clive fill you up with today?' The goblin clicks his tongue piercing against his teeth, already rubbing a gloved hand against your backside as you look at the options laid out before you.";
	else if CliveFuck > 0:
		say "     Clive excitedly jumps from the crate and begins pulling out his contraptions for you, clicking his tongue stud against his teeth repeatedly. Turning around as you approach, he tosses the toys onto the swing and enthusiastically says, 'Clive is glad that your ass is back! Filling it again would be Clive's joy and humor. As one of Clive's favorites, you can play with new, fancy, battery-use toys.' Clive pulls out a controller with a few buttons and a large needle gauge at the top to show it off for you. Then he points to a set of wired pads. 'Clive can give a zip-zip if you like, or fill your ass like before. What can Clive fill you up with today?'";
	say "[CliveSexMenu]";

to say CliveSexMenu:
	LineBreak;
	now sextablerun is 0;
	blank out the whole of table of fucking options;
	[]
	choose a blank row in table of fucking options;
	now title entry is "Choose the inflatable dildo";
	now sortorder entry is 1;
	now description entry is "Let Clive use an inflatable dildo in your ass?";
	[]
	choose a blank row in table of fucking options;
	now title entry is "Choose the enema bag";
	now sortorder entry is 2;
	now description entry is "Let Clive fill your ass with fluid?";
	[]
	if CliveFuck > 0:
		choose a blank row in table of fucking options;
		now title entry is "Choose the electrode pads";
		now sortorder entry is 3;
		now description entry is "Let Clive use electrode pads on your body?";
	[]
	sort the table of fucking options in sortorder order;
	repeat with y running from 1 to number of filled rows in table of fucking options:
		choose row y from the table of fucking options;
		say "[link][y] - [title entry][as][y][end link][line break]";
	say "[link]0 - Nevermind[as]0[end link][line break]";
	while sextablerun is 0:
		say "Pick the corresponding number> [run paragraph on]";
		get a number;
		if calcnumber > 0 and calcnumber <= the number of filled rows in table of fucking options:
			now current menu selection is calcnumber;
			choose row calcnumber in table of fucking options;
			say "[title entry]: [description entry]?";
			if player consents:
				let nam be title entry;
				now sextablerun is 1;
				if (nam is "Choose the inflatable dildo"):
					say "[clivesex1]";
				else if (nam is "Choose the enema bag"):
					say "[clivesex2]";
				else if (nam is "Choose the electrode pads"):
					say "[clivesex3]";
				wait for any key;
		else if calcnumber is 0:
			now sextablerun is 1;
			say "     You step back from the swing and tell the goblin you're not interested right now.";
			wait for any key;
		else:
			say "Invalid Option. Pick between 1 and [the number of filled rows in the table of fucking options] or 0 to exit.";
	clear the screen and hyperlink list;

to say clivesex1:
	say "     You point at a black, rubbery dildo attached to a thin tube which leads to a hand pump. Clive quickly swipes all of the items from the swing and tosses them into the box before pulling out a bottle of lube and slamming it shut, dildo in hand. 'Ass forward for Clive,' the little man orders you, gesturing towards the low swing. Removing your clothing, the goblin politely takes them to place upon his box. You lay your back down on the swing, lightly lifted about two feet from the ground. Clive lifts your right leg up, snapping a strap around your ankle and attaching it to a chain, then repeats with the other, framing your ass up for the goblin, who stares it down with a greedy look in his eyes. You start to hesitate as he quickly slathers lube onto the already sizable inflatable toy with maybe a little too much enthusiasm, apparent in his rush. You feel a slick, gloved hand smear lube along your hole, rubbing it around, before a finger is pushed inside of you.";
	say "     Surprisingly, the goblin is gentle as he probes around with the digit, smearing the lube along your walls. After thoroughly coating your insides, he sticks in another digit, pulling them apart inside to pry your hole looser, then inserting a third finger while swishing them around inside of you. You glance down your body to see Clive staring with intent as he probes you, the rushed expression seemingly replaced with wonder at your quickly loosening ring. Looking satisfied at opening you up, Clive takes the rubber phallus and gently pushes it against your opening, smoothly guiding it in as your relaxed hole consumes it.";
	WaitLineBreak;
	say "     Now all the way in, you lay your head back, feeling sufficiently full and incredibly relaxed with the smooth object inside of you[if player is male], barely noticing your erection climbing upwards[end if]. Then with a sudden twist, you feel the dildo quickly spinning around while being pulled out of you, a wave of pressure sweeping through your ass from the walls being suddenly stimulated. Before you can even react to the sudden sensation, the dildo is shoved deep inside of you again, forcing a moan from your surprised expression. The sound of Clive's tongue stud clicking against his teeth can be heard in rhythmic progression with the twist, pull, and rough shove of the dildo[if player is male], and almost in sync with the throbs of your penis as your prostate is pushed against[end if]. Feeling your ass begin to adjust to the quick movements, you look again at Clive. He is still staring intently at your ass, with his tongue sliding across his lips, causing the piercing's clicking sounds.";
	say "     Clive then looks up at your eyes and stops his movements, leaving the dildo fully immersed. A toothy grin forms as he raises the hand pump where you can see it and starts squeezing it rapidly. The effect is immediately apparent as you feel the object inside of you quickly expanding and pushing against your walls with incredible pressure. You whine, worried that such rapid growth will split you apart, but the pleasure from all of the pressure filling your lower body and forming you around it causes you to hold your breath. Clive stops squeezing the pump, and you exhale as you feel your body try to force out the large object, creating more pressure than it can handle, but Clive's other hand is pushing at the base of the toy, holding it in place. You only now realize that you've been tightly clutching the chains above you and can't find the will to let go as your body's energy is too focused on the swollen object invading you.";
	WaitLineBreak;
	say "     Slowly, Clive relents on your hole, and the toy begins to push out, stretching your hole more than you thought possible. Halfway freed, the toy is pushed back inside of you. Surpassing your body's feeble contractions, you feel the intense shape filling you back up and squirm at the pulsing sensation racking your body. With a click, you suddenly look at the goblin. He no longer looks at you with wonder or focus, but with a smug smile and an aroused gaze. 'A full ass is a good ass for Clive. Stretched out by Clive, wide and desperate for release.' The gloved hand pumps the dildo a couple of times, forcing your head back as your nerves scream in bizarre pleasure at feeling so stretched. Clive clicks his tongue as he removes the gloved hand from your hole. Your body having given up expelling the object, too exhausted to resist, leaves the dildo firmly in place, with your stretched opening hugging the expanded toy. You hear the goblin speak as rubber hands rub along your ass and thighs. 'Yes, your hole is under Clive's control now.'";
	say "     With that, the goblin begins using both hands to twist and pull the toy out of you, sending more waves through you. However, this time is calmer than before, your nerves already so exhausted. The feeling is pure bliss from what signals your body still sends your brain as the twisting out becomes twisting back in. The spiral of pleasure inside of you seems to be bobbing in and out as the movement gains speed[if player is male], and your cock leaks out precum in a steady stream that pools on your chest[end if]. As the goblin reaches a top speed, working his hands with inhuman dexterity, the dildo is spinning and pistoning out of you with intense speed, creating a chorus of wet noises and moans that you barely realize that you're releasing. Suddenly, the pressure pulsing inside causes you to shudder and tense your body up with a furious grunt, pulling you up slightly by your bound legs as [if player is male]you feel surges of cum shoot across your chest. Each change of direction by the pistoning twister inside of you forces another jet streaking over you[else if player is female]as the sensation sets off a chain reaction of nerves inside of you, forcing a powerful orgasm[end if]. As your body slowly lowers back down, Clive's movements calm down, the tempest inside of you settling into a mild pulsing.";
	WaitLineBreak;
	say "     Slightly out of it from the overwhelming sensation, you feel the dildo being slowly pulled from you, allowing your ass to finally relax. With a wet pop, you can feel your tired hole still left agape, too used up to close back just yet. You see Clive lift up the object, looking more like a bloated eggplant and now at least half a foot wide. Shouldn't it be bigger than that? It certainly felt bigger inside of you! Clive gently massages your hole, easily slipping the tips of his fingers in as he runs them along it. 'Very good ass! You let Clive play with ass more, and we will share more toys!' the little goblin exclaims. Taking a moment to breathe while your hole is still being massaged, you eventually slide from the swing to wipe off and slip into your clothing. The odd goblin grins and waves at you with the swollen dildo still in hand. 'Don't forget! Come see Clive again and get even more magic touch.' You shuffle awkwardly towards the exit, well used sphincter still sore, while the huge empty space inside of you slowly starts returning to normal.";
	if CliveFuck is 0:
		now CliveFuck is 1;

to say clivesex2:
	say "     You point at a tube connected to a funnel and a detachable drip bag full of water. Clive quickly swipes all of the items from the swing and tosses them into the box before pulling out a bottle of lube and slamming it shut, tube in hand. 'Ass forward for Clive,' the little man orders you, gesturing towards the low swing. Removing your clothing, the goblin politely takes them to place upon his box. You lay your back down on the swing, lightly lifted about two feet from the ground. Clive lifts your right leg up, snapping a strap around your ankle and attaching it to a chain, then repeats with the other, framing your ass up for the goblin, who stares it down with a greedy look in his eyes. You hesitate at letting the goblin use your ass with the anxious look in his eyes as he dabs lube on the end of the tube that is shaped like a small butt plug. Once that's done, he starts rubbing a gloved finger against your hole to smear a little more lube, eventually pushing it in to coat a little of the inside. He probes you with a serious and intent gaze, like an artist sculpting a masterpiece. Properly slicked up, Clive sinks the tube's end into you, resting just inside of your tight pucker, which instinctively clamps down on the object. He then hooks the drip bag up on one of the swing's chains. Looking over your form with a sly smile, the goblin clicks his tongue piercing against his teeth and adjusts a small valve on the drip bag, allowing water to pour down the clear tube and straight into your rectum.";
	say "     You feel the water rushing into you, noting how it already seems warm inside of you. The filling sensation coats your walls and spreads deeper as the bag drains into you. Halfway empty, Clive readjusts the valve, and the water flow stops. You shift slightly, the swing rocking with your movements, and you can feel the warm water sloshing around inside of you, further coating your insides and running down them only to splash back up again. Feeling sufficiently full, you hardly notice Clive moving around until you hear him place a bucket beneath you. With a stern voice, Clive tells you, 'Wet ass now. Hold water best you can inside, or we'll have to try again.' You can see a smile tug at his thin lips at inevitably having to redo the process. He unscrews the bottom of the little plug inside of you, leaking some water in the process until you clench, your inner sphincter holding the water in check. With a toothy grin, the goblin starts climbing up on top of you, causing you to grunt as the extra pressure makes holding the water in far more difficult all of a sudden. Thankfully, his small body isn't too heavy, save his balls, which feel like lead weights in comparison. The feeling of pressure inside and on top of you feels progressively pleasant, and you try to hold onto that feeling for as long as possible, but as soon as Clive starts [if player is male]rubbing on your penis and [else if player is female]rubbing against your clit and [end if]rocking softly, your focus breaks, and a small slip of water streams out of you, turning into a surge as the flowing sensation causes you to release. As your body drains most of the water out, Clive snickers. 'Ass is wasteful, losing all the good water. Clive refills thirsty ass,' he says while screwing the tube back onto the plug.";
	WaitLineBreak;
	if WSlevel is not 1: [normal or more WS]
		say "     You think he is about to empty the rest of the drip bag into you, filling you again with that warm, soothing pressure, but instead of opening the value, he removes the funnel part from the drip bag and moves it out of your sight, obscured by his form, which is now kneeling with its back to you. You start to wonder what he's doing with it when you suddenly see yellow fluid flying down the transparent tube towards your ass. You feel a flood entering your bowels, and unlike the water, this is much hotter and much more forceful as it enters you. Clive looks over his shoulder with a grin, clicking his tongue. 'Clive treats thirsty ass with the best thing. Marks ass and hole with his piss. Makes ass nice and full.' With that, Clive lowers the funnel so you can just see it beneath his huge balls, filled almost to the brim as the amount streaming into it accumulates slightly faster than it drains into you. The filling sensation continues, leaving you sure that there's more of the goblin's hot piss inside of you now than there was water before, and you moan at the warmth violating you so fully. The piss flow stops dripping into the funnel, still full of the acrid fluid, as well as the now yellow tube.";
		say "     'Ass needs to drink all of Clive's piss, or else ass will be punished.' While you don't know what kind of punishment the strange goblin might have in store, you don't even care as your body wants more of the fluid inside of you, and you try lifting your lower body up slightly to allow the stuff further entry into you. You see the funnel start to slowly empty, and the amount in the tube drain away as your bowels are further flooded. Once the tube is drained, you lower yourself cautiously, feeling the goblin's piss slosh inside of you as your gut looks swollen and pregnant. Then Clive unscrews the tube and starts massaging your sex again, gently lowering his weight back onto you. You squirm as you try to hold everything in, not wanting to relent any of the warmth radiating inside of you, but the goblin's balls force the stream to shoot out of you anyways, filling the air with the distinct scent of piss as it pours into the bucket below. The sheer volume flowing out of you and pushing past your hole sends shivers down your spine, further increasing the pleasure Clive is giving your [if player is male]erect penis now wedged between his rocking balls[else if player is female]pussy[end if].";
	else: [low/no WS setting]
		say "     Clive reopens the valve of the bag and warm water flows into you again, flooding inside until you feel sufficiently full again, as you mentally prepare for Clive's weight and stimulation. Removing the tube, Clive slowly lowers onto you, immediately reaching for your groin as he rests his heavy balls on top of your stomach. Clive's handwork become more vigorous and causes the swing to rock, creating an intense, sloshing sensation within you. You moan softly from the waves of pleasure this brings you for what feels like several minutes. The rocking eventually proves too much though, and the warmth pressing against your walls slips out, spraying below.";
	WaitLineBreak;
	say "     You realize now that while one hand is pleasuring you, Clive's other is working at his own prick, tongue stud clicking in sync with the pumps. You moan as the last of the fluid gushes out in spurts from your pucker, and Clive, picking up on this, quickly reconnects the tube with anxious fervor. As soon as it's connected, you feel Clive's balls grinding pleasurably against your groin as he beats himself off feverishly. With the swing now rocking rapidly and the goblin's heavy balls churning on top of your sex, you feel close to an orgasm. With a restrained grunt from Clive, you see him thrust the funnel into his groin and with incredible speed, pump cum straight down the tube. The sudden rush of semen shooting into your ass with increased pressure from the tight tube nearly launches the plug out, flooding you with spunk as the goblin visibly rises from your growing stomach as his balls pulse and contract. The sudden rush and grunts from the goblin still rocking those mighty balls against your groin pushes you to orgasm, [if player is male]spraying cum onto the heavy ball sack and painting the green skin white with your seed [end if]as you grind yourself against the weight. After your release, your sphincter relaxes just enough for the plug to pop out of you as spunk shoots out, completely missing the bucket and hitting the ground a few feet away.";
	say "     Spent and still filled with an incredible amount of cum, you lean up slightly as Clive slides off of you and onto the ground. He is huffing and clutching his drained balls as he tells you, 'That is very good ass. Can even hold Clive's mark. Hold more than many asses. *pant* Clive would like to play with ass again, with more toys next time.' You nod sheepishly at the thought and fall back onto your back to breathe for a moment, still in a haze. After a few minutes, you slide off of the swing, with several ounces of cum spilling from your hole before you tighten it back up to savor the full sensation for as long as you can. You redress and start to head towards the exit as the goblin waves at you saying, 'Don't forget! Come see Clive again and get even more magic touch.'[mimpregchance]";
	if CliveFuck is 0:
		now CliveFuck is 1;

to say clivesex3:
	say "     You point at the wired pads. Clive quickly swipes all of the items from the swing and tosses them into the box before slamming it shut, electrodes in hand. 'Ass forward for Clive,' the little man orders you, gesturing towards the low swing. Removing your clothing, the goblin politely takes them to place upon his box. You lay your back down on the swing, lightly lifted about two feet from the ground. Clive lifts your right leg up, snapping a strap around your ankle and attaching it to a chain, then repeats with the other, framing your ass up for the goblin, who stares it down with a greedy look in his eyes. You hesitate at letting the goblin use your ass with the anxious look in his eyes as he sticks the little pads on your body, one for each inner thigh and each butt cheek. He attaches the wires to his handheld controller and smiles at you as he flips the switch.";
	say "     You instantly feel a sharp sting jolt through your thighs and butt that quickly gives way to a pleasant sensation. Hearing your muffled shriek, the goblin snickers. The feeling makes your sides tingle, radiating deep beneath the skin. 'Harmonious' is the only way you can think to describe the sensations emanating from the pads. The pleasurable tingling increases as Clive turns a dial up further[if player is male], making your cock stiffen from the pleasure running even up to your groin[end if]. Closing your eyes, you relax and lay back in the swing, floating with that pleasant sensation humming across you. With the press of a button, the radiating sensation starts coming in waves, and you feel like your atoms were riding a current of pleasure. You can't help but reach down and rub [if player is male]your stiff prick[else if player is female]your clit softly[end if], feeling that pulsing travel through your fingers that fondle the area.";
	WaitLineBreak;
	say "     Thinking the sensation can't get much better, you feel the goblin push his pointed face against your exposed hole, running his thin lips against it before snaking a slender tongue that teases your ring. Suddenly, the pulsing sensation shifts squarely towards your ass for just a second, the shift forcing a wave of pleasure through you. Then it happens again. Suddenly, the feeling stays, and an intense stimulation is aiming at your hole, brought upon by the electrical currents being conducted through Clive's tongue piercing, which is now running along your ring like a magic wand of ecstasy. The tongue lashes playfully for a while, wetting the outside, as the saliva trails down the goblin's cheeks.";
	say "     His head starts bobbing and giving more exaggerated licks as his tongue smears itself along your hole forcefully. With no warning, your relaxed hole is suddenly bypassed by the slender tongue, and you feel the electrical current follow it inside of your ass. Soft and slick, the tongue snaking inside of you manages impressive reach as it glides along your inner walls. You continue rubbing yourself as the goblin skillfully tongue fucks you with the intense electrical pulses surging around your hole at his demand. For a bit, Clive pulls back while saying, 'Hm, ass is very tasty. Good ass in and out, just like Clive suspected. Now, Clive takes full control of ass.' A grin spreads on his face before lifting the controller and turning the dial up almost half a twist.";
	WaitLineBreak;
	say "     The surge of energy whips through you, and all of the pleasure from before is now doubled. Before you can really process how good that change felt, the goblin's tongue is already rapidly assaulting your hole in messy streaks, carrying the surge of electricity to its tip. The penetration is less focused now and just a mess of licking your ass and twitching inside of you with no real pattern. The pulsing flying through your groin and ass drive you over the edge as you suddenly lurch upwards in orgasm, but not before the goblin grips your thighs and launches his tongue back fully inside of you with a writhing motion you can't even feel over the electrical tingling flooding your senses[if player is male]. Cum shoots upwards and showers over your chest, legs, and the goblin's head in multiple spurts[end if] as your body convulses in pleasure.";
	say "     After you've been rattling for a bit, Clive pulls away from you and turns the dial down to zero, finally letting your body relax. You just lay slumped in the swing as the goblin removes the pads from your body[if player is male] and wipes his head and goggles clean of you cum[end if]. After taking a breather, you slide off of the swing to wipe yourself off, finding it hard not to rub a hand against your slick hole in the process. You can still feel a faint tingling from your nerves in the area. As you redress and prepare to walk away, Clive waves saying, 'Bring tasty ass back for more play! Let Clive use more toys next time.' You nod softly to the odd goblin and make your way towards the exit";

to say ShagShackSex19: [Dylan the minotaur by Vinickus]
	if strength of player > 15:
		if DylanFucked is 0: [intro text]
			say "     Looking past several attractive partners, your gaze settles on the well-defined, muscular form of an eight-foot minotaur, his body coated entirely in lustrous, brown fur. As you approach the large mutant, the muscles in his back repeatedly tense and twist up before relaxing. Once you step closer, however, you begin to hear the telltale grunts and groans of primal sex, the male's monstrous hips pounding into the current customer's eager hole to his heart's content. 'Hey there,' he grunts out through gritted teeth, half-moaning and half-mooing. 'Let me just finish up here, and then I'll get to you.' His thrusts stagger before he gets back into the rough fucking. '*Mmph* It's been a while since I've caught a scent like yours. I bet you have all those lust-crazed beasts running for cover.' He moos loudly, his thrusts losing pace again. 'Don't you?'";
			say "     After his question, he turns his bovine head from his current fuck-toy to watch you with one eye. That's when the light glints off the gigantic, ivory protrusions adorning his head, the four foot horns pushing out away from his head, then back inwards, straightening halfway to the tip. Luckily for [italic type]probably[roman type] everyone, the horns are sanded down, leaving a smooth end in place of the dagger-points they had before. You take in those tight, shapely ass cheeks once more, watching them spread out just enough to give a glimpse of his tight equine hole. Unfazed by your shameless voyeurism while he ravages his partner with ever increasing zeal, the minotaur's hips keep wetly slapping away. Oh, you [italic type]have[roman type] to see the face of the person getting reamed now!";
			WaitLineBreak;
			say "     Your curiosity gets the better of you, and you can't resist peeking around to see who the lucky bottom is. It turns out that those big, hoof-tipped hands are gripping at the hips of a rather small-even for his species-rabbit. The, at tallest, four foot male is getting reamed by a thick, equine shaft. Sloppy, wet squelches resound with every rough thrust as his stomach bulges from the sheer mass of cock shoved inside of him. But that's not what makes your dick lurch against the confines of your clothing; no, what does are the gallons of white cream pouring out of the rabbit's ass, drenching the minotaur's crotch in thick cum and coating every inch of the lapine's ass. The growing bulge in the little guy's stomach suggests that this flood of male essence won't be stopping any time soon.";
			say "     The minotaur's shaft just keeps throbbing as you watch it, the big beast's hips thrusting relentlessly into the smaller rabbit mid-climax. Dylan's flared head fucks his cum deeper into the smaller male's pulsing colon, guaranteeing that the fuck-puppet is marked in musk and seed, inside and out. Dylan keeps you in his vision, even when the smaller male screams out his own pleasure and unloads a comparatively pitiful load onto the bull's crotch, the beast letting the smaller male cover him in speckles of white without even batting an eye.";
			WaitLineBreak;
			say "     When the seemingly endless stream of cum stops flowing out past the tight anal-seal around Dylan's cock, the rabbit's stomach bulges out, almost as if pregnant. The minotaur stays silent, his nostrils flaring as he greedily drinks in your scent. 'Well, I'm done with this one now,' the big beast says, squeezing the rabbit enough to force more cum out around his cock. 'But I think that you're in need of a different kind of pleasure. One that doesn't involve me breeding you. At least, that's what I get from your...' He breathes in deep, eyes closing while he inhales, only opening them as he lets out the trapped air along with a deep, satisfied rumble. 'Strong scent.' The immaculately muscled bovine then hunches forward, lifting the now-dazed rabbit completely off of his shaft, setting the drooling, cum-coated mess onto the silken sheets draping the mattress in front of him.";
			say "     The big guy's thick, hoof-tipped fingers then curl around his white, glistening cock, stroking from the well-trimmed crotch of the beast to his flared tip, as he coats the calloused skin of his hand in thick, pure virility. His face takes on a satisfied expression as he releases his cock, moving his hand behind him as he pushes a cum-drenched finger between his pert ass cheeks, the appendage reappearing seconds later, before once more being jammed back in.";
			WaitLineBreak;
			say "     You break your silence as you watch his finger push his cum into his rim, lubing it with the musky, thick fluids, and explain all the reasons why you'd love to mount him, unload inside of him, and grind your hips against those sculpted cheeks. You watch as his face gives a slight smile, before it grows into a grin, his eyes lighting up from your ideas. Hearing a pop as his finger is brought back into view, you notice that there's still plenty of cum on his hand, but there's even more dribbling down his lower cheeks and legs, his entrance obviously oozing with the mutant seed.";
			say "     When you draw your eyes away from the seed dripping from his ass, you notice that he's bent over the rabbit, placing his hands firmly against the bed, and guiding his cock on top of the under-four-foot male. The little guy is just aware enough to realize his place, so he kisses at the shaft, the tip still leaking globs of cum onto him. The big guy then angles his ass to stick almost straight up, his equine hole perfectly at level with your eager dick.";
			now DylanFucked is 1;
			WaitLineBreak;
		else: [repeats]
			say "     You know exactly what you're going to do as you set your eyes on Dylan again, your memories filled with images of his ass, his hole, and that utter feeling of bliss you had as you unloaded into the undulating rectum of the male. Your mind flushes with pure lust at the rush of memories, and when you're within arm's reach of him, you shove the man over before he utters so much as a whisper. His chest slams into the silken sheet-covered bed before him, filling the room with the sudden protests from the bed's springs. Gripping his hips, you drag his ass upwards to level it with your groin Grabbing his pert butt, your fingers dig into the lightly-furred skin, hands grasping at the well-formed flesh, your cock leaking drop after drop of precum into your clothes.";
			WaitLineBreak;
		say "     Yanking open your pants, you take your [cock of player] cock out and pull your shirt up over your head, hooking it behind your neck. With your upper body revealed and your cock out, you grind your tip right against the minotaur's doughnut-shaped, cum-lubed hole. When your grinding finally turns to thrusting, your tip slips in easily, only to be pulled right back out. After just a few seconds of slipping in and out, you can't resist your need anymore and easily slam home, sinking the first-half of your erection into Dylan's tight, throbbing hole with little effort. With just one more short thrust, you feel your testicles press right against the male's taint, your hips firmly planted against his furry ass.";
		say "     You almost immediately notice how loose it feels when you're fully inside. However, when he tightens his equine hole around the base of your cock, you find yourself mindlessly humping away at the man, slapping your hips against his ass and filling the room with the sound of moist skin against furry flesh. A fog sets in too, leaving you unable to stop your rutting for several, long minutes. Every part of your mind is purely focused on that wonderful feeling that encapsulates your dick. Your mind does catch up eventually, though by no small effort on your part, allowing your constant fucking to slow to minor thrusts to help you feel every part of his wet ass squeezing and pulsing around your cock. All of it combines once more, clearing your mind of higher thoughts and sending you to a base, lust-filled path of thinking.";
		WaitLineBreak;
		say "     The slapping sounds of your hips and balls against Dylan's ass fill the area, almost deafening in their frequency and brutality. Nevertheless, as you feel your cock start to throb, the moans from both of you become even more audible than the ravenous fucking you're currently giving the mutant. Dylan then starts to roughly slam his rear into you, as if he's just a breeding bitch waiting for his next load. Of course, you're not one to turn down such a needy whore, so you angle your cock-tip right against his prostate, building up more and more pleasure within yourself and him, until you finally slam in balls-deep.";
		say "     Everything goes dead silent when you slam those hips against that curved ass, the pre and cum squelching around your cock the only audible sound as you fire off shot after shot of cum deep inside him. When your ejaculation begins to abate, his ass cheeks pulling tighter together as you feel the fur tickle across your extra sensitive erection. The pulses you feel around your dick come shortly before you hear liquid rushing, bringing the smell of strong, animal musk with it and overwhelming everything else. [if DylanFucked is 0]You momentarily wonder if the rabbit will even have the ability to think anymore[else]You almost fall back into a mindless rut just from the sheer power of the musk, but you hold on, barely[end if].";
		WaitLineBreak;
		say "     Once Dylan stops unloading all the seed packed inside of his gigantic balls, you manage to pull your softening shaft out, the appendage caked in white cum, no doubt from both you and the cum-turned-lube the minotaur used. Seeing the mess on your dick, you decide to wipe what you can off on the big lug's ass, leaving a nice, sticky mess for him to remember you by. The minotaur barely even registers the new wetness on him though, his body completely relaxed, his mind no doubt lost in a daze. You then tuck your cock back into your clothes, tidy yourself up, and pull your shirt back down, walking back to the main area of the brothel.";
	else:
		if DylanSucked is 0: [intro text]
			say "     You drink in the sight of the massive hunk, eyes gazing over his huge cock, sculpted, Adonis-like torso, bulging arms, and everything else about his worship-worthy, brown-furred form. When you finally tear your eyes from his body, you look up to his brown-furred muzzle, and as you step closer, his eyes gleam, and his grin grows. 'Another fun, little toy for me to play with. I hope that you last longer than my other clients.' The bull then chuckles, his horns catching the light as his body moves with the laughter. The four foot masses had their points sanded down, and they protrude to the side, before bending inwards, and then straight out again halfway through.";
			say "     'Don't stress it too much. I'm sure that you'll do fine,' he reassures, as he stops smirking and just gives a soft smile. Dylan then nods his head at you, and without taking his eyes off of your own, tilts his muzzle towards his equine cock, raising an eyebrow. If that wasn't an obvious enough cue, he grabs the base of his cock and wiggles it in your direction, letting the thick precum flick off of it and onto the floor. You find that the spicy aroma filling the area around him makes it impossible to resist his desires, and so you fall to your knees in front of him. As soon as you're between his sculpted legs, your mind almost immediately takes a step back from consciousness as the musk [italic type]truly[roman type] hits you, your pupils dilating as you almost pass out.";
			now DylanSucked is 1;
			WaitLineBreak;
		else: [repeats]
			say "     You stare longingly at the hunk of a beast that had filled your stomach so completely with his seed last time you serviced him. The need rising in you serves as plenty of evidence that you're happy to guzzle down even more of his essence, so there's little reason to be prodded to do what you did before, more than content to settle in between the minotaur's legs once again. When back in your proper place, you eagerly shove your face into his crotch.";
		say "     'Easy,' Dylan comments, as he holds your head in one large hand. The hoof-tipped fingers then dig into your scalp as he pulls you forward, grinding your face into his groin, smearing his day's worth of pungent musk and sweat onto your face. 'If we were in the wild right now, my scent would be wiping just about every thought from that pretty, little head of yours. But, I'm not a lust-crazed beast, so all that's going to happen is a bit of fun.";
		WaitLineBreak;
		say "     Dylan starts to lose his patience as he rolls his hips upward, grinding even more musk into your face as he pulls you further up the shaft. Eventually, the precum that has already drenched the flared tip trickles down the equine cock, drenching your face in even more of the creature's musk, but this time, the aroma comes directly from his testicles. By instinct, you lick your lips during all of this, mixing the sweat and precum flavor on your taste buds, which immediately causes your penis to make a small deposit of its own in your clothing. Now, thanks to all of the masculine fluids smeared across your face, every single breath, every lick of the lips reminds your senses of his potency.";
		say "     It takes very little time for Dylan to drag your mouth the rest of the way up his shaft and to the tip of his cock, rubbing your lips over the flat surface to give you a thorough taste of his essence. You feel your mind completely lock into an eagerness to do anything to please this mutant, and you know that he wants more from you, so you open wide, reaching your saliva-and-pre-stricken lips as far down that massive shaft as you can, almost reaching the medial ring. Once you tightly seal your lips around his flesh, you eagerly suckle at what's already in your mouth and throat, earning shots of his seed regularly, thanks to your efforts. All throughout your ministrations, you hear pleasured moo-moans from above, which only encourage you to take in more.";
		WaitLineBreak;
		say "     With surprisingly little effort, you've managed to take in over half of the big guy's titanic cock, stuffing it about three-quarters of it way down your throat. However, your mind and mouth both salivate at the thought of being pressed firmly into the source of all of his musk, and so you cram even more down your throat, and more, and more, even managing to surpass the point when you shouldn't be able to breathe anymore. Eventually, you cram all of his equine need down your throat, your nose and most of your face buried in Dylan's sweaty and thoroughly musky, brown-colored groin.";
		say "     When you start to pull back, you watch as the minotaur's hooved-feet stomp and scrape against the ground, the beast shuddering and forcefully driving up into your retreating mouth. All of the movement and force makes you clutch at his thighs with both hands, feeling the muscles tense and relax over and over again. Next thing you know, his hand shoves you back down onto his erection, his hips face-fucking you faster and faster, making you gag and cough as saliva and cum fly out of your mouth and over his groin. After just a few moments of the feral humping, he holds those damp thighs firmly around your head and starts to thrash about. Shortly, after he starts to thrash, you feel the equine shaft in your mouth throbbing, and you can feel Dylan's hot load shoot through the base of the cock, engorging the massive shaft as he deposits cum directly into your stomach.";
		WaitLineBreak;
		say "     Only when you start to feel lightheaded from having your airways blocked by a giant, flared cock does he start to pull out. His dick never quite stops throbbing as it leaves your throat though, and soon enough, the engorged flare sits on your tongue, unloading the musky, sweet tasting seed right onto your taste buds. You manage to catch your breath while still guzzling down as much of the nectar as you can. So distracted with drinking it all down, you don't notice the warmth gathering in your groin until the essence of your better starts to taper off. Nevertheless, you just barely manage to pull out your [cock of player] penis in time, your balls suddenly unloading their own share of seed all over the floor between Dylan's legs. The minotaur begins to chuckle at this.";
		say "     'There's always been something special about my cum.' You look up, watching as he glares down at your lurching dick as it unloads spurts of your [cum load size of player] load. Everything combines to fill you with orgasmic pleasure, the feelings of insane ecstasy only receding to a mere bliss when your ejaculation ebbs down to a trickle. Once you tuck your cock back into your pants, you give Dylan's shaft a goodbye kiss, dragging your tongue from the base to the flare in hopes of gathering up more cum or musk and swallowing anything you can get. You stand up, share a sloppy kiss with the wide-tongued minotaur, and turn around, feeling a calloused palm slap across your ass as you walk away.";

to say ShagShackSex20: [Archer the Great Dane]
	if ArcherFucked is 0: [first time]
		say "     Eager to see what Jerome keeps for his customers in the few side rooms available in the very open building, you step through a door into a relatively large and dimly lit room. Mind wandering, itching for an exciting partner, you start looking around. Then suddenly, a glimmer of light in your peripheral vision draws your attention. Looking over, you spot a large figure bounding towards you in a rapid dash. You can't help but instinctively brace for impact, a bit shaken from the sudden appearance. The dark outline of the pouncing beast is nearly taller than you and keeps coming without any sign of stopping, causing you to step back from it... right onto an empty bottle lying abandoned on the floor. The plastic vessel slips out from under your foot, sending you stumbling and falling onto one of the messily laid mattresses that litter the room.";
		say "     Clutching your foot and cursing your clumsiness, you realize that it has put you in quite a precarious situation right now - disoriented and on the ground, right in front of whatever creature lives in this room. Feeling that it is close, you slowly lift your head and meet the gaze of the enormous beast, looking into two glowing eyes that are visible through the thick shade. The sheer size of the animal is enough to make you quiver, and even though you can still only see an outline of it, the heavy breaths and scrapes of claws on the floorboards are enough to tell you that it is big and powerful.";
		WaitLineBreak;
		say "     Looming tall over your form, the black figure steps forward. With your eyes finally adjusting to the dim light in the room, you now get a good look at it: it is a monstrously sized dog, with dark-gray and black fur covering it from head to toe, and its bright, pale-orange eyes were still locked onto yours. A glance further back tells you that 'it' is a 'he' - with a large canine cock partially visible and only slightly poking out of his thick sheath, but still vividly aromatic to your senses. Obvious from the wagging tail behind the monstrous dog, he does not intend to lay harm to you. Instead, he's intent on the same thing that everyone is these days: quelling a primal instinct of his.";
		say "     Immediately upon realizing this, you instinctively shuffle backwards, scrambling to get away from the increasingly objectionable hound. However, now that you know just what it is, the beast is not abnormal in size after all, just on the very end of the spectrum for canines - a Great Dane. Attempting to stand and hold your ground against the Dane, he gives a slightly challenging bark and pounces. You manage to duck, but not without getting a whiff of his musky scent. The intense wave of strangely sharp odors hits your senses like a wrecking ball, making you feel delirious and lightheaded. colors, bright lights, and warping shapes fill your vision. In what thoughts you can still grasp despite the muddled state of your mind, you realize that some kind of chemical or pheromones must be secreted from the Great Dane's fur!";
		WaitLineBreak;
		say "     Falling to the ground as your sense of balance goes haywire for a second, the scent and chemicals continue to mix in your brain, making you feel increasingly unhinged. Meanwhile, the canine comes to stand over you, eyeing your weak and quaking body, and decides that now is as good a time as any to get exactly what he wants. Licking his lips, he starts to paw at your body, roughly dealing with the clothing that is in the way of his desire. Then the large dog turns you over with a shove of his muzzle, until you lie belly up beneath him, pinned to the mattress by a heavy paw on your chest. This, of course, exposes you to more musk, forcing you into heavy coughs and sputtering as you breathe it in.";
		say "     The thick gasses whirl in your nostrils, and droplets of an acidic substance fall from his sticky coat, creating steam and vapors wherever they land. The weight of the immensely heavy beast pushing forcefully on your ribcage and the distracting scents surrounding you combine to completely paralyze you. Body falling limp, you nevertheless feel no dread at all. Instead, arousal begins to wrack your body as your hands spring to life and drift towards your loins[if player is male]. Your needy rod stiffens, and you happily oblige it, kneading your cock like your life depended on it[end if][if player is female]. While the beast begins to shift his body towards your head, you are too preoccupied brushing over your abused pleasure button and sinking your fingers into your gushing feminine folds[end if].";
		WaitLineBreak;
		say "     Now with the Great Dane's head over your stomach and his crotch looming above your eyes, you can now see his stiffening and raging erection. Small beads of silvery pre forms at the end of his pointed, veiny shaft, dripping onto your nose for maximum scent exposure. It sends you manic with need. You [bold type]need[roman type] that sweet liquid in you right the fuck now. Lowering his hind legs so that his cock drags across your lips, nose, and brow, the musky hound teases you with what you can't help but desire. Greedily, you roll the slippery dick with your tongue, pulling it in past your lips and resting inside of your salivating mouth. Taking this opportunity, the dog rams home, lodging his member securely in your throat, and your drugged body wouldn't have it any other way. Retrieving his phallus after nearly a half minute of suffocating you with dick, he swiftly plunges it back in with even greater force, repeating this process and thoroughly throat-fucking you for what feels like hours.";
		say "     Panting with ever-increasing fervor, the beast does his best to go balls-deep in your gullet. You can feel the curve of his knot hit your straining lips, with him trying to wedge the softball-sized bulge into your mouth too. Clearly, it will never fit, but somehow, you feel yourself wishing that it would so you could have this glorious, musky beast knot your mouth and have you tied for ages, your nose buried in his crotch-fur. The heady chemicals literally dripping from him fooling with your perception, you just take anything the hundred pound hound wants to do as right and proper, happy to have him relieve his urges in your esophagus.";
		WaitLineBreak;
		say "     The canine increases his pace and force quickly, soon really pushing the limit of what your frame can take. Heavy thrusts cram as much of the saliva-lubricated manhood inside of you. His bulb expands to double its size, telling of what is to come. For a second or two, everything stops, with the dog's shaft deep in your throat no longer moving and both of you motionless in silence. Then his large shaft throbs wildly, sending a deluge of thick and creamy liquid rushing down your throat and into your stomach. The sheer volume of each blast he is dumping inside of you is staggering, and they just keep coming! The pulse of his load filling you and its even more intense aroma reaching your nose too sends you over the edge yourself in short notice. Shuddering all over, spurt after spurt of your sexual fluids stain the floor.";
		say "     You see stars dancing before your eyes as the beast has his ten inches of doggy cock lodged in your throat, continuing to flood your stomach with his massive load. You feel completely stuffed by the time the canine's cock finally deflates at least a little and he pulls out of your suckling mouth. As the thick, slimy member slips out of your gullet, you pant for breath, shaking and shivering. Lying on the mattress, which is thoroughly soaked in your own fluids and the dog's, as well as who knows how many others, you realize that you are far from the only one to fall victim to this horny pooch. He trots off without a passing grace, done with you for now. A part of you wants to reach out to him and make him take you for another round, but you regain at least some semblance of clear thoughts and quickly gather your clothes to leave before he changes your mind.";
		[now ArcherFucked is 1; [first time completed] ]
		LineBreak;
		say "     <Note: There currently are no repeat scenes for this encounter, so for now the initial scene will just repeat.>";
	else: [repeat]
		say "     Knowing what to expect inside the side room of the shag shack this time, you strip down before even entering. Nearby whores and their johns look over and chuckle as they see you, and you can hear comments of 'Another dog-slut for Archer!' being exchanged. Tuning them out while you get fully naked, you then step into the room with your bundled-up gear and clothes under one arm. As the door clicks shut behind you and leaves you seemingly alone in the large and dimly lit room, you set your stuff on the ground next to the entrance so that it doesn't get dirty. <...>";

to say ShagShackSex21: [Alyona by Shay]
	say "     You survey the room, your eyes landing on a lone feline who seems out of place. She is an anthro housecat who stands tall and proud in her tattered, old army uniform, but at the same time, the woman conveys an aura of submissiveness as she meets your gaze with a shy, inquisitive stare. A smirk finds its way to your mouth as you give her body an appreciative look over, your eyes hungrily taking in her every curve. They map everything from the soft, muscular form of her body, to those full, pouty lips and her incredibly silky calico fur that begs for your touch. You stride towards your newly bought prize, loosening your clothes as you go. The feline steps forward eagerly to meet you, licking her lips as her face gains a sultry grin, followed by the words, '[one of]The name's Alyona. How about I show you a fun time[or]Welcome back. Ready for a fun time[stopping]?'";
	say "     You watch attentively as she strips off the tattered remains of her army uniform in an incredibly sexy manner, exposing herself fully to you and revealing that she is a hermaphrodite. Taking in the sight, your arousal flares sharply, prompting you to pull the naked feline into a sloppy kiss. She leans into your touch, quickly becoming semi-erect. Deepening the kiss, you gently rub your hands across her decently sized shaft, brushing her pussy with each downward stroke. It isn't long before you find yourself pushing the feline roughly onto the provided bed, unable to hold back anymore. Alyona lets out a surprised yelp as you do so, but you can see that she likes being manhandled, her member going fully erect in response, just as the folds of her slightly flushed pussy become slick with moisture.";
	WaitLineBreak;
	say "[AlyonaSexMenu]";

to say AlyonaSexMenu:
	LineBreak;
	say "     You stick your fingers inside of her slick wetness, marveling at just how soaked she has gotten. She is certainly ready for you.";
	say "     [bold type]The only question is: Just what do you wish to do with her?[roman type][line break]";
	now sextablerun is 0;
	blank out the whole of table of fucking options;
	[]
	choose a blank row in table of fucking options;
	now title entry is "Give the sexy herm a blowjob";
	now sortorder entry is 1;
	now description entry is "Blow Alyona's well-sized shaft for a sticky reward";
	[]
	if player is male: [Option only visible for males and herms]
		choose a blank row in table of fucking options;
		now title entry is "Pound her needy cunt";
		now sortorder entry is 2;
		now description entry is "Fuck the sexy herm to your heart's content";
	[]
	if player is female: [Option only visible for females and herms]
		choose a blank row in table of fucking options;
		now title entry is "Ride Alyona's decently sized prick";
		now sortorder entry is 3;
		now description entry is "Take charge and impale your wet cunt on her shaft";
	[]
	sort the table of fucking options in sortorder order;
	repeat with y running from 1 to number of filled rows in table of fucking options:
		choose row y from the table of fucking options;
		say "[link][y] - [title entry][as][y][end link][line break]";
	say "[link]0 - Nevermind[as]0[end link][line break]";
	while sextablerun is 0:
		say "Pick the corresponding number> [run paragraph on]";
		get a number;
		if calcnumber > 0 and calcnumber <= the number of filled rows in table of fucking options:
			now current menu selection is calcnumber;
			choose row calcnumber in table of fucking options;
			say "[title entry]: [description entry]?";
			if player consents:
				let nam be title entry;
				now sextablerun is 1;
				if (nam is "Give the sexy herm a blowjob"):
					say "[AlyonaBlowjob]";
				if (nam is "Pound her needy cunt"):
					say "[AlyonaPussyFuck]";
				if (nam is "Ride Alyona's decently sized prick"):
					say "[AlyonaRide]";
				wait for any key;
		else if calcnumber is 0:
			now sextablerun is 1;
			say "     You step back from Alyona, shaking your head as she gives you a questioning look.";
			wait for any key;
		else:
			say "Invalid Option. Pick between 1 and [the number of filled rows in the table of fucking options].";
	clear the screen and hyperlink list;

to say AlyonaBlowjob:
	say "     Your mouth waters as you loom above her feline prick, taking in its strong, pleasant musk. You wrap your lips around the herm's bulbous tip, being met with the tangy, satisfying taste of her precum. Alyona moans in appreciation of your actions, lightly placing her paw on the back of your head in soft encouragement. Urged on, you fully encompass the herm's tip, using your tongue to lightly caress the place where shaft and glands meet. It isn't long before you find that you have taken Alyona's cock to the base, blowing her cock with wild abandon as you stroke [if player is male]your cock with fervent jerks of your hand[else if player is female]yourself with a finger rubbing your clit[else]your sexless crotch, rubbing where it feels good[end if].[line break]";
	say "     Alyona's pussy soaks the dingy mattress below as you work hard to satisfy her, creating a mess of precum and sweat. It isn't long before Alyona tells you that she is ready to cum, the muscular feline slut moaning your name as she begs you for release. You smirk, proud of what you have turned the previously, completely composed feline into. In defiance of Alyona's request, you slow down your pace as she whines with a strong sexual need. You bring the herm to the edge once more, and this time you grant it. Cumming along with the sexy anthro cat, as you swallow every last drop of her sweet, strong seed. As Alyona remains in bed, panting heavily, you take the opportunity to clean yourself off before leaving the exhausted herm to rest.";

to say AlyonaPussyFuck:
	say "     You line your cock up to the herm's soaking, wet cunt, her cock letting out a visible twitch as she looks at yours with a wanton need. Playfully giving her painfully erect nipples a flick, you delve balls deep into her needy snatch without warning. Alyona's eyes roll to the back of her head as the slutty cat has a powerful orgasm, the contractions of her cunt massaging you as you let out a decent-sized load of precum into her now thoroughly soaked snatch. Picking up your pace, Alyona moans like a bitch in heat, causing the heads of other customers to turn to her with aroused interest. You feel yourself nearing the edge as you fuck the herm's pussy with wild abandon, squelching noises filling the room as you breed the feline as though she were your bitch.";
	say "     Soon enough, you find yourself diving inside the pussy cat to the hilt, unloading your seed into her deepest depths as the herm comes once more, milking your cock for each and every drop. Your cock deflates as you pull away from her cunt, some cum leaking out of her pussy and onto the mattress. You admire your work proudly, while Alyona pants, trying to scoop the lost seed back inside of her well-used hole. Walking away satisfied, you find yourself already thinking of fucking the hermaphrodite feline again.";

to say AlyonaRide:
	say "     You eye the feline's cock with interest as you lean over the herm's attractive, exposed form on the bed. Catching the feline in another sloppy kiss, you rub your clit as you take Alyona's cock into your thoroughly soaked snatch. You moan as you seek to accept her to the hilt, the barbs of her cock massaging your pussy more with each and every inch. Alyona grips the thin sheets of the bed as you ride her with an undeniable passion, your cunt squelching as it fully encompasses her cock. The pussy cat releases a decent-sized load of precum into your soaked snatch as you moan with pleasure, feeling yourself become closer and closer to the edge. You speed up the pace, rubbing your clit as you roughly take her cock with wild abandon, a feeling of pleasure steadily rising in your gut. Burying Alyona's cock inside you to the hilt, you cum, milking the herm for her seed as she follows suit, depositing a load into the deepest recesses of your cunt. You smile as the sexy feline's cock is removed from your pussy, cum leaking from your well-used hole. After catching your breath, you thank Alyona for her time and make your way out.";

to say ShagShackSex22: [by Hierophant]
	if CassandraFucked is 0:
		say "     After paying your price, you're pointed to a room off to the side, ostensibly, a former employee lounge or something. As you approach, the sound of someone plucking the strings of a bass guitar fills your ears, though muffled by the surprisingly thick walls. Occasionally, the player hits a sour note, and you hear an equally muffled curse. Opening the door, you step inside to see just who you've paid to spend time with. Seated atop a mattress, the only object in the room, besides a small portable DVD player, is a young woman, an anthropomorphic canary clad in a tank top and panties, holding a bass guitar and apparently trying to get the hang of it. 'Damnable modern instrument...' she mutters in an accent you can't quite put a finger to. 'I'd kill for my old lute...' As you enter the room, her anger is forgotten, and she smiles warmly at you. 'Ah, a new listener! It's wonderful to meet you. Sit, sit, it's important you get comfortable for this. And get those clothes off.'";
		say "     You follow her advice, stripping naked and sitting beside her on the bed. Cassandra plucks a string on the guitar nervously. 'Now, er, I must warn you, this won't be... sex, as you know it. I've been accepted here for my unique skills. Skills I'll be putting to use towards your pleasure. Although, these instruments are new to me, but I assure you, I will only get better with practice!' She breathes in slowly, arranging her fingers on the guitar's strings. 'Take a deep breath, and close your eyes,' she tells you. You do so, and you hear her swallow with nerves. 'Alright. It's like riding a chariot, Cass, you never really forget it, right?' she mutters as she plucks a string...";
		WaitLineBreak;
		if player is male:
			say "     As that first note fills the air, something changes within you, your blood pumping just a little bit faster. Your cock immediately begins to stiffen, and you hear Cassandra make a noise of approval. 'Very nice...' she says lowly, before plucking a few more strings in a basic melody. She repeats it a few more times, and soon, you're fully erect. 'Good, good, let's keep going... Keep your eyes closed. Breathe deeply,' she instructs you, beginning to play a new song. It's nothing you've ever heard before, and suddenly, you feel a weight in your lap. Soft feathers and Cassandra's chest press against your body, even though she's still playing the guitar. 'You can open your eyes now,' she says.";
			say "     You do as you're told... and despite the physical feeling of Cassandra atop you, she still sits on the other side of the mattress, playing the guitar. She's blushing now, and she smiles nervously. 'Old Muse trick,' she informs you, before beginning to play again. The feeling of being straddled becomes the feeling of penetrating the canary, and she cries out, her fingers faltering briefly on the strings before she catches herself. The music she plays worms its way into your brain, even as you experience the sensations of being vigorously ridden. It's obvious that Cassandra feels it too, her eyes closed and beak hanging open as she tries to keep the song going through the sexual pleasure. For a moment, you wonder how long this will go on, your pleasure steadily rising. Your eyes close again despite yourself as you begin bucking your hips into the phantom sensations. You prepare to make her at least feel as good as you do...";
			WaitLineBreak;
			say "     Suddenly, Cassandra lets out a particularly loud moan, and her fingers slip, playing a note out of key. Whatever magic is running over your body hits a sudden intensity, and despite the fact that you've only barely started, you cry out and immediately climax. You look down, and even as you feel your seed spilling out, it seems to disappear instantly. You glance over at Cassandra and notice a damp patch spreading across the crotch of her panties. Seems you get to finish inside of her, even like this.";
			say "     When your intense, unexpected orgasm ends, Cassandra seems to be trying to look frustrated... but through the bliss of being fucked and inseminated, she's having a difficult time with that. 'Damnit... not... again...' she says, through deep, heavy breaths. 'Thought... I'd fixed that...' She shakes her head a little, trying to regather her thoughts. She frowns at you. 'I... hope that wasn't too terribly disappointing. Normally, my songs last longer, but... you get rusty after 300 years...' You assure her that you thoroughly enjoyed yourself, and secretly, you wonder how much better she'd get with practice. Gathering up your clothing and equipment, you leave her to clean up and continue her practice.";
		else if player is female:
			say "     As that first note fills the air, you feel a sudden dampness in your loins. Something in the music makes your entire body warm up and gets your blood pumping as your arousal suddenly builds. You gasp a little, and you hear Cassandra let out a small laugh. 'That's it...' she says, beginning to play a short, simple melody. You only get more and more aroused as she plays on, your folds beginning to literally drip with arousal. And then you feel Cassandra's feathery fingers rubbing against your outer lips, and your eyes snap open, looking down to see... nothing? Both of Cassandra's hands are thoroughly gripping the guitar. She smiles at you. 'Old Muse trick,' is all the explanation she gives before beginning to play again.";
			say "     You feel her fingers begin to prod your sex as she plays, the phantom feeling moving within you with skill you'd expect from someone who's paid to do this sort of thing. She has a bit of a smug look on her face, apparently pretty proud of herself that she's making you feel good with just her 'Muse tricks'. She plays faster, and the phantom digits inside you move faster too, her magic playing with your lust like her fingers play with the guitar's strings... You writhe softly as the sensations push deeper, harder, fiddling with parts of you that you didn't even know you had. Panting softly and toes curling with bliss, you spread your legs wider in an effort to get her fingers deeper. Deep down, part of you hopes that this never ends, the music and pleasure clouding your mind...";
			WaitLineBreak;
			say "     Then, Cassandra curses and a sour note fills the air, and the magic around you intensifies to a shock, making you cum harder than you have in ages. Your whole body shakes, and you flop onto your back as your climax slowly wears itself out. You glance over at Cassandra, noting that she seems a bit frustrated. 'Sorry. That could have gone better,' she says. 'That was meant to be way longer, but... it's been 300 years, and I had no flipping idea what a 'bass guitar' was until about two weeks ago. If you ever come back, I promise that this'll go way better.' You assure her that you enjoyed your session immensely, and you wonder to yourself what she'd be like with more practice. You slip on your clothing, giving the bird a little thank you kiss on the forehead, and get back to your previous doings.";
		else:
			say "     She seems a bit confused as to your lack of anything between your legs, but the note makes you feel... nice. A deep warmth blooms in your belly that somehow manages to be erotic despite your lack of genitals. 'Well, there's a first time for everything, that's what big sis used to say...' Cassandra mutters, before beginning to play further. The feelings she invokes in you with the music are pleasant, a sort of contentment that makes you relax as the anxiety of surviving this new world dissipates, at least for a moment. She seems to be adjusting to this new scenario, even smiling a bit as she plays further. 'Heh. Old Muse trick,' she says, as if by way of explanation. The two of you take the time to enjoy this unconventional experience, your cares fading away with the power of her enchanted music.";
			say "     Time passes, and you're not entirely sure how long it is... or if you care how long it is... before there's suddenly the twang of a sour note filling the air. All at once, the supernatural contentment flees you, and you are reminded where you are and what has happened. Cassandra curses, then glances up at you, apologetic. 'Sorry... it's been too long, and I'm still practicing with this thing...' she says. You assure her, at the very least, that you enjoyed what did transpire. You wonder how much longer she could make it last with more practice, how much better you'd feel... As you redress and prepare to leave, Cassandra clears her throat. 'Listen, um... I know this is a brothel and all, but, if you'd like to come back and just... listen to me play some more, that'd be really nice. I don't think the boss cares what we do as long as you pay, so, uh... just consider it, I guess,' she says, sitting back down and beginning to tune her instrument.";
		increase CassandraFucked by 1;
	else if CassandraFucked is 1:
		say "     You make your payment and head for the former employee lounge, hearing some music through the door as you approach. It's not Cassandra's playing this time, and as you step inside, you see her intently watching a musical on the DVD player. [one of]A sharply dressed young man sings about his intentions to make his TV dinner company a global presence[or]Two young witches sing about gravity and the defiance thereof[or]A buff man in hot pants climbs a radio tower to sweeping music[or]A man in a purple suit describes the wonders of imagination[or]A dentist sings about his unhealthy love of the profession[at random] as Cassandra glances over at you, shutting the screen and picking up her guitar. 'Hey, you!' she says, smiling. 'Good to see you again. I've been getting more practice in, and I've been watching a lot of those [']musical['] things you guys came up with, so I'm pretty confident that I'm back in the saddle, y'know? You know the drill! Clothes off, sit down.'";
		say "     You strip down again and sit in the same place you sat last time, Cassandra visibly eager to begin. 'I've definitely gotten better at this [']bass guitar['] thing,' she explains. 'And I think you're gonna like what I've got to show you. Just, y'know, relax and let me do my thing. I may be the youngest Muse, but it's not like I don't know my stuff.' You're admittedly slightly curious about this statement, but you didn't really come here for polite conversation, so you decide you'll just let the matter lie. She begins playing again, and you prepare for her magic to do its work...";
		WaitLineBreak;
		if player is male:
			say "     Her magic ignites your libido again, your cock growing painfully stiff in record time as she plays. You can hear the confidence in her stringwork and see it on her face. You feel the pressure and texture of a phantom body, her magic giving the impression of the bird straddling you even as she sits across from you. She doesn't hesitate this time, the song continuing as her magic makes you feel like you're buried within her. You get more into it too, immediately moving your hips to increase both of your pleasure. You both moan softly as she plays, the sounds of your lust accompanying her music.";
			say "     Her playing begins to reach a crescendo with time, both of you approaching your very peaks. You feel amazing, your entire body electric with pleasure and feeling even better than that first time with her. You wonder how explosive your release is going to be. After a moment, your question is answered when Cassandra plays one last lingering note, and your mind practically explodes with bliss as you share a powerful orgasm, feeling your seed blast out of your body and into your Muse lover. You both catch your breath, Cassandra's hands shaking on the guitar as the last note fades. She smiles at you, looking a bit dazed. 'S-see? I told you... I'd get better with practice...' she says, before passing out right there in front of you. As you dress yourself and leave her to recover, you decide that, yes, she's definitely much better with practice.";
		else if player is female:
			say "     This time, as she plays, you go from mostly dry to soaking wet in an instant, your nethers eagerly dripping in anticipation of being filled. Sure enough, there's a feeling of phantom fingers prodding at you, preparing to delve into your folds. Cassandra is visibly confident, playing like a dab hand... which, if you know anything at all about Muses, she probably is. 'Get ready,' she says, smiling. 'This is gonna get wild.' True to her word, the digits probing you do so with an intensity you absolutely hadn't been anticipating, causing you to cry out and shudder as they begin sliding around within you. This feels even better than your first time with her, and from your occasional glances at her face, she looks immensely pleased with herself.";
			say "     You think, for a while, that this is the height of it, and you're pretty content with that. But then Cassandra speaks up. 'And now for the bridge!' she announces, and suddenly, the phantom fingers slide out. The spectral apparition of [one of]a canine[or]an equine[or]a humanoid[or]a feline[or]a ridged[at random] shaft apparatus is conjured... before shoving itself roughly into your folds, rutting at you with the intensity of a particularly pent-up lover.";
			say "     As you're fucked senseless, Cassandra just plays on, her fingers flying across the strings faster and faster as you approach your peak. And then, it hits, your insides clenching around the spectral cock and your voice rising in a shout as you cum hard. Cassandra lets her last note linger, the cock going still inside you as you climax around it. When you're finally done, she presses her finger against the string to quiet it, the penis inside of you disappearing entirely, then smiles at you. 'Enjoy yourself there, cutie?' she asks. You only nod dumbly, half-ready to pass out, though somehow, you gather the strength to instead stand up and redress. 'Come back any time,' she says, beginning to plunk out another, non-magical tune as you leave.";
		else:
			say "     She begins playing softly, a deep contentment rising inside of you. 'It's good to see you again,' she says conversationally. 'The sex is fun and all that, but... part of being a Muse is really just music for the sake of it.' You say nothing, just enjoying the positive feelings her song wells up inside of you. You feel really good, getting a warm, fuzzy, almost nostalgic feeling as your anxiety fades. The song reaches into your very soul, melting away at the negativity inside of you, and after a short while, Cassandra begins to sing along in some language you don't understand, maybe even impossible to understand, considering Cassandra's supernatural nature.";
			say "     It goes on like this for a long while, maybe even longer, your mind fading into a fuzz of positivity as you let the music worm its way in. You wonder briefly, what she's singing about. You guess that she'd be singing in a language you'd understand if she really wanted you to know. It almost feels like hours have gone by before there's a gentle, but firm, knocking on the door. 'Uh, hey, Cass? Sorry to bug you, but Jerome says time's up,' Kaden says through the door. Cassandra stops playing, huffing and rolling her eyes. 'Well, you heard him, I guess. Sorry,' she says. You nod, dressing yourself anyhow and getting ready to go. As you open the door, Cassandra smiles warmly at you. 'Y'know, uh, you probably didn't know this, but you're probably the only person who's still alive that's gotten to hear a Muse sing. It was... is, kind of a big deal. I just wanted you to know that,' she says. You smile back at her, feeling your bond deepen, and head out to face the world, emboldened.";
		increase CassandraFucked by 1;
	else if CassandraFucked is 2:
		say "     You make your payment and head for the former employee lounge, hearing some music through the door as you approach. It's not Cassandra's playing this time, and as you step inside you see her intently watching a musical on the DVD player. [one of]A sharply dressed young man sings about his intentions to make his TV dinner company a global presence[or]Two young witches sing about gravity and the defiance thereof[or]A buff man in hot pants climbs a radio tower to sweeping music[or]A man in a purple suit describes the wonders of imagination[or]A dentist sings about his unhealthy love of the profession[at random] as Cassandra glances over at you, shutting the screen and picking up her guitar. 'Hey, you! Good to see you again. Guess you couldn't stay away, huh? I'm just too great?' She picks up her guitar, tuning a few strings. 'Well, get those clothes off, and I'll show you more good times.'";
		say "     You strip down and sit in your usual spot on the mattress as Cassandra plucks out a few practice, non-magical notes. 'It's really good to see you again, y'know. I'm not technically supposed to be go picking favorites, according to the boss-man, but if I were allowed, which I'm not, you'd be my favorite,' she says, before scowling. 'And Kaden says they'll take my musicals away if I don't hit my quota. Anyhow, let's do this...";
		WaitLineBreak;
		if player is male:
			say "     Her magic ignites your libido again, your cock growing painfully stiff in record time as she plays. There's no nervousness in the Muse's playing. She's truly adjusted to this work. You feel a pressure on your lap and the texture of feathers, her magic giving the impression of the bird straddling you even as she sits across from you. There's still no hesitation to her magic, that sensation of being ridden overwhelming you as you begin roughly mating with the bird magically. You've fully adjusted to the oddity of this supernatural coupling, treating it like you would any other sexual encounter as you slake your lusts.";
			say "     Her playing begins to reach a crescendo with time, both of you approaching your very peaks. It feels just as good as last time as you reach the edge, anticipating the powerful climax you know is coming. And soon enough, the both of you share cries of pleasure as you climax into her yet again. You both come down from the bliss of release, Cassandra visibly dazed by the intensity of her orgasm. She breathes heavily, breasts heaving as she lies back on the mattress and tries to recover. 'Hhhfff... amazing. Thanks for that. Can't wait to do it again!' she adds, as you dress yourself and head out.";
		else if player is female:
			say "     You're not even remotely surprised as your cunt goes moist in an instant, well used to the Muse's odd effect on your biology. Instead, you relax yourself, getting ready for whatever she has in store... and then a spectral apparition of a dog's penis appears, bright-red and already drooling precum. 'I'm good at dog dicks, apparently,' Cassandra says, as the pointed tip begins probing at your entrance... then shoves half of itself in at once. The sensation of being fucked right off the bat by an animal's cock is intense, your legs instinctually trying to squeeze around a lover's hips but finding no purchase as it plunges in and out of your folds. With all the intensity of being roughly mounted by a real canine, you moan loudly, enjoying the animalistic coupling provided by the bird's magic.";
			say "     You're not entirely sure how long the fucking goes on for, as you close your eyes and imagine a particularly handsome [one of]great dane[or]german shepherd[or]dalmatian[or]husky[or]malamute[or]borzoi[at random] attached to the cock plowing you, but eventually, you feel a knot begin to bump against your lips. The thrusts get more intense... and then it pushes in to the hilt, the knot locking inside you, and the cock giving a rough throb before hot semen gushes into your folds. You're not entirely sure where it's all coming from, but you can hardly complain as the sensation of getting filled drives you hard over the edge.";
			say "     Cassandra ends the song as your climax ends, the cock inside of you... and its seed... disappearing into thin air entirely. Cassandra gives a cheeky, little bow, grinning at you. 'Thank you, thank you, I'm here all week,' she states. For a moment, you just lie there, enjoying the afterglow of your supernatural mating, while Cassandra idly plays out the bassline to a song you remember hearing on the radio once or twice. Seems even Muses appreciate pop, sometimes. 'Glad that you had a good time, sweetie. I'll see you soon, huh?' she asks, as you finally stand, dressing yourself and shakily leaving the room.";
		else:
			say "     'How've things been out there?' she asks, plucking out a few practice notes. 'Must be dangerous. You've been keeping out of trouble? Making friends, influencing people, not getting your ass violated by assorted psychos? I worry 'bout you sometimes, y'know!!!' she says, her cheeks puffing out a bit. But she begins playing a tune, and you let the warmth of her enchanted music fill you. You feel content and happy as she plays, her voice rising as she begins to sing to her own song. It feels near divine, the power of her music on you, a happiness you'd never thought you'd experience in a place like this filling your soul, slowly, but surely. You lean back onto the bed, relaxing, letting her work her magic on you. The moment you share is almost better than sex, stretching on, just the two of you and the music.";
			say "     It goes on for a while like this, and if you're being entirely honest with yourself, you'd probably be pretty content if it went on forever, her words and song filling your heart and soul... but then there's a quiet, but firm, knocking at the door. 'Uh, sorry, but Jerome says time's up, Cass!' Kaden says, his voice slightly muffled by the walls. Cass sighs, plucking out one last note. 'Well, you heard the twink. You don't have to go home, but you can't stay here,' she says, rolling her eyes. You prepare to leave, Cass tuning her guitar again as you head for the door. 'Thanks for letting me practice my Enochian, by the way. Surprised you weren't weirded out by it. Most folks think it's me speaking in tongues,' she jokes. 'You know where to find me, right? I'll see you soon, hopefully.'";

[
to say ShagShackSex23: [by Hyliad]
-> see file Hyliad/Gus.i7x
]

Shag Shack ends here.
