Version 10 of Soldier Event by Wahn begins here.
[Version 10 - David+Brutus]

Soldier Squad is a situation.
The sarea of Soldier Squad is "Warehouse";
when play begins:
	add Soldier Squad to badspots of guy;       [male soldiers]
	add Soldier Squad to badspots of girl;      [one changes into a female husky]
	add Soldier Squad to badspots of furry;     [female husky involved]

SquadEncounters is a number that varies. SquadEncounters is usually 0.

Instead of resolving a Soldier Squad:
	if SquadEncounters is 0:
		say "     While exploring the second floor of an abandoned building in the city, you hear human voices through one of the open windows. Peeking outside, careful so you're not spotted, you see six armed soldiers move through the alley behind the building. They're not all that alert, keeping the ends of the alley in sight but otherwise just strolling along, chatting with each other.";
		say "     [WaitLineBreak]";
		say "     'Did you see the boobs of that last one? That's what I call a handful!' one jovially exclaims, nudging the man next to him. 'Maybe - but when she rubbed up against me, I felt something else beneath that skirt... and we're not supposed to start things with civilians anyways.'";
		say "     A third soldier says 'Man, it's hot today.' taking a pull from his canteen, then groans 'Really really hot!' He drops his backpack and weapon, then pulls off his jacket quickly. When he rips the olive shirt off his body, the source of his discomfort is revealed - grey-white fur that rapidly spreading over his arms and chest. He falls to the floor, twitching, and you hear the crackling sound of breaking and reforming bones. The other five soldiers become a weapon-bristling knot as they look first at each other for further infection, then all around in search of attackers. You quickly pull your head back, hoping that they didn't spot you.";
		say "     For a moment, you hear nothing but the transforming soldier's groans, then there's something else - a zipper? 'Oh, you stupid fuck! Guys, calm down - no new strain or attack - looks like Davies just didn't take his daily immunity booster.' You peek down over the windowsill, seeing the men lower their weapons as one pulls out a bright red syringe from the dropped backpack and holds it up to them. The infected soldier meanwhile has fully transformed into a humanoid husky, lying on the ground and caressing her three pairs of breasts.";
		say "     [WaitLineBreak]";
		say "     'Fuck, fuck, fuck! What are we supposed to do now? Why did that jackass have to be too stupid to take his meds?' You see one of the younger men kneel down over the newly transformed husky to examine her. The bitch happily licks his hand, whining needily as he touches one of her breasts. Turning to look at the others, he then says 'You know... this doesn't have to be a bad thing. We all got the speech from the captain how he'd rip out balls off if we started something with a civilian - but Davies isn't a civ, is he...'";
		say "     All eyes turn to the husky, who's still busily caressing her own breasts. Then the kneeling soldier opens the zipper of her fatigues and eases them down over her legs. His own clothes soon follow, and then he's on top of his transformed squad-mate, plunging his hard shaft into her needy pussy. As you watch the young man fuck the husky and fondle her breasts, [if cocks of player > 0 or cunts of player > 0]your hands wander down to your own crotch to deal with your building arousal[otherwise]you quietly shift a little closer to get a better point of view[end if]. The other soldiers in the squad aren't immune to the show either - they step closer, pulling out their cocks or stripping of their clothing. Soon there's a small gang bang going on down in the alley, with the husky bitch having one cock in her muzzle, one in her pussy and the other three men fondling her or sucking on her breasts. Not sure if you'd be welcome in their group, you just stay up at the window and watch, [if cocks of player > 0 or cunts of player > 0]masturbating at[otherwise]enjoying[end if] the show.";
		say "     [WaitLineBreak]";
		say "     After the first guy moans and fills the female husky with his seed, he makes room for the next one, who plunges in without pause. Balls deep inside her, he says 'Now there's a fine bitch - no whining about condoms and stuff, just ready to please.' He starts thrusting in and out, then continues 'I wonder if humans can knock up these mutants. I guess we'll find out...' giving his buddies a wide grin.";
		say "     Over the next hour or so, Davies the husky is fucked and bred at least twice by all of them, until the squad of soldiers comes to rest in a rather sticky and exhausted pile on their cast-off clothing. The guy who took her newly transformed virginity remarks 'When it's time to go back and report in, let me speak to the captain. If I can get him out alone and he gets a turn on Davies, he'll surely allow us to keep her as the unit's mascot...";
		increase score by 10;
		now SquadEncounters is 1;
	otherwise if SquadEncounters is 1:
		say "     While exploring out in the city, you come to lower class housing area at the edge of the warehouse district. Seems rather abandoned and many of the windows are broken, but there might be someth- a sudden noise makes you whirl around and listen. Footsteps on shards of glass. Seems someone or something is coming closer just around the corner. Knowing it's not likely to be something good, you hide in the entrance of the building behind you. A moment later, two soldiers come into sight, passing you by without noticing you.";
		say "     [WaitLineBreak]";
		say "     'So what's with all the secrecy, Jimmy?' one of them asks the other, whom you recognize as belonging to the soldier squad you observed before. 'You'll see and thank me for getting you there. Come on, it's not much further.'";
		say "     Having a good idea what the big surprise is, you decide to follow them unobtrusively, tailing them until they get to a nearby house. Knocking on the door, they're let in by another uniformed man. Sneaking along the buildings outer walls, careful not to step on any glass shards on the floor, you peek in over the bottom of the broken windows until - ah, there they are. It's a room at the back of the house, its floor mostly covered in a pile of mattresses. On one of them lies Davies, the soldier you saw succumb to his husky infection, panting as she strokes her breasts and bulging belly. The three men you saw before stand around her.";
		say "     [WaitLineBreak]";
		say "     '...so you see, with him - her - not being a civilian, it's fair game.' the one called Jimmy tells the newcomer, who stares wide-eyed at the husky bitch and has a noticeable tent in his pants. 'Come on, you know you want to - didn't you tell us all about how hot it was to pound that pregnant bitch wife of your neighbour? Here you got an actual bitch, ready and whining to be fucked. All of the guys already had a go - the kid's from one of us.' The man doesn't take much more convincing. He walks up to Davies, then lets his pants drop and gets on his knees before the female husky. He aims his rock-hard cock at her dripping pussy and plunges right in, fucking the transformed soldier with deep thrusts.";
		say "     Watching their friend go at it, the two other men chuckle to each other and one remarks 'Davies always was a bit of an ass - who'd have thought he'd get so popular just by adding breasts and a cunt.' 'I know... can't wait to get in there again myself.' Both of them rub their cocks through their pants, then pull them out and slowly jerk off[if cocks of player > 0 or cunts of player > 0]. Turned on by the scene yourself, you push a hand down to your crotch and start stroking yourself[end if].";
		say "     [WaitLineBreak]";
		say "     Soon the guy fucking Davies speeds up and gasps louder and louder until he slams into the horny bitch one last time before shouting 'Aaah - I'm coming. Take that you pregnant bitch. Your kids are bathing in my cum now.' Balls deep inside the transformed soldier, the man grabs and fondles her breasts, leaning forward to suck on them while still shooting cum into her. After he stops cumming, he pulls out and flops down on his back next to Davies. 'Man, thank you for bringing me here. That's an amazing bitch to fuck.' 'I know' his former guide answers, then gets down on the mattress himself, hard cock in his hand to fuck the sloppy cunt of their prize bitch...";
		say "     You spend quite some time outside that window, watching the three men take turns banging the female husky inside[if cocks of player > 0 or cunts of player > 0]. Your own fondling brings you to a climax more than once[otherwise]. You accidentally make a little noise while shifting to get a better view when the other two move in to share her muzzle[end if], the inevitable moans thankfully overshadowed by the pants and whimpers of Davies the husky, so the men don't notice you. At some point, you reluctantly snap yourself out of the thrill of watching them and get back to survival in the city[if cocks of player > 0], leaving behind your splatters of cum on the wall under the window[otherwise if cunts of player > 0], leaving behind the small puddle of femcum you dripped onto the ground before the window[end if].";
		increase score by 10;
		now SquadEncounters is 2;
	otherwise if SquadEncounters is 2:
		say "     Passing through the neighbourhood where you last saw several members of that soldier squad from before and their husky bitch Davies, you decide to check the building out again. Hopefully they'll still be there...";
		say "     [WaitLineBreak]";
		say "     You make your way through the empty streets as unobtrusively as you can, moving from hiding spot to hiding spot and watching your surroundings closely before you move. And it works - you find your way to the house unnoticed. Getting back into position under the broken window, you cross your fingers and slowly raise your head to peek inside. Great - Davies the husky bitch is still there. But she's not the only one. Another female husky sits near her on a mattress, this one clearly younger, looking like she's in her late teens. Judging from the large wet patch between the sleeping Davies legs, the matted fur of the second husky and their similar looks, she must be the daughter of the former soldier, quickly grown to maturity after being born.";
		say "     Looking around wide-eyed and sniffing her surroundings, the young husky explores this new room - this new world - for her, walking around on all fours. See looks so cute and innocent, dashing here and there to check out interesting things like piles of cum-stained clothing and some empty food wrappers. Then her ears suddenly perk up and she turns her head to your window. Quickly ducking out of sight, you press yourself against the wall under the windowsill and stay as quiet and unmoving as possible. Maybe you were fast enough and she did not- suddenly, the sniffing nose of the young husky comes into sight above you, followed by her whole head and shoulders as she leans far out of the window to look at you. Too far, that is - with a squeak, she tumbles out of the window right on top of you.";
		say "     [line break]";
		say "     Uh oh - you now have a naked husky female on your hands - literally. What now? Trying to take her with you would be very risky, but you could try if you wanted [link](1)[as]1[end link]. Alternatively, you could tell her to keep quiet about seeing you [link](2)[as]2[end link], take the opportunity to pick her cherry right here [link](3)[as]3[end link], or just run [link](4)[as]4[end link]?";
		now calcnumber is 0;
		while calcnumber < 1 or calcnumber > 4:
			say "Choice? (1-4)>[run paragraph on]";
			get a number;
			if calcnumber is 1 or calcnumber is 2 or calcnumber is 3 or calcnumber is 4:
				break;
			otherwise:
				say "Invalid choice.  Type [link]1[end link] to take her with you, [link]2[end link] to talk to her, [link]3[end link] give her her first sexual experience or [link]4[end link] to run off.";
		if calcnumber is 1:             [take her along]
			say "     'Hello there.' *She licks over your face and sniffs you.* 'Can you talk?' To that, she turns her head a bit, thinking, then replies '...talk? I haven't before, but I guess I can. You smell nice.' *Her tail wags and she smiles at you innocently.* 'How about we go for a little walk? You'll get to see a bit of the city and then we can stop at my place. And that is much nicer than this wrecked house.'";
			say "     [line break]";
			say "     Happy to join you for an exciting new experience, the husky trots by your side as you make your way back along the side of the house, ducking under the windows along the way as you don't know if any of the soldiers are in the house. When you get to the street, you hurry her along, running between spots of concealment. Everything goes well until, several blocks away, the husky spots another dog-morph on the street. Before you can stop her, she barks a loud greeting at him and bounces out onto the open street, her tail held high. You have no choice but to follow her, stepping between the canine woman and a German Shepherd who's already giving her a hungry leer.";
			challenge "German Shepherd";
			if fightoutcome >= 20 and fightoutcome <= 29:   [lost]
				say "     After finishing with you, the German Shepherd turns to your husky companion. Having followed everything that happened, she's pretty excited, standing there on all fours and squirming a bit as female juices drip from her pussy. Virgin as she is, she hasn't yet realized that she can stroke herself with her paw-hands. The male dog-morph gets behind the husky, leaning over her and reaching around to fondle her four breasts. Grinning, he says to you 'A fine bitch you have here - no, had. She's mine now!'";
				say "     With that, he thrusts forward, burying his erection in her body with one swift move. Feeling the virgin's hymen break and hearing her pained yip at losing her cherry, the shepherd laughs. 'And a virgin too - this is just too great. Let's knock you up, girlie ...make your first time memorable with a litter of my pups.' You can only helplessly watch the dog fuck her like a wild animal until he knots in her and starts filling her with his seed. A look of pure bliss comes over the young husky and she moans as his sperm impregnates her for the very first time. Accompanied by the mocking laughter of the German Shepherd still tied to his new bitch, you slink away in defeat.";
				now hp of Amy is 100;   [removed from game]
				remove Amy from play;
			otherwise if fightoutcome >= 30:   [fled]
				say "     Fleeing from combat with the German Shepherd, you run off without looking back. The dog-morph shouts after you 'You better run, coward. Not even man enough to lose properly. Guess I'll have to make do with your girlie...' Sliding to a halt around the next corner, you realize the husky didn't come with you when you fled. Oh damn - the thought of going back goes through your mind, then gets interrupted by a dog's yip from the way you came, signifying that your former opponent just took the girl's virginity. Too late now to do anything, you start walking away again...";
				now hp of Amy is 100;   [removed from game]
				remove Amy from play;
			otherwise if fightoutcome >= 10 and fightoutcome <= 19:  [won]
				say "     Having defeated the German Shepherd, you turn to your husky and start telling her she has to be more careful with strangers and that - unlike you - most of them are now nice people. Then a large shadow falls over you two - seems your little fight attracted the attention of a wyvern!";
				challenge "Wyvern";
				if fightoutcome >= 20 and fightoutcome <= 29:   [lost]
					say "     After 'hatching' from the wyvern goop egg, you look around, but there's no sign of your husky companion. Looks like her egg was laid somewhere else or is still inside the wyvern...";
					now hp of Amy is 100;   [removed from game]
					remove Amy from play;
				otherwise if fightoutcome >= 30:   [fled]
					say "     Fleeing from combat with the wyvern, you run off without looking back. Looks like you got away clean and... sliding to a halt around the next corner, you suddenly realize the husky didn't come with you when you fled. Oh damn - you look back around the corner of the building and see the husky being covered in wyvern goop, which hardens to a hard shell around her. Then the wyvern stuffs the 'egg' into her massive vagina and flies off. You're pretty sure you won't be seeing that young woman again - at least not in any shape you'd recognize...";
					now hp of Amy is 100;   [removed from game]
					remove Amy from play;
				otherwise if fightoutcome >= 10 and fightoutcome <= 19:   [won]
					say "     Having gotten away from the wyvern, you ride a bit closer herd on your husky companion and bring her to the Grey Abbey Library safely. She's still pretty wound up from all the excitement and the new things all around her, and soon knocks over a smaller bookshelf in the entrance area as she's trying to climb up on (and sniff the books on the top board). Luckily, she can jump off before it crashes down, but she's still rather frightened at almost having a piece of furniture fall on her. You put an arm around the female husky and stroke her hair. 'Calm down, girl - you have to be a bit more careful, ok?' She nods, saying 'I will, I promise.', then rubs the side of her head against your chest.";
					say "     'Hm, and I have to have something to call you...' Your view falls onto one of the many books tumbled all over the floor - 'The Life of Amelia Earhart'. 'How about I call you Amelia - no, Amy. Would you like that?' The husky looks at you and says 'Amy? Amy. A M Y. Amy - sounds good. So I'm Amy?' You nod, then show her around a bit. Later, you set up some bedding for her and learn that she prefers a mattress on the ground to a real bed - you guess because she never knew anything else in her short life.";
					move Amy to Grey Abbey Library;
					move player to Grey Abbey Library;
					now hp of Amy is 1;  [in the library, child-like]
					now AmyMaturityCounter is 24;
					now lastAmySpotted is turns + 3;
					now lastfuck of Amy is turns;
		otherwise if calcnumber is 2:			[talk]
			say "     'Hello there.' *She licks over your face and sniffs you.* 'Can you talk?' To that, she turns her head a bit, thinking, then replies '...talk? I haven't before, but I guess I can. You smell nice.' *Her tail wags and she smiles at you.* 'Listen, you should get back in the room there and stay with your mother, ok? And don't tell anyone you saw me, ok?' Unquestioningly accepting your orders, the young canine woman nods, then lets herself be helped back through the window. The last you see of her is her bushy tail, wagging happily at doing what you want. Time to get out of here for now...";
			now hp of Amy is 90;  [she's back in the room]
		otherwise if calcnumber is 3:			[fuck her]
			say "     'Hello there.' *She licks over your face and sniffs you.* 'Can you talk?' To that, she turns her head a bit, thinking, then replies '...talk? I haven't before, but I guess I can. You smell nice.' *Her tail wags and she smiles at you.* Petting her head with one hand, you stroke over her fur with the other, feeling her feminine curves. 'You're a good dog, aren't you? A beautiful little bitch who does what she's told.' Finding you looking into her face expectantly, she hesitantly replies '...yes?' A grin on your face, you move your hands to her four breasts. 'Wonderful. You know, dogs are meant to follow their master's orders.' Her breathing deepens and a sigh escapes her lips as you start fondling her nipples, rubbing your fingers slowly around them. Then you move a hand down to her crotch and start stroking over her sensitive pussy lips, making her gasp at the feelings suddenly coursing through her body. Pushing two fingers inside her until they bump against her hymen and rubbing her clit is enough to soon give her her first climax.";
			say "     [WaitLineBreak]";
			if cocks of player > 0:
				say "     As the husky rides out her orgasm, you quickly take off your clothes and use the femcum dripping from her pussy to lube up your already hard [cock of player] shaft. 'I got something even better for you now...' you tell the husky, then turn her around and make her raise her arms to hold on to the windowsill. Stepping up behind her, you rub your erect manhood up and down over her crotch, then put it between her pussy lips and press forward. The tip of your shaft poking against her fleshy barrier, you lean forward and fondle her breasts, then put a hand over her mouth, saying 'You're almost a woman now... this'll hurt just a moment.' Then you pull back a bit and thrust into her, hard, taking her virginity. She does a pained yip, muffled through your hand, then soon starts moaning as you fuck into her. Such a nice feeling to be the first to explore this juicy cunt. Eager to fill her up with your seed, you fuck her fast and hard and soon feel a familiar urge rise in your balls. Burying your [cock of player] shaft inside her pussy[if cock length of player > 10] until it pushes against her cervix[end if], you give a satisfied moan and shoot string after string of cum deep into her body. ";
				say "     [line break]";
			say "     Satisfied, you tell the canine woman 'Listen, you should get back in the room there and stay with your mother, ok? And don't tell anyone you saw me, ok?' Unquestioningly accepting your orders, the young husky nods, then lets herself be helped back through the window. The last you see of her is her bushy tail, wagging happily at doing what you want. Time to get out of here for now...";
			now hp of Amy is 91;  [she's back in the room, no longer virgin]
		otherwise if calcnumber is 4:			[run away]
			say "     Just wanting to get out of the situation, you take your legs under your arms and run. Though with dog's inborn urges being what they are, the husky follows after you, taking you up on a playful hunt. It's several blocks before you can shake her - not so much because you're faster, but rather a gargoyle suddenly lunging out of the alley you just passed and pulling the dog-morph inside. Judging from the yips, grunts and moans coming from the alley soon, you don't think you'll see the husky again - at least not in a shape you recognize.";
			now hp of Amy is 100;   [removed from game]
			remove Amy from play;
		increase score by 10;
		now SquadEncounters is 3;
	otherwise if SquadEncounters is 3:
		say "     Passing through the neighbourhood where you last saw several members of that soldier squad from before and their husky bitch Davies, you decide to check the building out again. Hopefully they'll still be there...";
		say "     [WaitLineBreak]";
		say "     You make your way through the empty streets as unobtrusively as you can, moving from hiding spot to hiding spot and watching your surroundings closely before you move. As you do so, you spot the man you know only as Jimmy, the leader of the soldier squad, walking in the same direction. Taking care you're not seen by him, you watch him arrive at the house and enter it, then make your way around it to the back. Getting into position under the broken window, you cross your fingers and slowly raise your head to peek inside.";
		say "     [line break]";
		if hp of Amy is 90:  [player sent her back into the room, virgin]
			say "     Davies the husky is there, lying on a stained mattress, with her teenage husky daughter sitting besides her. As you watch, the man you followed here enters the room, grinning at the two naked huskies. 'Hello, bitches - I'm back.' he calls, chuckling as they turn to him with wagging tails. Davies gives a needy whine, then immediately rolls over on her back to present her spread her legs to him, while her daughter starts happy and excited yipping. Coming to stand before them, Jimmy drops his backpack on the mattresses, then crouches down and just brazenly sticks two fingers in Davies pussy, thrusting them in and out a few times as his other hand fondles her breasts. 'You just can't get enough, can you? Look how wet you are, bitch.' With that, he pulls his fingers out and holds them in front of the transformed soldier's face, dripping and wet - then starts laughing as she licks it all up.";
			say "     Innocently following her mother's example, the young husky besides them also leans forward and laps her tongue over his hand, tasting Davies pussy juices. 'Horny little bitch, just like your mom, aren't you?' Jimmy says, reaching down to cup one of the young husky's four perky breasts. She gives a pleased but surprised whine, not used to the new feelings he gives her. 'Well, let's see how good you are, girlie.' the man chuckles, then stands up and pulls off his shirt, quickly followed by his boots, pants and underpants.";
			say "     [WaitLineBreak]";
			say "     Getting down on his knees on the stained mattresses, Jimmy pushes her unresisting body on her back and spreads her legs wide. Rubbing his shaft over her sensitive pussy lips, he draws a moan from her, then a gasp as he pushes the tip in between them. Partway sinking his shaft into her body, he stops for a moment, saying 'I'm up against your cherry. Gonna make you a woman now.' With that, he pulls back a bit, then slams right into her until his hips meet hers, breaking through her hymen like tissue paper. There is a pained whine from the young husky as he does so, but it quickly gets replaced by urgent moans as the man thrusts in and out of her rapidly. The teenage husky's mother meanwhile caresses her daughter's breasts with one hand, the other one in between her own legs, fondling herself.";
			say "     Being her first time having sex, it doesn't take much longer until the freshly de-virginized husky is overwhelmed by the feelings getting fucked gives her, coming in a pretty noisy orgasm. She gives a lust-filled howl as she comes, copious amounts of femcum leaking from her pussy, giving the thrusts of the man on top of her wet, squelching noises as he keeps pounding her body. Soon, he too reaches the point of no return, grunting as trembles run through his whole body while his cock unloads a large load directly into the husky's womb. He takes a few deep breaths, still twitching slightly with follow-on blasts of his seed, then says 'Can you feel my cum inside you? You're mine now - I'll have your tight pussy knocked up in no time.' Looking down on her, he fondles her breasts, then continues 'Hm, I should have something to call you I guess. How about Amy - after Amy Bernard, the class slut back when I was in high school.'";
			say "     [WaitLineBreak]";
			say "   	Pulling his cock out of the young husky and leaving her lying on her back with cum oozing out of her, Jimmy turns to Davies. 'How do you like that I fucked your little girl? Hell, she might even be mine - and already knocked up. Look at the load I shot in her.' He pulls Davies closer, pushing her head town towards Amy's crotch... then gives a callous laugh as the former soldier stats lapping her daughter's crotch. 'A bitch trough and thr-' The man is interrupted by the sudden beeping of his watch. He turns it off, then opens up the side pocket of his backpack, pulling out a red syringe like the one you remember being called an 'immunity booster'.";
			say "     He holds it up, then hesitates, letting his gaze wander towards the two huskies, Davies eating out Amy's pussy and her rear with its swollen pussy sticking up invitingly. He mumbles 'Who needs that stuff if he can have all the bitches he wants just ready for the taking?' Then he takes off the cap and presses the plunger, watching the liquid inside drip down to soak into a mattress. A grin on his face, Jimmy takes his again rock-hard cock in hand, then kneels behind Davies and thrusts into her doggie-style, just pounding away at her needy pussy. Having come recently before, he lasts longer this time as he fucks this second husky hard and deep, then finally fills her fertile womb up with another big load of cum.";
			say "     [WaitLineBreak]";
			say "     All three of them now lying down together on the mattresses, exhausted, the thrilling show is over - for now. Time to get back to survival in the city, you tell yourself, making your way back to one of the larger streets and leaving the soldier and his two bitches behind.";
			increase score by 10;
			now SquadEncounters is 4;
		otherwise if hp of Amy is 91:   [player sent her back into the room, fucked her before that]
			say "     Davies the husky is there, lying on a stained mattress, with her teenage husky daughter sitting besides her. As you watch, the man you followed here enters the room, grinning at the two naked huskies. 'Hello, bitches - I'm back.' he calls, chuckling as they turn to him with wagging tails. Davies gives a needy whine, then immediately rolls over on her back to present her spread her legs to him, while her daughter starts happy and excited yipping. Coming to stand before them, Jimmy drops his backpack on the mattresses, then crouches down and just brazenly sticks two fingers in Davies pussy, thrusting them in and out a few times as his other hand fondles her breasts. 'You just can't get enough, can you? Look how wet you are, bitch.' With that, he pulls his fingers out and holds them in front of the transformed soldier's face, dripping and wet - then starts laughing as she licks it all up.";
			say "     Following her mother's example, the young husky besides them also leans forward and laps her tongue over his hand, tasting Davies pussy juices. 'Horny little bitch, just like your mom, aren't you?' Jimmy says, reaching down to cup one of the young husky's four perky breasts. She gives a pleased whine, moving her body closer to him a bit. 'Well, let's see how good you are, girlie.' the man chuckles, then stands up and pulls off his shirt, quickly followed by his boots, pants and underpants.";
			say "     [WaitLineBreak]";
			say "     Getting down on his knees on the stained mattresses, Jimmy pushes her unresisting body on her back and spreads her legs wide. Rubbing his shaft over her sensitive pussy lips, he draws a moan from her, then a gasp as he pushes the tip in between them. He sinks his shaft into her slowly, getting a surprised look on his face when he sinks deeper and deeper without encountering the hymen you already broke when you took her virginity the last time you were here. His brows drawn together in anger, Jimmy remarks 'Did one of those bastards sneak out here and fuck you already? They were supposed to be out on patrols, not stopping by here to bang my virgin bitch.' Shaking his head in anger about the supposed squad-mate who took his prize, Jimmy grabs the husky's hips tightly and says 'Well, since you're already used to taking a cock, little whore...' then slams himself fully into her hard and deep. There is little whine from the young husky at his roughness, but it quickly gets replaced by urgent moans as the man thrusts in and out of her rapidly. The teenage husky's mother meanwhile caresses her daughter's breasts with one hand, the other one in between her own legs, fondling herself.";
			say "     Being only her second time having sex, it doesn't take long until the inexperienced husky is overwhelmed by the feelings getting fucked gives her, coming in a pretty noisy orgasm. She gives a lust-filled howl as she comes, copious amounts of femcum leaking from her pussy, giving the thrusts of the man on top of her wet, squelching noises as he keeps pounding her body. Soon, he too reaches the point of no return, grunting as trembles run through his whole body while his cock unloads a large load directly into the husky's womb. He takes a few deep breaths, still twitching slightly with follow-on blasts of his seed, then says 'Can you feel my cum inside you? I'll have your tight pussy knocked up in no time.' Looking down on her, he fondles her breasts, still somewhat roughly, then continues 'Hm, I should have something to call you I guess. How about Amy - after Amy Bernard, the class slut back when I was in high school.'";
			say "     [WaitLineBreak]";
			say "   	Pulling his cock out of the young husky and leaving her lying on her back with cum oozing out of her, Jimmy turns to Davies. 'How do you like that I fucked your little girl? Hell, she might even be mine - and already knocked up. Look at the load I shot in her.' He pulls Davies closer, pushing her head town towards Amy's crotch... then gives a callous laugh as the former soldier stats lapping her daughter's crotch. 'A bitch trough and thr-' The man is interrupted by the sudden beeping of his watch. He turns it off, then opens up the side pocket of his backpack, pulling out a red syringe like the one you remember being called an 'immunity booster'.";
			say "     He holds it up, then hesitates, letting his gaze wander towards the two huskies, Davies eating out Amy's pussy and her rear with its swollen pussy sticking up invitingly. He mumbles 'Who needs that stuff if he can have all the bitches he wants just ready for the taking?' Then he takes off the cap and presses the plunger, watching the liquid inside drip down to soak into a mattress. A grin on his face, Jimmy takes his again rock-hard cock in hand, then kneels behind Davies and thrusts into her doggie-style, just pounding away at her needy pussy. Having come recently before, he lasts longer this time as he fucks this second husky hard and deep, then finally fills her fertile womb up with another big load of cum.";
			say "     [WaitLineBreak]";
			say "     All three of them now lying down together on the mattresses, exhausted, the thrilling show is over - for now. Time to get back to survival in the city, you tell yourself, making your way back to one of the larger streets and leaving the soldier and his two bitches behind.";
			increase score by 10;
			now SquadEncounters is 4;
		otherwise:   [lost in the city or brought to the library]	
			say "     Davies the husky is there, lying on a stained mattress, all alone since her teenage husky daughter followed you out into the streets and [ if hp of Amy is 100]was taken by one of the infected out there[otherwise]now safely is in the Grey Abbey Library[end if]. As you watch, the man you followed here enters the room, grinning at the naked husky. Then his grin freezes on his face and he looks around 'Wait - where is your new little bitch? Here, doggy doggy.' He looks behind the pushed-aside furniture that made room for the mattress fuck-pad and you quickly pull down your head and press yourself flat against the wall as he moves closer to the window. There is a tense moment in which you see the man lean out of the window above you, looking left and right, but thankfully not straight down, then you hear him move back to the room's entrance and check the rest of the house, judging from how muffled his curses are as they arrive at your ears.";
			say "     [WaitLineBreak]";
			say "     You hear him come back to Davies room after a while, still grumbling to himself. 'Should have put that little bitch on a leash. Who knows what critter is banging her right now if she wandered out into the streets.' Daring to peek over the edge of the window again, you spot the man pulling off his shirt, then boots, pants and underwear. He kneels between the legs of Davies, grinning down at the transformed former soldier as she whines needily and rubs her pussy in anticipation. 'At least I still have you, bitch. Always ready to be taken. Let's breed another little husky right now...' With that, he unceremoniously aims his hard shaft at her pussy, then pounds it into her with a deep thrust. Jimmy slams in and out of Davies body hard and fast, only caring about his own pleasure, though from the looks of it, the husky gets off quite a bit to being used like this.";
			say "     Rutting her rather roughly to get the anger of losing his chance at a virgin out of his system, Jimmy pushes the submissive Davies to orgasm before much longer, with her giving a lust-filled howl as she comes, copious amounts of femcum leaking from her pussy, giving the thrusts of the man on top of her wet, squelching noises as he keeps pounding her body. Soon, he too reaches the point of no return, grunting as trembles run through his whole body while his cock unloads a large load directly into the husky's womb. He takes a few deep breaths, still twitching slightly with follow-on blasts of his seed, then says 'Can you feel my cum inside you? I'll have your tight pussy knocked up again in no time.'";
			say "     [WaitLineBreak]";
			say "     Looking down on Davies, the soldier fondles her breasts, still somewhat roughly, then continues 'You'd like giving me another girl, wouldn't you? Watch me as I fuck her, maybe even knoc-' The man is interrupted by the sudden beeping of his watch. With a sigh, he turns it off, pulling his half-hard out of Davies and moving over to get at his backpack. Jimmy grabs a red syringe like the one you remember being called an 'immunity booster' from one of the side pockets.";
			say "     He holds it up, then hesitates, letting his gaze wander towards the husky, lying on her back with his seed oozing out of her cunt. He mumbles 'Who needs that stuff if he can have all the bitches he wants just ready for the taking?' Then he takes off the cap and presses the plunger, watching the liquid inside drip down to soak into a mattress. A grin on his face, Jimmy strokes himself until he's quickly rock-hard again, then tells Davies to get on all fours. Kneeling behind her, he thrusts into her doggie-style, just pounding away at her needy pussy. Having come recently before, he lasts longer this time as he fucks her again hard and deep, then finally fills her fertile womb up with another big load of cum.";
			say "     [WaitLineBreak]";
			say "     The two of them now lying down together on the mattresses, exhausted, the thrilling show is over - for now. Time to get back to survival in the city, you tell yourself, making your way back to one of the larger streets and leaving the soldier and his breeding bitch behind.";
			increase score by 10;
			now SquadEncounters is 4;
	otherwise if SquadEncounters is 4:
		say "     Passing through the neighbourhood where you last saw Jimmy, the leader of that soldier squad from before and his husky bitch Davies, you decide to check the building out again. Hopefully someone will still be there...";
		say "     [WaitLineBreak]";
		say "     You make your way through the empty streets as unobtrusively as you can, moving from hiding spot to hiding spot and watching your surroundings closely before you move. And it works - you find your way to the house unnoticed. Getting back into position under the broken window, you cross your fingers and slowly raise your head to peek inside.";
		say "     [line break]";
		if hp of Amy is 90 or hp of Amy is 91:  [she's in the house]
			say "     In the room, you see five persons - three humans and two huskies. There are Davies and Amy, both lying on the mattresses with their legs spread and waiting, whining needily. From the visible bumps on their stomachs, it seems like Jimmy got them knocked up last time[if hp of Amy is 91]- or maybe you did, in the case of Amy when you took her virginity[end if]. The three men are members of the soldier squad you saw before. There's Jimmy, the squad leader, standing back a bit and watching two of the other soldiers undress with a smile. 'I've got them both warmed up for you already, boys. Hope you don't mind sloppy seconds, just couldn't hold back from those pussies.'";
			say "     It's clearly not a problem, with the two men getting down on their knees as soon as they're naked, their hard manhood ready for action. Pushing apart moist pussy lips with the tips of their cocks, the two soldiers start pounding into the female huskies, filling the room with moans and grunts. With the two of them busy mounting the huskies, they don't notice the malicious grin spreading over Jimmy's face and the growing bulge in his pants - but you do. Wrenching your gaze away from the couples on the ground, hips thrusting up and down and the women's many breasts wiggling enticingly, you observe the squad leader as he walks up behind the other men, pulls off his boots and then undoes his trousers.";
			say "     [WaitLineBreak]";
			say "     As Jimmy drops his pants, you see that he's... not quite human anymore. There's fur covering his crotch and thighs, and the large and hard cock he sports resembles that of a male husky, knot and all. As he steps out of the pants and pulls off his shirt too, you notice something happening with the other two men - white fur can be seen sprouting from their skin, first in patches, then soon starting to cover more and more. Looks like the one on top of Amy is too deep in his lust to even notice, just pounding her with complete abandon, while the third man looks at his own hands in shock as fur spreads down his arms. He bolts to his feet, wet cock flapping against his furred thighs as he stumbles back from Davies.";
			say "     His treacherous squad leader trips him, then is on top of him in a second as the man falls prone on a mattress, holding him down. Having pulled his arms behind his back and holding them tightly, Jimmy taunts 'Remember when I handed out everyone their immunity boosters yesterday? I switched them.' He grips the lying man's wrists in one of his hands, the other aiming his canine shaft as he thrusts forward into the soldier's ass. Chuckling at his squad-mate's pained grunt, Jimmy says 'Sorry for taking the back door, Carl, but you don't have a pussy yet', then thrusts in again and again, moaning in pleasure. 'On the other hand, with how nice this feels, I think I'll just keep fucking your ass even once you get a pussy...'";
			say "     [WaitLineBreak]";
			say "     Carl struggles to free himself from his squad leader, but the changes working their way through his body leave him pretty weak - and increasingly aroused at being dominated like this. Soon, as the man's ears lengthen to pointy husky shape, lust-filled moans and pants replace his former curses and protests. Pleased at his victim's defiance dying off, Jimmy lets go of his wrists, setting both his hands on the transforming man's hips to hold him tight for some hard thrusts. 'See - you like it, Carl. Don't you?' Jimmy taunts again, followed by sudden thrust as the changing human replies, which makes the answer into a mixture of a moan and the word yes.";
			say "     Jimmy himself shows quite a few changes too as he fucks the soldier under him, fur spreading further and further over his body and his legs changing in proportions as they go fully digitigrade with paws at the end. Then, as he thrusts forward especially hard and pops his knot past the soldier's pucker, a long canine tail pushes out from his spine, lifting up in a stiff curve. Howling in lust as he starts to cum into the man's ass and his knot expands to bind them together, Jimmy finally completes his transformation into an alpha husky, his head shifting into a muzzled shape halfway through the howl.";
			say "     [WaitLineBreak]";
			say "     Interestingly, Carl, the guy Jimmy fucked, didn't turn into a husky bitch after all - you can see a knotted cock spurting his own seed under the newly transformed male husky's form. One submissive male for the newly created pack then. The third soldier on the other hand did go female, never stopping having sex with Amy, as you now can see two sexy female huskies entwined on the mattresses.";
			say "     [line break]";
			say "     With all of them now lying down together on the mattresses, exhausted, the thrilling show is over - for now. Time to get back to survival in the city, you tell yourself, making your way back to one of the larger streets and leaving Jimmy the alpha husky and his new pack behind.";
		otherwise:   [lost in the city or brought to the library]
			say "     In the room, you see three persons - two humans and a husky. The husky is Davies, lying on the mattresses with her legs spread and waiting, whining needily. From the visible bump on her stomachs, it seems like Jimmy got her knocked up last time. The men are members of the soldier squad you saw before, Jimmy and another guy. The squad leader stands back a bit, watching with a smile as the other soldier undresses. 'I've got her warmed up for you already, Carl. Hope you don't mind sloppy seconds, just couldn't hold back from that pussy.'";
			say "     It's clearly not a problem, with the man getting down on his knees as soon as he's naked, his hard manhood ready for action. Pushing apart moist pussy lips with the tip of his cock, the soldier starts pounding into the female husky, filling the room with moans and grunts. With him busy mounting the husky, he doesn't notice the malicious grin spreading over Jimmy's face and the growing bulge in his pants - but you do. Wrenching your gaze away from the couple on the ground, hips thrusting up and down and Davies many breasts wiggling enticingly, you observe the squad leader as he walks up behind the other man, pulls off his boots and then undoes his trousers.";
			say "     [WaitLineBreak]";
			say "     As Jimmy drops his pants, you see that he's... not quite human anymore. There's fur covering his crotch and thighs, and the large and hard cock he sports resembles that of a male husky, knot and all. As he steps out of the pants and pulls off his shirt too, you notice something happening with the other man - white fur can be seen sprouting from his skin, first in patches, then soon starting to cover more and more. Carl looks at his own hands in shock as fur spreads down his arms. He bolts to his feet, wet cock flapping against his furred thighs as he stumbles back from Davies.";
			say "     His treacherous squad leader trips him, then is on top of him in a second as the man falls prone on a mattress, holding him down. Having pulled his arms behind his back and holding them tightly, Jimmy taunts 'Remember when I handed out everyone their immunity boosters yesterday? I switched them.' He grips the lying man's wrists in one of his hands, the other aiming his canine shaft as he thrusts forward into the soldier's ass. Chuckling at his squad-mate's pained grunt, Jimmy says 'Sorry for taking the back door, Carl, but you don't have a pussy yet', then thrusts in again and again, moaning in pleasure. 'On the other hand, with how nice this feels, I think I'll just keep fucking your ass even once you get a pussy...'";
			say "     [WaitLineBreak]";
			say "     Carl struggles to free himself from his squad leader, but the changes working their way through his body leave him pretty weak - and increasingly aroused at being dominated like this. Soon, as the man's ears lengthen to pointy husky shape, lust-filled moans and pants replace his former curses and protests. Pleased at his victim's defiance dying off, Jimmy lets go of his wrists, setting both his hands on the transforming man's hips to hold him tight for some hard thrusts. 'See - you like it, Carl. Don't you?' Jimmy taunts again, followed by sudden thrust as the changing human replies, which makes the answer into a mixture of a moan and the word yes.";
			say "     Jimmy himself shows quite a few changes too as he fucks the soldier under him, fur spreading further and further over his body and his legs changing in proportions as they go fully digitigrade with paws at the end. Then, as he thrusts forward especially hard and pops his knot past the soldier's pucker, a long canine tail pushes out from his spine, lifting up in a stiff curve. Howling in lust as he starts to cum into the man's ass and his knot expands to bind them together, Jimmy finally completes his transformation into an alpha husky, his head shifting into a muzzled shape halfway through the howl.";
			say "     [WaitLineBreak]";
			say "     Interestingly, Carl, the guy Jimmy fucked, didn't turn into a husky bitch after all - you can see a knotted cock spurting his own seed under the newly transformed male husky's form. One submissive male for the newly created pack then...";
			say "     [line break]";
			say "     With all of them now lying down together on the mattresses, exhausted, the thrilling show is over - for now. Time to get back to survival in the city, you tell yourself, making your way back to one of the larger streets and leaving Jimmy the alpha husky and his new pack behind.";
		now SquadEncounters is 5;
		Now Soldier Squad is resolved;  [for now]

[ Amy, the husky                                                        ]
[                                                                       ]
[ HP of Amy                                                             ]
[   0: starting state, not born yet                                     ]
[   1: in the library, still young mentally                             ]
[   2: in the library, matured                                          ]
[  10: in the library, told the player she's horny                      ]
[  11: in the library, fucked                                           ]
[  12: in the library, has puppies                                      ]
[  90: in the abandoned house, virgin                                   ]
[  91: in the abandoned house, player fucked her for the first time     ]
[ 100: removed from the game (lost somewhere)                           ]
[                                                                       ]
[ Lust of Amy (pregnancy timer)                                         ]
[     0: not pregnant                                                   ]
[  1-12: invisibly pregnant by the player                               ]
[ 13-24: visibly pregnant by the player                                 ]
[                                                                       ]
[ Libido of Amy (puppy counter)                                         ]
[                                                                       ]
[ Thirst of Amy (relationship with Xerxes)                              ]
[   0: nothing happened                                                 ]
[   1: Xerxes fucked her                                                ]
[  99: player forbade Xerxes to get close to Amy                        ]
[                                                                       ]
[ level of Amy (relationship with the Felinoid)                         ]
[   0: nothing happened                                                 ]
[   1: he fucked her                                                    ]
[  99: player warned Amy about the felinoid's musk                      ]
[                                                                       ]
[ Xp of Amy (relationship with Fang)                                    ]
[   0: nothing happened                                                 ]
[   1: Fang fucked her                                                  ]
[  99: player forbade Beta Fang to get close to Amy                     ]
[                                                                       ]
[ Dexterity of Amy (relationship with Elijah)                           ]
[   0: nothing happened                                                 ]
[   1: Good Elijah had sex with her                                     ]
[  51: Evil ELijah had sex with her                                     ]
[  99: player didn't approve Elijah/Amy sex                             ]
[                                                                       ]
[ SvenAmySex (relationship with Sven)                                      ]
[   0: nothing happened                                                 ]
[   1: Sven got ordered to satisfy Amy's needs                          ]
[  99: Sven sent off without sex when he was watching Amy               ]


Amy is a woman. The hp of Amy is usually 0.
The description of Amy is "[AmyDesc]";
The conversation of Amy is { "Woof." };
lastfuck of Amy is usually 555.
AmyNewPuppies is a number that varies. AmyNewPuppies is usually 0.
lastAmySpotted is a number that varies. 
AmyMaturityCounter is a number that varies.
SvenAmySex is a number that varies.

instead of conversing the Amy:
	if (hp of Amy is 1):   [child-like]
		say "     Amy says [one of]'This place is soo big. I wouldn't have believed it can exist if you hadn't brought me here.'[or]'You're really nice.'[or]'Woof!'[or]'I like you.'[or]'Some of the books here smell funny.'[at random]";
	otherwise if hp of Amy is 2 or hp of Amy is 10:    [matured]    
		say "     Amy says [one of]'Thanks for bringing me here. I realize now how dangerous our trip through the city was.'[or]'I wonder how mother is doing. I wasn't with her all that long, but now that I think back, she didn't have anything on her mind except... well, sex.'[or]'Woof! Woof!' Then she laughs and adds 'Just kidding.'[or]'So much interesting stuff to read in here...'[or]'How were things before the nanites spread? The stories in the books seem... more peaceful, mostly.'[at random]";
	otherwise if (hp of Amy is 11):		[fucked]
		say "     Amy says [one of]'Thanks for bringing me here. I realize now how dangerous our trip through the city was.'[or]'I wonder how mother is doing. I wasn't with her all that long, but now that I think back, she didn't have anything on her mind except... well, sex.'[or]'Woof! Woof!' Then she laughs and adds 'Just kidding.'[or]'So much interesting stuff to read in here...'[or]'How were things before the nanites spread? The stories in the books seem... more peaceful, mostly.'[or]I can't stop thinking about the last time with you. Could we do that again?[or]I sometimes get all wet just thinking about sex. I guess that's something I inherited from mom, hm?[at random]";
	otherwise if (hp of Amy is 12):		[has puppies]
		say "     Amy says [one of]'Thanks for bringing me here. I realize now how dangerous our trip through the city was.'[or]'I wonder how mother is doing. I wasn't with her all that long, but now that I think back, she didn't have anything on her mind except... well, sex.'[or]'Woof! Woof!' Then she laughs and adds 'Just kidding.'[or]'So much interesting stuff to read in here...'[or]'How were things before the nanites spread? The stories in the books seem... more peaceful, mostly.'[or]'I can't stop thinking about the last time with you. Could we do that again?'[or]'I sometimes get all wet just thinking about sex. I guess that's something I inherited from mom, hm?'[or]'One of the pups shredded a book - I hope that's not too bad.'[or]'Aren't the little ones cute?'[or]'I can't wait to do it again with you.'[or]'One of the pups shredded a book - I hope that's not too bad.'[or]'Aren't the little ones cute?'[or]'Thanks for knocking me up - I love having your puppies.'[at random]";
	otherwise:
		say "ERROR-Amy-[hp of Amy]C: She isn't in one of the states she should be in! Please report how you got to this message.";
	
to say AmyDesc:
	say "     Amy is a young and beautiful anthro canine, her body covered in soft, snowy fur. She has a slim, feminine muzzle and perky, overly large ears along with a large, fluffy husky tail. [if hp of Amy < 12]Her chest bears two firm and grope-able B cup breasts along with two smaller A cup pairs of breasts underneath them. [otherwise]Her chest bears two firm and grope-able C cup breasts along with two smaller B cup pairs of breasts underneath them. They all ooze small droplets of milk. [end if][if Lust of Amy > 12]There is a kind of special glow to her, and she seems to be very happy and fulfilled right now. [otherwise if Lust of Amy > 0]Her belly bulges in obvious pregnancy, making her a very content and happy husky.[end if][line break]";
	if hp of Amy is 1:
		say "     Her character is rather child-like, which might have something to do with having been born not all that long ago. She doesn't wear any clothing and usually moves around on all fours like a real dog.";
	otherwise:
		say "      Having had time to read quite a bit in the library, Amy has visibly matured compared to how she acted when you brought her here. By now, she's taken up acting more like a normal human, a glint of intelligence in her eyes. She also no longer moves on all fours, but walks on her two digitigrade legs - although she still doesn't seem to see the point in clothing, preferring to be naked except for her fur.";
	if hp of Amy is 12:
		if Libido of Amy is 1:
			say "     On and around the mattress that serves as Amy's bedding, her firstborn puppy capers about, playfully exploring and looking for new interesting things. His mother[if Lust of Amy > 0 and Lust of Amy < 13], already pregnant with a new litter,[end if] is busy watching over him, but also immensely happy at having a child.";
		otherwise if Libido of Amy > 1:
			say "     On and around the mattress that serves as Amy's bedding, her [Libido of Amy] puppies caper about, playing with each other and exploring for new interesting things. Their mother[if Lust of Amy > 0 and Lust of Amy < 13], already pregnant with the next litter[end if] is quite busy riding herd on them all, but also immensely happy at having these children.";
		
The scent of Amy is "     Amy smells a bit of husky - and a ready and fertile one at that. The scent makes you pretty horny - especially after she licks your face when you come close to smell her.";

An everyturn rule:
	if Lust of Amy is 1:
		now AmyNewPuppies is a random number between 1 and 3;
		if player is in the Grey Abbey Library:
			say "     Suddenly, Amy calls 'It's time!' and can be heard panting loudly. You rush over to the mattress serving as her bedding and see her lying on it, holding her bulging belly. There's a large patch of wetness under her spread legs, amniotic fluid from her womb showing that this isn't a false alarm. With nothing else you can do to help, you just sit beside Amy, holding her hand-paw and stroking her fur.";
			if AmyNewPuppies is 1:
				say "     Soon, her contractions come quicker and quicker, and then a single puppy slides out of her stretched vagina. It's rather large for a dog, but then - Amy isn't a normal husky either. You quickly grab a towel and wipe the newborn down, then put it up against the husky woman's breasts to drink. Hungrily sucking up milk, the little one quickly grows, arriving at early teen development before slowing down again.";
			otherwise if AmyNewPuppies is 2:
				say "     Soon, her contractions come quicker and quicker, and then a puppy slides out of her stretched vagina, quickly followed by another. They're rather large for newborn dogs, but then - Amy isn't a normal husky either. You quickly grab a towel and wipe the two down, then put them up against the husky woman's breasts to drink. Hungrily sucking up milk, the little ones quickly grow, arriving at early teen development before slowing down again.";
			otherwise if AmyNewPuppies is 3:
				say "     Soon, her contractions come quicker and quicker, and then a puppy slides out of her stretched vagina, quickly followed by another and another. They're rather large for newborn dogs, but then - Amy isn't a normal husky either. You quickly grab a towel and wipe the three down, then put them up against the husky woman's breasts to drink. Hungrily sucking up milk, the little ones quickly grow, arriving at early teen development before slowing down again.";
		otherwise:
			say "     You have a strange feeling in your body, as if you somehow just know that a new life has entered this world. Maybe you should go check on Amy in the library...";
		increase Libido of Amy by AmyNewPuppies;
		now AmyNewPuppies is 0;
		now hp of Amy is 12;
		increase score by a random number between 5 and 10;
		now Lust of Amy is 0;
	if Lust of Amy > 1:
		decrease Lust of Amy by 1;
	if AmyMaturityCounter is 1:
		now hp of Amy is 2;
		now AmyMaturityCounter is 0;
	if AmyMaturityCounter > 1:
		decrease AmyMaturityCounter by 1;
		
instead of going outside from Bunker while (hp of Amy is 1 and lastAmySpotted - turns > 3):
	move player to Grey Abbey Library;
	now lastAmySpotted is turns;
	if AmyMaturityCounter > 16:		[child-like]
		say "     As you come out of the bunker, you spot Amy standing on all fours over a book lying on the floor, just flipping a page with one of her paw-hands. It's a children's book, with many colorful pictures, but from the looks of it she's actually reading the descriptions too...";
	otherwise if AmyMaturityCounter > 8:
		say "     As you come out of the bunker, you see Amy sitting on her mattress, reading a book. Stepping a bit closer, you catch a glimpse of its cover - it's a [one of]detective story for younger teenagers, judging from the picture of a group of adolescents on it, one of whom brandishes a large magnifying glass.[or]book about fairy tales, containing collected stories from all kinds of places.[at random]";
	otherwise if AmyMaturityCounter > 1:
		say "     As you come out of the bunker, you see Amy sitting at one of the tables in the library, reading a book. Stepping a bit closer, you catch a glimpse of its cover - it's a a schoolbook. High school from the looks of, specifically [one of]a history[or]a biology[or]a chemistry[or]a physics[at random] book.";
				
instead of navigating Grey Abbey Library while (hp of Amy is 1 and lastAmySpotted - turns > 3):
	move player to Grey Abbey Library;
	now lastAmySpotted is turns;
	if AmyMaturityCounter > 16:		[child-like]
		say "     As you enter the library, you spot Amy standing on all fours over a book lying on the floor, just flipping a page with one of her paw-hands. It's a children's book, with many colorful pictures, but from the looks of it she's actually reading the descriptions too...";
	otherwise if AmyMaturityCounter > 8:
		say "     As you enter the library, you see Amy sitting on her mattress, reading a book. Stepping a bit closer, you catch a glimpse of its cover - it's a [one of]detective story for younger teenagers, judging from the picture of a group of adolescents on it, one of whom brandishes a large magnifying glass.[or]book about fairy tales, containing collected stories from all kinds of places.[at random]";
	otherwise if AmyMaturityCounter > 1:
		say "     As you enter the library, you see Amy sitting at one of the tables in the library, reading a book. Stepping a bit closer, you catch a glimpse of its cover - it's a a schoolbook. High school from the looks of, specifically [one of]a history[or]a biology[or]a chemistry[or]a physics[at random] book.";

instead of going outside from Bunker while ((hp of Amy > 1 and hp of Amy < 90) and (lastfuck of Amy - turns) > 12):
	move player to Grey Abbey Library;
	now lastfuck of Amy is turns + 4;
	if hp of Amy is 2:    [mature virgin]
		say "     As you come out of the bunker, Amy walks up to you, something clearly on her mind. She says 'I've been feeling some... urges lately, and read up a bit about that. There were some novels over in that section -' At that, she points to a large bookcase over on a nearby wall, bearing a sign with 'Romance' on it. As she does so, Amy's arm brushes against her breast, causing the young husky to moan before she can stop herself. Biting her lip, she continues 'I-I... would you be my first? It's supposed to be with someone you care for and - you saved me from those ferals out on the streets, brought me here, allowed me to learn so much.'";
		say "     The young husky woman is clearly aching to be fucked - but before you can say anything about it, she turns her head a bit and says 'Oh, but you were just going somewhere, weren't you? I don't want to distract you, so I'll just... be here and if you ever want to spend some time with me.'";
		now hp of Amy is 10;
	otherwise if hp of Amy is 10:
		say "     As you come out of the bunker, you see Amy sitting on her mattress, reading one of those romance novels with a pirate and a half-dressed woman on the front. She's slowly rubbing her breasts, moaning silently - which makes you remember her coming to talk to you about losing her virginity. The young husky woman is clearly aching to be fucked - you should probably just follow her invitation and take care of her - sometime soon.";
	otherwise:
		say "     As you come out of the bunker, you see Amy on her bedding, legs spread and a hand stroking her own pussy lips. Looks like she's pretty horny, aching for a fuck. Maybe you should help her out with that...";
		
instead of navigating Grey Abbey Library while ((hp of Amy > 1 and hp of Amy < 90) and (lastfuck of Amy - turns) > 12):
	move player to Grey Abbey Library;
	now lastfuck of Amy is turns + 4;
	if hp of Amy is 2:		[mature virgin]
		say "     As you enter the library, Amy walks up to you, something clearly on her mind. She says 'I've been feeling some... urges lately, and read up a bit about that. There were some novels over in that section -' At that, she points to a large bookcase over on a nearby wall, bearing a sign with 'Romance' on it. As she does so, Amy's arm brushes against her breast, causing the young husky to moan before she can stop herself. Biting her lip, she continues 'I-I... would you be my first? It's supposed to be with someone you care for and - you saved me from those ferals out on the streets, brought me here, allowed me to learn so much.'";
		say "     The young husky woman is clearly aching to be fucked - but before you can say anything about it, she turns her head a bit and says 'Oh, but you were just going somewhere, weren't you? I don't want to distract you, so I'll just... be here and if you ever want to spend some time with me.'";
		now hp of Amy is 10;
	otherwise if hp of Amy is 10:		[mature virgin, told the player she's horny]
		say "     As you enter the library, you see Amy sitting on her mattress, reading one of those romance novels with a pirate and a half-dressed woman on the front. She's slowly rubbing her breasts, moaning silently - which makes you remember her coming to talk to you about losing her virginity. The young husky woman is clearly aching to be fucked - you should probably just follow her invitation and take care of her - sometime soon.";
	otherwise if hp of Amy > 10 and Xerxes is in Grey Abbey Library and thirst of Amy is 0:	[first interest of Xerxes in her]
		say "     Entering the library, you see Amy on her bedding, legs spread and a hand stroking her own pussy lips. Looks like she's pretty horny, aching for a fuck. A fact that hasn't gone unnoticed by someone else... you can see Xerxes standing on all fours not too far from the young husky, his eyes riveted on her naked form. The erection visible under his toned body shows that he's very interested indeed. Nevertheless, your well-behaved and trained dog doesn't act on his desires, just watching her intently.";
		say "     As you walk up besides him, the human dog gives you an exuberant greeting and licks your hand, then gives a little pleading whine[if lust of Xerxes > 2] followed by the question 'Master's Friend - Sex?'[end if] and another hungry look over at Amy. It seems pretty obvious that he'd love to be the one to fulfill Amy's current need.";
		say "     [line break]";
		say "Do you allow it and go ask Amy if she'd like to spend some time with your pet (Y), or forbid Xerxes to get close to her (N)?";
		if player consents:		[Amy+Xerxes Sex]
			say "     [line break]";
			say "     Walking towards Amy, she finally notices you when you're just a few steps away. She gives a high-pitched 'Oh', pulling her hands away from her crotch and sitting up before continuing sheepishly with 'I - I got so horny that I just couldn't take it anymore. I just had to...' Smiling, you tell her you understand that she has these urges, then explain that she doesn't have to deal with them on her own if she'd rather have company. With a whistle, you call Xerxes, the human dog immediately appearing at your side, looking attentively from you to Amy. The young husky's eyes are immediately drawn to his hard cock and her libido flares up again. She gives you a beaming smile and a nod, then rolls over and gets on all fours, spreading her legs a bit as she presents herself to the transformed dog.";
			if lust of Xerxes >= 4:		[awesome/intelligent Xerxes]
				say "     You pat Xerxes shoulder and say 'Go for it' with a grin. Having gained intelligence to go along with his canine mind, he is able to hold back his instinctive desire to rut you hard and fast for a while, taking the time to run his hands over Amy's back and female curves first. He leans close against her back to cup two of the husky's breasts with his hands while moving his hips to position his shaft at her opening. Then, with a quick thrust accompanied by two persons very satisfied moans, he sinks his manhood into her drippingly moist pussy. Xerxes takes slower thrusts at first, enjoying the feel of Amy's hot, wet hole around his pulsing shaft. His hands roam over her[if lust of Xerxes < 7] almost as if he were petting Amy[otherwise], stroking and caressing Amy's body with growing adeptness[end if].  He nuzzles at the back of the young husky's neck, panting with a growing excitement that has his pace quicken in response.";
				say "     Xerxes fucks Amy with a relentless wild energy, his hard thrusts hitting very sensitive spots again and again, making her pant and yip in pleasure. This soon drives Amy's arousal to the max, giving her a mind-blowing orgasm that moistens Xerxes cock with even more slippery femcum. He obviously likes the feeling of that, as his growls of lust increase and he speeds up before plunging in one last time and filling Amy's womb with his human seed.";
			otherwise:	[basic Xerxes]
				say "     Almost before you're finished saying 'Go for it, boy', Xerxes is on top of Amy, his muscular chest against her back as he hugs her tightly and grinds his crotch against her body. Being a natural in the typical 'doggie-style', his shaft quickly finds her dripping opening and plunges deep into the husky's body. Xerxes fucks Amy with a relentless wild energy, his hard thrusts hitting very sensitive spots again and again, making her pant and yip in pleasure. This soon drives Amy's arousal to the max, giving her a mind-blowing orgasm that moistens Xerxes cock with slippery femcum. He obviously likes the feeling of that, as his growls of lust increase and he speeds up before plunging in one last time and filling Amy's womb with his human seed.";
			say "     As his cock and balls keep twitching with blast after blast of cum into his sexual partner, Xerxes just keeps holding on to Amy, panting with his head over her shoulder. Exhausted, the husky lowers herself to lie on her bedding, taking your human dog with her so they end up cuddled together on the mattress[if lust of Xerxes >= 4].  Raising his head to look at you for a moment, Xerxes mumbles 'Mmm... Master-Friend Amy nice' to you, then snuggles up to her with his arms around the young woman's chest[end if].";
			if Lust of Amy is 0:
				let AmyPregchance be a random number from 1 to 20;
				if AmyPregchance > 13:
					now Lust of Amy is 24;
			now lastfuck of Amy is turns;
			now lastfuck of Xerxes is turns;
			now thirst of Amy is 1;
		otherwise:		[Xerxes forbidden]
			say "     [line break]";
			say "     Shaking your head to the dog in the body of a human teenager, you take Xerxes to his cot, some distance away from Amy. After having him sit on it, you continue to tell him that he should stay away from Amy. Your pet gives a somewhat sad yip as he looks over at the naked husky again, then accepts his master's orders and lies down.";
			now thirst of Amy is 99;  [Xerxes/Amy sex forbidden]
	otherwise if hp of Amy > 10 and Felinoid Companion is tamed and level of Amy is 0:  [first interest of the Felinoid in her]
		say "     Entering the library, you see Amy walking towards her bedding with a book in hand, reading intently. Then suddenly, your felinoid companion moves into her way, giving a welcoming growl as he circles the young husky, rubbing his flank against her hips. Amy gives a pleased giggle at his presence and reaches down to pet him, rubbing behind his ears and down over his back, making the large feline purr almost as loud as an idling motor. He luxuriates in her touch, stretching so she can get to the best spots and brushing against her as often as he can. You can see Amy take a deep breath through her nose, giving a soft moan as she does so. Before long, the young husky is crouched down besides the big cat, her book lying forgotten on the ground while she strokes under his chin, her other hand on her crotch, caressing her open and quickly swelling pussy lips.";
		say "     [line break]";
		say "     Having been close to the felinoid and been in the influence of his stimulating musk yourself, you can see where this is going from a mile away. Do you let Amy get her first sexual experience with the large cat, or should you move in and put a stop to this? (Y = allow it, N = stop this) ";
		if player consents:  [felinoid fucks Amy]
			say "     [line break]";
			say "     Spellbound by the soothing purr, the soft touch of the felinoid's fur and his stimulating musk, Amy's arousal mounts higher and higher by the minute. It doesn't take much longer until she moves into position on all fours, her legs spread and tail held high to allow the felinoid access to her pussy. Giving a satisfied rumbling purr, the large cat moves to sniff Amy's pussy, then licks over her female parts with its wide tongue. Several licks later, he moves further up, running his tongue over the young husky's back fur and then her neck.";
			say "     Now standing over the smaller shape of Amy, his belly-fur touching her back, the felinoid is in the perfect position to fuck her. Lowering his hind legs a bit, your feline companion rubs his spined cock up and down the inside of husky girl's legs until he soon finds Amy's tight opening and plunges in. With a satisfied roar, he sinks all of his manhood inside, then starts fucking her with powerful and deep thrusts. Moans, barks and growls of lust fill the library and you move a bit closer to watch the show.";
			say "     [WaitLineBreak]";
			say "     After quite a while of hot and heavy fucking, Amy's moans and noises rise up to a loud pleased yip, announcing her orgasm to anyone in hearing range. Visibly satisfied in making her come, the felinoid isn't far behind, burying his hard cock all the way in the young husky's pussy and holding still, only his balls pulsing as they fill her up with his seed. When he finishes cumming, the big cat pulls out and throws himself on the floor right at that spot to lounge in satisfaction. Amy kneels down beside him to lick his cock clean, then joins him on the floor, snuggling up against his warm furred shape.";
			if Lust of Amy is 0:	[not pregnant]
				let AmyPregchance be a random number from 1 to 20;
				if AmyPregchance > 13:
					now Lust of Amy is 24;  [24 turns till birth]
			now lastfuck of Amy is turns;
			now level of Amy is 1;
		otherwise:  [stop this]
			say "     [line break]";
			say "     Quickly walking over there, you take Amy softly be the arm, pulling her up and walking some distance away from the felinoid with her. As she stands there, no longer in the immediate influence of your feline companion, she starts to wind down again, though she is still breathing rather heavily and stroking over her breasts with her fingers as you go pick up her book. The felinoid purrs and rubs his shoulder against you as you do so, and knowing him, you just give him a quick pat on the head, holding your breath until you stand back up. 'Not her', you tell your companion, who gives a disappointed mew, then stalks off. As you're sure that he'll try again no matter what, you warn Amy not to get too close to him in the future when you give her the book back.";
			now level of Amy is 99;
	otherwise if hp of Amy > 10 and Fang is in Grey Abbey Library and XP of Amy is 0:	[first interest of Fang in her]			
		say "     Entering the library, you see Amy on her bedding, legs spread and a hand stroking her own pussy lips. Her head is leaned back, eyes closed, and she moans silently to herself. Looks like she's pretty horny, aching for a fuck. A fact that hasn't gone unnoticed by someone else... close to her, slowly stalking forward is Fang, his canine shaft hanging erect under his black-furred body. Then suddenly, he pounces the young husky, making her give a surprised yip that leads over to a lust-filled gasp as the wolf sinks his cock deep into her pussy with the first thrust. As deep in the grip of her own libido as she is, Amy just accepts the virile male on top of her, moaning as he starts rutting her with urgent movements.";
		if hp of Fang < 3:  [Beta Fang can be stopped]
			say "     [line break]";
			say "     Do you allow your pet wolf to fuck Amy, or do you want to put an end to this? (Y = let him, N = stop him) ";
			if player consents:	[Fang gets to fuck her]
				say "     [line break]";
				say "     Walking up to them, you pat the wolf's back and lean down to rub his furry balls as he thrusts into her again and again, feeling them lie heavy in your hand, full of the load he's got prepared for Amy's womb. 'Mmm... yes,' the aroused husky girl cries out as the wolf keeps pounding into her like a wild animal, 'Harder! Faster!' You slip your fingers to Amy's wet folds, caressing them as Fang's hard canine cock slides in and out.";
				if cocks of player > 0 and anallevel > 1:  [male/herm and anal sex allowed]
					say "     Being so close to the hot action of their mating, your own lust rears its head, giving you an almost painfully hard cock tenting your pants. The urge to bury it into the gripping embrace of Fang's tight asshole rises inside you. Do you do so? ";
					if player consents:  [player fucks Fang]
						say "     [line break]";
						say "     Quickly pulling off your clothes and moving in behind Fang, you get your throbbing cock lined up with his tailhole, then push it into his tight pucker. Fang releases a soft whimper, but takes your cock easily enough in his experienced hole and doesn't let up at with his own thrusts into the wet pussy under him. Amy, meanwhile, moans loudly as your pounding against Fang's ass presses the wolf's shaft even deeper into her body. She rubs her hand-paws over his neck and ears, pulling his head down to trade licks, muzzle to muzzle.";
						say "     Fang licks her face and fucks her even harder, slamming his swollen knot against Amy's sore pussy until it stretches open enough to let that oversized knot pop in and tie with her. The black wolf howls triumphantly when this happens, unleashing a hot rush of semen into Amy, filling your husky girl with his ample load as he drains his large, virile balls into her. She writhes beneath him in ecstasy, cumming hard as well from taking your pet wolf's seed. On his back-end, you feel the wolf's insides twitch around your manhood with each burst of his cum into Amy, quickly driving you towards your own orgasm. As his muscles almost jerk you off as he spurts another and another blast of his seed, you can hold back no longer and blow your load deep into the wolf's bowels, claiming him once more as your own.";
					otherwise:  [just watch and touch]
						say "     [line break]";
						say "     Being content to just watch and touch them a bit for now, you stay right beside Fang and Amy on the mattress, caressing her breasts and body as well as his balls. He pounds into her hard and fast while the young husky's needy cunt grips and squeezes around that feral wolf cock. She moans about how strong your pet wolf is, how virile, to breed her like the bitch she is. Clearly pleased by those words, Fang licks her face and fucks her even harder, slamming his swollen knot against Amy's sore pussy until it stretches open enough to let that oversized knot pop in and tie with her. The black wolf howls triumphantly when this happens, unleashing a hot rush of semen into Amy, filling your husky girl with his ample load as he drains his large, virile balls into her. She writhes beneath him in ecstasy, cumming hard as well from taking his canine seed. When his knot goes down, he pops his cock from her, letting his excess semen flow out to soak into the mattress, leaving the scent of it upon Amy and her bedding as a reminder to you and others that he bred her.";
				otherwise:  [just watch and touch]
					say "     Being content to just watch and touch them a bit for now, you stay right beside Fang and Amy on the mattress, caressing her breasts and body as well as his balls. He pounds into her hard and fast while the young husky's needy cunt grips and squeezes around that feral wolf cock. She moans about how strong your pet wolf is, how virile, to breed her like the bitch she is. Clearly pleased by those words, Fang licks her face and fucks her even harder, slamming his swollen knot against Amy's sore pussy until it stretches open enough to let that oversized knot pop in and tie with her. The black wolf howls triumphantly when this happens, unleashing a hot rush of semen into Amy, filling your husky girl with his ample load as he drains his large, virile balls into her. She writhes beneath him in ecstasy, cumming hard as well from taking his canine seed. When his knot goes down, he pops his cock from her, letting his excess semen flow out to soak into the mattress, leaving the scent of it upon Amy and her bedding as a reminder to you and others that he bred her.";
				if Lust of Amy is 0:	[not pregnant]
					let AmyPregchance be a random number from 1 to 20;
					if AmyPregchance > 13:
						now Lust of Amy is 24;  [24 turns till birth]
				now lastfuck of Amy is turns;
				now XP of Amy is 1;  [he fucked her and may do it again]
			otherwise:	[stop Fang]
				say "     [line break]";
				say "     Rushing forward, you grab Fang by the scruff of his neck and on his back, pulling him off the young husky under him and throwing him back from her. Snarling at being stopped from mounting a horny female, the black wolf shows his teeth for a second, then whines and tucks in his tail in submission a moment later as you give him your best domineering stare and remind him of his position as your Beta. Turning to Amy, you ask if she's okay, getting a moaned 'Yes, but I need someone to fuck me - now!' as an answer. Getting hammered by a randy wolf for a moment sent Amy's body into overdrive and she really needs someone to take up the slack, and quickly.";
				if cocks of player > 0:
					say "     [WaitLineBreak]";
					say "     Well, you can't just leave her hanging now, can you? Quickly sliding off your clothes, you step up and kneel between Amy's legs, then lean over her. As you start making out hungrily, your [cock of player] shaft comes to rest hotly against her pubic mound. Amy moans as you take hold of your cock, rubbing its head over her pussy lips, then put its tip between them. Sliding into her wet and tight vagina in one smooth move, you grunt deeply as you bottom out in her, your balls touching her soft crotch-fur. You stay like that for a moment, giving her the opportunity to get used to your member spreading her inner passage, meanwhile seeking out Fang with a hard stare and growling to him to show that Amy is yours. Then you start pulling out a bit and thrusting back in, fucking the young husky.";
					say "     Amy is a very enthusiastic sex-partner, holding you close with her arms and making out as you pound into her. She even wraps her legs around your hips to pull your crotch down harder against her, moaning as your balls hit her buttcheeks when you bottom out again. You wish you could keep the amazing feelings you give each other up forever, but all too soon, the limit of your ability to hold back is reached. With a gasped 'I'm coming!', you thrust into her one last time, burying your [cock of player] shaft inside her pussy[if cock length of player > 10] until it pushes against her cervix[otherwise].[end if] Then your balls send the massive load built up inside them on its way, burst after burst of your fertile seed shooting into your beautiful husky's womb. The feeling of a male's cum flooding her insides gives Amy the last push she needed too. While you're still pumping more shots inside her, she writhes under you, tongue lolling out of her mouth as she rides her orgasm.";
					say "     [line break]";
					say "  	  Immensely satisfied, you stay like that on top of her for a while, then pull your softening cock out and lie down with Amy. Spooning her, you run a hand through her soft belly fur, circling her nipples with your finger, then just hold her.";
					if Lust of Amy is 0:	[not pregnant]
						let AmyPregchance be a random number from 1 to 20;
						if AmyPregchance > 13:
							now Lust of Amy is 24;  [24 turns till birth]
					now lastfuck of Amy is turns;
					now XP of Amy is 99;  [no Amy-pussy for Fang]
				otherwise:
					say "     [WaitLineBreak]";
					say "     Well, you can't just leave her hanging now, can you? Quickly sliding off your clothes, you step up and kneel between Amy's legs, then lean over her. As you start making out hungrily, you move your hand down her naked body, stroking over her breasts and soft-furred stomach to arrive at her crotch. Carefully spreading the husky's sensitive pussy lips with your fingers, you rub over her clit, making her moan in pleasure. While you proceed to push your fingers into her wet pussy, stroking the aroused husky's insides, you look over at Fang, still standing nearby in his submissive stance. 'Fetch' you call out to him, pointing at the dildo you keep on a nearby shelf for use on Amy. The black wolf complies, delivering the rubber sex toy to you, though not without a whine that it'll go where he's been forbidden.";
					say "     Grinning, you hold out the dildo to Fang to have him lick it, then send him off to his usual spot with a wave of your hand. He's only a pet after all, something he clearly needs a reminder of. Bringing the dildo to Amy's crotch next, you rub its head over her pussy lips and push it in between them, going deeper and deeper. She moans loudly as you sink the whole rubber shaft into her, up till the balls as its base touch her crotch. Taking hold of the sex toy there, you pull it out halfway again, then thrust it back into her, fucking Amy with it and rubbing her inner walls with the hard rubber shaft. Fucking the husky woman is a lot of fun, though a bit tiring for your arm, so you switch off your left and right hands as you take care of the insatiably horny husky. Accompanied by moans and gasps to go harder and faster, Amy's libido builds up higher and higher and her arousal finally culminates in a pretty noisy orgasm. Giving a lust-filled howl as she comes, Amy writhes on her mattress, her femcum glistening wetly on the rubber shaft of the dildo you're fucking her with.";
					say "     [line break]";
					say "  	  Satisfied in having taken care of her, you leave the dildo buried in her pussy and lie down with Amy on her mattress. Spooning her, you run a hand through her soft belly fur, circling her nipples with your finger, then just hold her.";
					now lastfuck of Amy is turns;
					now XP of Amy is 99;  [no Amy-pussy for Fang]
		otherwise:  [Alpha Fang fucks her for sure]
			say "     You stand there and watch as Fang mounts Amy, as is his right as Alpha over you - and now her as well. He pounds into her hard and fast while the young husky's needy cunt grips and squeezes around that feral wolf cock. She moans about how strong your big alpha is, how virile, to breed her like the bitch she is. Clearly pleased by those words, Fang licks her face and fucks her even harder, slamming his swollen knot against Amy's sore pussy until it stretches open enough to let that oversized knot pop in and tie with her. The black wolf howls triumphantly when this happens, unleashing a hot rush of semen into Amy, filling your husky girl with his ample load as he drains his large, virile balls into her. She writhes beneath him in ecstasy, cumming hard as well from taking your master's seed. When his knot goes down, he pops his cock from her, letting his excess semen flow out to soak into the mattress, leaving the scent of it upon Amy and her bedding as a reminder to you and others that she belongs to him now.";
			if Lust of Amy is 0:	[not pregnant]
				let AmyPregchance be a random number from 1 to 20;
				if AmyPregchance > 13:
					now Lust of Amy is 24;  [24 turns till birth]
			now lastfuck of Fang is turns;
			now lastfuck of Amy is turns;
			now XP of Amy is 1;
	otherwise if hp of Amy > 10 and Elijah is bunkered and hp of Elijah > 3 and Dexterity of Amy is 0:	[first interest of Elijah in her]
		if hp of Elijah is 99:  [evil Elijah]
			say "     Entering the library, you see Amy on her bedding, legs spread and a hand stroking her own pussy lips. Looks like she's pretty horny, aching for a fuck. As you stand there, eyes riveted on her naked form, you suddenly hear a voice from behind you say 'Quite a horny bitch, the little husky you've brought here.' Elijah steps into view besides you a second later, giving you the usual expression of vain handsomeness, with his adonis-like body only dressed in skin-tight leather pants and the pair of large black wings behind his back slightly spread. He claps a hand on your shoulder in an artifically comradely gesture, continuing with an awfully chummy-sounding 'I'm sure you don't have any problems with your good buddies having a go with her either? No? Good.' Having said that last bit in one go, without waiting a second for a response, he then starts walking towards the aroused husky, one hand rubbing his crotch through the tight leather pants.";
			say "     [line break]";
			say "Do you just stand back and watch the fallen angel approach Amy (Y), or explain to your 'buddy' that he should keep his distance from her (N)?";
			if player consents:		[Amy+Evil Elijah Sex]
				say "     [line break]";
				say "     Pulling off his boots, quickly followed by his leather pants, the now completely naked Elijah silently walks over to Amy. With her head leaned back and eyes closed as she revels in lustful fantasies, Amy doesn't even know the fallen angel is there until he's kneeling between her legs and reaches out to cup one of her breasts. With a surprised yip, Amy asks 'Who are you, what' - then she can't help but moan as he brings his other hand against her pussy, stroking her nether lips and clit with skillful fingers. 'Hush, my sweet little bitch. I'm here to give you what you need...' Elijah replies, then presses a kiss on the husky girl's lips as she tries to say something, just melting away any resistance she might have had left.";
				say "     As Amy starts to eagerly make out with him, the fallen angel aligns his erect shaft with her swollen and dripping pussy, then thrusts forward, sinking himself deep into her. There is a combined grunt and yip from the both of them as Elijah slides into Amy, rubbing against all the right spots. They gasp in lust as their hips touch, all of him now deep inside the young husky's body. Pushing his upper body up on his arms, the fallen angel gives a wide grin at Amy, then starts moving his hips, thrusting his cock into her again and again. He soon starts giving lustful grunts as he starts to pound more forcefully into her, driving his shaft deep in rapid movements. It's rather overwhelming for Amy, reducing her to gasping and moaning in pleasure as he starts using all kinds of other tricks, stroking her body in just the right spots while his cock finds pleasure zones she didn't even know she had. Must be something he learned from all those incubi and succubi he often picks up out in the city.";
				say "     [WaitLineBreak]";
				say "     Elijah indulges himself with Amy for a long time, keeping her in a pleasant lustful buzz and giving her more than one orgasm, but at some point his self-control just is at an end. Giving a final satisfied moan, he drives his cock into her pussy as deep as he can and fills Amy's womb with spurt after spurt of his fertile seed. With a satisfied sigh, he pulls out of her and gets up, his load trickling out of her stretched pussy to soak into her bedding. Not even looking back as he leaves her, the dark angel then picks up his pants and boots, sauntering over to you in absolutely shameless nakedness. He gives you a wide grin and says 'Nice pussy, can't wait for the next time. Oh, and you really should put a collar and leash on her... wouldn't want such a fine bitch to run off.' With that, he walks away to go cleam himself up.";
				if Lust of Amy is 0:
					let AmyPregchance be a random number from 1 to 20;
					if AmyPregchance > 13:
						now Lust of Amy is 24;
				now lastfuck of Amy is turns;
				now lastfuck of Elijah is turns;
				now Dexterity of Amy is 51;
			otherwise:		[Evil Elijah forbidden]
				say "     [line break]";
				say "     Shaking off the effects of his slick charm and quick-talking, you hurriedly step forward, grabbing Elijah by the arm before he's more than a third towards Amy. Bringing the dark angel to a stop, you tell him in no uncertain terms that he should keep his hands off Amy. For a second, annoyance and anger flicker over his handsome face, then his features smooth out again as he brings himself under control. 'As you wish. And of course, she's not really trained yet after all. No leash or even a collar.' He shrugs and continues 'I guess I'm off a bit then, gonna hunt me down some sweet little thing and give her - or him - a good pounding.' With that, the dark angel saunters to the library entrance and gloes out.";
				now Dexterity of Amy is 99;  [Elijah/Amy sex forbidden]
		otherwise:  [good Elijah]
			say "     Entering the library, you see Amy on her bedding, legs spread and a hand stroking her own pussy lips. Looks like she's pretty horny, aching for a fuck. As you stand there, eyes riveted on her naked form, you suddenly hear a voice from your left say 'How was it out there today? Not to bad, I hope? Hey, what are you looking at -' It's Elijah, walking up between two long bookshelves. As he clears the shelf blocking his view on Amy and turns his head towards her, his eyes get wide and he can't take his gaze off her. Which leads to him literally bumping into you as he's still walking while staring at the husky girl. 'Oh, err - sorry. I was just...' Elijah stammers, his cheeks getting a bit red as he looks over to Amy again, then quickly down - which only draws your attention to the boner that has sprung up in his jeans, tenting them quite a bit. 'I - I got to go. Later...' he brings out, then starts turning, no doubt wanting to run off to hide his arousal and beat off somewhere quiet.";
			say "     [line break]";
			say "Do you want to stop him and introduce Elijah - intimately - to Amy (Y), or just let him go (N)?";
			if player consents:		[Amy+Elijah Sex]
				say "     [line break]";
				say "     Grabbing Elijah by the arm, you hold on to him until he stops to weakly pull away, then say that you'll introduce him with a wink. Accompanied by the still blushing angel, you walk towards Amy and she finally notices you when the two of you are just a few steps away. She gives a high-pitched 'Oh', pulling her hands away from her crotch and sitting up before continuing sheepishly with 'I - I got so horny that I just couldn't take it anymore. I just had to...' Smiling, you tell her you understand and it's nothing to be ashamed of. Then you push Elijah a step forward and introduce the two of them to each other. With the young husky looking up at him, the angel stammers out 'Hi - you - you're beautiful'.";
				say "     There's a moment of silence as they just look at each other, with sexual tension almost palpable in the air between them, then you've got your arms around Elijah from behind and are undoing the button and zipper of his jeans. A quick pull downward later, your handsome angel stands bare-ass naked - and quite erect - in front of Amy. Telling Amy that she doesn't have to deal with her natural needs alone, you give Elijah a playful slap on the butt and tell them to have fun together. Then you move over to a nearby reading table, grab one of the chairs and sit down in a spot with a good view.";
				say "     [WaitLineBreak]";
				say "     Amy is the first to respond to your sudden exposure of Elijah's hard shaft, moaning softly as she lays eyes on his heavenly perfect manhood. Her hands move to brush over her four breasts and she means loudly, spreading her legs a bit and exposing her moist and swollen pussy for him. Now quickly succumbing to the grasp of his arousal, Elijah just gives a lustful pant, then sinks to his knees in front of the female husky and leans over her. Their lips meet and they start kissing hungrily, with his erection coming to lie hotly against her crotch. It's just a matter of moments until his rocking back and forth in their make-out-session puts the angel's cock right between her dripping pussy lips and he instinctively thrusts forward, sinking himself deep into her pussy.";
				say "     There is a combined grunt and yip from the both of them as Elijah slides into Amy, rubbing against all the right spots. They gasp in lust as their hips touch, all of Elijah now deep inside the young husky's body. After taking a deep breath, the handsome angel leans down again, giving Amy another kiss on the lips while his hips start moving, thrusting his cock into her again and again. And he's quite skillful in fucking her too - stroking and caressing her body as he goes along, nuzzling her four breasts and switching up with different positions that make his partner pant and howl in pleasure. Makes you wonder if he's found a copy of the Kama Sutra somewhere in the library or if he's just a natural...";
				say "     [WaitLineBreak]";
				say "     Elijah indulges Amy's needs for a long time, keeping her in a pleasant lustful buzz and giving her more than one orgasm, but at some point his self-control just is at an end. Giving a final satisfied moan, he drives his cock into her pussy as deep as he can and fills Amy's womb with spurt after spurt of his fertile seed. With a satisfied sigh, he just holds her against his chest afterwards, staying with the young husky to cuddle a bit on her mattress.";
				if Lust of Amy is 0:
					let AmyPregchance be a random number from 1 to 20;
					if AmyPregchance > 13:
						now Lust of Amy is 24;
				now lastfuck of Amy is turns;
				now lastfuck of Elijah is turns;
				now Dexterity of Amy is 1;
			otherwise:
				say "     [line break]";
				say "     Grinning at the antics of your handsome angel, you just let him go, though your thoughts stray to what he'll be doing to himself soon, sending a tingle of lust through your body. Maybe you should fuck him a bit more often, if just the sight of a masturbating Amy gets him this hot and bothered. Though it is quite a nice view, you have to admit...";
				now Dexterity of Amy is 99;
	otherwise if hp of Amy > 10 and Sven is bunkered and hp of Sven > 5 and hp of Sven < 50 and SvenAmySex is 0:	[first interest of Sven in her]				
		say "     Entering the library, you see Amy, sitting at one of the reading tables that have the library entrance in view with a book in her hands. When she notices you, she puts it down and gets up, walking towards you with something clearly on her mind. Judging from the cover of the book she was reading - a steamy romance novel with a pirate and a woman on the front - and the pronounced sway of her hips, you'd say she's in one of her frequent heat periods and pretty wound up with arousal. Coming to a stop before you that bounces her four breasts enticingly, the husky girl says 'Welcome back. I wanted to ask you what's up with the snowleopard guy who seems to be living in the cellar. I've seen him a few times from a distance, browsing books and cleaning up, but he always runs away when I go to talk to him.' Then she adds with a sigh 'Too bad, because he's really cute. I've tried to catch him on the way back to the stairs today, but he's escaped and now is hiding somewhere back there.'";
		say "     [WaitLineBreak]";
		say "     Telling Amy that the snowmeow is your pet kitty Sven, you explain that he's rather shy, but that his behaviour to her still is a bit strange and you'll go talk to him. The young husky nods to you, then goes to pick up her book, taking it to her mattress to indulge in some more romantic fantasies. Meanwhile, you make your way along the long rows of bookshelves, looking around until you find the hiding Sven eventually, peeking around the other end of a bookshelf. Coming up behind him silently, you give him quite a fright as you say his name. As the transformed exchange student whirls around quickly, you see a look of embarrassment on his face - and from the way he holds his bushed-out tail in front of himself, wringing the end with his hands, you can guess why...";
		say "     After patting his head and scritching behind Sven's ears a bit to calm him down, you then order your pet to explain himself. He says 'The husky woman up here is... very pretty. And every time I get close to her and smell her, I...' and then he moves his tail a bit to the side, revealing his almost painfully hard cock. Giving him some more time to mumble his explainations, you see the whole problem - the smell of Amy's heat arouses Sven to no end and he's far too embarrassed at having his boner sticking out at her to even talk to the husky. That's why he's been trying to avoid her at all costs."; 
		say "     [line break]";
		say "Well, you see two possibilities how you might resolve this situation. Do you want to introduce the two of them to each other (intimately) and show Sven he doesn't have to be embarrassed about his feelings towards Amy (Y), or do you just send him into the bunker and tell him to simply jerk off a few times before coming back up here so he doesn't get as affected by her as he is now (N)?";
		if player consents:
			say "     [line break]";
			say "     Ordering Sven to follow, you walk back to Amy's mattress and introduce them to each other, then motion to Sven to explain himself. He looks up from the floor to Amy, then stammers 'You're - very pretty, and you smell so nice that I always get... aroused when I'm close to you.' Smiling, you reach out for his tail that he was holding in front of himself again, pulling it to the side to reveal Sven's hard manhood. Amy's eyes go wide and she moans a little 'Oh', obviously quite interested in the snowmeow's hard and ready equipment. Sitting down besides her, Sven shyly chats a bit with Amy, but even then neither of them brings the topic of the quite obvious mounting sexual tension between them up on their own.";
			say "     With both of them rather submissive in temperament, it takes a suggestion from you till Amy makes the first step, reaching out for the big, grey cock of your snowmeow and wrapping her fingers around it. Sven shifts over and stretches out on his back, allowing her to straddle him as she moves into position over his hard rod. She lines up her opening with his cock, while he softly mewls his desire to fuck and fill her hot pussy. The husky girl sinks herself down over his big cock with ease, letting it fill her wide cunt slowly until he's all the way inside. Then she starts riding it, rocking back and forth on his pole while caressing your kitty's ears and scratching his cheeks. Sven purrumbles in pleasure, bucking lightly up into Amy as she rides him, but letting her set the pace. From her moans and pants, it's quite obvious how much Amy likes his long, thick and hard cock inside her. And she doesn't hold back in telling him that either, saying that he's a good and sexy kitty.";
			say "     [WaitLineBreak]";
			say "     Amy has a good, long fuck session with your fucktoy, reducing him to a mewling slut by the time her climax comes. Her pussy clamps down around his shaft, milking and tugging at it as her femcum soaks his crotch fur. The feel of a warm and wet cunt spasming around his throbbing rod is too much and Sven yowls in lust as he sprays his hot load into Amy moments later. The ample supply from his large balls flows up into her, causing the husky girl's tummy to swell as it fills her womb. Visibly pleased with the full feeling that gives her, Amy lies down on top of Sven, just keeping his cock inside her as she snuggles with him on her mattress. Only when his cock softens enough to plop out on its own does his load start leaking out of her, soaking into his fur and the bedding below the cuddling couple.";
			if Lust of Amy is 0:
				let AmyPregchance be a random number from 1 to 20;
				if AmyPregchance > 13:
					now Lust of Amy is 24;
			now lastfuck of Amy is turns;
			now lastfuck of Sven is turns;
			now SvenAmySex is 1;
		otherwise:
			say "     Telling Sven that while he's right in saving himself for your pleasure, it still doesn't excuse him being rude to Amy by not even talking to her. With the admonition that he should jerk off a few times before each time he wants to come up here so he can meet her without springing a hardon every time, you send him back down into the bunker.";
			now SvenAmySex is 99;
	otherwise if Xerxes is in Grey Abbey Library and (lastfuck of Xerxes - turns) > 12 and thirst of Amy is 1 and a random chance of 1 in 3 succeeds:
		say "     Entering the library, you see Amy - on all fours on her bedding, with Xerxes mounting her from behind. Looks like she felt the need to get some relief from her mounting arousal again. You human dog's firmly muscled ass moves back and forth as he pounds her pussy with a relentless wild energy, his hard thrusts obviously hitting just the right spots, judging from Amy's pants and pleased yips. This soon drives Amy's libido to the max, giving her a mind-blowing orgasm that moistens Xerxes cock with slippery femcum. He obviously likes the feeling of that, as his growls of lust increase and he speeds up before plunging in one last time and filling Amy's womb with his human seed.";
		say "     As his cock and balls keep twitching with blast after blast of cum into his sexual partner, Xerxes just keeps holding on to Amy, panting with his head over her shoulder. Exhausted, the husky lowers herself to lie on her bedding, taking your human dog with her so they end up cuddled together on the mattress[if lust of Xerxes >= 4].  Raising his head to look at you for a moment, Xerxes mumbles 'Mmm... Master-Friend Amy nice' to you, then snuggles up to her with his arms around the young woman's chest[end if].";
		if Lust of Amy is 0:
			let AmyPregchance be a random number from 1 to 20;
			if AmyPregchance > 13:
				now Lust of Amy is 24;
		now lastfuck of Amy is turns;
		now lastfuck of Xerxes is turns;
	otherwise if Felinoid Companion is tamed and (lastfuck of felinoid companion - turns) > 12 and level of Amy is 1 and a random chance of 1 in 3 succeeds:
		say "     Entering the library, you see Amy - on all fours on her bedding, with your felinoid companion standing over her, his legs bent a bit as he mounts her from behind. She's clearly under his influence again, all wound up and horny to be fucked hard. Mating her with powerful and deep thrusts, the felinoid doesn't hold back in any way. Moans, barks and growls of lust fill the library and you move a bit closer to watch the show.";
		say "     After quite a while of hot and heavy fucking, Amy's moans and noises rise up to a loud pleased yip, announcing her orgasm to anyone in hearing range. Visibly satisfied in making her come, the felinoid isn't far behind, burying his hard cock all the way in the young husky's pussy and holding still, only his balls pulsing as they fill her up with his seed. When he finishes cumming, the big cat pulls out and throws himself on her bedding to lounge in satisfaction. Amy kneels down beside him to lick his cock clean, then joins him on the mattress, snuggling up against his warm furred shape.";
		if Lust of Amy is 0:
			let AmyPregchance be a random number from 1 to 20;
			if AmyPregchance > 13:
				now Lust of Amy is 24;
		now lastfuck of Amy is turns;
		now lastfuck of felinoid companion is turns;
	otherwise if Fang is in Grey Abbey Library and (lastfuck of Fang - turns) > 12 and XP of Amy is 1 and a random chance of 1 in 3 succeeds:
		if hp of Fang < 3:  [Beta Fang]
			say "     Entering the library, you see Amy - on all fours on her bedding, with Fang mounting her from behind. Looks like she felt the need to get some relief from her mounting arousal again and he was only too happy to fuck the horny husky. The black wolf pounds into her hard and fast while the young husky's needy cunt grips and squeezes around that feral wolf cock. She moans about how strong your pet wolf is, how virile, to breed her like the bitch she is. Clearly pleased by those words, Fang takes the fur of her neck between his teeth in a careful bite and fucks her even harder, slamming his swollen knot against Amy's sore pussy until it stretches open enough to let that oversized knot pop in and tie with her. The black wolf howls triumphantly when this happens, unleashing a hot rush of semen into Amy, filling the husky girl with his ample load as he drains his large, virile balls into her. She writhes beneath him in ecstasy, cumming hard as well from taking your wolf's seed. When his knot goes down, he pops his cock from her, letting his excess semen flow out to soak into the mattress, leaving the scent of it upon Amy and her bedding as a reminder to you and others that he bred her.";
		otherwise:  [Alpha Fang]
			say "     Entering the library, you see Amy - on all fours on her bedding, with Fang mounting her from behind. As he should be - as Alpha, he's got the right to take any female - or male - he likes, whenever he wants. He pounds into her hard and fast while the young husky's needy cunt grips and squeezes around that feral wolf cock. She moans about how strong your big alpha is, how virile, to breed her like the bitch she is. Clearly pleased by those words, Fang takes the fur of her neck between his teeth in a careful bite and fucks her even harder, slamming his swollen knot against Amy's sore pussy until it stretches open enough to let that oversized knot pop in and tie with her. The black wolf howls triumphantly when this happens, unleashing a hot rush of semen into Amy, filling the husky girl with his ample load as he drains his large, virile balls into her. She writhes beneath him in ecstasy, cumming hard as well from taking your master's seed. When his knot goes down, he pops his cock from her, letting his excess semen flow out to soak into the mattress, leaving the scent of it upon Amy and her bedding as a reminder to you and others that she belongs to him.";
		if Lust of Amy is 0:
			let AmyPregchance be a random number from 1 to 20;
			if AmyPregchance > 13:
				now Lust of Amy is 24;
		now lastfuck of Amy is turns;
		now lastfuck of Fang is turns;
	otherwise if Elijah is bunkered and hp of Elijah > 3 and Dexterity of Amy > 0 and Dexterity of Amy < 99 and a random chance of 1 in 3 succeeds:	[repeat sex between Elijah and Amy]
		if hp of Elijah is 99:  [evil Elijah]		
			say "     Entering the library, you see Amy - lying on her bedding and panting loudly as Elijah thrusts his hard cock into her in a rapid pace. He's holding her legs spread apart, hands gripping her fur tightly as he really pounds her pussy, filling the library with slapping sounds of his hips hitting her crotch. Looks like the two of them have been going at it for a while now, judging from the cum-soaked spot on the mattress under Amy's hips and the wet squishing noises as Elijah slams into her, making one of his previous loads ooze out around his shaft. Wanting to get a closer look, you move in and watch from behind a nearby bookshelf, observing their movements against each other and listening to the pants and moans as they come quicker and quicker. It's obvious that Elijah is getting close to another climax quickly and he suddenly grips Amy by the hips, holding her tight against himself as his balls twitch again, sending pulse after pulse of his seed deep into the husky's womb. Amy writhes beneath him in ecstasy, cumming hard as well from taking even more of the dark angel's seed.";
			say "     With a satisfied sigh, he pulls out of her and gets up, his fresh load trickling out of her stretched pussy to soak into her bedding. Not even looking back as he leaves her, the dark angel then picks up his pants and boots, grinning at you as he stands up, having obviously spotted you. He saunters over in absolutely shameless nakedness and says 'Nice pussy, can't wait for the next time. Oh, and you really should put a collar and leash on her... wouldn't want such a fine bitch to run off.' With that, he walks away to go cleam himself up.";
		otherwise:
			say "     Entering the library, you see Amy - straddling the hips of a naked Elijah as he lies on her bedding. She rocks back and forth, moaning loudly as his hard cock moves inside her while Elijah has his arms stretched up, hands caressing her breasts. Looks like the two of them have been going at it for a while now, taking care of each other's needs. Not wanting to disturb their eager coupling, you just watch them from behind a nearby bookshelf, observing their movements against each other and listening to the pants and moans as they come quicker and quicker. It's obvious that Elijah's climax quickly approaches and he suddenly grips Amy by the hips, rolling the two of them aroundso she's now under him. He thrusts into her a few more times with urgent movements, then suddenly stiffens, grunting as his balls twitch and unload his fertile seed deep in the husky girl's pussy. Amy writhes beneath him in ecstasy, cumming hard as well from taking your angelic friend's seed. With a satisfied sigh, he just holds her against his chest afterwards, staying with the young husky to cuddle a bit on her mattress.";
		if Lust of Amy is 0:
			let AmyPregchance be a random number from 1 to 20;
			if AmyPregchance > 13:
				now Lust of Amy is 24;
		now lastfuck of Amy is turns;
		now lastfuck of Elijah is turns;
	otherwise if Sven is bunkered and hp of Sven > 5 and hp of Sven < 50 and SvenAmySex is 1 and a random chance of 1 in 3 succeeds:	[repeat sex between Sven and Amy]		
		say "     Entering the library, you see Amy - with Sven under her on her mattress, both of them moaning as she fucks him in the cowgirl position. Looks like she decided to use your pet kitty for her own pleasure again. She rocks back and forth on his pole while caressing your snowmeow's ears and scratching his cheeks. Sven purrumbles in pleasure, bucking lightly up into Amy as she rides him, but letting her set the pace. From her moans and pants, it's quite obvious how much Amy likes his long, thick and hard cock inside her. And she doesn't hold back in telling him that either, saying that he's a good and sexy kitty.";
		say "     Amy has a good, long fuck session with your fucktoy, reducing him to a mewling slut by the time her climax comes. Her pussy clamps down around his shaft, milking and tugging at it as her femcum soaks his crotch fur. The feel of a warm and wet cunt spasming around his throbbing rod is too much and Sven yowls in lust as he sprays his hot load into Amy moments later. The ample supply from his large balls flows up into her, causing the husky girl's tummy to swell as it fills her womb. Visibly pleased with the full feeling that gives her, Amy lies down on top of Sven, just keeping his cock inside her as she snuggles with him on her mattress. Only when his cock softens enough to plop out on its own does his load start leaking out of her, soaking into his fur and the bedding below the cuddling couple.";
		if Lust of Amy is 0:
			let AmyPregchance be a random number from 1 to 20;
			if AmyPregchance > 13:
				now Lust of Amy is 24;
		now lastfuck of Amy is turns;
		now lastfuck of Sven is turns;
	otherwise:
		say "     As you enter the library, you see Amy on her bedding, legs spread and a hand stroking her own pussy lips. Looks like she's pretty horny, aching for a fuck. Maybe you should help her out with that...";

Instead of fucking the Amy:
	if hp of Amy is 1:   [child-like]
		say "     With her being not even a week old and rather child-like in temperament, it doesn't seem right to just fuck Amy. You decide you'd rather not do that right now.";
	otherwise if hp of Amy is 2:    [matured]
		say "     Deciding that you'll just be straightforward about things, you walk up to Amy and tell her you'd like to have sex with her. 'Oh', the young husky says, looking to the side for a moment to a bookcase a sign above denounces to be filled with romance novels. 'I've read a bit about that when I started getting some funny feelings. So you want to... be my first? It's supposed to be someone special, a prince or a pirate or... a hero.' With that, she smiles at you. 'You saved me when we were out in the streets, brought me here and have been pretty nice, so sure - let's do it.' She takes you by the hand, leading you over to her mattress and sitting down on it.";
		say "     [AmyFirstFuck]";
		now lastfuck of Amy is turns;
		now hp of Amy is 11;
	otherwise if (HP of Amy is 10):   [she told the player she wanted them to fuck her]
		say "     Deciding that you'll just be straightforward about things, you walk up to Amy and tell her you'd like to have sex with her. The young husky happily embraces you, moaning a bit as her four breasts rub against your chest. 'Thank you for making me the happiest girl in the world. It'll be just like in the books, with you my hero.' She takes you by the hand, leading you over to her mattress and sitting down on it.";
		say "     [AmyFirstFuck]";
		now lastfuck of Amy is turns;
		now hp of Amy is 11;
	otherwise:   [repeat sex]
		if (lastfuck of Amy - turns < 2):
			say "     As you approach Amy, the young husky bitch looks at you and sighs. 'I want to have sex with you, but I'm pretty exhausted from last time. Please give me a moment to rest, ok?'";
		otherwise:
			say "     You walk over to Amy, who immediately starts smiling and stroking her breasts as she sees the lust-filled twinkle in your eyes.";
			wait for any key;
			say "[AmySexMenu]";
			now lastfuck of Amy is turns;

to say AmyFirstFuck:
	if(cocks of player > 0):      [males+herm]
		say "     After quickly stripping off your clothes, you let your gaze wander over Amy's naked form, your manhood hardening as you look at her female curves. The husky knowingly smiles, arching her back a bit to present her four breasts to you, sensually stroking over them. 'I'm waiting for you', she coos, giving you her best 'come hither' look. Kneeling down beside her, you bring your mouth to hers and kiss her, your hands roaming over her body, then holding her to lower her onto her back. Lying on top of her, you make out with the hot little husky, bringing her arousal she hasn't felt before. Then you move lower, cupping her breasts and playfully sucking on her nipples before going even further down her body and arriving at her pussy. Carefully spreading the husky's sensitive pussy lips, you put your tongue to it and lick, paying close attention to her clit. Amy gasps loudly as she experiences oral sex for the first time.";
		say "     [WaitLineBreak]";
		say "     Teasing the virgin husky with your tongue, you get her really wet down there in no time at all, with Amy just writhing on the mattress as you take her to new heights. Hearing her nonstop panting and moaning, you decide it's time to take this one step further and show her what really getting fucked is like. Holding open her legs, your hands rubbing Amy's soft fur, you move up until your [cock of player] shaft rests hotly against her pubic mound. Leaning over her, you kiss the aroused husky and slowly slide your head into her, soon pushing against her hymen.";
		say "     [WaitLineBreak]";
		say "  	   Wanting to distract her from the pain of losing her virginity, you give her another deep kiss, move your hands to cup her top two breasts - and then make a quick downward thrust, only stopping as your crotch touches hers. There is only a short yip from Amy as her hymen is broken by your invading member, the moment of pain drowned out almost instantly by the pleasurable sensations of being kissed, touched and fucked. She starts moaning again as you move inside her, rubbing her inner walls with your hard shaft. Fucking the husky woman feels great, with the warm and tight vagina around your cock and her soft-furred female body in your arms. Being her first time having sex, and your first time in her, it's not too much longer until your coupling culminates in two pretty noisy orgasms. Amy is the first to reach her goal, giving a lust-filled howl as she comes, her femcum making your shaft even wetter than before. After a few more deep thrusts, you follow her to the other side, body shuddering as your balls release burst after burst of cum to splash into the husky's womb.";
		say "     [WaitLineBreak]";
		say "  	  Satisfied, you stay like that with Amy for a while, listening to her comparing what you just did to the books she read, mostly in terms of '...soo much better than I had imagined, even after reading about Lady Catherine and Lord Malcomb...' Running you hands through her soft belly fur, circling a nipple with your finger, you soon start making out with your canine mate, telling her she doesn't need those books now as there's lots more interesting stuff to do with you in reality.";
		let AmyPregchance be a random number from 1 to 20;
		if AmyPregchance > 7:
			now Lust of Amy is 24;
	otherwise if (cunts of player > 0):  [females]
		say "     After quickly stripping off your clothes, you let your gaze wander over Amy's naked form, a shiver of excitement going through you as you look at her female curves. The husky knowingly smiles, arching her back a bit to present her four breasts to you, sensually stroking over them. 'I'm waiting for you', she coos, giving you her best 'come hither' look. Kneeling down beside her, you bring your mouth to hers and kiss her, your hands roaming over her body, then holding her to lower her onto her back. Lying on top of her, you make out with the hot little husky, bringing her arousal she hasn't felt before. Then you move lower, cupping her breasts and playfully sucking on her nipples before going even further down her body and arriving at her pussy. Carefully spreading the husky's sensitive pussy lips, you put your tongue to it and lick, paying close attention to her clit. Amy gasps loudly as she experiences oral sex for the first time.";
		say "     [WaitLineBreak]";
		say "     Teasing the virgin husky with your tongue, you get her really wet down there in no time at all, with Amy just writhing on the mattress as you take her to new heights. Hearing her nonstop panting and moaning, you decide it's time to take this one step further and show her what really getting fucked is like. Grabbing the dildo you brought for this purpose from between the pile of your cast-off clothing, you kiss Amy, then hold the rubber sex top up for her to see. As she takes it from you to put it in her mouth, you spread open her legs, your hands rubbing Amy's soft fur, then rub your fingers over her pussy mound and downwards, stroking her sensitive nether lips. Leaning over her, you take the now wet and ready dildo from her, you rub its head over her pussy lips and start to slowly push it in between them, soon bumping against her hymen.";
		say "     [WaitLineBreak]";
		say "  	   Wanting to distract her from the pain of losing her virginity, you give her another deep kiss, move a hand to cup one of her upper breasts - and then make a quick downward thrust with the dildo, only stopping as the rubber balls at its base touch her crotch. There is only a short yip from Amy as her hymen is broken by the invading member, the moment of pain drowned out almost instantly by the pleasurable sensations of being kissed, touched and fucked. She starts moaning again as you move the toy inside her, rubbing her inner walls with the hard rubber shaft. Fucking the husky woman is a lot of fun, though you ache for some release of your own, so you get on top of her in 69 position. Without any prompting, Amy starts licking you again, driving you to higher and higher arousal. Being her first time having sex, and you already aroused from taking care of Amy, it's not too much longer until your coupling culminates in two pretty noisy orgasms. Amy is the first to reach her goal, giving a lust-filled howl as she comes, her femcum glistening wetly on the rubber shaft of the dildo you're fucking her with. Just moments later, you experience your own climax, the young husky's talented tongue driving you over the edge.";
		say "     [WaitLineBreak]";
		say "  	  Satisfied, you stay like that with Amy for a while, listening to her comparing what you just did to the books she read, mostly in terms of '...soo much better than I had imagined, even after reading about Lady Catherine and Lord Malcomb...' Running you hands through her soft belly fur, circling a nipple with your finger, you soon start making out with your canine mate, telling her she doesn't need those books now as there's lots more interesting stuff to do with you in reality.";
	otherwise:       [neuter]
		say "     After quickly stripping off your clothes, you let your gaze wander over Amy's naked form, a shiver of excitement going through you as you look at her female curves. The husky knowingly smiles, arching her back a bit to present her four breasts to you, sensually stroking over them. 'I'm waiting for you', she coos, giving you her best 'come hither' look. Kneeling down beside her, you bring your mouth to hers and kiss her, your hands roaming over her body, then holding her to lower her onto her back. Lying on top of her, you make out with the hot little husky, bringing her arousal she hasn't felt before. Then you move lower, cupping her breasts and playfully sucking on her nipples before going even further down her body and arriving at her pussy. Carefully spreading the husky's sensitive pussy lips, you put your tongue to it and lick, paying close attention to her clit. Amy gasps loudly as she experiences oral sex for the first time.";
		say "     [WaitLineBreak]";
		say "     Teasing the virgin husky with your tongue, you get her really wet down there in no time at all, with Amy just writhing on the mattress as you take her to new heights. Hearing her nonstop panting and moaning, you decide it's time to take this one step further and show her what really getting fucked is like. Grabbing the dildo you brought for this purpose from between the pile of your cast-off clothing, you kiss Amy, then hold the rubber sex top up for her to see. As she takes it from you to put it in her mouth, you spread open her legs, your hands rubbing Amy's soft fur, then rub your fingers over her pussy mound and downwards, stroking her sensitive nether lips. Leaning over her, you take the now wet and ready dildo from her, you rub its head over her pussy lips and start to slowly push it in between them, soon bumping against her hymen.";
		say "     [WaitLineBreak]";
		say "  	   Wanting to distract her from the pain of losing her virginity, you give her another deep kiss, move a hand to cup one of her upper breasts - and then make a quick downward thrust with the dildo, only stopping as the rubber balls at its base touch her crotch. There is only a short yip from Amy as her hymen is broken by the invading member, the moment of pain drowned out almost instantly by the pleasurable sensations of being kissed, touched and fucked. She starts moaning again as you move the toy inside her, rubbing her inner walls with the hard rubber shaft. Fucking the husky woman is a lot of fun, though with it being her first time having sex, it's not too much longer until you drive the husky girl to a pretty noisy orgasm. As Amy reaches her goal, she gives a lust-filled howl and comes, her femcum glistening wetly on the rubber shaft of the dildo you're fucking her with.";
		say "     [WaitLineBreak]";
		say "  	  Satisfied, you stay like that with Amy for a while, listening to her comparing what you just did to the books she read, mostly in terms of '...soo much better than I had imagined, even after reading about Lady Catherine and Lord Malcomb...' Running you hands through her soft belly fur, circling a nipple with your finger, you soon start making out with your canine mate, telling her she doesn't need those books now as there's lots more interesting stuff to do with you in reality.";
		
to say AmySexMenu:
	blank out the whole of table of fucking options;
	if (cocks of player > 0):
		choose a blank row in table of fucking options;
		now title entry is "Have her blow your cock";
		now sortorder entry is 1;
		now description entry is "Put the husky's mouth to good use.";
		now toggle entry is AmySex rule;
	if (cunts of player > 0):
		choose a blank row in table of fucking options;
		now title entry is "Have her lick your pussy";
		now sortorder entry is 2;
		now description entry is "Put the husky's mouth to good use.";
		now toggle entry is AmySex rule;
	choose a blank row in table of fucking options;
	now title entry is "Finger her pussy";
	now sortorder entry is 3;
	now description entry is "Finger-fuck Amy's pussy to make her cum.";
	now toggle entry is AmySex rule;
	if (cocks of player > 0):
		choose a blank row in table of fucking options;
		now title entry is "Fuck her pussy";
		now sortorder entry is 4;
		now description entry is "Fill the husky bitch with your cock.";
		now toggle entry is AmySex rule;
[	
	if (cocks of player > 0):
		choose a blank row in table of fucking options;
		now title entry is "Take Amy's ass";
		now sortorder entry is 5;
		now description entry is "Fill the husky bitch's ass with your cock.";
		now toggle entry is AmySex rule;
]
	if (cocks of player > 0 and thirst of Amy is 1 and Xerxes is in the Grey Abbey Library):
		choose a blank row in table of fucking options;
		now title entry is "Have a threesome with Amy and Xerxes";
		now sortorder entry is 6;
		now description entry is "Have sex with both your human dog and horny husky.";
		now toggle entry is AmySex rule;
	if (cocks of player > 0 and level of Amy is 1 and felinoid companion is tamed):
		choose a blank row in table of fucking options;
		now title entry is "Have a threesome with Amy and the Felinoid";
		now sortorder entry is 7;
		now description entry is "Have sex with both your felinoid companion and horny husky.";
		now toggle entry is AmySex rule;
	if (cocks of player > 0 and XP of Amy is 1 and Fang is in the Grey Abbey Library):
		choose a blank row in table of fucking options;
		now title entry is "Have a threesome with Amy and Fang";
		now sortorder entry is 8;
		now description entry is "Have sex with both the black wolf and horny husky.";
		now toggle entry is AmySex rule;
	sort the table of fucking options in sortorder order;
	change the current menu to table of fucking options;
	carry out the displaying activity;
	clear the screen;

This is the AmySex rule:
	choose row Current Menu Selection in table of fucking options;
	let nam be title entry;
	say "[title entry]: [description entry][line break]";
	say "Is this what you want?";
	if player consents:
		decrease menu depth by 1;
		clear the screen;
		if (nam is "Have her blow your cock"):
			say "[AmySex1]";
		otherwise if (nam is "Have her lick your pussy"):
			say "[AmySex2]";
		otherwise if (nam is "Finger her pussy"):
			say "[AmySex3]";
		otherwise if (nam is "Fuck her pussy"):
			say "[AmySex4]";
		otherwise if (nam is "Take Amy's ass"):
			say "[AmySex5]";
		otherwise if (nam is "Have a threesome with Amy and Xerxes"):
			say "[AmySex6]";
		otherwise if (nam is "Have a threesome with Amy and the Felinoid"):
			say "[AmySex7]";
		otherwise if (nam is "Have a threesome with Amy and Fang"):
			say "[AmySex8]";
		wait for any key;
		
to say AmySex1:    [cock sucked by Amy]
	say "     A smile on your face as you walk up to her, you grab the bulge in your pants and ask her if she could help you it with it. No longer the innocent little husky you first found, she grins at you and licks her lips, then kneels before you. Pulling out your [cock of player] cock, you hold it out with one hand, allowing Amy to put it in her muzzle and suck on it. She really is a natural at giving blowjobs, holding her lips tight around your shaft and teasing it with her tongue...";
	say "     Before too much longer, the husky girl's enthusiastic sucking drives your arousal through the roof. As she goes down on your cock again, you hold her head against your crotch, shooting long blasts of cum into her mouth. When she pulls off your cock after you're done, Amy shows you the large load on her tongue, then swallows it demonstratively. Jokingly, you call her a 'Good dog', tousling her hair, then softly pull Amy to her feet, give her a deep kiss and thank her.";
			
to say AmySex2:    [cunt licked by Amy]
	say "     A smile on your face as you walk up to her, you rub the crotch of your pants and ask her if she could help you it with it. No longer the innocent little husky you first found, she grins at you and licks her lips, then kneels before you. Pulling off your pants, you show your already a bit moist pussy, allowing Amy to put her muzzle between your legs and lick. She really is a natural at stimulating you with that tongue of hers, pushing it into your vagina and teasing your clit with its tip...";
	say "     Before too much longer, the husky girl's enthusiastic oral attention drives your arousal through the roof. As she goes down on you to lick your pussy again, you hold her head against your crotch, breathing deeply as the husky girl slurps up the femcum running down your legs. Jokingly, you call her a 'Good dog', tousling her hair, then softly pull Amy to her feet, give her a deep kiss and thank her.";
	
to say AmySex3:    [Amy's cunt licked/fingered]
	say "     Walking up close to Amy, you put your arms around her and give her a hug. As your lips find hers for a kiss, your hands move down over her naked body, softly stroking her curves. Coming back up for air, you start rubbing over her sensitive pussy lips, making Amy give a needful moan.";
	say "     Guiding the aroused husky over to her bedding, you kneel between her legs as she lies down on her back. Her pussy, already a bit swollen and moist in anticipation, lies ready for you between the canine girl's legs. Leaning forward, you bring your mouth to it, licking over her crotch, then playing with Amy's clit with the tip of your tongue. It's a lot of fun to hear her gasp and moan under your ministrations and you switch up between fingering her and licking.";
	say "     Under your skilled fingers and tongue, it doesn't take long until Amy's moans get louder and louder and the female husky pants almost nonstop. Then suddenly, she arches her back, hands flying to hold your head in place as she climaxes. Your face is a bit wet with squirts of her femcum as you move on top of Amy afterwards to give her a deep kiss. The young husky smiles and licks your face, her arms around your body to hold you close.";

to say AmySex4:    [Amy's pussy fucked by player]
	if(Lust of Amy > 1 and Lust of Amy < 12):    [pregnant version]
		say "     Walking up close to Amy, you put your arms around her and give her a hug. As your lips find hers for a kiss, your hands move down over her naked body, softly stroking her curves and carefully touching her pregnant belly. Coming back up for air, you tell her how hard thinking about fucking her makes you. 'You're not the only one', she coos back at you, taking your hand and putting it between her legs to feel her sex already a bit moist, open and swollen. As you start stroking over her sensitive pussy lips with a finger, Amy moves up against you closely, rubbing her breasts against your body. The two of you enjoy touching each other for a bit, you fondling her breasts and Amy rubbing your cock, until the building arousal between you can no longer be contained. Holding you by her paw-hand, Amy almost pulls you over to her mattress, where she gets on all fours, showing her ass and the dripping vagina between her legs invitingly.";
		say "     [WaitLineBreak]";
		say "     Quickly sliding off your clothes, you step up and kneel behind Amy, then lean over her. As wrap your arms around her from behind, fondling her four breasts and rubbing the bulging pregnant belly, your [cock of player] shaft comes to rest hotly against her furred ass. Amy moans as you take hold of your cock, pushing it down a bit and rubbing its head over her pussy lips, then put its tip between them. Sliding into her wet and tight vagina in one smooth move, you grunt deeply as you bottom out in her, your balls touching her soft crotch-fur. You stay like that for a moment, giving her the opportunity to get used to your member spreading her inner passage, then start pulling out a bit and thrusting back in, fucking the young husky.";
		say "     Amy is a very enthusiastic sex-partner, rocking back to meet you with her hips as you pound into her. In between moans and pants, she groans 'Harder. Harder!', only satisfied when your balls smack against her buttcheeks with an audible thud each time you bottom out again. You wish you could keep the amazing feelings you give each other up forever, but all too soon, the limit of your ability to hold back is reached. With a gasped 'I'm coming!', you thrust into her one last time, burying your [cock of player] shaft inside her pussy[if cock length of player > 10] until it pushes against her cervix[otherwise].[end if] Then your balls send the massive load built up inside them on its way, burst after burst of your fertile seed shooting into your beautiful husky's womb. The feeling of a male's cum flooding her insides gives Amy the last push she needed too. While you're still pumping more shots inside her, she writhes under you, tongue lolling out of her mouth as she rides her orgasm.";
		say "     [WaitLineBreak]";
		say "  	  Immensely satisfied, you stay like that on top of her for a while, then pull your softening cock out and lie down with Amy. Spooning her, you run a hand through her soft belly fur, feeling the rounded curve of her body that bulges with the new life growing inside her.";
	otherwise:   						   [regular version]
		say "     Walking up close to Amy, you put your arms around her and give her a hug. As your lips find hers for a kiss, your hands move down over her naked body, softly stroking her curves. Coming back up for air, you tell her how hard thinking about fucking her makes you. 'You're not the only one', she coos back at you, taking your hand and putting it between her legs to feel her sex already a bit moist, open and swollen. As you start stroking over her sensitive pussy lips with a finger, Amy moves up against you closely, rubbing her breasts against your body. The two of you enjoy touching each other for a bit, you fondling her breasts and Amy rubbing your cock, until the building arousal between you can no longer be contained. Holding you by her paw-hand, Amy almost pulls you over to her mattress,  where she lies down on her back, spreading her legs invitingly.";
		say "     [WaitLineBreak]";
		say "     Quickly sliding off your clothes, you step up and kneel between Amy's legs, then lean over her. As you start making out hungrily, your [cock of player] shaft comes to rest hotly against her pubic mound. Amy moans as you take hold of your cock, rubbing its head over her pussy lips, then put its tip between them. Sliding into her wet and tight vagina in one smooth move, you grunt deeply as you bottom out in her, your balls touching her soft crotch-fur. You stay like that for a moment, giving her the opportunity to get used to your member spreading her inner passage, then start pulling out a bit and thrusting back in, fucking the young husky.";
		say "     Amy is a very enthusiastic sex-partner, holding you close with her arms and making out as you pound into her. She even wraps her legs around your hips to pull your crotch down harder against her, moaning as your balls hit her buttcheeks when you bottom out again. You wish you could keep the amazing feelings you give each other up forever, but all too soon, the limit of your ability to hold back is reached. With a gasped 'I'm coming!', you thrust into her one last time, burying your [cock of player] shaft inside her pussy[if cock length of player > 10] until it pushes against her cervix[otherwise].[end if] Then your balls send the massive load built up inside them on its way, burst after burst of your fertile seed shooting into your beautiful husky's womb. The feeling of a male's cum flooding her insides gives Amy the last push she needed too. While you're still pumping more shots inside her, she writhes under you, tongue lolling out of her mouth as she rides her orgasm.";
		say "     [WaitLineBreak]";
		say "  	  Immensely satisfied, you stay like that on top of her for a while, then pull your softening cock out and lie down with Amy. Spooning her, you run a hand through her soft belly fur, circling her nipples with your finger, then just hold her.";
		if Lust of Amy is 0:
			let AmyPregchance be a random number from 1 to 20;
			if AmyPregchance > 10:
				now Lust of Amy is 24;

to say AmySex5:    [Amy's ass fucked by player]
	if(Lust of Amy > 1 and Lust of Amy < 12):    [pregnant version]
		say "  Preg Version";
	otherwise:   						   [regular version]
		say "  Regular Version";

to say AmySex6:    [Xerxes+Amy+Player Threesome]
	say "     Stepping by Xerxes bunk, you ruffle the human dog's hair and say 'Come on, boy', then make your way to Amy's bedding accompanied by him. Walking up close to Amy, you put your arms around her and give her a hug. As your lips find hers for a kiss, your hands move down over her naked body, softly stroking her curves[if Lust of Amy > 1 and Lust of Amy < 12] and carefully touching her pregnant belly[end if]. Coming back up for air, you tell her how hard thinking about fucking her makes you. 'You're not the only one', she coos back at you, giving a smiling nod down to Xerxes, who's busy sniffing her already a bit moist, open and swollen pussy. She crouches down[if Lust of Amy > 1 and Lust of Amy < 12] with a bit of help from you, pregnant as she is[end if], then sits on her mattress and pulls the human dog's head to hers, exchanges some licks and kisses with him too.";
	say "     Joining the two of them on the mattress, Amy sitting and Xerxes on all fours, you start stroking over the husky's sensitive pussy lips with a finger, your other hand cupping and caressing her breasts. There's quite a bit of touching, kissing and licking going on between the three of you for a while, then Amy's mounting arousal can no longer be contained. Getting up on her knees, the young husky moves around on the mattress, then takes a position on all fours, showing her ass and the dripping vagina between her legs invitingly.";
	say "     [WaitLineBreak]";
	say "     Your human dog sniffs the air, taking in Amy's female scent, and is quite obviously rock hard and almost trembling with the desire to mount her right now. Nevertheless, he obediently waits on all fours besides you, his training overcoming his natural urges even now. Though he does give you an incredibly hard to resist pleading puppy dog look[if lust of Xerxes >= 4] as he says 'Me fuck Amy?'[end if] - amazing that that still works, even though he's in the body of a teenage human.";
	say "     [line break]";
	say "     So - do you allow Xerxes to mount Amy, or take that position yourself? Who shall fuck her? (Y = you, N = Xerxes) ";
	if player consents:  [player mounts her]
		say "     [line break]";
		say "     Shaking your head at Xerxes, you quickly strip off your clothes, then hold your already quite hard shaft out for him. With a happy yip, he starts licking it, running his talented tongue along your shaft, then lapping at your balls before returning to the tip of your cock and taking it in his mouth. After Xerxes bobs up and down on your cock a few times, you smile and tussle his hair, then pull out and move to kneel behind Amy. One hand on your slick and wet manhood, you rub its tip over the young husky's swollen nether lips, then press in between them. Sliding into her tight vagina in one smooth move, you grunt deeply as you bottom out in her, your balls touching her soft crotch-fur. You stay like that for a moment, giving her the opportunity to get used to your member spreading her inner passage, then start pulling out a bit and thrusting back in, fucking the young husky.";
		say "     [line break]";
		say "     Not forgetting about your human dog, in between moans you tell him to... (Y = mount you, N = move to get sucked off by Amy) ";
		if player consents:  [Xerxes fucks the player]
			say "     [line break]";
			say "     You wiggle your ass at Xerxes and reach back to spread your cheeks invitingly, to which the human dog pounces on your ass and starts lapping up and down your crack. Already hot and ready from his lust for Amy, that quickly leads over to him mounting you from behind in typical doggie-style, hugging your chest has his hips grind against you. His hard shaft pokes your ass and rubs up and down your crack until he finally finds your hole and presses in against you. As your pucker yields to Xerxes invading member, he plunges deep into your body, giving a lustful growl as he bottoms out in one thrust.";
			if lust of Xerxes >= 4:
				say "     Having gained intelligence to go along with his canine mind, he is able to hold back his instinctive desire to rut you hard and fast for a while, taking the time to run his hands over your [one of][bodytype of player][or][if cocks of player > 0 and cunts of player > 0]herm[otherwise if cocks of player > 0]male[otherwise if cunts of player > 0]female[otherwise]genderless[end if][as decreasingly likely outcomes] body as he takes slower thrusts at first, enjoying the feel of your hot, tight hole around his pulsing shaft. His hands roam over you[if lust of Xerxes < 7] almost as if he were petting you[otherwise], stroking and caressing your [bodydesc of player] body with growing adeptness[end if]. He nuzzles at the back of your neck, panting with a growing excitement that has his pace quicken in response. As he thrusts harder, you moan what a good boy he is.";
			say "     [WaitLineBreak]";
			say "     Xerxes fucks you with a relentless wild energy, his hard thrusts rubbing very sensitive and pleasurable spots inside you, just as you pound the very enthusiastic Amy in front of yourself. In between moans and pants, she groans 'Harder. Harder!', only satisfied when your balls smack against her buttcheeks with an audible thud each time you bottom out again. You wish you could keep the amazing feelings you give each other up forever, but all too soon, the limit of your ability to hold back is reached. With a gasped 'I'm coming!', you thrust into her one last time, burying your [cock of player] shaft inside her pussy[if cock length of player > 10] until it pushes against her cervix. [otherwise]. [end if]Then your balls send the massive load built up inside them on its way, burst after burst of your fertile seed shooting into your beautiful husky's womb. The feeling of a male's cum flooding her insides gives Amy the last push she needed too. While you're still pumping more shots inside her, she writhes under you, tongue lolling out of her mouth as she rides her orgasm.";
			say "     In the grip of your own climax, your anal muscles twitch around Xerxes cock, which obviously excites him, making his growls of lust increase and him speed up before plunging in one last time and filling your asshole with his human seed. As his cock and balls keep twitching with blast after blast of cum into you, Xerxes just keeps holding on to you, panting with his head over your shoulder. Turning your head, you pull his lips to yours, kissing him and sticking your tongue in his mouth. Holding him against you with one arm, the other one on Amy, you pull your little trio down to lie on the mattress, where you enjoy each other's warmth and closeness for a while as you come down from your respective orgasms[if lust of Xerxes >= 4]. 'Mmm... Master good fuck,' he mumbles softly, snuggling up to your back lovingly[end if].";
			setmonster "human";
			choose row monster from the table of random critters;
			say "     [mimpregchance]";
		otherwise:  [Xerxes gets sucked off by Amy]
			say "     [line break]";
			say "     Telling[if lust of Xerxes >= 4] Xerxes to get a blowjob from Amy, you watch the naked body of the human dog as he rushes around to her front, then kneels in front of her, his erect cock sticking up straight in front of her face. [otherwise] Xerxes to go to Amy, you watch the naked body of the human dog as moves to her front, then throws himself on the ground in front of her, rolling on his back with spread legs to allow her to suck his shaft. [end if]The young husky takes it in her muzzle, carefully keeping her teeth away as she starts bobbing up and down. While Xerxes is getting an amazing blowjob, you fuck Amy's tight pussy, pounding into the very enthusiastic young husky. In between moans and pants, she groans 'Harder. Harder!', only satisfied when your balls smack against her buttcheeks with an audible thud each time you bottom out again. You wish you could keep the amazing feelings you give each other up forever, but all too soon, the limit of your ability to hold back is reached. With a gasped 'I'm coming!', you thrust into her one last time, burying your [cock of player] shaft inside her pussy[if cock length of player > 10] until it pushes against her cervix. [otherwise]. [end if]Then your balls send the massive load built up inside them on its way, burst after burst of your fertile seed shooting into your beautiful husky's womb. The feeling of a male's cum flooding her insides gives Amy the last push she needed too. While you're still pumping more shots inside her, she writhes under you, tongue lolling out of her mouth as she rides her orgasm.";
			say "     After a moment, when the feelings of just having come ebb out, Amy continues the blowjob she was giving Xerxes and before too much longer, the husky girl's enthusiastic sucking drives his lust through the roof. As she goes down on the human dog's cock again, he[if lust of Xerxes >= 4] moans 'Aaah - Good Amy' and[end if] yips as he comes, shooting long blasts of cum into her mouth. When she pulls off his cock after he's done, Amy shows you the large load on her tongue, then swallows it demonstratively. Jokingly, you call her and Xerxes both 'Good dog', tousling their hair, then pull Amy's head to yours and give her a deep kiss. Lying down on the mattress with your two friends after that, you enjoy each other's warmth and closeness for a while[if lust of Xerxes >= 4]. 'Mmm... Amy and Master nice,' Xerxes mumbles softly, snuggling up to your back lovingly[end if].";
	otherwise:	[Xerxes gets on Amy]
		say "     [line break]";
		if lust of Xerxes >= 4:		[awesome/intelligent Xerxes]
			say "     You pat Xerxes shoulder and say 'Go for it' with a grin. Having gained intelligence to go along with his canine mind, he is able to hold back his instinctive desire to rut you hard and fast for a while, taking the time to run his hands over Amy's back and female curves first. He leans close against her back to cup two of the husky's breasts with his hands while moving his hips to position his shaft at her opening. Then, with a quick thrust accompanied by two persons very satisfied moans, he sinks his manhood into her drippingly moist pussy. Xerxes takes slower thrusts at first, enjoying the feel of Amy's hot, wet hole around his pulsing shaft. His hands roam over her[if lust of Xerxes < 7] almost as if he were petting Amy[otherwise], stroking and caressing Amy's body with growing adeptness[end if]. He nuzzles at the back of the young husky's neck, panting with a growing excitement that has his pace quicken in response.";
			say "     [line break]";
			say "     Having quickly gotten rid of your clothes and gear while your two companions got into fucking each other, you now stand naked besides them, your cock hard and ready for action. How do you want to join in on their coupling? (Y = have Amy suck you, N = fuck Xerxes ass) ";
		otherwise:	[basic Xerxes]
			say "     Almost before you're finished saying 'Go for it, boy', Xerxes is on top of Amy, his muscular chest against her back as he hugs her tightly and grinds his crotch against her body. Being a natural in the typical 'doggie-style', his shaft quickly finds her dripping opening and plunges deep into the husky's body. Quickly stripping off your own clothes as they start fucking each other, you now stand naked besides them, your cock hard and ready for action. How do you want to join in on their coupling? (Y = have Amy suck you, N = fuck Xerxes ass) ";
		if player consents:  [have Amy blow the player]
			say "     [line break]";
			say "     Walking around the two of them till you're in front of Amy, you sit down and hold your hard shaft out for her. The young husky takes it in her muzzle, carefully keeping her teeth away as she starts bobbing up and down. She really is a natural at giving blowjobs, holding her lips tight around your shaft and teasing it with her tongue. While you're getting an amazing blowjob, Xerxes fucks Amy with a relentless wild energy, his hard thrusts hitting very sensitive spots again and again, making her pant and yip in pleasure. This soon drives Amy's arousal to the max, giving her a mind-blowing orgasm that moistens Xerxes cock with even more slippery femcum. He obviously likes the feeling of that, as his growls of lust increase and he speeds up before plunging in one last time and filling Amy's womb with his human seed.";
			say "     After a moment of riding out her own orgasm, Amy continues the blowjob she was giving you and before too much longer, the husky girl's enthusiastic sucking drives your lust through the roof. As she goes down on your cock again, you hold her head against your crotch, shooting long blasts of cum into her mouth. When she pulls off your cock after you're done, Amy shows you the large load on her tongue, then swallows it demonstratively. Jokingly, you call her and Xerxes both 'Good dog', tousling their hair, then pull Amy's head to yours and give her a deep kiss. Lying down on the mattress with your two friends after that, you enjoy each other's warmth and closeness for a while[if lust of Xerxes >= 4]. 'Mmm... Amy good fuck,' Xerxes mumbles softly, snuggling up to your back lovingly and nuzzling your neck[end if].";
		otherwise:  [assfuck for Xerxes]
			say "     [line break]";
			say "     Walking around the two of them till you're behind Xerxes, you kneel down and quickly lube up your shaft. Running your hands down the muscular back of your human dog, from up on his shoulders down to his hips, you grip them tightly to hold him still for a moment and bring your hard cock against his pucker. Telling him in soft tones to relax, you push forward and slide into his body. Xerxes hole is incredibly warm and tight - no wonder, with only Mike and maybe one or two of the other human dogs having been in there before you. You take a moment to appreciate the tightly gripping feel of his ass as you bottom out, then start fucking him, with Xerxes panting and yipping in lust as you slide in and out[if lust of Xerxes >= 4]. 'Good master,' he moans, pressing his rear back into your thrusts[end if]. As you pound into him from behind, your pet's shaft gets pushed deeper into Amy's pussy in turn, making her pants and moans join Xerxes. That almost makes you feel like you're fucking them both at the same time...";
			say "     You run your hands over Xerxes sexy body, caressing his lovely skin[if lust of Xerxes >= 7] and running your fingers along his collar tattoo[end if] as you lean overtop of him. This draws added moans and yips of pleasure from him and he pushes himself back into your thrusts, his ass squeezing along your shaft as you fuck him like a dog. You play with his nipples while fucking him, whispering in his ear what a good boy he is.";
			say "     [WaitLineBreak]";
			say "     Getting shafted while being in Amy himself soon drives Xerxes over the edge, and as you do another deep thrust into his tight ass he gives a deep grunt and climaxes, squirting blast after blast of his human seed directly into the young husky's womb. With the flexing of his anal muscles around your shaft with each of his spurts, you're close behind him, moaning loudly as you cream his asshole with your sperm. With your cock twitching inside, painting his insides white, you pull Xerxes upper body against your chest and give him a deep kiss. Then, after your last shot, you pull your little trio down to lie on Amy's mattress, where you enjoy each other's warmth and closeness for a while as you come down from your respective orgasms[if lust of Xerxes >= 4]. 'Mmm... Amy nice. Master fuck Xerxes good,' he mumbles softly, snuggling up to you lovingly[end if][if lust of Xerxes >= 7] as you kiss along the tattooed collar ringing his neck[end if].";
	if Lust of Amy is 0:  [not pregnant yet]
		let AmyPregchance be a random number from 1 to 20;
		if AmyPregchance > 13:
			now Lust of Amy is 24;  [someone has knocked her up - either the player or Xerxes]
	now lastfuck of Amy is turns;
	now lastfuck of Xerxes is turns;

to say AmySex7:    [Felinoid+Amy+Player Threesome]
	say "     Accompanied by your felinoid companion, you walk over to the mattress you put up here in the library for Amy. The large cat sniffs the female husky's bedding with interest, then turns his head to you and gives a questioning rumble from his throat. Running both hands through his warm fur and scratching him affectionately behind the ears, you answer 'Yeah, lets have some fun with her.'";
	say "     Soon after, Amy comes into sight from among the long bookshelves in the library, walking towards you slowly, the stack of books in her hands so high that she can't actually see what is in front of her. As she comes closer, you walk up to her and take more than half of the books from her. She says 'Thank you, that's very nice of you.' - then she notices the look of lust in your eyes and the felinoid's presence. 'Oh', she says in an amused tone and sets down her books on the ground, then continues with 'Were you boys waiting for me? I wonder why...' in a playfully innocent tone. A moment later, she betrays that she's no blushing virgin as she moves up close to you, her hand feeling up the tent in your pants. With a lustful wink, she then saunters over to her bedding, swishing her tail while demonstratively shaking her hips.";
	say "     [WaitLineBreak]";
	say "     Quickly adding the books in your hands to the pile on the floor, you follow her over to the mattress, pulling off your clothes and dropping them as you go along. Soon you're sitting beside her, as naked as she herself always is, with the felinoid standing right beside you. The large cat circles you both, giving a pleasantly rumbling purr and rubbing the side of his furred body against yours, his long tail lazily flicking through the air in front of your faces. The effects of his touch and heady musk take effect almost immediately, with both Amy's and your breathing becoming quicker as you start panting in rising lust. Her pussy gets moist and ready for sex, a fact easily visible as she spreads her nether lips with her fingers and starts rubbing them.";
	say "     Suddenly stopping behind Amy, the felinoid puts his head over her shoulder, rubbing the side of his furry face against hers. Then he lifts a paw, softly pushing against her back while giving suggestive rumbles from his throat. Taking the hint, the young husky gets up from the mattress to move around on it and gets into a position on all fours, her legs spread a bit and tail raised high, presenting her ready and dripping pussy.";
	say "     [WaitLineBreak]";
	say "     After circling around you once more, the felinoid moves to Amy's backside, licking her crotch with his rough tongue a few times. Then he continues further up, licking over the arched back of the husky girl and continuing to her neck. Standing over the smaller shape of Amy, his belly-fur touching her back, the felinoid now is in the perfect position to fuck her. Lowering his hind legs a bit, the feline rubs his spined cock up and down the anthro husky's crotch until he soon finds Amy's swollen pussy lips and plunges in. With a satisfied roar, he sinks all of his manhood inside, then starts fucking with powerful and deep thrusts. Moans, barks and growls of lust fill the library.";
	say "     [line break]";
	say "     What would you like to do now?  Do you let Amy blow you and feed her your load (Y), or do you want to fuck and come in the felinoid's ass (N)? ";
	if player consents:     [sucked by Amy]
		say "     [line break]";
		say "     Your own libido awakened by the images of the large cat on top of the human-like Amy, as well as the felinoid's touch and musk, you quickly decide that it's time to join in. Putting a hand on your raging [cock of player] hardon, you stroke it a few times before moving into position and holding it out for Amy. The young husky takes it in her muzzle, carefully keeping her teeth away as she starts bobbing up and down. She really is a natural at giving blowjobs, holding her lips tight around your shaft and teasing it with her tongue. While you're getting an amazing blowjob, the felinoid fucks Amy with a relentless wild energy, his hard thrusts hitting very sensitive spots again and again, making her pant and yip in pleasure.";
		say "     Even though he is a quite virile male, everyone's stamina has its limits. When Amy suddenly gives a pleased yip and orgasms, her female juices dripping down to soak into her bedding, that gives large cat the last nudge too. A deep rumble of satisfaction vibrates in the felinoid's throat as he pushes his member as deep as it will go and fills Amy's womb with his seed.";
		say "     [WaitLineBreak]";
		say "     After a moment of riding out her own orgasm, Amy continues the blowjob she was giving you and before too much longer, the husky girl's enthusiastic sucking drives your lust through the roof. As she goes down on your cock again, you hold her head against your crotch, shooting long blasts of cum into her mouth. When she pulls off your cock after you're done, Amy shows you the large load on her tongue, then swallows it demonstratively. Jokingly, you call her a 'Good dog', tousling their hair, then pull Amy's head to yours and give her a deep kiss. Lying down on the mattress with your two friends after that, you enjoy each other's warmth and closeness for a while, accompanied by the felinoid's rumbling purr.";
	otherwise:              [fucking the Felinoid]
		say "     [line break]";
		say "     Your own libido awakened by the images of the large cat on top of the human-like Amy, as well as the felinoid's touch and musk, you quickly decide that it's time to join in. Putting a hand on your raging [cock of player] hardon, you grab the bottle of lube you've got lying around not too far way. After spreading some of the slick substance on your shaft, you step up behind the large shape of the rutting felinoid. Running your hands up through the soft fur on his lower back, you grab the feline's hips tightly then slam forward, burying your cock to the hilt in his warm, tight cave. Roaring at the sudden anal intrusion, the felinoid stops thrusting into Amy for a moment, looking back over his shoulder with partly bared teeth. That doesn't last long, though - moving in and out of his hole, your shaft stimulates his sensitive prostrate, and soon your big cat is purring in satisfaction and fucking Amy again.";
		say "     Even though you'd wish your threesome could last forever, everyone's stamina has its limits. When Amy suddenly gives a pleased yip and orgasms, her female juices dripping down to soak into her bedding, that gives large cat the last nudge too. A deep rumble of satisfaction vibrates in the felinoid's throat as he pushes his member as deep as it will go and fills Amy's womb with his seed. The big cat's insides in turn grip your penis tightly with each shot of cum shooting through his shaft, making you follow them to an amazing orgasm. You gasp as you grind your hips against the felinoid's furry behind and blast after blast of your sperm shoot into his tight chute.";
		say "     [WaitLineBreak]";
		say "     After a moment of just holding on to the large feline and catching your breath, you pull out and watch the felinoid's pink pucker snap shut before any of your seed can leak out. Satisfied but exhausted after this session, you sink down on Amy's mattress. The big cat and husky girl separate from each other too, then lie down next to you, with Amy cuddling up to the felinoid's soft and warm belly fur. Purring as loud as a idling motor, the big cat starts licking her fur. Looks as if he wants to spread his scent over all of the husky's body.";
	if Fang is in the Grey Abbey Library:
		say "     [line break]";
		if hp of Fang is 1 or hp of Fang is 2:  [Beta Fang]
			if XP of Amy is 0:
				say "     As you rest your head on a pillow for a post-coital nap, you dimly register Fang standing some distance away and giving the felinoid and Amy a hostile stare. Looks like he's not happy that the big cat is getting pussy he hasn't had. Not happy at all. Noting the wolf's interest, the big feline snarls and Fang slinks back to his post for the moment. Oh well, the felinoid seems to be able to intimidate your wolf guard, so there probably won't be any issue, you tell yourself as you doze off...";
			if XP of Amy is 1:
				say "     As you rest your head on a pillow for a post-coital nap, you dimly register Fang standing some distance away and giving the felinoid and Amy a hostile stare. Seeing the other fuck someone he had counted as his to mount and breed doesn't make him happy. Not happy at all. The feline clutches Amy closer and growls deeply at Fang, sending the wolf slinking back to his post for the moment. Oh well, the felinoid seems to be able to intimidate your wolf guard, so there probably won't be any issue, you tell yourself as you doze off...";
			if XP of Amy is 99:
				say "     As you rest your head on a pillow for a post-coital nap, you dimly register Fang standing some distance away and giving the felinoid and Amy a hostile stare. Seeing the other fuck someone he's been forbidden to mount doesn't make him happy. Not happy at all. The feline clutches Amy closer and growls deeply at Fang, sending the wolf slinking back to his post for the moment. Oh well, the felinoid seems to be able to intimidate your wolf guard, so there probably won't be any issue, you tell yourself as you doze off...";
		otherwise:            [Alpha Fang]
			if XP of Amy is 0:
				say "     As you rest your head on a pillow for a post-coital nap, you dimly register Fang standing some distance away and giving the felinoid and Amy a hostile stare. Looks like he's not happy that the big cat is getting pussy he hasn't had. Not happy at all. Oh well, the rivalry between them will likely work itself out sometime in the end, you tell yourself as you doze off...";
			if XP of Amy is 1:
				say "     As you rest your head on a pillow for a post-coital nap, you dimly register Fang standing some distance away and giving the felinoid and Amy a hostile stare. Seeing the other fuck someone he had counted as his to mount and breed doesn't make him happy. Not happy at all. Oh well, the rivalry between them will likely work itself out sometime in the end, you tell yourself as you doze off...";
	if Lust of Amy is 0:  [not pregnant yet]
		let AmyPregchance be a random number from 1 to 20;
		if AmyPregchance > 13:
			now Lust of Amy is 24;  [someone has knocked her up - either the player or the Felinoid]
	now lastfuck of Amy is turns;
	now lastfuck of Felinoid Companion is turns;
	
to say AmySex8:    [Fang+Amy+Player Threesome]
	if (hp of Fang is 1 or hp of Fang is 2):    [Beta Fang] 
		say "     Walking over to where Fang's leash is currently tied in the library, you kneel down beside your faithful guardian and stroke him between his ears and over his furred flank. Wagging his tail, he licks your hand, happy at getting attention from his Alpha. 'That's a good wolf. Come on, let's have some fun with Amy' you say and loosen Fang's leash from around his neck. Accompanied by your black wolf, you walk over to the mattress you put up here in the library for the husky girl.";
		say "     Soon after, Amy comes into sight from among the long bookshelves in the library, walking towards you slowly, the stack of books in her hands so high that she can't actually see what is in front of her. As she comes closer, you walk up to her and take more than half of the books from her. She says 'Thank you, that's very nice of you.' - then she notices the look of lust in your eyes and Fang's presence. 'Oh', she says in an amused tone and sets down her books on the ground, then continues with 'Were you boys waiting for me? I wonder why...' in a playfully innocent tone. A moment later, she betrays that she's no blushing virgin as she moves up close to you, her hand feeling up the tent in your pants. With a lustful wink, she then saunters over to her bedding, swishing her tail while demonstratively shaking her hips.";
		say "     [WaitLineBreak]";
		say "     Quickly adding the books in your hands to the pile on the floor, you follow her over to the mattress, pulling off your clothes and dropping them as you go along. Soon you're sitting beside her, as naked as she herself always is, with the Fang standing right beside you. Smiling at Amy, you lean back, holding up your hard cock for her and she quickly gets into a kneeling position, leaning forward to blow you. As she does so, Fang moves up behind her and sniffs Amy's pussy, then looks up to you pleadingly. Seeing his canine cock dangling erect beneath his body, it's pretty obvious what he wants to do, and as you slide your shaft once again into Amy's throat you smile and nod to Fang to continue. Without delay, the wolf jumps up and mounts Amy's body, front legs around her chest and hips thrusting forward. His hard manhood hits its target at once and plunges deep into Amy's pussy. Driven by his feral lust, Fang ruts the young woman mercilessly, growling and panting as he thrusts in and out.";
		say "     Getting blown as you watch Fang mounting your anthro husky housemate, the need to cum quickly rises inside you and you have to grab hold of Amy's head to stop from losing it right then and there. Cock resting for a moment in her throat, you take a deep breath, then slowly pull out and scooch back.  Now having her mouth free, Amy gives lustful pants and yips as Fang drives his shaft into her. Watching the black wolf mate her, you walk around them slowly taking in the full glory of the powerful wolf on top of his more human-like partner.";
		say "     [line break]";
		say "     What do you want to do now? Get blown by Amy and feed her your load (Y), or fuck and come in Fang's ass (N)? ";
		if player consents:     [sucking]
			say "     [line break]";
			say "     Walking back around to the front of the rutting couple, you grab your erect member and stroke it demonstratively as you hold it out. Amy immediately goes for it, taking your hard length into her mouth again and starts bobbing up and down on it. She really is a natural at giving blowjobs, holding her lips tight around your shaft and teasing it with her tongue. Running your hands through Amy's hair, you speed up face-fucking the husky girl as you're getting close to an orgasm. Soon you can feel your load boiling up from your balls and with one last thrust you bury yourself all the way in her throat and shoot spurt after spurt of cum directly into her stomach.";
			say "     Breathing heavily, you stand still as Amy softly sucks you until you stop coming, then pulls off and licks your balls. Satisfied and just a bit exhausted, you move over to sit down at the end of the mattress and watch the rest of your pet's coupling with Amy.";
			say "     [WaitLineBreak]";
			say "     After some more hot and heavy fucking, Fang does one especially deep thrust that pops his knot inside Amy, then holds still as it expands. Getting tied to Fang was the last straw for the aroused husky, and her body shudders as the feelings from her pussy make her gush femcum to drip down and soak into her bedding. Deep inside her, Fang's cock pulses with burst after burst of wolf cum, filling Amy's womb with his fertile seed.";
			say "     That should satisfy even as horny a husky as Amy for a while. With both of them standing where they fucked, breathing heavily and patiently waiting for Fang's knot to go down and allow them to separate, you lay back on the mattress and get comfortable.";
		otherwise:              [fucking Fang]
			say "     [line break]";
			say "     Your eyes searching out your goal - the tight hole under Fang's tail - you stroke your hard cock and step closer to Fang's rear end. Running your hands through the fur on his lower back, you grab hold of the wolf's hips and sink your [cock of player] shaft into him with one deep thrust. After giving a loud yelp at the sudden anal invasion, Fang stops for a second and looks back. Seeing it's you, he accepts being fucked as his due to the Alpha, even tightening his anal muscles around you as you move inside him. Then the hot threesome continues, all of you moving together to give each other as much pleasure as you can.";
			say "     [WaitLineBreak]";
			say "     After some more hot and heavy fucking, Fang does one especially deep thrust that pops his knot inside Amy, then holds still as it expands. Getting tied to Fang was the last straw for the aroused husky, and her body shudders as the feelings from her pussy make her gush femcum to drip down and soak into her bedding. Deep inside her, Fang's cock pulses with burst after burst of wolf cum, filling Amy's womb with his fertile seed. That only leaves you, with Fang's anal muscles twitching and gripping your manhood tightly as you thrust in one last time. Filling the wolf's back passage with a huge load of your seed, you once again prove your dominance as Alpha over him.";
			say "     Resting on Fang's furry back for a moment, you then pull your cock out of his cum-filled hole and sink down on Amy's mattress. Satisfied but exhausted after this session, you lie on it lengthwise and get comfortable. Both Amy and Fang still stand where they fucked, breathing heavily and patiently waiting for Fang's knot to go down and allow them to separate.";
		if felinoid companion is tamed:     [rivalry message - Beta Fang vs Felinoid]
			say "     [line break]";
			if level of Amy is 0:  [felinoid didn't fuck her yet]
				say "     As you rest your head on a pillow for a post-coital nap, you dimly register your felinoid companion standing some distance away among the bookshelves and giving the Fang and Amy a calculating look. You see him pad closer and give a deep, rumbling growl. Fang growls in response, but slinks back to his post by the door as soon as his knot goes down, driven off by the dominant feline creature. The felinoid then pads to lie down on the floor between you and the door, grooming himself with the occasional glance of interest at the dog-person and glare at the wolf. In your sleepy haze, you almost think the feline's looking at you possessively as well, but that must be your imagination you tell yourself as you doze off...";
			otherwise if level of Amy is 1:  [felinoid did fuck her]
				say "     As you rest your head on a pillow for a post-coital nap, you dimly register your felinoid companion standing some distance away among the bookshelves and giving the Fang and Amy a calculating look. You see him pad closer and give a deep, rumbling growl. Fang growls in response, but slinks back to his post by the door as soon as his knot goes down, driven off by the dominant feline creature. The felinoid then pads to lie down on the floor between you and the door, grooming himself with the occasional possessive glance at the dog-person and glare at the wolf for touching what the Felinoid has claimed as his own. In your sleepy haze, you almost think the feline's looking at you possessively as well, but that must be your imagination you tell yourself as you doze off...";
			otherwise if level of Amy is 99:  [felinoid forbidden to fuck her]
				say "     As you rest your head on a pillow for a post-coital nap, you dimly register your felinoid companion standing some distance away among the bookshelves and giving the Fang and Amy a calculating look. You see him pad closer and give a low, frustrated growl. Fang growls in response, holding his own, seemingly aware that you stopped the felinoid from fucking Amy before, but allowed him to fuck and breed her. When his knot goes down enough so he can pull out, Fang and Amy lie down on the mattress to cuddle against you. The felinoid then pads to lie down on the floor between you and the door, grooming himself with the occasional glance at the three of you. In your sleepy haze, you almost think the feline's just biding his time before taking Amy and you as well, but that must be your imagination you tell yourself as you doze off...";
	otherwise if (hp of Fang is 3 or hp of Fang is 4):    [Alpha Fang]  
		say "     Walking over to Fang, you crouch next to the big wolf and stroke him, rubbing his warm belly fur and his quickly hardening erection.  With your Alpha hot and ready to go, you and he walk over to the mattress you put up here in the library for the husky girl.";
		say "     Soon after, Amy comes into sight from among the long bookshelves in the library, walking towards you slowly, the stack of books in her hands so high that she can't actually see what is in front of her. As she comes closer, you walk up to her and take more than half of the books from her. She says 'Thank you, that's very nice of you.' - then she notices the look of lust in your eyes and Fang's presence. 'Oh', she says in an amused tone and sets down her books on the ground, then continues with 'Were you boys waiting for me? I wonder why...' in a playfully innocent tone. A moment later, she betrays that she's no blushing virgin as she moves up close to you, her hand feeling up the tent in your pants. With a lustful wink, she then saunters over to her bedding, swishing her tail while demonstratively shaking her hips.";
		say "     [WaitLineBreak]";
		say "     Amy gets on all fours to sniff and be sniffed by Fang, softly panting in rising arousal. Already knowing what's expected of her, she then turns her backside to the wolf, taking a secure stance and spreads her legs a bit further. With a satisfied growl Fang moves up behind her and sniffs Amy crotch, then jumps up and mounts her more human-like body, front legs around her chest and hips thrusting forward. His hard manhood hits its target at once and plunges deep into the husky's ready pussy. Driven by his feral lust, Fang ruts the young woman mercilessly, growling and panting as he thrusts in and out.";
		say "     [WaitLineBreak]";
		say "     Seeing your Alpha penetrate Amy makes you quite hard as well and you quickly strip off your clothes. Pulling out your [cock of player] manhood, you pump your hand up and down its length a few times, then step up to the front of the mating couple and present your erection. Amy eagerly licks your balls and cock a bit before taking it into her mouth. ";
		say "     Getting blown as you watch Fang mounting your anthro husky housemate, the need to cum quickly rises inside you and you have to grab hold of Amy's head to stop from losing it right then and there. Cock resting for a moment in her throat, you take a deep breath, then slowly pull out and scooch back.  Now having her mouth free, Amy gives lustful pants and yips as Fang drives his shaft into her. Watching the black wolf mate her, you walk around them slowly taking in the full glory of the powerful wolf on top of his more human-like partner.";
		say "     [line break]";
		say "     What do you want to do now?  Get blown by Amy and feed her your cum (Y), or wait your turn at filling her pussy (N)? ";
		if player consents:     [sucking]
			say "     [line break]";
			say "     Walking back around to the front of the rutting couple, you grab your erect member and stroke it demonstratively as you hold it out. Amy immediately goes for it, taking your hard length into her mouth again and starts bobbing up and down on it. She really is a natural at giving blowjobs, holding her lips tight around your shaft and teasing it with her tongue. Running your hands through Amy's hair, you speed up face-fucking the husky girl as you're getting close to an orgasm. Soon you can feel your load boiling up from your balls and with one last thrust you bury yourself all the way in her throat and shoot spurt after spurt of cum directly into her stomach.";
			say "     Breathing heavily, you stand still as Amy softly sucks you until you stop coming, then pulls off and licks your balls. Satisfied and just a bit exhausted, you move over to sit down at the end of the mattress and watch the rest of your Alpha's coupling with Amy.";
			say "     [WaitLineBreak]";
			say "     After some more hot and heavy fucking, Fang does one especially deep thrust that pops his knot inside Amy, then holds still as it expands. Getting tied to Fang was the last straw for the aroused husky, and her body shudders as the feelings from her pussy make her gush femcum to drip down and soak into her bedding. Deep inside her, Fang's cock pulses with burst after burst of wolf cum, filling Amy's womb with his fertile seed.";
			say "     That should satisfy even as horny a husky as Amy for a while. With both of them standing where they fucked, breathing heavily and patiently waiting for Fang's knot to go down and allow them to separate, you lay back on the mattress and get comfortable.";
		otherwise:              [fucking Amy]
			say "     [line break]";
			say "     Deciding that you'll wait your turn, you move to sit on the other end of Amy's mattress, watching your Alpha rut the husky girl and jerk off a bit. After some more hot and heavy fucking, Fang does one especially deep thrust that pops his knot inside Amy, then holds still as it expands. Getting tied to Fang was the last straw for the aroused husky, and her body shudders as the feelings from her pussy make her gush femcum to drip down and soak into her bedding. Deep inside her, Fang's cock pulses with burst after burst of wolf cum, filling Amy's womb with his fertile seed.";
			say "     [WaitLineBreak]";
			say "     You move over to crouch beside them, fondling and stroking both their bodies as you wait for Fang's knot to go down. Some time later, the wolf pulls out of Amy's hole and sits down on the floor nearby, curling up to lick himself clean. With Amy's pussy still gaping a bit and dripping femcum and your Alpha's seed, you quickly get on top of her and ram your erection home. Even stretched by Fang's shaft, she's still nicely tight and feeling your strong Alpha wolf's cum filling her hole and squishing around your thrusting member is a definite plus. It doesn't take all that long until you feel a familiar tingling in your balls, and with one last thrust, you bottom out inside Amy and come, adding your seed to Fang's load.";
			say "     Phew.  Satisfied and just a bit exhausted, you keep your slowly softening shaft in Amy's pussy, just lowering the two of you down to lie on her bedding together.";
		if felinoid companion is tamed:     [rivalry message - Alpha Fang vs Felinoid]
			say "     [line break]";
			if level of Amy is 0:  [Felinoid hasn't fucked Amy yet]
				say "     As you rest your head on a pillow for a post-coital nap, you dimly register your felinoid companion standing some distance away among the bookshelves and giving Fang and Amy a calculating look. Seems almost like he's up to something - taking Amy away from Fang and mounting her himself most likely. Oh well, the rivalry between them will hopefully work itself out sometime in the end, you tell yourself as you doze off...";
			otherwise if level of Amy is 1:  [Felinoid has fucked Amy]
				say "     As you rest your head on a pillow for a post-coital nap, you dimly register your felinoid companion standing some distance away among the bookshelves and giving Fang and Amy a calculating look. Seems almost like he's up to something - filling Amy again to make her his alone possibly.  Oh well, the rivalry between them will hopefully work itself out sometime in the end, you tell yourself as you doze off...";
			otherwise if level of Amy is 99:  [Felinoid forbidden to fuck her]
				say "     As you rest your head on a pillow for a post-coital nap, you dimly register your felinoid companion standing some distance away among the bookshelves and giving the Fang and Amy a calculating look. You see him pad closer and give a low, frustrated growl. Fang growls in response, holding his own. The felinoid then pads to lie down on the floor between you and the door, grooming himself with the occasional glance at the three of you. In your sleepy haze, you almost think the feline's just biding his time before taking Amy and you as well, but that must be your imagination you tell yourself as you doze off...";
	if Lust of Amy is 0:  [not pregnant yet]
		let AmyPregchance be a random number from 1 to 20;
		if AmyPregchance > 13:
			now Lust of Amy is 24;  [someone has knocked her up - either the player or Fang]
	now lastfuck of Amy is turns;
	now lastfuck of Fang is turns;

Red Light Requisition is a situation.
The sarea of Red Light Requisition is "Red";
when play begins:  [these exceptions are based on the second half so people aren't left standing]
	add Red Light Requisition to badspots of guy;
	add Red Light Requisition to badspots of furry;

Instead of resolving a Red Light Requisition:
	say "     Moving through a seedier area of the city, you come around a corner and spot two soldiers a bit down the road, lugging around a large sack. When they spot you, their faces flush red with embarrassment and they run off, dashing away from you. You run after them, but then slip on something that must have dropped out of the sack as they jostled it while running. It's... a dark blue rubber dildo?";
	if Camp Bravo is known:
		say "     Looks like these guys were gathering supplies for the things going on in Camp Bravo. Well, where else would they get those piles of sex toys from...";
	otherwise if Trickster's Masterpiece is resolved:
		say "     Looks like these guys were gathering supplies for the crazy plan of theirs with the minotaur. Well, where else would they get those piles of sex toys from...";
	otherwise:
		say "     What's going on here? Why are soldiers looting the red light district and gathering up whole sacks of dildos and who knows what? Maybe you'll find out one of these days...";
	increase score by 5;
	Now Red Light Requisition is resolved;


Trickster's Masterpiece is a situation.
The sarea of Trickster's Masterpiece is "Outside";
when play begins:
	add Trickster's Masterpiece to badspots of guy;       [male soldiers]
	add Trickster's Masterpiece to badspots of furry;     [minotaur involved]

Instead of resolving a Trickster's Masterpiece:
	say "     Following lust-filled grunts and bellows, you come upon a mid-sized military encampment on the parking space behind an office building. There you find a strange scene - in the middle of several olive green tents, there is a wooden hitching post - which a buck-naked soldier uses to hold on to. Behind the man is a very tall musclebound humanoid, sporting a horned bull's head and furred legs ending in cloven hooves - a minotaur. He's in a full on mating frenzy, shafting the human in front of him with mighty thrusts of his long cock. A bit to the side, a group of soldiers stands in front of an officer, many of them apprehensively looking over to the rutting minotaur before they turn back to their superior.";
	say "     Curious what's going on there you sneak forward, staying out of sight behind one of the tents and just peeking around the corner. From your new location, you can hear the briefing the officer shouts at his men to be audible over the grunts and moans of the coupling man and beast.";
	say "     '...so our local informant identified this creature to us as Patient Zero. Analyzing its bodily fluids could lead to a cure - but [if Diegochanged is 0]he [otherwise]she [end if]also warned us that samples must be kept at body temperature or they won't be usable after a short while. So since we can't guarantee to capture that -' he waves towards the minotaur, hulking over the soldier in front of it, '- alive, we had to move on to a different plan to get those samples to the scientists. Team up in twos, then grab your new equipment from corpsman Jones and follow his instructions. Dismissed.'";
	say "     [WaitLineBreak]";
	say "     The soldiers form up teams, then move towards the tent you're hiding behind. You peek in through a window flap and see a corpsman standing in front of several large sacks. When the first two soldiers come in, he says 'Here, take this -' (a bottle of lube) '- that -' (a black rubber dildo) '- and these -' (two butt-plugs) '- and get each other ready for Tiny Tim out there. Don't be embarrassed about it - you'll be heroes if they find a cure through your service. Also - really, really take your daily immunity boosters! You'll be carrying around potent stuff, so don't miss ANY injection.'";
	say "     You spy in on them as group after group get their stuff, then strip and start to finger each other's asses rather sheepishly. Luckily several of the brave soldiers turn out to be gay, stepping in to help their inexperienced fellows out with some tips and hands-on support. Some even get to 'train' the newbies with their own hard shafts, the men preferring another soldier to often brightly colored sex toys.";
	say "     Hearing the noise from the center of the camp rise, you reluctantly pull your gaze away from a whole tent full of naked men, most experimenting with dildos and some fucking each other with a passion. Looking around the corner of the tent, you see the minotaur thrust in a few more times, then grab the soldier's hips and hold him tightly as he grinds his hips forward and bellows loudly. You can see the creature's large balls pulsate as it deposits its seed inside the man's hole. Then another naked man comes forward and pushes a rubber butt plug into the fucked soldier's gaping hole as he pulls off the thick shaft. He leads the freshly filled and plugged man to a nearby bunk to recuperate, then steps up to the hitching post himself and wiggles his ass at the minotaur. Tireless, the massive creature pushes his hard cock against the man's pucker making them both grunt as he sinks into its tight embrace and starts another round of fucking.";
	say "     [WaitLineBreak]";
	say "     You stay quite a while, watching the soldiers take care of each other and then being bred one after another by the minotaur. In the end a whole squad of them gathers at the edge of the camp, fully clothed and with weapons and equipment, but standing and acting a bit strangely from the feeling of loads of cum and butt plugs inside their asses. Then they move out towards the closest checkpoint of the containment barrier around the city. You wonder what their superiors will say about this plan and the 'cargo' each soldier carries with him, should they even make it at all with all that active minotaur cum wearing down whatever defenses they do have[if diegotalk is 0]. And who might the trickster have been who sold them on this improbable tall tale? It would certainly be interesting to meet him - or her - or it[otherwise if diegochanged is 0]. Certainly an awesome trick, to sell them all on this highly improbable story and plan. Recognizing his hand in this, you'd say it's one of the best Diego's done yet.[otherwise]. Certainly an awesome trick, to sell them all on this highly improbable story and plan. Recognizing her hand in this, you'd say it's one of the best Diego's done yet.[end if]";
	say "     [line break]";
	say "     Certainly worth another visit... you just hope you can find your way back to the [bold type]camp[roman type] with all the chaos on the streets of this city.";
	wait for any key;
	increase libido of player by 15;
	if libido of player > 100, now libido of player is 100;
	increase score by 15;
	extend game by 24;
	now hp of Adam is 2;
	Now Back at the Camp is unresolved;
	Now Trickster's Masterpiece is resolved;


Human Urges is a situation.
The sarea of Human Urges is "Red";
when play begins:
	add Human Urges to badspots of guy;      [male soldier]
	add Human Urges to badspots of girl;     [female soldier]

Instead of resolving a Human Urges:
	say " As you wander through one of the residential areas next to this seedy section of town, you hear moaning coming from an open window of a nearby house. Curious what kind of creatures are in there, you slowly walk closer, careful not to make a sound. When you arrive at the window and peek inside, you see that it's... humans.";
	say " Their city-camouflage clothing strewn about on the floor and rifles leaned against the opposite wall, you see two soldiers in intimate embrace on a bed. It's a man and a woman, with his hips pumping up and down as he fucks her with fast strokes and her arms holding him close to her body. One doesn't have to be infected with nanites to feel the basic urges of human existence - and with what's going on around all of you and the sexual sights around here especially, those two turned to each other to let off some steam.";
	say " You silently watch them go at it, sliding your hand down to your own crotch to stroke yourself. Both of the soldiers look pretty good, sweat glistening on their trained bodies as they move in unison. Soon, the woman's moans rise as she gets closer and closer, then turn into full-fledged lustful screams as she orgasms. Her partner isn't far behind, plunging his shaft deep into her pussy and grunting with each shot of semen he cums into her.";
	say " They lie on the bed in each other's arms for a moment, then the man pulls his cum-dripping cock out of her and stands up, going for a pack of cigarettes lying on a dresser nearby. The woman just lies there, softly stroking her wet pussy lips as she rides out the last bit of her orgasm. Unseen, but deep inside her, her partner's sperm race onwards, doing their duty in the battle to keep humanity going. The fastest of them soon finds a fertile egg, burrowing into it and starts a new life. Only time will tell if its parents succeed in their mission to protect humanity or if it and they will become something different in the end.";
	increase score by 5;
	now Human Urges is resolved;


Captured Demon is a situation.
The sarea of Captured Demon is "Red";
when play begins:
	add Captured Demon to badspots of guy;            [male soldier, demon brute]
	add Captured Demon to badspots of hellspawn;      [demon brute]

Instead of resolving a Captured Demon:
	say "     Moving through an alley in the seedier part of town, you hear voices from the smashed window of a nearby bar. Careful not to step on anything and make a sound, you slowly walk closer and listen.";
	say "     'The brute smashed our only working radio. Now we got the mission objective locked down, but can't call in the retrieval team. Anderson's dead and that claw-slash on Kowalski's leg doesn't look good.' You peek over the window-still and see a mid-sized bar, its interior devastated by a fight. In the midst of bullet-holed walls and smashed furniture, there is a demon brute slumped down on a chair, bound with leather straps and chains. Near him, there are four soldiers, one of them just being bandaged on the thigh.";
	say "     The apparent leader watches the wounded man being patched up, then says 'It can't be helped. No way a man supporting a wounded comrade can make it through the streets alone. I'll have to go with them. Private Jackson, guard the captive until the retrieval team arrives. If need be, give him more sedatives.' He nods to a young-looking soldier, who salutes and says 'Yes sir!' You don't want to get shot by stressed out soldiers, so you have to hurry down the alley a bit to hide behind a dumpster not to get spotted as they move out.";
	say "     [WaitLineBreak]";
	say "     After waiting some minutes so be sure they're gone, you go back to the window and look in. Now there's only that one soldier in there, looking from the demon to the entrance door and back again. He looks rather nice, slender but muscular and with a handsome face. While you're still wondering if you could perhaps go in and talk to him, the demon brute makes a snorting sound, startling the soldier and you as a slight movement runs through his bound body. Private Jackson raises his weapon and steps closer, poking the demon in the chest to check if he's still unconscious.";
	say "     ...which is exactly what the brute has been waiting for. With a metallic screech the chains holding him rip apart as he flexes his muscles, then grips the barrel of the rifle and bends it to a right angle. His other hand quickly grabs the young soldier around the throat and stops any attempt to escape.";
	say "     Chuckling in a deep gravelly voice, the demon says 'Did you really think it'd be that easy to capture a soldier of the infernal legion? You'll pay for your insolence!' and rips the soldier's uniform off his body. Carrying the man to the bar, the demon bends him over it and gives his ass a hard slap, leaving a reddening hand-print on the pale flesh of the young soldier's right bun. 'If you try running, I'll disembowel you. But feel free to struggle and scream - I like it.' the demon says, then grabs his massive erection and strokes it.";
	say "     [WaitLineBreak]";
	say "     Seeing the demon prepare to rape the young soldier, you wonder if you should step in and stop him. The safer option would be to just watch it happen, but can you just leave Private Jackson to his fate? ";
	if player consents:   [just watch]
		say "     The demon smacks his manhood against the human's ass several times, creating slapping noises and making him grunt in pain. Looking down at the reddened cheeks and the deeper red hand-print on them, the demon aims his cock at Private Jackson's virgin pucker and plunges it right in. His victim whimpers in pain as the infernal cock forces his asshole to open and the thick shaft of the demon's cock sinks inside his body. You watch the otherworldly beast fuck the poor man without restraint, slamming in and out and just getting more and more aroused as the soldier begs and struggles weakly to push him off.";
		say "     Then finally, the demon brute slams his whole shaft inside, roaring in satisfaction as the contents of his balls erupt into his human captive. He keeps pumping blast after blast of cum into the young man, pumping slowly in and out of his hole with squishy noises as cum starts to squirt out around his shaft from the overfilled ass. Pulling Private Jackson's head up by the hair, the demon licks his cheek slowly, then says 'Feel my infernal seed fill your innermost being, little man. You're mine now - now and forever!' With that, he pulls the soldier up against his chest, holding him against his body with his cock still inside the man. Then black-purple smoke starts forming around them both, obscuring them from sight. When it spreads out in the room and slowly blows away, there's nothing to be seen of the demon or his newest slave.";
	otherwise:            [fight]
		say "     Your decision to rush into the bar almost comes too late. The demon already has the tip of his cock poised at the soldier's virgin pucker as you throw the nearest item - a cracked beer glass - at his back to distract him. He turns with an annoyed grunt, growling 'Another mortal who wants to ride my shaft? Bring it on, weakling.'";
		now inasituation is true;
		challenge "Demon Brute";
		now inasituation is false;
		if fightoutcome >= 20 and fightoutcome <= 29:			[lost]
			say "     Having dealt with you, the demon turns back to Private Jackson, who's tried to crawl off in the meantime. He picks the man up by his neck, choking him a bit and runs a clawed hand down his side, leaving shallow but long lines bloody in his pale flesh. 'Don't try to flee again. You're taxing my patience.' With that, he throws his captive back on the bar, bent over and his rear sticking out at the right height.";
			say "     The demon smacks his manhood against the human's ass several times, creating slapping noises and making him grunt in pain. Looking down at the reddened cheeks and the deeper red hand-print on them, he aims his cock at Private Jackson's virgin pucker and plunges it right in. His victim whimpers in pain as the infernal cock forces his asshole to open and the thick shaft of the demon's cock sinks inside his body. You watch the otherworldly beast fuck the poor man without restraint, slamming in and out and just getting more and more aroused as the soldier begs and struggles weakly to push him off.";
			say "     Then finally, the demon brute slams his whole shaft inside, roaring in satisfaction as the contents of his balls erupt into his human captive. He keeps pumping blast after blast of cum into the young man, pumping slowly in and out of his hole with squishy noises as cum starts to squirt out around his shaft from the overfilled ass. Pulling Private Jackson's head up by the hair, the demon licks his cheek slowly, then says 'Feel my infernal seed fill your innermost being, little man. You're mine now - now and forever!' With that, he pulls the soldier up against his chest, holding him against his body with his cock still inside the man. Then black-purple smoke starts forming around them both, obscuring them from sight. When it spreads out in the room and slowly blows away, there's nothing to be seen of the demon or his newest slave.";
		otherwise if fightoutcome >= 30:			[fled]
			say "     Recognizing a lost fight, you just take your legs under your arms and run as fast as you can. You can only guess what happened to the young soldier you left behind with the demon brute. Nothing good, you're sure...";
		otherwise if fightoutcome >= 10 and fightoutcome <= 19:  [won]
			say "     After the demon vanishes, you take care of Private Jackson, who's still rather groggy from being choked and manhandled like that. He dresses as good as he can with the remains of his uniform and ends up looking more like a male stripper than a soldier, with all the naked skin he's showing. Looks rather hot, but since his thoughts are anywhere but at sex right now, you wish him the best as he moves out to rejoin his unit.";
			say "     [line break]";
			say "     Something tells you this might not be the last time you'll see this young man. Maybe you should go looking for the handsome [bold type]soldier[roman type] sometime... out in the city, as you doubt he'll be back in the red light district anytime soon.";
			Now Thankful Soldier is unresolved;
			increase score by 5;
	now Captured Demon is resolved;


Thankful Soldier is a situation. Thankful Soldier is resolved.  [meeting the guy from 'Captured Demon' again - if you saved him]
The sarea of Thankful Soldier is "Outside";
when play begins:
	add Thankful Soldier to badspots of guy;            [male soldier]
	
TSEventCounter is a number that varies.  TSEventCounter is normally 0.
LastTSEvent is a number that varies.  LastTSEvent is normally 555.

Instead of resolving a Thankful Soldier:
	if (LastTSEvent - turns < 4):
		say "     You walk through the alley where you last met David and check the surrounding area - no luck. Seems like your soldier-friend is patrolling or scouting somewhere else right now. Maybe you should try a bit later again...";
	otherwise:
		if TSEventCounter is 0: [first meeting]
			say "     Moving through the city, you run into a lone soldier patrolling an alley near a small military encampment. It's Private Jackson, the young soldier you saved from that demon brute in the red light district. He's got a slender but still muscular build and a nice-looking face with a boyish charm.";
			say "     At first raising his weapon in alarm, he then lowers it again as he recognizes you in turn. 'Hello there. You saved me from that hellish thing in the bar. Thanks a lot for that - sorry I didn't say anything then, but I was pretty groggy after that beating. I'm David, by the way.' He pulls his backpack off and digs around in it for a moment, then turns to you holding three MREs and a water bottle. 'Please accept these as thanks.'";
			say "     [line break]";
			say "     Do you graciously accept the supplies (Y) ...or would you rather take the handsome Private as your reward? (N) ";
			if player consents:   [accept supplies]
				say "     [line break]";
				say "     You take the items he offers you and stash them in your pack. 'Hope that'll help you a bit. Stay safe - help is coming, it's just a question of time till more troops arrive and the scientists figure out this whole mess.' He nods to you, then continues his patrol route. You memorize where the alley is in the city, hoping you can catch him on patrol again sometime later.";
				say "     Food x3, Water x1 obtained.";
				increase carried of food by 3;
				increase carried of water bottle by 1;
			otherwise:            [fuck the soldier]
				say "     Stepping closer to the good-looking young soldier, you pull him tight against your body and give him a deep kiss before he can react. The initial look of alarm in his eyes quickly fades as you make out with him, exploring his mouth with your tongue as you run a hand through his hair and goose his bubble butt with the other one.";
				say "     As you come back up for air, he stammers 'I - I shouldn't... we're not supposed to...', but he moans as you squeeze his ass and his bulge pressing against your body show that he's quite ready for some action. Not getting any relief except rushed masturbation in the weeks and months since the outbreak started, Private Jackson is like putty in your hands, his horny body telling him to go along with anything you want.";
				if (cocks of player > 0 and cunts of player > 0):
					say "     [line break]";
					say "     Being dual-gendered, which way do you want to enjoy your new soldier friend? (Y = Fuck his Ass, N = Take him in your Pussy) ";
					if player consents:   [fuck his ass]
						say "[DavidPatrolAnal]";
					otherwise:    [let him fuck your pussy]
						say "[DavidPatrolVaginal]";
				otherwise if(cocks of player > 0):
					say "[DavidPatrolAnal]";
				otherwise if(cunts of player > 0):
					say "[DavidPatrolVaginal]";
				otherwise:
					say "[DavidPatrolRubbing]";
				say "     [line break]";
				say "     For now, you leave your handsome soldier boy to gather up his clothes and continue with his patrol. Hopefully you can catch him here again on his next patrol...";
				now thirst of David is 1;
			wait for any key;
			increase score by 5;
			now LastTSEvent is turns;
			increase TSEventCounter by 1;
		otherwise if TSEventCounter > 3:   [all good things come to an end - he's ordered to Camp Bravo]
			say "     Moving through the city, you run into a lone soldier walking down a street. It's Private Jackson, the young soldier you saved from that demon brute in the red light district. He's got a slender but still muscular build and a nice-looking face with a boyish charm. Currently he's pretty loaded with equipment, a large backpack full and all kinds of stuff hanging on straps and his belt.";
			say "     As he recognizes you, he gives you a little wave and walks up to talk. He says [if thirst of David < 2]'Hello and goodbye I guess. I got new order to report to one of the larger beachhead camps in the city for some special duties, so I'm afraid we won't be seeing each other again for now.' You ask him if he knows what he's supposed to do there and he shrugs, saying that he just got ordered to report there.[otherwise] with a bit of a sad expression 'I got ordered to report to one of the larger beachhead camps in the city for some other duties. So I guess that's it for our little meetings in that alley... I'll miss you.' After pulling you in for a goodbye-kiss, he walks away, looking back after a while and waving, then continuing on his way.[end if]";
			now hp of David is 1;
			move David to Parade Ground;
			now Thankful Soldier is resolved;
		otherwise:           [meeting him in the alley to chat or fuck]
			say "     Moving through the city, you run into a lone soldier patrolling an alley near a small military encampment. It's Private Jackson, the young soldier you saved from that demon brute in the red light district. He's got a slender but still muscular build and a nice-looking face with a boyish charm.";
			say "     As he recognizes you in turn, he gives you a little wave and walks up to you after a last vigilant look up and down the alley. He says [if thirst of David is 0]'Hello again. It's nice to see you're okay. Sadly, I can't share any more supplies...'[otherwise if thirst of David is 1]'Hello. It's... nice to see you again,' his face getting a bit red in embarrassment as he remembers what you did with him last time.[otherwise if thirst of David > 1]'Hi there - I've missed you.'[end if]";
			say "     [line break]";
			say "     What now? Do you want to talk to him (Y), or rather have some hot and sexy action (N)?";
			if player consents:   [just talking]
				say "     You chat a bit with David about life before the nanite plague and now and what's going on in the city. Speaking to a regular human about these things calms your mind and strengthens your human self-image a bit. After a while, you say your goodbyes and he goes on walking his patrol. Maybe you'll see him again the next time he comes through here...";
				increase humanity of player by 10;
			otherwise:            [sex]
				if thirst of David is 0:
					say "     Stepping closer to the good-looking young soldier, you pull him tight against your body and give him a deep kiss before he can react. The initial look of alarm in his eyes quickly fades as you make out with him, exploring his mouth with your tongue as you run a hand through his hair and goose his bubble butt with the other one.";
					say "     As you come back up for air, he stammers 'I - I shouldn't... we're not supposed to...', but he moans as you squeeze his ass and his bulge pressing against your body show that he's quite ready for some action. Not getting any relief except rushed masturbation in the weeks and months since the outbreak started, Private Jackson is like putty in your hands, his horny body telling him to go along with anything you want.";
				otherwise:
					say "     Stepping closer to the good-looking young soldier, you pull him tight against your body and give him a deep kiss. [if thirst of David is 1]After a moment of hesitation, he replies in kind and you make out with each other, exploring each other's mouths with your tongues[otherwise if thirst of David > 1]He eagerly complies, hungrily making out with you and exploring your mouth with his tongue[end if]. Meanwhile, you run a hand through his hair and goose his bubble butt with the other one.";
					say "     As you come back up for air, he [if thirst of David is 1]stammers 'I... just can't resist. So ... good.', moaning as you squeeze his ass and feel his bulge pressing against your body. Not getting any relief except rushed masturbation in the weeks and months since the outbreak started, Private Jackson is like putty in your hands, his horny body telling him to go along with anything you want.[otherwise if thirst of David > 1]says 'I'm so horny right now. You're amazing...', moaning as you squeeze his ass and feel his bulge pressing against your body. Private Jackson is like putty in your hands, his horny body telling him to go along with anything you want.[end if]";
				if(cocks of player > 0 and cunts of player > 0):
					say "     [line break]";
					say "     Being dual-gendered, which way do you want to enjoy your soldier friend? (Y = Fuck his Ass, N = Take him in your Pussy) ";
					if player consents:   [fuck his ass]
						say "[DavidPatrolAnal]";
					otherwise:    [let him fuck your pussy]
						say "[DavidPatrolVaginal]";
				otherwise if(cocks of player > 0):
					say "[DavidPatrolAnal]";
				otherwise if(cunts of player > 0):
					say "[DavidPatrolVaginal]";
				otherwise:
					say "[DavidPatrolRubbing]";
				say "     [line break]";
				say "     For now, you leave your handsome soldier boy to gather up his clothes and continue with his patrol. Hopefully you can catch him here again in a little while...";
				wait for any key;
				if thirst of David < 5:
					increase thirst of David by 1;
			now LastTSEvent is turns;
			increase TSEventCounter by 1;


to say DavidPatrolAnal:
	if lust of David is 0: 								[anal virgin]
		say "     As you make out with him some more, you slide your hands under his shirt and feel your way up his hard-muscled chest, then pull the fabric up and over his head. Leaning down a bit you run your tongue over his nipples, playfully sucking on first one, then the other. From David's lustful moans, he's ready for the real thing.";
		say "     Opening up the zipper of his pants and letting them drop down, you free his raging hard-on, standing proudly erect in your direction. Quickly stripping off your own clothes, you give him another quick kiss on the lips, then spin him around, your arms around his chest from behind and walk him over to the nearest wall of a building.";
		say "     [WaitLineBreak]";
		say "     With a moaned 'Stand like this.', you lift his arms up and put them against the wall, then pull his ass towards you a bit. You rub your rock-hard [cock of player] cock up and down between the round buns of his bubble butt, then bring its tip to the tight opening between them. Pushing forward with increasing pressure, David's pucker resists you for a moment, then opens up and allows your cockhead to slide into the tight embrace of his ass. It's virgin territory for sure you're exploring here - and from his lust-filled groans as you slowly slide deeper into him, you're being very well received.";
		say "     As you bottom out inside his ass, you give his cock a few strokes, then move your hands back to his hips. Holding on tightly, you start pulling out almost all the way and hammering your shaft back inside him in quick deep strokes, filling the alley with slapping noises as your hips meet his butt. His tightly gripping hole feels just amazing around your thrusting member, filling you with ecstasy as you very thoroughly take his virginity.";
		say "     Getting shafted like this soon drives your handsome Private over the edge, his cock spraying a huge load of cum all over the stones of the wall he's standing against. David's ass muscles quiver and flex with each shot of seed erupting from his cock, giving you all new sensations as you move in and out of him. Then it's your turn, and with one final deep thrust you push inside David all the way and fill his insides with spurt after spurt of warm seed.";
		say "     [WaitLineBreak]";
		say "     You keep standing like that for a moment, with your arms around his chest from behind and still connected through your dick in his ass. As both of you come down from the rush of sex and David's brain starts working again, he looks over his shoulder at you with a questioning expression. 'I like... this,' he says and you feel his asshole tighten for a second around your member. 'Does that mean I'm gay?' With a worried look he adds 'I got a girlfriend back home, you know.'";
		say "     After giving him a playful slap on his firm buttocks as you pull out, you calm him down a bit by telling that he just might be bisexual and that he should use the opportunity to try out the whole spectrum of possible partners. The girlfriend situation will surely work itself out once he knows what he really wants. Although judging from his load all over the wall, you're pretty certain you left a lasting impression on him, opening him up more man-on-man action...";
		now lust of David is 1;
	otherwise:             								[repeat assfucking]
		say "     As you make out with him some more, you slide your hands under his shirt and feel your way up his hard-muscled chest, then pull the fabric up and over his head. Leaning down a bit you run your tongue over his nipples, playfully sucking on first one, then the other. From David's lustful moans, he's ready for the real thing.";
		say "     Opening up the zipper of his pants and letting them drop down, you free his raging hard-on, standing proudly erect in your direction. Quickly stripping off your own clothes, you give him another quick kiss on the lips, then spin him around, your arms around his chest from behind and walk him over to the nearest wall of a building.";
		say "     [WaitLineBreak]";
		say "     Knowing what's coming, he lifts his arms up and puts them against the wall, bending forward a bit and offering his ass. You rub your rock-hard [cock of player] cock up and down between the round buns of his bubble butt, then bring its tip to the tight opening between them. Pushing forward with increasing pressure, David's pucker resists you for a moment, then opens up and allows your cockhead to slide into the tight embrace of his ass. He's still tight as he was when you took his virginity and giving lust-filled groans as you slowly slide deeper into him.";
		say "     As you bottom out inside his ass, you give his cock a few strokes, then move your hands back to his hips. Holding on tightly, you start pulling out almost all the way and hammering your shaft back inside him in quick deep strokes, filling the alley with slapping noises as your hips meet his butt. His tightly gripping hole feels just amazing around your thrusting member, filling you with ecstasy as you give him a good fucking.";
		say "     Getting shafted like this soon drives your handsome Private over the edge, his cock spraying a huge load of cum all over the stones of the wall he's standing against. David's ass muscles quiver and flex with each shot of seed erupting from his cock, giving you all new sensations as you move in and out of him. Then it's your turn, and with one final deep thrust you push inside David all the way and fill his insides with spurt after spurt of warm seed.";
		say "     [WaitLineBreak]";
		say "     You keep standing like that for a moment, with your arms around his chest from behind and still connected through your dick in his ass. As both of you come down from the rush of sex, he says 'I still can't believe how good you feel inside me,' he says and you feel his asshole tighten for a second around your member. 'I guess I really am bi, like you said.' With a worried look he adds 'What will Ann say about that when I get back home?'";
		say "     After giving him a playful slap on his firm buttocks as you pull out, you calm him down a bit by telling that his girlfriend surely won't learn about you two once he goes back to her when this is all over. What happens in this city stays in the city. Unless of course you can make him fully yours to keep, you think to yourself...";

to say DavidPatrolVaginal:
	setmonster "human";
	choose row monster from the table of random critters;
	say "     As you make out with him some more, you slide your hands under his shirt and feel your way up his hard-muscled chest, then pull the fabric up and over his head. Leaning down a bit you run your tongue over his nipples, playfully sucking on first one, then the other. From David's lustful moans, he's ready for the real thing.";
	say "     Opening up the zipper of his pants and letting them drop down, you free his raging hard-on, standing proudly erect in your direction. Quickly stripping off your own clothes and putting them down as an improvised blanket, you give him another quick kiss on the lips and lie down on it, pulling him with you by the hand so he ends up on top of you.";
	say "     [WaitLineBreak]";
	say "     It only takes a helping hand guiding his rod to your pussy lips for the young man's instincts to kick in and his hips plunge downward, thrusting his hard manhood deep into your vagina. He fucks you with smooth strokes, making you moan with the feelings as his shaft hits just the right spots inside you. You run your hands over his chest, feeling his muscles while your legs wrap around his hips to pull him even deeper with each of his thrusts. Soon he speeds up even more, groaning louder and louder as he gets closer to orgasm.";
	say "     Then he shouts 'I'm coming!' and you feel a shudder run through his body as the first blast of his human cum shoots deep inside your body. You pull him down on top of you, hugging him close and kissing him as his cock twitches again and again, filling you to the brink with his fertile seed.[fimpregchance]";
	say "     You lay there for a while, entwined and kissing, with his slowly softening cock still inside you. As both of you come down from the rush of sex and David's brain starts working again, he pants 'Wow, that was... just wow.' and you feel his manhood twitch inside you once. Then a worried look comes over his face and he adds 'But... oh no, I just cheated on my girlfriend. What will she say when I get back home. I - you...'";
	say "     Pulling his mouth to yours for a quick kiss, you tell him to calm down and that his girlfriend surely won't learn about you two once he goes back to her when this is all over. What happens in this city stays in the city. Unless of course you can make him fully yours to keep, you think to yourself...";

to say DavidPatrolRubbing:
	say "     As you make out with him some more, you slide your hands under his shirt and feel your way up his hard-muscled chest, then pull the fabric up and over his head. Leaning down a bit you run your tongue over his nipples, playfully sucking on first one, then the other. From David's lustful moans, he's ready for the something more.";
	say "     Opening up the zipper of his pants and letting them drop down, you free his raging hard-on, standing proudly erect in your direction. Quickly stripping off your own clothes, you give him another quick kiss on the lips, then start rubbing your naked body against his. Grasping his hard manhood in your hand, you jerk a few times up and down on it, then and stroke the sensitive skin of your flat crotch with its tip. Even though you don't have anything there as a neuter, it still gives you a warm and pleasant feeling to feel the warmth of his shaft against you and hear his lustful moans.";
	say "     You switch between grinding against David, fondling his body and making out with him, filling the alley with both of your moans and groans. Not being able to cum yourself, you could keep this up forever, but your horny soldier's urges all too soon have him gasping faster and faster as he gets closer to orgasm. Then it's time - his thick shaft pules in your hand as blasts of cum jet out of its head to splat all over your crotch and stomach.";
	say "     [WaitLineBreak]";
	say "     Gathering up some cum with your finger, you lick it off, then give your handsome Private a kiss, making him taste his own cum on your lips. You keep standing like that for a moment, your arms around his chest and slowly making out. As both of you come down from the rush of sex and David's brain starts working again, he says 'That felt amazing - but... what exactly are you?' with a nod to your genderless nether region. With a worried look he adds 'Anyways... maybe this was wrong. We didn't really have sex, but you made me cum. Feels like I'm cheating on my girlfriend Ann back home.'";
	say "     Stroking his cheek, you tell him to calm down and that his girlfriend surely won't learn about you two once he goes back to her when this is all over. What happens in this city stays in the city. Unless of course you can make him fully yours to keep, you think to yourself...";

[ David, the npc:                                                       ]
[ thirst states of David - Relationship with the Player                 ]
[   0: had no sex of any kind with the player                           ]
[   1: had some sort of intimate contact with the player - once         ]
[   2: had some sort of intimate contact with the player - often        ]
[   5: the point at which he'll ask the player to be his girl/boyfriend ]
[  10: is the player's fuck-buddy                                       ]
[  20: player is his girl/boyfriend                                     ]
[ lust states of David - Gay Sex Variable                               ]
[   0: anal virgin                                                      ]
[   1: got fucked in the ass                                            ]
[   2: got fucked in the ass + sucked player cock                       ]
[  51: de-virginized by Brutus                                          ]
[ libido states of David - Demon Brute Pet Interaction                  ]
[   0: hasn't seen the player with Brutus yet                           ]
[   1: got frightened as he saw evil Brutus, no special sex prepped     ]
[  50: talked to a 'cleansed' Brutus, noticed Brutus staring            ]
[  51: player asked Brutus about why he stares at David                 ]
[  52: Brutus removed the enslavement mark from David (hurting himself) ]
[  53: David thanked Brutus for helping him                             ]
[  54: David & Brutus had fun together                                  ]
[  89: revenge fuck option enabled when talking to him                  ]
[  90: fucked the demon, lost his fear                                  ]
[  99: player agreed to have the demon brute fuck him                   ]
[ 100: got fucked & enslaved by the demon brute                         ]
[ hp states of David - Location                                         ]
[   0: on patrol                                                        ]
[   1: got called in to Camp Bravo                                      ]
[   2: met the player in Camp Bravo                                     ]
[   3: liaison to the player - in Camp Bravo                            ]
[   4: liaison to the player - in the Bunker                            ]
[ 100: demon brute pet's slave - in the amulet                          ]

David is a man.
The description of David is "     David Jackson is a young soldier, pretty friendly if a bit shy. He has a slender but still muscular build, a handsome face and short-cut brown hair.";
The conversation of David is { "Oh, hello." };
lastfuck of David is usually 555.

The scent of David is "     David has a nice masculine human smell.";

Instead of fucking David:
	if(lastfuck of David - turns < 5):
		say "     David says 'I'd love to, but I'm still pretty worn out from the last time...'";
	otherwise:
		if David is in Parade Ground:
			say "     You walk up to David and tell him you want to 'talk' to him - alone. [if thirst of David < 2]He salutes and leads you to a nearby tent. Soon you're standing between several bunk beds, alone in the tent with the handsome soldier..[otherwise]He gives you a knowing wink and leads you to a nearby tent. Soon you're standing between several bunk beds, alone in the tent with the handsome soldier...[end if]";
		now sextablerun is 0;
		blank out the whole of table of fucking options;
		choose a blank row in table of fucking options;
		now title entry is "Suck David's cock";
		now sortorder entry is 1;
		now description entry is "Give him a blow-job.";
		if (lust of David > 0 and cocks of player > 0):
			choose a blank row in table of fucking options;
			now title entry is "Have him suck your cock";
			now sortorder entry is 2;
			now description entry is "Get a blow-job.";
		if (cunts of player > 0):
			choose a blank row in table of fucking options;
			now title entry is "Let David fuck your pussy";
			now sortorder entry is 3;
			now description entry is "Let the young soldier breed you.";
		if (lust of David > 0):
			choose a blank row in table of fucking options;
			now title entry is "Let David fuck your ass";
			now sortorder entry is 4;
			now description entry is "Let the young soldier fill your ass with his seed.";
		if (cocks of player > 0):
			choose a blank row in table of fucking options;
			now title entry is "Take David's ass";
			now sortorder entry is 5;
			now description entry is "Fill the young soldier's ass with your cock.";
		sort the table of fucking options in sortorder order;
		while sextablerun is 0:
			repeat with y running from 1 to number of filled rows in table of fucking options:
				choose row y from the table of fucking options;
				say "[link][y] - [title entry][as][y][end link][line break]";
			say "Pick the corresponding number> [run paragraph on]";
			get a number;
			if calcnumber > 0 and calcnumber <= the number of filled rows in table of fucking options:
				now current menu selection is calcnumber;
				choose row calcnumber in table of fucking options;
				say "[title entry]: [description entry][line break]";
				say "Is this what you want?";
				if player consents:
					let nam be title entry;
					clear the screen and hyperlink list;
					now sextablerun is 1;
					if nam is "Suck David's cock":
						say "[DavidSex1]";
					otherwise if (nam is "Have him suck your cock"):
						say "[DavidSex2]";
					otherwise if (nam is "Let David fuck your pussy"):
						say "[DavidSex3]";
					otherwise if (nam is "Let David fuck your ass"):
						say "[DavidSex4]";
					otherwise if (nam is "Take David's ass"):
						say "[DavidSex5]";
		if thirst of David < 5:
			increase thirst of David by 1;
		now lastfuck of David is turns;

instead of conversing David:
	if hp of David < 2:
		say "     Error! He shouldn't be talking yet - please report on the forum how you saw this.";
	if hp of David is 2:
		say "     David says 'I'm still waiting for my number to come up. Doesn't seem as frightening as before though - maybe it's the strange smell in the air here...'";
	otherwise if hp of David > 2:	
		if libido of David > 50 and libido of David < 80:  [talking about the cleansed Brutus included]
			say "     So what do you want? Just chat a bit [link](1)[as]1[end link], send him to the [if hp of David is 3]bunker[otherwise]camp[end if] [link](2)[as]2[end link], talk to him about Brutus [link](3)[as]3[end link], or not say anything after all [link](4)[as]4[end link]?";
			now calcnumber is 0;
			while calcnumber < 1 or calcnumber > 4:
				say "Choice? (1-3)>[run paragraph on]";
				get a number;
				if calcnumber is 1 or calcnumber is 2 or calcnumber is 3 or calcnumber is 4:
					break;
				otherwise:
					say "Invalid choice.  Type [link]1[end link] to chat, [link]2[end link] to send him to the [if hp of David is 3]bunker[otherwise]camp[end if] or [link]3[end link] to break off talking.";
			if calcnumber is 1:								[chat]
				if hp of David is 3: 						[in the camp]
					say "     David says 'As you can see, the sample gathering is still going well. It's unbelievable how much stamina Tiny Tim has. [if CampBravoWomenAllowed is 1]Several of the female soldiers got sent out as well by now, their bellies already swelling with minotaur calves.' [end if][if Adam is in Quartermaster's Tent]The quartermaster had a half-minotaur son too - he's in her tent helping her out.' [end if]";
				if hp of David is 4:						[in the bunker]
					if Sarahpups > 3:
						say "     David says 'Sarah's puppies keep trying to chew up my boots. They're sweet and all, but sometimes they get on my nerves. I've been going up into the library to get some peace and quiet and read[if Fang is in the Grey Abbey Library]. Of course, there your wolf keeps staring at me like he wants to mount me[end if].'";
					otherwise:
						say "     David says 'Pretty quiet down here in the bunker. I've been going up into the library to grab a book or two to read[if Fang is in the Grey Abbey Library]. And your wolf kept looking at me all the time like he wanted to mount me[end if].'";
			otherwise if calcnumber is 2:			[send him to the bunker/camp bravo]
				if hp of David is 3:						[in the camp]
					say "     David gives you a salute and says [if thirst of David is 20]'See you there, baby.' [otherwise]'As you wish, sir.' [end if]before going to collect his clothes and equipment.";
					move David to Bunker;
					now hp of David is 4;
				otherwise if hp of David is 4:	[in the bunker]
					say "     David gives you a salute and says [if thirst of David is 20]'See you there, baby.' [otherwise]'As you wish, sir.' [end if]before going to collect his clothes and equipment.";
					move David to Parade Ground;
					now hp of David is 3;
			otherwise if calcnumber is 3:
				if libido of David is 51:
					say "     Bringing up the topic of Brutus, you explain that your demon companion thinks that the demon who attacked him did something, possibly leaving what Brutus called a 'seal of enslavement'. Continuing with the offer by Brutus to have a look for it, you see David become rather uncomfortable as he imagines stripping before the demon. Still, he might be in real danger from it, if he actually has the seal on him and it draws other demons like it seems to be affecting Brutus. You do your best to convince David to agree to Brutus examining him, and...";
					say "     [line break]";
					let bonus be (( the Charisma of the player minus 10 ) divided by 2);
					let diceroll be a random number from 1 to 20;
					say "You roll 1d20([diceroll])+[bonus]: [diceroll + bonus] in a Charisma-Check.";
					increase diceroll by bonus;
					if diceroll is greater than 12:
						say "     ...manage to convince David to do it.";
						say "     [line break]";
						if DemonBruteStatus is 2: [female]
							say "     [if hp of David is 3]After moving over to an empty tent a bit out of the way from the parade ground,[otherwise if hp of David is 4]After moving to the far corner of the bunker,[end if] you give the young soldier a squeeze on the shoulder and an encouraging nod. With a look up at the demon waiting besides you, and another at Brutus (again) moist and swollen pussy, David gives himself a small shake, then pulls his shirt over his head and strips down. As the young man slides the last bit of fabric off and stands completely naked before you. He trembles uncontrollably as Brutus steps up to him. Brutus looks down on the naked human, then carefully puts a hand on David's shoulder. 'I'm... sorry about what was done to you. And that I make you feel like this.' David looks up, meeting Brutus eyes, and after a moment you see him slowly relax a bit as he sees the concern and apology in the demon's large, slitted pupils.";
						otherwise:		[male+herm]
							say "     [if hp of David is 3]After moving over to an empty tent a bit out of the way from the parade ground,[otherwise if hp of David is 4]After moving to the far corner of the bunker,[end if] you give the young soldier a squeeze on the shoulder and an encouraging nod. With a look up at the demon waiting besides you, and another at Brutus (again) hardening cock, David gives himself a small shake, then pulls his shirt over his head and strips down. As the young man slides the last bit of fabric off and stands completely naked before you. He trembles uncontrollably as Brutus steps up to him. Brutus looks down on the naked human, then carefully puts a hand on David's shoulder. 'I'm... sorry about what was done to you. And that I make you feel like this.' David looks up, meeting Brutus eyes, and after a moment you see him slowly relax a bit as he sees the concern and apology in the demon's large, slitted pupils.";
						say "     [WaitLineBreak]";
						say "     Slowly stepping around David, Brutus looks closely at him, lightly touching the scars the other demon left. Then he has the young man raise his right arm, and brushes his clawed fingers over a bit of scar tissue there. 'This is it - the seal. This will make you amplify your fear, almost paralyze you with it, while at the same time craving serving, being degraded, everything like that. You would follow your master everywhere, even to hell.'";
						say "     Concentrating, murmuring a chain words that you couldn't even pronounce while holding his hand in place over David, Brutus draws some purple smoke out of the young soldier. It coalesces into a faintly glowing, eye-twisting rune in the air above David's skin. You notice that there seems to be quite a bit of effort involved - judging from the beads of sweat forming on Brutus skin and dripping off the demon's brow. In an earnest tone, he says 'I'm sorry for all the innocents I too bound like this. You, at least, will be free.' then slashes his claws through the glowing symbol.";
						say "     [WaitLineBreak]";
						say "     With a loud crack of power, Brutus is thrown several feet backwards, where he crumples to the ground. The smell of burned flesh rises in the air. For a second of shocked silence, no one moves - not you, and not David, who stands where he was, not affected or hurt at all by what happened. Then both of you rush forward to kneel besides the fallen demon brute. Thankfully, he's okay - mostly. With a groan, Brutus starts moving again and opens his eyes. He lifts his head a bit so he can look at his hand as he raises it with a pained hiss, grunting at the view of blistered, burned skin. 'Mh - it will heal.' he says, his head slumping back as he takes a deep breath.";
						say "     Next, Brutus eyes focus on David, mostly on his face but wandering down to gaze at the young man's naked body too. 'It is done. You should be  free. Do you still fear me, human?' David looks down at the demon's prone form, meeting his eyes for a moment before replying 'No', a thoughtful expression on his face. Brutus lips form what can be called a smile, even if it looks rather frightening with all the teeth it shows. He turns his head to you, not quite suppressing a pained wince as he tries lowering his hand to rest on the ground at the same time. 'Master, may I rest?' Not wanting to see your companion suffer any longer, you immediately intone the magic words to send him back into the amulet.";
						if companion of player is demon brute:
							now companion of player is nullpet;
						now libido of David is 52;
					otherwise:
						say "     ...get an answer of 'Sorry, I just can't. Be close to one of those things...' David shudders.";
				otherwise if libido of David is 52:	[Brutus helped David, got hurt - first meeting after]
					if companion of player is demon brute:		[is the active pet]
						say "     David inquires how Brutus is now and is visibly relieved when the demon shows him his fully healed hand. Turning into smoke and back regularly means that he has lots of practice in reassembling himself after all. David nods, then falls silent for a moment, thinking. He pulls you aside out of earshot of your demon companion before asking 'Did you order him to do it? Did you... know it would hurt him?' Both of those questions you truthfully say no to, recounting Brutus shameful admission of certain... urges, then him pleading to look at David. 'So it was all him? That's... quite something. For a demon.' He rubs his side where the demonic seal once was hidden, biting his lip before he continues. 'Could I... talk to him sometime?'";
						say "     [WaitLineBreak]";
						say "     Why wait - you call Brutus over. David walks up to him, putting a hand on his muscled arm. 'I wanted to thank you again for dealing with that evil symbol. It was... unexpected, for you to take such a risk for me.' Then he holds out his hand to Brutus, offering it to him. 'So... friends?' The demon looks down at him nonplussed for a second as he tries to come up with a response to a topic that hasn't been part of his life for eons - then he exuberantly shakes the smaller human's hand and pulls him into an embrace.";
					otherwise:
						say "     As you bring up Brutus again, David inquires how he is now and is visibly relieved when you tell him he came out alright. Turning into smoke and back regularly means that he has lots of practice in reassembling himself after all. David nods, then falls silent for a moment, thinking, before asking 'Did you order him to do it? Did you... know it would hurt him?' Both of those questions you truthfully say no to, recounting Brutus shameful admission of certain... urges, then him pleading to look at David. 'So it was all him? That's... quite something. For a demon.' He rubs his side where the demonic seal once was hidden, biting his lip before he continues. 'Could I... talk to him sometime?'";
						say "     [WaitLineBreak]";
						say "     Why wait - you murmur the magic words to summon Brutus, making him appear from a cloud of purple smoke. The demon bows his head to you, saying 'Master', then turns to the soldier besides you and says 'Hello, David'. David walks up to him, putting a hand on his muscled arm. 'I wanted to thank you again for dealing with that evil symbol. It was... unexpected, for you to take such a risk for me.' Then he holds out his hand to Brutus, offering it to him. 'So... friends?' The demon looks down at him nonplussed for a second as he tries to come up with a response to a topic that hasn't been part of his life for eons -then he exuberantly shakes the smaller human's hand and pulls him into an embrace.";
					if DemonBruteStatus is 2: [female]
						say "     They stay in that tight hug for a moment, David pressed against Brutus chest, his arms not even close long enough to reach around the demon's wide chest. Then suddenly, Brutus clears his throat, his face taking on an interesting shade of embarrassed purple as he lets the young soldier in his arms go. As David steps away, you see the pussy in a quite aroused state, its lips swollen, a wet spot on David's clothing where he must have been pressed right against it. With you standing right next to them, both the soldier and the demon seem to come to the decision to ignore the last bit at the same time, resulting in a somewhat awkward 'See ya.' and 'Sure, friend.'";
					otherwise:   [male+herm]	
						say "     They stay in that tight hug for a moment, David pressed against Brutus chest, his arms not even close long enough to reach around the demon's wide chest. Then suddenly, Brutus clears his throat, his face taking on an interesting shade of embarrassed purple as he lets the young soldier in his arms go. As David steps away, you see the demon's cock in a quite aroused state, hanging where it must have pressed right against David. With you standing right next to them, both the soldier and the demon seem to come to the decision to ignore the last bit at the same time, resulting in a somewhat awkward 'See ya.' and 'Sure, friend.'";
					now libido of David is 53;
				otherwise if libido of David is 53:   [talking after they've become friends]
					say "     As you bring your demon companion up, David says 'I still can't quite believe that Brutus is so... nice. No, that's the wrong word. Normal. After seeing that big beast in the bar you had to save me from, I'd never have believed one of them could be like a normal guy. Ever.' He rubs the claw-marks on his side, then shakes off the memory again, continuing with 'Now Brutus is a friend, and couldn't be more different than that other demon. Well - except his strength. Awesome muscles on him. He really had me tight with that hug, and right against his... er' David's face turns a bit red as he stops talking, then quickly continues with 'Anyways, we're both lucky you came along when you did. Saving me and saving him, from himself.'";
					say "     [line break]";
					say "     Despite David's attempt of changing the topic, it seems pretty obvious to you that there's some... interest for each other between your two friends. The thought comes up from somewhere inside your head that it might be a good idea to just get the two of them alone for a while and see what develops. Do you want to follow it?";
					if player consents:  [arrange for them to be alone together]
						say "     [line break]";
						say "     Your decision made, you mull over how to arrange things for a moment, then turn back to your soldier friend and suggest that he check the contents of the piles of crates stacked up in a storeroom at the back of the library. In all likelihood just books, but since there was a tiny store at the entrance, selling various small stuff, there might just be something interesting there. 'Good idea' David says with a nod, then starts out towards the stairs up to the library.";
						say "     Before he can make more than two steps, you continue to say that he should take Brutus along, to help with carrying stuff and so on. The young soldier turns, his eyes immediately seeking out your demon companion's muscular chest and arms, then dropping lower to pass over his... other endowments. His cheeks slightly red as he tears his eyes away and looks back to you, David says 'Err... of course.' Then the soldier and demon walk off together, on their way to the library storeroom.";
						say "     [WaitLineBreak]";
						say "     You're certainly curious what will come of this. Maybe you should follow them unobtrusively and have a look (Y) - or do you want to give them real privacy to deal with their issues after all (N)?";
						if player consents:  [follow them]
							say "     [line break]";
							say "     Waiting a few minutes to give them enough time to get where they are going, you then make your way to the stairs and walk in the direction of the storeroom when you get up into the library. As you silently walk along the hallway towards its open door, you can hear voices from within. David says '...and some more books. Could you please move these two crates over to that corner. We need them out of the way.'";
							say "     Then you're at the door and carefully peek inside the room. There are quite a few crates, large and small, in it, and in the midst of those stand David and Brutus. As you watch, the demon brute puts the lid of a large wooden crate that he was holding back on it, then bends to effortlessly pick up the heavy crate. From the looks of it and the pallet it stood on, no human could have moved it without a pallet jack. Impressed by that feat of superhuman strength, David can't suppress a 'Whoa' as he watches Brutus carry the heavy load and set it down where it was supposed to go, followed by the second crate. Grinning widely as he walks back, Brutus comes to stand before the young man, flexing his chest and arms demonstratively. David reaches out to run his fingers over Brutus chest, then stops himself, clearing his throat as he says 'Lets check out the next crate.'";
							say "     [WaitLineBreak]";
							say "     As the two of them continue to open and move aside box after heavy box of books, you overhear them chatting a bit about this and that and observe David slowly losing his reflexive inhibition at watching Brutus body - all of his body. The demon just eats up the admiration for his physique, often flexing and stretching to show off, grinning happily when David compliments him.";
							say "     Finishing with the first row of pallets and the crates on them, they come to a pallet laden with a bit smaller carton boxes. 'This could be something' David says, pulling one of the top ones off and setting it on the ground with a thump. He leans over it, opening up its lid, then grumbles 'Oh great, pencils.' Brutus doesn't react to the disappointing contents of the box, his whole attention riveted to the curve of David's ass, looking very nice in the bent over young soldier's pants. With a lustful grunt, the aroused demon steps forward, his purple dick having quickly reached its full hardness. Putting his clawed hands on David's body, he cups the cheeks of the young man's ass and gives them a squeeze. 'Oh? Ooh..' David says breathlessly as he stands up again and turns, looking at Brutus chest, then quickly down to his crotch, then up into his azure blue eyes. After just a moment more of hesitation, the floodgates break, with the young soldier being pulled into a tight embrace against the demon's chest, eagerly meeting his lips as they start making out. In between the hungry kisses, moans fill the storeroom, coupled with pleased rumbles out of Brutus chest.";
							say "     [WaitLineBreak]";
							say "     Then, as David gets lowered back to the ground, Brutus says in his deep voice 'I want you - now!', his hands moving to pull off David's shirt, accidentally tearing it to shreds in his haste. With eager, hurried movements, the young soldier kicks off his boots, almost falls over as he stands on one leg, then the other, to pull off and throw aside his socks and finally manages to undo his belt and pants, letting them drop to the ground. His boxer briefs end up cleanly sliced off his body by one of Brutus sharp claws, leaving David standing in the buff before the equally naked Brutus.";
							if DemonBruteStatus is 0 or DemonBruteStatus is 1: [male+herm]
								say "     Leaning forward to lick his forked tongue over the young soldier's chest, then along his neck, Brutus gives a lust-filled grunt, the veins on his hard shaft throbbing in anticipation. He picks up David, one hand cupping his ass, the other guiding the human's head to his own so they can kiss, then carries him over to a crate that's hip-height for himself and covered in some soft plastic wrap. As he lowers David onto it softly, the demon says 'I wanted you since I first saw you - and now that you're my friend, I want you even more.' His large hand strokes over David's chest, stops to jerk the man's cock a few times before moving even lower, rubbing over his butthole, pulling a breathless pant from the soldier.";
								say "     [WaitLineBreak]";
								if lust of David is 0:  [anal virgin]
									say "     David moans 'I - I haven't had anyone... go there before', still somewhat hesitant even though deeply in the grasp of his own lust. With surprising gentleness, Brutus replies 'Don't worry my friend, I'll go slow, at first. Make it good.' then leans forward to kiss David on the lips before crouching down and bringing his tongue to lick the man's buttcheeks. Then he moves it along David's crack, playing over his pucker several times before pushing it inside, probing and licking him. After several minutes of this during which David's hole is carefully teased and spread, lubed with Brutus spit as David moans and writhes in pleasure, your demon companion stands up again, now bringing his hard shaft up against David with a guiding hand. Looking down with clear concern for the human, Brutus caresses his chest again, then says 'Tell me how fast I can go, ok?' and gets a nod from the lying human.";
									say "     After nudging the tip of his shaft against David's pucker several times to prepare him for what's coming, Brutus presses in, giving a deep grunt of pleasure as his head pops into the soldier's body. David's reaction is a short, pained gasp, as he loses his virginity to a very large male indeed and Brutus stops immediately, holding still inside him. After a few deep breaths, David pants 'Keep going', and the demon brute takes up sinking his manhood into him slowly again, bit by bit spreading the freshly deflowered human's passage around his shaft. At some point, the pleasurable feelings of having the bumps on Brutus cock rub his insides outweigh the discomfort and David's utterances turn from gasps and pants to moans, coupled with demands to take him deeper. Finally, the demon bottoms out inside him and leans in for another long kiss.";
									now lust of David is 51;  [de-virginized by Brutus]
								otherwise:
									say "     David moans 'I'm still a bit new to this, never did it with men before... you know, your master', still somewhat hesitant even though deeply in the grasp of his own lust. With surprising gentleness, Brutus replies 'Don't worry my friend, I'll go slow, at first. Make it good.' then leans forward to kiss David on the lips before crouching down and bringing his tongue to lick the man's buttcheeks. Then he moves it along David's crack, playing over his pucker several times before pushing it inside, probing and licking him. After several minutes of this during which David's hole is carefully teased and spread, lubed with Brutus spit as David moans and writhes in pleasure, your demon companion stands up again, now bringing his hard shaft up against David with a guiding hand. Looking down with clear concern for the human, Brutus caresses his chest again, then says 'Tell me how fast I can go, ok?' and gets a nod from the lying human.";
									say "     After nudging the tip of his shaft against David's pucker several times to prepare him for what's coming, Brutus presses in, giving a deep grunt of pleasure as his head pops into the soldier's body. Thankfully being prepared to taking a dick through your own intimate encounters with him as well as Brutus oral attention, David is relaxed about taking him, reacting only with a short gasp, then says 'I'm okay, keep going.' After a few moment of hesitation, the demon brute takes up sinking his manhood into him slowly again, bit by bit spreading the human's passage around his shaft. David pants and moans in lust, and after a while even calls out for Brutus to go faster, deeper. Finally, the demon bottoms out inside him and leans in for another long kiss.";
								say "     [WaitLineBreak]";
								say "     Raising his upper body back up, the horny demon puts his hands on David's shoulders to hold him from sliding back on his padded crate, then slowly pulls out of him before thrusting back in with a lusty grunt, his massive balls hitting David's ass with a meaty slap. He goes slow at first, then speeds up bit by bit as the young soldier's inner muscles are stretched out and get used to the thick invading member moving in and out of David's body. Before long, their loud moans and gasps are joined by scraping sounds as the crate David is lying on gets shifted further and further back when Brutus harder thrusts hit it. Which means that you can relax your self-control finally, no longer having to suppress your own noises with all the racket they're making. Having been thoroughly turned on by spying on your friend's coupling, you bring your hand to your crotch, [if cocks of player > 0]stroking your manhood[otherwise]stroking yourself[end if] in rhythm with Brutus thrusts.";
								say "     The hot sex between the two very different partners continues for some more time, with the moans, pants and slapping noises of Brutus balls against David's ass getting ever faster and louder. Their coupling builds up to an impressive - and pretty noisy - climax. David is the first to go, shouting 'Oooh fuck... oh, oh... god... I'm gonna cummmMM...' as his hard cock pulses, shooting long streaks of cum over his chest and even hitting him in the face. With the human's inner muscles gripping him tightly, flexing around Brutus shaft as David rides out his orgasm, it doesn't take much longer for the demon to join him too. With a long and very satisfied grunt, Brutus slams into David one last time, bottoming out as he unloads a veritable flood of cum into him. As he pumps more and more seed into David, the human's belly bulges slightly, as if he was in the early stages of pregnancy, with even more cum squirting around his thick shaft and running down over the crate. Eager to join the two of them in their satisfaction, you speed up your own efforts, only moments later [if cocks of player > 0]shooting a load all over the wall at the storeroom's entrance[otherwise if cunts of player > 0]squirting femcum on the floor to form a small wet patch[otherwise]feeling a pleasant tingle fill your whole body[end if].";
								say "     [WaitLineBreak]";
								say "     Picking up the exhausted human still impaled on his cock, Brutus holds David against his chest as he himself staggers a few steps to another  crate and sits on it. Stroking the naked soldier's back slowly and affectionately, he rumbles 'I love fucking you. And even just holding you. Best friend ever.' David raises his head from where it leaned against Brutus broad chest, reaching up to caress the demon's cheek. 'I like you too, big guy. A whole lot.' He chuckles, saying 'If someone had told me six months ago I'd be doing... this' *he rocks back on the demon's slowly softening shaft in his ass* 'I'd have told them they were bonkers. Crazy, how times change.'";
								say "     [line break]";
								say "     Looks like they'll stay like that for a while yet, just holding each other and being close together, so you make your exit from the scene  before they might spot you after all. Moving back down into the bunker, you busy yourself with some work so it doesn't see, that you were waiting on them. Some time later, David and Brutus also come back down from above. With it having been ripped up, the young man is now shirtless and his hair is a bit dishevelled, while the large demon following him has a pretty self-satisfied grin on his face. As the two of them walk up to you, David says 'Just a lot of books, writing supplies and other useless crap, sorry. We moved them to block the back door though, that should help a bit at least to keep the building safer.' Noticing you looking at his bare chest, David's cheeks get a slight tinge of redness and he quickly says 'I caught my shirt on a crate's splintered edge and ripped it. That's all. Nothing else.' He quickly moves over to his bed, grabbing a new shirt to put on.";
							otherwise:  [female]
								say "     <Sex scene with David + cuntboy Brutus here>";
						otherwise:		[give them privacy]
							say "     [line break]";
							say "     Nah, you decide to let them deal with what they'll do in private, without you following them around and snooping in. Though with your curiosity still burning, almost making you go back on your choice, you start various time-consuming tasks in the bunker to distract yourself.";
							say "     [line break]";
							say "     Quite a while later, David and Brutus come back down from above. Interestingly, the young man is now shirtless and his hair a bit dishevelled, while the large demon following him has a pretty self-satisfied grin on his face. As the two of them walk up to you, David says 'Just a lot of books, writing supplies and other useless crap, sorry. We moved them to block the back door though, that should help a bit at least to keep the building safer.' Noticing you looking at his bare chest, David's cheeks get a slight tinge of redness and he quickly says 'I caught my shirt on a crate's splintered edge and ripped it. That's all. Nothing else.' He quickly moves over to his bed, grabbing a new shirt to put on.";
						now libido of David is 54;
					otherwise:
						say "     [line break]";
						say "     Maybe it's not such a great idea after all. David might not like you arranging things, manipulating him and Brutus...";
				otherwise if libido of David is 54:   [talking after they had sex]
					say "     <after-sex (with Brutus) talking to David yet be written>";
			otherwise:    [break off]
				say "     You wave David off and turn away.";
		otherwise:
			say "     So what do you want? Just chat a bit [link](1)[as]1[end link], send him to the [if hp of David is 3]bunker[otherwise]camp[end if] [link](2)[as]2[end link] or not say anything after all [link](3)[as]3[end link]?";
			now calcnumber is 0;
			while calcnumber < 1 or calcnumber > 3:
				say "Choice? (1-3)>[run paragraph on]";
				get a number;
				if calcnumber is 1 or calcnumber is 2 or calcnumber is 3:
					break;
				otherwise:
					say "Invalid choice.  Type [link]1[end link] to chat, [link]2[end link] to send him to the [if hp of David is 3]bunker[otherwise]camp[end if] or [link]3[end link] to break off talking.";
			if calcnumber is 1:								[chat]
				if hp of David is 3: 						[in the camp]
					say "     David says 'As you can see, the sample gathering is still going well. It's unbelievable how much stamina Tiny Tim has. [if CampBravoWomenAllowed is 1]Several of the female soldiers got sent out as well by now, their bellies already swelling with minotaur calves.' [end if][if Adam is in Quartermaster's Tent]The quartermaster had a half-minotaur son too - he's in her tent helping her out.' [end if]";
				if hp of David is 4:						[in the bunker]
					if Sarahpups > 3:
						say "     David says 'Sarah's puppies keep trying to chew up my boots. They're sweet and all, but sometimes they get on my nerves. I've been going up into the library to get some peace and quiet and read[if Fang is in the Grey Abbey Library]. Of course, there your wolf keeps staring at me like he wants to mount me[end if].'";
					otherwise:
						say "     David says 'Pretty quiet down here in the bunker. I've been going up into the library to grab a book or two to read[if Fang is in the Grey Abbey Library]. And your wolf kept looking at me all the time like he wanted to mount me[end if].'";
			otherwise if calcnumber is 2:			[send him to the bunker/camp bravo]
				if hp of David is 3:						[in the camp]
					say "     David gives you a salute and says [if thirst of David is 20]'See you there, baby.' [otherwise]'As you wish, sir.' [end if]before going to collect his clothes and equipment.";
					move David to Bunker;
					now hp of David is 4;
				otherwise if hp of David is 4:	[in the bunker]
					say "     David gives you a salute and says [if thirst of David is 20]'See you there, baby.' [otherwise]'As you wish, sir.' [end if]before going to collect his clothes and equipment.";
					move David to Parade Ground;
					now hp of David is 3;
			otherwise:												[break off]
				say "     You wave David off and turn away.";
	
after of going to Parade Ground while hp of David is 1:
	now hp of David is 2;
	say "     As you enter Camp Bravo, you see a familiar face standing on the parade ground - it's David Jackson, your handsome Private from out in the city. He's watching the minotaur with a bit of a wide-eyed expression. Moving up to him, you say hello.";
	say "     [line break]";
	say "     'Hello again. I was told there might be a special agent coming to talk to us, but I never thought it'd be you. You never told me you're with the government...' You apologize, giving him some airy explanation about needed secrecy and gathering unbiased information. Quickly leading over to another topic, you ask him about what he thinks about the Camp.";
	say "     David points over at the minotaur, saying 'Just look at the thing - it's huge. Almost couldn't believe it when the first group of men came out and it stuck its cock up their asses and fucked them. And the whole story about why we're doing this sounds a bit fishy to me... but orders are orders.' He gives the minotaur another look and rubs his ass. 'I worry a bit that it'll be my turn soon...'";

after of going to Parade Ground while thirst of David is 5 and hp of David is 3:
	say "     As you step on the parade ground of Camp Bravo, David walks up to you and pulls you aside, saying he has something important to talk to you about. He looks a bit embarrassed about it, hesitating before he says 'Listen, you saved me from minotaur duty, and I like being with you and... you know. I wanted to ask how you see - you and me - us.'";
	say "     He looks at you with an earnest and hopeful expression. What do you tell him? Y = 'I like you too - come be my boyfriend.' ; N = 'We're just fuck-buddies, blowing off some steam.'";
	if player consents:
		now thirst of David is 20;                [boyfriend]
		say "     He smiles and gives you a kiss and a tight embrace.";
	otherwise:
		now thirst of David is 10;                [fuck-buddy]
		say "     'Oh, ok - just buddies, you say. I'll go back to Ann then when all this is over.";

after of going to Bunker while thirst of David is 5 and hp of David is 4:
	say "     As you enter the bunker, David walks up to you and says he has something important to talk to you about. He looks a bit embarrassed about it, hesitating before he says 'Listen, you saved me from minotaur duty, and I like being with you and... you know. I wanted to ask how you see - you and me - us.'";
	say "     He looks at you with an earnest and hopeful expression. What do you tell him? Y = 'I like you too - come be my boyfriend.' ; N = 'We're just fuck-buddies, blowing off some steam.'";
	if player consents:
		now thirst of David is 20;                [boyfriend]
		say "     He smiles and gives you a kiss and a tight embrace.";
	otherwise:
		now thirst of David is 10;                [fuck-buddy]
		say "     'Oh, ok - just buddies, you say. I'll go back to Ann then when all this is over.";

after of going to Bunker while thirst of David > 5 and hp of David is 4 and hp of Eric > 0 and lust of Eric is 0:  [David spots Eric's genitals and wants to talk about them]
	say "     As you enter the bunker, David walks up to you and pulls you to the side, whispering he has something talk to you about. He looks a bit embarrassed about it, and you notice his eyes straying over to where Eric sits on his bunk (reading something with his back to you) before he continues. 'I - I accidentally saw Eric when he changed his clothes. I didn't spy on him or anything, it just happened, and... he's...'";
	if hp of Eric is 1:
		say "     '...a woman, down below. I didn't know the infections could do that - change only your gender and nothing else. It must be very strange for him.'";
		say "     [line break]";
		say "     You say 'Yeah, he was bitten and got that rather surprising transformation out of it. I'll have to talk to him about that - he can't just deny that the change happened. Either he has to accept his new form, or maybe I can find a cure somewhere...' David looks over to Eric and opens his mouth to ask another question, but you put a hand on his arm and shake your head. 'I'd rather not talk more about things Eric might not want other people to know. Why don't you ask him about it yourself and he'll tell you what he's ready for. But... be nice, ok? He's been through a lot.'";
		now lust of Eric is 1;
	otherwise if hp of Eric is 10 or hp of Eric is 11:
		say "     '...a woman, down below. I didn't know the infections could do that - change only your gender and nothing else. It must be very strange for him.'";
		say "     [line break]";
		say "     You say 'Yeah, he was bitten and got that rather surprising transformation out of it. Hopefully he'll learn to accept his new body fully...' David looks over to Eric and opens his mouth to ask another question, but you put a hand on his arm and shake your head. 'I'd rather not talk more about things Eric might not want other people to know. Why don't you ask him about it yourself and he'll tell you what he's ready for. But... be nice, ok? He's been through a lot.'";
		now lust of Eric is 1;
	otherwise if hp of Eric is 20:
		say "     '...a woman, down below. I didn't know the infections could do that - change only your gender and nothing else. It must be very strange for him.'";
		say "     [line break]";
		say "     You say 'Yeah, he was bitten and got that rather surprising transformation out of it. But I'm working on fixing that...' David looks over to Eric and opens his mouth to ask another question, but you put a hand on his arm and shake your head. 'I'd rather not talk more about things Eric might not want other people to know. Why don't you ask him about it yourself and he'll tell you what he's ready for. But... be nice, ok? He's been through a lot.'";
		now lust of Eric is 1;
	otherwise if hp of Eric is 21 or hp of Eric is 22:
		say "     '...got a horse's penis. But he's human everywhere else. I didn't know the infections could do that - change only your genitals without the rest. It must be very strange for him.'";
		say "     You say 'You should have seen him before I... ah, maybe it'd be better if I didn't tell you that. I don't want to gossip about something that might still be a sore point with him.' David looks over to Eric and opens his mouth to ask another question, but you put a hand on his arm and shake your head. 'Why don't you ask him about it yourself and he'll tell you what he's ready for. But... be nice, ok? He's been through a lot.'";
		now lust of Eric is 1;
	otherwise if hp of Eric is 31 or hp of Eric is 32:
		say "     '...got a goat's penis. But he's human everywhere else. I didn't know the infections could do that - change only your genitals without the rest. It must be very strange for him.'";
		say "     You say 'You should have seen him before I... ah, maybe it'd be better if I didn't tell you that. I don't want to gossip about something that might still be a sore point with him.' David looks over to Eric and opens his mouth to ask another question, but you put a hand on his arm and shake your head. 'Why don't you ask him about it yourself and he'll tell you what he's ready for. But... be nice, ok? He's been through a lot.'";
		now lust of Eric is 1;
	otherwise if hp of Eric is 99:
		say "     '...a woman, down below. I didn't know the infections could do that - change only your gender and nothing else. It must be very strange for him.'";
		say "     [line break]";
		say "     You say 'Don't worry about that - he's got a pussy now and needs to be fucked, that's just how things are these days. Want to take him for a ride?' David opens his mouth as if to say something, then stops and shakes his head 'I couldn't just take advantage of him - we're supposed to help people.'";
		say "     [line break]";
		say "     His moment of hesitation tells you that David wouldn't be completely adverse to fucking your submissive cuntboy. If you could get him over the initial hangup and into that juicy pussy... maybe you should talk to Eric about making that happen.";
		now lust of Eric is 2;
	otherwise:
		say "ERROR-Eric-[hp of Eric]C: He isn't in one of the states he should be in! Please report how you got to this message.";

after of going to Bunker while thirst of David > 5 and hp of David is 4 and hp of Eric > 0 and lust of Eric is 1:  [David talks with Eric about his gender and they exchange stories]
	say "     As you enter the bunker, you see David and Eric sitting together on one of the far bunks, talking. Curious about what's going on, you unobtrusively walk closer and overhear:";
	say "     [line break]";
	say "			[DavidEricTalk]";

An everyturn rule:			[you can just wait for them to talk too]
	if player is in bunker and thirst of David > 5 and hp of David is 4 and hp of Eric > 0 and lust of Eric is 1:
		say "     As you spend some time in the bunker, you notice David and Eric sitting together on one of the far bunks, talking. Curious about what's going on, you unobtrusively walk closer and overhear:";
		say "     [line break]";
		say "			[DavidEricTalk]";
	
instead of going to Bunker while hp of David is 4 and companion of player is demon brute:  [David reacts when the player comes in with the demon brute pet]
	move player to Bunker;
	if libido of David is 0:  [first time David sees the player with a demon brute]
		if DBCaptureQuestVar is 5: [original, evil Brutus]
			say "     As you enter the bunker with your demon brute pet in tow and David spots it, he jumps up from where he was sitting on one of the many cots and shouts 'Watch out, there's a dem...', then suddenly falls silent as he realizes the big creature is following you and controlled. 'What the fuck?' he says, still a bit shocked and wide-eyed. Explaining that you've got him tightly controlled and the demon can't hurt him, you assure David that he can calm down. The young soldier accepts your word on it, but still moves to distance himself from the demon brute as far as possible.";
			if (DemonBruteStatus is 0 or DemonBruteStatus is 1):  [male/herm]
				say "     Watching David move to the far side of the underground room, you notice feeling some heat against your arm that wasn't there before. Turning, you see the massive cock of the demon brute besides you, hanging down between his legs fully engorged, radiating a fair amount of warmth as it pulses in anticipation. Your pet's eyes follow David and he sniffs the air through his slit-like nostrils, a pleased rumble going through his chest. Quite a reaction... curious what prompted it so instantly, you ask the brute to explain himself.";
				say "     Looking over to you, the demon gives an evil grin. 'That one has felt the touch of the Infernal Legion - I can smell is fear.' At that, he pulls in another lungful of air through his nose and precum starts dripping from his erection. He moves his claws over his chest, at the approximate positions where David had bloody slashes from the other demon on your first meeting 'He is marked to be a Bal'ssh'avizatz'gul's slave, but can still walk without hobbling, so he hasn't been taken properly. I WANT him as mine!' His eyes flash brightly and his gaze bores into yours. 'Give him to me and I won't rip your arms off when I finally get free.'";
				say "     [line break]";
				say "     Chuckling at the demon brute making demands even though he's yours to command, you grasp your demontooth amulet and whisper the command word, banishing him inside. Enough of this, for now.";
				now libido of David is 1;   [first-time fright scene resolved]
				[
				say "			The things you had to do to survive in this city certainly has some effect on your morality - or is it the ritual with which you bound the demon to you causing some of his evil to leak into you? No matter what, you imagine seeing your demon brute pet shoving his thick shaft into David's ass for a second, a hot flash of lust running through you at the same time.";
				say "     Shaking your head softly to shake off the vision, your answer to the demon brute is...";
				if player consents:	[let's be evil]
					say "     Willing to indulge your pet, you tell him he'll get to mount the soldier - but not here in the bunker. An alley out in the city seems much more appropriate, and you can arrange David being out there alone when you send him towards Camp Bravo again...";
					now libido of David is 99;  [open up the 'lure out and fuck' in David's code]
				otherwise:  [nope, David won't be raped by the demon in an alley]
					say "     Chuckling at the demon brute making demands even though he's yours to command, you grasp your demontooth amulet and whisper the command word, banishing him inside. Enough of this, for now.";
					now libido of David is 1;   [first-time fright scene resolved]
				]
			otherwise if DemonBruteStatus is 2:  [cuntboy demon brute]
				say "     Watching David move to the far side of the underground room, you notice the demon brute fidgeting besides you. Turning, you see the pussy between his legs, its lips open and swollen in arousal, moisture glistening on them. Your pet's eyes follow David and he sniffs the air through his slit-like nostrils, a pleased rumble going through his chest. His left hand moves to his crotch as if to grab his nonexistent cock and he snarls as he is reminded of you modifying his body. Quite a reaction... curious what prompted it so instantly, you ask the brute to explain himself.";
				say "     Looking over to you, the demon grumbles. 'That one has felt the touch of the Infernal Legion - I can smell is fear.' At that, he pulls in another lungful of air through his nose and you can see droplets of female juices drip out of his pussy - much to the demon's chagrin as he looks down at his crotch. He moves his claws over his chest, at the approximate positions where David had bloody slashes from the other demon on your first meeting 'He is marked to be a Bal'ssh'avizatz'gul's slave, but can still walk without hobbling, so he hasn't been taken properly. I WANT him as mine!' His eyes flash brightly and his gaze bores into yours. 'I'll flay you alive for gelding me and taking this chance away when I finally get free.'";
				say "     [line break]";
				say "     Chuckling at the demon brute making threats even though he's yours to command, you grasp your demontooth amulet and whisper the command word, banishing him inside. Enough of this, for now.";
				now libido of David is 1;  [first-time fright scene resolved]
				[ 
				Revenge fuck path: 
				"- though a new image appears before your mental eye... seeing your demon brute pet on the ground, David pounding into his pussy in a revenge-fuck. That would surely show the demon his place and get David over his fear.";
				say "     Shaking your head softly to shake off the vision, you wonder if that's really such a good idea.";
				if player consents:	[prep the revenge fuck by David]
					say "     Well, the demon brute certainly deserves it. You decide to bring it up with David later when you talk to him again.";
					now libido of David is 89;  [open up the 'revenge fuck' in David's code]
				otherwise:  [nope]
					say "     Better not - who knows how David would react if you suggested this to him.";
					now libido of David is 1;   [first-time fright scene resolved]
				]
		otherwise if DBCaptureQuestVar > 5 and DBCaptureQuestVar < 99:	[cleansed brute]
			say "     As you enter the bunker with your demon brute pet in tow and David spots it, he jumps up from where he was sitting on one of the many cots and shouts 'Watch out, there's a dem...', then suddenly falls silent as he realizes the big creature is following you obediently. 'What the fuck?' he says, still a bit shocked and wide-eyed. Introducing Brutus to him, you explain that while he is a demon, you cleansed him of his inner evil.";
			if DemonBruteStatus is 2:		[female]
				say "     A somewhat doubtful expression on his face, David nods to you, then looks up as he notices the demon's eyes fixed on him in an intense stare. 'Why is he looking at me like that?' he asks, followed by him dropping his gaze down to Brutus crotch, where the demon's pussy looks pretty aroused and moist at the moment. Shaking his head vehemently and looking back to you, David says 'Just keep him away from me please. I don't want to be reminded of what happened in that bar.' With that, David grips his books tightly and goes up into the library for a while. Brutus follows him with a curious, interested gaze. When he looks down to his crotch afterwards, an uncomfortable, even ashamed, look comes over his face.";
			otherwise:  [male+herm]
				say "     A somewhat doubtful expression on his face, David nods to you, then looks up as he notices the demon's eyes fixed on him in an intense stare. 'Why is he looking at me like that?' he asks, followed by him dropping his gaze down to Brutus crotch, where the demon's massive, veined shaft gives a small, but noticeable throb. Shaking his head vehemently and looking back to you, David says 'Just keep him away from me please. I don't want to be reminded of what happened in that bar.' With that, David grips his books tightly and goes up into the library for a while. Brutus follows him with a curious, interested gaze. When he looks down to his cock, partly erect now, an uncomfortable, even ashamed, look comes over his face.";
			say "     What is this about? Maybe you should ask Brutus about it sometime...";
			now libido of David is 50;  [met the cleansed Brutus, noticed him staring]
	otherwise if libido of David is 1:  [saw the evil brute with the player before]
		if DBCaptureQuestVar is 5 and a random chance of 4 in 10 succeeds: [repeat for the original, evil Brutus]
			say "     As you enter the bunker with your demon brute pet in tow, you run into David who was just on his way up into the library with a stack of books in his hands. The demon growls at David, chuckling as the young soldier flinches away from him and drops several of the books - at least until you order the enslaved demon to shut up. Eying the large creature with a frightened expression, David says to you 'Why do you keep that thing around all the time? Can't you... have it wait for you outside the library or something?' Then he picks up his books and quickly climbs the stairs, only returning about twenty minutes later with some new ones.";
		otherwise if DBCaptureQuestVar > 5 and DBCaptureQuestVar < 99:	[first meeting with the cleansed brute]
			say "     As you enter the bunker with Brutus in tow, you run into David who was just on his way up into the library with a stack of books in his hands. The young soldier stops in his tracks, eyes widening as he takes in the demon standing obediently behind you. Seeing that Brutus is under control and not about to attack or anything, David asks 'Is that the same thing you brought with you before? It looks... different, doesn't it? No longer snarling all the time too.' You tell him that your companion now has a name - Brutus - and that he is indeed the same demon, which you cleansed of his inner evil.";
			if DemonBruteStatus is 2:		[female]
				say "     A somewhat doubtful expression on his face, David nods to you, then looks up as he notices the demon's eyes fixed on him in an intense stare. 'Why is he looking at me like that?' he asks, followed by him dropping his gaze down to Brutus crotch, where the demon's pussy looks pretty aroused and moist at the moment. Shaking his head vehemently and looking back to you, David says 'Just keep him away from me please. I don't want to be reminded of what happened in that bar.' With that, David grips his books tightly and goes up into the library for a while. Brutus follows him with a curious, interested gaze. When he looks down to his crotch afterwards, an uncomfortable, even ashamed, look comes over his face.";
			otherwise:  [male+herm]
				say "     A somewhat doubtful expression on his face, David nods to you, then looks up as he notices the demon's eyes fixed on him in an intense stare. 'Why is he looking at me like that?' he asks, followed by him dropping his gaze down to Brutus crotch, where the demon's massive, veined shaft gives a small, but noticeable throb. Shaking his head vehemently and looking back to you, David says 'Just keep him away from me please. I don't want to be reminded of what happened in that bar.' With that, David grips his books tightly and goes up into the library for a while. Brutus follows him with a curious, interested gaze. When he looks down to his cock, partly erect now, an uncomfortable, even ashamed, look comes over his face.";
			say "     What is this about? Maybe you should ask Brutus about it sometime...";
			now libido of David is 50;  [met the cleansed Brutus, noticed him staring]
	otherwise if libido of David is 50:		[saw the cleansed Brutus with the player before]
		if DBCaptureQuestVar > 5 and DBCaptureQuestVar < 99 and a random chance of 4 in 10 succeeds:	[repeat meeting with the cleansed brute]
			if DemonBruteStatus is 2:		[female]
				say "     As you enter the bunker with your demon brute companion in tow, you run into David who was just on his way up into the library with a stack of books in his hands. After flinching slightly in the first moment he sees the large creature, David grips his books tightly, quickly passing you as he continues going up into the library for a while. Brutus follows him with a curious, interested gaze. When he looks down to his crotch afterwards, which shows his pussy being pretty moist and aroused, an uncomfortable, even ashamed, look comes over his face.";
			otherwise:  [male+herm]
				say "     As you enter the bunker with your demon brute companion in tow, you run into David who was just on his way up into the library with a stack of books in his hands. After flinching slightly in the first moment he sees the large creature, David grips his books tightly, quickly passing you as he continues going up into the library for a while. Brutus follows him with a curious, interested gaze. When he looks down to his cock afterwards, which went slightly hard, an uncomfortable, even ashamed, look comes over his face.";
			say "     What is this about? Maybe you should ask Brutus about it sometime...";
	otherwise if libido of David is 51:  [Brutus wants to check David out, told the player]
		if a random chance of 4 in 10 succeeds:  [repeat urging to look at David]
			say "     As you enter the bunker with your demon brute companion in tow, you see David, sitting on his bed as he so often does, reading. Brutus gives him an intense look, then turns to you. 'I must see his scars, please Master. There is a possibility that his attacker has put the seal of enslavement on his body.' Looking down again, he continues silently '...if that's the case, I'm not shaming my Master after all.' and goes back to his usual tone 'But the soldier would be in danger!'";
	otherwise if libido of David is 52:	 [Brutus hurt himself when removing the enslavement mark - first meeting afterwards]
		say "     As you enter the bunker with your demon brute companion in tow, David immediately comes over to ask how Brutus is doing. He is visibly relieved when the demon shows him his fully healed hand. Turning into smoke and back regularly means that he has lots of practice in reassembling himself after all. David nods, then falls silent for a moment, thinking. He pulls you aside out of earshot of your demon companion before asking 'Did you order him to do it? Did you... know it would hurt him?' Both of those questions you truthfully say no to, recounting Brutus shameful admission of certain... urges, then him pleading to look at David. 'So it was all him? That's... quite something. For a demon.' He rubs his side where the demonic seal once was hidden, biting his lip before he continues. 'Could I... talk to him sometime?'";
		say "     [WaitLineBreak]";
		say "     Why wait - you call Brutus over. David walks up to him, putting a hand on his muscled arm. 'I wanted to thank you again for dealing with that evil symbol. It was... unexpected, for you to take such a risk for me.' Then he holds out his hand to Brutus, offering it to him. 'So... friends?' The demon looks down at him nonplussed for a second as he tries to come up with a response to a topic that hasn't been part of his life for eons - then he exuberantly shakes the smaller human's hand and pulls him into an embrace.";
		if DemonBruteStatus is 2: [female]
			say "     They stay in that tight hug for a moment, David pressed against Brutus chest, his arms not even close long enough to reach around the demon's wide chest. Then suddenly, Brutus clears his throat, his face taking on an interesting shade of embarrassed purple as he lets the young soldier in his arms go. As David steps away, you see the demon's pussy in a quite aroused state, its lips swollen, a wet spot on David's clothing where he must have been pressed right against it. With you standing right next to them, both the soldier and the demon seem to come to the decision to ignore the last bit at the same time, resulting in a somewhat awkward 'See ya.' and 'Sure, friend.'";
		otherwise:   [male+herm]	
			say "     They stay in that tight hug for a moment, David pressed against Brutus chest, his arms not even close long enough to reach around the demon's wide chest. Then suddenly, Brutus clears his throat, his face taking on an interesting shade of embarrassed purple as he lets the young soldier in his arms go. As David steps away, you see the demon's cock in a quite aroused state, hanging where it must have pressed right against David. With you standing right next to them, both the soldier and the demon seem to come to the decision to ignore the last bit at the same time, resulting in a somewhat awkward 'See ya.' and 'Sure, friend.'";
		now libido of David is 53;
	otherwise if libido of David is 53:  [David thanked Brutus after he got hurt - some attraction here]
		if a random chance of 4 in 10 succeeds: [40% chance]
			let bonus be (( the Perception of the player minus 10 ) divided by 2);
			let diceroll be a random number from 1 to 20;
			increase diceroll by bonus;
			if a random chance of 1 in 2 succeeds:  [David watches Brutus - perceptive players notice his looks linger on Brutus naked body]
				say "     As you walk into the bunker with Brutus in tow, you see David [one of]sitting on his bed, reading[or]sorting through his supplies[or]writing in a notebook[at random]. The young soldier looks up as he notices you, greeting you and your demon companion with a smile and a wave. [if diceroll > 15]Perceptive as you are, you notice that David's gaze lingering on Brutus muscular chest, then wandering lower to the large demon's crotch. The young man bites his lip, then suddenly realizes you're watching him stare at Brutus and looks back down, embarrassment giving him reddened cheeks.[end if]";
			otherwise:   [Brutus is more obvious - just stands and stares]
				say "     As you walk into the bunker with Brutus in tow, you see David [one of]just getting up after taking a rest[or]pull out some clean clothes out of his bag[or]walk to his bed half-dressed after freshening up[at random], his back turned to you. Walking along to the open area in the middle of the bunker, you notice the presence of Brutus missing from where he always walks along - behind your shoulder on the right side. Turning around, you find the demon still standing at the entrance, busy watching the young soldier pulling on a new pair of pants. There seems to be some interest for David in him, judging from [if DemonBruteStatus is 0 or DemonBruteStatus is 1]his semi-hard and throbbing member[otherwise]soon drippingly wet pussy[end if]. As you're still deciding if you should say something, Brutus notices you looking at him and hurries after you, taking his usual place with a murmured 'Sorry, master.'";
	otherwise if libido of David is 54:  [they've had some fun together]
		if a random chance of 4 in 10 succeeds: [40% chance]
			if a random chance of 1 in 2 succeeds:  [David greets the player and Brutus]
				say "     As you walk into the bunker with Brutus in tow, you run into David just on his way up to the library to return a book and grab a new one. He gives the both of you a friendly smile, greeting you and giving Brutus a clap on the arm, squeezing it affectionately as he says 'Nice to see you, big guy.' Then he moves on, walking up the stairs and returning some time later with something new to read.";
			otherwise:   [Brutus is rather more obvious]
				say "     As you walk into the bunker with Brutus in tow, the large demon makes a beeline for David, who was just [one of]reading a book[or]sorting through his supplies[or]cleaning his weapon[or]making his bed[or]folding his clothes[at random]. With a loud 'Hello, my friend!' he pulls the young soldier into a tight embrace, the smaller human pressed against his muscled chest. Watching them, you notice the demon's hand cupping David's ass as he holds him. Putting the man down a moment later, Brutus walks back to you and takes his usual place - behind your shoulder on the right side.";
				
to say DavidEricTalk:
	if hp of Eric is 1 or hp of Eric is 20:		[gender not addressed yet, or Eric waiting for a cure]
		say "     '...and then, as I was bandaging my arm, I felt this wrenching pain in my gut and passed out. When I came back to I was...' Eric waves a hand at his crotch. 'You know. Different.' David nods in silent understanding and puts a hand on Eric's shoulder. 'I don't believe I can understand what you went through, but... look at it from this point - you're still a human, good-looking guy and above all still have your own mind. You should see some of the infected out there, behaving like beasts. So what if you're female down below now - that's not all that defines you...' Eric gets a thoughtful expression, then bites his lip before... whispering something.";
		say "     Standing there, craning your head to maybe catch his words, you suddenly realize how ridiculous you must look - and that it's not a good thing to spy on friends. Not wanting to listen in any more than you already have, you go to the other side of the room and busy yourself by counting and sorting your supplies.";
		say "     [WaitLineBreak]";
		say "     Quite a while later, now knowing exactly how many blankets and other things are in the bunker, you turn back to the bunks and see that your two friends are still sitting there, now seemingly in much higher spirits. David gestures wildly and says '...it really was this big, a massive brute of a thing. I had no chance, until...' he spots you and smiles, waving you closer to them 'Hi there, we're just regaling each other with tales of your heroics - kicking demon butt and taking down green cheerleaders. Thanks to your timely intervention, both of us are hanging around here now in nice company, instead of getting buggered by who knows what.' Both of them smile at you and invite you to sit with - or rather between - them. Then Eric starts another story, this time about fight against the incubus and succubus you two met while on the campus...";
		say "     [line break]";
		say "     Being on a bunk with David on one side and Eric on the other makes your thoughts wander a bit, imagining what it would be like to do... other things on a bed together. From what you can see, they like each other and might possibly be down for it... though you should surely first sort out Eric's gender issues. Bringing up fun with David up before he's really comfortable in his skin wouldn't be a good idea.";
	if hp of Eric is 10 or hp of Eric is 11:	[Eric talked into accepting his female parts or already fucked]
		say "     '...and then, as I was bandaging my arm, I felt this wrenching pain in my gut and passed out. When I came back to I was...' Eric waves a hand at his crotch. 'You know. Different.' David nods in silent understanding and puts a hand on Eric's shoulder. 'I don't believe I can understand what you went through, but... look at it from this point - you're still a human, good-looking guy and above all still have your own mind. You should see some of the infected out there, behaving like beasts. So what if you're female down below now - that's not all that defines you...' Eric gets a thoughtful expression, then bites his lip before... whispering something.";
		say "     Standing there, craning your head to maybe catch his words, you suddenly realize how ridiculous you must look - and that it's not a good thing to spy on friends. Not wanting to listen in any more than you already have, you go to the other side of the room and busy yourself by counting and sorting your supplies.";
		say "     [WaitLineBreak]";
		say "     Quite a while later, now knowing exactly how many blankets and other things are in the bunker, you turn back to the bunks and see that your two friends are still sitting there, now seemingly in much higher spirits. David gestures wildly and says '...it really was this big, a massive brute of a thing. I had no chance, until...' he spots you and smiles, waving you closer to them 'Hi there, we're just regaling each other with tales of your heroics - kicking demon butt and taking down green cheerleaders. Thanks to your timely intervention, both of us are hanging around here now in nice company, instead of getting buggered by who knows what.' Both of them smile at you and invite you to sit with - or rather between - them. Then Eric starts another story, this time about fight against the incubus and succubus you two met while on the campus...";
		say "     [line break]";
		say "     Being on a bunk with David on one side and Eric on the other makes your thoughts wander a bit, imagining what it would be like to do... other things on a bed together. From what you can see, they like each other and might possibly be down for it... [if hp of Eric is 10]though for now, it would be best if you spent some time with Eric first and took his virginity. Pushing sex with someone he barely knows on Eric might otherwise put him back into denying his new gender.[otherwise if hp of Eric is 11]Eric should be comfortable enough with sex now to be open for some fun - as long as you're part of it. It's worth a try to talk to him about it.[end if]";
	otherwise if hp of Eric is 21 or hp of Eric is 22 or hp of Eric is 31 or hp of Eric is 32:	[horse/satyr hung Eric]
		say "     '...and then, as I was bandaging my arm, I felt this wrenching pain in my gut and passed out. When I came back to I was...' Eric waves a hand at his crotch. 'You know. Different. And when we tried to fix me later, it made me part [if hp of Eric is 21 or hp of Eric is 22]horse[otherwise if hp of Eric is 31 or hp of Eric is 32]goat-man[end if].' David nods in silent understanding and puts a hand on Eric's shoulder. 'I don't believe I can understand what you went through, but... look at it from this point - you're still a human, good-looking guy and above all still have your own mind. You should see some of the infected out there, behaving like beasts. So what if you're different now down below - that's not all that defines you...' Eric gets a thoughtful expression, then bites his lip before... whispering something.";
		say "     Standing there, craning your head to maybe catch his words, you suddenly realize how ridiculous you must look - and that it's not a good thing to spy on friends. Not wanting to listen in any more than you already have, you go to the other side of the room and busy yourself by counting and sorting your supplies.";
		say "     [WaitLineBreak]";
		say "     Quite a while later, now knowing exactly how many blankets and other things are in the bunker, you turn back to the bunks and see that your two friends are still sitting there, now seemingly in much higher spirits. David gestures wildly and says '...it really was this big, a massive brute of a thing. I had no chance, until...' he spots you and smiles, waving you closer to them 'Hi there, we're just regaling each other with tales of your heroics - kicking demon butt and taking down green cheerleaders. Thanks to your timely intervention, both of us are hanging around here now in nice company, instead of getting buggered by who knows what.' Both of them smile at you and invite you to sit with - between - them. Then Eric starts another story, this time about fight against the incubus and succubus you two met while on the campus...";
		say "     [line break]";
		say "     Being on a bunk with David on one side and Eric on the other makes your thoughts wander a bit, imagining what it would be like to do... other things on a bed together. From what you can see, they like each other and might possibly be down for it... [if lust of David is 0]though you should break David's ass in first. You'll have to get the soldier used to taking it up the rear end, otherwise he'll refuse to even consider Eric's enlarged meat. [otherwise if lust of David > 0]with the pleasure you gave him by shafting his ass before, David would surely like it. [end if][if hp of Eric is 21]And Eric - it'd likely be best if you broke in the newly virgin shaft yourself first...[otherwise if hp of Eric is 22]And Eric - with how much he enjoys his new cock, you're sure he'll jump at the opportunity. You really should talk to him about it.[end if]";
	now lust of Eric is 2;

to say DavidSex1:												[player sucks him]
	if thirst of David is 0:
		if David is in Parade Ground:
			say "     Stepping up close to the young soldier, you put your arms around him and pull him in for a deep kiss before he can react. There's a look of alarm in his eyes for a second, then he accepts your tongue exploring his mouth and gives in. As you come back up for air, he stammers 'I - I shouldn't... we're not supposed to...', but quickly falls silent as you reach down and stroke the bulge in his pants. With all the minotaur pheromones in the air here, he's already half hard and pretty pliable.";
		otherwise:
			say "     Stepping up close to the young soldier, you put your arms around him and pull him in for a deep kiss before he can react. There's a look of alarm in his eyes for a second, then he accepts your tongue exploring his mouth and gives in. As you come back up for air, he stammers 'I - I shouldn't... we're not supposed to...', but quickly falls silent as you reach down and stroke his crotch, a bulge quickly forming in his pants. Not getting any relief except rushed masturbation in the weeks and months since the outbreak started, Private Jackson is like putty in your hands, his horny body telling him to go along with anything you want.";
		say "     Kneeling down in front of him, you undo David's zipper and pull out his cock, making the man moan as you handle his erect manhood. Stroking up and down on his shaft, you have him rock-hard in no time, then move your head forward a bit and lick over the tip. Next you take his cock into your mouth, and start bobbing up and down on it, while David groans and murmurs things like 'So good...' and 'You're a lot better than...'";
		say "     You give the young soldier a long and amazing blow-job, keeping at it until he suddenly shouts 'I'm coming!' and starts to shoot strings of cum into your mouth. You wait till he stops twitching and the last spurt of semen leaves his cock, then stand up and start making out with him, smiling inwardly as you push some of his own cum in David's mouth with your tongue to give him a taste.'";
		say "     [WaitLineBreak]";
		say "     As he comes down from the rush of orgasm a while later and David's brain starts working again, he pants 'Wow, you're better than... Oh!' with a guilty expression suddenly shadowing his face. 'I got a girlfriend - and now I've cheated on her having oral sex! What will she say when I get back home? I - you...'";
		say "     Pulling his mouth to yours for another quick kiss, you tell him to calm down and that his girlfriend surely won't learn about you two once he goes back to her when this is all over. What happens in this city stays in the city. Unless of course you can make him fully yours to keep, you think to yourself...";
	otherwise:
		if David is in Parade Ground:
			say "     Stepping up close to the young soldier, you put your arms around him and pull him in for a deep kiss, then feel the bulge in his pants. With all the minotaur pheromones in the air here, he's already half hard. As you pull away to get some air, you moan 'Let me take care of that for you.', getting an eager nod from David as answer.";
		otherwise:
			say "     Stepping up close to the young soldier, you put your arms around him and pull him in for a deep kiss, then let your hands wander down to his crotch. Through the fabric you feel his manhood already filling out, as his body reacts to you kiss and touch.";
		say "     Kneeling down in front of him, you undo David's zipper and pull out his cock, making the man moan as you handle his erect manhood. Stroking up and down on his shaft, you have him rock-hard in no time, then move your head forward a bit and lick over the tip. Next you take his cock into your mouth, and start bobbing up and down on it, while David groans and murmurs things like 'So good...' and 'You're a lot better than...'";
		say "     You give the young soldier a long and amazing blow-job, keeping at it until he suddenly shouts 'I'm coming!' and starts to shoot strings of cum into your mouth. You wait till he stops twitching and the last spurt of semen leaves his cock, then stand up and start making out with him, smiling inwardly as you push some of his own cum in David's mouth with your tongue to give him a taste.'";
		say "     [WaitLineBreak]";
		if thirst of David is 10:						[fuck buddy]
			say "     As he comes down from the rush of orgasm a while later and David's brain starts working again, he pants 'Wow, you're better than Ann. Best fuck-buddy ever. I'll miss you when I'm back with her.'";
		otherwise if thirst of David is 20:	[boy/girlfriend]
			say "     As he comes down from the rush of orgasm a while later and David's brain starts working again, he pants 'You're better than Ann ever was. I love having you as my [if cocks of player > 0]boyfriend[otherwise]girlfriend[end if].'";
		otherwise:   												[worrying about cheating on his girlfriend]
			say "     As he comes down from the rush of orgasm a while later and David's brain starts working again, he pants 'Wow, you're better than Ann.' with a somewhat guilty expression. 'And I've just cheated on her - again!'";

to say DavidSex2:							[he sucks the player]
	if David is in Parade Ground:
		say "     Stepping up close to the young soldier, you put your arms around him and pull him in for a deep kiss, then feel the bulge in his pants. With all the minotaur pheromones in the air here, he's already half hard.";
	otherwise:
		say "     Stepping up close to the young soldier, you put your arms around him and pull him in for a deep kiss, then let your hands wander down to his crotch. Through the fabric you feel his manhood already filling out, as his body reacts to you kiss and touch.";
		say "     Pulling back from David, you quickly strip off your clothes and sit at the edge of one of the nearby bunk beds. Holding out your hard [cock of player] manhood, you wave him closer and tell the young soldier to suck you off. [if lust of David is 1]He just stands there for a moment, staring at your cock until you say 'Come on, you liked getting fucked with it, didn't you? Just give it a try...' then steps up and kneels between your legs.[otherwise]He smiles at you, licking his lips, then steps up and kneels between your legs.[end if]";
	say "     Taking hold of your cock, the young soldier holds it up and licks along the shaft before taking the tip in his mouth. You put your hands on his head and softly push it down on your cock, helping him to get into sucking on it. Soon you have him bobbing up and down on your manhood, with his lips tight around the shaft. [if lust of David is 1]Even though it's his first blow-job, he's pretty good at it, knowing how to handle a cock from being a man himself.[otherwise]He's very eager to please you, even trying to deep-throat you once or twice.[end if]";
	say "     Before too much longer, you feel the need to cum rise in your balls and say 'I'm close, suck me harder.' [if lust of David is 0]You pull his head against your crotch as you start shooting, spurt after spurt of your seed filling his hot mouth.[otherwise]He pushes your cock into his mouth all the way as you orgasm, making you shoot directly down his throat and into his stomach.";
	say "     [WaitLineBreak]";
	if thirst of David is 10:							[fuck buddy]
		say "     After softly sucking on your cock a bit more, David pulls it out of his mouth and looks up at you, saying 'How was that, fuck-buddy?'";
	otherwise if thirst of David is 20:		[boy/girlfriend]
		say "     After softly sucking on your cock a bit more, David pulls it out of his mouth and looks up at you with a smile. Then he moves up and pushes you back to lie on the bunk so you can make out. 'You're amazing. I love having you as my boyfriend.'";
	otherwise:    												[worrying about cheating on his girlfriend]
		say "     After softly sucking on your cock a bit more, David pulls it out of his mouth and looks up at you, saying 'Cock-sucking isn't so bad - I somehow even like the taste of cum. Ann always said it tastes horrible.' with a somewhat guilty expression.";
	now lust of David is 2;

to say DavidSex3:												[player pussy fucked]
	setmonster "human";
	choose row monster from the table of random critters;
	if thirst of David is 0:							[first time]
		if David is in Parade Ground:
			say "     Stepping up close to the young soldier, you put your arms around him and pull him in for a deep kiss before he can react. There's a look of alarm in his eyes for a second, then he accepts your tongue exploring his mouth and gives in. As you come back up for air, he stammers 'I - I shouldn't... we're not supposed to...', but quickly falls silent as you reach down and stroke the bulge in his pants. With all the minotaur pheromones in the air here, he's already half hard and pretty pliable.";
		otherwise:
			say "     Stepping up close to the young soldier, you put your arms around him and pull him in for a deep kiss before he can react. There's a look of alarm in his eyes for a second, then he accepts your tongue exploring his mouth and gives in. As you come back up for air, he stammers 'I - I shouldn't... we're not supposed to...', but quickly falls silent as you reach down and stroke his crotch, a bulge quickly forming in his pants. Not getting any relief except rushed masturbation in the weeks and months since the outbreak started, Private Jackson is like putty in your hands, his horny body telling him to go along with anything you want.";
		say "     As you make out with him some more, you slide your hands under his shirt and feel your way up his hard-muscled chest, then pull the fabric up and over his head. Leaning down a bit you run your tongue over his nipples, playfully sucking on first one, then the other. From David's lustful moans, he's ready for the real thing.";
		say "     Opening up the zipper of his pants and letting them drop down, you free his raging hard-on, standing proudly erect in your direction. Quickly stripping off your own clothes, you grab David and pull him with you to one of the nearby bunks, lying down with him on top of you.";
		say "     [WaitLineBreak]";
		say "     It only takes a helping hand guiding his rod to your pussy lips for the young man's instincts to kick in and his hips plunge downward, thrusting his hard manhood deep into your vagina. He fucks you with smooth strokes, making you moan with the feelings as his shaft hits just the right spots inside you. You run your hands over his chest, feeling his muscles while your legs wrap around his hips to pull him even deeper with each of his thrusts. Soon he speeds up even more, groaning louder and louder as he gets closer to orgasm.";
		say "     Then he shouts 'I'm coming!' and you feel a shudder run through his body as the first blast of his human cum shoots deep inside your body. You pull him down on top of you, hugging him close and kissing him as his cock twitches again and again, filling you to the brink with his fertile seed.[fimpregchance]";
		say "     [line break]";
		say "     You lay there for a while, entwined and kissing, with his slowly softening cock still inside you. As both of you come down from the rush of sex and David's brain starts working again, he pants 'Wow, that was... just wow.' and you feel his manhood twitch inside you once. Then a worried look comes over his face and he adds 'But... oh no, I just cheated on my girlfriend. What will she say when I get back home. I - you...'";
		say "     Pulling his mouth to yours for a quick kiss, you tell him to calm down and that his girlfriend surely won't learn about you two once he goes back to her when this is all over. What happens in this city stays in the city. Unless of course you can make him fully yours to keep, you think to yourself...";
	otherwise:
		if David is in Parade Ground:
			say "     Stepping up close to the young soldier, you put your arms around him and pull him in for a deep kiss, then feel the bulge in his pants. With all the minotaur pheromones in the air here, he's already half hard.";
		otherwise:
			say "     Stepping up close to the young soldier, you put your arms around him and pull him in for a deep kiss, then let your hands wander down to his crotch. Through the fabric you feel his manhood already filling out, as his body reacts to you kiss and touch.";
		say "     As you make out with him some more, you slide your hands under his shirt and feel your way up his hard-muscled chest, then pull the fabric up and over his head. Leaning down a bit you run your tongue over his nipples, playfully sucking on first one, then the other. From David's lustful moans, he's ready for the real thing.";
		say "     Opening up the zipper of his pants and letting them drop down, you free his raging hard-on, standing proudly erect in your direction. Quickly stripping off your own clothes, you grab David and pull him with you to one of the nearby bunks, lying down with him on top of you.";
		say "     [WaitLineBreak]";
		say "     It only takes a helping hand guiding his rod to your pussy lips for the young man's instincts to kick in and his hips plunge downward, thrusting his hard manhood deep into your vagina. He fucks you with smooth strokes, making you moan with the feelings as his shaft hits just the right spots inside you. You run your hands over his chest, feeling his muscles while your legs wrap around his hips to pull him even deeper with each of his thrusts. Soon he speeds up even more, groaning louder and louder as he gets closer to orgasm.";
		say "     Then he shouts 'I'm coming!' and you feel a shudder run through his body as the first blast of his human cum shoots deep inside your body. You pull him down on top of you, hugging him close and kissing him as his cock twitches again and again, filling you to the brink with his fertile seed.[fimpregchance]";
		say "     [line break]";
		if thirst of David is 10:  						[fuck buddy]
			say "     You lay there for a while, entwined and kissing, with his slowly softening cock still inside you. As both of you come down from the rush of sex, he pants 'Wow, that was... just wow.' and you feel his manhood twitch inside you once. 'You're an amazing fuck-buddy, you know. I'll miss you after all this is over.'";
		otherwise if thirst of David is 20:  	[boy/girlfriend]
			say "     You lay there for a while, entwined and kissing, with his slowly softening cock still inside you. As both of you come down from the rush of sex, he pants 'Wow, that was... just wow.' and you feel his manhood twitch inside you once. 'I love having you as my [if cocks of player > 0]boyfriend[otherwise]girlfriend[end if]. You're just amazing.' he says and gives you another deep kiss.";
		otherwise:    												[worrying about cheating on his girlfriend]
			say "     You lay there for a while, entwined and kissing, with his slowly softening cock still inside you. As both of you come down from the rush of sex and David's brain starts working again, he pants 'Wow, that was... just wow.' and you feel his manhood twitch inside you once. Then a worried look comes over his face and he adds 'But... I just cheated on Ann - again!'";

to say DavidSex4:												[player ass fucked]
	setmonster "human";
	choose row monster from the table of random critters;
	if David is in Parade Ground:
		say "     Stepping up close to the young soldier, you put your arms around him and pull him in for a deep kiss, then feel the bulge in his pants. With all the minotaur pheromones in the air here, he's already half hard.";
	otherwise:
		say "     Stepping up close to the young soldier, you put your arms around him and pull him in for a deep kiss, then let your hands wander down to his crotch. Through the fabric you feel his manhood already filling out, as his body reacts to you kiss and touch.";
	say "     As you make out with him some more, you slide your hands under his shirt and feel your way up his hard-muscled chest, then pull the fabric up and over his head. Leaning down a bit you run your tongue over his nipples, playfully sucking on first one, then the other. From David's lustful moans, he's ready for the real thing.";
	say "     Opening up the zipper of his pants and letting them drop down, you free his raging hard-on, standing proudly erect in your direction. Quickly stripping off your own clothes, you push David to lie on one of the nearby bunks, then climb on top of him, straddling his hips.";
	say "     [WaitLineBreak]";
	say "     Reaching back to hold his hard cock up, you push it against your hole, then slowly sink your ass down, impaling yourself on his manhood. David moans 'So tight.' as his shaft goes deeper into your tightly gripping asshole, his hands holding on to and stroking your hips. Then he bottoms out in you and you can feel a pleasant fullness and the warmth of his crotch against your buns. You stay still for a moment to revel in the feeling, then start sliding up and down on the hard shaft.";
	say "     Fucking yourself on his cock, you make David moan and gasp under you, holding on tight to sides of the bunk. Then, after a while, you pull off him with a slight *plop* and say 'Your turn on top - fuck me hard and deep.' Laying down next to him, you give him a quick kiss, then spread your legs and wiggle your ass invitingly.";
	say "     Without hesitation, he moves to kneel behind you, then sets the tip of his hard cock against your pucker and plunges in. The young soldier fucks you hard and fast, grinding his hips against your ass and moaning into your ear with his arms around your chest. With each frenzied thrust you move closer to orgasm, and soon you're pushed over the brink, spraying your seed into the bedsheets below you. Your anal muscles twitching and tightening around his cock with each burst of your cum, David joins you in orgasm, flooding your insides with his human seed.[mimpregchance]";
	say "     [line break]";
	if thirst of David is 10:  						[fuck buddy]
		say "     You lay there for a while, with him resting on your back and his slowly softening cock still inside you. As both of you come down from the rush of sex, he pants 'Nice ass, it's really tight' and you feel his manhood twitch inside you once. 'You're an amazing fuck-buddy, you know. I'll miss you after all this is over.'";
	otherwise if thirst of David is 20:  	[boy/girlfriend]
		say "     You lay there for a while, with him resting on your back and his slowly softening cock still inside you. As both of you come down from the rush of sex, he pants 'Wow, that was... just wow.' and you feel his manhood twitch inside you once. 'I love having you as my [if cocks of player > 0]boyfriend[otherwise]girlfriend[end if]. You're just amazing.' he says and slides over to lie beside you, giving you another deep kiss.";
	otherwise:    												[worrying about cheating on his girlfriend]
		say "     You lay there for a while, with him resting on your back and his slowly softening cock still inside you. As both of you come down from the rush of sex and David's brain starts working again, he pants 'Wow, that was... just wow.' and you feel his manhood twitch inside you once. Then a worried look comes over his face and he adds 'But... I just cheated on Ann - again!'";

to say DavidSex5:												[David ass fucked]
	if thirst of David is 0:							[first time]
		if David is in Parade Ground:
			say "     Stepping up close to the young soldier, you put your arms around him and pull him in for a deep kiss before he can react. There's a look of alarm in his eyes for a second, then he accepts your tongue exploring his mouth and gives in. As you come back up for air, he stammers 'I - I shouldn't... we're not supposed to...', but quickly falls silent as you reach down and stroke the bulge in his pants. With all the minotaur pheromones in the air here, he's already half hard and pretty pliable.";
		otherwise:
			say "     Stepping up close to the young soldier, you put your arms around him and pull him in for a deep kiss before he can react. There's a look of alarm in his eyes for a second, then he accepts your tongue exploring his mouth and gives in. As you come back up for air, he stammers 'I - I shouldn't... we're not supposed to...', but quickly falls silent as you reach down and stroke his crotch, a bulge quickly forming in his pants. Not getting any relief except rushed masturbation in the weeks and months since the outbreak started, Private Jackson is like putty in your hands, his horny body telling him to go along with anything you want.";
	otherwise:														[already had some sex]
		if David is in Parade Ground:
			say "     Stepping up close to the young soldier, you put your arms around him and pull him in for a deep kiss, then feel the bulge in his pants. With all the minotaur pheromones in the air here, he's already half hard.";
		otherwise:
			say "     Stepping up close to the young soldier, you put your arms around him and pull him in for a deep kiss, then let your hands wander down to his crotch. Through the fabric you feel his manhood already filling out, as his body reacts to you kiss and touch.";
	say "     As you make out with him some more, you slide your hands under his shirt and feel your way up his hard-muscled chest, then pull the fabric up and over his head. Leaning down a bit you run your tongue over his nipples, playfully sucking on first one, then the other. From David's lustful moans, he's ready for the real thing.";
	if lust of David is 0:								[anal virgin]
		say "     Opening up the zipper of his pants and letting them drop down, you free his raging hard-on, standing proudly erect in your direction. Quickly stripping off your own clothes, you give him another quick kiss on the lips, then spin him around and push him towards one of the nearby bunks.";
		say "     [WaitLineBreak]";
		say "     With a moaned 'On all fours', you guide him onto the mattress, then pull his ass up a bit as you kneel behind him. You rub your rock-hard [cock of player] cock up and down between the round buns of his bubble butt, then lean over him and whisper 'I'm gonna fuck you now' in his ear. As horny as you've gotten him, he doesn't protest and just moans as you bring the tip of your cock to his tight opening. Pushing forward with increasing pressure, David's pucker resists you for a moment, then opens up and allows your cockhead to slide into the tight embrace of his ass. It's virgin territory for sure you're exploring here - and from his lust-filled groans as you slowly slide deeper into him, you're being very well received.";
		say "     As you bottom out inside his ass, you give his cock a few strokes, then move your hands back to his hips. Holding on tightly, you start pulling out almost all the way and hammering your shaft back inside him in quick deep strokes, filling the [if David is in Bunker]room [otherwise]tent [end if]with slapping noises as your hips meet his butt. His tightly gripping hole feels just amazing around your thrusting member, filling you with ecstasy as you very thoroughly take his virginity.";
		say "     Getting shafted like this soon drives your handsome Private over the edge, his cock spraying a huge load of cum all over the bedsheets under him. David's ass muscles quiver and flex with each shot of seed erupting from his cock, giving you all new sensations as you move in and out of him. Then it's your turn, and with one final deep thrust you push inside David all the way and fill his insides with spurt after spurt of warm seed.";
		now lust of David is 1;
	otherwise:														[repeat anal]
		say "     Opening up the zipper of his pants and letting them drop down, you free his raging hard-on, standing proudly erect in your direction. Quickly stripping off your own clothes, you give him another quick kiss on the lips and say 'Let's fuck.'";
		say "     [WaitLineBreak]";
		say "     Eager to get fucked, David gets on the next bunk on all fours, invitingly wiggling his ass at you. You kneel behind him and rub your rock-hard [cock of player] cock up and down between the round buns of his bubble butt, then lean over him and kiss is neck. He moans as you bring the tip of your cock to his tight opening and tease him a bit with it. Pushing forward with increasing pressure, David's pucker resists you for a moment, then opens up and allows your cockhead to slide into the tight embrace of his ass. He's still tight as he was when you took his virginity and giving lust-filled groans as you slowly slide deeper into him.";
		say "     As you bottom out inside his ass, you give his cock a few strokes, then move your hands back to his hips. Holding on tightly, you start pulling out almost all the way and hammering your shaft back inside him in quick deep strokes, filling the [if David is in Bunker]room [otherwise]tent [end if]with slapping noises as your hips meet his butt. His tightly gripping hole feels just amazing around your thrusting member, filling you with ecstasy as you give him a good fucking.";
		say "     Getting shafted like this soon drives your handsome Private over the edge, his cock spraying a huge load of cum all over the bedsheets under him. David's ass muscles quiver and flex with each shot of seed erupting from his cock, giving you all new sensations as you move in and out of him. Then it's your turn, and with one final deep thrust you push inside David all the way and fill his insides with spurt after spurt of warm seed.";
	say "     [WaitLineBreak]";
	if thirst of David is 10:  						[fuck buddy]
		say "     You keep kneeling like that for a moment, with your arms around his chest from behind and still connected through your dick in his ass. As both of you come down from the rush of sex, he pulls off your cock and sits next to you on the bed. 'Incredible how good having something up my ass feels. I'll have to talk Ann into getting some toys...'";
	otherwise if thirst of David is 20:  	[boy/girlfriend]
		say "     You keep kneeling like that for a moment, with your arms around his chest from behind and still connected through your dick in his ass. As both of you come down from the rush of sex, you pull out and lie on the bed with David, face to face. He smiles at you, cuddling close and gives you a kiss. 'That was amazing. You're an incredible boyfriend, you know.'";
	otherwise if thirst of David is 0:    [first time worrying]
		say "     You keep kneeling like that for a moment, with your arms around his chest from behind and still connected through your dick in his ass. As both of you come down from the rush of sex and David's brain starts working again, he looks over his shoulder at you with a questioning expression. 'I like... this,' he says and you feel his asshole tighten for a second around your member. 'Does that mean I'm gay?' With a worried look he adds 'I got a girlfriend back home, you know.'";
		say "     After giving him a playful slap on his firm buttocks as you pull out, you calm him down a bit by telling that he just might be bisexual and that he should use the opportunity to try out the whole spectrum of possible partners. The girlfriend situation will surely work itself out once he knows what he really wants. Although judging from his load all over the wall, you're pretty certain you left a lasting impression on him, opening him up more man-on-man action...";
	otherwise:    												[worrying about cheating on his girlfriend]
		say "     You keep kneeling like that for a moment, with your arms around his chest from behind and still connected through your dick in his ass. As both of you come down from the rush of sex and David's brain starts working again, he looks over his shoulder at you with a questioning expression. 'I like... this,' he says and you feel his asshole tighten for a second around your member. 'But even if I'm just Bi as you say - this is till cheating on Ann.'";


Back at the Camp is a situation. Back at the Camp is resolved.  [enabled by the 'Trickster's Masterpiece' event]
The sarea of Back at the Camp is "Outside";

when play begins:
	add Back at the Camp to badspots of guy;            [male soldiers]

lastGuardBeg is a number that varies.  lastGuardBeg is normally 555.

Instead of resolving a Back at the Camp:
	say "     Following your memory through the chaotic streets of the city, you try to find the military camp where you observed all those men taking a minotaur in the ass before. You think it was somewhere around the block you're right now, and... ah - there it is. Coming round a corner, you see the first of the olive green tents of the camp. And what you also see are two soldiers standing guard, who notice you and give you suspicious looks as they click off the safety of their rifles.";
	say "     One of them steps forward and looks at you with a grim look on his face. He calls out 'Halt, this is a restricted military zone. Move away from -' ...he's interrupted by a loud, lust-filled bellow from inside the camp and turns a bit red in the face as he looks there and back to you. 'As I was saying, move away from the perimeter. We're doing... important work here on a cure.'";
	say "     [line break]";
	say "     So, what now?";
	now sextablerun is 0;
	blank out the whole of table of fucking options;
	choose a blank row in table of fucking options;
	now title entry is "(Lie) Say you're a special agent here to check on their progress.";
	now sortorder entry is 1;
	now description entry is "Lie your way into the camp.";
	choose a blank row in table of fucking options;
	now title entry is "Ask if they can spare any supplies.";
	now sortorder entry is 2;
	now description entry is "Ask them nicely for some supplies.";
	choose a blank row in table of fucking options;
	now title entry is "Turn around and go.";
	now sortorder entry is 3;
	now description entry is "Leave the camp for now.";
	sort the table of fucking options in sortorder order;
	while sextablerun is 0:
		repeat with y running from 1 to number of filled rows in table of fucking options:
			choose row y from the table of fucking options;
			say "[link][y] - [title entry][as][y][end link][line break]";
		say "Pick the corresponding number> [run paragraph on]";
		get a number;
		if calcnumber > 0 and calcnumber <= the number of filled rows in table of fucking options:
			now current menu selection is calcnumber;
			choose row calcnumber in table of fucking options;
			say "[title entry]: [description entry][line break]";
			say "Is this what you want?";
			if player consents:
				let nam be title entry;
				clear the screen and hyperlink list;
				now sextablerun is 1;
				if (nam is "(Lie) Say you're a special agent here to check on their progress."):
					say "[GuardLie]";
				if (nam is "Ask if they can spare any supplies."):
					say "[GuardBeg]";
				if (nam is "Leave the camp for now."):
					say "[GuardLeave]";

to say GuardLie:    [lie to get into the camp]
	let bonus be (( the Intelligence of the player minus 10 ) divided by 2);
	if 2 is listed in bookcollection, increase bonus by 2;
	let diceroll be a random number from 1 to 20;
	say "You roll 1d20([diceroll])+[bonus]: [diceroll + bonus], ";
	increase diceroll by bonus;
	if diceroll is greater than 18:
		say "     You walk up to them like confidently and totally wrap them around your finger with some quick talking. In the end, they salute you before one of them leads the way to their commanding officer's tent. You pass the hitching post you saw being used before, and also the huge minotaur sitting besides it right now munching on some food.";
		attempttowait;
		say "     The commandant of the camp is Major Padgett, who stands up from his field desk to shake your hand before offering you a seat.";
		say "     'So you're the special agent sent to check out the situation? Welcome to Camp Bravo. Let me brief you about what's been happening. We were lucky enough to have a top scientist in the city when the outbreak started - a doctor Diego Garcia who contacted scouting parties I sent out. [if Diegochanged is 0]He's been infected himself so he's stuck inside the quarantine zone like all the other people when the outbreak hit. Not content to just sit and wait, he's been gathering data and looking into the infection himself. He pointed out Patient Zero for us - that large minotaur thing out in the camp - and explained the procedures necessary to gather and transport samples...' [otherwise]She's been infected herself so she's stuck inside the quarantine zone like all the other people when the outbreak hit. Not content to just sit and wait, she's been gathering data and looking into the infection herself. She pointed out patient zero for us and explained the procedures necessary to gather and transport samples...' [end if]He looks a bit embarrassed as he continues, saying 'You see, the samples can only be used if they're kept at human body temperature. So I've had to order the men to... carry the material inside their bodies to keep it valid.";
		say "     'Several detachments of soldiers are on the way to the containment barrier, but I'm running out of men rapidly. I've already had to pull people out of other camps and scouting posts. Many of the remaining soldiers are women, and considering the potency of that creature's seed, I hesitate to expose any of them to it.'";
		say "     'Please feel free to check out the camp and talk with everyone. And when you go back to report, please pass on that I need more people here to be able to send more people out with samples.'";
		move player to Major's Tent;
		now hp of Adam is 3;
		now Camp Bravo Entrance is known;
		now Back at the Camp is resolved;
	otherwise:
		say "     'Yeah, right - listen buddy, your story doesn't ring even remotely true in my ears. Get lost.' one of the soldiers scoffs at you. Can't be helped, you won't be getting any further here right now. Although there might be some hope of getting someone else on guard duty next time you come along here...";

to say GuardBeg:    [mooch some food from a guard]
	if(lastGuardBeg - turns < 12):
		say "     The soldier lowers a hand to his pocket, then stops. 'Wait a minute - I gave you something not too long ago! I can't hand out stuff constantly. That'll attract too much attention and all kinds of critters will show up asking for food.'";
	otherwise:
		say "     The first guard just scoffs at you, but the other guy pulls out a ration bar and throws it to you. 'Here. Now go away and don't tell anyone about this. We can't have a mob of people begging for food right in front of the camp.'";
		increase carried of food by 1;
		now lastGuardBeg is turns;

to say GuardLeave:    [lie to get into the camp]
	say "     You follow the soldier's order and walk away. Too bad, getting into the camp would surely have been interesting. Maybe you should return later and try to convince them to let you in.";


Camp Bravo Entrance is a room. It is a fasttravel. It is private.
The description of Camp Bravo Entrance is "     You're at the entrance of Camp Bravo, a mid-sized military camp consisting of row after row of olive green tents. Two soldiers are on guard here, using a barricade line of wrecked cars as cover as they vigilantly watch the street. To the north lies the parade ground in the center of the camp.";
Instead of sniffing Camp Bravo Entrance:
	say "     A musky scent hangs in the air.";

Private Cooper is a man. Private Cooper is in Camp Bravo Entrance.
The description of Private Cooper  is "     Private Cooper is a bulky man with a grim look on his face most of the time. He constantly scans for approaching intruders coming too close to the Camp Entrance.";
The conversation of Private Cooper is { "Meep!" };

instead of conversing the Private Cooper:
	if MovingOrwell is 1:
		say "     You step up to Private Cooper and say 'Soldier! Why are you two over here together? Can't you see that enemies might sneak close concealed by that rubble over there?' He replies 'Err, yes - but... I was just making sure that Orwell doesn't -' he looks over towards the parade ground in the north '-he's not supposed to go - to do - you know... I bet he'd like to sneak off to get a ride from the beast, the little fagg-' 'Let me stop you right there - enough! Even if your ridiculous idea was right, he'd still have to pass by you here, wouldn't he? So let's stop this nonsense.'";
		say "     Raising your voice, you order Cooper to stay where he is, while telling Orwell to move quite a bit down the barricade of wrecked cars. Going with him, you have him take position behind a large car with tinted windows. It's quite nice to watch the man's ass as he leans over the car's hood, setting up his rifle to rest on it. Reluctantly taking your eyes off his bubble butt, you look back towards where Private Cooper still holds guard - perfect, with the car as concealment, he won't be able to see anything but Orwell's rifle and head. The young man seems delighted with his new post, smiling as he tells you 'Thanks for getting some distance between that ass and me. Oh, and by the way - please call me Marc.'";
		now MovingOrwell is 2;
	otherwise:
		say "     With an annoyed look he says 'Don't distract me. Who knows what might rush us any minute now.'";

MovingOrwell is a number that varies. MovingOrwell usually is 0.

[MovingOrwell - micro-quest variable for Pvt. Orwell     ]
[ 0 - Starting State                                     ]
[ 1 - Tried fucking Pvt. Orwell                          ]
[ 2 - Moved him to a spot more or less out of sight      ]
[ 3 - Had sex (oral/anal) with Marc Orwell               ]

Private Orwell is a man. Private Orwell is in Camp Bravo Entrance.
The description of Private Orwell is " [OrwellDesc]";
The conversation of Private Orwell is { "Meep!" };

to say OrwellDesc:
	if MovingOrwell < 2:
		say "     Private Orwell is an attractive and fit male, bearing the tattoo of a merman on his left shoulder. He's leaning comfortably against one of the wrecked cars, but still has his rifle at hand.";
	otherwise:
		say "     Private Marc Orwell is an attractive and fit male, bearing the tattoo of a merman on his left shoulder. He's leaning over the hood of one of the wrecked cars, resting his elbows on it and his rifle set up to cover the approach to the camp. That stance shows off a well-rounded bubble butt in his pants.";
	
instead of conversing the Private Orwell:
	say "     [one of]With a sigh, Private Orwell says 'Man, this sucks - I only stumbled that one time in the mess tent and hit the Major with a mug of coffee and now I'm on perpetual guard duty and can't join in for the fun in there.'[or]Letting his gaze wander over the approach to the military camp, Private Orwell remarks 'Some of the infected are downright freaky - and I don't just mean their shapes, but how they think... if they still think.'[or]Letting his gaze wander over the approach to the military camp, Private Orwell remarks 'It's strange that you never can quite know what to expect from infected. A few days ago, this big guy came along - fur all over, wolf's head with lots of teeth... honestly, I thought he'd be all werewolf and attack. But he just said hello and offered me a tryout for his football team and then left. Interesting times, hm?'[or]A boyish smile comes to Private Orwell's face as you approach him. 'Hey there, thanks for talking to me.' He continues in a whisper 'You won't believe how boring guard duty is with just grumpy-pants over there as company. Well, him and the mostly sex-crazed infected out there...'[at random]";

instead of fucking Private Orwell:
	if MovingOrwell is 0:
		say "     He sighs, 'Oh, how I'd love to take you up on that. But I just can't leave my post, as Grumpy over there would go ape if I tried.' Looking over to Private Cooper, you have an idea... you should try talking to him.";
		now MovingOrwell is 1;
	otherwise if MovingOrwell is 1:
		say "     There might be a way to get it on with him, try talking to Private Cooper...";
	otherwise if MovingOrwell is 2 or MovingOrwell is 3:
		say "     Stepping up behind Private Orwell, you give his ass a squeeze. Surprised, he looks back over his shoulder, then smiles as he sees you. 'Hey there, hot stuff. Thanks for getting me a bit of distance to Grumpy. I assume you want to have some fun now?' Nodding to the tinted windows of the car, he continues 'Great idea with that - he can't see much more than my head and rifle from over there. And... I can keep quiet pretty well. Lots of experience from after light-out in the barracks, you know.' He gives you a wink.";
		if cocks of player > 0:
			say "     What would you prefer to do with the handsome soldier now? Fuck him (Y) or maybe just blow him off (N)?";
			if player consents:
				say "     Grinding your hardening bulge against his ass in anticipation, you reach around Marc and undo the button and zipper of his pants, then pull them down to reveal his well-muscled butt. Quickly throwing off your own clothes, you step up close behind him and rub your [cock of player] cock up and down between his firm cheeks. Then you position its head at his hole, pushing forward against his well-trained pucker that easily lets you slide in while still gripping your shaft tightly. Your soldier boy gives a soft moan as you bottom out inside him, then says under his breath 'Yeah, that feels great. Now fuck me.'";
				say "     Eager to follow Marc's request, you pull back a bit, then thrust back in and continue fucking him with deep strokes. It's amazing how tight and gripping his muscles are around your erection, his years of training as a bottom paying off handsomely. Almost losing yourself in a haze of lust, you shaft his ass, slamming forward until your hips hit his cheeks with slapping noises. Then suddenly, your soldier boy reaches back to grip your ass, holding you tight against him. 'Whoa Tiger' he says after another stifled moan and a little laugh. 'You rocked the whole car with that last one. Not that I mind a good hard fuck, but we do have an audience who would love to make trouble if we get too obvious...'";
				say "     [WaitLineBreak]";
				say "     Whispering an apology, you start up fucking him again, though with a bit less intense strokes. Even though you ache to just take him hard against the hood of the car, this slower rhythm still feels amazing. You almost have to laugh out loud as you see Marc nod over to the other soldier, giving the 'no enemy in sight' hand-sign nonchalantly as if he wasn't being fucked right at that very moment. Your semi-public coupling gives having sex with this handsome and athletic man a delicious extra thrill, and it doesn't take much longer until your raging libido demands its due. With a satisfied grunt, you grind your hips against Private Orwell's butt, holding him tight as your balls start unloading their fertile load. Feeling the first spurt of your cum splash against his inner walls, Marc gives a satisfied moan, his hand moving down to stroke his own cock. After just a few jerks, he joins you in orgasm, long strings of his sperm spurting all over the front wheel and side of the car.";
				say "     After finishing with the last spurts inside the young soldier, you stay in him a while longer while moving your hands under his shirt, stroking and caressing his back and chest. As your cock starts getting soft, you slowly pull out of him, then move to collect your clothes and gear. While you do so, Marc gives you a pretty nice and distracting view - bent over the hood of the car, all business to an observer from the front with his rifle and uniform cap and shirt... while at the same time showing off his bare ass to you, pants pooled around his legs and combat boots, with a small trickle of cum dripping from his freshly fucked hole.";
			otherwise:
				say "     [OrwellBJ]";
		otherwise:
			say "     [OrwellBJ]";
		if MovingOrwell is 2:
			now MovingOrwell is 3;
		
to say OrwellBJ:
	say "     You reach around Marc and undo the button and zipper of his pants, then pull them down to reveal his well-muscled butt. Stroking his buttocks, firm under deliciously soft and hairless skin, you then kneel down and crawl between his legs. After a bit of maneuvering, you come to sit between him and the car, your face just inches away from the young soldier's cock. It twitches in anticipation as Marc feels your breath against his skin. Not wanting to leave him waiting, you softly take it in your hand, stroking it, then hold it and slide your lips over the tip and further down his shaft. A stifled moan escaping your sexual partner's lips makes you stop for a moment to allow him to find his composure again. 'Go on, that feels great.' he whispers down to you.";
	say "     Eager to give Marc pleasure, you pull back a bit, then start bobbing your head up and down on his cock and bring your hands up to fondle his balls. After weeks of constant guard duty with such a dour partner who made sure he never had time on his own to get off, they're heavy with pent-up cum. With him aching for release, it doesn't take too much longer until your efforts drive the young man over the edge and a not quite suppressed gasp heralds a flood of a load gushing into your mouth. Spurt after spurt coat your tongue and tonsils, and you swallow it all, not spilling anything.";
	say "     [WaitLineBreak]";
	say "     As you stand back up Private Orwell looks over his shoulder and says 'Thanks, I really really needed that!' 'Anytime.' you tell him, licking your lips. As you swallow the last drops of his cum, Marc gives you a pretty nice and distracting view - bent over the hood of the car, all business to an observer from the front with his rifle and uniform cap and shirt... while at the same time showing off his bare ass to you, pants pooled around his legs and combat boots, his now softening cock dangling between his legs.";

North of Camp Bravo Entrance is Parade Ground.
The description of Parade Ground is "     You're in Camp Bravo, surrounded by green military tents. To the north lies the tent of the camp's commanding officer, west is the quartermaster's tent and to the south is the entrance of the camp. In the middle of the camp is an mostly empty parade ground with a wooden hitching post and a single field bed. There are various patches of dried cum on them and the ground around. An impressively large minotaur sits next to it, munching on vegetables and bread brought to him by a grizzled looking soldier. Seems like caring for the beast is his responsibility.";

Instead of sniffing Parade Ground:
	say "     The heavy scent of cum and a musky minotaur odor hang in the air. It must be laden with pheromones, as you're getting quite horny just from taking it in.";

North of the Parade Ground is the Major's Tent.
The description of Major's Tent is "     You're in a sparely furnished military tent, holding only a field desk, a small table, several chairs and a field bed. Major Padgett, the camp's commander sits at the desk, reading scout reports and other paperwork. On top of the table at one wall of the tent rests a military radio.";

Instead of sniffing Major's Tent:
	say "     Even in here, the minotaur cum smell is still pretty strong. No wonder, since it's been rutting people in the area right before the tent.";

West of the Parade Ground is the Quartermaster's Tent.
The description of Quartermaster's Tent is "     You're in the large tent of Camp Bravo's quartermaster. It holds a long row of filled shelves in the back, combined with various crates stacked high and a few large sacks resting on the floor next to the quartermaster's field desk. A medical corpsman is bent over one of them, counting its contents.";

Instead of sniffing Quartermaster's Tent:
	say "     Even in here, the minotaur cum smell is still pretty strong. No wonder, since it's been rutting people in the area right before the tent.";


Major Padgett is a man. Major Padgett is in Major's Tent.
The description of Major Padgett is "     Major Padgett is an older man in military uniform, sporting a military buzz-cut of greying hair. He's sitting at a field desk and looks busy with scouting reports and other paperwork.";
The conversation of Major Padgett is { "Attention!" };
thirst of Major Padgett usually is 555.  [ The thirst value is used for the turn-number the player last tried to talk the Major into allowing women with the minotaur ]
CampBravoWomenAllowed is a number that varies.  CampBravoWomenAllowed is normally 0.

instead of sniffing Major Padgett:
	say "     He smells of Old Spice.";

Instead of fucking Major Padgett:
	say "     His brows draw together as you proposition him. 'What the - NO! Get a hold of yourself! I had expected better from you.'";

instead of conversing Major Padgett:
	now sextablerun is 0;
	blank out the whole of table of fucking options;
	choose a blank row in table of fucking options;
	now title entry is "Congratulate him on his work.";
	now sortorder entry is 1;
	now description entry is "Butter him up a bit.";
	choose a blank row in table of fucking options;
	now title entry is "Explain to him that he's been tricked.";
	now sortorder entry is 2;
	now description entry is "Tell him the minotaur story was a hoax.";
	if CampBravoWomenAllowed is 0:
		choose a blank row in table of fucking options;
		now title entry is "Talk him into letting women fuck the minotaur.";
		now sortorder entry is 3;
		now description entry is "Convince him to let the minotaur breed female soldiers.";
	if hp of David is 2:
		choose a blank row in table of fucking options;
		now title entry is "Ask to have David taken of the minotaur breeding list.";
		now sortorder entry is 4;
		now description entry is "Convince him to make David a liaison to you.";
	if thirst of Military Radio is 1:
		choose a blank row in table of fucking options;
		now title entry is "Ask about the radio.";
		now sortorder entry is 5;
		now description entry is "Ask him about the strange transmissions.";
	choose a blank row in table of fucking options;
	now title entry is "Ask him to repeat his briefing.";
	now sortorder entry is 6;
	now description entry is "Another briefing.";
	choose a blank row in table of fucking options;
	now title entry is "Excuse yourself and break off the conversation.";
	now sortorder entry is 7;
	now description entry is "Stop talking.";
	sort the table of fucking options in sortorder order;
	while sextablerun is 0:
		repeat with y running from 1 to number of filled rows in table of fucking options:
			choose row y from the table of fucking options;
			say "[link][y] - [title entry][as][y][end link][line break]";
		say "Pick the corresponding number> [run paragraph on]";
		get a number;
		if calcnumber > 0 and calcnumber <= the number of filled rows in table of fucking options:
			now current menu selection is calcnumber;
			choose row calcnumber in table of fucking options;
			say "[title entry]: [description entry][line break]";
			say "Is this what you want?";
			if player consents:
				let nam be title entry;
				clear the screen and hyperlink list;
				now sextablerun is 1;
				if (nam is "Congratulate him on his work."):
					say "[MajorBrownnose]";
				if (nam is "Explain to him that he's been tricked."):
					say "[MajorPartypooper]";
				if (nam is "Talk him into letting women fuck the minotaur."):
					say "[MajorBreeding]";
				if (nam is "Ask to have David taken of the minotaur breeding list."):
					say "[MajorDavid]";
				if (nam is "Ask about the radio."):
					say "[MajorRadio]";
				if (nam is "Ask him to repeat his briefing."):
					say "[MajorBriefing]";
				if (nam is "Excuse yourself and break off the conversation."):
					say "[MajorLeave]";

to say MajorBrownnose:
	say "     You congratulate the major on his handling of the whole situation and butter him up a bit, making him open up about his dreams of being recognized as one of the people beating the infection. Oh boy, won't he be surprised when what's been happening here comes out to the public...";

to say MajorPartypooper:    [try to make the Major see how he's been tricked]
	say "     You try to explain to the man that he's been led to believe a highly unlikely scenario, making him offer his men to a minotaur for rutting on the word of only one individual of doubtful intent and qualification.";
	say "     As the major listens to you talk, his face gets redder and redder in anger. After a while he says 'Ah, I see...' - and pulls out a pistol - '... that you're an impostor, trying to stop our efforts in finding a cure. Sick individuals like you relish in all this chaos and don't want it to end, hm?'";
	say "     Not being able to accept having been duped, he has his soldiers throw you out of the camp, ordering them to drive you away if you return. Your body bruised from the rough handling, you slowly make your way back to the bunker and resolve not to return to Camp Bravo to avoid any further unpleasantness.";
	now hp of player is hp of player / 2;
	now Camp Bravo Entrance is not known;
	move player to bunker;

to say MajorBreeding:
	if (thirst of Major Padgett - turns < 12):
		say "     Maybe you should let your previous arguments sink in for a while before trying to talk the Major into this again...";
	otherwise:
		say "     You tell the major that the researchers urgently need more material and also that getting direct offspring of Patient Zero to examine could be greatly beneficial for their progress. Minotaur calves would surely be easier to manage and move than the creature itself, especially if they inherit the habit of obedience to superiors from their soldier mothers - or of course if said women can be brought outside the city before they even give birth.";
		let bonus be (( the Charisma of the player minus 10 ) divided by 2);
		if 2 is listed in bookcollection, increase bonus by 2;
		let diceroll be a random number from 1 to 20;
		say "You roll 1d20([diceroll])+[bonus]: [diceroll + bonus], ";
		increase diceroll by bonus;
		if diceroll is greater than 18:
			say "     He nods at your explanation, clearly accepting it for the truth. 'I see your point. Spreading out the duty of obtaining and transporting research samples to all soldiers under my command would alleviate the shortage of people I can send off. I'll pass along orders to that effect. Thank you for bringing this to my attention.'";
			now CampBravoWomenAllowed is 1;
			now hp of Adam is 4;
			now ElainePregnant is 48;      [48h till birth]
		otherwise:
			say "     He looks doubtful at your explanation, unconvinced that sending his female soldiers to be impregnated by the huge minotaur outside is such a great idea. Maybe you should work at getting better at Ly- err, convincing him of the truth and try this again later.";
		now thirst of Major Padgett is turns;

to say MajorDavid:
	say "     You tell the major that you could use a soldier to serve as a liaison to you, keeping you informed about what's going on in the camp and sometimes coming with you for special duties. And that very nice Private David Jackson would fit perfectly...";
	say "     He nods, answering 'Of course, I'll issue the order in a moment. And please remember to tell the people outside the city that I need more men sent here.'";
	now hp of David is 3;

to say MajorRadio:
	say "     As you ask the Major about the strange transmission you heard over the radio, he grumbles and gives the device a hostile stare.";
	say "     'Looks like some kind of critter out there has developed the ability to intercept and answer radio broadcasts. We don't even know how many of them are there - might be a whole lot of the bastards, or just the one who can change its voice infernally well. With them - or it - prattling nonsense, impersonating officers and delivering false information and orders almost constantly, I've had to order the men to turn in their receivers so they're not led astray. So we're out of direct communication with the forces quarantining the city for now...'";

to say MajorBriefing:
	say "     He looks a bit strangely at you, then says 'But I already - oh well, try to remember it this time: We were lucky enough to have a top scientist in the city when the outbreak started - a doctor Diego Garcia who contacted scouting parties I sent out. [if Diegochanged is 0]He's been infected himself so he's stuck inside the quarantine zone like all the other people when the outbreak hit. Not content to just sit and wait, he's been gathering data and looking into the infection himself. He pointed out Patient Zero for us - that large minotaur thing out in the camp - and explained the procedures necessary to gather and transport samples..' [otherwise]She's been infected herself so she's stuck inside the quarantine zone like all the other people when the outbreak hit. Not content to just sit and wait, she's been gathering data and looking into the infection herself. She pointed out patient zero for us and explained the procedures necessary to gather and transport samples...' [end if]He looks a bit embarrassed as he continues, saying 'You see, the samples can only be used if they're kept at human body temperature. So I've had to order the men to... carry the material inside their bodies to keep it valid.";

to say MajorLeave:
	say "     You excuse yourself for disturbing him and step back from the major's desk.";


[ thirst states of Military Radio                                    ]
[   0: Starting State - never listened to any broadcast              ]
[   1: listened at least once                                        ]

Military Radio is a man. Military Radio is in Major's Tent.
The description of Military Radio is "     The radio is a chunky piece of olive-green equipment with a multitude of buttons and dials. A handheld speaker set is attached to it at the end of a long flexible cord.";
The conversation of Military Radio is { "Beep!" };

instead of sniffing Military Radio:
	say "     Doesn't really smell of anything out of the ordinary.";

Instead of fucking Military Radio:
	say "     Now how do you want to do that? It's a lifeless piece of machinery. No holes in it where you could insert anything, and no part of it will fit in any of your own orifices.";

instead of conversing Military Radio:
	say "[CampBravoRadioTalk]";

to say CampBravoRadioTalk:
	say "     As you turn on the radio and try to reach anyone, you hear this in response:[line break]";
	if thirst of Military Radio is 0:
		say "     'You're in Camp Bravo? Excellent, we've been trying to reach you for days now. Now listen - this is important - you have to send two squads of men immediately to the capitol building. There they should strip naked and dance around in a circle to pacify the infected in the area. Do you copy those instructions?'";
		now thirst of Military Radio is 1;
	otherwise:
		say "     '[one of]The number you have dialed is busy. If you want to leave a message, please speak after the beep. BEEEP!'[or]New order to everyone - bring all unspoiled food that contains chocolate you can find to the corner building of Main Street and 5th. Deposit it inside the house and leave the area.'[or]What's going on with you in that city? We've had half-changed soldiers stumbling out to the quarantine barrier babbling something about special transport duties...'[or]...then put the turkey in the oven. And don't forget to bast it regularly with the juices collecting in the dish. You don't want the meat to dry out...'[or]Delta squad, proceed through to the end of the street, no hostiles in sight.'[or]Our researchers have figured out how to turn the nanites off. The signal is has already been sent. You can stop injecting your daily immunity boosters now.'[or]You won't believe how good those husky bitches can give head. Absolutely amazing - why don't you go find one and try it?'[at random]";


[ thirst states of Elaine                                            ]
[   0: Starting State - not pregnant                                 ]
[   1: invisibly pregnant by the minotaur                            ]
[   2: visibly pregnant by the minotaur                              ]
[   3: Adam was born                                                 ]
[ hunger states of Elaine                                            ]
[   0: hasn't had sex with the player                                ]
[   1: had sex with the player                                       ]
[ ElainePregnant - timer for the birth (48h from start)              ]


Elaine is a woman. Elaine is in Quartermaster's Tent.
The description of Elaine is "     Elaine Scott is the quartermaster of this camp, responsible for the regular and... more unusual supplies the soldiers need. She's an attractive woman in her thirties, about 4'9' or so in height, with short-cut black hair. [if thirst of Elaine is 1]She has a healthy glow to her.[otherwise if thirst of Elaine is 2]Her belly bulges outward in obvious pregnancy.[otherwise if thirst of Elaine is 3]She keeps a watchful eye over her son Adam, who's just learning how to manage the inventory here.[end if]";
The conversation of Elaine is { "Huh?" };
ElainePregnant is a number that varies.
lastfuck of Elaine is usually 555.

An everyturn rule:
	if ElainePregnant is 1:
		move Adam to Quartermaster's Tent;
		now hp of Adam is 5;
		now ElainePregnant is 0;
		now thirst of Elaine is 3;
	if ElainePregnant is 24:
		now thirst of Elaine is 2;   [visible pregnancy]
	if ElainePregnant is 36:
		now thirst of Elaine is 1;   [so there's some time between the player talking to the Major and Elaine first mentioning she got fucked by the minotaur]
	if ElainePregnant is greater than 1:
		decrease ElainePregnant by 1;

instead of sniffing Elaine:
	say "     Smells like a female human[if thirst of Elaine is 1] - with a slight undertone of pregnancy[otherwise if thirst of Elaine is 2] - a pregnant one[end if].";

Instead of fucking Elaine:
	say "[ElaineFucking]";

instead of conversing Elaine:
	say "[CampBravoElaineTalk]";

to say CampBravoElaineTalk:
	now sextablerun is 0;
	blank out the whole of table of fucking options;
	choose a blank row in table of fucking options;
	now title entry is "Ask her for a status report.";
	now sortorder entry is 1;
	now description entry is "Get a report.";
	if thirst of Elaine is 3:
		choose a blank row in table of fucking options;
		now title entry is "Ask her about Adam.";
		now sortorder entry is 2;
		now description entry is "Talk about Elaine's son with the minotaur.";
	choose a blank row in table of fucking options;
	now title entry is "Observe the next group of men getting their special supplies.";
	now sortorder entry is 3;
	now description entry is "Watch the dildos being handed out and used.";
	choose a blank row in table of fucking options;
	now title entry is "Proposition Elaine Scott for sex.";
	now sortorder entry is 4;
	now description entry is "Fuck her.";
	choose a blank row in table of fucking options;
	now title entry is "Do Nothing, turn away.";
	now sortorder entry is 5;
	now description entry is "Break the conversation off.";
	sort the table of fucking options in sortorder order;
	while sextablerun is 0:
		repeat with y running from 1 to number of filled rows in table of fucking options:
			choose row y from the table of fucking options;
			say "[link][y] - [title entry][as][y][end link][line break]";
		say "Pick the corresponding number> [run paragraph on]";
		get a number;
		if calcnumber > 0 and calcnumber <= the number of filled rows in table of fucking options:
			now current menu selection is calcnumber;
			choose row calcnumber in table of fucking options;
			say "[title entry]: [description entry][line break]";
			say "Is this what you want?";
			if player consents:
				let nam be title entry;
				clear the screen and hyperlink list;
				now sextablerun is 1;
				if (nam is "Ask her for a status report."):
					say "[CampBravoElaineReport]";
				if (nam is "Ask her about Adam."):
					say "[CampBravoElaineAdamTalk]";
				if (nam is "Observe the next group of men getting their special supplies."):
					say "[CampBravoMenPrepping]";
				if (nam is "Proposition Elaine Scott for sex."):
					say "[ElaineFucking]";
				if (nam is "Do Nothing, turn away."):
					say "     You wave Elaine Scott off as she looks at you inquisitively and turn away.";

to say CampBravoElaineReport:
	if CampBravoWomenAllowed is 0:
		say "     She leads you over to the large sacks resting next to her desk and opens one of them up. It's filled to the top with dildos and butt plugs 'As you can see, our scouts did a good job gathering these. They must have loot- erm, checked out every sex shop in the city. With the amount of material we have now, we'll run out of available men in the camp long before anything else.'";
		say "     'Some of the guys are a bit squeamish at first, but orders are orders - and a lot of them warm up to sticking things up their butts once they try it. I only wish I could do more than just watch them go at it... us women are the only ones not getting any action these days.' She sighs. 'Seeing all those yummy guys parade into this tent and strip sure makes me horny.'";
	otherwise:
		say "     She leads you over to the large sacks resting next to her desk and opens one of them up. It's filled to the top with dildos and butt plugs 'As you can see, our scouts did a good job gathering these. They must have loot- erm, checked out every sex shop in the city. With the amount of material we have now, we'll run out of available men in the camp long before anything else.'";
		say "     'Some of the guys are a bit squeamish at first, but orders are orders - and a lot of them warm up to sticking things up their butts once they try it. Since the new orders came from the Major, the women in the camp have been added to Tiny Tim's schedule too. The things you do for your country - none of us expected to end up as breeding partners for a minotaur, that's for sure...'";
	if thirst of Elaine is 1:
		say "     She nods to the outside of the tent in the east. 'My own turn with our horny bull out there came up not too long ago - and I can tell you he's packing a pretty large piece of equipment. And the amount of cum he pumped into me... that was something else.'";
	otherwise if thirst of Elaine is 2:
		say "     She nods to the outside of the tent in the east. 'My own turn with our horny bull out there came up not too long ago...' Elaine says as she strokes her bulging belly. 'His kid grows faster than I had imagined - and I'm hornier than ever.'";
	otherwise if thirst of Elaine is 3:
		say "     She nods to Adam, who's busy sorting the inventory of a storage box. 'It still amazes me how quickly my boy has grown. I mean - it's been only days from Tiny Tim fucking me to Adam's current size. The aging seems to have slowed down to human levels now, thankfully.'";

to say CampBravoElaineAdamTalk:
	say "     'My boy's grown up into a quite handsome charmer, hasn't he? And it only took a few hours. You know, I only let that big brute out there shag me to help fight the plague, but... now that I have him, I love my son. I couldn't bear to send him away, so I talked the Major into letting him stay here as my assistant. Wasn't too hard, once I showed him how disorganized things had gotten after he sent my two male subordinates out to the city quarantine barrier filled with minotaur cum a few days back.'";

to say CampBravoMenPrepping:
	say "     Four two-man teams of soldiers file into the tent and get into line in front of Elaine's desk. She accepts a salute from them, then goes over to the sacks and hands out items from them, saying 'Here, take this -' (a bottle of lube) '- that -' (a rubber dildo) '- and these -' (two butt-plugs) '- and get each other ready for Tiny Tim out there. Don't be embarrassed about it - you'll be heroes if they find a cure through your service. Also - really, really take your daily immunity boosters! You'll be carrying around potent stuff, so don't miss ANY injection.'";
	say "     One after another the men get their special equipment, then stand around a bit sheepishly, inspecting the often brightly colored rubber toys they're supposed to put up their asses. Only when Elaine gives one of the men a nudge and says 'Go on, strip - you're not shy little girls.' does the ice break and the men start taking off their clothes. Soon eight naked men stand in the tent, with two of them sporting obvious erections as they look at the other men. These two gay - or at least bi - men take point, telling their partners to bend over, then lubing them up and starting on their asses with the dildos. The next team of men shrugs, then start emulating the others, which leaves only the two guys closest to you the odd men out.";
	say "     [line break]";
	say "     These two, one slender redhead and his more beefy and muscular partner only hesitantly get going. The redhead bends over a storage crate, while the bigger guy takes out the dildo from its packaging, then just starts pushing it against his partner's asshole without any lube at all.";
	say "     [line break]";
	say "     Do you want to keep watching and see if they figure things out for themselves, or step in and help things along? (Y = just watch; N = step in) ";
	if player consents:   [just watch them figure out the lube, etc.]
		say "     You wince in shared pain as the muscled guy just tries to shove in the dry dildo several times without much success. Seeing that this isn't working, he throws a look at the other teams, who are by now well into fucking each other with their sex toys. 'Oh...' he murmurs embarrassedly, then grabs the lube bottle from the floor and drenches the whole dildo in the slippery fluid. It almost slips out of his hands several times when he gets back to inserting it into his partner's ass, but after a few tries he finally gets it in and starts to fuck the redhead soldier with it.";
		say "     Despite the rocky start, it turns out the other guy really likes having his prostrate stimulated, and before too long he shoots a big load all over the side of the crate he's leaning against. After getting his breath back, he says 'That was amazing - come on, your turn... you'll like it.' After the bigger soldier takes his place, the redhead pulls the dildo out of his own ass and starts to push the slippery tip against his partner's opening...";
	otherwise:	           [get involved]
		say "     Stepping up to the men, you tell big guy that he can't just shove the toy in dry, especially into a virgin hole. Rather embarrassed at having tried, he listens closely to your instructions and follows them to the letter - warming up some lube in his hands before starting to rub it over and into the redhead's asshole, then massaging his insides with strong fingers. As the redhead's moans at getting fingered get louder and louder, you smile at the man doing the fingering, saying 'And that's how you're supposed to do it.'";
		if cocks of player > 0:    [male player chars get the choice of fucking]
			say "     [line break]";
			say "     Do you want to hand the muscled guy the dildo - or show him how real men go on from here? (Y = Give him the Dildo; N = Fuck the redhead with your own cock) ";
			if player consents:      [just let them use the dildo]
				say "     You hand the man the dildo, then walk him through inserting it, going slow so his buddy's relaxed asshole doesn't tighten up again. Soon he's shafting the redhead deeply with the sex toy, encouraged by the man's lustful moans at having his prostrate stimulated. Before too much longer, the slender soldier shoots a big load all over the side of the crate he's leaning against. After getting his breath back, he says 'That was amazing - come on, your turn... you'll like it.' After the bigger soldier takes his place, the redhead pulls the dildo out of his own ass and starts to push the slippery tip against his partner's opening...";
			otherwise:               [fuck the redhead yourself]
				say "     You quickly strip off your own clothing, then step up besides the beefy soldier, softly pulling his hands away from his teammate's hole. Lining up your hard shaft with the redhead's ass, you say 'There's something much better than a dildo to stretch a man's hole...', then move forward, touching his pucker with the tip of your cock. Putting your arms around the man's chest, holding him close and stroking his muscles, you whisper 'Just relax and push back a bit.' into his ear as you push forward, slowly spreading his hole around your cock. Then the head is in and moves deeper, exploring this tight tunnel where no man has gone before. And from the red-headed soldier's moans, you're quite well received in his virgin depths.";
				say "     After bottoming out in him, you give the man a moment to get used to your girth, then fuck his virgin ass, becoming someone he'll never forget - the first guy to fuck him. Your soldier's hole is so warm and tight that you almost forget everything but fucking him - until you hear a moan right next to you and remember the second soldier standing there. The larger, more muscular man has obviously become pretty aroused by watching you shaft his partner and his jerking his own hard-on with his strong hands. Taking a look at his ripped body, long cock and muscled butt, you instantly decide what to do next.";
				say "     [WaitLineBreak]";
				say "     Pulling your redhead soldier's lips to yours, you give him a quick kiss, then slowly pull out of his ass and present the ready and slightly gaping opening to the other soldier. 'Your turn.' you say, and the man eagerly takes the spot behind his mate, then sinks himself in him with a satisfied groan. You give him a minute to get really into fucking his teammate, their moans and the slapping noises of one man's hips against the other's ass filling the tent.";
				say "     And then it's time to take another man's virginity for you. Your eager cock rock-hard, lubed and ready, you step up behind the muscular soldier and thrust forward, penetrating his tight ass in one quick move. He gives a gasp, more in surprise than pain, and looks back at you. Being balls deep in another soldier's ass himself, he can't very well complain, so he just shrugs and starts moving in and out again. Each time he pulls back from his partner's hole, he pushes your shaft deeper in his own ass, giving him quite a bit of extra stimulation that soon has him moaning louder than before.";
				say "     Your little threesome goes on for a while, until the muscled soldier suddenly shouts 'Aaah - I'm coming!', filling up his buddy's ass with pulse after pulse of his seed. The man's anal muscles spasming around your own shaft push you over the edge right with him, claiming his no longer virgin asshole as yours with a huge load shot deep inside. You pull out of his hole and tell the man to lie down on his back on the crate, then give the red-headed soldier a nudge. As hot and ready as he is, he instantly sinks himself into the larger man's cum-dripping hole, pumping away urgently until his own orgasm approaches. With a last loud moan, he pulls out just in time to cum all over his mate, spraying quite a bit of cum all over his muscled chest.";
		otherwise:		             [females and neuter just hand over the dildo]
			say "     You hand the man the dildo, then walk him through inserting it, going slow so his buddy's relaxed asshole doesn't tighten up again. Soon he's shafting the redhead deeply with the sex toy, encouraged by the man's lustful moans at having his prostrate stimulated. Before too much longer, the slender soldier shoots a big load all over the side of the crate he's leaning against. After getting his breath back, he says 'That was amazing - come on, your turn... you'll like it.' After the bigger soldier takes his place, the redhead pulls the dildo out of his own ass and starts to push the slippery tip against his partner's opening...";
	say "     [line break]";
	say "     Over the next hour or so, you watch all of the men get fucked in the ass with the dildos - and sometimes their teammates hard shafts. Looks like a successful prepping session for their later encounters with the minotaur to you.";

to say ElaineFucking:
	if cocks of player is 0:
		say "     She shakes her head as you proposition her. 'Sorry, I don't swing that way. But I'm sure you'll find a willing man - or beast - out in the camp in a second...'";
	otherwise:
		if (lastfuck of Elaine - turns < 12):
			say "     As you approach Elaine and proposition her for sex, she smiles, but turns you away for now. 'Sorry sweetie, I do have other things to do at the moment. Someone has to keep this whole operations supplied, you know...'";
		otherwise:
			if thirst of Elaine is 1: 	[pregnant sex]
				say "     Delighted at a sexual partner not in her chain of command, the soldier eagerly responds, putting her arms around you and giving you a hungry kiss. Without hesitation she pulls off her top and throws it to the side, quickly followed by boots, pants and underwear. Now fully naked, she makes a quite enticing picture - with her full breasts, trained body and a bulging pregnant belly.";
				say "     As you stand there, your eyes following her curves, Elaine steps up and runs her hands over you, stroking your body and pulling off your clothing. Soon you're both naked in front of each other, your by now rock-hard cock grasped and stroked by her slender hands. Her eyes wander to a box in a nearby shelf, then she shakes her head softly, murmuring to herself 'No need for condoms today - he can't knock me up twice.'";
				say "     The horny quartermaster leads you over to her bed and pushes you to lie down on it, running her hands over your body and cock. Not losing any time, she climbs up on the bed with you, holding your proudly erect member up as she lowers herself onto it. Both of you moan deeply as your shaft spreads the moist cunt lips and penetrates her warm and tight opening. With Elaine moving up and down on your shaft, you revel in the incredible feeling of her inner walls rubbing against your shaft. Feels like she's fit and trained all over, even with her inner muscles, which grip and squeeze your cock at just the right moments each time you slide into her.";
				say "     [WaitLineBreak]";
				say "     The two of you spend a long while on the bed, fucking each other and making out, until you feel an urgent feeling rise in your balls. You thrust upwards, burying your cock as far as you can go and grab Elaine's hips to hold her body tight as spurt after spurt of fertile seed shoot upwards into her vagina.";
				say "     Leaning down to you, Elaine gives you a deep kiss, moaning 'Thanks, stud. I really needed that...' After a short rest, she slides off your slowly softening cock and goes to put her clothes back on.";
			otherwise:                  [normal sex]
				say "     Delighted at a sexual partner not in her chain of command, the soldier eagerly responds, putting her arms around you and giving you a hungry kiss. Without hesitation she pulls off her top and throws it to the side, quickly followed by boots, pants and underwear. Now fully naked, she makes a quite enticing picture - with her perky breasts, lithe trained body and an attractive face showing a seductive smile.";
				say "     As you stand there, your eyes following her curves, Elaine steps up and runs her hands over you, stroking your body and pulling off your clothing. Soon you're both naked in front of each other, your by now rock-hard cock grasped and stroked by her slender hands. She measures your length and girth with her hands, then says 'Just a sec.' and goes for one of the many boxes in the shelves, grabbing something out of it. She says [if cock length of player > 9]'Thankfully I have some extra-large ones in stock that will fit even you.' [otherwise]'Time to suit up.' [end if]and hands you a condom. Eager to get into her pussy, you unwrap it and put it on your shaft.";
				say "     The horny quartermaster leads you over to her bed and lies down on it, spreading her legs and pussy for you. Not losing any time, you join her on the bed, grab your cock and push it against her nether lips, moaning as you penetrate her warm and tight opening. Thrusting in and out of her body, you revel in the incredible feeling of her inner walls rubbing against your shaft. Feels like she's fit and trained all over, even with her inner muscles, which grip and squeeze your cock at just the right moments each time you slide into her.";
				say "     The two of you spend a long while on the bed, fucking each other and making out, until you feel an urgent feeling rise in your balls. You thrust in all the way one last time and orgasm, with spurt after spurt of fertile seed filling your condom to the brink.";
				say "     [WaitLineBreak]";
				say "     Pulling your lips to hers, Elaine gives you a deep kiss, moaning 'Thanks, stud. I really needed that...' After a short rest, she slides out from under you and goes to put her clothes back on.";
			now lastfuck of Elaine is turns;


Adam is a man.
The description of Adam is "     The offspring of Elaine Scott and the minotaur out in the middle of the camp, Adam is a ...half-minotaur you'd say. While his lower body consists of furred, two-jointed legs and hooves like his father's, from the waist up he's almost completely human, with only small nubby horns poking out from under his shoulder-length black hair. All in all, he's much less bulky than his father, having a more slender build and the upper body of a fit teenager of about nineteen. His handsome, beardless face is very open and he smiles a lot. At the moment he's dressed in a black t-shirt and wide camo-shorts - with a hole in the back to allow for his moderately long flexible tail (which has a larger tuft of black fur at the end).";
The conversation of Adam is { "Oh, hello." };
lastfuck of Adam is usually 555.

instead of sniffing Adam:
	say "     Adam has a nice smell somewhere between the pheromone-laden musk of his father and a clean human teenager's smell. It doesn't have you ripping your clothes off, but sure is attractive.";

Instead of fucking Adam:
	if(lastfuck of Adam - turns < 6):
		say "     Adam chuckles as you try to talk him into sex again. 'You're just insatiable, aren't you? Too bad I don't have quite dad's stamina, so I need a break before I'm ready to go again...'";
	otherwise:
		say "[AdamSexMenu]";
		now lastfuck of Adam is turns;

instead of conversing Adam:
	say "     He looks at you attentively as you step up, saying 'Oh, hello... I mean... Provisional Private Adam Scott ready for orders, sir!' Accepting his salute, you chat a bit and find the boy charming and pretty eager to please.";

to say AdamSexMenu:
	now sextablerun is 0;
	blank out the whole of table of fucking options;
	choose a blank row in table of fucking options;
	now title entry is "Suck Adam's cock";
	now sortorder entry is 1;
	now description entry is "Taste some half-minotaur seed.";
	if (cocks of player > 0):
		choose a blank row in table of fucking options;
		now title entry is "Have him blow you";
		now sortorder entry is 2;
		now description entry is "Put Adam's mouth to good use.";
	if (cunts of player > 0):
		choose a blank row in table of fucking options;
		now title entry is "Let Adam fuck your pussy";
		now sortorder entry is 3;
		now description entry is "Let the boy breed you.";
	choose a blank row in table of fucking options;
	now title entry is "Let Adam fuck your ass";
	now sortorder entry is 4;
	now description entry is "Let the boy fill your ass with his seed.";
	if (cocks of player > 0):
		choose a blank row in table of fucking options;
		now title entry is "Take Adam's ass";
		now sortorder entry is 5;
		now description entry is "Fill the half-minotaur's ass with your cock.";
	sort the table of fucking options in sortorder order;
	while sextablerun is 0:
		repeat with y running from 1 to number of filled rows in table of fucking options:
			choose row y from the table of fucking options;
			say "[link][y] - [title entry][as][y][end link][line break]";
		say "Pick the corresponding number> [run paragraph on]";
		get a number;
		if calcnumber > 0 and calcnumber <= the number of filled rows in table of fucking options:
			now current menu selection is calcnumber;
			choose row calcnumber in table of fucking options;
			say "[title entry]: [description entry][line break]";
			say "Is this what you want?";
			if player consents:
				let nam be title entry;
				clear the screen and hyperlink list;
				now sextablerun is 1;
				if (nam is "Suck Adam's cock"):
					say "[AdamSex1]";
				otherwise if (nam is "Have him blow you"):
					say "[AdamSex2]";
				otherwise if (nam is "Let Adam fuck your pussy"):
					say "[AdamSex3]";
				otherwise if (nam is "Let Adam fuck your ass"):
					say "[AdamSex4]";
				otherwise if (nam is "Take Adam's ass"):
					say "[AdamSex5]";

to say AdamSex1:    [suck Adam's cock]
	say "     You pull Adam aside and lead him behind one of the long storage shelves in the tent. Giving him a deep kiss, you put your arms around him and slide your hands into his shorts at the back, feeling and softly squeezing his furred buns. Then you move on to his t-shirt, grabbing it and pulling it up and over his head, revealing Adam's fit and human upper body. Leaning down a bit, you suck on first one, then the other of his nipples, followed by a line of kisses down over his abs until you're crouched in front of the half-minotaur. Stroking the obvious bulge of his cock through the fabric of his shorts, you have him moaning needfully in no time. You smile up at Adam, undoing the zipper of his sorts then pull them down off his legs, freeing his proudly erect human manhood.";
	say "     Starting with a tentative lick over his balls, you run your tongue along the side of Adam's long shaft, circling the head of his cock as you get to it. You stroke his dick with your hand a few times, then take its tip between your lips. Adam moans as you slowly slide his manhood deeper into your mouth, running your tongue over its sensitive skin. Soon he hits the back of your mouth, but you take a deep breath and continue going, sliding his shaft deeper and deeper. When your nose finally bumps into the skin under his navel, you have Adam halfway down your throat and gasping almost incoherently how good it feels.";
	say "     Pulling off his cock to get some air, you run your hands through the black fur on his legs and tight buns, delighted in its softness. Then you stroke his saliva-coated manhood some more and start sucking him in earnest, pumping your lips up and down on his hard shaft. You keep Adam going for a while, bringing him to the brink of an orgasm several times, but stopping each time to let him cool down a bit. Then finally you go all out, sucking on his cock hard and pumping it in and out of your throat. With all the built up arousal, Adam doesn't last much longer before a mind-blowing orgasm shakes his body, his cock pulsing as spurt after spurt of his seed shoot directly into your stomach.";
	say "     Satisfied with pleasing the young half-minotaur, you stand up and give him another deep kiss, playfully exploring his mouth with your tongue.";

to say AdamSex2:    [have Adam suck the player char's cock]
	say "     You pull Adam aside and lead him behind one of the long storage shelves in the tent. Giving him a deep kiss, you put your arms around him and slide your hands into his shorts at the back, feeling and softly squeezing his furred buns. Then you move on to his t-shirt, grabbing it and pulling it up and over his head, revealing Adam's fit and human upper body. Leaning down a bit, you suck on first one, then the other of his nipples, followed by licking over his chest and neck until you reach the chin and kiss him again. Moaning 'Blow me, beast-boy.', you move back a step and quickly slide off your clothes. Adam watches you undress, then smiles and replies 'My pleasure, sir.' before he licks his lips and kneels down.";
	say "     Grasping your by now proudly standing erection in one hand, Adam strokes it softly a few times, then holds it up as he gives your balls a tentative lick and runs his tongue up the underside of your shaft, making you pant in pleasure. Arriving at the tip, he circles the head of your cock a few times with his tongue, then takes it between your lips. Your manhood slowly sliding deeper into his mouth, his lips caressing sensitive skin and giving you amazing sensations. Soon your cock hits the back of your mouth, but Adam takes a deep breath and continues going, sliding your shaft deeper and deeper. When his nose finally bumps into the skin under your navel, you moan loudly from the warm and tight feeling that gives you.";
	say "     Pulling off your cock to get some air, Adam strokes its saliva-coated length some more, then start sucking you off in earnest, pumping his lips up and down on the hard shaft. He keeps going for a while, bringing you to the brink of an orgasm several times, but stopping each time to let you cool down a bit. Then finally he goes all out, sucking on your cock hard and pumping it in and out of his throat. With all the built up arousal, you don't last much longer before a mind-blowing orgasm shakes your body, spurt after spurt of your seed filling Adam's mouth.";
	say "     Adam sticks out his tongue, showing off your white creamy cum, then demonstratively swallows it all. Then he stands up and gives you a deep kiss, making you taste some of your cum and playfully tongue-wrestling with you.";

to say AdamSex3:    [pussy-fucked by Adam]
	[puts Minotaur as lead monster in case of impregnation]
	repeat with y running from 1 to number of filled rows in table of random critters:
		choose row y in table of random critters;
		if name entry is "Minotaur":
			now monster is y;
			break;
	let baby be 0;
	if child is born or gestation of child is not 0, now baby is 1;
	say "     You pull Adam aside and lead him behind one of the long storage shelves in the tent. Giving him a deep kiss, you put your arms around him and slide your hands into his shorts at the back, feeling and softly squeezing his furred buns. Then you move on to his t-shirt, grabbing it and pulling it up and over his head, revealing Adam's fit and human upper body. Leaning down a bit, you suck on first one, then the other of his nipples, followed by licking over his chest and neck until you reach the chin and kiss him again. Moaning 'I want you inside me, beast-boy.', you stroke his cock through the shorts, then move back a step and quickly slide off your clothes. Adam watches you undress with a smile on his face and replies 'My pleasure, Ma'am.' before grabbing a pile of blankets out of the shelf and spreading them on the floor.";
	say "     Lying down on the improvised bedding, you have a nice view as Adam pulls down his shorts to stand naked before you. His long cock stands proudly erect in your direction, showing an interesting contrast of white skin against the black fur of his legs. Liking what you see, you spread your legs invitingly and stroke the lips of your pussy, moaning 'I'm waiting for you...'. Adam is very eager to follow your invitation, kneeling down and putting his head between your legs to lick your pussy. And what a long and talented tongue he has - after running it over your sensitive lips and clit, he sticks it inside your vagina, wiggling around and poking your inner walls with the tip. Next, he [if cocks of player > 0]runs his tongue up the underside of your cock, [otherwise]puts a line of small kisses up to your belly button, [end if]then moves up to lie on top of you and gives you a hungry kiss.";
	say "     Yearning for his cock inside you, you reach down and guide it to your opening, then scooch down a bit to get the head in. Adam moans in lust, sliding his manhood deeper, spreading your inner walls around his hard shaft. Soon he's all the way in, with his balls and soft furred hips rubbing against your body. For a moment, he just stays still like that, connected to you as intimately as possible, before starting to slide in and out. Moans rise in both your throats as he starts fucking you in earnest, going faster and faster with his deep strokes and rubbing just the right spots inside you. With the noise of your coupling quite loud now, it doesn't surprise you to see Elaine and a male soldier look behind the storage shelf to check out what's going on. You don't care if they watch, your whole mind focused on the virile half-minotaur fucking you.";
	say "     Wrapping your legs around him, you pull him towards you with each of his thrusts, making him slam into you harder and deeper. You lose track of time for a while as you're so thoroughly fucked, only few things registering through the lust-filled buzz in your head. One thing you do remember is Elaine pulling the soldier with her out of sight and moans starting up from the direction of her bed. As Adam does another deep thrust into your body, he stops for a moment, gasping 'I'm getting pretty close.'";
	say "     [line break]";
	say "     So, where do you want him to cum? (Y = your pussy; N = your mouth) ";
	if player consents:
		say "     You moan 'Fill me with your beast-boy cum.' while flexing your inner muscles around his cock. Eager to follow your command, he resumes his deep and hard strokes, only lasting for a few more before his body stiffen in your embrace. Adam holds tight onto you with his arms as spurt after spurt of his fertile seed shoots out of his throbbing cock and into you, filling your womb with warm cum.[fimpregchance]";
		say "     'That was amazing - you are amazing.' he moans in between kisses as you lie there for a while, making out with each other as you come down from the rush of orgasm.";
	otherwise:
		say "     You moan 'Come in my mouth.' and slide your hands down to his hips to softly push him off. Eager to follow your command, Adam pulls out and moves up over you, kneeling down with his legs left and right of your body. His soft fur feels amazing against your chest and... what's still stroking your pussy? You stretch your head far enough to the side to look past Adam and catch a glimpse of his flexible tail stroking you with the bushy tip. Smiling, you pull on Adam's hips so he moves up a bit more, then get to work on his cock, teasing it with your tongue before sucking on it. It doesn't take long before you push him over the edge, gasping in lust as cum boils up from his balls and gushes into your mouth. You fondle his balls as he comes, feeling them twitch with each new blast of seed.";
		say "     After you milk the last bit of cum out of his cock, Adam moves back to lie down with you on the blankets. 'That was amazing - you are amazing.' he moans as you pull him in for a sloppy kiss, making him taste his own cum from your mouth. You stay there together for a while, making out with each other as you come down from the rush of orgasm.";

to say AdamSex4:    [ass-fucked by Adam]
	[puts Minotaur as lead monster in case of impregnation]
	repeat with y running from 1 to number of filled rows in table of random critters:
		choose row y in table of random critters;
		if name entry is "Minotaur":
			now monster is y;
			break;
	let baby be 0;
	if child is born or gestation of child is not 0, now baby is 1;
	say "     You pull Adam aside and lead him behind one of the long storage shelves in the tent. Giving him a deep kiss, you put your arms around him and slide your hands into his shorts at the back, feeling and softly squeezing his furred buns. Then you move on to his t-shirt, grabbing it and pulling it up and over his head, revealing Adam's fit and human upper body. Leaning down a bit, you suck on first one, then the other of his nipples, followed by licking over his chest and neck until you reach the chin and kiss him again. Moaning 'I want you inside me, beast-boy.', you stroke his cock through the shorts, then move back a step and quickly slide off your clothes. Adam watches you undress with a smile on his face and replies 'My pleasure, sir.' before grabbing a pile of blankets out of the shelf and spreading them on the floor.";
	say "     Adam pulls down his shorts to stand naked before you, his long cock standing proudly erect in anticipation and showing an interesting contrast of white skin against the black fur of his legs. Liking what you see, you kneel down on the improvised bedding and wiggle your ass at him, moaning 'I'm waiting for you...'. Adam is very eager to follow your invitation, getting behind you on his knees, then leaning down to rim you. And what a long and talented tongue he has - after running it over the outside of your hole a few times, he sticks it inside, wiggling around and poking your inner walls with the tip. Next, he puts a line of small kisses up your back until he reaches your neck and softly pulls your head to the side for a quick kiss.";
	say "     You feel Adam's soft fur against your ass and legs and the warmth of his engorged cock rest on the small of your back. Yearning to feel him inside you, you reach back and stroke his shaft, then scooch forward a bit until it's resting in the crack of your ass. Adam moans in lust as he pushes forward, slowly increasing the pressure against your pucker before it relents and his cockhead enters you. Putting his arms around you from behind, he holds you close as he slides his manhood deeper, spreading your inner walls around his hard shaft. Soon he's all the way in, with his balls and soft furred hips rubbing against your body. For a moment, he just stays still like that, connected to you as intimately as possible, before starting to slide in and out. Moans rise in both your throats as he starts fucking you in earnest, going faster and faster with his deep strokes and rubbing just the right spots inside you.";
	say "     With the noise of your coupling quite loud now, it doesn't surprise you to see Elaine and a male soldier look behind the storage shelf to check out what's going on. You don't care if they watch, your whole mind focused on the virile half-minotaur fucking you.";
	say "     You rock backwards against him with each of his thrusts, making him slam into you harder and deeper. Losing track of time for a while as you're so thoroughly fucked, only few things not to do with Adam's movements, smell, etc. register through the lust-filled buzz in your head. One thing you do remember is Elaine pulling the soldier with her out of sight and moans starting up from the direction of her bed. As Adam does another deep thrust into your body, he stops for a moment, gasping 'I'm getting pretty close.'";
	say "     [line break]";
	say "     So, where do you want him to cum? (Y = your ass; N = your mouth) ";
	if player consents:
		say "     You moan 'Fill me with your beast-boy cum.' while flexing your inner muscles around his cock. Eager to follow your command, he resumes his deep and hard strokes, only lasting for a few more before his orgasm overcomes him. Adam holds on tight with his arms around you as spurt after spurt of his fertile seed shoots out of his throbbing cock and into you, filling your asshole with warm cum.[mimpregchance] [if cocks of player > 0]Feeling your lover's load inside you, your own arousal mounts quickly, and after a moment of rapid stroking you come all over the blankets below.[end if]";
		say "     Turning you around, Adam says 'That was amazing - you are amazing.' before pulling you down on the blankets to make out and lie there together as come down from the rush of orgasm.";
	otherwise:
		say "     You moan 'Come in my mouth.' and slide your hands down to his hips to softly push him off. Eager to follow your command, Adam pulls out and moves around you, holding his hard cock out for you to suck. Smiling, you lean forward a bit and get to work on his cock, teasing it with your tongue before sucking on it. It doesn't take long before you push him over the edge, gasping in lust as his cum gushes into your mouth. You fondle his balls as he comes, feeling them twitch with each new blast of seed they deliver.";
		say "     After you milk the last bit of cum out of his cock, Adam moves back to lie down with you on the blankets. 'That was amazing - you are amazing.' he moans as you pull him in for a sloppy kiss, making him taste his own cum from your mouth. You stay there together for a while, making out with each other as you come down from the rush of orgasm.";

to say AdamSex5:    [give Adam's tight ass a good fucking]
	say "     You pull Adam aside and lead him behind one of the long storage shelves in the tent. Giving him a deep kiss, you put your arms around him and slide your hands into his shorts at the back, feeling and softly squeezing his furred buns. Then you move on to his t-shirt, grabbing it and pulling it up and over his head, revealing Adam's fit and human upper body. Leaning down a bit, you suck on first one, then the other of his nipples, followed by licking over his chest and neck until you reach the chin and kiss him again. Moaning 'I'm gonna fuck you, beasty-boy.' you push him to the next shelf and turn him around. Standing close behind him, rubbing your crotch against his ass, you grab his hands and set them on one of the higher shelf boards so he can hold on to it. Then you run your hands down over his defined chest, arriving at his shorts. Quickly undoing the button and zipper, you pull them down, so Adam now is naked and ready for you to fuck him.";
	say "     Shucking off your own clothes in no time at all, you take your engorged cock in hand and move in position behind your half-minotaur lover. It's an amazingly soft feeling as you slide it up and down along the crack of his ass with his short black fur rubbing against your skin. Yearning to feel his hole around your cock, you lean forward, pressing against his pucker with the tip of your maleness. Adam moans in lust as you pop in, stretching his sphincter around your cock's girth. Putting your arms around him from behind, you hold him close as you slide your manhood deeper, spreading his inner walls around your hard shaft. Soon you're all the way in, with your balls and hips touching the soft fur of Adam's ass. For a moment, you just stay still like that, connected to him as intimately as possible, before starting to slide in and out. Moans rise in both your throats as you start fucking him in earnest, going faster and faster with deep strokes and rubbing just the right spots to make him gasp and moan.";
	say "     With the noise of your coupling quite loud now, it doesn't surprise you to see Elaine look behind the storage shelf to check out what's going on. You don't care if she or anyone else watch, your whole mind focused on the tight hole of your virile half-minotaur buddy. Grabbing his hips with both hands, you speed up, slamming into Adam harder and deeper. Then suddenly he gasps, a shudder running through his body as the anal stimulation drives him to orgasm, with long spurts of his cum splattering all over the supply chests of the shelf he's holding on to. With his tight hole flexing around your shaft with each of his shots, you're soon getting close to cumming yourself.";
	say "     [line break]";
	say "     So, where do you want to spend your load? (Y = in his ass; N = in his mouth) ";
	if player consents:
		say "     You just keep going, thrusting into Adam several more times hard enough to create loud slapping noises as your hips meet his ass. Then as you feel your balls tightening, you bottom out in him, holding Adam tightly around the chest while spurt after spurt of your seed shoot into him.";
		say "     When you pull your cock out of his dripping hole a while later, Adam turns around, saying 'That was amazing - you are amazing.' before pulls you into an embrace, making out with you.";
	otherwise:
		say "     You moan 'I'm close - and I want to come in your moth.' and carefully pull out of his ass. Eager to follow your command, Adam turns around and kneels before you, taking hold of your hard cock. Smiling, he runs his tongue over the underside, then goes to work giving you a blow-job. It doesn't take long before he pushes you over the edge, gasping in lust as your load gushes into Adam's mouth. After he milks the last bit of cum out of your cock, Adam looks up at you and sticks out his tongue, showing you the ample load you shot. Pulling him up from the ground, you give him a deep kiss, tasting your own cum as your tongues explore each other's mouths.";
		say "     Coming back up to breath, Adam moans 'That was amazing - you are amazing.' affectionately stroking your cheek.";


Sergeant Alexander is a man. Sergeant Alexander is in Parade Ground.
The description of Sergeant Alexander is "     Sergeant Alexander is a tough-looking soldier, who's seen a lot in his time. He's about 5'11' and pretty buff and muscular. Looks like he's responsible for caring for the minotaur, as he carries box after box of vegetables and other foodstuffs to the creature from behind one of the nearby tents.";
The conversation of Sergeant Alexander is { "Ick!" };
lastfuck of Alexander is usually 555.

instead of sniffing Sergeant Alexander:
	say "     He smells a bit of sweat and minotaur cum. Since he's often pretty close to the action on the parade ground, his uniform has a lot of dried cum-splatters responsible for the smell.";

Instead of fucking Sergeant Alexander:
	say "[AlexanderFucking]";

instead of conversing Sergeant Alexander:
	now sextablerun is 0;
	blank out the whole of table of fucking options;
	choose a blank row in table of fucking options;
	now title entry is "Watch a man take his turn getting fucked at the hitching post.";
	now sortorder entry is 1;
	now description entry is "Witness the minotaur assfucking a soldier.";
	if CampBravoWomenAllowed is 1:
		choose a blank row in table of fucking options;
		now title entry is "Watch the minotaur fuck a female soldier.";
		now sortorder entry is 2;
		now description entry is "Observe the minotaur breeding a woman.";
	choose a blank row in table of fucking options;
	now title entry is "Take position at the hitching post yourself.";
	now sortorder entry is 3;
	now description entry is "Present yourself to the minotaur for fucking.";
	choose a blank row in table of fucking options;
	now title entry is "Proposition Sergeant Alexander for sex.";
	now sortorder entry is 4;
	now description entry is "Let Sergeant Alexander fuck you.";
	choose a blank row in table of fucking options;
	now title entry is "Do Nothing, turn away.";
	now sortorder entry is 5;
	now description entry is "Break the conversation off.";
	sort the table of fucking options in sortorder order;
	while sextablerun is 0:
		repeat with y running from 1 to number of filled rows in table of fucking options:
			choose row y from the table of fucking options;
			say "[link][y] - [title entry][as][y][end link][line break]";
		say "Pick the corresponding number> [run paragraph on]";
		get a number;
		if calcnumber > 0 and calcnumber <= the number of filled rows in table of fucking options:
			now current menu selection is calcnumber;
			choose row calcnumber in table of fucking options;
			say "[title entry]: [description entry][line break]";
			say "Is this what you want?";
			if player consents:
				let nam be title entry;
				clear the screen and hyperlink list;
				now sextablerun is 1;
				if (nam is "Watch a man take his turn getting fucked at the hitching post."):
					say "[CampBravoWatchMen]";
				if (nam is "Watch the minotaur fuck a female soldier."):
					say "[CampBravoWatchWomen]";
				if (nam is "Take position at the hitching post yourself."):
					say "[CampBravoGetFucked]";
				if (nam is "Proposition Sergeant Alexander for sex."):
					say "[AlexanderFucking]";
				if (nam is "Do Nothing, turn away."):
					say "     You wave Sergeant Alexander off as he looks at you inquisitively and turn away.";


to say CampBravoWatchMen:
	say "     'So you want to watch someone's ass getting filled by Tiny Tim?' Sergeant Alexander asks and you nod in confirmation. 'Just a moment, the next plugging team will be here shortly.' He chats a bit with you until two buck-naked soldiers enter the parade ground, carrying nothing but two butt-plugs and a bottle of lube.";
	let diceroll be a random number from 1 to 20;  [a bit randomness which soldiers come]
	if diceroll is greater than 13:  [guy #1 straight, guy #2 gay]
		say "     The first one, a brown haired guy looks a bit apprehensively at the large minotaur next to the hitching post, while his blond partner has his eyes mostly on his buddy's bubble butt in front of him and shows a nine inch erection. Arriving at the field bed near the hitching post, the men set down their butt plugs on it and the blond one has his buddy bend over, then goes on to lube his ass, giving the man's opening a massage with very eager fingers. With his cock even harder than before, you'd say he himself wants to use the opportunity to fuck that hole.";
	otherwise:                       [both straight]
		say "     Both men look very apprehensively at the large minotaur next to the hitching post. The first one pales visibly as the beast stands up, allowing him to clearly see the massive shaft dangling between its legs. He drops his butt plug on the field bed, then hesitantly steps towards the hitching post. Sergeant Alexander calls to him 'Hey buddy, go let your partner put some of that lube up your butt - you'll need it.' The naked soldier looks back a bit sheepishly, then turns around and bends over so he other guy can lube him up.";
	say "     [line break]";
	say "     Ready now, the first man goes over to the hitching post and bends over, tightly gripping the smooth wood as he sticks out his ass for the minotaur. The tall beast steps up and gives the man a sniff, then gives a lustful rumble and runs his wide tongue up over the human's bare back. Grabbing his long shaft in a hand, he then slaps it softly against the soldier's buns a few times before bringing it to the waiting hole. You hear a gasp from the man as the minotaur pushes forward, popping the head of his thick cock inside, then starts to slide deeper. Inch after inch of rock-hard shaft slides into the tight opening until the minotaur is finally fully inside the man, his large balls rubbing up against him.";
	say "     For a moment, only the man and beast's heavy breathing can be heard, then the minotaur pulls almost all the way out and slams back inside with a bellow, gripping the human's hips tightly with his large hands as he humps him with deep thrusts. The mystical beast's animal nature becomes obvious now, as he tirelessly ruts the man without holding back, each thrust accompanied by the meaty slap of his balls against the human's ass. Having been prepared for this and thoroughly lubed, the soldier takes the hard fucking pretty well, with the first gasps at the thick intruder into his ass quickly replaced by lustful moaning. His cock hardens without ever being touched and you can see a glistening line of precum dripping from its tip.";
	say "     The minotaur continues fucking the soldier without pause for about twenty minutes, until the man under him gives a sudden shout of 'Aaah... I'm coming!' and thick ropes of cum spray from his manhood, splattering over the cum-drenched ground. The anal muscles of his human buddy clenching in orgasm around his long thrusting cock, the minotaur isn't far behind. With a last deep shove he buries his cock fully in the human as his balls spasm with the blasts of cum shooting up his shaft. Breathing heavily, he steadies himself with one hand on the wooden post while the other holds the human close until his orgasm subsides.";
	say "     [line break]";
	if diceroll is greater than 13:   [guy #1 straight, guy #2 gay]
		say "     Sergeant Alexander waves the second man forward to stand ready with his butt-plug for when the minotaur pulls out so they don't lose any of the cum. He eagerly steps forward, already having lubed himself up and being almost impatient at taking a ride on the long minotaur cock himself.";
	otherwise:                        [both straight]
		say "     Sergeant Alexander waves the second man forward to stand ready with his butt-plug for when the minotaur pulls out so they don't lose any of the cum. The man seems a lot less anxious now to be the next in line for fucking. Might be that he's reconsidered his position on anal intercourse after seeing his buddy come while being fucked - or it could just be the pheromone-laden musk of the minotaur laying heavily in the air...";

to say CampBravoWatchWomen:
	say "     'You want to watch Tiny Tim breed a woman? You and everyone else in the camp I guess...' Sergeant Alexander points behind you, where the male soldiers of the camp walk up from their tents alone or in small groups and find places at the edge of the parade ground. Then suddenly, the murmur among the men falls silent. You follow their looks and see a female soldier coming out of the quartermaster's tent in the west carrying a bottle of lube.";
	say "     She makes her way to the field bed in the center of the open space, then starts taking off her clothes accompanied by whistles and cheering from the crowd. The minotaur seems spell-struck by seeing her undressing, motionless except for his hard shaft twitching in anticipation and dribbling precum on the ground. When the soldier is completely naked, she walks over to the towering beast-man and takes him by the hand, leading him effortlessly towards the field bed. She strokes the minotaur's fur and the rock-hard muscles of his chest a bit, then picks up the lube bottle and starts rubbing a generous amount over his long cock. Then she lies down on the field bed, spreading her legs invitingly.";
	say "     Seeing a ready pussy before him breaks the minotaur from his daze, as he leans down and starts running his wide tongue over the soldier's folds. After a few licks, he continues upwards over her flat stomach to the woman's perky breasts, sucking softly on one, then the other. The woman pulls his head up to hers for a kiss, then feels for his long shaft and positions it at her opening. Without hesitation, the minotaur pushes forward, penetrating her pussy and spreading her folds around his thick maleness. He pushes into her further and further until finally bottoming out, her belly showing a slight bulge from the massive member stuffed inside her. Then with a lustful bellow, he starts thrusting in and out, each deep thrust accompanied by the female soldier's satisfied moans.";
	say "     As the minotaur humps the woman faster and faster, the field bed under hear starts to screech with the protesting sound of over-strained metal. Showing that there's still room for some thought in his bull's head besides rutting, the large creature picks up his sexual partner before he breaks the bed. Now standing, he holds the woman close to his muscled chest, sliding her up and down on his erection. The change of position seems to have increased the soldier's pleasure quite a bit, as she now screams in lust every time he slides in, rubbing very sensitive spots deep in her vagina.";
	say "     [line break]";
	say "     Looking around, you see that many of the men around the parade ground have their own cocks out, stroking themselves and sometimes each other while watching the show. They sure are happy that you talked the Major into allowing this. There's a constant background noise of moaning now and the ground gets a good soaking in cum as many of the men stroke themselves to orgasm and shoot their loads.";
	say "     [line break]";
	say "     Returning the minotaur, it seems he's getting close from the volume and urgency of his grunts and bellows. Then he pushes the woman down on his shaft all the way and roars, his large balls twitching as they send thick streams of minotaur seed into the soldier's womb. After at last a dozen spurts, he gives a very satisfied grunt and pulls her off his cock. Giving her face an affectionate lick, he puts the woman down on the field bed, her belly still bulging a bit - this time from all the cum inside...";

to say CampBravoGetFucked:
	[puts Minotaur as lead monster in case of impregnation]
	repeat with y running from 1 to number of filled rows in table of random critters:
		choose row y in table of random critters;
		if name entry is "Minotaur":
			now monster is y;
			break;
	let baby be 0;
	if child is born or gestation of child is not 0, now baby is 1;
	if cunts of player > 0:
		if CampBravoWomenAllowed is 1:
			say "     'You want to be bred by Tiny Tim? Hope you like an audience...' Sergeant Alexander points behind you, where soldier who overheard you talking to him rushes off to get the other men. Soon quite a few of the male soldiers of the camp walk up from their tents and gather at the edges of the parade ground. Meanwhile, Sergeant Alexander goes into the quartermaster's tent and comes out with a bottle of lube which he hands to you.";
			say "     Walking to the field bed in the center of the open space, you start to strip, causing appreciative whistles and cheers from the men watching. The minotaur seems spell-struck by seeing you undress, standing motionless except for his hard shaft twitching in anticipation and dribbling precum on the ground. When you stand completely naked, you walk over to the towering beast-man and take him by the hand, leading him effortlessly towards the field bed. You stroke the minotaur's fur and the rock-hard muscles of his chest a bit, then pick up the lube bottle and start rubbing a generous amount over his long cock. When you're done, you lie down on your back on the field bed and spread your legs invitingly.";
			say "     Seeing a ready pussy before him breaks the minotaur from his daze, as he leans down and starts running his wide tongue over your sensitive folds. After a few licks, he continues upwards over your stomach and chest to your nipples, sucking softly on one, then the other. You pull his head up to yours for a quick kiss, then feel for his long shaft and position it at your opening. Without hesitation, the minotaur pushes forward, penetrating your pussy and spreading the folds around his thick maleness. He pushes into you further and further, his shaft rubbing the inner walls of your vagina, until finally bottoming out. Looking down over yourself, you see your show a slight bulge from the massive member stuffed inside. Then with a lustful bellow, the minotaur starts thrusting in and out, each deep thrust making you moan from the pleasant feelings of having him inside.";
			say "     As the minotaur humps you faster and faster, the field bed under you starts to screech with the protesting sound of over-strained metal. Showing that there's still room for some thought in his bull's head besides rutting, the large creature picks up your body before he breaks the bed. Now standing, he holds you close to his muscled chest, sliding you up and down on his erection. In this new position, his cock rubs up against all new pleasure centers inside you, driving you into a lust-filled daze. You can't help yourself but scream and moan in lust every time he slides in, your body hungering for him to do it again and again.";
			say "     You lose track of time as your mind gets lost for a while in a world that only consists of you, the minotaur and his cock, only registering short glimpses of the camp and the men jerking off to you getting fucked. When you can focus again after another in a series of incredible orgasms, you notice that your minotaur seems to be getting close himself. He's increasing the volume and urgency of his grunts and bellows. Then suddenly, he pushes your body down on his shaft all the way and roars, his thick shaft pulsing with blast after blast of fertile seed shooting directly into your womb. He just keeps on cumming, filling you up to the brink and even making your belly bulge a bit more from all the cum inside.[fimpregchance]";
			say "     Thoroughly satisfied, the minotaur gives your sweaty chest one last lick, running his broad tongue over your nipples, then lowers your body back to the field bed. Almost reluctantly, he pulls his large cock out of the warm, cum-filled cave of your vagina and sits down on the ground to rest. Sergeant Alexander comes over to you with a towel in hand, helping you clean up a bit and wipe off the cum running out of your body before you put on your clothes and gear again.";
			infect "Minotaur";
		otherwise:
			say "     As you start to disrobe, Sergeant Alexander interrupts you, saying 'Sorry, no women allowed. Major's orders. You'll have to take that up with him before I can let you do that.'";
	otherwise:
		say "     'So you want to let the bull take a ride in your ass?' Sergeant Alexander asks and you nod in confirmation. 'One moment please, sir.' He walks into the quartermaster's tent in the west and shortly comes out of it again carrying a bottle of lube. 'You'll need this. And don't use it sparingly.'";
		say "     You quickly undress, piling your clothes and equipment on the field bed standing close to the minotaur's fucking post. Then you lube your asshole with a generous amount of slippery gel, walk over to the hitching post and take position with your hands on the smooth wooden crossbar. Wiggling your ass invitingly brings the large minotaur to stand behind you almost instantly. He sniffs you, gives a lustful grumble and then runs his wide tongue up from your ass over your bare back. Grabbing his long shaft in a hand, he slaps it softly against your butt-cheeks before bringing it to your waiting hole. You give a short gasp as the minotaur pushes forward, popping the head of his thick cock inside, then starts to slide deeper. Inch after inch of rock-hard shaft slides through your tight opening until the minotaur is finally fully inside your body, his large balls rubbing up against your ass.";
		say "     He holds still for a moment, his breach blowing warm against your neck, giving your ass time to get used to his massive girth. Then the pause is over, and the minotaur pulls almost all the way out and slams back inside with a bellow, gripping your hips tightly with his large hands as he humps you with deep thrusts. His animal nature becomes obvious now, as he tirelessly ruts your body without holding back, each thrust accompanied by the meaty slap of his balls against the your ass. You're quite thankful now for the lube, as it allows that massive cock to slide in and out of your body a lot easier than it otherwise would. The hard shaft rubbing sensitive spots deep inside you quickly has you moaning lustfully. [if cocks of player > 0]Your own cock hardens without ever being touched and looking down, you see drops of precum glisten at its tip.[otherwise]Even though you have no genitalia yourself, a deep pleasant feeling suffuses your body.[end if]";
		say "     The hot any heavy coupling with the large beast continues for about twenty minutes, until the feelings of getting fucked drive you over the edge, your body shaking as orgasm grips it. [if cocks of player > 0]Your cock jerks as thick ropes of cum spray from its tip, splattering over the cum-drenched ground. [end if]As you writhe in the throes of lust, your anal muscles flex and spasm around the minotaur's long thrusting cock, giving your beastly fucker the last push to arrive at his own fulfillment. With a last deep shove he buries his cock fully in you as his balls contract with each blast of cum shooting up his shaft. Breathing heavily, he steadies himself with one hand on the wooden post while the other holds your body close until his orgasm subsides.[mimpregchance]";
		say "     Thoroughly satisfied, the minotaur gives your sweaty back one last lick, then pulls is large cock out, leaving your stretches asshole gaping and with cum running out of it. Sergeant Alexander comes over to you and helps you to the field bed nearby to sit down and rest a bit before you put on your clothes and gear again.";
		infect "Minotaur";

to say AlexanderFucking:
	if cocks of player > 0 or cunts of player is 0:
		say "     He shakes his head as you proposition him. 'Sorry, sonny - this man's only here for the ladies. Why don't you do a round at the post, if you're into that stuff...'";
	otherwise:
		if (lastfuck of Alexander - turns < 12):
			say "     As you approach Alexander, he immediately sees the lust-filled twinkle in your eyes. He gives you an apologetic shrug, saying 'Sorry, I got duties to perform. Can't fuck around all day, even though I'd like to...' He gives you a quick kiss, then goes to grab some more food for the minotaur.";
		otherwise:
			setmonster "human";
			choose row monster from the table of random critters;
			say "     'How could I say no to such an offer', he replies huskily, then leads you to the side and around a tent, out of sight from the minotaur. He says 'Wouldn't want Tiny Tim over there to get any ideas.' with a nod back towards the parade ground. Then he pulls you close to himself, running large hands over your body and giving you a hot and heavy kiss.";
			say "     Accompanied by lustful groping at your curves, Sergeant Alexander peels you out of your clothing, then lifts you up on a stack of crates roughly hip-height for him. Pulling off his shirt and throwing it aside, he then opens his zipper, freeing a nicely thick piece of hard man-meat.";
			say "     After moistening its shaft a bit with his spit he steps up spreads your legs wide. As he rubs your sensitive folds softly with the tip of his cock, you moan lustfully, then gasp as he pushes forward, plunging his shaft into your body. The girth of his member rubbing against your inner walls just feels amazing and the man really knows what he's doing, giving you a deep and very satisfying shafting.";
			say "     He's got good stamina, so your intense coupling takes quite a while before the man's grunts and moans rise to a lust-filled crescendo and he buries his cock all the way in your cunt with one last deep thrust. You can feel his member pulsing as blast after blast of cum paint your insides, giving you a delightfully full feeling. The large man leans over you to make out some more with his shaft still inside your body, depositing spurts of fertile seed as he wrangles your tongue with his.[fimpregchance]";
			say "     After depositing his full load inside you, he raises his upper body again and gives your naked form an appreciative look, accompanied by a slight twitch of his cock in your pussy. 'You're an awesome fuck, baby. Let's go for round two.' He starts to pump his cock in and out of you again, but before he can get really into it, a deep-voiced bellow of 'I'm hungry.' sounds from the parade ground. With a sigh, Sergeant Alexander pulls out of your pussy and packs his manhood away with some difficulty because of its erect state. 'Sorry to cut this short, but duty calls...' he says, giving you a quick kiss and then hurries back to the minotaur with a crate full of food.";
			now lastfuck of Alexander is turns;

Tiny Tim is a man.
The description of Tiny Tim is "     The large minotaur affectionately called 'Tiny Tim' by the soldiers in the camp currently sits on the ground besides the hitching post used in couplings with him. He's a magnificently well-build creature, at least nine feet tall and with large curved horns adoring his bull-like head. His otherwise human upper body shows thick, ropey muscles under bronzed skin. Beginning at the hip downwards, he has dark brown shaggy fur covering strong two-jointed legs that end in hooves. Between his legs dangles a long human-like cock and two large balls. The minotaur almost constantly half-hard, his manhood springing up instantly to its full one and a half feet of erect length every time the creature sees or smells a sexual partner.";
Tiny Tim is in Parade Ground.
The conversation of Tiny Tim is { "[one of]'Alexander is my friend.'[or]'I'm hungry.'[or]'I'm horny. Want to fuck.'[or]'Are you my friend?'[or]'You smell nice.'[or]'Humans are tight. Good.'[or]'Nice place here.'[or]'I like soldiers.'[at random]" };

instead of sniffing Tiny Tim:
	say "     The minotaur has a heavy musk with an undertone of cum around him. It must be laden with pheromones, as you're getting quite horny just from taking it in.";

Instead of fucking Tiny Tim:
	say "     As you move purposefully towards the creature, Sergeant Alexander steps in your way. 'Now just a minute there. I'm responsible for caring for our horny beast here, so if you want to do or watch anything around him talk with me.'";


Soldier Event ends here.