Version 1 of Viking Woman by Wahn begins here.
[Version 1 - Initial Setup]


"Adds a Female Viking to Flexible Survival's Wandering Monsters table"

[ VikingRelationship - relationship and quest variable             ]
[   0: never met                                                   ]
[   1: initial encounter done, no player win yet                   ]
[   2: player won once                                             ]
[   3: player won twice                                            ]
[   4: player won three times (Sonya likes them)                   ]
[   5: player won four times                                       ]
[   6: player won five times                                       ]
[   7: father heard about the player - her cousin appears instead  ]
[   8: the father is waiting for the player to appear for a fight  ]
[   9: during the fight                                            ]
[  20: player won her hand                                         ]
[ 100: player ran away from the father, Vikings sailed away        ]
[ 101: (not used really, father killed the player)                 ]
[ 150: player punched Sonya instead of taking her virginity        ]
[ VikingPregnancy - pregnancy progress variable                    ]
[  0: not preggers                                                 ]
[  1: male player knocked her up (invisible)                       ]
[  2: male player knocked her up (slightly visible)                ]
[  3: male player knocked her up (bulging belly)                   ]
[  4: after the kid's been born                                    ]

[ VikingKidGender                                                  ]
[  0: no kids                                                      ]
[  1: just boys                                                    ]
[  2: just girls                                                   ]
[  3: mixed                                                        ]

[ VikingKidShape - Sonya's kids are part human, part X             ]
[ VikingKidCounter - number of children with the player            ]
[ VikingPregCounter - timer for the next birth (48h from start)    ]

VikingRelationship is a number that varies.			[main variable, something for the saveword]
VikingPregnancy is a number that varies.
VikingKidShape is a text that varies.
VikingKidGender is a number that varies.
VikingKidCounter is a number that varies.				[another thing that should be saved]
VikingPregCounter is a number that varies.
VikingUltimatum is a number that varies.

An everyturn rule:
	if VikingRelationship < 100: [to prevent birth-messages after she's gone from play]
		if VikingPregCounter is 1:
			increase VikingKidCounter by 1;
			increase score by a random number between 5 and 10;
			if Player is in Sonya's Cabin:
				say "     Suddenly, Sonya calls 'It's time!' and starts panting loudly, holding her bulging stomach with both hands. You rush over to her and help her to sit on the bed, then open the door to the lengthwise hallway through the ship and shout for help. In no time at all, an elderly viking woman and two younger women rush into the cabin and help Sonya out of her clothes while telling her to keep calm breathe. So you're not standing in the way, they just tell you to sit on the bed beside your wife, keeping her company and holding her hand.";
				if a random chance of 1 in 2 succeeds: [kid is a boy]
					if VikingKidShape is "Human":
						say "     Soon, her contractions come quicker and quicker, and then with a gush of fluids, Sonya's child is pushed out of her stretched vagina. The matronly viking gives him a soft slap on the butt and the baby takes his first breath, then immediately starts bawling at full volume. After tying off the umbilical cord and cutting it, the little one is quickly picked up by the experienced women and wiped down, then brought up to his mother, who puts him against her chest in a loving embrace. A bit of peace and quiet returns to the cabin a moment later as he finds her breast and starts suckling. The little human boy in Sonya's arms - your child - looks so incredibly cute, you just can't help yourself from leaning over to kiss him on the head, then give your wife a loving kiss on the lips.";
						say "     While you hold and kiss your viking wife, the reality of a nanite-infected world starts to show itself in your child, as the boy grows and grows, seemingly getting weeks, if not months older with each swallow of her milk. The baby quickly becomes a toddler, then a very young child, getting older and more developed by the second. By the time he's finished drinking from one breast, then the other, a boy looking about fourteen years old is sitting between the two of you. He gives Sonya and you a hug, then shouts 'I'm gonna go play catch with [one of]Svetjalf[or]Snorri[or]Leif[or]Arnvid[or]Ari[or]Finn[or]Gudrun[or]Halla[or]Svala[at random]', jumping off the bed to run out of the room, naked as he is. Seems like he absorbed the knowledge about the other children directly from his mother. Oh, kids grow up so fast these days...";
					else:
						say "     Soon, her contractions come quicker and quicker, and then with a gush of fluids, Sonya's child is pushed out of her stretched vagina. The matronly viking gives him a soft slap on the butt and the baby takes his first breath, then immediately starts bawling at full volume. After tying off the umbilical cord and cutting it, the little one is quickly picked up by the experienced women and wiped down, then brought up to his mother, who puts him against her chest in a loving embrace. A bit of peace and quiet returns to the cabin a moment later as he finds her breast and starts suckling. The little baby in Sonya's arms - your child - looks so incredibly cute in a half-human, half-[VikingKidShape] way, you just can't help yourself from leaning over to kiss him on the head, then give your wife a loving kiss on the lips.";
						say "     While you hold and kiss your viking wife, the reality of a nanite-infected world starts to show itself in your child, as the boy grows and grows, seemingly getting weeks, if not months older with each swallow of her milk. The baby quickly becomes a toddler, then a very young child, getting older and more developed by the second. By the time he's finished drinking from one breast, then the other, a boy looking about fourteen is sitting between the two of you. He gives Sonya and you a hug, then shouts 'I'm gonna go play catch with [one of]Svetjalf[or]Snorri[or]Leif[or]Arnvid[or]Ari[or]Finn[or]Gudrun[or]Halla[or]Svala[at random]', jumping off the bed to run out of the room, naked as he is. Seems like he absorbed the knowledge about the other children directly from his mother. Oh, kids grow up so fast these days...";
					if VikingKidGender is 0:
						now VikingKidGender is 1;
					else if VikingKidGender is 2:
						now VikingKidGender is 3;
				else: [kid was a girl]
					if VikingKidShape is "Human":
						say "     Soon, her contractions come quicker and quicker, and then with a gush of fluids, Sonya's child is pushed out of her stretched vagina. The matronly viking gives her a soft slap on the butt and the baby takes her first breath, then immediately starts bawling at full volume. After tying off the umbilical cord and cutting it, the little one is quickly picked up by the experienced women and wiped down, then brought up to her mother, who puts her against her chest in a loving embrace. A bit of peace and quiet returns to the cabin a moment later as the girl finds her breast and starts suckling. The little human baby in Sonya's arms - your child - looks so incredibly cute, you just can't help yourself from leaning over to kiss her on the head, then give your wife a loving kiss on the lips.";
						say "     While you hold and kiss your viking wife, the reality of a nanite-infected world starts to show itself in your child, as the girl grows and grows, seemingly getting weeks, if not months, older with each swallow of her milk. The baby quickly becomes a toddler, then a very young child, getting more developed by the second. By the time she's finished drinking from one breast, then the other, a girl looking about fourteen years old is sitting between the two of you. She gives Sonya and you a hug, then shouts 'I'm gonna go play catch with [one of]Svetjalf[or]Snorri[or]Leif[or]Arnvid[or]Ari[or]Finn[or]Gudrun[or]Halla[or]Svala[at random]', jumping off the bed to run out of the room, naked as she is. Seems like she absorbed the knowledge about the other children directly from her mother. Oh, kids grow up so fast these days...";
					else:
						say "     Soon, her contractions come quicker and quicker, and then with a gush of fluids, Sonya's child is pushed out of her stretched vagina. The matronly viking gives her a soft slap on the butt and the baby takes her first breath, then immediately starts bawling at full volume. After tying off the umbilical cord and cutting it, the little one is quickly picked up by the experienced women and wiped down, then brought up to her mother, who puts her against her chest in a loving embrace. A bit of peace and quiet returns to the cabin a moment later as the girl finds her breast and starts suckling. The little baby in Sonya's arms - your child - looks so incredibly cute in a half-human, half-[VikingKidShape] way, you just can't help yourself from leaning over to kiss her on the head, then give your wife a loving kiss on the lips.";
						say "     While you hold and kiss your viking wife, the reality of a nanite-infected world starts to show itself in your child, as the girl grows and grows, seemingly getting weeks, if not months, older with each swallow of her milk. The baby quickly becomes a toddler, then a very young child, getting more developed by the second. By the time she's finished drinking from one breast, then the other, a girl looking about fourteen years old is sitting between the two of you. She gives Sonya and you a hug, then shouts 'I'm gonna go play catch with [one of]Svetjalf[or]Snorri[or]Leif[or]Arnvid[or]Ari[or]Finn[or]Gudrun[or]Halla[or]Svala[at random]', jumping off the bed to run out of the room, naked as she is. Seems like she absorbed the knowledge about the other children directly from her mother. Oh, kids grow up so fast these days...";
					if VikingKidGender is 0:
						now VikingKidGender is 2;
					else if VikingKidGender is 1:
						now VikingKidGender is 3;
				now VikingPregnancy is 0; [no need to tell the player about the birth, as he was present]
			else:
				say "You have a strange feeling in your body, as if you somehow just know that one of your offspring has entered this world. Maybe you should look for Sonya again on the beach[if VikingRelationship is 20] or visit her in her cabin on the Viking ship[end if]...";
				now VikingPregnancy is 4; [so she can tell the player about their kid in the next meeting]
			now VikingPregCounter is 0;
		else if VikingPregCounter is 12:
			now VikingPregnancy is 3; [very visible pregnancy]
		else if VikingPregCounter is 24:
			now VikingPregnancy is 2; [visible pregnancy]
			if VikingRelationship < 7: [getting visibly pregnant will get Sonya's involvement with the player noticed]
				now VikingRelationship is 7;
		if VikingPregCounter > 1:
			decrease VikingPregCounter by 1;
	if VikingUltimatum is 1:
		say "You remember the [bold type]challenge of the viking chieftain[roman type] against you - running out right about now, your time being up. With you not even showing up, now they'll see Sonya as doubly dishonored - losing in combat against an outlander (with most of them suspecting you of magic or some trickery), who additionally isn't even brave enough to fight her father. Hopefully, you won't run into any of them again, as this'll enrage all of them - even Sonya - a lot. She'd likely try to kill you...";
		now VikingUltimatum is 0;
		now Chieftain's Challenge is resolved;
		now Resolution of Chieftain's Challenge is 99; [failed to show up]
		repeat with y running from 1 to number of filled rows in Table of Random Critters:
			choose row y in Table of Random Critters;
			if Name entry is "Viking Woman":
				now MonsterID is y;
				now area entry is "Nowhere";
				break;
	else if VikingUltimatum is 8:
		say "Time's ticking away if you want to fight for Sonya. The [bold type]chieftain's challenge[roman type] you can answer on the beach will run out today, so better grab your gear now and get moving - but watch out, the man will actually try to kill you...";
	else if VikingUltimatum is 16:
		say "Time's ticking away if you want to fight for Sonya. The [bold type]chieftain's challenge[roman type] you can answer on the beach will run out in two days, so better grab your gear now and get moving soon - but watch out, the man will actually try to kill you...";
	if VikingUltimatum > 1:
		decrease VikingUltimatum by 1;

Section 1 - Creature Responses

to say Viking wins:
	if VikingRelationship is 9: [fighting Sonya's father]
		say ""; [dealt with in the event]
	else:
		if HP of Player > 0: [player submits]
			if the player is not facially human or the player is not bodily human or the player is not skintone human: [non-human player = a monster, in her words]
				if VikingRelationship is 1: [first time submit]
					if charisma of Player > 15: [handsome enough for some sexy time]
						say "     'What kind of monster are you, meekly surrendering to me? I was told there are powerful beasts in the world, not... this.' With a scoff, she shoves you to the ground. 'Let's see if you're at least of use for some pleasure.' With that, she puts down her weapon and starts undressing, revealing a tough and strong body, though not without female curves and a pair of well-rounded, perky breasts.";
						say "[VikingWinSex]";
					else: [ugly people just get robbed]
						say "     'What kind of monster are you, meekly surrendering to me? I was told there are powerful beasts in the world, not... this.' With a scoff, she shoves you to the ground. 'Let's see if you've at least got something worth taking.' With that, she starts poking around in your stuff.";
						if carried of food >= 1:
							say "     Finding some food in your pack, she puts it in her satchel and then walks away, leaving you lying in the dust without any look back.";
							ItemLoss food by 1;
						else if carried of water bottle >= 1:
							say "     Finding a bottle of water in your pack, she puts it in her satchel and then walks away, leaving you lying in the dust without a look back.";
							ItemLoss water bottle by 1;
						else:
							say "     Not finding anything to her liking as she throws one after another of your belongings aside, the Viking woman grumbles 'What a waste of time.' Then she turns away from you and walks off, leaving you lying in the dust without any look back.";
				else if VikingRelationship is 2: [submit after one victory]
					say "     'What?!' She shoves you to the ground 'To think you beat me! Must have been a lucky blow, with you proving so meek now.' With a scoff, she glares down at you. 'Let's see if you're at least of use for some pleasure.' With that, she puts down her weapon and starts undressing, revealing a tough and strong body, though not without female curves and a pair of well-rounded, perky breasts.";
					say "[VikingWinSex]";
				else if VikingRelationship is 3: [submit after 2 victories]
					say "     A disappointed expression appears on the face of the Viking woman's face 'No spirit to fight, monster? And I thought you were shaping up so well until now.' With a sigh, she shrugs and continues 'Well then, if you want to be a tame monster, get busy and give me some pleasure.' She puts down her weapon and starts undressing, revealing a tough and strong body, though not without female curves and a pair of well-rounded, perky breasts.";
					say "[VikingWinSex]";
				else if VikingRelationship > 3: [submit after 3 and more victories]
					say "     She is a bit nonplussed, saying 'What's this, my monster? Don't you want to fight and prove your power over me again and ravish me afterwards?' Looking at you affectionately for a moment, she shrugs and continues 'Well, I won't just have sex with you - can't, really - I don't want to appear weak. But we can still have some fun...' She puts down her weapon and starts undressing, revealing a tough and strong body, though not without female curves and a pair of well-rounded, perky breasts.";
					say "[AffectionateVikingWinSex]";
			else: [human form player]
				if VikingRelationship is 1: [first time submit]
					if charisma of Player > 15: [handsome enough for some sexy time]
						say "     'Hmph - you're just another of those weaklings that run around like frightened chickens when they're raided. I had hoped to find somewhat more impressing people in this new land.' With a scoff, she shoves you to the ground. 'Let's see if you're at least of use for some pleasure.' With that, she puts down her weapon and starts undressing, revealing a tough and strong body, though not without female curves and a pair of well-rounded, perky breasts.";
						say "[VikingWinSex]";
					else: [ugly people just get robbed]
						say "     'Hmph - you're just another of those weaklings that run around like frightened chickens when they're raided. I had hoped to find somewhat more impressing people in this new land.' With a scoff, she shoves you to the ground. 'Let's see if you've at least got something worth taking.' With that, she starts poking around in your stuff.";
						if carried of food >= 1:
							say "     Finding some food in your pack, she puts it in her satchel and then walks away, leaving you lying in the dust without any look back.";
							ItemLoss food by 1;
						else if carried of water bottle >= 1:
							say "     Finding a bottle of water in your pack, she puts it in her satchel and then walks away, leaving you lying in the dust without a look back.";
							ItemLoss water bottle by 1;
						else:
							say "     Not finding anything to her liking as she throws one after another of your belongings aside, the Viking woman grumbles 'What a waste of time.' Then she turns away from you and walks off, leaving you lying in the dust without any look back.";
				else if VikingRelationship is 2: [submit after one victory]
					say "     'What?!' She shoves you to the ground 'You think I'd treat you differently like any other outlander, only because you've beaten me once? Must have been a lucky blow too, with you proving so meek now.' With a scoff, she glares down at you. 'Let's see if you're at least of use for some pleasure.' With that, she puts down her weapon and starts undressing, revealing a tough and strong body, though not without female curves and a pair of well-rounded, perky breasts.";
					say "[VikingWinSex]";
				else if VikingRelationship is 3: [submit after 2 victories]
					say "     A disappointed expression appears on the face of the Viking woman's face 'No spirit to fight? And I thought you were shaping up so well until now.' With a sigh, she shrugs and continues 'Well then, if you want to be just a servant, get busy and give me some pleasure.' She puts down her weapon and starts undressing, revealing a tough and strong body, though not without female curves and a pair of well-rounded, perky breasts.";
					say "[VikingWinSex]";
				else if VikingRelationship > 3: [submit after 3 and more victories]
					say "     She is a bit nonplussed, saying 'What's this, my warrior? Don't you want to fight and prove your power over me again and ravish me afterwards?' Looking at you affectionately for a moment, she shrugs and continues 'Well, I won't just have sex with you - can't, really - I don't want to appear weak. But we can still have some fun...' She puts down her weapon and starts undressing, revealing a tough and strong body, though not without female curves and a pair of well-rounded, perky breasts.";
					say "[AffectionateVikingWinSex]";
		else: [player loses]
			if the player is not facially human or the player is not bodily human or the player is not skintone human: [non-human player = a monster, in her words]
				if VikingRelationship is 1: [first time loss]
					if charisma of Player > 15: [handsome enough for some sexy time]
						say "     Leaving you dazed with her last blow, she gives you a shove and you fall on your ass. 'A bit weak for a monster, aren't you? Oh well, maybe you're just a stunted one.' Looking down on your prone form, she lets her gaze wander over you appraisingly. 'Still, there was at least some fight in you. I wonder if you can please a woman too, creature...' With that, she puts down her weapon and starts undressing, revealing a tough and strong body, though not without female curves and a pair of well-rounded, perky breasts.";
						say "[VikingWinSex]";
					else: [ugly people just get robbed]
						say "     Leaving you dazed with her last blow, she gives you a shove and you fall on your ass. 'A bit weak for a monster, aren't you? Oh well, maybe you're just a stunted one.' Looking down on your prone form, she lets her gaze wander over you appraisingly. 'Let's see if you've at least got something worth taking.' With that, she starts poking around in your stuff.";
						if carried of food >= 1:
							say "     Finding some food in your pack, she puts it in her satchel and then walks away, leaving you lying in the dust without any look back.";
							ItemLoss food by 1;
						else if carried of water bottle >= 1:
							say "     Finding a bottle of water in your pack, she puts it in her satchel and then walks away, leaving you lying in the dust without a look back.";
							ItemLoss water bottle by 1;
						else:
							say "     Not finding anything to her liking as she throws one after another of your belongings aside, the Viking woman grumbles 'What a waste of time.' Then she turns away from you and walks off, leaving you lying in the dust without any look back.";
				else if VikingRelationship is 2: [loss after one victory]
					say "     Leaving you dazed with her last blow, she gives you a shove and you fall on your ass. 'I win.' Looking down on your prone form, she lets her gaze wander over you appraisingly and a small smile comes to her lips. 'That victory of yours from before must have been pure luck, but still... you've got some spirit to fight. I could imagine taking you with me when we finally raid this land. For now, I'll just have some fun with you and catch you again later.' With that, she puts down her weapon and starts undressing, revealing a tough and strong body, though not without female curves and a pair of well-rounded, perky breasts.";
					say "[VikingWinSex]";
				else if VikingRelationship is 3: [loss after 2 victories]
					say "     Leaving you dazed with her last blow, she puts a finger against your chest, then slowly pushes your swaying body until you fall on your ass. 'I win. You won't get another victory against me today.' Looking down on your prone form, she lets her gaze wander over you appraisingly and a wide smile comes to her lips. 'Though that you actually did beat me twice shows that there's more to you than I thought at first. You might just be worth as a pet to accompany me into battle. I look forward to fighting and capturing you when we finally raid this coast. But for now, how about you give me some pleasure.' With that, she puts down her weapon and starts undressing, revealing a tough and strong body, though not without female curves and a pair of well-rounded, perky breasts.";
					say "[VikingWinSex]";
				else if VikingRelationship > 3: [loss after 3 and more victories]
					say "     She is a bit nonplussed, saying 'Not quite up to your usual form, my monster? You'll have to do better if you want to prove your power over me again and ravish me afterwards.' Looking at you affectionately for a moment, she shrugs and continues 'Well, sex is out for now, but we can still have some fun...' Guiding you up behind a dune, she tells you to strip and then softly pushes you to lie on the ground. Taking off her own gear, she reveals a tough and strong body, though not without female curves and a pair of well-rounded, perky breasts.";
					say "[AffectionateVikingWinSex]";
			else: [human form player]
				if VikingRelationship is 1:
					if charisma of Player > 15: [handsome enough for some sexy time]
						say "     Leaving you dazed with her last blow, she gives you a shove and you fall on your ass. 'I win. Not a big surprise, but at least you fought back a bit.' Looking down on your prone form, she lets her gaze wander over you appraisingly. 'You've shown some courage and just might be worth taking as a serf. Let's see how you measure up providing pleasure to me...' With that, she puts down her weapon and starts undressing, revealing a tough and strong body, though not without female curves and a pair of well-rounded, perky breasts.";
						say "[VikingWinSex]";
					else: [ugly people just get robbed]
						say "     Leaving you dazed with her last blow, she gives you a shove and you fall on your ass. 'A bit weak for a monster, aren't you? Oh well, maybe you're just a stunted one.' Looking down on your prone form, she lets her gaze wander over you appraisingly. 'Let's see if you've at least got something worth taking.' With that, she starts poking around in your stuff.";
						if carried of food >= 1:
							say "     Finding some food in your pack, she puts it in her satchel and then walks away, leaving you lying in the dust without any look back.";
							ItemLoss food by 1;
						else if carried of water bottle >= 1:
							say "     Finding a bottle of water in your pack, she puts it in her satchel and then walks away, leaving you lying in the dust without a look back.";
							ItemLoss water bottle by 1;
						else:
							say "     Not finding anything to her liking as she throws one after another of your belongings aside, the Viking woman grumbles 'What a waste of time.' Then she turns away from you and walks off, leaving you lying in the dust without any look back.";
				else if VikingRelationship is 2: [loss after one victory]
					say "     Leaving you dazed with her last blow, she gives you a shove and you fall on your ass. 'I win. Not a big surprise, but at least you fought back.' Looking down on your prone form, she lets her gaze wander over you appraisingly and a small smile comes to her lips. 'That time you won before must have been pure luck, but still... I like my serfs to have a bit of spirit. Too bad I'm in the middle of scouting this coast, or I'd take you along to the ship. For now, I'll just have some fun with you and catch you later, when we really raid.' With that, she puts down her weapon and starts undressing, revealing a tough and strong body, though not without female curves and a pair of well-rounded, perky breasts.";
					say "[VikingWinSex]";
				else if VikingRelationship is 3: [loss after 2 victories]
					say "     Leaving you dazed with her last blow, she puts a finger against your chest, then slowly pushes your swaying body until you fall on your ass. 'I win. You won't get another victory against me today.' Looking down on your prone form, she lets her gaze wander over you appraisingly and a wide smile comes to her lips. 'Though that you actually did beat me twice shows that there's more to you than I thought at first. You'll be my favorite serf after we raid this coast and carry off our loot. I look forward to fighting and capturing you then. But for now, how about you give me some pleasure.' With that, she puts down her weapon and starts undressing, revealing a tough and strong body, though not without female curves and a pair of well-rounded, perky breasts.";
					say "[AffectionateVikingWinSex]";
				else if VikingRelationship > 3: [loss after 3 and more victories]
					say "     She is a bit nonplussed, saying 'Not quite up to your usual form, my warrior? You'll have to do better if you want to prove your power over me again and ravish me afterwards.' Looking at you affectionately for a moment, she shrugs and continues 'Well, sex is out for now, but we can still have some fun...' Guiding you up behind a dune, she tells you to strip and then softly pushes you to lie on the ground. Taking off her own gear, she reveals a tough and strong body, though not without female curves and a pair of well-rounded, perky breasts.";
					say "[AffectionateVikingWinSex]";

to say VikingWinSex: [demanding sex]
	WaitLineBreak;
	say "     Coming to stand over you, she puts a hand to her pussy and spreads its lips a bit. The tall Nordic beauty just looks amazing standing over you, and your gaze inevitably is drawn to wander over her perfect, pale skin, the pretty bush of blond pubic hair, her toned body and finally the pair of well-rounded breasts. You get so distracted by the alluring sights that you totally blank out that she says something. Only when you get poked in the side by her naked foot do you hear the by then impatient order 'Get busy - now!'";
	say "     Sitting up, you bring your head up between her legs, your nose almost bumping against her crotch in your hurry. Licking over her folds and teasing the Viking's clit with your tongue, you start giving her the oral attention she demands. Then you bring your fingers into the game too, stroking her nether lips, then pushing one and another into her vagina, spreading and caressing her inner passage. Pleasing this attractive woman has your own libido rising to new heights, [if Player is male]your cock almost painfully hard[else if Player is female]your cunt dripping wet[else]your whole body tingling[end if], but you don't dare slowing down on her to take care of yourself.";
	WaitLineBreak;
	say "     Fingering and licking her pussy, you draw pleased gasps and moans from the woman, which get louder and louder as she quickly moves towards orgasm. Her hands grab your head tightly at one point to hold you against her tightly for some extra tongue action, during which a new tone of urgency comes into her shouts of pleasure. Then finally, she reaches the point of no return, panting and shaking as her climax courses through her whole body. You can feel her inner muscles tense and twitch around your fingers, and femcum starts running down your fingers and onto your tongue.";
	if the player is not facially human or the player is not bodily human or the player is not skintone human: [non-human player = a monster, in her words]
		say "     As her orgasm slowly winds down, the Nordic woman takes a few deep breaths, then goes to collect her gear. Meanwhile, you get busy [if Player is male]stroking your cock[else if Player is female]fingering your pussy[else]stroking yourself[end if] to take care of your own needs. As the Viking bends over to pick up her sword, she gives you another look and chuckles. 'Hah, maybe you're just another kind of monster - less powerful, but skilled in other ways. You'll be busy when we finally raid this coast.' With that, she turns and walks away.";
	else: [human player]
		say "     As her orgasm slowly winds down, the Nordic woman takes a few deep breaths, then goes to collect her gear. Meanwhile, you get busy [if Player is male]stroking your cock[else if Player is female]fingering your pussy[else]stroking yourself[end if] to take care of your own needs. As the Viking bends over to pick up her sword, she gives you another look and chuckles. 'Hah, at least that's something you're good at. Keep up training your skills, you'll need them again when we come to really raid this coast.' With that, she turns and walks away.";
	NPCSexAftermath Player receives "OralPussy" from Sonya;

to say AffectionateVikingWinSex: [sex with player, gets the player off too]
	WaitLineBreak;
	if the player is not facially human or the player is not bodily human or the player is not skintone human: [non-human player = a monster, in her words]
		say "     Kneeling in the sand between your legs, Sonya runs her hands up your body and slides herself forward to lie on top of you. The soft touch of her perky breasts against your chest sends pleasant tingles through your body. A lustful moan escapes your lips, leading over into a hungry kiss as she presses her lips against yours and explores your mouth with her tongue. 'My [one of]brave[or]strong[or]powerful[or]beloved[or]handsome[or]beautiful[or]handsome[at random] monster, how I long for your touch. You might be just an outsider and not one of us, though... maybe you could be. But for now, let's just enjoy this.'";
	else: [human player]
		say "     Kneeling in the sand between your legs, Sonya runs her hands up your body and slides herself forward to lie on top of you. The soft touch of her perky breasts against your chest sends pleasant tingles through your body. A lustful moan escapes your lips, leading over into a hungry kiss as she presses her lips against yours and explores your mouth with her tongue. 'My [one of]brave[or]strong[or]powerful[or]beloved[or]handsome[or]beautiful[or]handsome[at random] warrior, how I long for your touch. You might be just an outsider and not one of us, though... maybe you could be. But for now, let's just enjoy this.'";
	LineBreak;
	if Player is male: [male+herm]
		say "     With that, she grinds her crotch against yours, your hard shaft rubbing against her soft, pale skin. Panting in lust, you bring your hands to her hips, pushing them up a bit so you can align your cock with her pussy. Touching her nether lips with its tip, you can feel them spreading a bit for your entry, then... pull away. Sonya grins down at you, saying 'Ahah - you didn't earn that this time, lover. See it as a motivation to fight better next time...' She moves further up and turns around, then leans forward until she's in the 69 position on top of you. Her crotch is right in your face and the blond hair of her bush tickles your chin. Going with the flow, you put your tongue to work, licking and teasing her pussy. Meanwhile, your Viking partner takes hold of your cock, stroking it and fondling your balls softly. Then she takes the tip into her mouth and sinks her lips deeper around the shaft, bobbing up and down.";
		say "     The two of you lick and suck and stroke each other for quite a while, each totally focused on the other's pleasure. When things get pretty close for both of you, Sonya changes positions again, getting to kneel over your crotch. With flowing movements of her hips, she rubs the moist and swollen lips of her pussy along the shaft of your cock, sometimes teasingly letting the tip of it come between them then quickly moving down along the shaft again. It doesn't take more than a minute or two of this to finally drive you over the edge, gasping as your balls twitch and spurt after spurt of your seed splats all over your chest and abdomen. The Viking woman isn't far behind, the feel of your pulsing shaft rubbing against her pussy lips giving her an intense climax.";
		WaitLineBreak;
		if the player is not facially human or the player is not bodily human or the player is not skintone human:
			say "     Sticky with sweat, cum and female juices, you lie there together, holding each other in your arms as your orgasms wind down. Breathing deeply, Sonya moans 'I love you, my monster.' and presses a kiss against your lips. You keep making out for a moment longer, then each gather your gear and get back to everyday post-apocalyptic survival.";
		else:
			say "     Sticky with sweat, cum and female juices, you lie there together, holding each other in your arms as your orgasms wind down. Breathing deeply, Sonya moans 'I love you, my warrior.' and presses a kiss against your lips. You keep making out for a moment longer, then each gather your gear and get back to everyday post-apocalyptic survival.";
		NPCSexAftermath Player receives "OralPussy" from Sonya;
		NPCSexAftermath Sonya receives "OralCock" from Player;
	else if Player is female: [female]
		say "     With that, she grinds her crotch against yours, rubbing your two pussies against each other. Sonya grins down at you, saying 'How about we eat each other out...' She moves further up and turns around, then leans forward until she's in the 69 position on top of you. Her crotch is right in your face and the blond hair of her bush tickles your chin. Going with the flow, you put your tongue to work, licking and teasing her pussy. Meanwhile, your Viking partner does the same below, her tongue and fingers expertly stimulating your pussy.";
		say "     The two of you lick and suck and stroke each other for quite a while, each totally focused on the other's pleasure. When things get pretty close for both of you, Sonya changes positions again, getting to kneel over your crotch. With flowing movements of her hips, she rubs the moist and swollen lips of her pussy against yours. Knowing exactly how to please a woman, she moves you towards orgasm at the same pace as herself, and less than a minute later, the two of you climax at the same time, loud gasps and moans only interrupted as she kisses you.";
		WaitLineBreak;
		if the player is not facially human or the player is not bodily human or the player is not skintone human:
			say "     Sticky with sweat and female juices, you lie there together, holding each other in your arms as your orgasms wind down. Breathing deeply, Sonya moans 'I love you, my monster.' and presses another kiss against your lips. You keep making out for a moment longer, then rub yourselves clean with the beach's very fine dry sand and each gather your gear. Time to get back to everyday post-apocalyptic survival.";
		else:
			say "     Sticky with sweat and female juices, you lie there together, holding each other in your arms as your orgasms wind down. Breathing deeply, Sonya moans 'I love you, my warrior.' and presses another kiss against your lips. You keep making out for a moment longer, then rub yourselves clean with the beach's very fine dry sand and each gather your gear. Time to get back to everyday post-apocalyptic survival.";
		NPCSexAftermath Player receives "OralPussy" from Sonya;
		NPCSexAftermath Sonya receives "OralPussy" from Player;
	else: [neuter]
		say "     With that, she grinds her crotch against yours, and even though you don't have any genitals, her touch wakes urges inside you. Sonya grins down at you, saying 'How about you eat me out and I stoke you there...' She moves further up and turns around, then leans forward until she's in the 69 position on top of you. Her crotch is right in your face and the blond hair of her bush tickles your chin. Going with the flow, you put your tongue to work, licking and teasing her pussy. Meanwhile, your Viking partner caresses the skin of your bare crotch with her fingers and tongue.";
		say "     The two of you lick and stroke each other for quite a while, each totally focused on the other's pleasure. When things get pretty close for both of you, Sonya changes positions again, getting to kneel over your crotch again. With flowing movements of her hips, she rubs the moist and swollen lips of her pussy against you. It feels great, and less than a minute later, a tingly feeling of satisfaction runs through your whole body. Satisfied, Sonya quickly strokes herself and joins you just moments later, her femcum dripping down on you.";
		WaitLineBreak;
		if the player is not facially human or the player is not bodily human or the player is not skintone human:
			say "     Sticky with sweat and female juices, you lie there together, holding each other in your arms as your orgasms wind down. Breathing deeply, Sonya moans 'I love you, my monster.' and presses another kiss against your lips. You keep making out for a moment longer, then rub yourselves clean with the beach's very fine dry sand and each gather your gear. Time to get back to everyday post-apocalyptic survival.";
		else:
			say "     Sticky with sweat and female juices, you lie there together, holding each other in your arms as your orgasms wind down. Breathing deeply, Sonya moans 'I love you, my warrior.' and presses another kiss against your lips. You keep making out for a moment longer, then rub yourselves clean with the beach's very fine dry sand and each gather your gear. Time to get back to everyday post-apocalyptic survival.";
		NPCSexAftermath Player receives "OralPussy" from Sonya;

to say Viking loses:
	if VikingRelationship is 1: [first time victory over her]
		if the player is not facially human or the player is not bodily human or the player is not skintone human: [non-human player = a monster, in her words]
			say "     Your last hit leaves the Viking woman swaying on her feet. For a moment it looks like she's gathering strength to continue fighting, then she lets out her breath in a huff and drops her sword and shield. 'You're stronger than I thought, monster. *pant* I... I Sonya Frithjofsdotter - I must admit defeat. I still can't believe this - no one ever beat me!' She looks to the ground for a moment, then back at you. 'Well then - time to keep my promises. I swore an oath to Freya that I wouldn't let a weakling be my first, and so I never, I couldn't - even Leif's son Snorri wasn't strong enough. I never thought that a monster would be...'";
		else: [human player]
			say "     Your last hit leaves the Viking woman swaying on her feet. For a moment it looks like she's gathering strength to continue fighting, then she lets out her breath in a huff and drops her sword and shield. 'You're stronger than I thought, outlander. *pant* I... I Sonya Frithjofsdotter - I must admit defeat. I still can't believe this - no one ever beat me!' She looks to the ground for a moment, then back at you. 'Well then - time to keep my promises. I swore an oath to Freya that I wouldn't let a weakling be my first, and so I never, I couldn't - even Leif's son Snorri wasn't strong enough. I never thought that an outlander would be...'";
		LineBreak;
		say "     Falling silent, the young Viking woman leads you up and over the crest of the nearest dune, then starts taking off her armor and clothes.";
		LineBreak;
		say "     [bold type]What now?[roman type][line break]";
		LineBreak;
		say "     ([link]Y[as]y[end link]) - Have sex with her.";
		say "     ([link]N[as]n[end link]) - Tell her she doesn't have to do this.";
		if Player consents:
			LineBreak;
			say "[VikingVirginSex]";
			increase VikingRelationship by 1;
		else:
			LineBreak;
			say "     As you tell her she doesn't have to do this, she's not at all relieved, as you might have thought, but rather... annoyed. Pulling off the scale mail covering her chest and revealing a very attractive upper body with pale skin and two perky breasts, she growls 'What part of 'Oath to a god' did you not understand, you idiot?' Uhoh - looks like her eyes glowed a bit as she said that, and there's a hum of electricity in the air that makes you feel very uneasy about declining her again.";
			LineBreak;
			say "     [bold type]Fuck her after all?[roman type][line break]";
			LineBreak;
			say "     ([link]Y[as]y[end link]) - Better to just go with it...";
			say "     ([link]N[as]n[end link]) - Hell no!";
			if Player consents:
				LineBreak;
				LineBreak;
				say "[VikingVirginSex]";
				increase VikingRelationship by 1;
			else:
				LineBreak;
				say "     Making a fist, you punch the viking woman in the nose, sending her sprawling backwards on the sand. She appears dazed for the moment - giving you a chance to gain some ground and get away from her. As you hurry over the beach, a static charge starts to buld all around you. Uh-oh... that doesn't seem like a good thing. You tense for what might happen next, then feel the hum of electricity suddenly quiet down - like the calm before a storm. Your first instinct in that moment is to jump to the side... and it definitively was the right one. A literal thunderbolt hits the sand right where you had been standing, leaving a patch of it molten into glass, spraying outside in a shower of searing hot droplets. Quite a few of them hit and singe you, but at least you didn't get fried by that lightning bolt.";
				if HP of Player > 10:
					now HP of Player is 7;
	else if VikingRelationship is 2: [second victory]
		if the player is not facially human or the player is not bodily human or the player is not skintone human: [non-human player = a monster, in her words]
			say "     Breathing heavily, Sonya stumbles back from your last hit, then lowers her sword and shield with a grunt, looking annoyed. 'You beat me - again! There just might be more to the legends about you monsters you than I thought.' With a shrug, her expression changes to one that is a bit more friendly, coupled with eyes that roam over your body with interest. She bites her lip for a second, then continues 'You know... last time with you wasn't half bad, and you certainly proved yourself again. How about another tumble in the dunes?'";
		else: [human player]
			say "     Breathing heavily, Sonya stumbles back from your last hit, then lowers her sword and shield with a grunt, looking annoyed. 'You beat me - again! There just might be more to you than I thought. You're certainly no easily raided outlander.' With a shrug, her expression changes to one that is a bit more friendly, coupled with eyes that roam over your body with interest. She bites her lip for a second, then continues 'You know... last time with you wasn't half bad, and you certainly proved yourself again. How about another tumble in the dunes?'";
		LineBreak;
		say "     [bold type]Do you let her lead you there for another round of sex with this beautiful Viking woman?[roman type][line break]";
		LineBreak;
		say "     ([link]Y[as]y[end link]) - Get it on with Sonya.";
		say "     ([link]N[as]n[end link]) - Excuse yourself for now.";
		if Player consents:
			LineBreak;
			say "[VikingLossSex]";
		else:
			LineBreak;
			say "     You excuse yourself and tell her now isn't a good time. Sonya isn't too pleased with your rejection, but it doesn't go further than a few grumbles to herself as she walks off without a look back.";
		increase VikingRelationship by 1;
	else if VikingRelationship > 2 and VikingRelationship < 7: [three+ victories]
		if the player is not facially human or the player is not bodily human or the player is not skintone human: [non-human player = a monster, in her words]
			say "     Breathing heavily, Sonya stumbles back from your last hit, then lowers her shield and sheathes her sword. With only a tiny bit of hesitation, she acknowledges defeat, then walks up to you and kisses your lips. 'Another victory for you, my brave monster.' She rubs her nose against yours and lets her hands roam over your body, then nods towards the nearby dunes. 'Come, let's have some fun!'";
		else: [human player]
			say "     Breathing heavily, Sonya stumbles back from your last hit, then lowers her shield and sheathes her sword. With only a tiny bit of hesitation, she acknowledges defeat, then walks up to you and kisses your lips. 'Another victory for you, my outlander warrior.' She rubs her nose against yours and lets her hands roam over your body, then nods towards the nearby dunes. 'Come, let's have some fun!'";
		LineBreak;
		say "     [bold type]Do you let her lead you there for another round of sex with this beautiful Viking woman?[roman type][line break]";
		LineBreak;
		say "     ([link]Y[as]y[end link]) - Get it on with Sonya.";
		say "     ([link]N[as]n[end link]) - Excuse yourself for now.";
		if Player consents: [sexy time]
			LineBreak;
			say "[AffectionateVikingLossSex]";
		else: [no sex after all]
			LineBreak;
			say "     You excuse yourself and tell her now isn't a good time. Sonya isn't too pleased with your rejection, but it doesn't go further than a few grumbles to herself as she walks off without a look back.";
		increase VikingRelationship by 1;
	else if VikingRelationship is 20: [victory by a player who won her hand]
		if the player is not facially human or the player is not bodily human or the player is not skintone human: [non-human player = a monster, in her words]
			say "     Breathing heavily, Sonya stumbles back from your last hit, then lowers her shield and sheathes her sword. With only a tiny bit of hesitation, she acknowledges defeat, then walks up to you and kisses your lips. 'Another victory for you, my brave monster.' She rubs her nose against yours and lets her hands roam over your body, then nods towards the nearby dunes. 'Come, let's have some fun!'";
		else: [human player]
			say "     Breathing heavily, Sonya stumbles back from your last hit, then lowers her shield and sheathes her sword. With only a tiny bit of hesitation, she acknowledges defeat, then walks up to you and kisses your lips. 'Another victory for you, my outlander warrior.' She rubs her nose against yours and lets her hands roam over your body, then nods towards the nearby dunes. 'Come, let's have some fun!'";
		LineBreak;
		say "     [bold type]Do you let her lead you there for another round of sex with your beautiful Viking wife?[roman type][line break]";
		LineBreak;
		say "     ([link]Y[as]y[end link]) - Get it on with Sonya.";
		say "     ([link]N[as]n[end link]) - Excuse yourself for now.";
		if Player consents: [sexy time]
			LineBreak;
			say "[AffectionateVikingLossSex]";
		else: [no sex after all]
			LineBreak;
			say "     You excuse yourself and tell her now isn't a good time. Sonya isn't too pleased with your rejection, but it doesn't go further than a few grumbles to herself as she walks off without a look back.";
	if VikingRelationship is 9: [fighting Sonya's father]
		say ""; [dealt with in the event]

to say VikingVirginSex: [first time with the player]
	if Player is male: [male+herm]
		say "     You watch Sonya take off her armor and then the rest of her clothes, revealing the pale-skinned perfection of her well-trained body. There is a certain... urgency to her movements, as you guess there would be with her a virgin and all. Now completely naked, her perky breasts bouncing as she moves, the young Viking moves to lie down in the sand, spreading her legs a bit and looking up expectantly at you. 'Come on, claim your prize - But you better be good. I've been waiting a long time for this.' Feeling decidedly overdressed, you quickly remove your own clothes, freeing your by now fully hard erection.";
		WaitLineBreak;
		say "     Following your stiff organ's lead, you kneel between Sonya's legs, running your hands down over the smooth skin of her legs then reaching out to cup her breasts. She moans softly as you stroke them and move on to taking her nipples, one after another, into your mouth and suckle on them. 'That feels *gasp* great, but... but come on - Fuck me!' she says, her hand sliding down your body to grasp your hard shaft and setting it against her moist pussy lips. Eager to fulfill her wish, you thrust into her body, easily penetrating her hymen and sliding deeper until you bottom out. It feels amazing to have her warm and tight passage stretched around your manhood, a sentiment clearly shared by the Nordic warrior-woman. You rest like that for a moment, balls deep inside this pale beauty, letting her get used to it.";
		say "     Soon, Sonya moans 'Go on. Take me!', her legs wrapping around your hips to pull you deeper into her vagina. Taking up sliding out then pounding deep into her again, you find yourself with a very enthusiastic partner, meeting each of your thrusts with a push of her hips. Her arms wrap around your upper body, pulling you fully on top of her as she seeks your lips with hers, hungrily making out with you. For a while, anything but the wild and urgent sex you have with her is forgotten, the two of you filling the air with loud moans and gasps of pleasure...";
		WaitLineBreak;
		say "     As much as you wish this could last forever, there are limits to everything. Her pants having gotten louder and faster quickly, Sonya suddenly pulls you even tighter against herself, holding you there as she shouts 'I'm coming!' You can feel her whole body shuddering under yours, the muscles in her vagina tightening their grip on your cock as the Viking orgasms. Not to lag too far behind, you abandon all restraint, grinding against her crotch urgently, and blow your load moments later. Pulse after pulse of your fertile seed shoot deep into the young woman's insides, making her well and truly deflowered.";
		say "     Exhausted, you stay on top of her, still with your cock inside, and try to catch your breath. Looks like Sonya has other ideas... suddenly the world spins as she rolls the two of you over until she's on top and straddling your hips. With a new composure, now that her lusts have been satisfied, she pulls off your softening shaft and cleans up a bit by rubbing off with the beach's very fine dry sand. Then she goes to collect her gear.";
		NPCSexAftermath Sonya receives "PussyFuck" from Player;
	else if Player is female: [female]
		say "     You watch Sonya take off her armor and then the rest of her clothes, revealing the pale-skinned perfection of her well-trained body. There is a certain... urgency to her movements, as you guess there would be with her a virgin and all. Now completely naked, her perky breasts bouncing as she moves, the young Viking moves to lie down in the sand, spreading her legs a bit and looking up expectantly at you. 'Come on, claim your prize - But you better be good. I've been waiting a long time for this.' Feeling decidedly overdressed, you quickly remove your own clothes, revealing your own pussy.";
		say "     With a sigh, Sonya remarks, 'Finally getting beaten - and then by a woman who can't even take me properly. Oh, why did it have to be you.' Looking down on the pale-skinned, beautiful woman, you tell her that she shouldn't worry about that - there are quite a lot that two women can do to enjoy themselves. Demonstrating one of them, you lie down yourself and part your legs, then tell the viking to get licking. After all, it's her duty to please you if she wants to fulfill that oath. Sonya grimaces slightly, clearly having imagined her first sexual encounter very differently, but after a moment of hesitation, she stands up with a huff and gets on all fours in front of you. Lowering her head, the striking woman then gives your pussy a first hesitant little lick.";
		WaitLineBreak;
		say "     You moan loudly as Sonya makes her first experiences with pleasing a woman orally, still somewhat resentful that you don't have a cock. Despite this, she gives it her best try, honor-bound as she is, and... after a little bit of fumbling around, it turns out she's a natural at it - licking and nibbling your sensitive little clit, gently rubbing and spreading your nether lips as a finger strokes the opening of your vagina. Of course, being a female herself, the viking just knows what to go for and how to drive a woman to the edge of orgasm, then across. After a short while of breathtaking stimulation by the blond beauty, you give a satisfied gasp, throwing your head back as femcum squirts from your opening and hits Sonya's face.";
		say "     The viking wipes your juices off her skin with a snort, then says, 'There, I took care of it for you. Now...' She starts to raise herself up, seemingly ready to leave the let-down of a first time behind - but you grab her by the shoulder and push her back down, as you're far from done with the sexy woman. Ordering Sonya to stay as she is, you move around to the Viking's backside, running a hand over her firm, well-rounded butt-cheeks. There is a pant from the Nordic beauty as your hand slides between her legs, brushing against sensitive nether lips and then reaching her little clittie. Sonya gives a breathless gasp as you rub over her button with a finger, gently tickling it while your other hand starts to spread the lips of her pussy apart.";
		WaitLineBreak;
		say "     As you slide one of your digits into Sonya, rubbing her virgin passage, you can't help but thing that there is something very delicious about having this strong woman before you on her hands and knees, shivering and panting helplessly as you touch her. This animates you to really put in some effort, teasing her first in one spot, then another, finding out what really gets her going. It's quite a lot of fun to learn that if you slide your finger in... just... like... so... and... then... do THIS - Sonya throws her head back moaning loudly as a mini-orgasm runs through her body. By now, her earlier reluctance is long forgotten, washed away with the steady trickle of female juices from a very, very wet and swollen pussy.";
		say "     You keep going for a while like this, playing with Sonya's body, making her tremble, pant and gasp, before you finally go all out, intensifying your finger-work to get her to the climax that has been building all this time. The beautiful woman's moans get louder and more high-pitched as they come faster and faster, then she gives something halfway between a squeak and an aroused shout as the point of no return is reached. Sonya rocks back - hard - to get even more of your teasing fingers inside her. As she does so, you feel something push back against them for a fraction of a second, then break - there it goes, Sonya's hymen. The pain of losing her cherry doesn't even register with the pale-skinned woman, as deep as she is in the grip of her orgasm...";
		WaitLineBreak;
		say "     Sinking forward to lie panting on the ground, her ass still half-raised, Sonya regains her breath after a minute or two, then rolls over on her side to look at you. Her eyes roam up and down your body, resting for a second on your own pussy, then she says, 'That was... unexpectedly good. I - I still would have preferred a cock though - I think. Well, my oath is now well and truly fulfilled.' With a new composure, now that her lusts have been satisfied, she sits up and cleans herself a bit by rubbing off with the beach's very fine dry sand. Then she goes to collect her gear.";
		NPCSexAftermath Sonya receives "OralPussy" from Player;
		NPCSexAftermath Sonya receives "PussyDildoFuck" from Player;
		now Dexterity of Sonya is 1;
	else: [neuter]
		say "     You watch Sonya take off her armor and then the rest of her clothes, revealing the pale-skinned perfection of her well-trained body. There is a certain... urgency to her movements, as you guess there would be with her a virgin and all. Now completely naked, her perky breasts bouncing as she moves, the young Viking moves to lie down in the sand, spreading her legs a bit and looking up expectantly at you. 'Come on, claim your prize - But you better be good. I've been waiting a long time for this.' Feeling decidedly overdressed, you quickly remove your own clothes, revealing your bare, genital-less crotch.";
		say "     Sonya gives a surprised 'What?', then remarks with a sigh 'Finally getting beaten - and then by... what are you, even? With nothing between your...' Looking down on the pale-skinned, beautiful woman, you tell her that she shouldn't worry about that - there are quite a lot she can do with you, even if it isn't fucking. Demonstrating one of them, you lie down yourself and part your legs, then tell the viking to get licking. After all, it's your right as the victor. Sonya grimaces slightly, her idea of a good time more centered on hard cocks and male bodies, but after a moment of hesitation, she stands up with a huff and gets on all fours in front of you. Lowering her head, the striking woman then gives your smooth crotch a first hesitant little lick.";
		WaitLineBreak;
		say "     You moan loudly as Sonya makes her first experiences with pleasing a genderless person orally, still somewhat resentful that you don't have a cock. Despite this, she gives it her best try, honor-bound as she is, and... after a little bit of fumbling around, it turns out she's a natural at it - licking and nibbling your sensitive skin, gently rubbing and finding the most tender spots. After a short while of breathtaking stimulation by the blond beauty, you give a satisfied gasp, throwing your head back as tremors of lust run through your whole being.";
		say "     The viking wipes her lips with a snort, then says, 'There, I took care of it for you. Now...' She starts to raise herself up, seemingly ready to leave - but you grab her by the shoulder and push her back down, as you're far from done with the sexy woman. Ordering Sonya to stay as she is, you move around to the Viking's backside, running a hand over her firm, well-rounded butt-cheeks. There is a pant from the Nordic beauty as your hand slides between her legs, brushing against sensitive nether lips and then reaching her little clittie. Sonya gives a breathless gasp as you rub over her button with a finger, gently tickling it while your other hand starts to spread the lips of her pussy apart.";
		WaitLineBreak;
		say "     As you slide one of your digits into Sonya, rubbing her virgin passage, you can't help but thing that there is something very delicious about having this strong woman before you on her hands and knees, shivering and panting helplessly as you touch her. This animates you to really put in some effort, teasing her first in one spot, then another, finding out what really gets her going. It's quite a lot of fun to learn that if you slide your finger in... just... like... so... and... then... do THIS - Sonya throws her head back moaning loudly as a mini-orgasm runs through her body. By now, her earlier reluctance is long forgotten, washed away with the steady trickle of female juices from a very, very wet and swollen pussy.";
		say "     You keep going for a while like this, playing with Sonya's body, making her tremble, pant and gasp, before you finally go all out, intensifying your finger-work to get her to the climax that has been building all this time. The beautiful woman's moans get louder and more high-pitched as they come faster and faster, then she gives something halfway between a squeak and an aroused shout as the point of no return is reached. Sonya rocks back - hard - to get even more of your teasing fingers inside her. As she does so, you feel something push back against them for a fraction of a second, then break - there it goes, Sonya's hymen. The pain of losing her cherry doesn't even register with the pale-skinned woman, as deep as she is in the grip of her orgasm...";
		WaitLineBreak;
		say "     Sinking forward to lie panting on the ground, her ass still half-raised, Sonya regains her breath after a minute or two, then rolls over on her side to look at you. Her eyes roam up and down your body, resting for a second on your own pussy, then she says, 'That was... unexpectedly good. I - I still would have preferred a cock though - I think. Well, my oath is now well and truly fulfilled.' With a new composure, now that her lusts have been satisfied, she sits up and cleans herself a bit by rubbing off with the beach's very fine dry sand. Then she goes to collect her gear.";
		NPCSexAftermath Sonya receives "PussyDildoFuck" from Player;
	LineBreak;
	if the player is not facially human or the player is not bodily human or the player is not skintone human: [non-human player = a monster, in her words]
		say "     As she pulls her clothes back on, Sonya gives your naked body a glance that lingers for a moment, then she shakes her head. 'You weren't half bad in fulfilling your duty in my oath - but don't think that makes you special in any way or gives you rights with me. You're still just a foreign monster, and one victory over me won't change that!' On that note, she turns away and walks off without a look back.";
	else: [human player]
		say "     As she pulls her clothes back on, Sonya gives your naked body a glance that lingers for a moment, then she shakes her head. 'You weren't half bad in fulfilling your duty in my oath - but don't think that makes you special in any way or gives you rights with me. You're still just an outlander, and one victory over me won't change that!' On that note, she turns away and walks off without a look back.";

to say VikingLossSex: [second time with the player]
	if Player is male:
		say "     After following the young viking to a secluded spot behind the crest of a dune, you watch Sonya take off her armor and then the rest of her clothes, revealing the pale-skinned perfection of her well-trained body. Now completely naked, her perky breasts bouncing as she moves, the young Viking moves to lie down in the sand, spreading her legs a bit and looking up expectantly at you. 'Come on, claim your prize.' Feeling decidedly overdressed, you quickly remove your own clothes, freeing your by now fully hard erection.";
		WaitLineBreak;
		say "     Following your stiff organ's lead, you kneel between Sonya's legs, running your hands down over the smooth skin of her legs then reaching out to cup her breasts. She moans softly as you stroke them and move on to taking her nipples, one after another, into your mouth and suckle on them. 'That feels *gasp* great, but... I need you in me - Now!' she says, her hand sliding down your body to grasp your hard shaft and setting it against her moist pussy lips. Eager to fulfill her wish, you thrust into her body, sliding deeper and deeper until you bottom out. It feels amazing to have her warm and tight passage stretched around your manhood, a sentiment clearly shared by the Nordic warrior-woman. You rest like that for a moment, balls deep inside this pale beauty, letting her get used to it.";
		say "     Soon, Sonya moans 'Go on. Take me!', her legs wrapping around your hips to pull you deeper into her vagina. Taking up sliding out then pounding deep into her again, you find yourself with a very enthusiastic partner, meeting each of your thrusts with a push of her hips. Her arms wrap around your upper body, pulling you fully on top of her as she seeks your lips with hers, hungrily making out with you. For a while, anything but the wild and urgent sex you have with her is forgotten, the two of you filling the air with loud moans and gasps of pleasure...";
		WaitLineBreak;
		say "     As much as you wish this could last forever, there are limits to everything. Her pants having gotten louder and faster quickly, Sonya suddenly pulls you even tighter against herself, holding you there as she shouts 'I'm coming!' You can feel her whole body shuddering under yours, the muscles in her vagina tightening their grip on your cock as the Viking orgasms. Not to lag too far behind, you abandon all restraint, grinding against her crotch urgently, and blow your load moments later. Pulse after pulse of your fertile seed shoot deep into the young woman's insides.";
		say "     Exhausted, you stay on top of her, still with your cock inside, and try to catch your breath. Looks like Sonya has other ideas... suddenly the world spins as she rolls the two of you over until she's on top and straddling your hips. With a new composure, now that her lusts have been satisfied, she pulls off your softening shaft and cleans up a bit by rubbing off with the beach's very fine dry sand. Then she goes to collect her gear.";
		NPCSexAftermath Sonya receives "PussyFuck" from Player;
	else if Player is female: [female]
		if Dexterity of Sonya is 0: [first time FF]
			say "     After following the young viking to a secluded spot behind the crest of a dune, you watch Sonya take off her armor and then the rest of her clothes, revealing the pale-skinned perfection of her well-trained body. Now completely naked, her perky breasts bouncing as she moves, the young Viking moves to lie down in the sand, spreading her legs a bit and looking up expectantly at you. 'Come on, claim your prize - But you better be good.' Feeling decidedly overdressed, you quickly remove your own clothes, revealing your own pussy.";
			say "     With a sigh, Sonya remarks 'Getting beaten - and then by a woman who can't even take me properly. Oh, why did it have to be you.' Looking down on the pale-skinned, beautiful woman, you tell her that she shouldn't worry about that - there are quite a lot that two women can do to enjoy themselves. Demonstrating one of them, you lie down yourself and part your legs, then tell the viking to get licking. After all, it's your right as the victor. Sonya grimaces slightly, her idea of a good time more centered on hard cocks and male bodies, but after a moment of hesitation, she stands up with a huff and gets on all fours in front of you. Lowering her head, the striking woman then gives your pussy a first hesitant little lick.";
			WaitLineBreak;
			say "     You moan loudly as Sonya makes her first experiences with pleasing a woman orally, still somewhat resentful that you don't have a cock. Despite this, she gives it her best try, honor-bound as she is, and... after a little bit of fumbling around, it turns out she's a natural at it - licking and nibbling your sensitive little clit, gently rubbing and spreading your nether lips as a finger strokes the opening of your vagina. Of course, being a female herself, the viking just knows what to go for and how to drive a woman to the edge of orgasm, then across. After a short while of breathtaking stimulation by the blond beauty, you give a satisfied gasp, throwing your head back as femcum squirts from your opening and hits Sonya's face.";
			say "     The viking wipes your juices off her skin with a snort, then says, 'There, I took care of it for you. Now...' She starts to raise herself up, seemingly ready to leave - but you grab her by the shoulder and push her back down, as you're far from done with the sexy woman. Ordering Sonya to stay as she is, you move around to the Viking's backside, running a hand over her firm, well-rounded butt-cheeks. There is a pant from the Nordic beauty as your hand slides between her legs, brushing against sensitive nether lips and then reaching her little clittie. Sonya gives a breathless gasp as you rub over her button with a finger, gently tickling it while your other hand starts to spread the lips of her pussy apart.";
			WaitLineBreak;
			say "     As you slide one of your digits into Sonya, rubbing her passage, you can't help but thing that there is something very delicious about having this strong woman before you on her hands and knees, shivering and panting helplessly as you touch her. This animates you to really put in some effort, teasing her first in one spot, then another, finding out what really gets her going. It's quite a lot of fun to learn that if you slide your finger in... just... like... so... and... then... do THIS - Sonya throws her head back moaning loudly as a mini-orgasm runs through her body. By now, her earlier reluctance is long forgotten, washed away with the steady trickle of female juices from a very, very wet and swollen pussy.";
			say "     You keep going for a while like this, playing with Sonya's body, making her tremble, pant and gasp, before you finally go all out, intensifying your finger-work to get her to the climax that has been building all this time. The beautiful woman's moans get louder and more high-pitched as they come faster and faster, then she gives something halfway between a squeak and an aroused shout as the point of no return is reached. Sonya rocks back - hard - to get even more of your teasing fingers inside her.";
			WaitLineBreak;
			say "     Sinking forward to lie panting on the ground, her ass still half-raised, Sonya regains her breath after a minute or two, then rolls over on her side to look at you. Her eyes roam up and down your body, resting for a second on your own pussy, then she says, 'That was... unexpectedly good. I - I still would have preferred a cock though - I think.' With a new composure, now that her lusts have been satisfied, she sits up and cleans herself a bit by rubbing off with the beach's very fine dry sand. Then she goes to collect her gear.";
			now Dexterity of Sonya is 1;
			NPCSexAftermath Sonya receives "OralPussy" from Player;
			NPCSexAftermath Sonya receives "PussyDildoFuck" from Player;
		else if Dexterity of Sonya is 1: [repeat FF]
			say "     After following the young viking to a secluded spot behind the crest of a dune, you watch Sonya take off her armor and then the rest of her clothes, revealing the pale-skinned perfection of her well-trained body. Now completely naked, her perky breasts bouncing as she moves, the young Viking moves to lie down in the sand, spreading her legs a bit and looking up expectantly at you. 'Come on, claim your prize - But you better be good.' Feeling decidedly overdressed, you quickly remove your own clothes, revealing your own pussy.";
			say "     With a sigh, Sonya remarks 'I have to admit... I came pretty hard from the last time, but - aren't the people in this strange land able to change their form? Maybe you could - grow a cock and fuck me with it properly?' Looking down on the pale-skinned, beautiful woman, you tell her that she shouldn't worry about that - there are quite a lot that two women can do to enjoy themselves. Demonstrating one of them, you lie down yourself and part your legs, then tell the viking to get licking. After all, it's your right as the victor. Sonya gives a resigned shrug, her idea of a good time more centered on hard cocks and male bodies, but after a short moment of hesitation, she stands up with a huff and gets on all fours in front of you. Lowering her head, the striking woman then gives your pussy a first hesitant little lick.";
			WaitLineBreak;
			say "     You moan loudly as Sonya makes some more experiences with pleasing a woman orally, still somewhat annoyed that you don't have a cock. Despite this, she gives it her best try, and... after a little bit of fumbling around, it turns out she's a natural at it - licking and nibbling your sensitive little clit, gently rubbing and spreading your nether lips as a finger strokes the opening of your vagina. Of course, being a female herself, the viking just knows what to go for and how to drive a woman to the edge of orgasm, then across. After a short while of breathtaking stimulation by the blond beauty, you give a satisfied gasp, throwing your head back as femcum squirts from your opening and hits Sonya's face.";
			say "     The viking wipes your juices off her skin with a snort, then says, 'There, I took care of it for you. Now... Would you care to return the favor?' She looks up at you, then wiggles her hips invitingly. Taking hold of her shoulder, you stroke down Sonya's side as you move around her body, letting your fingers slide over her soft and warm skin until they reach the firm, well-rounded cheeks of her butt. There is a pant from the Nordic beauty as your hand slides between her legs, brushing against sensitive nether lips and then reaching her little clittie. Sonya gives a breathless gasp as you rub over her button with a finger, gently tickling it while your other hand starts to spread the lips of her pussy apart.";
			WaitLineBreak;
			say "     As you slide one of your digits into Sonya, rubbing her passage, you can't help but thing that there is something very delicious about having this strong woman before you on her hands and knees, shivering and panting helplessly as you touch her. This animates you to really put in some effort, teasing her first in one spot, then another, finding out what really gets her going. It's quite a lot of fun to learn that if you slide your finger in... just... like... so... and... then... do THIS - Sonya throws her head back moaning loudly as a mini-orgasm runs through her body. By now, her earlier reluctance is long forgotten, washed away with the steady trickle of female juices from a very, very wet and swollen pussy.";
			say "     You keep going for a while like this, playing with Sonya's body, making her tremble, pant and gasp, before you finally go all out, intensifying your finger-work to get her to the climax that has been building all this time. The beautiful woman's moans get louder and more high-pitched as they come faster and faster, then she gives something halfway between a squeak and an aroused shout as the point of no return is reached. Sonya rocks back - hard - to get even more of your teasing fingers inside her.";
			WaitLineBreak;
			say "     Sinking forward to lie panting on the ground, her ass still half-raised, Sonya regains her breath after a minute or two, then rolls over on her side to look at you. Her eyes roam up and down your body, resting for a second on your own pussy, then she says, 'That was... really good. I - I still would have preferred a cock, but... there's something to this too.' With a new composure, now that her lusts have been satisfied, she sits up and cleans herself a bit by rubbing off with the beach's very fine dry sand. Then she goes to collect her gear.";
			now Dexterity of Sonya is 2;
			NPCSexAftermath Sonya receives "OralPussy" from Player;
			NPCSexAftermath Sonya receives "PussyDildoFuck" from Player;
		else if Dexterity of Sonya is 2: [first time with dildo]
			say "     After following the young viking to a secluded spot behind the crest of a dune, you watch Sonya take off her armor and then the rest of her clothes, revealing the pale-skinned perfection of her well-trained body. Now completely naked, her perky breasts bouncing as she moves, the young Viking moves to lie down in the sand, spreading her legs a bit and looking up expectantly at you. 'Come on, claim your prize - But you better be good.' Feeling decidedly overdressed, you quickly remove your own clothes, revealing your own pussy.";
			say "     An impish smile on her lips, Sonya remarks, 'How about we... make things a bit more interesting between the two of us? I like being with you, even though we're both women, but I feel like I... need something long and hard thrusting deep into me. So - I got something for us...' Looking down on the pale-skinned, beautiful woman, you stroke her cheek and give her a curious expression. Sonya playfully catches your hand, closing her lips around one of your fingers and sucking on it sensually, then she pulls away and stretches over to the pile of her clothing, opening up a satchel and... pulls out a bright green double headed dildo. 'I... want you to take me, please. Make use of this cock snake and fuck me good...,' Sonya moans huskily as she raises the artificial cock high.";
			WaitLineBreak;
			say "     Your eyes are riveted to the rubber sex toy for a moment, then you kneel between the young Viking's legs and take it from her. Pushing one end in between her pussy lips, her moans encourage you to go deeper and deeper. Then it's time to get into the action yourself... bending the other end of the sex toy up a bit, you slide it into your vagina and start thrusting forward with your hips, making it move in both of you. You still have to hold on to its shaft when you pull back, but you can fuck like this, in a fashion. As you are grinding against each other at the hips, Sonya's hands roam over your body, stroking and touching you. It feels amazing to be so intimately close to her, and feeling her movements through the rubber cock you two share.";
			say "     Soon, Sonya moans 'Harder, harder!', her legs wrapping around your hips to make you push the dildo deeper into her vagina. Taking up sliding it out then pounding deep into her again, you find yourself with a very enthusiastic partner, meeting each of your thrusts with a push of her hips. Her arms wrap around your upper body, pulling you fully on top of her as she seeks your lips with hers, hungrily making out with you. For a while, anything but the wild and urgent sex you have with her is forgotten, the two of you filling the air with loud moans and gasps of pleasure...";
			WaitLineBreak;
			say "     As much as you wish this could last forever, there are limits to everything. Her pants having gotten louder and faster quickly, Sonya suddenly pulls you even tighter against herself, holding you there as she shouts 'I'm coming!' You can feel her whole body shuddering under yours, a tremble running through the dildo connecting you. Not to lag too far behind, you push the sex toy deeper into yourself, rubbing it against your inner walls until you reach your peak a moment later. A trickle of your femcum runs down over the sex toy, to drip down into she sand with your partner's.";
			say "     Exhausted, you stay on top of her, still with the dildo connecting you, and try to catch your breath. Looks like Sonya has other ideas... suddenly the world spins as she rolls the two of you over until she's on top and straddling your hips. With a new composure, now that her lusts have been satisfied, she pulls the rubber cock out of both of you and cleans up a bit by rubbing off with the beach's very fine dry sand. Then she goes to collect her other gear.";
			now Dexterity of Sonya is 3;
			NPCSexAftermath Sonya receives "OralPussy" from Player;
			NPCSexAftermath Sonya receives "PussyDildoFuck" from Player;
		else if Dexterity of Sonya is 3: [dildo or fingers]
			say "     After following the young viking to a secluded spot behind the crest of a dune, you watch Sonya take off her armor and then the rest of her clothes, revealing the pale-skinned perfection of her well-trained body. Now completely naked, her perky breasts bouncing as she moves, the young Viking moves to lie down in the sand, spreading her legs a bit and looking up expectantly at you. 'Come on, claim your prize - But you better be good.' Feeling decidedly overdressed, you quickly remove your own clothes, revealing your own pussy.";
			LineBreak;
			say "     [bold type]You can feel the Viking's eyes on you as you stand there naked, then she says, 'Do you want to just use your tongue, or should I get out the two-headed cock-snake?'[roman type][line break]";
			LineBreak;
			say "     ([link]Y[as]y[end link]) - Have oral sex with Sonya.";
			say "     ([link]N[as]n[end link]) - Make use of the double-dong dildo.";
			if Player consents:
				LineBreak;
				say "     Kneeling down in the sand with your legs spread, you put both hands on your hips and just look at Sonya expectantly - to which the warrioress gives a sexy little smile and licks her lips. Then Sonya gets down on all fours, prowling closer to you in a playful, cat-like way that involves showing off her beautiful, naked body. Arriving directly before you just a short moment later, the striking woman lowers her head and gives your pussy a first eager little lick.";
				WaitLineBreak;
				say "     You moan loudly as Sonya makes good use of her experiences with pleasing a woman orally, more than willing to have fun with you even though you've chosen not to make use of her not so little dildo. And she really is a natural at it - licking and nibbling your sensitive little clit, gently rubbing and spreading your nether lips as a finger strokes the opening of your vagina. Of course, being a female herself, the viking just knows what to go for and how to drive a woman to the edge of orgasm, then across. After a short while of breathtaking stimulation by the blond beauty, you give a satisfied gasp, throwing your head back as femcum squirts from your opening and hits Sonya's face.";
				say "     The viking wipes your juices off her skin with a snort, then licks it off her fingers, before eventually saying, 'That was fun - and tasty. Now... Would you care to return the favor?' She looks up at you, then wiggles her hips invitingly. Taking hold of her shoulder, you stroke down Sonya's side as you move around her body, letting your fingers slide over her soft and warm skin until they reach the firm, well-rounded cheeks of her butt. There is a pant from the Nordic beauty as your hand slides between her legs, brushing against sensitive nether lips and then reaching her little clittie. Sonya gives a breathless gasp as you rub over her button with a finger, gently tickling it while your other hand starts to spread the lips of her pussy apart.";
				WaitLineBreak;
				say "     As you slide one of your digits into Sonya, rubbing her passage, you can't help but thing that there is something very delicious about having this strong woman before you on her hands and knees, shivering and panting helplessly as you touch her. This animates you to really put in some effort, teasing her first in one spot, then another, making good use of all the little sensitive spots you know of Sonya. It's quite a lot of fun to see her react when you slide your finger in... just... like... so... and... then... do THIS - Sonya throws her head back moaning loudly as a mini-orgasm runs through her body.";
				say "     You keep going for a while like this, playing with Sonya's body, making her tremble, pant and gasp, before you finally go all out, intensifying your finger-work to get her to the climax that has been building all this time. The beautiful woman's moans get louder and more high-pitched as they come faster and faster, then she gives something halfway between a squeak and an aroused shout as the point of no return is reached. Sonya rocks back - hard - to get even more of your teasing fingers inside her.";
				WaitLineBreak;
				say "     Sinking forward to lie panting on the ground, her ass still half-raised, Sonya regains her breath after a minute or two, then rolls over on her side to look at you. Her eyes roam up and down your body, resting for a second on your own pussy, then she says, 'That was... really good. Thank you, my love.' With a new composure, now that her lusts have been satisfied, she sits up and cleans herself a bit by rubbing off with the beach's very fine dry sand. Then she goes to collect her gear.";
				NPCSexAftermath Sonya receives "OralPussy" from Player;
				NPCSexAftermath Sonya receives "PussyDildoFuck" from Player;
			else:
				LineBreak;
				say "     Kneeling between Sonya's legs, you brush your fingers over her already pretty wet pussy, then sink two of them deep inside. She lets you finger her for a moment, then stretches over to the pile of her clothing, opening up a satchel and pulls out the bright green double headed dildo you've had so much fun with in the past. 'Take me, please. Fuck me good with this,' Sonya moans huskily as she raises the artificial cock high.";
				WaitLineBreak;
				say "     Your eyes are riveted to the rubber sex toy for a moment, then you kneel between the young Viking's legs and take it from her. Pushing one end in between her pussy lips, her moans encourage you to go deeper and deeper. Then it's time to get into the action yourself... bending the other end of the sex toy up a bit, you slide it into your vagina and start thrusting forward with your hips, making it move in both of you. You still have to hold on to its shaft when you pull back, but you can fuck like this, in a fashion. As you are grinding against each other at the hips, Sonya's hands roam over your body, stroking and touching you. It feels amazing to be so intimately close to her, and feeling her movements through the rubber cock you two share.";
				say "     Soon, Sonya moans 'Harder, harder!', her legs wrapping around your hips to make you push the dildo deeper into her vagina. Taking up sliding it out then pounding deep into her again, you find yourself with a very enthusiastic partner, meeting each of your thrusts with a push of her hips. Her arms wrap around your upper body, pulling you fully on top of her as she seeks your lips with hers, hungrily making out with you. For a while, anything but the wild and urgent sex you have with her is forgotten, the two of you filling the air with loud moans and gasps of pleasure...";
				WaitLineBreak;
				say "     As much as you wish this could last forever, there are limits to everything. Her pants having gotten louder and faster quickly, Sonya suddenly pulls you even tighter against herself, holding you there as she shouts 'I'm coming!' You can feel her whole body shuddering under yours, a tremble running through the dildo connecting you. Not to lag too far behind, you push the sex toy deeper into yourself, rubbing it against your inner walls until you reach your peak a moment later. A trickle of your femcum runs down over the sex toy, to drip down into she sand with your partner's.";
				say "     Exhausted, you stay on top of her, still with the dildo connecting you, and try to catch your breath. Looks like Sonya has other ideas... suddenly the world spins as she rolls the two of you over until she's on top and straddling your hips. With a new composure, now that her lusts have been satisfied, she pulls the rubber cock out of both of you and cleans up a bit by rubbing off with the beach's very fine dry sand. Then she goes to collect her other gear.";
				NPCSexAftermath Sonya receives "PussyDildoFuck" from Player;
				NPCSexAftermath Player receives "PussyDildoFuck" from Sonya;
	else: [neuter]
		if Dexterity of Sonya is 0: [first time FF]
			say "     You watch Sonya take off her armor and then the rest of her clothes, revealing the pale-skinned perfection of her well-trained body. There is a certain... urgency to her movements, as you guess there would be with her a virgin and all. Now completely naked, her perky breasts bouncing as she moves, the young Viking moves to lie down in the sand, spreading her legs a bit and looking up expectantly at you. 'Come on, claim your prize - But you better be good. I've been waiting a long time for this.' Feeling decidedly overdressed, you quickly remove your own clothes, revealing your bare, genital-less crotch.";
			say "     Sonya gives a shocked 'What?' then remarks with a sigh, 'Finally getting beaten - and then by... what are you, even? With nothing between your... You can't even take me properly. Oh, why did it have to be you.' Looking down on the pale-skinned, beautiful woman, you tell her that she shouldn't worry about that - there are quite a lot she can do with you, even if it isn't fucking. Demonstrating one of them, you lie down yourself and part your legs, then tell the viking to get licking. After all, it's your right as the victor. Sonya grimaces slightly, her idea of a good time more centered on hard cocks and male bodies, but after a moment of hesitation, she stands up with a huff and gets on all fours in front of you. Lowering her head, the striking woman then gives your smooth crotch a first hesitant little lick.";
			WaitLineBreak;
			say "     You moan loudly as Sonya makes her first experiences with pleasing a genderless person orally, still somewhat resentful that you don't have a cock. Despite this, she gives it her best try, honor-bound as she is, and... after a little bit of fumbling around, it turns out she's a natural at it - licking and nibbling your sensitive skin, gently rubbing and finding the most tender spots. After a short while of breathtaking stimulation by the blond beauty, you give a satisfied gasp, throwing your head back as tremors of lust run through your whole being.";
			say "     The viking wipes her lips with a snort, then says, 'There, I took care of it for you. Now...' She starts to raise herself up, seemingly ready to leave - but you grab her by the shoulder and push her back down, as you're far from done with the sexy woman. Ordering Sonya to stay as she is, you move around to the Viking's backside, running a hand over her firm, well-rounded butt-cheeks. There is a pant from the Nordic beauty as your hand slides between her legs, brushing against sensitive nether lips and then reaching her little clit. Sonya gives a breathless gasp as you rub over her button with a finger, gently tickling it while your other hand starts to spread the lips of her pussy apart.";
			WaitLineBreak;
			say "     As you slide one of your digits into Sonya, rubbing her passage, you can't help but thing that there is something very delicious about having this strong woman before you on her hands and knees, shivering and panting helplessly as you touch her. This animates you to really put in some effort, teasing her first in one spot, then another, finding out what really gets her going. It's quite a lot of fun to learn that if you slide your finger in... just... like... so... and... then... do THIS - Sonya throws her head back moaning loudly as a mini-orgasm runs through her body. By now, her earlier reluctance is long forgotten, washed away with the steady trickle of female juices from a very, very wet and swollen pussy.";
			say "     You keep going for a while like this, playing with Sonya's body, making her tremble, pant and gasp, before you finally go all out, intensifying your finger-work to get her to the climax that has been building all this time. The beautiful woman's moans get louder and more high-pitched as they come faster and faster, then she gives something halfway between a squeak and an aroused shout as the point of no return is reached. Sonya rocks back - hard - to get even more of your teasing fingers inside her.";
			WaitLineBreak;
			say "     Sinking forward to lie panting on the ground, her ass still half-raised, Sonya regains her breath after a minute or two, then rolls over on her side to look at you. Her eyes roam up and down your body, resting for a second on your own pussy, then she says, 'That was... unexpectedly good. I - I still would have preferred a cock though - I think.' With a new composure, now that her lusts have been satisfied, she sits up and cleans herself a bit by rubbing off with the beach's very fine dry sand. Then she goes to collect her gear.";
			now Dexterity of Sonya is 1;
			NPCSexAftermath Sonya receives "PussyDildoFuck" from Player;
		else if Dexterity of Sonya is 1: [repeat FF]
			say "     You watch Sonya take off her armor and then the rest of her clothes, revealing the pale-skinned perfection of her well-trained body. There is a certain... urgency to her movements, as you guess there would be with her a virgin and all. Now completely naked, her perky breasts bouncing as she moves, the young Viking moves to lie down in the sand, spreading her legs a bit and looking up expectantly at you. 'Come on, claim your prize - But you better be good. I've been waiting a long time for this.' Feeling decidedly overdressed, you quickly remove your own clothes, revealing your bare, genital-less crotch.";
			say "     With a sigh, Sonya remarks 'I have to admit... I came pretty hard from the last time, but - aren't the people in this strange land able to change their form? Maybe you could - grow a cock and fuck me with it properly?' Looking down on the pale-skinned, beautiful woman, you tell her that she shouldn't worry about that - there are quite a lot that you two can do to enjoy themselves. Demonstrating one of them, you lie down yourself and part your legs, then tell the viking to get licking. After all, it's your right as the victor. Sonya gives a resigned shrug, her idea of a good time more centered on hard cocks and male bodies, but after a short moment of hesitation, she stands up with a huff and gets on all fours in front of you. Lowering her head, the striking woman then gives your smooth crotch a first hesitant little lick.";
			WaitLineBreak;
			say "     You moan loudly as Sonya makes some more experiences with pleasing a genderless person orally, still somewhat annoyed that you don't have a cock. Despite this, she gives it her best try, honor-bound as she is, and... after a little bit of fumbling around, it turns out she's a natural at it - licking and nibbling your sensitive skin, gently rubbing and finding the most tender spots. After a short while of breathtaking stimulation by the blond beauty, you give a satisfied gasp, throwing your head back as tremors of lust run through your whole being.";
			say "     The viking wipes her lips with an amused snort, then says, 'There, I took care of it for you. Now... Would you care to return the favor?' She looks up at you, then wiggles her hips invitingly. Taking hold of her shoulder, you stroke down Sonya's side as you move around her body, letting your fingers slide over her soft and warm skin until they reach the firm, well-rounded cheeks of her butt. There is a pant from the Nordic beauty as your hand slides between her legs, brushing against sensitive nether lips and then reaching her little clit. Sonya gives a breathless gasp as you rub over her button with a finger, gently tickling it while your other hand starts to spread the lips of her pussy apart.";
			WaitLineBreak;
			say "     As you slide one of your digits into Sonya, rubbing her passage, you can't help but thing that there is something very delicious about having this strong woman before you on her hands and knees, shivering and panting helplessly as you touch her. This animates you to really put in some effort, teasing her first in one spot, then another, finding out what really gets her going. It's quite a lot of fun to learn that if you slide your finger in... just... like... so... and... then... do THIS - Sonya throws her head back moaning loudly as a mini-orgasm runs through her body. By now, her earlier reluctance is long forgotten, washed away with the steady trickle of female juices from a very, very wet and swollen pussy.";
			say "     You keep going for a while like this, playing with Sonya's body, making her tremble, pant and gasp, before you finally go all out, intensifying your finger-work to get her to the climax that has been building all this time. The beautiful woman's moans get louder and more high-pitched as they come faster and faster, then she gives something halfway between a squeak and an aroused shout as the point of no return is reached. Sonya rocks back - hard - to get even more of your teasing fingers inside her.";
			WaitLineBreak;
			say "     Sinking forward to lie panting on the ground, her ass still half-raised, Sonya regains her breath after a minute or two, then rolls over on her side to look at you. Her eyes roam up and down your body, resting for a second on your own pussy, then she says, 'That was... really good. I - I still would have preferred a cock, but... there's something to this too.' With a new composure, now that her lusts have been satisfied, she sits up and cleans herself a bit by rubbing off with the beach's very fine dry sand. Then she goes to collect her gear.";
			now Dexterity of Sonya is 2;
			NPCSexAftermath Sonya receives "PussyDildoFuck" from Player;
	LineBreak;
	if the player is not facially human or the player is not bodily human or the player is not skintone human: [non-human player = a monster, in her words]
		say "     As she pulls her clothes back on, Sonya gives your naked body a glance that lingers for a moment, and you can almost see lust and desire flickering up in her eyes again. Then she shakes her head. 'You're not bad at all at this - or fighting, I have to admit. But now I've got to go, monster. Raiding targets don't scout themselves, you know...' She winks at you, then walks away, giving you a short look back as she climbs over the crest of the dune.";
	else: [human player]
		say "     As she pulls her clothes back on, Sonya gives your naked body a glance that lingers for a moment, and you can almost see lust and desire flickering up in her eyes again. Then she shakes her head. 'You're not bad at all at this - or fighting, I have to admit. But now I've got to go, outlander. Raiding targets don't scout themselves, you know...' She winks at you, then walks away, giving you a short look back as she climbs over the crest of the dune.";

to say AffectionateVikingLossSex: [3+ times with the player]
	if Player is male: [male+herm]
		say "     Hand in hand, you climb over the crest of a nearby dune, stopping several times on the way to share hungry kisses. After finally arriving in a somewhat protected spot, out of sight from the beach, Sonya pushes you to sit in the sand and starts to undress in a hot little strip-show. It's amazing how arousing she can make taking off scale mail armor and then piece by piece her other clothing. She quickly has you so hot and bothered that you just can't resist standing up and 'helping' a bit, pulling off articles of clothing and caressing her. Soon she is completely naked, revealing the pale-skinned perfection of her well-trained body. A beaming smile on her face, she starts undressing you too, rubbing her breasts and body against you as you're stripped bare.";
		say "     Sonya gooses your ass, daring you to catch her, and runs off a few steps, her perky breasts bouncing as she moves. With her not really trying to get away, you quickly catch her, embracing her as you plant a kiss on her lips. Holding on you, she lets herself fall into the sand on the side of the dune, and you find yourself lying on the eager young woman, your cock poking against her pubic mound. Not one to waste such an opportunity, you move your hips a bit till the tip of your manhood brushes over her nether lips, then thrust in, sinking deep into your Viking's moist vagina.";
		WaitLineBreak;
		say "     As you bottom out inside her, Sonya wraps her legs around your hips, holding you tight against herself. Her arms pull your upper body down on her too, so she can make out with you. In between kisses she pants 'Fuck me hard!' and you comply eagerly, pulling out most of your shaft before plunging back in in a fast rhythm. The sexy Viking even pushes down her hips to meet each of your thrusts and pulls you down on her with her legs around your ass. It feels amazing to have her warm and tight passage stretched around your manhood as you are pounding the Nordic warrior-woman's pussy. For a while, anything but the wild and urgent sex you have with her is forgotten, the two of you filling the air with loud moans and gasps of pleasure...";
		WaitLineBreak;
		say "     As much as you wish this could last forever, there are limits to everything. Her pants having gotten louder and faster quickly, Sonya suddenly pulls you even tighter against herself, holding you there as she shouts 'I'm coming!' You can feel her whole body shuddering under yours, the muscles in her vagina tightening their grip on your cock as the Viking orgasms. Not to lag too far behind, you abandon all restraint, grinding against her crotch urgently, and blow your load moments later. Pulse after pulse of your fertile seed shoot deep into the young woman's insides.";
		say "     Exhausted, you stay on top of her, still with your cock inside, and try to catch your breath. She strokes your back softly, content in just lying there with you for a while, resting and holding one another. Then, she sighs, rubbing your nose with hers before sliding out from under you and sitting up. After cleaning up a bit by rubbing off with the beach's very fine dry sand, she stands up and goes to collect her gear.";
		NPCSexAftermath Sonya receives "PussyFuck" from Player;
		if VikingPregnancy is 0: [not already preggers]
			let VikingPregChance be a random number from 1 to 20;
			if VikingPregChance > 10: [50% chance]
				now VikingPregCounter is 48; [48 turns till birth]
				now VikingPregnancy is 1; [invisibly pregnant]
				if the player is not facially human or the player is not bodily human or the player is not skintone human: [player a legendary monster]
					now VikingKidShape is BodyName of Player;
				else: [human player]
					now VikingKidShape is "Human";
	else if Player is female: [female]
		if Dexterity of Sonya is 0: [first time FF]
			say "     Hand in hand, you climb over the crest of a nearby dune, stopping several times on the way to share hungry kisses. After finally arriving in a somewhat protected spot, out of sight from the beach, Sonya pushes you to sit in the sand and starts to undress in a hot little strip-show. It's amazing how arousing she can make taking off scale mail armor and then piece by piece her other clothing. She quickly has you so hot and bothered that you just can't resist standing up and 'helping' a bit, pulling off articles of clothing and caressing her. Soon she is completely naked, revealing the pale-skinned perfection of her well-trained body. A beaming smile on her face, she starts undressing you too, rubbing her breasts and body against you as you're stripped bare.";
			say "     As your pussy is revealed, Sonya remarks with a sigh, 'Hm... as a woman you can't take me properly.' Turning around to kiss the pale-skinned, beautiful woman, you tell her that she shouldn't worry about that - there are quite a lot that two women can do to enjoy themselves. Demonstrating one of them, you lie down yourself and part your legs, then tell the viking to get licking. After all, it's your right as the victor. Sonya gives you a bewildered look for a second, her idea of a good time more centered on hard cocks and male bodies, but after a moment of hesitation, she gets on all fours in front of you. Lowering her head, the striking woman then gives your pussy a first hesitant little lick.";
			WaitLineBreak;
			say "     You moan loudly as Sonya makes her first experiences with pleasing a woman orally, though still somewhat miffed that you don't have a cock. Despite this, she gives it her best try, and... after a little bit of fumbling around, it turns out she's a natural at it - licking and nibbling your sensitive little clit, gently rubbing and spreading your nether lips as a finger strokes the opening of your vagina. Of course, being a female herself, the viking just knows what to go for and how to drive a woman to the edge of orgasm, then across. After a short while of breathtaking stimulation by the blond beauty, you give a satisfied gasp, throwing your head back as femcum squirts from your opening and hits Sonya's face.";
			say "     The viking wipes your juices off her skin with a snort, then says, 'There, I took care of it for you. Now... you Would you care to return the favor?' She looks up at you, then wiggles her hips invitingly. Taking hold of her shoulder, you stroke down Sonya's side as you move around her body, letting your fingers slide over her soft and warm skin until they reach the firm, well-rounded cheeks of her butt. There is a pant from the Nordic beauty as your hand slides between her legs, brushing against sensitive nether lips and then reaching her little clit. Sonya gives a breathless gasp as you rub over her button with a finger, gently tickling it while your other hand starts to spread the lips of her pussy apart.";
			WaitLineBreak;
			say "     As you slide one of your digits into Sonya, rubbing her passage, you can't help but thing that there is something very delicious about having this strong woman before you on her hands and knees, shivering and panting helplessly as you touch her. This animates you to really put in some effort, teasing her first in one spot, then another, finding out what really gets her going. It's quite a lot of fun to learn that if you slide your finger in... just... like... so... and... then... do THIS - Sonya throws her head back moaning loudly as a mini-orgasm runs through her body. By now, her earlier reluctance is long forgotten, washed away with the steady trickle of female juices from a very, very wet and swollen pussy.";
			say "     You keep going for a while like this, playing with Sonya's body, making her tremble, pant and gasp, before you finally go all out, intensifying your finger-work to get her to the climax that has been building all this time. The beautiful woman's moans get louder and more high-pitched as they come faster and faster, then she gives something halfway between a squeak and an aroused shout as the point of no return is reached. Sonya rocks back - hard - to get even more of your teasing fingers inside her.";
			WaitLineBreak;
			say "     Sinking forward to lie panting on the ground, her ass still half-raised, Sonya regains her breath after a minute or two, then rolls over on her side to look at you. Her eyes roam up and down your body, resting for a second on your own pussy, then she says, 'That was... unexpectedly good. I - I still would have preferred a cock though - I think.' With a new composure, now that her lusts have been satisfied, she sits up and cleans herself a bit by rubbing off with the beach's very fine dry sand. Then she goes to collect her gear.";
			now Dexterity of Sonya is 1;
			NPCSexAftermath Sonya receives "OralPussy" from Player;
			NPCSexAftermath Sonya receives "PussyDildoFuck" from Player;
		else if Dexterity of Sonya is 1: [repeat FF]
			say "     Hand in hand, you climb over the crest of a nearby dune, stopping several times on the way to share hungry kisses. After finally arriving in a somewhat protected spot, out of sight from the beach, Sonya pushes you to sit in the sand and starts to undress in a hot little strip-show. It's amazing how arousing she can make taking off scale mail armor and then piece by piece her other clothing. She quickly has you so hot and bothered that you just can't resist standing up and 'helping' a bit, pulling off articles of clothing and caressing her. Soon she is completely naked, revealing the pale-skinned perfection of her well-trained body. A beaming smile on her face, she starts undressing you too, rubbing her breasts and body against you as you're stripped bare.";
			say "     Soon ending up standing naked with Sonya's arms wrapped around you from behind, you revel in the feel of her curves and smooth skin against you, as well as the young woman's hands that sensually stroke your body. Her hand dips down your front eventually, stroking over your clit in a feather-light touch that has you panting in lust. After a moment of this, she whispers in your ear, 'I love being with you, but there is this craving to feel a hard cock inside me. Aren't the people in this strange land able to change their form? Maybe you could - grow a cock and fuck me with it properly?' Reaching back to slide your hand down the pale-skinned, beautiful woman's side, you tell her that you'll have to think about it... but for now - there are quite a lot that two women can do to enjoy themselves. Demonstrating one of them, you lie down yourself and part your legs, then tell the viking to get licking. After all, it's your right as the victor. Sonya gives a saucy smile, then gets on all fours in front of you. Lowering her head, the striking woman then gives your pussy a first eager lick.";
			WaitLineBreak;
			say "     You moan loudly as Sonya makes some more experiences with pleasing a woman orally, even though you can tell she is still somewhat disappointed that you don't have a cock. Despite this, she gives it her best try, and... it turns out she's a natural at it - licking and nibbling your sensitive little clit, gently rubbing and spreading your nether lips as a finger strokes the opening of your vagina. Of course, being a female herself, the viking just knows what to go for and how to drive a woman to the edge of orgasm, then across. After a short while of breathtaking stimulation by the blond beauty, you give a satisfied gasp, throwing your head back as femcum squirts from your opening and hits Sonya's face.";
			say "     The viking wipes your juices off her skin with an amused snort, then licks it off her fingers, before eventually saying, 'That was fun - and tasty. Now... Would you care to return the favor?' She looks up at you, then wiggles her hips invitingly. Taking hold of her shoulder, you stroke down Sonya's side as you move around her body, letting your fingers slide over her soft and warm skin until they reach the firm, well-rounded cheeks of her butt. There is a pant from the Nordic beauty as your hand slides between her legs, brushing against sensitive nether lips and then reaching her little clit. Sonya gives a breathless gasp as you rub over her button with a finger, gently tickling it while your other hand starts to spread the lips of her pussy apart.";
			WaitLineBreak;
			say "     As you slide one of your digits into Sonya, rubbing her passage, you can't help but thing that there is something very delicious about having this strong woman before you on her hands and knees, shivering and panting helplessly as you touch her. This animates you to really put in some effort, teasing her first in one spot, then another, finding out what really gets her going. It's quite a lot of fun to learn that if you slide your finger in... just... like... so... and... then... do THIS - Sonya throws her head back moaning loudly as a mini-orgasm runs through her body. By now, her earlier reluctance is long forgotten, washed away with the steady trickle of female juices from a very, very wet and swollen pussy.";
			say "     You keep going for a while like this, playing with Sonya's body, making her tremble, pant and gasp, before you finally go all out, intensifying your finger-work to get her to the climax that has been building all this time. The beautiful woman's moans get louder and more high-pitched as they come faster and faster, then she gives something halfway between a squeak and an aroused shout as the point of no return is reached. Sonya rocks back - hard - to get even more of your teasing fingers inside her.";
			WaitLineBreak;
			say "     Sinking forward to lie panting on the ground, her ass still half-raised, Sonya regains her breath after a minute or two, then rolls over on her side to look at you. Her eyes roam up and down your body, resting for a second on your own pussy, then she says, 'That was... really good. I - I still would have preferred a cock, but... there's something to this too.' With a new composure, now that her lusts have been satisfied, she sits up and cleans herself a bit by rubbing off with the beach's very fine dry sand. Then she goes to collect her gear.";
			now Dexterity of Sonya is 2;
			NPCSexAftermath Sonya receives "OralPussy" from Player;
			NPCSexAftermath Sonya receives "PussyDildoFuck" from Player;
		else if Dexterity of Sonya is 2: [first time with dildo]
			say "     Hand in hand, you climb over the crest of a nearby dune, stopping several times on the way to share hungry kisses. After finally arriving in a somewhat protected spot, out of sight from the beach, Sonya pushes you to sit in the sand and starts to undress in a hot little strip-show. It's amazing how arousing she can make taking off scale mail armor and then piece by piece her other clothing. She quickly has you so hot and bothered that you just can't resist standing up and 'helping' a bit, pulling off articles of clothing and caressing her. Soon she is completely naked, revealing the pale-skinned perfection of her well-trained body. A beaming smile on her face, she starts undressing you too, rubbing her breasts and body against you as you're stripped bare.";
			say "     An impish smile on her lips, Sonya remarks, 'How about we... make things a bit more interesting between the two of us? I love being with you, even though we're both women, but I feel like I... need something long and hard thrusting deep into me. So - I got something for us...' Looking at the pale-skinned, beautiful woman, you stroke her cheek and give her a curious expression. She just smiles mysteriously, then steps over to the pile of her discarded clothing and bends over to open her satchel, giving you a very inviting view of her shapely ass and the wet and swollen pussy between her legs. Sonya turns around a moment later with... a green double-headed dildo in hand, giving a pleased little laugh as she sees where your gaze rests. Then she gets down, stretching out in the sand with her shoulders and head resting on the pile of her clothes and spreading those long, lithe legs invitingly. The sexy woman raises her hand with the dildo a moment later, and waves it at you, making the ends wobble in the air. 'I... want you to take me, please. Make use of this 'cock snake' and fuck me good...'";
			WaitLineBreak;
			say "     Your eyes are riveted to the rubber sex toy for a moment, then you kneel between the young Viking's legs and take it from her. Pushing one end in between her pussy lips, her moans encourage you to go deeper and deeper. Then it's time to get into the action yourself... bending the other end of the sex toy up a bit, you slide it into your vagina and start thrusting forward with your hips, making it move in both of you. You still have to hold on to its shaft when you pull back, but you can fuck like this, in a fashion. As you are grinding against each other at the hips, Sonya's hands roam over your body, stroking and touching you. It feels amazing to be so intimately close to her, and feeling her movements through the rubber cock you two share.";
			say "     Soon, Sonya moans 'Harder, harder!', her legs wrapping around your hips to make you push the dildo deeper into her vagina. Taking up sliding it out then pounding deep into her again, you find yourself with a very enthusiastic partner, meeting each of your thrusts with a push of her hips. Her arms wrap around your upper body, pulling you fully on top of her as she seeks your lips with hers, hungrily making out with you. For a while, anything but the wild and urgent sex you have with her is forgotten, the two of you filling the air with loud moans and gasps of pleasure...";
			WaitLineBreak;
			say "     As much as you wish this could last forever, there are limits to everything. Her pants having gotten louder and faster quickly, Sonya suddenly pulls you even tighter against herself, holding you there as she shouts 'I'm coming!' You can feel her whole body shuddering under yours, a tremble running through the dildo connecting you. Not to lag too far behind, you push the sex toy deeper into yourself, rubbing it against your inner walls until you reach your peak a moment later. A trickle of your femcum runs down over the sex toy, to drip down into she sand with your partner's.";
			say "     Exhausted, you stay on top of her, still with the dildo connecting you, and try to catch your breath. Looks like Sonya has other ideas... suddenly the world spins as she rolls the two of you over until she's on top and straddling your hips. With a new composure, now that her lusts have been satisfied, she pulls the rubber cock out of both of you and cleans up a bit by rubbing off with the beach's very fine dry sand. Then she goes to collect her other gear.";
			now Dexterity of Sonya is 3;
			NPCSexAftermath Sonya receives "OralPussy" from Player;
			NPCSexAftermath Sonya receives "PussyDildoFuck" from Player;
		else if Dexterity of Sonya is 3: [dildo or fingers]
			say "     Hand in hand, you climb over the crest of a nearby dune, stopping several times on the way to share hungry kisses. After finally arriving in a somewhat protected spot, out of sight from the beach, Sonya pushes you to sit in the sand and starts to undress in a hot little strip-show. It's amazing how arousing she can make taking off scale mail armor and then piece by piece her other clothing. She quickly has you so hot and bothered that you just can't resist standing up and 'helping' a bit, pulling off articles of clothing and caressing her. Soon she is completely naked, revealing the pale-skinned perfection of her well-trained body. A beaming smile on her face, she starts undressing you too, rubbing her breasts and body against you as you're stripped bare.";
			say "     Soon ending up standing naked with Sonya's arms wrapped around you from behind, you revel in the feel of her curves and smooth skin against you, as well as the young woman's hands that sensually stroke your body. Her hand dips down your front eventually, stroking over your clit in a feather-light touch that has you panting in lust.";
			LineBreak;
			say "     [bold type]After a moment of this, she whispers in your ear, 'Should we just use our tongues, or do you want me to get the cock-snake out for some real fun?'[roman type][line break]";
			LineBreak;
			say "     ([link]Y[as]y[end link]) - Have oral sex with Sonya.";
			say "     ([link]N[as]n[end link]) - Make use of the double-dong dildo.";
			if Player consents:
				LineBreak;
				say "     Turning around to face Sonya, you give her a hungry kiss, then pant that you want her to go down on you as you come up for air afterwards. With that, you pull away from your sexy viking and kneel down in the sand with your legs spread. Both hands on your hips, you just look at Sonya expectantly - to which the warrioress gives a sexy little smile and licks her lips. Then Sonya gets down on all fours, prowling closer to you in a playful, cat-like way that involves showing off her beautiful, naked body. Arriving directly before you just a short moment later, the striking woman lowers her head and gives your pussy a first eager little lick.";
				WaitLineBreak;
				say "     You moan loudly as Sonya makes good use of her experiences with pleasing a woman orally, more than willing to have fun with you even though you've chosen not to make use of her not so little dildo. And she really is a natural at it - licking and nibbling your sensitive little clit, gently rubbing and spreading your nether lips as a finger strokes the opening of your vagina. Of course, being a female herself, the viking just knows what to go for and how to drive a woman to the edge of orgasm, then across. After a short while of breathtaking stimulation by the blond beauty, you give a satisfied gasp, throwing your head back as femcum squirts from your opening and hits Sonya's face.";
				say "     The viking wipes your juices off her skin with an amused snort, then licks it off her fingers, before eventually saying, 'That was fun - and tasty. Now... Would you care to return the favor?' She looks up at you, then wiggles her hips invitingly. Taking hold of her shoulder, you stroke down Sonya's side as you move around her body, letting your fingers slide over her soft and warm skin until they reach the firm, well-rounded cheeks of her butt. There is a pant from the Nordic beauty as your hand slides between her legs, brushing against sensitive nether lips and then reaching her little clit. Sonya gives a breathless gasp as you rub over her button with a finger, gently tickling it while your other hand starts to spread the lips of her pussy apart.";
				WaitLineBreak;
				say "     As you slide one of your digits into Sonya, rubbing her passage, you can't help but thing that there is something very delicious about having this strong woman before you on her hands and knees, shivering and panting helplessly as you touch her. This animates you to really put in some effort, teasing her first in one spot, then another, making good use of all the little sensitive spots you know of Sonya. It's quite a lot of fun to see her react when you slide your finger in... just... like... so... and... then... do THIS - Sonya throws her head back moaning loudly as a mini-orgasm runs through her body.";
				say "     You keep going for a while like this, playing with Sonya's body, making her tremble, pant and gasp, before you finally go all out, intensifying your finger-work to get her to the climax that has been building all this time. The beautiful woman's moans get louder and more high-pitched as they come faster and faster, then she gives something halfway between a squeak and an aroused shout as the point of no return is reached. Sonya rocks back - hard - to get even more of your teasing fingers inside her.";
				WaitLineBreak;
				say "     Sinking forward to lie panting on the ground, her ass still half-raised, Sonya regains her breath after a minute or two, then rolls over on her side to look at you. Her eyes roam up and down your body, resting for a second on your own pussy, then she says, 'That was... really good. Thank you, my love.' With a new composure, now that her lusts have been satisfied, she sits up and cleans herself a bit by rubbing off with the beach's very fine dry sand. Then she goes to collect her gear.";
				NPCSexAftermath Sonya receives "OralPussy" from Player;
				NPCSexAftermath Sonya receives "PussyDildoFuck" from Player;
			else:
				LineBreak;
				say "     Turning around to face Sonya, you give her a hungry kiss while one of your hands snakes down between you, its fingers dipping into her pussy an eye-blink later. As you thrust in with two fingers and start to wiggle them around, Sonya can't help but lean her head back and give a loud moan. You tell her that you want to 'take her', letting the two of you feel each other inside. Moving your head to find one of her perky nipples with your lips as you continue to finger Sonya, you do playfully suckle on it, which gives the young woman's aroused squeals a whole new note of urgency. Then finally after a short little while, you do pull back, allowing her to catch her breath and for the lustful haze to recede from her mind.";
				say "     Eager to get on the real action after you warming her up like this, she steps over to the pile of her discarded clothing and bends over to open her satchel, giving you a very inviting view of her shapely ass and the wet and swollen pussy between her legs. Sonya turns around a moment later with the green double-headed dildo in hand, giving a pleased little laugh as she sees where your gaze rests. Then she gets down, stretching out in the sand with her shoulders and head resting on the pile of her clothes and spreading those long, lithe legs invitingly. The sexy woman raises her hand with the dildo a moment later, and waves it at you, making the ends wobble in the air.";
				WaitLineBreak;
				say "     Your eyes are riveted to the rubber sex toy for a moment, then you kneel between the young Viking's legs and take it from her. Pushing one end in between her pussy lips, her moans encourage you to go deeper and deeper. Then it's time to get into the action yourself... bending the other end of the sex toy up a bit, you slide it into your vagina and start thrusting forward with your hips, making it move in both of you. You still have to hold on to its shaft when you pull back, but you can fuck like this, in a fashion. As you are grinding against each other at the hips, Sonya's hands roam over your body, stroking and touching you. It feels amazing to be so intimately close to her, and feeling her movements through the rubber cock you two share.";
				say "     Soon, Sonya moans 'Harder, harder!', her legs wrapping around your hips to make you push the dildo deeper into her vagina. Taking up sliding it out then pounding deep into her again, you find yourself with a very enthusiastic partner, meeting each of your thrusts with a push of her hips. Her arms wrap around your upper body, pulling you fully on top of her as she seeks your lips with hers, hungrily making out with you. For a while, anything but the wild and urgent sex you have with her is forgotten, the two of you filling the air with loud moans and gasps of pleasure...";
				WaitLineBreak;
				say "     As much as you wish this could last forever, there are limits to everything. Her pants having gotten louder and faster quickly, Sonya suddenly pulls you even tighter against herself, holding you there as she shouts 'I'm coming!' You can feel her whole body shuddering under yours, a tremble running through the dildo connecting you. Not to lag too far behind, you push the sex toy deeper into yourself, rubbing it against your inner walls until you reach your peak a moment later. A trickle of your femcum runs down over the sex toy, to drip down into she sand with your partner's.";
				say "     Exhausted, you stay on top of her, still with the dildo connecting you, and try to catch your breath. Looks like Sonya has other ideas... suddenly the world spins as she rolls the two of you over until she's on top and straddling your hips. With a new composure, now that her lusts have been satisfied, she pulls the rubber cock out of both of you and cleans up a bit by rubbing off with the beach's very fine dry sand. Then she goes to collect her other gear.";
				NPCSexAftermath Player receives "PussyDildoFuck" from Sonya;
				NPCSexAftermath Sonya receives "PussyDildoFuck" from Player;
	else: [neuter]
		if Dexterity of Sonya is 0: [first time FF]
			say "     Hand in hand, you climb over the crest of a nearby dune, stopping several times on the way to share hungry kisses. After finally arriving in a somewhat protected spot, out of sight from the beach, Sonya pushes you to sit in the sand and starts to undress in a hot little strip-show. It's amazing how arousing she can make taking off scale mail armor and then piece by piece her other clothing. She quickly has you so hot and bothered that you just can't resist standing up and 'helping' a bit, pulling off articles of clothing and caressing her. Soon she is completely naked, revealing the pale-skinned perfection of her well-trained body. A beaming smile on her face, she starts undressing you too, rubbing her breasts and body against you as you're stripped bare.";
			say "     As your genderless crotch is revealed, Sonya remarks with a sigh, 'I still don't know how you can live without... oh never-mind. But how are we gonna have fun with - well, nothing between your legs?' Turning around to kiss the pale-skinned, beautiful woman, you tell her that she shouldn't worry about that - there are quite a lot that the two of you can do to enjoy yourselves. Demonstrating one of them, you lie down yourself and part your legs, then tell the viking to get licking. After all, it's your right as the victor. Sonya gives you a bewildered look for a second, her idea of a good time more centered on hard cocks and male bodies, but after a moment of hesitation, she gets on all fours in front of you. Lowering her head, the striking woman then gives your smooth crotch a first hesitant little lick.";
			WaitLineBreak;
			say "     You moan loudly as Sonya makes her first experiences with pleasing a genderless person orally, still somewhat resentful that you don't have a cock. Despite this, she gives it her best try, honor-bound as she is, and... after a little bit of fumbling around, it turns out she's a natural at it - licking and nibbling your sensitive skin, gently rubbing and finding the most tender spots. After a short while of breathtaking stimulation by the blond beauty, you give a satisfied gasp, throwing your head back as tremors of lust run through your whole being.";
			say "     The viking wipes her lips with a snort, then says, 'There, I took care of it for you. Now...' She starts to raise herself up, seemingly ready to leave - but you grab her by the shoulder and push her back down, as you're far from done with the sexy woman. Ordering Sonya to stay as she is, you move around to the Viking's backside, running a hand over her firm, well-rounded butt-cheeks. There is a pant from the Nordic beauty as your hand slides between her legs, brushing against sensitive nether lips and then reaching her little clit. Sonya gives a breathless gasp as you rub over her button with a finger, gently tickling it while your other hand starts to spread the lips of her pussy apart.";
			WaitLineBreak;
			say "     As you slide one of your digits into Sonya, rubbing her passage, you can't help but thing that there is something very delicious about having this strong woman before you on her hands and knees, shivering and panting helplessly as you touch her. This animates you to really put in some effort, teasing her first in one spot, then another, finding out what really gets her going. It's quite a lot of fun to learn that if you slide your finger in... just... like... so... and... then... do THIS - Sonya throws her head back moaning loudly as a mini-orgasm runs through her body. By now, her earlier reluctance is long forgotten, washed away with the steady trickle of female juices from a very, very wet and swollen pussy.";
			say "     You keep going for a while like this, playing with Sonya's body, making her tremble, pant and gasp, before you finally go all out, intensifying your finger-work to get her to the climax that has been building all this time. The beautiful woman's moans get louder and more high-pitched as they come faster and faster, then she gives something halfway between a squeak and an aroused shout as the point of no return is reached. Sonya rocks back - hard - to get even more of your teasing fingers inside her.";
			WaitLineBreak;
			say "     Sinking forward to lie panting on the ground, her ass still half-raised, Sonya regains her breath after a minute or two, then rolls over on her side to look at you. Her eyes roam up and down your body, resting for a second on your own pussy, then she says, 'That was... unexpectedly good. I - I still would have preferred a cock though - I think.' With a new composure, now that her lusts have been satisfied, she sits up and cleans herself a bit by rubbing off with the beach's very fine dry sand. Then she goes to collect her gear.";
			now Dexterity of Sonya is 1;
			NPCSexAftermath Sonya receives "PussyDildoFuck" from Player;
		else if Dexterity of Sonya is 1: [repeat FF]
			say "     Hand in hand, you climb over the crest of a nearby dune, stopping several times on the way to share hungry kisses. After finally arriving in a somewhat protected spot, out of sight from the beach, Sonya pushes you to sit in the sand and starts to undress in a hot little strip-show. It's amazing how arousing she can make taking off scale mail armor and then piece by piece her other clothing. She quickly has you so hot and bothered that you just can't resist standing up and 'helping' a bit, pulling off articles of clothing and caressing her. Soon she is completely naked, revealing the pale-skinned perfection of her well-trained body. A beaming smile on her face, she starts undressing you too, rubbing her breasts and body against you as you're stripped bare.";
			say "     Soon ending up standing naked with Sonya's arms wrapped around you from behind, you revel in the feel of her curves and smooth skin against you, as well as the young woman's hands that sensually stroke your body. Her hand dips down your front eventually, stroking over your smooth crotch in a feather-light touch that has you panting in lust. After a moment of this, she whispers in your ear, 'I love being with you, but there is this craving to feel a hard cock inside me. Aren't the people in this strange land able to change their form? Maybe you could - grow a cock and fuck me with it properly?' Reaching back to slide your hand down the pale-skinned, beautiful woman's side, you tell her that you'll have to think about it... but for now - there are quite a lot that the two of you can enjoy yourselves. Demonstrating one of them, you lie down yourself and part your legs, then tell the viking to get licking. After all, it's your right as the victor. Sonya gives a saucy smile, then gets on all fours in front of you. Lowering her head, the striking woman then gives your crotch a first eager lick.";
			WaitLineBreak;
			say "     You moan loudly as Sonya makes some more experiences with pleasing someone orally, even though you can tell she is still somewhat disappointed that you don't have a cock. Despite this, she gives it her best try, and... it turns out she's a natural at it - licking and nibbling your sensitive skin, gently rubbing and finding the most tender spots. After a short while of breathtaking stimulation by the blond beauty, you give a satisfied gasp, throwing your head back as tremors of lust run through your whole being.";
			say "     The viking wipes her lips with an amused snort, then says, 'That was fun. Now... Would you care to return the favor?' She looks up at you, then wiggles her hips invitingly. Taking hold of her shoulder, you stroke down Sonya's side as you move around her body, letting your fingers slide over her soft and warm skin until they reach the firm, well-rounded cheeks of her butt. There is a pant from the Nordic beauty as your hand slides between her legs, brushing against sensitive nether lips and then reaching her little clit. Sonya gives a breathless gasp as you rub over her button with a finger, gently tickling it while your other hand starts to spread the lips of her pussy apart.";
			WaitLineBreak;
			say "     As you slide one of your digits into Sonya, rubbing her passage, you can't help but thing that there is something very delicious about having this strong woman before you on her hands and knees, shivering and panting helplessly as you touch her. This animates you to really put in some effort, teasing her first in one spot, then another, finding out what really gets her going. It's quite a lot of fun to learn that if you slide your finger in... just... like... so... and... then... do THIS - Sonya throws her head back moaning loudly as a mini-orgasm runs through her body. By now, her earlier reluctance is long forgotten, washed away with the steady trickle of female juices from a very, very wet and swollen pussy.";
			say "     You keep going for a while like this, playing with Sonya's body, making her tremble, pant and gasp, before you finally go all out, intensifying your finger-work to get her to the climax that has been building all this time. The beautiful woman's moans get louder and more high-pitched as they come faster and faster, then she gives something halfway between a squeak and an aroused shout as the point of no return is reached. Sonya rocks back - hard - to get even more of your teasing fingers inside her.";
			WaitLineBreak;
			say "     Sinking forward to lie panting on the ground, her ass still half-raised, Sonya regains her breath after a minute or two, then rolls over on her side to look at you. Her eyes roam up and down your body, resting for a second on your own pussy, then she says, 'That was... really good. I - I still would have preferred a cock, but... there's something to this too.' With a new composure, now that her lusts have been satisfied, she sits up and cleans herself a bit by rubbing off with the beach's very fine dry sand. Then she goes to collect her gear.";
			now Dexterity of Sonya is 2;
			NPCSexAftermath Sonya receives "PussyDildoFuck" from Player;
		else if Dexterity of Sonya is 2: [first time with dildo]
			say "     Hand in hand, you climb over the crest of a nearby dune, stopping several times on the way to share hungry kisses. After finally arriving in a somewhat protected spot, out of sight from the beach, Sonya pushes you to sit in the sand and starts to undress in a hot little strip-show. It's amazing how arousing she can make taking off scale mail armor and then piece by piece her other clothing. She quickly has you so hot and bothered that you just can't resist standing up and 'helping' a bit, pulling off articles of clothing and caressing her. Soon she is completely naked, revealing the pale-skinned perfection of her well-trained body. A beaming smile on her face, she starts undressing you too, rubbing her breasts and body against you as you're stripped bare.";
			say "     An impish smile on her lips, Sonya remarks, 'How about we... make things a bit more interesting? I love being with you, even though you've got nothing down there, but I feel like I... need something long and hard thrusting deep into me. So - I got something for us...' Looking at the pale-skinned, beautiful woman, you stroke her cheek and give her a curious expression. She just smiles mysteriously, then steps over to the pile of her discarded clothing and bends over to open her satchel, giving you a very inviting view of her shapely ass and the wet and swollen pussy between her legs. Sonya turns around a moment later with... a green double-headed dildo in hand, giving a pleased little laugh as she sees where your gaze rests. Then she gets down, stretching out in the sand with her shoulders and head resting on the pile of her clothes and spreading those long, lithe legs invitingly. The sexy woman raises her hand with the dildo a moment later, and waves it at you, making the ends wobble in the air. 'I... want you to take me, please. Make use of this 'cock snake' and fuck me good...'";
			WaitLineBreak;
			say "     Your eyes riveted to the rubber sex toy, you kneel between the young Viking's legs and take it from her. Pushing one end in between Sonya's pussy lips, her moans encourage you to go deeper and deeper. Sliding it in and out of her, you slowly fuck Sonya while your other hand explores her body, stroking over soft skin and fondling her breasts. With her writhing in pleasure under your ministrations, there soon is a gasp of 'Kiss me', and you eagerly comply, moving up on top of her and finding her lips with yours. It feels amazing to be so intimately close to her, and making out as you fuck her with a dildo.";
			say "     Before long, Sonya moans 'Harder, harder!' her arms pulling you tight against her. Taking up the speed of your thrusts into her, you find yourself with a very enthusiastic partner, meeting each of your thrusts with a push of her hips. It's great fun finding out what she likes best and how you can make her squeal in delight. For a while, anything but making out, touching and fucking is forgotten, the two of you filling the air with loud moans and gasps of pleasure...";
			WaitLineBreak;
			say "     As much as you wish this could last forever, there are limits to everything. Her pants having gotten louder and faster quickly, Sonya suddenly pulls you even tighter against herself, holding you there as she shouts 'I'm coming!' You can feel her whole body shuddering under yours, a tremble running through the dildo in your hand as her inner muscles grip it. A trickle of her femcum runs down over the sex toy, to drip down into she sand.";
			say "     After a moment of catching her breath, Sonya looks up at you and... suddenly the world spins as she rolls the two of you over until she's on top and straddling your hips. With a new composure, now that her lusts have been satisfied, she pulls the rubber cock out herself and cleans up a bit by rubbing off with the beach's very fine dry sand. Then she goes to collect her other gear.";
			now Dexterity of Sonya is 3;
			NPCSexAftermath Sonya receives "PussyDildoFuck" from Player;
		else if Dexterity of Sonya is 3: [dildo or fingers]
			say "     Hand in hand, you climb over the crest of a nearby dune, stopping several times on the way to share hungry kisses. After finally arriving in a somewhat protected spot, out of sight from the beach, Sonya pushes you to sit in the sand and starts to undress in a hot little strip-show. It's amazing how arousing she can make taking off scale mail armor and then piece by piece her other clothing. She quickly has you so hot and bothered that you just can't resist standing up and 'helping' a bit, pulling off articles of clothing and caressing her. Soon she is completely naked, revealing the pale-skinned perfection of her well-trained body. A beaming smile on her face, she starts undressing you too, rubbing her breasts and body against you as you're stripped bare.";
			say "     Soon ending up standing naked with Sonya's arms wrapped around you from behind, you revel in the feel of her curves and smooth skin against you, as well as the young woman's hands that sensually stroke your body. Her hand dips down your front eventually, stroking over your smooth crotch in a feather-light touch that has you panting in lust.";
			LineBreak;
			say "     [bold type]After a moment of this, she whispers in your ear, 'Should we just use our tongues, or do you want me to get the cock-snake out for some real fun?'[roman type][line break]";
			LineBreak;
			say "     ([link]Y[as]y[end link]) - Have oral sex with Sonya.";
			say "     ([link]N[as]n[end link]) - Make use of the double-dong dildo.";
			if Player consents:
				LineBreak;
				say "     Turning around to face Sonya, you give her a hungry kiss, then pant that you want her to go down on you as you come up for air afterwards. With that, you pull away from your sexy viking and kneel down in the sand with your legs spread. Both hands on your hips, you just look at Sonya expectantly - to which the warrioress gives a sexy little smile and licks her lips. Then Sonya gets down on all fours, prowling closer to you in a playful, cat-like way that involves showing off her beautiful, naked body. Arriving directly before you just a short moment later, the striking woman lowers her head and gives your smooth crotch a first eager little lick.";
				WaitLineBreak;
				say "     You moan loudly as Sonya makes some more experiences with pleasing someone orally, even though you can tell she is still somewhat disappointed that you don't have a cock. Despite this, she gives it her best try, and... it turns out she's a natural at it - licking and nibbling your sensitive skin, gently rubbing and finding the most tender spots. After a short while of breathtaking stimulation by the blond beauty, you give a satisfied gasp, throwing your head back as tremors of lust run through your whole being.";
				say "     The viking wipes her lips with an amused snort, then says, 'That was fun. Now... Would you care to return the favor?' She looks up at you, then wiggles her hips invitingly. Taking hold of her shoulder, you stroke down Sonya's side as you move around her body, letting your fingers slide over her soft and warm skin until they reach the firm, well-rounded cheeks of her butt. There is a pant from the Nordic beauty as your hand slides between her legs, brushing against sensitive nether lips and then reaching her little clit. Sonya gives a breathless gasp as you rub over her button with a finger, gently tickling it while your other hand starts to spread the lips of her pussy apart.";
				WaitLineBreak;
				say "     As you slide one of your digits into Sonya, rubbing her passage, you can't help but thing that there is something very delicious about having this strong woman before you on her hands and knees, shivering and panting helplessly as you touch her. This animates you to really put in some effort, teasing her first in one spot, then another, making good use of all the little sensitive spots you know of Sonya. It's quite a lot of fun to see her react when you slide your finger in... just... like... so... and... then... do THIS - Sonya throws her head back moaning loudly as a mini-orgasm runs through her body.";
				say "     You keep going for a while like this, playing with Sonya's body, making her tremble, pant and gasp, before you finally go all out, intensifying your finger-work to get her to the climax that has been building all this time. The beautiful woman's moans get louder and more high-pitched as they come faster and faster, then she gives something halfway between a squeak and an aroused shout as the point of no return is reached. Sonya rocks back - hard - to get even more of your teasing fingers inside her.";
				WaitLineBreak;
				say "     Sinking forward to lie panting on the ground, her ass still half-raised, Sonya regains her breath after a minute or two, then rolls over on her side to look at you. Her eyes roam up and down your body, resting for a second on your own pussy, then she says, 'That was... really good. Thank you, my love.' With a new composure, now that her lusts have been satisfied, she sits up and cleans herself a bit by rubbing off with the beach's very fine dry sand. Then she goes to collect her gear.";
				NPCSexAftermath Sonya receives "PussyDildoFuck" from Player;
			else:
				LineBreak;
				say "     Turning around to face Sonya, you give her a hungry kiss while one of your hands snakes down between you, its fingers dipping into her pussy an eye-blink later. As you thrust in with two fingers and start to wiggle them around, Sonya can't help but lean her head back and give a loud moan. You tell her that you want to 'take her', letting the two of you feel each other inside. Moving your head to find one of her perky nipples with your lips as you continue to finger Sonya, you do playfully suckle on it, which gives the young woman's aroused squeals a whole new note of urgency. Then finally after a short little while, you do pull back, allowing her to catch her breath and for the lustful haze to recede from her mind.";
				say "     Eager to get on the real action after you warming her up like this, she steps over to the pile of her discarded clothing and bends over to open her satchel, giving you a very inviting view of her shapely ass and the wet and swollen pussy between her legs. Sonya turns around a moment later with the green double-headed dildo in hand, giving a pleased little laugh as she sees where your gaze rests. Then she gets down, stretching out in the sand with her shoulders and head resting on the pile of her clothes and spreading those long, lithe legs invitingly. The sexy woman raises her hand with the dildo a moment later, and waves it at you, making the ends wobble in the air.";
				WaitLineBreak;
				say "     Your eyes riveted to the rubber sex toy, you kneel between the young Viking's legs and take it from her. Pushing one end in between Sonya's pussy lips, her moans encourage you to go deeper and deeper. Sliding it in and out of her, you slowly fuck Sonya while your other hand explores her body, stroking over soft skin and fondling her breasts. With her writhing in pleasure under your ministrations, there soon is a gasp of 'Kiss me', and you eagerly comply, moving up on top of her and finding her lips with yours. It feels amazing to be so intimately close to her, and making out as you fuck her with a dildo.";
				say "     Before long, Sonya moans 'Harder, harder!' her arms pulling you tight against her. Taking up the speed of your thrusts into her, you find yourself with a very enthusiastic partner, meeting each of your thrusts with a push of her hips. It's great fun finding out what she likes best and how you can make her squeal in delight. For a while, anything but making out, touching and fucking is forgotten, the two of you filling the air with loud moans and gasps of pleasure...";
				WaitLineBreak;
				say "     As much as you wish this could last forever, there are limits to everything. Her pants having gotten louder and faster quickly, Sonya suddenly pulls you even tighter against herself, holding you there as she shouts 'I'm coming!' You can feel her whole body shuddering under yours, a tremble running through the dildo in your hand as her inner muscles grip it. A trickle of her femcum runs down over the sex toy, to drip down into she sand.";
				say "     After a moment of catching her breath, Sonya looks up at you and... suddenly the world spins as she rolls the two of you over until she's on top and straddling your hips. With a new composure, now that her lusts have been satisfied, she pulls the rubber cock out herself and cleans up a bit by rubbing off with the beach's very fine dry sand. Then she goes to collect her other gear.";
				NPCSexAftermath Sonya receives "PussyDildoFuck" from Player;
	LineBreak;
	if the player is not facially human or the player is not bodily human or the player is not skintone human: [non-human player = a monster, in her words]
		say "     As she pulls her clothes back on, Sonya gives your naked body a glance that lingers for a moment, and you can almost see lust and desire flickering up in her eyes again. Then she shakes her head with a sigh. 'I'd have another go with you, my handsome monster, but... there's my duty to be done. Raiding targets don't scout themselves, you know...' She kneels next to you for a quick kiss, then stands up and walks away, turning her head for one last look back as she climbs over the crest of the dune.";
	else: [human player]
		say "     As she pulls her clothes back on, Sonya gives your naked body a glance that lingers for a moment, and you can almost see lust and desire flickering up in her eyes again. Then she shakes her head with a sigh. 'I'd have another go with you, my outlander warrior, but... there's my duty to be done. Raiding targets don't scout themselves, you know...' She kneels next to you for a quick kiss, then stands up and walks away, turning her head for one last look back as she climbs over the crest of the dune.";

to say VikingDesc:
	setmongender 4;
	if debugactive is 1:
		say "DEBUG -> VIKINGRELATIONSHIP: [VikingRelationship], VIKINGPREGNANCY: [VikingPregnancy], PREGCOUNTER: [VikingPregCounter], KIDCOUNTER: [VikingKidCounter] <- DEBUG[line break]";
	if VikingRelationship is 0: [first meeting]
		say "     As you walk along the beach, you notice something moving out on the water. Turning your gaze toward it and straining your eyes a bit, you recognize it as a Viking longboat with a big square sail. Where did that thing come from? On the other hand... with all the things happening these days, the sudden appearance of Vikings isn't all that surprising. As you watch, you see a smaller boat being rowed towards the bigger one. Looks like they went ashore a while ago - or maybe dropped off som-[line break][line break]";
		say "     *thunk, thunk* sounds come from behind you, and as you turn around you find yourself confronted with a female Viking, hitting the broad side of her sword against her round wooden shield to attract your attention. She's got shoulder-length blond hair, the impressive physique of a seasoned fighter and is dressed in light scale mail. Her gaze wanders over you appraisingly, then she says:[line break]";
		if the player is not facially human or the player is not bodily human or the player is not skintone human: [sees player as a legendary monster]
			say "     'So we did land in the land of the legends, with monsters roaming about. Let's see if the old men spoke the truth when they told their stories about oh so powerful beasts. Let's fight, creature!' A challenging look in her eye, she brings up her shield again and raises the sword, rushing at you.";
		else: [human player to be raided]
			say "     'So you're an inhabitant of this strange land? I'm not impressed. I bet you'll just squawk like a plucked chicken as all the others did when we carried off the loot. But who knows - prove me wrong if you can, weakling!' A challenging look in her eye, she brings up her shield again and raises the sword, rushing at you.";
		now VikingRelationship is 1;
	else if VikingRelationship is 1: [never won against her]
		say "     Walking along the beach, you suddenly find yourself confronted with a female Viking, running down the raise of the dune where she lay in wait and rushing at you. The attractive blond woman in her light scale mail brandishes her sword and shield as she lets her gaze wander over you appraisingly.";
		if the player is not facially human or the player is not bodily human or the player is not skintone human: [sees player as a legendary monster]
			say "     'Another monster - or is it the same one? Bah, who cares.' She gives you a challenging look. 'Let's see if at least one of you critters is as powerful and strong as the old men told in their stories.' She brings up her shield again and raises the sword, rushing at you.";
		else: [human player to be raided]
			say "     'Another sheep waiting to be shorn - or is it the same one? Bah, who cares.' She gives you a challenging look. 'Fear me and get ready to loose your wool - or prove me wrong if you can, weakling!' She brings up her shield again and raises the sword, rushing at you.";
	else if VikingRelationship is 2: [player beat her once]
		say "     Walking along the beach, you suddenly find yourself confronted with a female Viking, running down the raise of the dune where she lay in wait and rushing at you. The attractive blond woman in light scale mail brandishes her sword and shield as she lets her gaze wander over you appraisingly.";
		if the player is not facially human or the player is not bodily human or the player is not skintone human: [sees player as a legendary monster]
			say "     'So we meet again, monster.' She gives you a challenging look. 'You beat me once, but I bet that was just luck. This time, I'll show you!' She brings up her shield again and raises the sword, rushing at you.";
		else: [human player to be raided]
			say "     'So we meet again, outlander.' She gives you a challenging look. 'You beat me once, but I bet that was just luck. This time, I'll show you!' She brings up her shield again and raises the sword, rushing at you.";
	else if VikingRelationship is 3: [player beat her twice]
		say "     Walking along the beach, you suddenly find yourself confronted with a female Viking, running down the raise of the dune where she lay in wait and rushing at you. The attractive blond woman in light scale mail brandishes her sword and shield as she lets her gaze wander over you appraisingly.";
		if the player is not facially human or the player is not bodily human or the player is not skintone human: [sees player as a legendary monster]
			say "     'Face to face again, monster.' She gives you a challenging look. 'You're not a bad fighter, I have to admit - but this time, I'll show you!' She brings up her shield again and raises the sword, rushing at you.";
		else: [human player to be raided]
			say "     'Face to face again, little warrior.' She gives you a challenging look. 'You're not a bad fighter, I have to admit - but this time, I'll show you!' She brings up her shield again and raises the sword, rushing at you.";
	else if (VikingRelationship > 3 and VikingRelationship < 7) or VikingRelationship is 20: [player beat her three+ times]
		if VikingPregnancy is 0:
			say "     Walking along the beach, you suddenly find yourself confronted with a female Viking, running down the raise of the dune where she lay in wait and rushing at you. The attractive blond woman in light scale mail brandishes her sword and shield as she lets her gaze wander over you.";
			if the player is not facially human or the player is not bodily human or the player is not skintone human: [sees player as a legendary monster]
				say "     'Hello, my [one of]brave[or]strong[or]powerful[or]beloved[or]handsome[at random] monster. You're everything - and more - that the old men said you'd be when they told us the legends.' She gives you a challenging look. 'How about you prove your power again and then ravish me? Let's fight!' She brings up her shield again and raises the sword, rushing at you.";
			else: [human player to be raided]
				say "     'Hello, my [one of]brave[or]strong[or]powerful[or]beloved[or]handsome[at random] warrior. I'll admit that you've proven me wrong about your people again and again.' She gives you a challenging look. 'How about you show me your power another time and then ravish me? Let's fight!' She brings up her shield again and raises the sword, rushing at you.";
		if VikingPregnancy is 1:
			say "     Walking along the beach, you suddenly find yourself confronted with a female Viking, running down the raise of the dune where she lay in wait and rushing at you. The attractive blond woman in light scale mail brandishes her sword and shield as she lets her gaze wander over you.";
			if the player is not facially human or the player is not bodily human or the player is not skintone human: [sees player as a legendary monster]
				say "     'Hello, my [one of]brave[or]strong[or]powerful[or]beloved[or]handsome[at random] monster. I've been feeling... different, lately. Looks like your seed has done its work and we'll have a child.' She gives you a challenging look. 'But don't you think that'll mean I'll end up a tame brood-cow. I can fight, no matter what - and if you want another tumble in the dunes, you'll have to fight!' She brings up her shield again and raises the sword, rushing at you.";
			else: [human player to be raided]
				say "     'Hello, my [one of]brave[or]strong[or]powerful[or]beloved[or]handsome[at random] warrior. I've been feeling... different, lately. Looks like your seed has done its work and we'll have a child.' She gives you a challenging look. 'But don't you think that'll mean I'll end up a tame brood-cow. I can fight, no matter what - and if you want another tumble in the dunes, you'll have to fight!' She brings up her shield again and raises the sword, rushing at you.";
		else if VikingPregnancy is 2:
			say "     Walking along the beach, you suddenly find yourself confronted with a female Viking, running down the raise of the dune where she lay in wait and rushing at you. The attractive blond woman in light scale mail brandishes her sword and shield as she lets her gaze wander over you. There's somewhat of a bulge noticeable in her midriff, showing proof of your sperm's virility.";
			if the player is not facially human or the player is not bodily human or the player is not skintone human: [sees player as a legendary monster]
				say "     'Hello, my [one of]brave[or]strong[or]powerful[or]beloved[or]handsome[at random] monster. Our child grows quick, as you can see. He'll be as powerful as his father, for sure.' She rubs her belly through the tunic and gives you a challenging look. 'But don't you think I've become a tame brood-cow now. I'd love another tumble in the dunes, but you'll still have to prove your power. Let's fight!' She brings up her shield again and raises the sword, rushing at you.";
			else: [human player to be raided]
				say "     'Hello, my [one of]brave[or]strong[or]powerful[or]beloved[or]handsome[at random] warrior. Our child grows quick, as you can see. He'll be as powerful as his father, for sure.' She rubs her belly through the tunic and gives you a challenging look. 'But don't you think I've become a tame brood-cow now. I'd love another tumble in the dunes, but you'll still have to prove your power. Let's fight!' She brings up her shield again and raises the sword, rushing at you.";
		else if VikingPregnancy is 3:
			say "     Walking along the beach, you suddenly find yourself confronted with a female Viking, running down the raise of the dune where she lay in wait and rushing at you. The attractive blond woman in a woolen tunic brandishes her sword and shield as she lets her gaze wander over you. She is quite obviously pregnant, with a bulging belly showing proof of your sperm's virility.";
			if the player is not facially human or the player is not bodily human or the player is not skintone human: [sees player as a legendary monster]
				say "     'Hello, my [one of]brave[or]strong[or]powerful[or]beloved[or]handsome[at random] monster. Our child told me you were close. He always gets more active when you're there.' She rubs her belly through the tunic and gives you a challenging look. 'But don't you think I've become a tame brood-cow now. I'd love another tumble in the dunes, but you'll still have to prove your power. Let's fight!' She brings up her shield again and raises the sword, rushing at you.";
			else: [human player to be raided]
				say "     'Hello, my [one of]brave[or]strong[or]powerful[or]beloved[or]handsome[at random] warrior. Our child told me you were close. He always gets more active when you're there.' She rubs her belly through the tunic and gives you a challenging look. 'But don't you think I've become a tame brood-cow now. I'd love another tumble in the dunes, but you'll still have to prove your power. Let's fight!' She brings up her shield again and raises the sword, rushing at you.";
		else if VikingPregnancy is 4:
			say "     Walking along the beach, you suddenly find yourself confronted with a female Viking, running down the raise of the dune where she lay in wait and rushing at you. The attractive blond woman in light scale mail brandishes her sword and shield as she lets her gaze wander over you.";
			if a random chance of 1 in 2 succeeds: [kid was a boy]
				if the player is not facially human or the player is not bodily human or the player is not skintone human: [sees player as a legendary monster]
					say "     'Hello, my [one of]brave[or]strong[or]powerful[or]beloved[or]handsome[at random] monster. Our child is strong and healthy, a beautiful little boy. He looks a lot like you and will become a powerful warrior for sure, being half-monster like in the legends.' Biting her lip, she gives you a look, half challenging half needful. 'I miss having part of you inside me, and by body tells me I'm ready again already. How about you prove your power over me again and ravish me? Let's fight!' She brings up her shield again and raises the sword, rushing at you.";
				else: [human player to be raided]
					say "     'Hello, my [one of]brave[or]strong[or]powerful[or]beloved[or]handsome[at random] warrior. Our child is strong and healthy, a beautiful little boy. He looks a lot like you and will become a powerful warrior for sure.' Biting her lip, she gives you a look, half challenging half needful. 'I miss having part of you inside me, and by body tells me I'm ready again already. How about you prove your power over me again and ravish me? Let's fight!' She brings up her shield again and raises the sword, rushing at you.";
					if VikingKidGender is 0:
						now VikingKidGender is 1;
					else if VikingKidGender is 2:
						now VikingKidGender is 3;
			else: [kid was a girl]
				if the player is not facially human or the player is not bodily human or the player is not skintone human: [sees player as a legendary monster]
					say "     'Hello, my [one of]brave[or]strong[or]powerful[or]beloved[or]handsome[at random] monster. Our child is strong and healthy, a beautiful little girl. She looks a lot like you and will become a powerful warrior for sure, being half-monster like in the legends.' Biting her lip, she gives you a look, half challenging half needful. 'I miss having part of you inside me, and by body tells me I'm ready again already. How about you prove your power over me again and ravish me? Let's fight!' She brings up her shield again and raises the sword, rushing at you.";
				else: [human player to be raided]
					say "     'Hello, my [one of]brave[or]strong[or]powerful[or]beloved[or]handsome[at random] warrior. Our child is strong and healthy, a beautiful little girl. She looks a lot like you and will become a powerful warrior for sure.' Biting her lip, she gives you a look, half challenging half needful. 'I miss having part of you inside me, and by body tells me I'm ready again already. How about you prove your power over me again and ravish me? Let's fight!' She brings up her shield again and raises the sword, rushing at you.";
					if VikingKidGender is 0:
						now VikingKidGender is 2;
					else if VikingKidGender is 1:
						now VikingKidGender is 3;
			now VikingPregnancy is 0; [reset into receptive state]
	else if VikingRelationship is 7: [Sonya is on the ship, her cousin appears and offers an ultimatum]
		now VikingUltimatum is 24; [72h to appear for the challenge]
		now Chieftain's Challenge is active;
		if the player is not facially human or the player is not bodily human or the player is not skintone human: [they see the player as a monster]
			say "     Walking along the beach, you suddenly find yourself confronted with two male Vikings, rushing towards you as they spot you. The young blond men in light scale mail carry round shields and brandish sharp-looking axes - and are pretty enraged. Seems like your previous encounters Sonya didn't go over too well with these two... brothers, you'd say, from their similar looks. For a moment, it looks like one of them would just keep coming and attack you, until he's stopped in his tracks by the other calling out 'Stop, Svetjalf. This... creature is not ours to slay. We've got a message to deliver.'";
			say "     The Viking turns to you and continues with a snarl 'So you're the beast that despoiled our cousin? How did you beat her in a fight - or make her believe you did? Magic? Some other treachery? Clearly you've got her controlled somehow, or she wouldn't praise an outlander beast so highly. Bah.' He spits in the sand before your feet. 'Our chieftain Frithjof sent us to pass on a message. He calls upon you, the one who dishonored his daughter, to come to those big rocks at the end of the beach during the next three days. You'll fight - in front of the rest of the clan, to prevent any of your tricks - and he'll spill your guts on the sand. If you at least have the decency to appear and die like a man would, that'll restore some honor to Sonya...' With that said, he and his brother give you a final angry stare, then turn around and walk off to a waiting rowboat some way along the beach.";
		else: [human-like player]
			say "     Walking along the beach, you suddenly find yourself confronted with two male Vikings, rushing towards you as they spot you. The young blond men in light scale mail carry round shields and brandish sharp-looking axes - and are pretty enraged. Seems like your encounters Sonya didn't go over too well with these two... brothers, you'd say, from their similar looks. For a moment, it looks like one of them would just keep coming and attack you, until he's stopped in his tracks by the other calling out 'Stop, Svetjalf. This... outlander is not ours to slay. We've got a message to deliver.'";
			say "     The Viking turns to you and continues with a snarl 'So you're the bastard that despoiled our cousin? How did you beat her in a fight - or make her believe you did? Magic? Some other treachery? Clearly you've got her controlled somehow, or she wouldn't praise an outlander so highly. Bah.' He spits in the sand before your feet. 'Our chieftain Frithjof sent us to pass on a message. He calls upon you, the one who dishonored his daughter, to come to those big rocks at the end of the beach during the next three days. You'll fight - in front of the rest of the clan, to prevent any of your tricks - and he'll spill your guts on the sand. If you at least have the decency to appear and die like a man would, that'll restore some honor to Sonya...' With that said, he and his brother give you a final angry stare, then turn around and walk off to a waiting rowboat some way along the beach.";
		LineBreak;
		say "     You've got [bold type]72 hours (24 turns)[roman type] from now on to appear at the [bold type]chieftain's challenge[roman type] here on the beach and fight it out with him. Beating the man in an honest one on one duel should hopefully convince the gathered vikings that you didn't trick or bespell Sonya and really are worthy of her.";
		LineBreak;
		say "     Prepare yourself well for the duel - you could be gutted like a fish (and die) - or gain the admiration of Vikings if you win (and see Sonya again).";
		now combat abort is 1;
		now VikingRelationship is 8;
	else if VikingRelationship is 8: [ultimatum is ticking away]
		if VikingUltimatum > 16:
			say "     Walking along the beach, you suddenly find yourself confronted with two male Vikings, rushing towards you as they spot you. It's Sonya's two cousins again, who snarl and glower at you as they get closer. 'Remember, you've got [bold type]three days[roman type] to show up for the [bold type]chieftain's challenge[roman type]. Less than that by now, really. Have at least the decency to show up and die properly - Sonya will never be able to succeed her father as leader of the clan now, disgraced as she is by losing herself to some of your tricks, but she'll at least regain some of her honor that way,' says the more talkative of them before they move on.";
		else if VikingUltimatum > 8:
			say "     Walking along the beach, you suddenly find yourself confronted with two male Vikings, rushing towards you as they spot you. It's Sonya's two cousins again, who snarl and glower at you as they get closer. 'We waited for you yesterday, coward. Have at least the decency to show up and die properly - Sonya will never be able to succeed her father as leader of the clan now, disgraced as she is by losing herself to some of your tricks, but she'll at least regain some of her honor that way. You've got [bold type]two days[roman type] left to show up for the [bold type]chieftain's challenge[roman type].' says the more talkative of them before they move on.";
		else:
			say "     Walking along the beach, you suddenly find yourself confronted with two male Vikings, rushing towards you as they spot you. It's Sonya's two cousins again, who snarl and glower at you as they get closer. 'You're not gonna show up and allow Sonya to reclaim some of her honor as she watches you bleed out? Filthy coward! You've got [bold type]one day[roman type] left to show up for the [bold type]chieftain's challenge[roman type].' says the more talkative of them, only barely holding back from attacking you.";
		now combat abort is 1;
	else if VikingRelationship is 9:
		say "     Gripping the handle of his axe tightly, the Viking chieftain points at you with it. 'I still don't know what you did to my daughter, but you'll pay for it, may it have been a spell, drug or anything else. No amount of trickery can save you now!' Then he attacks, rushing at you with a loud war-cry.";
	else if VikingRelationship is 100:
		say "     Error: The vikings should have left the area since you didn't snow up for the duel with their chief. Please report how you saw this.";

to say VikingWomanAttacks:
	if VikingRelationship is 9:
		say "[one of]Chief Frithjof swings his axe and lands a hit on you, though you luckily manage to turn away from it in time so it just leaves a bleeding cut and doesn't take your arm off.[or]The Viking chieftain slams his shield against your chest, making you stumble backwards dazedly.[or]A sudden kick from the Viking Chieftain against the side of your leg leaves you numb and weakened.[or]You manage to evade a swing of his axe, but the chieftain slams the hilt of the weapon into your stomach, making you double over in pain.[or]Frithjof slams his shield into your chest, driving the air from your lungs.[or]Rushing at you with his shield held in front of him, Frithjof slams against you and bowls you over.[at random]";
	else:
		say "[one of]She lands a shallow cut on you. Luckily, she's not trying to kill you, or she could have skewered you there...[or]The Viking woman slaps the broad side of her sword against your head, leaving you seeing stars for a moment.[or]A sudden kick against the side of your leg leaves you numb and weakened.[or]She slams her shield into your chest, driving the air from your lungs.[at random]";

Section 2 - Creature Insertion

Table of Random Critters (continued)
NewTypeInfection (truth state)	Species Name	Name	Enemy Title	Enemy Name	Enemy Type	Attack	Defeated	Victory	Desc	Face	Body	Skin	Tail	Cock	Face Change	Body Change	Skin Change	Ass Change	Cock Change	str	dex	sta	per	int	cha	sex	HP	lev	wdam	area	Cock Count	Cock Length	Ball Size	Nipple Count	Breast Size	Male Breast Size	Cunt Count	Cunt Depth	Cunt Tightness	SeductionImmune	Libido	Loot	Lootchance	TrophyFunction	MilkItem	CumItem	Scale (number)	Body Descriptor (text)	Type (text)	Magic (truth state)	Resbypass (truth state)	non-infectious (truth state)	Cross-Infection (text)	DayCycle	Altcombat (text)	BannedStatus (truth state)
--	--	--	--	--	--	--	--	--	--	--	--	--	--	--	--	--	--	--	--	--	--	--	--	--	--	--	--	--	--	--	--	--	--	--	--	--	--	--	--	--	--	--	--	--	--	--	--	--	--	--	--	--	--	--	--	--;

When Play begins:
	Choose a blank row from Table of Random Critters;
	now NewTypeInfection entry is false;
	now Species Name entry is "Viking";
	add "Viking Woman" to infections of HumanList;
	add "Viking Woman" to infections of HistoricalList;
	add "Viking Woman" to infections of FemaleList;
	add "Viking Woman" to infections of BipedalList;
	now Name entry is "Viking Woman";
	now enemy title entry is "Viking Shieldmaiden";
	now enemy Name entry is "Sonya";
	now enemy type entry is 1; [0 = non unique enemy; 1 = unique (unknown name); 2 = unique (known name) | Used to disqualify unique enemies from Vore/UB and showing the enemy name in encounters]
	now attack entry is "[VikingWomanAttacks]";
	now defeated entry is "[Viking loses]";
	now victory entry is "[Viking wins]";
	now desc entry is "[VikingDesc]";
	now face entry is "a handsome young woman's, framed by a mane of shoulder-long, unkempt blond hair";
	now body entry is "that of a young woman, quite fit and healthy. It is garbed in a woolen tunic and pants, plus a pair of leather boots";
	now skin entry is "smooth, pale"; [ format as "Your body is covered in (your text) skin"]
	now tail entry is "You have a tight, firmly muscled butt."; [ write a whole Sentence or leave blank. ]
	now cock entry is "human"; [ format as "You have a 'size' (your text) cock ]
	now face change entry is "it shapes itself into a handsome female visage. Your hair turns into a shoulder-length blond mane"; [ format as "Your face feels funny as (your text)." ]
	now body change entry is "it is reshaped into a that of a young woman, and a fit and healthy one at that"; [  format as "Your body feels funny as (your text)." ]
	now skin change entry is "it smoothes out, becoming the pale tint of a northern European"; [ format as "Your skin feels funny as (your text)." ]
	now ass change entry is "it gets tight and firmly muscled"; [ format as "Your ass feels funny as (your text)." ]
	now cock change entry is "it becomes human-shaped"; [ format as "Your cock feels funny as (your text)." ]
	now str entry is 20;
	now dex entry is 20;
	now sta entry is 18;
	now per entry is 15;
	now int entry is 12;
	now cha entry is 18;
	now sex entry is "Female";
	now HP entry is 80;
	now lev entry is 9;
	now wdam entry is 15;
	now area entry is "Beach";             [ Case sensitive]
	now Cock Count entry is 0;                  [ number of cocks if sex is 'Male' or 'Both' ]
	now Cock Length entry is 0;
	now Ball Size entry is 0;             [ Size of balls ]
	now Nipple Count entry is 2;                [ Number of nipples. ]
	now Breast Size entry is 3;            [cup size as number, counting Flat Pecs = 0, A = 1, B = 2, ...]
	now Male Breast Size entry is 0;       [ Breast size for if Sex="Male", usually zero. ]
	now Cunt Count entry is 1;                  [ number of pussies if sex is 'Female' or 'Both' ]
	now Cunt Depth entry is 10;
	now Cunt Tightness entry is 3; [ Inches circumference. 3:extremely tight, 5:tight, 7:receptive, 10:open, 11+ gaping ]
	now SeductionImmune entry is false;
	now libido entry is 10;                [ As part of infection, the Player will be gradually moved towards this value; also used for the creature's seduce defense as a penalty ]
	now loot entry is "mead horn";         [ Dropped item, blank for none. Case sensitive. ]
	now lootchance entry is 40;            [ Percentage chance of dropping loot, from 0-100. ]
	now MilkItem entry is "";
	now CumItem entry is "";
	now TrophyFunction entry is "-";
	now scale entry is 3;                  [ Number 1-5, approx size/height of infected PC body: 1=tiny, 3=avg, 5=huge ]
	now body descriptor entry is "Nordic"; [ Ex: "plump" "fat" "muscled" "strong" "slimy" "gelatinous" "slender". Use [one of] to vary ]
	now type entry is "human";             [ one-word creature type. Ex: feline, canine, lupine, robotic, human... Use [one of] to vary ]
	now magic entry is false;
	now resbypass entry is false;
	now non-infectious entry is true;
	now Cross-Infection entry is "Viking Man"; [infection that this infection will give the player when they lose; can be left empty if they infect with the monster's own]
	now DayCycle entry is 0;         [ 0 = Up at all times; 1 = Nocturnal (night encounters only); 2 = Diurnal (day encounters only) ]
	now altcombat entry is "default";
	now BannedStatus entry is false;


Viking Woman ends here.
