Version 1 of Zephias by Wahn begins here.

Section 1 - Zephias the spidertaur

[ Lust of Zephias                                                        ]
[  0: player hasn't met him with the captive Julio yet                   ]
[  1: player met the spidertaur with his captive soldier before          ]
[  2: player learned that Julio is gay and doesn't fuck women            ]

Table of GameCharacterIDs (continued)
object	name
Zephias	"Zephias"

Zephias is a man.
ScaleValue of Zephias is 4. [human+ sized]
Body Weight of Zephias is 5. [scale of 1-9 for body weight, grouped into low weight (1-3), mid weight (4-6) and high weight (7-9)]
Body Definition of Zephias is 5. [scale of 1-9 for body definition, grouped into low muscle (1-3), mid muscle (4-6), high muscle (7-9)]
[Body Adjective is generated out of the body weight and body definition and can be used in scenes - one word descriptive adjective depending on weight and definition groups: low weight group: skinny/slender/lithe; mid weight group: average/fit/muscled; high weight group: pudgy/husky/jacked]
Androginity of Zephias is 2. [Gender Adjective is generated out of androginity 1-9: hypermasculine/masculine/somewhat effeminate/effeminate/androgynous/feminine butch/tomboyish/feminine/hyperfeminine]
Mouth Length of Zephias is 6. [inches deep for face fucking; maximum possible will be double this number (when deep throating)]
Mouth Circumference of Zephias is 3.  [mouth circumference 1-5, "tiny, small, normal, wide, gaping"]
Tongue Length of Zephias is 4. [length in inches]
Breast Size of Zephias is 0. [cup size as number, counting Flat Pecs = 0, A = 1, B = 2, ...]
Nipple Count of Zephias is 2. [count of nipples]
Asshole Depth of Zephias is 14. [inches deep for anal fucking]
Asshole Tightness of Zephias is 3. [asshole tightness 1-5, "extremely tight, tight, receptive, open, gaping"]
Cock Count of Zephias is 1. [number of cocks]
Cock Girth of Zephias is 3. [thickness 1-5, thin/slender/average/thick/monstrous]
Cock Length of Zephias is 14. [length in inches]
Ball Count of Zephias is 2. [allowed numbers: 1 (uniball), 2 or 4]
Ball Size of Zephias is 4. [size of balls 1-7: "acorn-sized", "dove egg-sized", "chicken egg-sized" "goose-egg sized", "ostrich-egg sized", "basketball-sized", "beachball-sized"]
Cunt Count of Zephias is 0. [number of cunts]
Cunt Depth of Zephias is 0. [penetratable length in inches; some minor stretching allowed, or more with Twisted Capacity]
Cunt Tightness of Zephias is 0. [size 1-5, generates adjectives of extremely tight/tight/receptive/open/gaping]
Clit Size of Zephias is 0. [size 1-5, very small/small/average/large/very large]
[Basic Interaction states as of game start]
PlayerMet of Zephias is false.
PlayerRomanced of Zephias is false.
PlayerFriended of Zephias is false.
PlayerControlled of Zephias is false.
PlayerFucked of Zephias is false.
OralVirgin of Zephias is false.
Virgin of Zephias is true.
AnalVirgin of Zephias is false.
PenileVirgin of Zephias is false.
SexuallyExperienced of Zephias is true.
TwistedCapacity of Zephias is false. [Twisted Characters can take any penetration, no matter the size]
Sterile of Zephias is false. [steriles can't knock people up]
MainInfection of Zephias is "Spidertaur Male".
The description of Zephias is "[Zephiasdesc]".
The conversation of Zephias is { "Meep!" }.

instead of sniffing Zephias:
	say "     A";

to say Zephiasdesc:
	say "     A";

instead of conversing Zephias:
	say "     A";


Section 2 - Events

Table of GameEventIDs (continued)
Object	Name
Captured Soldier	"Captured Soldier"

Captured Soldier is a situation.
Captured Soldier is inactive.
The sarea of Captured Soldier is "Warehouse".

when play begins:
	add Captured Soldier to BadSpots of MaleList;

Instead of resolving a Captured Soldier:
	if lust of Zephias is 0: [first time]
		say "     As you make your way through the chaos of abandoned, sometimes smashed vehicles on the street, you spot several large shapes in the distance, flying about a hundred feet above the street and getting bigger - it's a trio of wyverns, out hunting together. Best to avoid attracting their attention, so you hurriedly rush over to one of the side alleys, throwing yourself out of sight just moments before the huge shadows of the massive creatures sweep over the street. They screech to each other, seemingly disappointed by the absence of prey around here, then the sounds of large flapping wings abates as they move on. Phew, seems like ...";
		WaitLineBreak;
		say "     'My, my - whom do we have here? Elijah's little pet. Hey Fucktoy,' says a voice from deeper in the alley. Turning that way, you see that it's a spidertaur - and one you know at that. With his handsome features, muscular upper body and a spider body with green body-paint, it's almost impossible not to recognize Zephias, the guy who fashioned a silken sex-nest for Elijah and got to fuck you as payment for that. A shiver of lust runs through your body as you think back to him dominating you, thrusting into your tied-up body - then you shake off the memory and focus on what Zephias is carrying. It's a humanoid shape, wrapped in many strands of silk, and you can see a military uniform through the gaps between the binding.";
		say "     Giving you a wide grin as he sees you staring, Zephias says, 'Ah, but where are my manners. Fucktoy, meet soldier boy.' He gives his captive's ass a grope, causing the man to struggle futilely for a second and mumble something into the silken gag in his mouth. 'Just caught him in one of my webs. Gonna take this little stud home and have some fun with him. Isn't he cute?' With that, he lowers the soldier from his shoulder, turning him around to face you. He's a good-looking young guy, pretty fit and well-built from what you can see, with a mane of somewhat longer than regulation black hair. He looks at you with an imploring gaze and murmurs something into his gag.";
		LineBreak;
		say "     [bold type]Do you want to do something about this situation?[roman type][line break]";
		LineBreak;
		say "     ([link]Y[as]y[end link]) - Offer yourself to take the soldier's place.";
		say "     ([link]N[as]n[end link]) - Not your problem.";
		if Player consents: [random selection if Zephias or the soldier fucks the player]
			LineBreak;
			say "     [ZephiasJulioRandomSelection]";
			now Resolution of Captured Soldier is 1; [stepped in to take his place]
		else: [let Zephias carry the guy off]
			LineBreak;
			say "     You stay silent as the bound man gets hefted back on Zephias's shoulder. 'No worries about my little soldier boy - I won't let anything happen to him. At worst, he'll have trouble sitting down for a day or two after I let him go later,' Zephias says and gives his captive's ass another quick squeeze, then scuttles off down the alleyway.";
			now Resolution of Captured Soldier is 2; [let Zephias carry him off]
		now lust of Zephias is 1;
	else: [repeat scene]
		say "     As you make your way through the chaos of abandoned, sometimes smashed vehicles on the streets, you duck into an alley at one point to get around the wreck of a truck blocking the road ahead. Walking in the shadowy alley, you're halfway through when suddenly someone else enters from the other end, a large shape carrying a white bundle. It's Zephias, a cocooned body over his shoulder. Peeking out from under the silk strands binding the man, a military uniform can be seen, as well as his somewhat longer than regulation black hair. Could that be... the same soldier he had with him when you met last time in this area?";
		say "     Giving you a wide grin, Zephias says, 'What a coincidence, here we three meet again.' He gives his captive's ass a grope, causing the man to struggle futilely for a second and mumble something into the silken gag in his mouth. 'Julio here just can't stay out of my traps it seems. Or maybe he actually wants to be dragged off to my lair to be fucked...' Lowering the soldier from his shoulder, Zephias turns him to face you and says, 'Do say hello to Fucktoy, my little soldier boy,' after which Private Vasquez murmurs something into his gag and gives you a nod. Then the large spidertaur puts his hands on his bound captive again, taking hold of several though silk strands to carry him away to his lair.";
		LineBreak;
		say "     [bold type]Do you want to do something about this situation?[roman type][line break]";
		LineBreak;
		say "     ([link]Y[as]y[end link]) - Offer yourself to take the soldier's place.";
		say "     ([link]N[as]n[end link]) - Not your problem.";
		if Player consents:
			LineBreak;
			if lust of Zephias is 2 and player is purefemale: [that Julio is gay is known, so the female sex option with him doesn't come up]
				say "     Coming to a decision, you speak up and ask for Zephias to let his captive go free. The spidertaur gives you a lust-filled leer, then says, 'Agreed.' Then he ruffles his captive's hair with one hand, telling the young man 'Hear that, soldier boy? She's so concerned about you that she offers himself in your place. How sweet.' He lowers the soldier to the ground, positioning him to sit against the building wall on one side of the alley, still wrapped tight in his silk bindings. 'There, you even get a ringside seat for the show,' Zephias says and chuckles. Ignoring the man mumble something into his gag, the spidertaur then turns to you and says, 'Okay Fucktoy, strip!'";
				say "     A lustful shiver runs down your spine as you hear the hybrid creature's order, striking a chord with your submissive nature. You drop your gear on the ground and start giving the two of them a little show, stretching and turning as you slide off your clothes piece by piece. You can almost feel their eyes on your exceedingly naked form, making you feel all warm inside and very sexy. By the time you're completely naked, Zephias's human-like shaft is fully hard, jutting out from between protective chitinous plates.";
				WaitLineBreak;
				if a random chance of 1 in 2 succeeds:
					say "     [ZephiasAlleyFuck]"; [fuck on the ground]
				else:
					say "     [ZephiasAlleyWallFuck]"; [fuck against the wall]
			else: [random selection if Zephias or the soldier fucks the player]
				say "     [ZephiasJulioRandomSelection]";
			now Resolution of Captured Soldier is 1; [stepped in to take his place]
		else: [let Zephias carry the guy off]
			LineBreak;
			say "     You stay silent as the bound man gets hefted back on Zephias's shoulder. 'No worries about my little soldier boy - I won't let anything happen to him. At worst, he'll have trouble sitting down for a day or two after I let him go later,' Zephias says and gives his captive's ass another quick squeeze, then scuttles off down the alleyway.";
			now Resolution of Captured Soldier is 2; [let Zephias carry him off]

to say ZephiasJulioRandomSelection:
	if a random chance of 1 in 2 succeeds: [Zephias fucks the player]
		say "     Coming to a decision, you speak up and ask for Zephias to let his captive go free. The spidertaur gives you a lust-filled leer, then says, 'Agreed.' Then he ruffles his captive's hair with one hand, telling the young man 'Hear that, soldier boy? [if Player is purefemale]She's so concerned about you that she offers herself in your place. How sweet.' [else]He's so concerned about you that he offers himself in your place. How sweet.' [end if]He lowers the soldier to the ground, positioning him to sit against the building wall on one side of the alley, still wrapped tight in his silk bindings. 'There, you even get a ringside seat for the show,' Zephias says and chuckles. Ignoring the man mumble something into his gag, the spidertaur then turns to you and says, 'Okay Fucktoy, strip!'";
		say "     A lustful shiver runs down your spine as you hear the hybrid creature's order, striking a chord with your submissive nature. You drop your gear on the ground and start giving the two of them a little show, stretching and turning as you slide off your clothes piece by piece. You can almost feel their eyes on your exceedingly naked form, making you feel all warm inside and very sexy. By the time you're completely naked, Zephias's human-like shaft is fully hard, jutting out from between protective chitinous plates.";
		WaitLineBreak;
		if a random chance of 1 in 2 succeeds:
			say "     [ZephiasAlleyFuck]"; [fuck on the ground]
		else:
			say "     [ZephiasAlleyWallFuck]"; [fuck against the wall]
	else: [the player is told to fuck themselves on the captive soldier's cock]
		say "     Coming to a decision, you speak up and ask for Zephias to let his captive go free. The spidertaur gives you a lust-filled leer, then says, 'Agreed.' Then he ruffles his captive's hair with one hand, telling the young man 'Hear that, soldier boy? [if Player is purefemale]She's so concerned about you that she offers himself in your place. How sweet.' [else]He's so concerned about you that he offers himself in your place. How sweet.' [end if]He lowers the soldier to the ground, positioning him on his back, then cuts away those strands wrapped around his hips and pulls down the young man's zipper. 'Your ass is safe, soldier boy - but I still want to see you in action today,' Zephias says and chuckles, pulling down the soldier's pants a bit to reveal his whole crotch and half-hard cock. Ignoring the man mumble something into his gag, the spidertaur then turns to you and says, 'Okay Fucktoy, strip!'";
		if Player is purefemale: [female player - though that doesn't get Julio hard]
			say "     A lustful shiver runs down your spine as you hear the hybrid creature's order, striking a chord with your submissive nature. You drop your gear on the ground and start giving the two of them a little show, stretching and turning as you slide off your clothes piece by piece. You can almost feel their eyes on your exceedingly naked form, making you feel all warm inside and very sexy. By the time you're completely naked, Zephias's human-like shaft is fully hard, jutting your way from between protective chitinous plates. The soldier on the other hand... isn't hard at all. 'Oh, is our little Fucktoy not to your liking? Guess you'd have preferred the time in my lair more, then. Oh well...' he pulls the soldier a bit to the side, positioning him to sit against the building wall on one side of the alley '...then I get to fuck her and you can watch.'";
			WaitLineBreak;
			if a random chance of 1 in 2 succeeds:
				say "     [ZephiasAlleyFuck]"; [fuck on the ground]
			else:
				say "     [ZephiasAlleyWallFuck]"; [fuck against the wall]
		else: [male, herm, neuter players]
			say "     A lustful shiver runs down your spine as you hear the hybrid creature's order, striking a chord with your submissive nature. You drop your gear on the ground and start giving the two of them a little show, stretching and turning as you slide off your clothes piece by piece. You can almost feel their eyes on your exceedingly naked form, making you feel all warm inside and very sexy. By the time you're completely naked, the soldier's cock stands erect as a flagpole, showing his clear arousal at watching your performance. Zephias puts a hand on it and strokes up and down a few times, then waves you closer.";
			WaitLineBreak;
			if a random chance of 1 in 2 succeeds:
				say "     [BlowingJulio]"; [blow him while Zephias fucks the player]
			else:
				say "     [RidingJulio]"; [ride the soldier's cock]

to say ZephiasAlleyFuck:
	setmonster "Spidertaur Male";
	choose row MonsterID from the Table of Random Critters;
	if Player is female:
		say "     Arranging your dropped clothes to give at least a bit of comfort over the bare stone ground, you lie down on them and obediently spread your legs for Zephias. The spidertaur is on you in seconds, running one of his human hands over your crotch, stroking along your sensitive nether lips, then pushing two fingers into your pussy. He says, 'Very nice, little slut. I'm gonna fuck your hot little hole so hard...', replacing his probing digits a moment later with something much thicker and longer.";
		say "     You feel his hard rod against your pussy lips, nudging them apart as he pushes forward and enters your body. He slides deeper slowly but surely, grinning down at you as the feeling of his shaft rubbing your insides makes you moan. Soon he's all the way in, his cock poking the entrance to your womb and you can feel the chitinous plates of his lower body against your crotch. Stroking your legs with his human hands, he then starts to thrust in and out, fucking you with deep strokes. Pulling out until only the tip of his cock remains inside you, then slamming it all the way in again, he has you gasping in lust and squirming under him in no time. 'You like that, don't you? Getting fucked hard and fast in front of an audience. Go on, give [if lust of Zephias < 2]soldier boy[else]Julio[end if] a wave. You haven't forgotten him already, have you?'";
		WaitLineBreak;
		say "     Panting and moaning as the spidertaur thrusts into you again and again, you weakly turn your head to the bound soldier sitting against the wall and watching you and wave a hand to him. There really is something to what he says, a little bit of extra naughtiness at getting fucked with others watching - just like Elijah was when the spidertaur got to fuck you as payment for his services.";
		say "     Zephias takes great pleasure in dominating you, his cock twitching every time you give him an involuntary moan after one of his sudden thrusts. After quite a bit more hot and hard fucking, he groans 'Time for the finale of our little show, pet. I'm gonna.... cuummmMMM!', pushing all of his shaft into you one last time and gives a satisfied grunt with each shot of cum directly into your womb as he orgasms. The dominant spider-hybrid coming inside you, using your body for his pleasure, pushes you over the edge right with him [if Player is male]and your own cock starts pulsing as long strings of cum splatter all over your chest[else]and femcum starts gushing out around his shaft from your well-bred pussy[end if].[fimpregchance]";
	else if Player is male:
		say "     Arranging your dropped clothes to give at least a bit of comfort over the bare stone ground, you lie down on them and obediently spread your legs for Zephias. The spidertaur is on you in seconds, running one of his human hands over your crotch, jerking your cock a few times, then moving down to brush over your pucker and making you moan in anticipation. Leaning forward, he holds two fingers out for you to take into your mouth and suck on, then when they are good and wet, he pushes them against into your ass. Stretching your pucker with his fingers in preparation, he says, 'Very nice, little slut. I'm gonna fuck your hot little hole so hard...', replacing his probing digits a moment later with something much thicker and longer.";
		say "     You feel his hard rod against your asshole, pushing forward until your pucker yields to the pressure and allows him in. He slides deeper slowly but surely, grinning down at you as the feeling of his shaft rubbing your insides makes you moan. Soon he's all the way in, his cock poking pleasure spots you didn't know you had, and you can feel the chitinous plates of his lower body against your butt. Stroking your legs with his human hands, he then starts to thrust in and out, fucking you with deep strokes. Pulling out until only the tip of his cock remains inside you, then slamming it all the way in again, he has you gasping in lust and squirming under him in no time. 'You like that, don't you? Getting fucked hard and fast in front of an audience. Go on, give [if lust of Zephias < 1]soldier boy[else]Julio[end if] a wave. You haven't forgotten him already, have you?'";
		WaitLineBreak;
		say "     Panting and moaning as the spidertaur thrusts into you again and again, you weakly turn your head to the bound soldier sitting against the wall and watching you and wave a hand to him. There really is something to what he says, a little bit of extra naughtiness at getting fucked with others watching - just like Elijah was when the spidertaur got to fuck you as payment for his services.";
		say "     Zephias takes great pleasure in dominating you, his cock twitching every time you give him an involuntary moan after one of his sudden thrusts. After quite a bit more hot and hard fucking, he groans 'Time for the finale of our little show, pet. I'm gonna.... cuummmMMM!', pushing all of his shaft into you one last time and gives a satisfied grunt with each shot of cum deep into your asshole as he orgasms. The dominant spider-hybrid coming inside you, using your body for his pleasure, pushes you over the edge right with him and your own cock starts pulsing as long strings of cum splatter all over your chest.[mimpregchance]";
	else:
		say "     Arranging your dropped clothes to give at least a bit of comfort over the bare stone ground, you lie down on them and obediently spread your legs for Zephias. The spidertaur is on you in seconds, running one of his human hands over your featureless crotch, then moving down to brush over your pucker and making you moan in anticipation. Leaning forward, he holds two fingers out for you to take into your mouth and suck on, then when they are good and wet, he pushes them against into your ass. Stretching your pucker with his fingers in preparation, he says, 'Very nice, little slut. I'm gonna fuck your hot little hole so hard...', replacing his probing digits a moment later with something much thicker and longer.";
		say "     You feel his hard rod against your asshole, pushing forward until your pucker yields to the pressure and allows him in. He slides deeper slowly but surely, grinning down at you as the feeling of his shaft rubbing your insides makes you moan. Soon he's all the way in, his cock poking pleasure spots you didn't know you had, and you can feel the chitinous plates of his lower body against your butt. Stroking your legs with his human hands, he then starts to thrust in and out, fucking you with deep strokes. Pulling out until only the tip of his cock remains inside you, then slamming it all the way in again, he has you gasping in lust and squirming under him in no time. 'You like that, don't you? Getting fucked hard and fast in front of an audience. Go on, give [if lust of Zephias < 1]soldier boy[else]Julio[end if] a wave. You haven't forgotten him already, have you?'";
		WaitLineBreak;
		say "     Panting and moaning as the spidertaur thrusts into you again and again, you weakly turn your head to the bound soldier sitting against the wall and watching you and wave a hand to him. There really is something to what he says, a little bit of extra naughtiness at getting fucked with others watching - just like Elijah was when the spidertaur got to fuck you as payment for his services.";
		say "     Zephias takes great pleasure in dominating you, his cock twitching every time you give him an involuntary moan after one of his sudden thrusts. After quite a bit more hot and hard fucking, he groans 'Time for the finale of our little show, pet. I'm gonna.... cuummmMMM!', pushing all of his shaft into you one last time and gives a satisfied grunt with each shot of cum deep into your asshole as he orgasms. The dominant spider-hybrid coming inside you, using your body for his pleasure, pushes you over the edge right with him and you climax, a tingly feeling of satisfaction spreading through you from your crotch.[mimpregchance]";
	WaitLineBreak;
	say "     After he finishes cumming, Zephias pulls his shaft out of you with a wet slurp and gives your freshly fucked form an appraising look before remarking 'I really have to congratulate Elijah again for owning such a nice submissive pet. You can go dress now, Fucktoy.' While you stand up and start collecting your gear, the spidertaur cuts his human captive's bindings and allows him to stand up. As the gag comes off, the young man calls to you 'Thanks for the... help[if lust of Zephias < 1]? I'm Private Julio Vasquez by the way.' [else]?' [end if]Then his gaze is drawn downward to the trickle of cum running down the inside of your leg and he turns an interesting shade of embarrassed red as his thoughts catch up with what just happened here - and why. He pants 'Thanks' again, then beats a hasty retreat and runs off.";

to say ZephiasAlleyWallFuck:
	setmonster "Spidertaur Male";
	choose row MonsterID from the Table of Random Critters;
	if Player is female:
		say "     Moving forward to bodily pick you up, his human hands holding and squeezing your butt, Zephias kisses you hungrily, then nibbles on your neck and gives you a very obvious and somewhat painful hickey. You can feel his hard cock press against your leg as he carries you with him, over to where the bound soldier is resting against the alley wall. Then you find your back pressed against the smooth plaster right above Zephias's captive, with the spidertaur's long legs pulling forward strong strands of silk from his silk glands to tie you up. After a first few lines over your chest, he takes your left arm, stretches it out and fastens it to the wall, then the right arm on the other side. Soon your upper body is securely webbed to the building, with your lower half still free and held by Zephias's hands stroking over your butt and thighs.";
		say "     Looking down past your soon-to-be fucked asshole and his own erection, Zephias grins at the soldier. With a chuckle, he tells the wide-eyed man 'I said you'd get a nice view of the action, didn't I, my sweet soldier boy.' Then he starts running one of his human hands over your crotch, stroking along your sensitive nether lips before pushing two fingers into your pussy. 'Very nice, little slut. I'm gonna fuck your hot little hole so hard...', replacing his probing digits a moment later with something much thicker and longer.";
		WaitLineBreak;
		say "     You feel his hard rod against your pussy lips, nudging them apart as he pushes forward and enters your body. He slides deeper slowly but surely, grinning down at the watching soldier as the feeling of his shaft rubbing your insides makes you moan. Soon he's all the way in, his cock poking the entrance to your womb and you can feel the chitinous plates of his lower body against your crotch. Leaning forward, the spidertaur kisses your lips and asks 'You like this, don't you? Getting fucked with an audience?' Being deep in the grip of arousal, you can only moan and nod, twitching your muscles around the hard cock that feels so good in your pussy. Stroking the inside of your legs with his human hands, Zephias then starts to thrust in and out, fucking you with deep strokes. He pulls out until only the tip of his cock remains inside you, then slams it all the way in again, making you gasp in lust and squirm in your bindings in no time at all.";
		say "     Panting and moaning as the spidertaur thrusts into you again and again, your thoughts wander to the human man sitting directly under you against the wall - winding you up even more as you imagine the hot view he must be getting. There really is something to what Zephias says, a little bit of extra naughtiness at getting fucked with others watching - just like Elijah was when the spidertaur got to fuck you as payment for his services.";
		say "     Zephias takes great pleasure in dominating you, his cock twitching every time you give him an involuntary moan after one of his sudden thrusts. After quite a bit more hot and hard fucking, he suddenly pulls out of you completely, holding his glistening wet shaft out for the soldier and yourself to see. Then he groans 'Time for the finale of our little show, soldier boy. Now Fucktoy is gonna get it!' With that, he thrusts all the way into you in one quick stroke, followed by just a few more thrusts before he shouts 'I'm gonna.... cuummmMMM!' and blasts shot after shot of his seed directly into your womb. The dominant spider-hybrid coming inside you, using your body for his pleasure, pushes you over the edge right with him and [if Player is male]your own cock starts pulsing as long strings of cum splatter all over your chest[else]femcum starts gushing out around his shaft from your well-bred pussy[end if].[fimpregchance]";
	else if Player is male:
		say "     Moving forward to bodily pick you up, his human hands holding and squeezing your butt, Zephias kisses you hungrily, then nibbles on your neck and gives you a very obvious and somewhat painful hickey. You can feel his hard cock press against your leg as he carries you with him, over to where the bound soldier is resting against the alley wall. Then you find your back pressed against the smooth plaster right above Zephias's captive, with the spidertaur's long legs pulling forward strong strands of silk from his silk glands to tie you up. After a first few lines over your chest, he takes your left arm, stretches it out and fastens it to the wall, then the right arm on the other side. Soon your upper body is securely webbed to the building, with your lower half still free and held by Zephias's hands stroking over your butt and thighs.";
		say "     Looking down past your soon-to-be fucked asshole and his own erection, Zephias grins at the soldier. With a chuckle, he tells the wide-eyed man 'I said you'd get a nice view of the action, didn't I, my sweet soldier boy.' Then he starts running one of his human hands over your crotch, jerking your cock a few times, before moving down to brush over your pucker and making you moan in anticipation. Next, he holds two fingers out for you to take into your mouth and suck on, then when they are good and wet, he pushes them against into your ass. Stretching your pucker with his fingers in preparation, he says, 'Very nice, little slut. I'm gonna fuck your hot little hole so hard...', replacing his probing digits a moment later with something much thicker and longer.";
		WaitLineBreak;
		say "     You feel his hard rod against your asshole, pushing forward until your pucker yields to the pressure and allows him in. He slides deeper slowly but surely, grinning down at the watching soldier as the feeling of his shaft rubbing your insides makes you moan. Soon he's all the way in, his cock poking pleasure spots you didn't know you had, and you can feel the chitinous plates of his lower body against your butt. Leaning forward, the spidertaur kisses your lips and asks 'You like this, don't you? Getting fucked with an audience?' Being deep in the grip of arousal, you can only moan and nod, twitching your muscles around the hard cock that feels so good in your hole. Stroking the inside of your legs with his human hands, Zephias then starts to thrust in and out, fucking you with deep strokes. He pulls out until only the tip of his cock remains inside you, then slams it all the way in again, making you gasp in lust and squirm in your bindings in no time at all.";
		say "     Panting and moaning as the spidertaur thrusts into you again and again, your thoughts wander to the human man sitting directly under you against the wall - winding you up even more as you imagine the hot view he must be getting. There really is something to what Zephias says, a little bit of extra naughtiness at getting fucked with others watching - just like Elijah was when the spidertaur got to fuck you as payment for his services.";
		say "     Zephias takes great pleasure in dominating you, his cock twitching every time you give him an involuntary moan after one of his sudden thrusts. After quite a bit more hot and hard fucking, he suddenly pulls out of you completely, holding his glistening wet shaft out for the soldier and yourself to see. Then he groans 'Time for the finale of our little show, soldier boy. Now Fucktoy is gonna get it!' With that, he thrusts all the way into you in one quick stroke, followed by just a few more thrusts before he shouts 'I'm gonna.... cuummmMMM!' and blasts shot after shot of his seed deep into your asshole. The dominant spider-hybrid coming inside you, using your body for his pleasure, pushes you over the edge right with him and your own cock starts pulsing as long strings of cum splatter all over your chest.[mimpregchance]";
	else:
		say "     Moving forward to bodily pick you up, his human hands holding and squeezing your butt, Zephias kisses you hungrily, then nibbles on your neck and gives you a very obvious and somewhat painful hickey. You can feel his hard cock press against your leg as he carries you with him, over to where the bound soldier is resting against the alley wall. Then you find your back pressed against the smooth plaster right above Zephias captive, with the spidertaur's long legs pulling forward strong strands of silk from his silk glands to tie you up. After a first few lines over your chest, he takes your left arm, stretches it out and fastens it to the wall, then the right arm on the other side. Soon your upper body is securely webbed to the building, with your lower half still free and held by Zephias hands stroking over your butt and thighs.";
		say "     Looking down past your soon-to-be fucked asshole and his own erection, Zephias grins at the soldier. With a chuckle, he tells the wide-eyed man 'I said you'd get a nice view of the action, didn't I, my sweet soldier boy.' Then he starts running one of his human hands over your featureless crotch before moving down to brush over your pucker and making you moan in anticipation. Next, he holds two fingers out for you to take into your mouth and suck on, then when they are good and wet, he pushes them against into your ass. Stretching your pucker with his fingers in preparation, he says, 'Very nice, little slut. I'm gonna fuck your hot little hole so hard...', replacing his probing digits a moment later with something much thicker and longer.";
		WaitLineBreak;
		say "     You feel his hard rod against your asshole, pushing forward until your pucker yields to the pressure and allows him in. He slides deeper slowly but surely, grinning down at the watching soldier as the feeling of his shaft rubbing your insides makes you moan. Soon he's all the way in, his cock poking pleasure spots you didn't know you had, and you can feel the chitinous plates of his lower body against your butt. Leaning forward, the spidertaur kisses your lips and asks 'You like this, don't you? Getting fucked with an audience?' Being deep in the grip of arousal, you can only moan and nod, twitching your muscles around the hard cock that feels so good in your hole. Stroking the inside of your legs with his human hands, Zephias then starts to thrust in and out, fucking you with deep strokes. He pulls out until only the tip of his cock remains inside you, then slams it all the way in again, making you gasp in lust and squirm in your bindings in no time at all.";
		say "     Panting and moaning as the spidertaur thrusts into you again and again, your thoughts wander to the human man sitting directly under you against the wall - winding you up even more as you imagine the hot view he must be getting. There really is something to what Zephias says, a little bit of extra naughtiness at getting fucked with others watching - just like Elijah was when the spidertaur got to fuck you as payment for his services.";
		say "     Zephias takes great pleasure in dominating you, his cock twitching every time you give him an involuntary moan after one of his sudden thrusts. After quite a bit more hot and hard fucking, he suddenly pulls out of you completely, holding his glistening wet shaft out for the soldier and yourself to see. Then he groans 'Time for the finale of our little show, soldier boy. Now Fucktoy is gonna get it!' With that, he thrusts all the way into you in one quick stroke, followed by just a few more thrusts before he shouts 'I'm gonna.... cuummmMMM!' and blasts shot after shot of his seed deep into your asshole. The dominant spider-hybrid coming inside you, using your body for his pleasure, pushes you over the edge right with him and you climax, a tingly feeling of satisfaction spreading through you from your crotch.[mimpregchance]";
	WaitLineBreak;
	say "     As Zephias pulls out of your freshly fucked ass with a wet slurp, some of his ample load stuffing your insides gushes forth too before your gaping pucker pulls closed. The spidertaur's white cum drips down on [if lust of Zephias < 1]the bound soldier[else]Julio[end if], landing on the black locks over his forehead, then running down his cheek. Grinning, the hybrid creature picks up the human, asking with a charmingly smooth voice 'Did you like the show, my little soldier boy?' Then he runs his tongue up over the man's face, gathering up the streak of cum in his mouth before ripping off the gag on [if lust of Zephias < 1]his captive[else]Julio[end if] and giving him a deep kiss, sharing a taste of his load with him.";
	say "     After cutting the main strands holding [if lust of Zephias < 1]the bound soldier[else]Julio[end if] wrapped up, Zephias walks over to where you're hanging on the wall and gives your freshly fucked form an appraising look before remarking 'I really have to congratulate Elijah again for owning such a nice submissive pet. You can go dress now, Fucktoy.' With that, he puts his hands up to hold you by the hips and uses a foreleg to slash the strands binding you to the wall. As you're lowered to the floor after that, the by now totally free young soldier calls to you 'Thanks for the... help[if lust of Zephias < 1]? I'm Private Julio Vasquez by the way.' [else]?' [end if]Then his gaze is drawn downward to the trickle of cum running down the inside of your leg and he turns an interesting shade of embarrassed red as his thoughts catch up with what just happened here - and why. He pants 'Thanks' again, then beats a hasty retreat and runs off.";

to say RidingJulio:
	setmonster "Human";
	choose row MonsterID from the Table of Random Critters;
	if Player is female: [herms]
		say "     Walking over to the tied-up soldier, you kneel down and get to work on him, sliding your lips over the head of his manhood and starting to bob up and down on the shaft. Zephias's captive moans into his gag as you blow him, his hips soon thrusting upwards as he tries to get more of his cock in your mouth. After a few more minutes, you pull off his manhood with a wet pop, giving its tip one last lick before you move upwards, swinging your legs over your bound partner to straddle his hips. Reaching down with one hand to grasp his wet and slippery shaft, you hold it up and rub it against your moist pussy lips in eager anticipation of feeling him inside you.";
		say "     But then, as you start lowering yourself on it, with the tip just nudging apart your nether lips, the man under you gives you a pretty intense gaze and shakes his head. Seems like he's this hot and bothered not for your pussy, but rather another hole... something you take in stride as you slide a little bit further up his body and bring the young man's hard cock up against your asscrack. Then, with a smile down at the now happily nodding soldier, you push his cockhead against your pucker and gasp as it yields and his manhood penetrates your ass. You go lower and lower, slowly sinking him further into you until finally your buns touch his hips and he's all the way in. Taking a deep breath, you wait for a moment to get used to the hard rod, then start sliding up and down on it. He feels amazing inside you, his hard shaft rubbing your inner walls, making you pant and moan as it hits your prostate.";
	else: [male and neuter]
		say "     Walking over to the tied-up soldier, you kneel down and get to work on him, sliding your lips over the head of his manhood and starting to bob up and down on the shaft. Zephias's captive moans into his gag as you blow him, his hips soon thrusting upwards as he tries to get more of his cock in your mouth. After a few more minutes, you pull off his manhood with a wet pop, giving its tip one last lick before you move upwards, swinging your legs over your bound partner to straddle his hips[if Player is male]. Reaching down with one hand to grasp his wet and slippery shaft, you hold it up and bring your own manhood against it, rubbing against his as you jerk both off together for a moment[end if].";
		say "     Then, the anticipation of feeling him inside you burning in you, you bring the young man's hard cock up against your asscrack. With a smile down at the soldier, you push his cockhead against your pucker and gasp as it yields and his manhood penetrates your ass. You go lower and lower, slowly sinking him further into you until finally your buns touch his hips and he's all the way in. Taking a deep breath, you wait for a moment to get used to the hard rod, then start sliding up and down on it. He feels amazing inside you, his hard shaft rubbing your inner walls, making you pant and moan as it hits your prostate.";
	WaitLineBreak;
	say "     Riding the bound soldier's cock with abandon, your gasps, moans and pants fill the alleyway and echo out into the city. Your captive partner gets off on it quite a bit too, judging from the throb of his rock-hard shaft deep inside your body. With the wild ride you're giving his erect pole, it's not much longer before that drives him over the edge. His whole body stiffens and twitches, lust-filled grunts escaping through his silken gag as he comes, long strings of his human seed squirting deep into your asshole. Feeling the pulse of his cock against your inner walls as he fills you up, your hands just fly to [if Player is male]grab your own cock, joining your partner in orgasm after just a few seconds of rapid jerking. With a satisfied grunt, you come, squirting your cum over the young soldier's chest to soak into his bindings and shirt[else]stroke your featureless crotch, caressing the sensitive area and driving you the rest of the way to an orgasm. With a satisfied grunt, you feel a tingly feeling of satisfaction spread through you from your crotch[end if].[mimpregchance]";
	say "     Breathing hard, you rest on top of the bound soldier for a moment with his manhood still inside you, reveling in the feeling of fullness, your eyes closed. Then suddenly, the sound of slow clapping shakes you out of your thoughts. Opening your eyes, you see Zephias standing nearby as he leers at you with lust in his gaze, his spidertaur cock hard and dripping precum from the end. 'A very nice show, Fucktoy - but you're not quite done yet,' he says, with a nod at his own erection. Then he scuttles closer on his many legs, standing over the bound human on the ground an instant later, his cock just inches from your face. Giving an aroused moan at getting used for his pleasure, you lean forward as he puts his hands on your head and starts to face-fuck you with rapid thrusts. Having watched you riding the soldier's shaft and masturbated to it, he's already quite close to his own climax, so it doesn't take all that long until spidertaur cum gushes into your mouth, leaving a spicy taste on your tongue as you eagerly swallow blast after blast of it.";
	WaitLineBreak;
	say "     After he finishes cumming, Zephias pulls your head off his shaft with a plop and pushes it back so he can lean down and make out with you. The spidertaur's tongue invades your mouth as his lips press against yours, tasting his own cum. As he pulls back, he holds your head by the chin for a moment, giving you an appraising look before remarking 'I really have to congratulate Elijah again for owning such a nice submissive pet. You can go dress now, Fucktoy.' While you pull off the soldier's cock and go grab your stuff, Zephias cuts his bindings and allows him to stand up. As the gag comes off, the young man calls to you 'Thanks for the... help[if lust of Zephias < 1]? I'm Private Julio Vasquez by the way.' [else]?' [end if]Then his gaze is drawn downward to the trickle of cum running down the inside of your leg and he turns an interesting shade of embarrassed red as his thoughts catch up with what just happened here - and why. He pants 'Thanks' again, then beats a hasty retreat and runs off.";

to say BlowingJulio:
	setmonster "Spidertaur Male";
	choose row MonsterID from the Table of Random Critters;
	say "     Walking over to the tied-up soldier, Zephias guides you to kneel down between he young man's legs. Then he pulls your arms behind your back, tying them together at the wrists with soft, but pretty strong strands of spidersilk. The hybrid creature's human hands stroke up and down your back for a moment, followed by him putting his arms around you from behind and starts playing with your nipples. Zephias nibbles on your earlobe, then whispers 'Doesn't he look just delicious?' and nods to the bound man in front of you. Not really expecting an answer, the spidertaur pulls your head to the side to kiss you, then moves over to your exposed neck on the other side to give you a very obvious and slightly painful hickey. That done, he puts a hand on your hip to hold you while his other pushes against your back to bend you over, bringing your head directly over the bound man's crotch. It's obvious what the spidertaur wants you to do, so you obey his unspoken command with a shiver of submissive arousal and immediately take the man's erect shaft into your mouth and start bobbing up and down on it. Zephias's captive moans into his gag as you blow him, his hips soon thrusting upwards as he tries to get more of his cock in your mouth.";
	say "     While you're busy giving a blowjob to the soldier, you don't notice Zephias move around behind you - until he puts his hands on your buttcheeks, kneading them with his fingers as he pulls them apart. Then you feel the wetness of his tongue lap over your crack and home in on your pucker, licking and poking against it with the tip. He expertly eats your ass for a while, then pulls back and experimentally stretches your pucker with his fingers. Zephias says, 'Very nice, little slut. I'm gonna fuck your hot little hole so hard...', replacing his probing digits a moment later with something much thicker and longer.";
	WaitLineBreak;
	say "     You feel his hard rod against your asshole, pushing forward until your pucker yields to the pressure and allows him in. He slides deeper slowly but surely, grinning down at his playtoys, you on his shaft and the soldier getting sucked off at his command. Soon he's all the way in, his cock poking pleasure spots you didn't know you had, and you can feel the chitinous plates of his lower body against your butt. Leaning forward, the spidertaur plants a kiss between your shoulder blades and asks 'You like this, don't you? Getting fucked with an audience - and one that even participates by getting a blowjob from you.' Being deep in the grip of your own arousal, most of your concentration on the hard cock that feels so good in your hole, you can only moan around the cock in your mouth and give a slight nod. Grabbing your hips with his human hands, Zephias then starts to thrust in and out, fucking you with deep strokes. He pulls out until only the tip of his cock remains inside you and slams it all the way in again, making you shiver and squirm in lust in no time at all.";
	say "     'What's the verdict, soldier boy? Does Fucktoy give good head?' the spidertaur asks his captive over your head. The twitch of his erection on your mouth tells you quite a bit already, and as you look up at the man and meet his lust-glazed gaze, he nods and murmurs something into the silken gag in his mouth. Content at doing a good job, you get back to sucking him off some more, sinking your lips all the way down his shaft to deep-throat him. There really is something to what Zephias said, a little bit of extra naughtiness at getting fucked with others watching - or involved directly - just like Elijah was when the spidertaur got to fuck you as payment for his services.";
	WaitLineBreak;
	say "     Zephias takes great pleasure in dominating you, his cock twitching every time you give him an involuntary moan after one of his sudden thrusts. The little threesome continues for quite a bit more sucking and fucking, until the bound soldier suddenly starts trembling all over, thrusting up his hips as his cock starts to blast his cum into your mouth. You catch shot after shot, swallowing the soldier's tasty seed hungrily. As you finally pull off his manhood with a plop and start licking its shaft to catch any trickle that might have escaped you, Zephias takes out all the stops and begins to really pound your ass. Soon, he groans, 'Time for the finale of our little show, pet. I'm gonna.... cuummmMMM!', pushing all of his shaft into you one last time and gives a satisfied grunt with each shot of cum deep into your asshole as he orgasms. The dominant spider-hybrid coming inside you, using your body for his pleasure, pushes you over the edge right with him and [if Player is male]your own cock starts pulsing as long strings of cum splatter all over the ground under you[else]you climax, a tingly feeling of satisfaction spreading through you from your crotch[end if].[mimpregchance]";
	say "     After he finishes cumming, Zephias pulls his shaft out of you with a wet slurp and gives your freshly fucked form an appraising look before remarking, 'I really have to congratulate Elijah again for owning such a nice submissive pet. You can go dress now, Fucktoy.' After he loosens the strands binding your wrists and you stand up and start collecting your gear, the spidertaur cuts his human captive free too and allows him to stand up. As the gag comes off, the young man calls to you, 'Thanks for the... help[if lust of Zephias < 1]? I'm Private Julio Vasquez by the way.' [else]?' [end if]Then his gaze is drawn downward to the trickle of cum running down the inside of your leg and he turns an interesting shade of embarrassed red as his thoughts catch up with what just happened here - and why. He pants 'Thanks' again, then beats a hasty retreat and runs off.";

Zephias ends here.
