Version 1 of Broken Husky Bad-End by Luneth begins here.

[ Brokenhuskygoodgirl - good girl points                                        ]
[   purely progressive/decreasing variable                                      ]

[ Brokenhuskybadbitch - bad bitch points                                        ]
[   purely progressive/decreasing variable                                      ]

[ Brokenhuskysluttypuppy - slutty puppy points                                  ]
[   purely progressive/decreasing variable                                      ]

[ Brokenhuskyescape - variable for hidden ending                                ]
[   purely progressive variable for certain answers                             ]


[ Brokenhuskydelta - type of husky player becomes                               ]
[   0: haven't been changed yet                                                 ]
[   1: good girl/traditional husky                                              ]
[   2: bad bitch/albino-ish with same head and chest crest as alpha             ]
[   3: slutty puppy/pink and cream bimbo husky                                  ]

Brokenhuskygoodgirl is a number that varies.
Brokenhuskybadbitch is a number that varies.
Brokenhuskysluttypuppy is a number that varies.
Brokenhuskyescape is a number that varies.
Brokenhuskydelta is a number that varies.

Section 1 - Broken Husky Bad End
[This bad end will trigger if you have the Artemis disciple feat and are fully male genital wise. You must also lose to the alpha that has captured Sarah, it will not activate if you lose to the regular female huskies though since the alpha will then view you as a worthless addition to his pack. WARNING: this will also overwrite the male preferred feat.]

to say BrokenHuskySlutBadend:
	say "     Falling down on one knee before the alpha husky, your bruised and battered body quickly begins to mend itself, however that does nothing to restore your will to fight. With deep shaky breaths, you look up into the arrogant eyes of the beast that bested you, a cocky grin on his muzzle and a dark glint in his gaze. Meanwhile, the dog's captive takes advantage of the fact that you beat all of the female huskies and that the alpha seems to be focused on you at the moment, and she quickly makes her escape. Watching as she runs away, you do hear her yelling that she is sorry, but she never stops, only calling over her shoulder. Oddly enough, the alpha husky remains calm, not even sparing a glance for his escaped captive.";
	say "     'Alright, ya sluts, that bitch we came for... let's just get her back later. For now, we'll take this one instead.' Before the female huskies can act, the male gets down on your level. 'I like your attitude. It'll be fun to break ya in, little bitch.' His drawl sounds both charming and trashy at the same time. Your eyes widen in surprise. While you realize that you had managed to rescue the captive, it hadn't occurred to you that the alpha would want to take you as a replacement. A flurry of white fur fills your sight as the group of husky bitches grab and restrain you. Forced to your feet, the last thing you see is the alpha's huge fist coming towards your face before everything goes black in a burst of pain.";
	WaitLineBreak;
	say "     You slowly come back to consciousness later, at first feeling confused and unable to figure out exactly where you are. Your head is hanging upside down, with all you can see being a white, furred bubble butt with a fluffy tail, lightly swaying back and forth with each step. Slowly starting to become more aware of your surroundings, you realize that your body is completely naked and slung over the shoulder of the large alpha dog. You begin a struggle to escape, but without much success as his grip is firm and relentless. The alpha releases a deep chuckle at your antics, followed by an annoyed grunt and a few hard smacks to your ass as you try to call for help.";
	say "     'Woke up a bit too early, bitch. You're definitely a fighter, I'll give you that. I knew that I made the right choice. Unfortunately, I need you to sleep a little longer.' With that, your head is knocked against the wall he is walking past, effectively sending you off into unconsciousness once again. When you wake up next, you can still feel a remnant of the impact, leaving behind a splitting headache. For a second, you are worried that something is really off, because you can't see anything even as you open your eyes, but then you realize that your surroundings simply are pitch black and that there is nothing at all to see. Attempting to get up, you almost choke yourself on a metal collar wrapped around your throat, with you crashing back to the ground to cough and feel your throat.";
	WaitLineBreak;
	say "     After a moment to recover your wits, you feel the unyielding band of metal and find that it is attached to a chain that ends at what seems to be a cement wall. Taking a few shaky breaths in an attempt to calm yourself down, the sounds of voices from what must be the next room manage to catch your attention. 'Keep an ear out, you sluts. I'm going to go check on our newest recruit. If you see or hear anything, just shout.' A door opens suddenly, allowing a bright light to enter the room and sending you cringing back from the sudden change.";
	say "     Having been surrounded by nothing but darkness, it literally hurts to see light again, blinding you momentarily and sending tears to streak down your cheeks until your eyes can adjust. Standing in the doorway, watching you, is the same large male husky that you had encountered before, the cocky smirk on his muzzle being a dead giveaway. 'Morning, princess. I hope that you're enjoying my hospitality. Had enough beauty sleep now.' The canine strolls into the room, and with an air of indifference, he slowly makes his way over, eventually coming to kneel in front of you. 'Don't worry, girl, it's ok now. I won't let any of those bad monsters near you again. You're gonna make a real pretty husky slut, I can tell.' You can't help your body from shaking as you shout at the large canine that you aren't a [']girl[']!";
	WaitLineBreak;
	say "     Without skipping a beat, the muscled alpha backhands you across your face. 'Don't you ever, and I mean ever, talk to your master like that again! Here I am being a nice guy and welcoming some worthless little wannabe whore like you into my home, only to have my generosity thrown back in my face!' You crawl backwards as far as you can in an attempt to put some distance between yourself and the angry dog, however the collar around your neck only allows so much movement. The husky reaches out with one furred hand, wrapping it around your jaw, forcing you to look him in the eye. 'I think that I deserve an apology, don't you?' The cruel face of the canine morphs into one of tenderness, almost as if the rage he just went through never happened.";
	say "     Although it comes out with a slight stutter, you apologize to the alpha in an attempt to buy some time and hopefully keep his anger in check. 'Good girl, see I knew that you weren't bad, just needed some direction is all.' Without thinking, you mutter under your breath once again that you're not a girl. Realizing what you just said, you look at the husky, hoping that he didn't hear you, however glancing at his powerful ears, you doubt that is the case and fully expect another backhand across the face.";
	WaitLineBreak;
	say "     'Aww, look how scared the little bitch in training is. I didn't punish you earlier for what you said, I punished you for the way you talked to your master.' Before you can react, the canine reaches down, grabbing ahold of your cock and caressing your balls. 'And don't you worry, darlin. I see exactly what you have between your thighs. It might look like that you're a man, but I see the truth, that your pussy just got turned inside out, didn't it, my li'l slut? Don't you worry, we'll get it back on the inside where it belongs.'";
	say "     A surge of endorphins course through your veins, and you instantly attempt to struggle against the collar around your throat, but the alpha pays little attention to your desperate movements and simply rises to his feet. 'Truth be told, I got a bit spoiled with this new world. I mean when I first changed, it was like a party! I would go out, find some random bimbo on the street, fuck a few loads into them, and [']BAM['] instant fuck toy. Unfortunately, a mind broken slut can never really be an ally, or trusted in general to be honest. Nah, the only loyalty they know is to the next load that gets shot inside of them. That's where you come in, my newest little bitch. I realize the mistakes that I made with these other cum sluts, but with you, I'm gonna start fresh and train you up right.'";
	WaitLineBreak;
	say "     At this point, you aren't even sure if the well-built husky is even talking to you anymore, or if he is simply talking to himself. The canine finally whips around and is once again crouching next to you, with one paw petting you and the other holding your face, forcing you to look him in the eye. 'The others changed in a matter of hours. I think that was the mistake, they changed too fast, and their pathetic minds couldn't take the strain. With you, I plan on making sure we go nice and slow. Make you become just what I want of you, and when I want you to.'";
	say "     The expression on his face softens for a bit, allowing you to see through the tears in your eyes that if he wasn't completely batshit crazy, he would definitely be seen as an extremely attractive male. 'Y'know, when I was a kid I always wanted a puppy. Sucks that I had to wait so long to get a proper one.' You aren't able to hold back the sob that breaks through you as he says, 'Welcome to the family, cunt!' With that said, the large male stands up and strolls over to a simple wooden chair, turning it to sit on it backwards and lean on the backrest as he stares at you with an odd gleam in his eyes.";
	LineBreak;
	say "     << End of Day 1 >>";
	WaitLineBreak;
	say "     The next time you wake up, it is with a major headache seemingly ready to split your head in two. Opening your eyes, you are once again greeted by nothing but the darkness of the room that you're being held in. Reaching up to hold your throbbing head, you accidentally jostle the chain attached to your collar, causing a fresh rush of pain to spread throughout your throat as the already chafed skin of your neck is pulled on. Alone in the shadows, your mind goes over what feels like hours, or even a day back, when the alpha that has captured you kept you up for an exceedingly long time, ranting and raving about how he was going to be the top dog in the city.";
	say "     Most of what he said sounded as if he was planning something big, however he didn't give you any details as to what he had in mind, and the rest... well the rest sounded like some lunatic cult leader preaching. He had mentioned rising up above the other alphas, how this nanite infection was a sign that it was his time to ascend as the leader of his canine brethren. As your mind comes back to the present, you're able to hear the rumbling of movement somewhere outside of your room. You know that you can't stay here. If you do, who knows what will happen, not just to your body but also your mind. The only option is to bide your time until an opening presents itself, playing along with the psychotic husky's game.";
	WaitLineBreak;
	say "     You feel rage beginning to build up at the thought, but it can't be helped. You will do what is necessary to survive, even if it means debasing yourself in some way. On the flip side however, he may assume you have plans if you don't even attempt to fight back. Also, he seems to appreciate your resistance as something he can 'work on', so who knows what he would do if you didn't meet his expectation. At the end of the day, it is going to come down to how you decide to handle this situation. On one hand, you could attempt to appease him while waiting for your chance to escape, or you could rebel against his desires in the hope that he will tire of you and release you, however there is a third option as well... you could attempt to seduce him to try and win his favor.";
	say "     With your thoughts racing in an attempt to both calculate how to get out of here and how to cope with what you will have to go through, you don't realize at first that someone has entered your room. It must be night outside of your prison right now, as there wasn't any light to betray the opening of the door. 'How ya feelin['] this mornin['], pretty girl?' You can't control the look of hatred you shoot in the direction of the voice, due to the fact it's pitch black in the room you assume he will not notice. 'Haha, darlin', you do realize I can see just fine in the dark, dont'cha?' Closing your eyes, you attempt to calm yourself, slowly counting to ten in your head. 'Aww, don't hide them pretty eyes away. They're part of the reason that I chose you.' Leaning down, the husky grabs your face in his paws and demands that you open your eyes for him. Reluctantly, you do as he asks. 'See, right beautiful they are. You wanna know what I see in you? Look into my eyes for a second!' He must be right in front of you now, as you can feel his breath on your face.";
	LineBreak;
	say "     [bold type]What's your gut reaction to this?[roman type][line break]";
	say "     [link](1)[as]1[end link] - Be a good girl.";
	say "     [link](2)[as]2[end link] - Be a bad bitch.";
	say "     [link](3)[as]3[end link] - Be a slutty puppy.";
	now calcnumber is 0;
	while calcnumber < 1 or calcnumber > 3:
		say "Choice? (1-3)>[run paragraph on]";
		get a number;
		if calcnumber is 1 or calcnumber is 2 or calcnumber is 3:
			break;
		else:
			say "Invalid choice. Type [link]1[end link] good, [link]2[end link] bad or [link]3[end link] slut.";
	if calcnumber is 1:
		LineBreak;
		say "     You can't bring yourself to answer him. You know that you should if you want to attempt to make your plan work, but you can't help but loathe the maniac touching you. Giving in and looking at where you hope his eyes are, you know that you're not able to hide the hatred you're feeling, but hopefully the fact that you're doing as he asked will garner you some leniency. One of his furred digits lightly caresses the side of your face, the touch while firm is still gentle. For a moment, you almost allow yourself to be comforted by this simple act of affection, but you know that you have to keep your eye on the prize and push those feelings down. Embracing the idea that he is attempting to trick you, you can't fight the look of betrayal you send his way.";
		increase Brokenhuskygoodgirl by 2;
		decrease Brokenhuskybadbitch by 1;
		decrease Brokenhuskysluttypuppy by 1;
	else if calcnumber is 2:
		LineBreak;
		say "     Knowing that you may not get another chance, you wait and prepare for your opening, feeling the husky taking a deep breath, more than likely taking in your scent, and then you ram your forehead into his muzzle! Unfortunately, while you do hit the canine, it's not enough to do very much damage. Bracing yourself for a hit in return, you are surprised when instead all the alpha does is release a booming laugh. 'Ha, ya definitely have spirit, that's for sure.' Once again, the husky leans down and takes your face in his paws, though this time with a bit more force. You can't help but glare back at what you're sure is probably his smug face.";
		decrease Brokenhuskygoodgirl by 1;
		increase Brokenhuskybadbitch by 2;
		decrease Brokenhuskysluttypuppy by 1;
		increase Brokenhuskyescape by 1;
	else:
		LineBreak;
		say "     You can't tell if it's the fact that he called your eyes beautiful, or if it's merely the fact that he is so close to you, but you can feel your face begin to heat up. The scent of the powerful male in front of you enters your body, his musk almost intoxicating. Your tongue slips from between your lips wetting them while at the same time one of your hands slowly travels up the length of your naked thigh. In the darkness, you can't see the male before you, but you can hear him take in a deep breath. You're not sure if it's because of the effect he is having on you at the moment, or if he is simply taking in your scent, but it does force a soft moan to escape your throat. 'I see that you know the proper way to appreciate your master, but we will have to save that for later, darlin'. You feel frustration build up inside of you at being denied, glaring back at what you hope is his muzzle.";
		decrease Brokenhuskygoodgirl by 1;
		decrease Brokenhuskybadbitch by 1;
		increase Brokenhuskysluttypuppy by 2;
	say "     'Right there! See, that's part of why I chose you. When I look into your gaze, I see fire, the very flames of rebellion, and with what I have planned for us, well I can't imagine a better partner in crime than someone reborn in defiance, haha.' The alpha finally releases your face and steps away from you. You can't help the anxiety welling up inside of you, knowing that he is still in the room but not being able to tell where he is or what he's doing. You hear a clicking sound and then you're blinded as bright light floods your vision. Looking around, you take in both the room and the alpha husky. While not the first time you have seen him in the light, you were far too upset before to actually analyze him. The room is simple enough, four white walls with a dark wood floor It is a bit on the small side though... almost as if this is nothing more than the walk-in closet for a much bigger room.";
	WaitLineBreak;
	say "     Taking in the alpha, you decide to look for anything that could help you in the future. While at first he appears to look just like any other alpha husky with his adonis-like build and arrogant personality to match, now that you're able to see him clean and without all of the dirt and grime from the city, you quickly notice a major difference: his patterning. It's not that it's different, it's just not there. The closest thing he has to a pattern is a black patch on his forehead and a small patch on his chest. Besides those two small black patches, everything seems to be pointing at the possibility that he may actually be an albino. 'You curious about what your master truly looks like? I guess that I shouldn't be surprised, after all, it's only proper for my pretty girl to wanna see exactly who she's gonna be worshipping.' Finally stepping fully into the light, the husky looks down at you with... one dark-red eye and another that is a warm amber color.";
	[reaction point concerning commenting on the potential of him being albino]
	LineBreak;
	say "     [bold type]What's your gut reaction to this?[roman type][line break]";
	say "     [link](1)[as]1[end link] - Be a good girl.";
	say "     [link](2)[as]2[end link] - Be a bad bitch.";
	say "     [link](3)[as]3[end link] - Be a slutty puppy.";
	now calcnumber is 0;
	while calcnumber < 1 or calcnumber > 3:
		say "Choice? (1-3)>[run paragraph on]";
		get a number;
		if calcnumber is 1 or calcnumber is 2 or calcnumber is 3:
			break;
		else:
			say "Invalid choice. Type [link]1[end link] good, [link]2[end link] bad or [link]3[end link] slut.";
	if calcnumber is 1:
		LineBreak;
		say "     You study the black patches on the husky. The one on his forehead almost looks like a great heptagram while the one on his chest could be a simple tuft, reminding you of some sort of crest. Part of you wants to ask more about whether his markings are real or if he is indeed an albino, but you can only imagine how he would react to that, seeing as most people sadly attribute albinos with sterility, and this alpha doesn't seem like the most learned of males. 'Why are you being so quiet? I know that I'm a perfect specimen of manhood, but as my woman, you should feel safe with confiding in me your thoughts... unless I already broke you.' Faster than your eyes can follow, a furred paw slams into one of the walls of your room, quickly followed by another, until he is pummeling the wall over and over.";
		increase Brokenhuskygoodgirl by 2;
		decrease Brokenhuskybadbitch by 1;
		decrease Brokenhuskysluttypuppy by 1;
		increase Brokenhuskyescape by 1;
	else if calcnumber is 2:
		LineBreak;
		say "     You study the black patches on the husky. The one on his forehead almost looks like a great heptagram while the one on his chest could be a simple tuft, reminding you of some sort of crest. Not caring how he feels, you ask him if his black marks are real or if he's an albino. Without warning, a fist slams into the wall right next to your face. 'I ain't fucking sterile, you stupid bitch! And my brands are real! They are a sign that I was chosen!' You recoil and attempt to make yourself seem as non-threatening as possible. The alpha pulls away and starts walking around the small room, mumbling under his breath. You can't fully understand what he is saying, but you can tell that it's directed at you by the looks of rage he keeps shooting your way.";
		decrease Brokenhuskygoodgirl by 1;
		increase Brokenhuskybadbitch by 2;
		decrease Brokenhuskysluttypuppy by 1;
	else:
		LineBreak;
		say "     You study the black patches on the husky. The one on his forehead almost looks like a great heptagram while the one on his chest could be a simple tuft, reminding you of some sort of crest. While you know that this is your chance to possibly gain an advantage, you can't help but stare at the little dark crest on his chest and wonder what it would feel like to rake your fingers through it. Your gaze then travels lower to his sheath and then to his full heavy looking balls. Your mouth waters slightly at the thought of seeing this powerful male in all his glory, his proud cock slowly pushing its way out of his sheath, precum leaking from its tapered head as he looks at you with desire. You are pulled from your fantasy by his words, 'God, you smell like a bitch in heat! Great, another useless mindless slut!' Faster than your eyes can follow, a furred paw slams into one of the walls of your room, quickly followed by another, until he is pummeling the wall over and over.";
		decrease Brokenhuskygoodgirl by 1;
		decrease Brokenhuskybadbitch by 1;
		increase Brokenhuskysluttypuppy by 2;
	WaitLineBreak;
	say "     You need to try and calm him down. The last thing that you want is to be chained up and be at the mercy of a pissed off canine, so you decide to ask him his name. 'Hahaha, what my name? My name is Master! You see, li'l bitch, names have power, and you will never have power over me! Why do you think that I don't care about what your name was? Because we are working on pushing you closer to rebirth! Who you were doesn't matter, only who you will be!' He stops shouting for a bit, and a thoughtful expression passes over his face. 'However, I may share my name with you once you have proven that you can be an obedient puppy for me. Y'know what that's called? Incentive, haha.' Afterwards, he promptly ignores you, instead looking around the room and making comments about how it isn't pretty enough to bring up a proper puppy slut.";
	say "     The way the husky reacts, going from being charming one second to violent the next, you wonder if it's possible that he may have some sort of split personality disorder or at least something similar. You're still shaking from his last reaction when he finally addresses you again. 'What's wrong, baby girl? You're shakin['] like a leaf, are you cold? Let me get you something to help.' With that he leaves your room, offering you a quick glimpse of the adjoining one but not enough to really go by. As soon as the door shuts, you begin pulling at the collar around your throat as well as the chain screwed into the back wall holding you in place. Even at full strength, it would be a challenge, but with how weak you are from hunger and dehydration, it's a lost cause. You finally give up for the moment, and a few seconds later the husky returns, a soft-looking pink blanket held tightly in his paws.";
	WaitLineBreak;
	say "     'Here, sugar, this should warm you up. I was gonna give it to you last night, but I got too excited and forgot.' Leaning down, he wraps your quivering form in the soft blanket, making sure to tuck you in and being as gentle as possible while doing so. 'Hmm, somethin['] don't seem right about ya, baby girl. Come on, you can tell me what's wrong.' At first, you aren't sure what to say. You don't want to piss him off and have him take the blanket he just gave you away. Just the thought of it makes you hold on to the pink fabric even tighter. 'Aww come on, darlin', ya don't need to be so shy about what you want, unless it's not that you're shy at all and that you think I'm some sorta monster that would steal your blanket from ya, haha. That's not it... is it?' His muzzle pulls back, and the husky opens it, baring his fangs and running his tongue over them, with an odd look in his eyes.";
	[reaction point concerning what you think of him]
	LineBreak;
	say "     [bold type]What's your gut reaction to this?[roman type][line break]";
	say "     [link](1)[as]1[end link] - Be a good girl.";
	say "     [link](2)[as]2[end link] - Be a bad bitch.";
	say "     [link](3)[as]3[end link] - Be a slutty puppy.";
	now calcnumber is 0;
	while calcnumber < 1 or calcnumber > 3:
		say "Choice? (1-3)>[run paragraph on]";
		get a number;
		if calcnumber is 1 or calcnumber is 2 or calcnumber is 3:
			break;
		else:
			say "Invalid choice. Type [link]1[end link] good, [link]2[end link] bad or [link]3[end link] slut.";
	if calcnumber is 1:
		LineBreak;
		say "     You quickly stammer out that he isn't a monster and that you're just really shy. 'I thought that's what it was, so why don't you tell me what you want, but remember, only good girls get treats.' You can't stop the chill that goes down your spine at the alpha's words. Looking directly in his eyes, you attempt to be a cutesy as possible. 'Master, I'm hungry and thirsty. Please take care of me. I promise that I will be a really good girl for you!' A huge grin spreads across his muzzle and just like that, he is up and out the door in a flash. You start to think about what had just happened and how you could use this to your advantage. After a while, your [']host['] returns, carrying a tray... with two bowls on it.";
		increase Brokenhuskygoodgirl by 2;
		decrease Brokenhuskybadbitch by 1;
		decrease Brokenhuskysluttypuppy by 1;
	else if calcnumber is 2:
		LineBreak;
		say "     Looking him dead in the eye, you tell the canine exactly what you think about him. From kidnapping you, to the collar, to the abuse, and the starvation that he seems intent forcing on you. The last words you utter to him are that yes, he is nothing but a monster. 'Well, you certainly have some strong opinions, dont'cha, bitch? But look on the bright side, if you really do think that I'm a monster, then you prolly also know that I will do [']whatever['] I have to if it means gettin['] what I want. Now you think about that long and hard while I go and get your spoiled princess ass some grub.' With that, he casually saunters out of the room. You roll your eyes at his reaction. Who knows, maybe he will be easier to manipulate than you originally thought. After a while, your [']host['] returns, carrying a tray... with two bowls on it.";
		decrease Brokenhuskygoodgirl by 1;
		increase Brokenhuskybadbitch by 2;
		decrease Brokenhuskysluttypuppy by 1;
	else:
		LineBreak;
		say "     Allowing yourself to recline back against the wall, you look directly into his heterochromia eyes and with a slight smirk you ask him if he's sure that he really wants to know what you think. 'Of course I want to know. I wouldn't have asked if I didn't!' Pushing off of the wall slightly, you move forward onto your knees. With a lusty tinge to your voice, you seductively tell him what you think of him, how you see him as a powerful and sexy alpha, his chest instantly puffing up at your praise. One of your fingers softly scrapes across your bottom lip, instantly drawing his attention. Glancing down at his sheath, you also inform him about how hungry you are, playing up to the fact that a strong master should have no problem providing for those under his care. With a last longing look at your body, he saunters out of the room, and you release a shuddering breath of relief that your plan actually worked. After a while, your [']host['] returns, carrying a tray... with two bowls on it.";
		decrease Brokenhuskygoodgirl by 1;
		decrease Brokenhuskybadbitch by 1;
		increase Brokenhuskysluttypuppy by 2;
		increase Brokenhuskyescape by 1;
	say "     He places them both on the floor in front of you. Glancing inside, you are met with pools of a white liquid, and you can only assume by the smell that it's his cum. Your heart drops at the prospect of this being your only source of nutrition. 'Oh don't look so glum, darlin'. That's just the gravy to help you become a sexy bitch like I know you wanna be, here's the rest.' With that, he pours some sort of kibble into the cum-filled bowl and the other with water. You watch as the kibble soaks up the cum and becomes slightly soggy looking. Just looking at the sight makes you feel nauseous. Looking at the facts though, you haven't eaten, and who knows when your next chance will be. You have to try and keep your strength up if you want any chance at escaping.";
	WaitLineBreak;
	say "     You are about to lean forward and attempt to eat the only food on hand without getting ill, that is until the canine pulls the bowls back a bit out of your reach. 'Come on, babe, here I am bein['] a good guy, taking care of his woman, and you can't even say thank you first? That's awfully rude, y'know.' You gape like a fish for a moment, both for you being referred to as [']his woman['], and also at the fact that he kidnapped you and is now claiming to be taking care of you! Closing your eyes for a moment, you think of the best way to handle this situation.";
	LineBreak;
	say "     [bold type]What's your gut reaction to this?[roman type][line break]";
	say "     [link](1)[as]1[end link] - Be a good girl.";
	say "     [link](2)[as]2[end link] - Be a bad bitch.";
	say "     [link](3)[as]3[end link] - Be a slutty puppy.";
	now calcnumber is 0;
	while calcnumber < 1 or calcnumber > 3:
		say "Choice? (1-3)>[run paragraph on]";
		get a number;
		if calcnumber is 1 or calcnumber is 2 or calcnumber is 3:
			break;
		else:
			say "Invalid choice. Type [link]1[end link] good, [link]2[end link] bad or [link]3[end link] slut.";
	if calcnumber is 1:
		LineBreak;
		say "     Forcing yourself to swallow your pride, you once again go into cutesy mode and tell him [']thank you, daddy['], hoping that it will at least make him happy enough that he pushes the bowls back within reach. Once again, a dopey smile spreads across his muzzle, but he doesn't push the bowls closer to you. 'See, I knew that you were gonna be the best bitch in the house. The other dumb sluts I keep around here kept tryin['] to make it seem like I was spoilin['] ya, but I knew that they were just a bunch of jealous cunts, ain't that right, baby?' You nod back at him somewhat on autopilot, your eyes glued to the food that is so close but just out of your grasp. 'So, princess, let's go over the rules one more time, ok?' You finally look away from the food to meet his different colored gaze, and almost on autopilot, you mutter that [']good girls get treats[']. 'And what else?'";
		say "     Your stomach decides to choose that exact moment to call out in hunger before you can say a word. Quickly, a fist slams into the floor close to you, almost hitting your body in the process. 'Do you think that I can't tell that you're fucking hungry!? What, think I'm stupid or something? Jeez, here I am praising you for being such a good girl, and all you can do is think of yourself, you ungrateful bitch! I ask for so little and want to give you everything, you would think it would be enough to at least get a li'l bit of respect in return! Is that too much to ask for!?' Even though you've been trying your best to appease the demented canine, it seems that your plan has blown up in your face.";
		increase Brokenhuskygoodgirl by 2;
		decrease Brokenhuskybadbitch by 1;
		decrease Brokenhuskysluttypuppy by 1;
		increase Brokenhuskyescape by 1;
	else if calcnumber is 2:
		LineBreak;
		say "     Steeling your nerves, you tell him with venom in your voice that what's really rude is the fact that he expects you to thank him for forcing you to eat his second-rate cum. Rather than the violence you have come to expect from him, he simply lets out a slightly manic laugh. 'You either got a lot of pride or very li'l brains. I mean, you do realize that you're my property, right? I [']don't['] have ta feed ya. I could always mark ya as a lost cause and just go get a replacement.' Before he can continue, you quickly cut him off, telling him to just do it then, that anything would be better than having to be around him. 'I guess those dumb sluts were right. They told me that I was spoilin['] ya to much. Here I was thinkin that you could be the best bitch in the house, and lo and behold, you proved me wrong! I am the man of this household, and I will not tolerate some fucking cunt making me look bad, do you hear me!?'";
		say "     Your stomach decides to choose that exact moment to call out in hunger before you can say a word. Before you can even react, one of his large paws backhands you to the floor. 'Do you think that I can't tell you're fucking hungry? What, think I'm stupid or something? Jeez, here I am trying to take care of you, and all you can do is spit on my hospitality! You are nothing but a selfish, ungrateful bitch! All I ask is for you to worship me, as I am meant to be, but apparently that's too much for you, I reckon. I could just leave you to waste away in this room ya'know, just shut the door and lock it forever! So from now on, I expect you to show me some respect. Is that clear, li'l lady?' You don't doubt that he would do exactly what he had just threatened, so you quickly nod your head in agreement. Unfortunately you still have to deal with a very pissed off alpha now.";
		decrease Brokenhuskygoodgirl by 1;
		increase Brokenhuskybadbitch by 2;
		decrease Brokenhuskysluttypuppy by 1;
	else:
		LineBreak;
		say "     Rubbing your hands along the inside of your thighs, you tell him that you would much prefer your treats from the source, all the while your eyes are locked onto his furry sheath. A sultry smile forms on his muzzle at your implications, along with a deep baritone chuckle showing that he obviously enjoys the idea of what's on offer. 'Really now? Well, normally I would definitely give a naughty li'l slut like you a treat, but there is a time and place for that, and right now, I want you to [']tell['] me just how grateful you are.' Wanting to see just how far you can push the alpha, you stay silent with a suggestive smirk on your lips. 'Haha, you are a cocky one, ain't ya? Well how about this, either you give me a proper thank you, or the only treat that you're gonna get is being tied to a post outside and at the mercy of every horny creature out there.' Through every word spoken, the canine retains a happy smile on his muzzle.";
		say "     Your stomach decides to choose that exact moment to call out in hunger before you can say a word. Quickly, one of his huge paws reaches out, grabbing one of your flat pecs in a firm grip. 'Do you think that I can't tell that you're fucking hungry!? What, think I'm stupid or something? Jeez, here I am trying to teach you the proper way to act, and all ya can do is think with your cunt!' One of his sharp claws scrapes across your nipple, forcing out a hiss of both pain and pleasure from your mouth. 'See that's what I'm talkin['] about! All you had to do is say [']thank you, master['], like a good li'l bitch, but no, instead you think that it would be fun to try and play games while I'm tryin['] to train you!' Wrenching his paw away from your chest, you can't help but tremble in the face of his overwhelming rage.";
		decrease Brokenhuskygoodgirl by 1;
		decrease Brokenhuskybadbitch by 1;
		increase Brokenhuskysluttypuppy by 2;
	say "     You watch in silence as the husky pulls away from you and begins to pace around the small room, the bowls of food and water now overturned by his fast movements. 'So you think that this is a fucking game then, do ya?! Maybe I have just been going too easy on ya, is that what it is? Maybe I should show you what it would be like to no longer be my special girl! Is that what you fucking want?!' You can't help but shrink away from his shouting and cursing. Thankfully, the canine doesn't make any move to get closer to you, and he eventually calms down. While his form is still visibly shaking in anger, his voice comes out calm but hollow. 'What is the golden rule, bitch?' It takes you a moment to find your voice. In what could be described as barely a whisper, you softly tell him, '[']good girls get treats['].' He then asks, 'And what happens to bad girls?'";
	say "     You can't stop the sob that erupts from within you. 'That's right, bad girls get punished. Now don't get me wrong, darlin', I don't want to punish you, but you need to learn how to be a good girl, right?' A soft expression passes over his muzzle, but only for a moment before a cold look overtakes his eyes. 'We only have a li'l over a week before the summit, and if you can't do what's expected, then we're both screwed. So we gotta up the ante. You [']need['] to be better.' You aren't sure what he means exactly by [']what's expected of you['], but you have a feeling that it's nothing good. 'I think that you need some time to think about your future, and frankly, I got more important things that I could be doin['] rather than coddlin['] an ungrateful whore that doesn't realize just how good she has it.'";
	WaitLineBreak;
	say "     You feel the first bit of hope since you arrived in this hellhole begin to lift your spirits. Maybe he is finally tired of you and will let you go. Almost as if reading your mind, the alpha husky's muzzle tilts up on one side in a smirk. 'You ain't goin nowhere, baby doll. I just won't be seein['] ya for a few days is all. I will make sure that you get fed, no worries, but I also don't want you to get too lonely without my handsome mug, so I have a plan for that as well.' Your heart drops as he turns to leave. In all honesty, it did seem way too easy, but that doesn't mean it didn't still feel like a kick in the stomach. After a minute or two, the canine comes back with something hidden behind his back. You don't even want to think about what this sociopath has in mind to keep you company.";
	say "     With a huge grin on his muzzle, the powerful male pulls from behind himself a standing mirror. Your mouth drops open, taking in your appearance. You are both dirty and malnourished, and it shows. 'See? Now ya won't be alone! Anytime you feel lonely, all ya gotta do is talk to this pretty li'l whore right in front of ya, haha.' With a shaky breath, you comment on the fact that [']she['] isn't real. The snow-colored alpha comes close to you, taking in your scent, all the while rubbing your face gently. 'Aww come on, princess, I mean who even knows what's real anymore?' Getting back up onto his feet, the canine gives you a final wink before leaving the room and closing the door.";
	WaitLineBreak;
	say "     Closing your eyes, you wrap the soft pink blanket tighter around your naked body. So far, you have learned more about the husky that has captured you, but unfortunately nothing that you could use to escape. Not realizing just how tired you were, sleep claims you rather quickly. Your dreams are filled with a mix of fast images, all of which include dogs fucking each other and even dogs with human partners, until finally the dream starts to slow down and settle on a single scenario. You see yourself laying on your back in the room that you are being kept in, your legs spread and tied back fully exposing your... pussy, instead of the cock you know that should be there. Finally, the door opens, and your captor enters, the look in his heterochromatic eyes filled with hunger.";
	say "     The alpha doesn't speak a word, instead he merely inspects your nude body, paying special attention to your spread open labia. His scarlet canine cock is already rising from within his sheath. The dream version of you struggles against their bonds, all the while screaming, begging him to go away and to please not do this. Either the husky is too far gone to make out what you're saying, or he simply doesn't care. His only response to your pleas is to slowly begin to stroke his dick. Without warning, he jumps onto the dream you, and as you watch everything play out, you can't help but wonder where the real difference is between the you viewing these events and the you that is being attacked. Placing the tapered head of his cock at your opening, he finally speaks, 'Ya'know what they call a knotted cock, slut?' With that, he slams balls deep inside of your tight pussy. 'A bitch breaker, haha!'";
	WaitLineBreak;
	say "     You wake up trembling, pulling your soft blanket tighter around you in an attempt to shake off the dream. At first, it seems that you can still hear your screams from the dream world, that is until you realize that what you're hearing is happening in the real world. 'Please stop, you're hurting me!' Almost immediately, you hear what sounds like something being slammed hard into a wall. 'Don't lie to me, you fuckin['] whore. With that loose ass cunt of yours, I bet ya couldn't even feel anything! Now go get your fuckin['] sister. At least she's not a blown out slut that constantly whines!' A tear falls from your eye at the thought that if this is how he treats his own people, what chance do you have against his wrath.";
	say "     The next time your door opens, you are shocked to see a female husky enter your room, carrying a tray with two bowls on it. 'The master is busy with his preparations, so I was told to feed you.' She makes no move to place the food on the ground though. Feeling more and more unsettled, you decide to ask her what her name is. 'Not that it's any of your business, but I'm Number Four.' Inspecting her closer, you can make out what looks like dried blood on her fur and decide to ask if he hurt her. The husky's eyes change almost instantly like a light switch went off behind them. She turns around and slowly closes the door. Spinning around, she walks up to with purpose behind every step and abruptly pours both of the bowls that were on the tray over you. You can't hide the shocked expression on your face at her actions.";
	WaitLineBreak;
	say "     When she finally speaks, it is eerily calm and composed. 'Did he hurt me? I belong to the master. He can do whatever he wants with his property.' You are surprised when she pulls back and punches you directly in the mouth, a twisted smile forming on her muzzle. 'You think that you will fare any better? Once the master realizes what a waste of time you are, he will throw you out to be claimed by the monsters of this city!' With that, she storms out of the room, slamming the door behind her. You are left sitting on the ground with a busted lip and covered in both food and cum. Looking at yourself in the mirror, you can't help but recoil at the sight you make. If you thought that you looked dirty before then, you are utterly filthy now. Thankfully, your pink blanket was saved from the bulk of the mess and only has a few wet spots from the water.";
	say "     Over the course of what feels like days, the cycle is repeated. Number Four comes in, bringing you food and water, only to dump it on your body and then strike at you in her rage. At random intervals, you also hear the sounds of rough sex on the other side of the door. Rubbing your fuzzy blanket gently helps to relax and center you. Each time you hear sounds on the other side of the door though, you can't help but feel jealous, of who exactly, you're not sure. It could be the control that the alpha has, or it could be the female huskies that are being used. Hell, it might simply be the freedom that they have of not being trapped inside of this room. You try to focus on your plan, but you can't help but wonder if you're losing your mind, wondering if this will be the last place that you'll ever be.";
	WaitLineBreak;
	say "     Once again, the disturbed female husky enters your room. This time however something seems different. The deranged canine keeps mumbling to herself and alternating from glaring around the room to checking the door. Eventually, she begins to speak clearly, but it doesn't really seem like she is actually talking to you, more like at you. 'Stupid piece of shit! Thinking you're so special, just because the master gave you a gift!' Following her gaze, you see that she is glaring daggers at your pink blanket, the only comfort and warmth that you have had since entering this hell. Slowly, you move your body in front of it, attempting to do your best to protect it from the crazed bitch. This seems to infuriate her even further, and she lunges forward, slamming your body against the wall.";
	say "     Once your back hits the wall, you instantly feel the wind being knocked out of you. Looking up at the twisted [']Number Four['], you attempt to get your breathing under control, but it's more than enough for her to accomplish what she wants. Grabbing hold of the pink blanket that the alpha had presented to you, she viciously tears the fabric right down the middle and throws the two pieces to the ground. Walking with purpose, she goes over to where the tray and bowls had fallen after she attacked you and leans down, picking up the two messy containers. With a smile on her muzzle, she dumps what is left onto the remains of your blanket. You look on powerless at what was the only thing you had in this hellhole, now covered in water, kibble, and cum.";
	WaitLineBreak;
	say "     A swift kick in your gut has you doubling over and causing your eyes to water. 'You see! You're nothing! The master thinks that you're something special, but I know better. You're just trying to trick the master. Once he sees you for what you truly are, trust me, I will be there, and I will enjoy every second of the hell he inflicts on you!' With that, she begins to cackle like some crazed witch while making her way to the door, however right before she opens it, she turns her muzzle back towards you. 'Sweet dreams, naughty boy.' The door slams behind her, and you can't fight back the tears any further. Picking up what remains of the soft blanket, you attempt to clean off the disgusting mixture that has now begun to dry and flake off.";
	say "     Eventually, the door creeps open again, and you huddle against the wall, wondering what the sadistic female husky could want now. 'Hey, darlin, I could hear how sad ya must be without me, so I thought that I would...' The alpha husky looks at you for a moment with a dumbfounded expression on his muzzle. It doesn't last long before his heterochromia eyes harden, and he bares his fangs at you. 'What the fuck did you do!? Is this some way of trying to get back at me, by makin['] yourself look like some filthy gutter whore!? I hope that you're ready for your punishment, slut, and be warned, ya won't like it!' Your body can't stop shaking as the canine takes a step closer to you, but he stops and makes no move to proceed. Looking up at his face, you can see that his eyes have zeroed in on the dirty torn up blanket that is being cradled against your chest.";
	WaitLineBreak;
	say "     The alpha's expression goes completely blank, followed by his demeanor softening all of a sudden. Even his voice is slightly different as he says, 'Just answer me one question, did ya do this to yourself?' His voice lacking any sort of emotion, you quickly shake your head in the negative, and just like that, he is out the door, slamming it shut. For a while, all that you can hear is deathly silence, that is until you hear glass breaking from somewhere beyond your door, followed by what sounds like something being thrown against the walls. 'Ya fuckin['] worthless cunt! I told ya what to do, Number Four! What the hell did I say!?' You can't make out the response - well, other than the screams, that is.";
	say "     'That bitch in there is mine, which means that she is my fuckin['] property, and ya just decided to do what? To defy me? To try and prove that you're above her in the pecking order? Well guess what, slut, I don't need ya anymore, and if I don't need ya, well then, I think ya know what that means, dont'cha?' Finally, one of Number Four's screams is clear enough for you to make out what she is saying. 'That [']thing['] isn't a girl! It's a guy, a worthless male that will never be of any use to you! But you can use me. Please, master, I'm a real woman, and all that I want is to make you happy!' Everything goes quiet for a minute before the alpha's booming voice can be heard, 'Tryin['] to show off that gaping pussy ya got there for master? Well now I got some fun ideas on how to use it, haha!'";
	WaitLineBreak;
	say "     Your blood runs cold at the thought that the psycho alpha and the sadistic female beta might have found some common ground. What if she convinces him to take out all of that aggression on you instead of her? For awhile, the only sound you can make out is your own heartbeat ringing in your ears, but eventually, your door slowly opens. Bracing yourself for whatever is to come, you place your back against the wall and close your eyes. 'Y'all right there, baby girl?' You open your eyes at the soft voice of the alpha, who has a scarily friendly smile on his muzzle, showing just the barest hint of his fangs. 'I know that ya heard that argument, but I don't want ya to worry that pretty li'l head about it, alright?'";
	say "     You quickly nod your head as he casually makes his way over to you and leans down. 'How about we get ya all cleaned up, huh? It can't feel very good to be covered in all of that shit, can it? But first, let's get ya free from the wall, huh?' As the alpha husky reaches around your neck to unlock your collar, you notice a small device in one of his paws, and almost as if reading your mind, he comments on it. 'This gadget is tied into that collar, meanin['] I push this here li'l button and zap, it'll take anythin['] down. Apparently some rich guy thought that it would be fun to keep some exotic pets and used this as a failsafe. Didn't help him much, but I have tested it out on a few things around here, and it works wonders for me.' You aren't sure if that was meant to be a threat, or if it was simply him explaining what the device is capable of.";
	WaitLineBreak;
	say "     'Not that I don't trust ya to be a good girl, darlin['], but seein['] as you're not officially a member of the pack yet, I'm gonna need ya down on all fours as we make our way to the bathroom. Last thing I need to deal with is any of those other dumb sluts gettin['] uppity, haha.' Feeling excitement welling up in your chest at the prospect of finally getting out of this room, you quickly lower yourself down on your hands and knees without hesitation. As the door to your room is opened, you have to suppress the urge to run, your mind filling with images of you being electrocuted and the punishment that follows keeping you in check. Crawling on the floor behind the alpha, you get your first taste of what the rest of the house looks like.";
	say "     The bedroom itself is simple enough, a dresser against one wall next to the door and a four poster king sized bed against the other, with a little table with a lamp sitting next to it. You only have a moment to glance around before being rushed into the hallway, which for the most part is dark, except for one room further down the hall that is lit up. However the alpha goes in the opposite direction. You are led into a dark room, however the husky flicks a switch, and the area is illuminated to reveal a decently sized bathroom, complete with a sink, toilet, and bathtub. Walking over to the tub, he turns the knobs, allowing it to fill up, then while waiting, he goes over and closes the door, effectively locking the two of you within.";
	WaitLineBreak;
	say "     The only sound that can be heard for a while is the rush of water. Deciding to try and learn more about the place that you are being kept in, you ask the large canine about the electricity and running water. 'Heh, I've always been prepared. My pops always made sure that I understood the end was coming and just how to be prepared for it. He used to say that if you got fuel, generators, food, water, and plenty of chicks to knock up, then you would be all set, haha. My pops was a smart man that's for sure, dont'cha think?!'";
	[Good option for a choice point that will effect the whole of the bath scene, the one in place would be the good girl option.]
	say "     Opening your mouth, you agree that [']pops['] must have been a smart man to see that all of this would happen, especially since he also seemed to have raised his son to be ready as well. Thinking on it though, you start to wonder exactly what kind of upbringing this guy must have had, especially with a dad that raised him to be prepared for [']the end[']. Your answer though seems to make the husky happy, if his wagging tail and the huge grin on his muzzle is anything to go by. 'Well I know that he thinks pretty highly of ya too.' You instantly become frozen in place, the idea that another sadistic male husky creeping around this house sending a chill down your spine.";
	WaitLineBreak;
	say "     You are brought back to reality by the sound of the water being turned off. The large canine gently taps the side of the tub, letting you know that he wants you to get in now. It's hard to climb into the basin while on all fours, but you finally manage to get in, your hands and feet submerged while your head and backside remain above the surface. He starts to rub a washcloth down your back, making sure to get all of the caked-on food, but where you would have expected him to grate your skin, he instead is very gentle. The whole time that you are being cleaned, a soft hum escapes his throat, sounding almost like a lullaby. Deciding that this might be the perfect opportunity to gain more information, you ask the alpha about his father, mainly where he is and if you will meet him soon.";
	say "     This causes an almost boyish giggle to erupt from the canine, almost causing you to slip in the water from shock. 'He's around, ya know just doin['] his own thing, but now I gotta admit that I'm a li'l worried about what that girl musta put you through, I mean if you really don't remember him that is. That does remind me though that I never really properly introduced myself, did I? The name's Keith, if ya wanna know that is, haha.' Silence fills the air around the two of you as he continues bathing your body. You attempt to remember ever meeting another male, then a thought enters your mind that makes your stomach roll: what if he was entering the room while you slept, while you were the most vulnerable? Another thought enters your mind as well: why is the husky now telling you his name when he was so against it before? At the moment, you don't even want to think of those implications though and instead decide to comment on something else the buff male mentioned, namely Number Four and what exactly happened to her.";
	WaitLineBreak;
	say "     At the mention of her [']name,['] Keith pauses in his ministrations, and you almost feel the paw gently holding your hip shake a little bit. 'Well, after pops found out what she had done, he decided that she needed to be punished for defying him. I mean don't get me wrong, my pops is a great man, but he is really strict when it comes to... breakin['] the rules.' You can't quite explain it, but the way those last words are uttered, you can't help but want to comfort the male, that is until you remember what exactly he's put you through. 'There ya go, all squeaky clean. Now ya just hold on a sec, and I will grab a towel. Wouldn't do ta have ya gettin['] a chill now, would it!' The happy tone is nothing new to you, but something seems off. Rather than making him seem crazy, it's almost like the atrocities of the past few days never happened.";
	say "     You are startled when the husky returns, and without warning, lifts your entire body out of the water, although you can't decide if you are more shocked by the action itself or at how softly he caresses and cradles you against his form. While the towel may not be the softest in the world, it is still somewhat nice to have someone take care of you, especially after the last few days that you have been through. 'Pops wanted to see ya after I was finished cleaning ya all up, pretty girl. Why don't ya go and head out to the sittin['] room while I clean up in here? It's that brightly lit room at the end of the hall. I'm sure that he won't make ya wait long. Just as a warning, ya might wanna stay on all fours, otherwise... well things might go south.'";
	WaitLineBreak;
	say "     Looking over your shoulder at the alpha, he quickly gets down on all fours and begins to clean up the spilled water all over the floor with the towel he used on you. On shaky limbs, you begin to make your way towards the door, only to have the husky get up quickly and rush over to the door, opening it for you with a lopsided grin on his muzzle. 'Ladies first, and I look forward ta seein['] ya soon, darlin[']!' Despite yourself, you can't help but feel a smile form on your own face at this new chivalrous aspect of your canine captor. Once you are out in the dark hall though, you can't help the thundering of your heart inside of your chest at the idea of meeting a man that has apparently met you but you have not.";
	say "     You make it only a few paces before you hear a whisper behind you in the darkness, 'Oh, and just warnin['] ya, pops has one of these doodads as well, so please be good. I'd hate ta see ya get hurt, pretty girl.' Something seems wrong, to be honest all of this is wrong, but something seems really off about this situation. Hopefully when you meet [']pops['] at the very least some of this will start to make sense. Upon entering the sitting room, you are surprised to see some of the other female betas lounging around, however once they notice your presence, they quickly begin to stare daggers at you. Attempting to take the male husky's advice, you lower your body as close to the ground as possible. Thankfully, this seems to ease the agitated bitches in the room.";
	WaitLineBreak;
	say "     While you wait, you notice that you can see the outside world through the windows, meaning that the door in front of you could lead to freedom, well if it weren't for this damn collar around your neck. After a few minutes, you notice the betas beginning to become anxious, lowering themselves out of the chairs that they were occupying and laying on the ground just as you are. 'Always nice ta have sluts around that know their place,' a voice behind you booms, followed by a furry paw that slaps your ass hard. 'Alright, princess, enough lazing about! I'm not my piece of shit son that goes soft on a bitch, so up with ya and heel! I got a real special treat for ya. Let's head on outside for a gander, shall we?' His voice is quite familiar to Keith's, which further adds to the uncomfortableness of the situation. The male moves ahead to unlock the door, revealing a color pattern you have seen before.";
	say "     After opening the door, he turns to face you, and a gasp escapes your mouth. He... looks virtually identical to the other alpha, down to the black splotches on his fur. You have seen some very similar looking creatures among the infected, but this is pretty eerie, with them being almost clones of one another. 'Well? Are ya comin['] or what, bitch? Don't make me come and get ya. Trust me, ya won't like that!' You hurriedly scramble over to the male, remembering the warning from earlier. As you slip through the gap between the canine and the door, you can't help but take a deep lungful of the fresh air, your eyes closing as you savor it. 'Master! Master, I knew that you would come back for me!' The shrieking feminine voice causes your eyes to shoot open in bewilderment. The voice almost sounds like Number Four, but different almost garbled.";
	WaitLineBreak;
	say "     Looking out across the street, you see Number Four, or at least you're pretty sure it's her. The female is strung up to an electric pole, her paws tied up above her head, while her legs are spread wide by cables around the back of the pole. You have no idea how long she had been there, but it appears that wandering creatures have seen her as an easy mark, at least going by the new infections that have begun to shape her body. Two large green parrot-like wings have emerged from her back, and one of her legs have changed from the dainty paw you have come to expect to some sort of hoof. Beneath her hangs a tufted tail that normally be found on a lion, but your eyes are drawn even lower though, where broken eggshells are littering the ground. You can't be sure what knocked her up with eggs, but you would assume that it's the same thing that gave her those wings.";
	say "     'Look at that disgusting animal, not even a proper husky anymore. Now it's nothing more than a cumdump for lower lifeforms. See, my li'l slut, that's how you can tell that it's an animal and not a person anymore. Only an animal would be dumb enough to not realize when it's been thrown away.' If you didn't already hate this guy, you sure do now. The complete disregard he is showing for someone that up until a little while ago was under his protection is infuriating! Then again, you can't help that a small part voice in the back of your mind is thrilled by the fact that she is being punished for what she put you through. A booming laugh erupts from the husky beside you, causing you to jump and look up at his face, only to see that he is no longer watching Number Four. Instead, he is looking to the sky, or more appropriately, the large beast that is descending.";
	WaitLineBreak;
	say "     The ground shakes slightly as the large wyvern comes crashing down in front of the once beta husky. Seeing as it's an apex predator of the city, the dragon-like creature shows little fear in its approach toward the trussed up female. Unsurprising, she begins to scream as the monster begins to get closer to her, 'Master! Please help me! I promise that I will be good for you!' The alpha only laughs at her pleas, instead deciding to encourage whatever the wyvern has planned. 'There ya go, fella. That's a good boy taking care of the trash, haha!' Only after he mentions that the beast is male do you look lower and see its colossal ridged cock easing its way out of the genital slit.";
	say "     The wyvern stretches its long, serpentine neck out, bringing it face to face with Number Four, and you can't help but feel fear for her at what could possibly happen. Lowering its snout, the dragon's lengthy forked tongue emerges from within its maw and begins to caress the female's bare breasts, circling around the areola of her nipple. The now mismatched husky begins to struggle even more in an attempt to get as far away from the invasive lizard as she can. Annoyed, the reptile rears back, blasting the squirming bitch with an ear-splitting roar, shocking the girl into both silence and stillness. The great beast then begins to leans against up the electric pole using its clawed wings, and unfortunately for Number Four, this also places the wyvern's ungodly cock directly at her opening.";
	WaitLineBreak;
	say "     While her pussy could be described as gaping, by comparison, the lizard's shaft dwarfs it in size, almost guaranteeing that it couldn't possibly fit, however the winged reptile apparently did not receive that memo. It begins to hump at the once husky's labia, but with its enormous size, the ridged cock keeps missing the mark, eventually leading the beast to essentially use the woman as a full body flesh-light, causing a pleased hiss to escape its throat. 'That the best ya can do?! A big guy like ya gonna let yourself be beaten by some li'l piece a pussy. Guess you're not a [']real['] man, huh?!' This causes the beast to glare at the alpha husky, and the lizard starts to fuck with intent, trying its best to enter the spread-open cunt before it.";
	say "     After a few unsuccessful passes, the monster eventually hits the mark, the head of its ridged cock splitting open Number Four's pussy, causing her to scream at the intrusion. The wyvern is not satisfied with only the crown of his cock entering her hot body, and instead keeps ramming into the female. Thankfully for the reptile though, the bindings around her body are keeping her locked in place, making the job that much easier. 'Come on, man, ya were so close. Wouldn't ya like to just destroy that tight li'l pussy?' You can't believe that the alpha is trying to push the wyvern to put more of its large cock into a body that obviously can't handle it.";
	WaitLineBreak;
	say "     As more and more of the serpentine cock enters her body, Number Four's screams turn into gurgles as her eyes begin to roll up into the back of her skull, and drool begins to slowly dribble from her muzzle. 'Don't worry, princess, when the world was remade, we all came back stronger... and in her case, more elastic. Paired with how fast we heal, the dumb cunt will be fine, haha.' Looking up at the husky, you can tell that he is enjoying the show, both by the grin on his muzzle as well as the scarlet cock that is standing erect from his sheath. Turning back to what is playing out before you, the wyvern by now is almost at the base of its knot, fucking the barely conscious husky as hard as he possibly can.";
	say "     The brutality of the fuck is so intense that you are hardly surprised when you realize that with each thrust, her tits are forced to swing so much that she actually starts to hit herself in the muzzle... not that she even seems to realize that though. 'Ya'know, bitch, I should start making this a regular thing, turn some random slut and then set up this nice li'l show, haha!' You can see the precum starting to leak from his tapered head and fall slowly to the porch floor. 'So, my li'l bitch in trainin['], what do ya think of the show? I mean this [']is['] the slut that made your life hell for the past few days, right? Maybe she deserves this, huh, or maybe you're just some weak pussy-bitch that wants us to [']all get along['], so which is it, whore?'";
	[Good idea for a choice point where the player can react to what Number Four is going through, the next path would be the default good girl]
	WaitLineBreak;
	say "     You glance back over at Number Four. It's hard to tell if the expression on her muzzle is one of pleasure, or the more likely one... torture. Hopefully it's neither, and she is locked away somewhere safe, even if it's only within her own mind. The male husky beside you can obviously tell which side of the fence your intentions are on, well that or something else has left an annoyed grimace on his muzzle. 'Seriously? Ya actually feel bad for that worthless piece of fuckmeat? Do I have to remind ya that the only reason she got tied up and is gettin['] her cunt blown out is cuz of you? I mean, here I am offering ya this taste of revenge, and ya just sit there acting like I committed some kinda crime!' The canine seems to be getting more and more hostile with each passing second, but you're not sure how to calm him down, so all you can do is just sit there and attempt to wait it out patiently.";
	say "     Your eyes are drawn to the husky's scarlet cock, which seems to leak more and more precum the angrier he gets, a small puddle already forming between his feet. 'Fine, ya don't like my gift, that's your problem, but ya still owe me a thank you!' The hostile male reaches down, grabbing you by your hair and pulls you up onto your knees, pressing your face flush against his leaking dick. 'Open that mouth, ya ungrateful bitch! You're gonna suck on daddy's cock till he fills your tight suckhole with more than ya deserve. Ya better do a good job too, cuz if I feel any teeth, well I'll just have ta knock [']em all out then, won't I?! You don't believe for a second that this male is bluffing and will do exactly what he threatened. Preparing yourself for what is to come, you open your mouth and hope that you don't disappoint him.";
	WaitLineBreak;
	say "     Coming face to face with the canine's thick shaft, you can already smell his musk, tinged with the aroma of saltiness. The husky is obviously not in the mood to allow you to adjust to the situation, forcing the tapered end of his dick past your lips. The taste of him assaults your tongue, a mix between the pre leaking out him and an undertone of something else, almost like burnt copper. 'Keep your eyes on me, whore! I don't care if I'm enjoying the show or not, but if I look down, those peepers of yours had better be looking up at me in worship!' You do your best to keep your gaze fixed on the alpha's face while you suck on the narrow head of his shaft. A series of low grunts, similar to a growl, begins to vibrate out of his chest, whether from your work on his head or from watching Number Four having her pussy wrecked, you're not sure.";
	say "     The clawed paw holding your head in place begins to tighten around your scalp, causing you to wince in pain. 'Damn, big guy, I doubt that pathetic li'l cocksleeve will ever be able to close its legs again, haha!' From behind you, the only sounds that can be heard in response are the hissing and growls from the wyvern and something that sounds almost like a squeak toy that you can only assume is Number Four. The husky glances down as you attempt to keep him happy, all while you're making sure that your teeth are covered by your lips at all times. Looking deep into his cruel eyes, a cold sweat begins to form on your body as you see a twisted smile form on his muzzle.";
	WaitLineBreak;
	say "     'I didn't ask for a head job, now did I, bitch?!' With those words, he uses the grip he has on your hair to pull you further down his red shaft, until your gag reflex kicks in, forcing you to choke on the cock that continues its path down your throat. His rough treatment of your mouth causes tears to form in your eyes and eventually to fall down your cheeks, which only seems to excite the canine even more. 'There ya go, slut. See, ain't that much better? I can see how thankful ya are that your master is using you. I mean, look at those tears of happiness, haha!' You can't tell if he's trying to convince you that you're happy by his actions, or if he really is insane enough to believe that this is you feeling thankful.";
	say "     You can feel your lips bumping against something every time the male makes you slide further down his dick. You dare not check it with his gaze locked onto your face, but you can assume that it's probably his knot. That thought alone is enough to fill you with fear. What if he attempts to [']tie['] himself to your mouth? Would you even be able to breathe? 'God, I wanna just ram my knot down this tight li'l face cunt of yours, but business before pleasure after all, ain't that right, princess?' You can't tell if he could see the fear on your face or if he acquired some sort of psychic abilities from his infection, but he always seems to know what's on your mind without you saying. Either way, it only adds to his already creepy personality.";
	WaitLineBreak;
	say "     Unfortunately, you don't have time to think on this potential information as his thrusts begin to come faster and harder until finally he releases an ear-splitting howl as he starts to cum. The first shot goes straight down your throat and is quickly followed by a second, however the alpha quickly pulls out and begins to paint your face with his seed. Eventually, the eruptions from his cock begins to ebb, leaving him panting and chuckling slightly. 'Damn, I wish that I coulda['] shot everything I had into ya, but the last thing I need is another fuckin['] useless slut like that one over there, haha!'";
	say "     Your whole body is twisted around to face the scene of Number Four still being screwed by the wyvern, and you can tell that the winged beast is close by how fast it is jackhammering its ridged member into her. With a roar that almost seems to cause the air around you to vibrate, it rams the knot at the base of its cock into Number Four, and the only sounds that comes out of her is a guttural moan. This leaves the lizard stuck inside the once husky who is tied to the electric pole, which the reptile is none too happy about. While beating its massive wings, the creature begins to ram the pole with its long neck until the base breaks off, and the reptile takes to the air with Number Four still locked onto the monster's shaft, along with the pole itself.";
	WaitLineBreak;
	say "     'Ya'know, I've never been one for theater and all of that sissy shit, but I gotta say, that actually wasn't too bad, haha!' The fact that he is able to laugh after what had just happened forces bile to rise in your throat. 'Alright, well hopefully ya had fun with your gift, but now it's time for bed, slut.' With that, the canine grabs you by your head and begins to drag you back into the house, you struggle against his grip, but this doesn't seem to faze him in the slightest. Once you both are back in your closet, he unceremoniously throws you against the wall, causing your head to spin. He quickly ties your collar back up to the chain coming out of the wall and without a word, he turns the overhead light off and leaves you there.";
	say "     Laying on the floor, you can't help the sob that falls from your lips, the events of the day crashing down upon you. The next thing you know, a small towel is being rubbed against your face, and you quickly jerk away, not sure who it is touching you. 'Hey, it's alright, darlin['], it's just me, Keith. I came to check in on ya and noticed ya were... dirty again, so I thought that I'd just clean ya up a bit.' His voice is barely a whisper, but it does help you calm down, knowing that at the very least it's not his father deciding to visit you. His touch is soft, almost gentle. 'Oh, I almost forgot, I got ya somethin[']!' While you can't make out his face, you can definitely hear the excitement in his voice. After a moment, a soft piece of fabric is placed into your hands. 'I saw what happened to your blanket, so I decided to clean it up and fix the sew job, only don't let my pops know. He thinks that this kinda stuff is for girls and would be pretty mad about me doin['] it.'";
	[another good choice point option for how to handle what Keith has to offer this is of course the default good girl]
	WaitLineBreak;
	say "     You can't be sure why, but the fact that the husky repaired what Number Four destroyed makes you emotional and without thinking, you grab the male, pulling him into a tight embrace. The canine freezes up at first, but slowly begins to return the hug, snuggling up to you and cradling your head. 'Wow, if I had known my crappy sewing coulda got me these kinda rewards, I woulda practiced a lot more, haha.' Your mind floods with thoughts about this husky. Seeing as he and his father look identical, could your hatred of him actually be based on the actions his [']pops['] committed? This moment of realization pushes you past logic. Feeling along his face, you slowly bring your lips to his muzzle, kissing him gently.";
	say "     The man pulls back, and you can feel his shaky breath against your skin. 'Ya don't have ta do this... I just wanted to do somethin['] nice for ya. I always thought that it was a shame when someone so pretty couldn't smile is all.' That's all the words you needed to hear, and you pull him back until he is laying on top of your body. The two of you share a few sweet kisses, but eventually, the heat becomes too much, and the two of you begin to dry hump each other. The feeling of his canine cock rubbing against your own pushes you closer and closer to the edge, but all too soon, Keith pulls back from your mouth panting, 'I should stop. I'm close, and I don't want pops to find any evidence of what we are doin[']. He would be furious if he found out.'";
	WaitLineBreak;
	say "     At that moment, you couldn't care less about what [']pops['] would like and what he wouldn't. Reaching down between your bodies, you take of the husky's throbbing shaft and place it directly at your hole, whispering to him that [']now there won't be any evidence[']. Whether it's from the alpha believing you or simply being too turned on to argue, he slowly begins to penetrate you. 'I don't wanna accidentally knot ya, pretty girl. That could end badly for the both of us.' You can't even bring yourself to correct him that you're a guy as he begins to enter you in shallow thrusts, the whole time alternating between kissing your throat and lips. Finally on one of his downward thrusts, his whole body goes rigid, and you can feel the powerful blasts of his cum shooting deep inside of you.";
	say "     Once he begins to come down from his orgasm, he softly begins to caress your body. 'Wow, that was awesome, baby. I'm gonna have ta be careful not ta fall for ya after that, haha. Don't worry though, I didn't forget about ya.' His voice has a playful air about it as he gets up and off of your body. At first, you don't know what to expect, until you feel a wet heat wrap around your cock. The feeling of his tongue swiping along your shaft as he deepthroats you has your toes curling and your back arching. The skill of his blowjob shows you that this is not his first time doing this, and while he works fast, he also makes sure to hit every spot right, pushing you closer to the edge with each second.";
	WaitLineBreak;
	say "     As you are about unload down Keith's muzzle, you feel one of his clawed digits at your mouth, pushing its way in. Sucking on his finger helps deafen the sound once you hit your peak, it however does nothing to stop the vibrating of your body. The husky finally pulls off of your shaft and chuckles a bit to himself, 'I haven't done that in awhile. Good to know I still got it though haha. Sad ta say, sweet thing, but I prolly should head out. We don't wanna get busted now, do we?' With that, Keith leans in and kisses you deeply and full of passion, almost like a promise for things to come. Upon hearing the door close behind the alpha, you once again close your eyes, this time with a spark of hope for the future.";
	[difference need to be put in place for which form is in the lead]
	if Brokenhuskygoodgirl > Brokenhuskybadbitch:
		if Brokenhuskygoodgirl > Brokenhuskysluttypuppy:
			say "     Waking up again some time later in a cold sweat, you feel sick, and your skin itches just underneath the surface. As you attempt to get up, your arm rubs against one of your nipples, drawing a shocked grunt from your throat from just how sensitive it is. Feeling your chest with both hands, you notice a noticeable swelling, almost like each pec is growing slowly, and your nipples also seem to be growing larger as well. Panicking, you quickly get onto your knees to further inspect yourself, only to have your spine go rigid, forcing you down on all fours, as something begins to grow outward from right above your ass. Reaching back, you try to find out what it is, only to discover... a tail. You are growing a long, soft furry tail. Horrified, you quickly check the front of your body too, and you could've sworn that your cock was longer than it is right now. You now know what exactly is happening to you: you're transforming as the nanites from either Keith or his father alter your form.";
			WaitLineBreak;
			say "     A burning sensation creeps along the sides of your head as your ears flow and reform, drawing further up your skull and elongating into points. The sound of your shifting and altering bones grates on your nerves, disconcerting cracks and snaps all throughout your body making you cringe and shudder. Once your face begins to elongate, you begin to drool as your mouth attempts to adjust to its new shape. In your current position, you feel what seems to be like B-cup sized breasts swaying as you move and contort. Reaching up with a quickly shifting paw, you grab hold of one of your breast in an effort to help ease the sensitivity, however one of your claws rakes across the nub, causing a panting gasp to escape your new muzzle.";
			say "     With the enhanced hearing of your ears, you can make out movement on the other side of the door. Your head quickly whips up, and you catch sight of something in the mirror in the dark room: your eyes... they are glowing! Luminescent amber orbs look back at you from your reflection, that is before the door flies open, blinding you with light. 'Well, well, what do ya know? It looks like I was right to choose ya for my plan after all, my li'l pet!'";
			now Brokenhuskydelta is 1; [traditional delta husky]
		else:
			say "     Waking up again some time later in a cold sweat, you feel sick, and your skin itches just underneath the surface. As you attempt to get up, your legs and whole body feels subtly [italic type]wrong[roman type], like it's smaller than before. This strange sensation has you struggling to find your balance, and as you wave your hands around, your arm rubs against one of your nipples, drawing a shocked grunt from your throat from just how sensitive it is. Feeling your chest with both hands, you notice a massive swelling, almost like each pec is growing slowly, and your nipples also seem to be growing larger as well. Panicking, you quickly get onto your knees to further inspect yourself, only to have your spine go rigid, forcing you down on all fours, as something begins to grow outward from right above your ass. Reaching back, you try to find out what it is, only to discover... a tail. You are growing a long, silky furry tail. Horrified, you quickly check the front of your body too, and you could've sworn that your cock was longer than it is right now. You now know what exactly is happening to you: you're transforming as the nanites from either Keith or his father alter your form.";
			WaitLineBreak;
			say "     A burning sensation creeps along the sides of your head as your ears flow and reform, drawing further up your skull and elongating into points. The sound of your shifting and altering bones grates on your nerves, disconcerting cracks and snaps all throughout your body making you cringe and shudder. Once your face begins to elongate, you begin to drool as your mouth attempts to adjust to its new shape. In the current position of your body you feel what seems to be like D-cup sized breasts swaying as you move and contort. Reaching up with a quickly shifting paw, you grab hold of one of your breast in an effort to help ease the sensitivity, however one of your claws rakes across the nub, causing a panting gasp to escape your new muzzle.";
			say "     With the enhanced hearing of your ears, you can make out movement on the other side of the door. Your head quickly whips up, and you catch sight of something in the mirror in the dark room: your eyes... they are glowing! Luminescent violet orbs look back at you from your reflection, that is before the door flies open, blinding you with light. 'Well, well, what do ya know? It looks like I was right to choose ya for my plan after all, my li'l pet!'";
			now Brokenhuskydelta is 3; [bimbo delta husky]
	else:
		if Brokenhuskybadbitch > Brokenhuskysluttypuppy:
			say "     Waking up again some time later in a cold sweat, you feel sick, and your skin itches just underneath the surface. As you attempt to get up, your legs and whole body feels subtly [italic type]wrong[roman type], like it's bigger than before. This strange sensation has you struggling to find your balance, and as you wave your hands around, the side of your arm rubs against one of your nipples, drawing a shocked grunt from your throat from just how sensitive it is. Feeling your chest with both hands, you notice a slight swelling, almost like each pec is growing slowly, and your nipples also seem to be growing larger as well. Panicking, you quickly get onto your knees to further inspect yourself, only to have your spine go rigid, forcing you down on all fours, as something begins to grow outward from right above your ass. Reaching back, you try to find out what it is, only to discover... a tail. You are growing a long, bristly furry tail. Horrified, you quickly check the front of your body too, and you could've sworn that your cock was longer than it is right now. You now know what exactly is happening to you: you're transforming as the nanites from either Keith or his father alter your form.";
			WaitLineBreak;
			say "     A burning sensation creeps along the sides of your head as your ears flow and reform, drawing further up your skull and elongating into points. The sound of your shifting and altering bones grates on your nerves, disconcerting cracks and snaps all throughout your body making you cringe and shudder. Once your face begins to elongate, you begin to drool as your mouth attempts to adjust to its new shape. In the current position of your body you feel what seems to be like A-cup sized breasts swaying as you move and contort. Reaching up with a quickly shifting paw, you grab hold of one of your breast in an effort to help ease the sensitivity, however one of your claws rakes across the nub, causing a panting gasp to escape your new muzzle.";
			say "     With the enhanced hearing of your ears you can make out movement on the other side of the door. Your head quickly whips up and you catch sight of something in the mirror in the dark room, your eyes... they are glowing! Luminescent crimson orbs look back at you from your reflection, that is before the door flies open, blinding you with light. 'Well well, what do ya know? It looks like I was right to choose ya for my plan after all, my li'l pet!'";
		else:
			say "     Waking up again some time later in a cold sweat, you feel sick, and your skin itches just underneath the surface. As you attempt to get up, your legs and whole body feels subtly [italic type]wrong[roman type], like it's smaller than before. This strange sensation has you struggling to find your balance, and as you wave your hands around, your arm rubs against one of your nipples, drawing a shocked grunt from your throat from just how sensitive it is. Feeling your chest with both hands, you notice a massive swelling, almost like each pec is growing slowly, and your nipples also seem to be growing larger as well. Panicking, you quickly get onto your knees to further inspect yourself, only to have your spine go rigid, forcing you down on all fours, as something begins to grow outward from right above your ass. Reaching back, you try to find out what it is, only to discover... a tail. You are growing a long, silky furry tail. Horrified, you quickly check the front of your body too, and you could've sworn that your cock was longer than it is right now. You now know what exactly is happening to you: you're transforming as the nanites from either Keith or his father alter your form.";
			WaitLineBreak;
			say "     A burning sensation creeps along the sides of your head as your ears flow and reform, drawing further up your skull and elongating into points. The sound of your shifting and altering bones grates on your nerves, disconcerting cracks and snaps all throughout your body making you cringe and shudder. Once your face begins to elongate, you begin to drool as your mouth attempts to adjust to its new shape. In the current position of your body you feel what seems to be like D-cup sized breasts swaying as you move and contort. Reaching up with a quickly shifting paw, you grab hold of one of your breast in an effort to help ease the sensitivity, however one of your claws rakes across the nub, causing a panting gasp to escape your new muzzle.";
			say "     With the enhanced hearing of your ears, you can make out movement on the other side of the door. Your head quickly whips up and you catch sight of something in the mirror in the dark room: your eyes... they are glowing! Luminescent violet orbs look back at you from your reflection, that is before the door flies open, blinding you with light. 'Well, well, what do ya know? It looks like I was right to choose ya for my plan after all, my li'l pet!'";
			now Brokenhuskydelta is 3; [bimbo delta husky]
	say "     <<End of Week 1>>  ";
	now bodyname of Player is "Broken Husky Slut";
	end the story saying "You'll never escape your fate!";

Section 2 - Rough Roadmap

[Week 1: Base training content. The alpha will continue breaking the player's mind and training him to be a good girl. Part of the training will also involve blowjobs and anal sex. These will begin the husky changes as well as starting breast development. Breast size growth will be set to a B cup in this week. As far as the husky transformation goes, they will become a husky hybrid, so mostly husky but not completely.]

[Week 2: Stockholm, jealousy and mind-break content. The alpha will offer the player the chance to be free, but only if they join him in attempting to catch someone else to take their place. Decent length scene involving capture and player's mindset, but after the capture the player will not be happy with how the alpha treats the new recruit, thus a fight will break out between the player and the new husky bitch. This will push the player growing their pussy, upon finally making the player orgasm during anal. The player will shoot his load while his cock will shrink dramatically, becoming a very large clit, and breast size will be pushed up to D cups.]

[Week 3: Orgy, gangbang, pregnancy and slight drug content in the form on sleepy time and contraception. The alpha summit will begin. At the summit, alphas across the city will come together to exchange their bitches for breeding. The point of this is to keep the bloodlines pure without inbreeding; however, if the player allows incest content, the alpha will give them a drug to make it so the other alphas can't knock them up. After the event, the alpha will knock you up with his own pups. Whichever choice is used, the player's breasts will increase in size to a F cup and this is where they will remain.]

[Conclusion: This will involve you becoming the alpha's #1 bitch and the player finally giving themselves over to him. This will show the pups that you had no matter the father being used by the alpha after you present them to him. The conclusion will involve Sarah coming back to try and save the player, but sadly since the player has already succumbed, the player will capture her as an offering for their master.]

[father-Travis: princess, slut, whore, bitch, cunt, pet]
[son-Keith: darlin, pretty girl, lady, sweet thing, baby]

Section 3 - Expansion Ideas

[Locations: Option of creating new location and possibly more in the future where the player can explore this exclusive area around them and the alpha's actions will be set up with a timer. This would allow the player to learn more about the content that by normal means they would not.]
[Submissive & Dominant Feat Repercussions: Either have doms and subs have more limited options or have small flavors added to their content.]
[Kinky Feat Repercussions: More than likely will effect more content later on, but like in week 1 rather than not really being interested in consuming the alpha's cum kibble a kinky player would really want to consume it.]
[Cut-off Bad End: Making it so certain choices could actually lead to an early bad end, for example starvation or having the players mind become completely shattered.]
[New Delta Breeds: No real info has been added yet, but you can at least see potential types at the bottom of section 4's delta log.]
[Added Dream: Player has a dream where Artemis condemns them for being weak and not embracing the power of a "real woman".]
[Repercussions: Add more flavor text to each scene depending on which "route" is in the lead.]

Section 4 - Delta's AKA Husky Queens

[A delta is an alpha's equal within the pack, however in a very different way. A simple way to look at the difference is to look at the stereotype between a mother and a father of a family. Most deltas are kept hidden away since the alphas that control them are also the ones that are viewed as the most powerful. A delta form infection is actually very rare to gain; however, it is believed that the easiest way to become a delta husky is how your mind handles the situation while you are being made a regular female husky.]

[Special Stats Explanation

Cum Requirements: How much cum they require either to be kept happy or for survival.
Alpha Loyalty: The loyalty they feel towards their alpha and whether they will stay loyal or simply move onto another if not kept happy.
Alpha Level of Control Over Delta: The amount of overall power the alpha has over a delta in terms on controlling them and keeping them in line.
Level of Compulsion Over Non-alpha Huskies: The amount of control a delta can exert to make other non-alpha huskies do their bidding.
]

Part 1 - Traditional AKA The Espionage Expert

[The most common of the delta husky breeds. While she may appear to be nothing more than a much more curvaceous regular female husky, she has her own tricks. Her biggest ability is to lower her own hormone level, this allows her to downgrade herself to a regular female husky to help her avoid alpha detection.]

[Average Tradition Delta

Rarity: 1 [most common of delta breeds]
ScaleValue: 3 [human sized]
Fur Color: White, gray, and black color patterning.
Eyes Color: Amber, brown, or honey.
Number of Breast Rows: 3
Breast Size: B-cup to C-cup
Nipple Size, Shape and Color: Average sized, circular, pastel pink nipples.
Lactation Type: Normal
Number of Cunts: 1
Fem-cum Type: Normal
Heat Intensity: 3 [average]
Pregnancy Gestation:3 [average]
Litter Size: 3 pups
Cum Requirements: 3 [average]
Alpha Loyalty: 3 [average]
Alpha Level of Control Over Delta: 5 [extremely high]
Level of Compulsion Over Non-alpha Huskies: 2 [low]
]

Part 2 - Amazon AKA The Wild Bloodlust

[Standing at a height of seven feet and filled with tight compact muscles the amazon delta is built to fight. By nature these deltas are incredibly dominant and it take either a powerful alpha to keep them in line or at the least a very manipulative one. The main special ability of this variant is its bloodlust, this can either be a hindrance for their alpha or used to their advantage. With the bloodlust they go insane desiring nothing more than combat, if the warning signs are showing she could be placed in an enemy location and blindly raze them, otherwise she could do the same to her own pack.]

[Average Amazon Delta

Rarity: 4 [very rare of delta breeds]
ScaleValue: 4-ish [much larger than an average human]
Fur Color: White with very little black patterning.
Eyes Color: Dark red, bright red, pink.
Number of Breast Rows: 2
Breast Size: A-cup to B-cup
Nipple Size, Shape and Color: small sized, star shaped, black nipples.
Lactation Type: Only lactates for a short while after giving birth.
Number of Cunts: 1
Fem-cum Type: low amount, usually much more *dry* than the average husky
Heat Intensity: 1 [very low]
Pregnancy Gestation:1 [slow pregnancy]
Litter Size: 1 pups
Cum Requirements: 1 [very low]
Alpha Loyalty: 1 [very low]
Alpha Level of Control Over Delta: 1 [very low]
Level of Compulsion Over Non-alpha Huskies: 1 [very low]
]

Part 3 - Bimbo AKA The Pleasure Princess

[At about four feet tall this is the smallest of the delta types. While she has the typical bimbo type body, she also has her own strengths. Her breast milk is extremely addictive and once consumed any husky will do whatever she asks for their next fix, even if they are from a rival pack. She also has two pussies by nature, while some alpha enjoy having two to play with the actual reason for them is so that she can breed as rapidly as possible, while gestating one litter she can also be knocked up with another.]

[Average Bimbo Delta

Rarity: 3 [uncommon delta breed]
ScaleValue: 2-ish [about 4 feet tall]
Fur Color: Light pink with cream accents.
Eyes Color: Bright blue, lavender, or gold.
Number of Breast Rows: 3
Breast Size: D-cup to F-cup
Nipple Size, Shape and Color: large sized, heart shaped, pastel purple nipples.
Lactation Type: High [never stops lactating, breast milk also has a hint of strawberries and cream]
Number of Cunts: 2
Fem-cum Type: thick like syrup
Heat Intensity: 5 [extremely high]
Pregnancy Gestation:5 [extremely fast]
Litter Size: 5-6 pups
Cum Requirements: 4 [high]
Alpha Loyalty: 2 [low]
Alpha Level of Control Over Delta: 3 [average]
Level of Compulsion Over Non-alpha Huskies: 1-default [very low] 5-if they have fed on her milk [extremely high]
]

Part 4 - Cuntboi AKA The Loyal General

[The cuntboi delta is an incredibly rare breed and incredibly sought after. The reason for this is because of the special abilities it possesses. Its loyalty is above any other delta and is not built around fear lust or control, but rather a real attachment to the alpha and the pack. This delta while nowhere near as aggressive as the amazon also enjoys fighting on the front line beside their alpha. Once a cuntboi delta has chosen a specific alpha to serve under the only way they can get pregnant is by that alpha or if the alpha is present, although that may have to do with his pheromones. Outside of battle these deltas also tend to break out into a motherly role with their pack, more so than the controlled deltas.]

[Average Cuntboi Delta

Rarity: 5 [rarest of delta breeds]
ScaleValue: 3 [human sized]
Fur Color: Copper, white, and black color patterning.
Eyes Color: Green, violet, or amber.
Number of Breast Rows: 1
Breast Size: flat
Nipple Size, Shape and Color: small sized, circular, pastel pink nipples.
Lactation Type: Normal [extremely heavy lactation after birth but otherwise only small amounts]
Number of Cunts: 1
Fem-cum Type: Normal
Heat Intensity: 5 [extremely high]
Pregnancy Gestation:4 [high]
Litter Size: 4-5 pups
Cum Requirements: 5 [extremely high]
Alpha Loyalty: 5 [extremely high]
Alpha Level of Control Over Delta: 2 [low]
Level of Compulsion Over Non-alpha Huskies: 4 [high]
]

Part 5 - Potential Delta Futa AKA The Latex Dominatrix

[The futa delta has a very special ability that changes with the day cycle. By day they appear no different than the traditional delta, however once night falls their body changes rapidly. Their fur changes into jet black latex and where once they had a normal pussy they now have both a pussy and a large cock. The demeanor of this delta is altered as well, while by day they are submissive, at night their dominance shoots through the roof. For this reason most alphas are very shocked upon the initial transformation, some alphas enjoy this breed as a way to be submissive on occasion, while others detest this breed for attempting to take the alphas dominance. There may be a way to keep this delta in its night form permanently but more research would be required.]

Part 6 - Potential Delta Male AKA The Muscle Bitch

[Only a couple male delta have been recorded by the alpha summit. It is believed that the formation of this delta is directly tied to the alpha, this breed is brought into being by the alpha desiring both a cock and extreme masculinity in their delta. Of all the delta breeds this one is by far the most feral and while it can walk on two legs it usually will choose to walk on all fours. They are ruled by instinct and tend to also speak in a very simple fashion avoiding large words. One of the perks of this breed is its ability to both knock others up but it also is created with the ability to be knocked up in return. While it may act like a huge muscled puppy it can also just as quickly act like a wild animal.]


Broken Husky Bad-End ends here.
