Master-of-Hell-Quest by Luneth begins here.


Book 1 - Start of Quest

[this will need the player to have "master bite" traits on both Skarnoth and Brutus]
[Nala must have been allowed to stay at the library]
[Atticus is optional, but his variable for existence is very important as well as the point in his personal story the player is in]
[This scene will also need to be around 8-10 hours later than the last Skarnoth/Brutus scene and it should trigger when the player enters the Maintenance Storeroom]
[warding genders is fine for this event but banning even one gender will make the event never appear]
[this event also needs to be heavy flagged by hellspawn, incest, non-con, feral, and mind control/hypno]

[Flags

Gender-

[No genders banned, warding is fine, but if a single gender is banned content is locked]

Content-

hellspawn
Incest
non-con
Feral
mind control/Hypno

Requirements-

Skarnoth must be on his submissive or himbo route
Skarnoth and Brutus must have the "Master's Bite" trait
Nala must be in the library, if she is removed at any point the quest ends

Place-

Maintenance Closet

Timing-

8-12 hours after previous event
]

Table of GameCharacterIDs (continued)
object	name
Brutus-MoH	"Brutus-MoH"
Skarnoth-Moh	"Skarnoth-Moh"

Brutus-MoH is a man.
Skarnoth-Moh is a man.

Section 1 - Initial Event

after going to Half-Renovated Room while (Skarnoth is booked and SkarnothMasterSlave > 1 and demon brute is listed in companionList of Player and DBCaptureQuestVar is 5 and DemonBruteStatus is 0 and "Unchained" is listed in Traits of Skarnoth and "Brother-in-Arms" is not listed in Traits of Skarnoth-Moh and "Brother-in-Arms" is not listed in Traits of Brutus-MoH and "Broken Master Bonds" is not listed in Traits of Skarnoth-Moh and "Broken Master Bonds" is not listed in Traits of Brutus-MoH):
	say "     Note: Once Skarnoth's Master/Slave chain is completed this event will only be encountered if you have sub slave/drug slave Skarnoth instead of default slave Skarnoth.";
	say "     Walking into the half-renovated room with Brutus at your side, you see the demon prince sitting upon his [']throne['], more than likely attempting to recharge so that he can leave and do whatever it is that he does when you're not around. Out of the corner of your eye, you see the demon brute stop and take in the sight of ";
	if "Nude" is listed in traits of Skarnoth:
		say "a naked Skarnoth";
	else:
		say "Skarnoth";
		say ". You try to remember if this is the first time that your pet has seen the royal demon that you've claimed, but judging by the look on his face, you assume that it is. Brutus's eyes are wide, and his fanged jaw is hanging open slightly. Without any prompt from either you or Skarnoth, Brutus immediately starts to walk over to the demon prince quickly.";
	if SkarnothDrugStatus is 2:
		say "     Getting down on one knee, the demon brute regards his prince with respect. 'Master! I didn't know this [BodyName of Player in lower case] was yours?! Or did you want to reclaim your worthless servant?' The demonic prince seems confused at first, but eventually attempts to figure out what's going on. 'Oh yeah, you're like one of my old hellguard right? So one of you guys are serving the super sexy [master] as well? Well, that's good. I mean like, if you do all the fighting, then [SubjectPro of Player] will have that much more time to ravage me hehe.' The airheaded prince's drunk like words shock Brutus and he's visibly taken aback by the fact that his prince just referred to you as [master]. 'My prince! What do you mean by ['][master][']? Aren't you gonna take me back from the mortal? Or make [ObjectPro of Player] serve you!'";
		WaitLineBreak;
		say "     Skarnoth rolls his eyes at the brute, 'Are you like dumb or something? Why would I not wanna be the property of the [master]? I mean as long as I stay a good boy, I will always be used to sate [PosAdj of Player] desires, just as a proper little muscle slut should and I wouldn't have it any other way!' Brutus stands up with a look of disdain on his face. 'You worthless whore! Unworthy of my obedience!' Turning his back on his at one point prince, Brutus regards you with even more rage in his eyes than usual, 'You made the old master into your brainless slut?! The hellguard is broken too then. No going back for me now.' For the first time, you see the closest thing to hopelessness enter the demon brute's eyes, all while the demon's erection keeps growing in size.";
	else:
		say "     Getting down on one knee, the demon brute regards his prince with respect. 'Master! I didn't know this [BodyName of Player in lower case] was yours?! Or did you want to reclaim your worthless servant?' The demonic prince seems shocked at first, but quickly attempts to reel it in. 'So one of my hellguard is serving the powerful [master] as well? Well, that's good. It will make me feel better knowing that [SubjectPro of Player] has a strong warrior by their side.' Brutus is visibly taken aback by the fact that his prince just referred to you as [master]. 'My lord! What do you mean by ['][master][']? Aren't you gonna take me back from the mortal? Or make [ObjectPro of Player] serve you!'";
		WaitLineBreak;
		say "     Skarnoth's eye widen in shock, 'The [master] serving me!? That's crazy. I'm [PosAdj of Player] subby slave, and I wouldn't have it any other way!' Brutus stands up with a look of disdain on his face. 'You worthless whore! Unworthy of my obedience!' Turning his back on his at one point prince, Brutus regards you with even more rage in his eyes than usual, 'You made the old master into your slut?! The hellguard is broken too then. No going back for me now.' For the first time, you see the closest thing to hopelessness enter the demon brute's eyes, all while the demon's erection keeps growing in size.";
	LineBreak;
	say "     [bold type]Do you want to attempt making Brutus feel better?[roman type][line break]";
	say "     [link](1)[as]1[end link] - Yes, let the demonic slave play with your royal slut, at least for a bit.";
	say "     [link](2)[as]2[end link] - Yes, but you'll think of something different since you don't really think of them sexually.";
	say "     [link](3)[as]3[end link] - Maybe, but they both need to understand that their bodies belong to you.";
	now calcnumber is 0;
	while calcnumber < 1 or calcnumber > 3:
		say "Choice? (1-3)>[run paragraph on]";
		get a number;
		if calcnumber is 1 or calcnumber is 2 or calcnumber is 3:
			break;
		else:
			say "Invalid choice. Type [link]1[end link] to threesome, [link]2[end link] to nonsexual or [link]3[end link] to condescending.";
	if calcnumber is 1: [This will present a threesome route for the two gaining the master's bite trait]
		LineBreak;
		say "     You confidently walk up to Brutus and begin to stroke his abs with one hand, slowly snaking your way higher, feeling the hard muscles of his pecs. Allowing one of your nails to scrape against his dark-purple nipples causes a sharp intake of breath from the broken demon and what had appeared as despair in his eyes now starts to fill with both lust and rage. Looking down, you can see his uncut dick begin to harden even further. The firmer it becomes, the less human it appears. Thick bumps begin to form around his shaft from underneath the sensitive flesh while at the same time his foreskin pulls back over the head of his prick, revealing firm ridges hardening just beneath the crown.";
		say "     Reaching up to the side of his face with your other hand, you softly stroke his horned jaw, before hooking a finger behind one of the protrusions, pulling him closer to you. Brutus's expression looks aroused and at the same time leery. Pressing your mouth against the demon's, you can't help but smirk when his lips pull back, baring his fangs. You slip your tongue out and gently caress one of his sharp canines, and a weird sort of purr then starts to come from the demon's chest as his eyes flutter shut.";
		WaitLineBreak;
		say "     You can't help but want to continue stroking the demon's fangs to elicit that sound, your smile beginning to grow bigger the longer Brutus's purr lasts. You eventually pull back, and the demon's eyes slowly open to see you grinning at him. Oddly enough, his face changes color, becoming a much darker indigo, and you can only assume it's because of his lustful desires. However, without warning, he quickly turns his head away from you as an annoyed look forms on his face, and he attempts to stand up straighter. It finally clicks: could it be that he isn't just merely aroused? Could he actually be... embarrassed that you caught him purring?";
		say "     Having come to terms with this new development, you move around Brutus's body until you are once again face to face. The demon opens his mouth, more than likely to attempt to threaten you, however before he can say a word, you surge forward and press your lips against his own. At first, his mouth remains immobile, but slowly, he begins to return the kiss. The demon's powerful arms surround your waist in a crushing grip, his claws digging into your midsection and piercing you. You know that you could use the power of the amulet to control the brute and force him to stop, however you have other plans in mind. Brutus eventually pulls back from the kiss and with an oddly curious look in his eyes, gazes down at the red marks that he left on your body.";
		WaitLineBreak;
		say "     The demon brute's face morphs into one ready for a threat. 'Why?' That one word speaks volumes to the mindset of the hellspawn, and you can't help but return the question with a simple, 'Why not?' Brutus's chest quickly begins to puff up in an attempt to appear more intimidating. 'Gonna trick me? Break me? Forget it! I'll never bow to a pathetic mortal!' With rising confidence, you remind the demon that you have already broken his old master, and you have also broken him to your will. Raising one finger in the air, you silence the outburst of rage you know that is about to pour from the brute's lips and finally say something to make him pause.";
		say "     You explain to him that you don't want another broken toy, but a soldier, an ally, now that is something you have much more interest in. Brutus turns his gaze to the rest of the room, as if preparing himself for some sort of trick or trap. 'Think I'm a fool?! It's just another way to break me into some obedient pet!' Not allowing yourself to react angrily to the outburst from the demon, you calmly explain to him that with Skarnoth under your rule, you are technically now the new ruler of the hellguard, and effectively his new lord. Before Brutus can make more accusations, you continue speaking and inform him that you have no desire to break him further, or to change him.";
		WaitLineBreak;
		say "     You simply desire to have a powerful, handsome, and brutal general, one that will be loyal and force any and all to bend to your will no matter what. A dark guttural chuckle fills the room, and the demon looks at you with a manic expression in his eyes. 'I'm strong, dumb and convenient. That's what the old master always said! Don't call me 'handsome' just to fuck with my head! Just use me as a tool to break slaves with, like he did!' With that, he pushes his long, thick, forked tongue to slip past his fangs and wiggles it around in an obscene way. Leaning forward, you allow your own tongue to lick upwards against the demon's, apparently shocking him if the loud growl is anything to go by. 'I am tired of your games, mortal!'";
		say "     Reaching up, you begin to fondle with his meaty chest, paying special attention to circling and teasing the flesh around the base of each of the horns adorning his collarbone. With your face so close to his own, you lean in and whisper that every ruler needs a dark knight, a being of depravity that will destroy and consume anything in their path. Pulling back, you ask him in your most seductive voice if he won't be the hand that delivers terror and corruption in your name. 'What do I get out of that?!' You simply smile and tell him that he will get everything he wants. The only thing that will be off limits are your other allies, well unless you give permission, but the rest of the city can be his dark paradise, as long as he serves you.";
		WaitLineBreak;
		say "     Silence fills the air between the two of you for a moment and in a surprisingly small voice Brutus asks, 'Can you make the pain stop?' You assure him that if he stands by your side, you will do everything you can to keep him both happy and sated. Brutus thinks on this for a few moments. Eventually though, an arrogant smile forms on his lips. 'Let's say I want to destroy something with my cock right now. Am I free to leave and snatch up the prey I want?' You can't help but laugh out loud at his request, before pointing behind him, and in a seductive voice, you ask him why go out hunting when the prey has come to him. Turning around, Brutus is met with the sight of his broken master of the past, laying upon his throne like a perfect little [if SkarnothDrugStatus is 2]himbo slut[else]subby pet.[end if]";
		say "     'You'll share your whore?' Rubbing your body up against the brute's, you tell him to consider the submissive fuck-meat as a gift for his initiation as your general of the new hellguard, the only requirement to obtain this title being that he needs to kneel and accept you as his new [master]. A long pause takes place. 'If you are deceiving me, I will destroy you. Somehow.' The words are said so casually that you don't doubt he means what he is saying. With a firm nod of your head, the demon lowers himself down on one knee, and you stroke one of your hands up one of the giant horns on his head and whisper to him that you vow to keep his depraved hunger sated.";
		WaitLineBreak;
		say "     Brutus rises back to his feet, his still hard dick bouncing around with his movement. You let your handle circle around the dark-purple shaft, stroking it firmly and asking the brute if he is ready to claim his reward for becoming your soldier. With a sadistic smile on his face, the demon gives you a nod of approval, and the two of you make your way over towards Skarnoth's throne. The [if SkarnothDrugStatus is 2]airheaded [else]submissive [end if]former prince of hell doesn't even acknowledge Brutus and simply looks to you either for praise or orders. You explain to your slut that since Brutus has chosen to follow you faithfully that you have decided to offer him as a reward for the brute.";
		say "     The look on Skarnoth's face is [if SkarnothDrugStatus is 2]giddy, '[Master], you really want to watch me get used by a brute? That's kinda sick, I mean like [else]mortified, '[Master], you can't be serious! I have never fucked a brute, I mean [end if]come on they're animals, just corruption fodder!' You silence the past royal with a raise of your hand, explaining to him that it has already been decided and that he should be careful of what he says in front of his future [']lover[']. Glancing over at Brutus, you can see that his hard cock is already starting to drip precum on the floor heavily, and you take a step back. Your new soldier takes this as your approval to begin his fun and quickly grabs hold of Skarnoth's massive horns and yanks ";
		if "Nude" is listed in traits of Skarnoth:
			say "his naked form ";
		else:
			say "him ";
		say "to the floor. [if SkarnothDrugStatus is 2]'Hey now, no need to be so rough, just say what yo-oooaahh!'[else]'Hey, watch who the fuck you throw on the floor you dum-oooaahh!'[end if]";
		WaitLineBreak;
		say "     Your royal slave has his tirade ended quickly by Brutus quickly shoving his entire 18-inches of prick inside of the slutty demon's throat, causing his eyes to tear up as he gags and chokes on the immense amount of meat that he is being forced to take in. Brutus looks down at the pitiful sight his past master makes with a vicious grin. 'Shouldn't talk with your mouth full, whore!' As if to exert his own sadistic pleasure, the demon brute then begins to chuckle as he grabs Skarnoth's horns like handlebars and begins to power fuck the royal demon's throat as intensely as if he were screwing the royal slave's ass at full speed. The [if SkarnothDrugStatus is 2]himbo [else]submissive [end if]demon's whole body flops around like a ragdoll as he does all that he can just to stay upright.";
		say "     '[Master], I'm gonna destroy this slut's throat-cunt!' Looking down, you [if SkarnothDrugStatus is 2]are shocked to see that Skarnoth is doing everything that he can to swallow ever bit of cock he can, even at the expense of oxygen, [else]can see that Skarnoth's face is starting to gain a slight blue hue to it from the lack of oxygen being inflicted upon him, [end if]and you decide that it would probably be best if you intervene. Walking up to Brutus's side, you pull his face towards your own, and he quickly captures your mouth in a searing kiss, the whole time never letting up on the skull-fucking that is being delivered to Skarnoth's throat. Feeling his long, serpentine tongue swirling around your mouth is almost enough to make you forget why you actually came over. Yanking your head back, you allow your fingertips to travel down the chest of the muscular brute, feeling the immense heat burning from within.";
		WaitLineBreak;
		say "     Breathless, you ask Brutus why he doesn't make use of the subby demon's other hole. 'Good idea, [master]. Its suck-hole is getting loose anyway.' The brute forces Skarnoth's face against his pelvic bone one last time, looking down with a devilish smirk and watching the bitch choke on the cock that is fully encased in the former prince's esophagus. 'You think that this was fun, hell-slut? The best part comes next!' With that, Brutus pushes the [if SkarnothDrugStatus is 2]dumb [else]subby [end if]demon off of his prick, causing him to fall backwards and gasp for breath. [if SkarnothDrugStatus is 2]The slut quickly attempts to crawl back towards Brutus's dick. Shocked by his former master's actions, the brute quickly [else]Without giving your slave a chance to fully recover, [end if]reaches down and grabs one of Skarnoth's legs, pulling it up and moving the former prince into the position he desires.";
		say "     Being forced to balance on one foot while the other is stretched over Brutus's shoulder, Skarnoth looks more like he is attempting to do the splits across the whole length of the brute's body. You can see him look down at the infernal prince's ";
		if "Nude" is listed in traits of Skarnoth:
			say "fully-exposed hole";
		else:
			say "thong-covered ass, before he quickly adjusts his new toy and yanks the obstructing garment down";
		say ". 'This is gonna hurt, princeling! But I'm gonna enjoy breaking you!' With that last comment, Brutus slams his ribbed shaft inside of Skarnoth, going balls deep, and then begins to pound into him as hard as he possibly can.";
		WaitLineBreak;
		if SkarnothDrugStatus is 2:
			say "     You walk in a slow circle around the two screwing demons, taking in the sight that the pair make. While Brutus appears to be having the time of his life ramming into the demon below him, Skarnoth seems to have retreated into a state of constant pleasure. The infernal prince's brimstone-colored eyes having rolled up into his head, and his long forked tongue is hanging out of his mouth. The bliss-addicted whore's cock shooting a fresh load of cum with each punishing thrust to his prostate. As you inspect the former royal's prick, you notice a definite movement in his abdomen. Taking a closer look, you can't help the chuckle that escapes your throat at the realization that what you're seeing is the bulge of Brutus's 18-inch cock. Finally, he's actually able to focus on you and attempts to plead with the brute to fuck him harder, 'Come on you beast, is that all you got! I though you brutes were supposed to be like good at this!' The comment enrages Brutus, causing him to pound the himbo with such speed and powerful thrusts that you can't help but wonder if the slutty demon can even handle it.";
			say "     Opening your mouth you remind Brutus that if he breaks the toy he wont be able to use it anymore. The brute simply rolls his crimson-colored eyes. 'I won't break your toy, [master]. We are demons and heal faster than even those little machines make you do. That's why demons are always virgin tight, no matter how much you use them! Ain't that right, you little cum-slut?!' With that, he reaches up and wraps a clawed hand around Skarnoth's throat and tightens his grip, making Skarnoth release a mixture of gasping breaths and choking squeals. Before you can comment on his current actions, the brute explains, 'It's all about control [master], I know how much this thing can take, besides if you choke it out a bit, then its cunt tightens up real nice, hehe. Realizing that Brutus is right, well going by the demons that you have encountered anyway, you walk back up to his side as he continues to punch fuck his cock into Skarnoth's hole, which does look awfully stretched at this point.";
			WaitLineBreak;
			say "     Watching as the prince's backside jiggles with each thrust, you can't help the playful side that wants to be let out from within you, and you reach over, spanking the dumb demon's ass every time the brute pulls his dick back. This causes Brutus to chuckle, and eventually, it becomes a game between the two of you, each trying to make the other mess up the tempo. You notice what feels like a snake trailing up your leg and look down to see that the brute's dark-purple tail has started to coil around your calf. Glancing at his face, you see that he now refuses to make eye contact and what appears to be a burst of rage passes over his features as the color of his flesh darkens.";
			say "     You notice that Brutus is mumbling something in between grunts, and you strain your ears to make out, 'Take it! You know you want to! Give into your instinct!' At first, you aren't sure if he is talking to either you or Skarnoth, but then you see the brute's throat being purposely exposed ever so slightly, and without thinking, you give in. Rushing forward, you clamp your mouth over the firm skin you find there and lightly bite down, feeling a surge of heat erupt within your body. 'I'm not some fucking pussy! I can take everything you got!' Those words spur you on, and you deepen the pressure on his neck, and for a moment, you feel as if magma has surged under your skin, and Brutus lets out an ear-shattering roar.";
		else:
			say "     You walk in a slow circle around the two screwing demons, taking in the sight that the pair make. While Brutus appears to be having the time of his life ramming into the demon below him, Skarnoth seems to be either in a state of shock, ecstasy, or agony, you can't be sure which. The infernal prince's brimstone-colored eyes having rolled up into his head, and his long forked tongue is hanging out of his mouth. The demon's cock leaking a copious amount of precum with each punishing thrust to his prostate. As you inspect the former royal's prick, you notice a definite movement in his abdomen. Taking a closer look, you can't help the chuckle that escapes your throat at the realization that what you're seeing is the bulge of Brutus's 18-inch cock. Finally, he's actually able to focus on you and attempts to plead with you to stop Brutus, '[Master], you have to stop him! His cock is way too thick! At this speed, he's going to destroy me! I can feel my ass breaking!'";
			say "     That information is slightly alarming to say the least, and you look to the demon brute for a reply, who simply rolls his crimson-colored eyes. 'I won't break your toy, [master]. We are demons and heal faster than even those little machines make you do. That's why demons are always virgin tight, no matter how much you use them! Ain't that right, you little cum-whore?!' With that, he ups his pounding speed even further, making Skarnoth release a mixture of squeals and unearthly moans. Realizing that Brutus is right, well going by the demons that you have encountered anyway, you walk back up to his side as he continues to punch fuck his cock into Skarnoth's hole, which does look awfully stretched at this point.";
			WaitLineBreak;
			say "     Watching as the prince's backside jiggles with each thrust, you can't help the playful side that wants to be let out from within you, and you reach over, spanking the subby demon's ass every time the brute pulls his dick back. This causes Brutus to chuckle, and eventually, it becomes a game between the two of you, each trying to make the other mess up the tempo. You notice what feels like a snake trailing up your leg and look down to see that the brute's dark-purple tail has started to coil around your calf. Glancing at his face, you see that he now refuses to make eye contact and what appears to be a burst of rage passes over his features as the color of his flesh darkens.";
			say "     You notice that Brutus is mumbling something in between grunts, and you strain your ears to make out, 'Take it! You know you want to! Give into your instinct!' At first, you aren't sure if he is talking to either you or Skarnoth, but then you see the brute's throat being purposely exposed ever so slightly, and without thinking, you give in. Rushing forward, you clamp your mouth over the firm skin you find there and lightly bite down, feeling a surge of heat erupt within your body. 'I'm not some fucking pussy! I can take everything you got!' Those words spur you on, and you deepen the pressure on his neck, and for a moment, you feel as if magma has surged under your skin, and Brutus lets out an ear-shattering roar.";
		WaitLineBreak;
		say "     'I'm gonna blast your insides with my fucking load, you little hell-slut!' Pulling your mouth away from the demon's throat, you look down as he begins to shoot inside of Skarnoth, the torrent of cum just seems to be never ending. Your eyes go wide as you notice that with his plugged up, Skarnoth's belly begins to expand, giving him a slightly pregnant appearance. Eventually though, Brutus rips his cock free from the vice-like grip that Skarnoth's hole had on him and allowing all of the stockpiled cum to shoot out from his extremely gaping pucker, however right before your eyes it begins to heal and tighten back up. Once Brutus is finished he casually allows the infernal prince to crumple to the floor. Turning to face you, the demon brute once again pulls you into a heated kiss, but when he pulls back, you are shocked to see the look on Brutus's face. While he doesn't look peaceful, he certainly does look content. Could it have had something to do with the claiming bite you left on him?";
		say "     Not noticing the ideas floating inside of your head, the demon brute turns to his former master. 'You're lucky that you aren't a woman, little whore-prince! Otherwise I would have knocked your pussy up past the point of no return, haha!' His laugh while still giving off evil vibes, actually sounds... happy. '[Master], I'm going to try out my new freedom. Call my name though, and I will be there to punish any you desire!' With that Brutus leaves, no doubt to go about checking out the library and the surrounding area without a [']handler['] present. Reaching down, you gingerly pick up Skarnoth and carry him over to his throne and set him down gently, you take a moment to pet and love up your passed-out demon slut, praising him for his efforts.";
		WaitLineBreak;
		say "     You know that you will have to figure out more about how demons work to be able to properly handle these two, but thankfully that's tomorrow's problems. You can't help but also think about Brutus's parting words to Skarnoth, the whole knocking up thing. The idea of using Brutus as a breeding stud does excite you, and what better way to build an army than through conception[if carried of orc pill case > 0]. Then again, you do have something that you could use to make it possible for Skarnoth and even Brutus himself to get knocked up as well..[end if].";
		add "Master's Bite" to the Traits of Brutus-MoH;
		add "Brother-in-Arms" to the Traits of Brutus-MoH;
		add "Brother-in-Arms" to the Traits of Skarnoth-Moh;
		increase Loyalty of Brutus-MoH by 5;
		increase Libido of Brutus-MoH by 10;
		increase Humanity of Brutus-MoH by 5;
		if SkarnothDrugStatus is 2:
			increase Loyalty of Skarnoth-Moh by 5;
			increase Libido of Skarnoth-Moh by 5;
			increase Humanity of Skarnoth-Moh by 10;
		else:
			decrease Loyalty of Skarnoth-Moh by 10;
			increase Libido of Skarnoth-Moh by 5;
			increase Humanity of Skarnoth-Moh by 5;
	else if calcnumber is 2: [This will open up the option for one on one scenes to acquire the master's bite trait but without a sexual flavor]
		LineBreak;
		say "     You confidently walk up to Skarnoth's throne and gently lift the demonic prince's jaw, forcing him to look you in the eyes and reaching up, you begin to stroke his crimson hair, much like you would a pet. This causes the former royal to close his eyes and simply enjoy the feeling of being owned, the knowledge that he's viewed as a good boy causing a sigh of contentment to release from his lips. A possessive smile forms on your mouth at the thought of how far Skarnoth has descended into the role that you've placed upon him. Walking back over towards Brutus, you take note of his massive erection and decide to explain to him that he needs to learn to control his baser instincts, 'Why? I'm a weapon and this is my blade!' With that the demon grabs ahold of his massive tool. As he says this Brutus barely acknowledges your presence, too busy glaring daggers at what was once his lord. Opening your mouth, you tell Brutus that you are aware of his role, but that a [']true['] weapon is one that is wielded by a warrior and that he should think bigger.";
		say "     The brute's crimson eyes look toward the ground, 'I'm not good at thinking... I'm better at crushing things.' The sadistic smile on his face at those words showcasing his massive fangs. While that would most likely unnerve most people, it simply makes you roll your eyes at this point. Snapping your fingers in front of Brutus's face in an attempt to pull him back from whatever twisted memory he's lost in, you comment on the fact that crushing things is good, but maybe not always with his cock. Informing him that perhaps he should put some of the energy from his libido into training his body, after all the better he can fight, the bigger the prey he can catch. This causes the brute to pause and slowly a vicious expression forms on his face, 'Hmmm, I like that idea. Alright little mortal, I will try this training thing, now let's go find something to break!' With that Brutus's body reverts back to his mist form and his essence returns to the amulet.";
		add "Solo Brutus Bonds" to the Traits of Brutus-MoH;
		add "Solo Skarnoth Bonds" to the Traits of Skarnoth-Moh;
		increase Loyalty of Brutus-MoH by 5;
		increase Libido of Brutus-MoH by 5;
		decrease Humanity of Brutus-MoH by 5;
		if SkarnothDrugStatus is 2:
			increase Loyalty of Skarnoth-Moh by 5;
			increase Libido of Skarnoth-Moh by 5;
			decrease Humanity of Skarnoth-Moh by 10;
		else:
			increase Loyalty of Skarnoth-Moh by 10;
			increase Libido of Skarnoth-Moh by 5;
			decrease Humanity of Skarnoth-Moh by 5;
	else if calcnumber is 3: [This will open up the option for one on one scenes to acquire the master's bite trait but with a still sexual flavor]
		LineBreak;
		say "     You confidently walk up to Skarnoth's throne and firmly grab the demonic prince by his jaw, surprising him with a dominating kiss of ownership. Reaching down, you grab his ";
		if "Nude" is listed in traits of Skarnoth:
			say "fully-exposed";
		else:
			say "cloth-covered";
		say ", half-hard cock and give it a firm squeeze. A moan escapes from the infernal royal's throat, and with a cocky smirk on your lips you decide to let go and walk back over towards your demon brute, you take note of his massive erection and decide to have some fun. Brutus barely acknowledges your presence, too busy glaring daggers at what was once his lord. Once you are close enough, you wrap your fingers around the brute's bumpy and ridged shaft.";
		say "     Slowly, you begin to jerk Brutus off, eliciting a growl from the beast. Stepping further into the demon's personal space, you force him to look you in the eye and bring his face closer to your own. Pressing your mouth against the demon's, you can't help but smirk when his lips pull back, baring his fangs. You slip your tongue out and softly caress one of his sharp canines, and a weird sort of purr then starts to come from the demon's chest. Having had your fun for the moment, you whisper to Brutus, making sure that he understands how both him and his old master belong to you, now and forever. Removing your hand from his dick, you begin to make your way back to the task at hand, with Brutus's essence returning to the amulet.";
		add "Solo Brutus Bonds" to the Traits of Brutus-MoH;
		add "Solo Skarnoth Bonds" to the Traits of Skarnoth-Moh;
		decrease Loyalty of Brutus-MoH by 5;
		increase Libido of Brutus-MoH by 5;
		increase Humanity of Brutus-MoH by 5;
		if SkarnothDrugStatus is 2:
			increase Loyalty of Skarnoth-Moh by 5;
			increase Libido of Skarnoth-Moh by 10;
			increase Humanity of Skarnoth-Moh by 10;
		else:
			decrease Loyalty of Skarnoth-Moh by 5;
			increase Libido of Skarnoth-Moh by 10;
			increase Humanity of Skarnoth-Moh by 5;


Section 2 - Second Event

[Part 1 - Solo Skarnoth Path
[if you turn down the threesome option either sexually or platonically this will pop as a way to still get the master's bite trait]
[this will need a variation for sub skarnoth vs himbo skarnoth as well as an added variation for whether you had the last scene end on a sexual note or not]
[Skarnoth's side event will be based on him becoming your lord-in-waiting and possibly some minor combat training for him and the choice point for the master's bite trait will be on whether you decided to train him sexually or in a more servitude manner]
[humanity = slut stat]
[SkarnothDrugStatus is 2: himbo skarnoth]
[if humanity is < 0: non-sexualized]
[if humanity is > 0: sexualized]
[SkarnothDrugStatus else: normal]
[if humanity is < 0: non-sexualized]
[if humanity is > 0: sexualized]

[say "     You confidently walk up to Skarnoth's throne and firmly grab the demonic prince by his jaw, surprising him with a dominating kiss of ownership. Reaching down, you grab his ";
if "Nude" is listed in traits of Skarnoth:
	say "fully-exposed";
else:
	say "cloth-covered";
say ", half-hard cock and give it a firm squeeze. A moan escapes from the infernal royal's throat, and with a cocky smirk on your lips you decide to let go and walk back over towards your demon brute, you take note of his massive erection and decide to have some fun. Brutus barely acknowledges your presence, too busy glaring daggers at what was once his lord. Once you are close enough, you wrap your fingers around the brute's bumpy and ridged shaft.";]

[you could go to check in on Skarnoth and find him in some sort of lazy moment, basically playing around with the idea that without being in power he's lost his purpose. this would cause the idea of training up his confidence as well as making him more useful, the training would be tied into two parts. one being servitude with a sexual (cleaning while being revealing and a little obscene) and non-sexual route (simply keeping the place in order). the second being some combat training with a sexual (focusing on tempting and seducing an opponent) and non-sexual route (pure violence). the end of the event would prolly be in the shower room where the ending would be either him simply washing you down, or well yeah you get it, ending in the bite.]
after going to Half-Renovated Room while "Solo Skarnoth Bonds" is listed in Traits of Skarnoth-Moh:
	say "     Walking into the messy room, you are surprised to see Skarnoth simply lounging around on his recharge station, his lava colored eyes closed. After finally having gained some semblance of freedom, you fully expected him to at the very least attempt to explore more often. The[if SkarnothDrugStatus is 2] dumb muscle slut [else] muscled sub [end if]finally acknowledges your entrance by slowly opening his eyes and regarding your form with[if SkarnothDrugStatus is 2] unabashed desire[else] respectful obedience[end if]. Deciding to take the initiative, you slowly strut up to the demon, all the while thinking on what the former master of hell could be doing with his free time. The crimson haired male [if humanity of Skarnoth-Moh > 0]allows one of his clawed hands to begin trailing down his tan chest [else]almost instinctively bares his throat to you [end if]as his gaze follows your approach.";
	say "     Once you're standing directly in front of the demon he finally spreads his full lips into a wicked smirk, 'Hey [master], Whatever could I have done to have earned a visit from you?' While Skarnoth's voice still holds its usual cocky edge, you can see in his eyes and body language though that the hellspawn is definitely a little nervous by your presence. With a smirk of your own, you begin to question the demon about what he's been doing with his temporary freedom. At first the former master of hell just stares back at you like a deer in the headlights, but eventually he breaks the silence, 'Well... I've been thinking on how my life has changed and what that means for me.' It doesn't take a rocket scientist to know that this line of thought without any action to go with it can lead to incredibly depressive thoughts.";
	WaitLineBreak;
	say "     ";


Part 2 - Solo Brutus Path

[if you turn down the threesome option either sexually or platonically this will pop as a way to still get the master's bite trait]
[this will need a variation for if the player mentioned brutus training or if they were condescending]
[Brutus's side event will be based on a impromptu fighting competition with a human gang the choice point will be on whether you want to handle this like a tournament or a non-con free for all]
[a courtyard option would be preferred]
[loyalty = affection stat]
[if loyalty of brutus is 5 then non sexual path was taken else sexual was]
after going to Grey Abbey Library while "Solo Brutus Bonds" is listed in Traits of Brutus-MoH:
	say "     ...";
]
Part 3 - Skarnoth&Brutus Threesome Path

after going to Maintenance Storeroom while (Skarnoth is booked and SkarnothMasterSlave > 1 and "Brother-in-Arms" is listed in Traits of Skarnoth-Moh and "Brother-in-Arms" is listed in Traits of Brutus-MoH and demon brute is listed in companionList of Player and DBCaptureQuestVar is 5 and DemonBruteStatus is 0 and "Master's Bite" is listed in Traits of demon brute and HP of Lilith > 0):
	say "     Walking back into the storeroom that you've been using as a makeshift bedroom, you are slightly surprised to see your demonic slave prince stretched across the small bed, the glow of the limited lighting in the room casting shadows across the demon's form. You're about to ask Skarnoth what exactly he's doing in your personal room, but stop yourself when you realize that the horned stud is asleep. This is a rare opportunity, usually whenever your gaze falls upon the royal hellspawn, he is either [if SkarnothDrugStatus is 2]looking at you like a slut or too busy playing with himself to notice that you're even there. [else]smirking or looking at you with nothing but desire. [end if]Right now, you are able to see a different side, softer perhaps, or maybe he just appears that way since he isn't playing a [']role['] at the moment. Softly, you close the door behind you and take a single step further into the room, but you stop in your tracks when you hear a heavy thud from the other side of the now closed door.";
	say "     [italic type]'[Master], I will keep guard over your room.'[roman type] At first, you are surprised to hear Brutus's voice echoing inside your skull, but you quickly recover, knowing that after claiming the demon brute as your dark knight that things would likely change. Concentrating as much as you can, you ask Brutus if he can hear you. [italic type]'Yes, [master]. After I offered myself and you claimed me as yours, it opened a new way for me to receive your orders.'[roman type] A dark thought enters your mind, and you ask the demon on the other side of the door if he's always able to read your mind. [italic type]'No, I can only hear you when you [']want['] to let me in, but you shouldn't have that same problem. Reading our minds are how our masters track down renegades.'[roman type] Taking in this new information, you nod your head in acceptance, even though you know that Brutus can't see you do so.";
	WaitLineBreak;
	say "     Looking back over towards the bed, you double-check to make sure that your [']guest['] is still asleep and didn't wake up due to the loud arrival of the heavy demon brute. Your eyes take in the tan flesh of the dark prince's chest, which rises and falls with each deep breath the demon takes. Once you are sure that the fallen prince is still slumbering within dreamland, you allow yourself to fully enjoy the sight that Skarnoth makes resting there. Your slave's broad frame is laying on his side with one of his thick biceps under his head while the other is casually draped over the demon's wide hips. Slowly, you make your way over towards the cot, the feeling of a hunter stalking its prey at the forefront of your mind. [italic type]'Haha!'[roman type] The raspy laugh in your head stops you dead in your tracks till you quickly remember that whatever noise Brutus makes can only be heard within your head.";
	say "     [italic type]'It might take some time getting used to blocking your thoughts, [master], but... I am enjoying the imagery that you're sending out.'[roman type] The pleased rumble at the end of the brute's comment excites you. The feeling of doing something naughty, something that you're not supposed to be doing and all the while being encouraged by others to break the rules, it's an adrenaline rush. You continue forward, finally reaching the bed and can't help the feeling of power that courses through your veins as you loom over the unsuspecting Skarnoth. Reaching out, you slowly caress the demon's face and can't believe how innocent he appears while asleep. His long eyelashes flutter slightly in his sleep as your hand creeps even higher up through the silky strands of the incubus's crimson mane. While you've touched the royal's massive horns before, you haven't actually taken the time to examine them closely.";
	WaitLineBreak;
	say "     The ebony-colored keratin feels slick under your fingertips, the thick base leading up to the much narrower sharp points of each large piece of bone. A smile creeps across your mouth at the thought of this powerful and handsome being that has completely given himself over to you, well, with a little bit of training, but still. A soft moan escapes the demon's lips as he moves slightly in his sleep, the sound exciting you further and causing your gaze to lower to Skarnoth's crotch. His ";
	if "Nude" is listed in traits of Skarnoth:
		say "exposed cock is standing fully erect and leaking profusely";
	else:
		say "cloth-covered cock is straining at the material, and judging by the wet spot, is leaking profusely";
	say ". An erotic hunger fills your thoughts while an almost electric feeling travels down your spine.";
	say "     A slightly dark and perverse idea enters your mind, and you attempt to open your mind to Brutus and ask him the [']full['] extent of his abilities. [italic type]'[Master], you have seen my abilities first hand. Why not just give me orders, and I will complete them.'[roman type] You can make out some slight annoyance in the brute's voice and inform him that it isn't about orders. He's the new leader of your hellguard, meaning that he should feel pride with all of your decisions. A rumbling purr extends through the connection that the two of you share, followed by a feeling of warmth. You can't help but wonder if this is Brutus's... happiness, or if perhaps you are simply imagining it. Deciding to share your plan with your dark knight, a boisterous laugh soon erupts inside your head. [italic type]'I like the way your twisted mind works, [master]!'[roman type]";
	WaitLineBreak;
	say "     Looking back at the entrance of the room, a glowing dark-purple mist begins to flow from underneath the door and through its small keyhole. A smile of anticipation forms on your lips as you watch the winding smoke creep ever closer. Once it reaches the large cot, it slowly swirls around the legs of the bed and starts to rise. Watching the entity glide over the sleeping prince, you can almost make out a clawed hand caressing Skarnoth's calf and continues trailing up his thigh. The fiery-maned sub moves around slightly in his sleep as a soft moan can be heard, and by now, the mist has reached his ";
	if "Nude" is listed in traits of Skarnoth:
		say "hard, throbbing cock, fully exposed to whatever may happen.";
	else:
		say "hard, throbbing cock, still confined within his black thong.";
	say "     As the mist tightens around the former royal's body, you are able to see the indentions from Brutus's clawed hands on the supple tan flesh. You move to Skarnoth's side and gently nudge him in an effort to wake the handsome demon, his eyes finally fluttering open as you murmur that it's time for sleeping beauty to awaken. Looking down into the normally magma-like eyes, at the moment, they appear to be closer to a warm amber color, more than likely due to the demon's sleepy state. '[Master]?' The fallen prince's groggy and questioning tone tells you that he's still not fully awake yet. Leaning down, your nose softly bumps into the man below you, and with no other warning, you quickly capture his lips in a searing kiss that tastes like smoke and chocolate. While you focus on where your mouth meets, you feel a sharp claw caress along your side, almost as if Brutus is reminding you that you're not alone.";
	WaitLineBreak;
	say "     Drawn out moans can be heard from within Skarnoth's throat, causing you to open your eyes and look down his heaving torso. You attempt to hold in a snicker as you watch the purple smoke ";
	if "Nude" is listed in traits of Skarnoth:
		say "weave around your sub's cock";
	else:
		say "quickly pulls off your sub's black thong and weave around his cock";
	say ". The glowing mist alternates from sensually gentle strokes to rough quick ones in an effort to never allow their victim to prepare for what's to come. Reaching up, you give one of Skarnoth's dark nipples a sharp twist and enjoy the squeal of both shock and pleasure that seems to vibrate through the fallen prince's entire body. Pulling your mouth away, you smile when the subby incubus rushes to follow your lips with a needy whine. Looking into his now luminescent hellfire eyes, you softly stroke his cheek, watching as his long eyelashes slowly flutter, almost begging for you to come hither.";
	say "     Whispering into the prince's ear for him to close his eyes, an oddly shy smile spreads across his face as he complies, 'Anything you want, [master]. It feels like you're touching me everywhere, please don't stop!' A dark chuckle reverberates through you as you promise that you have no intention of stopping. Your eyes land on where the incubus's throat meets his shoulder, and without warning, a sudden almost instinctual need rises up within you. Remembering your last encounter with Skarnoth and Brutus, you had the same desire to lay claim to the demon brute. The only question is do you really want to give into this instinct? You attempt to think of reasons why this would be a bad idea, but the only thing that keeps popping into your mind is that he is already yours, so why not give him what he needs.";
	WaitLineBreak;
	say "     Surging forward, your teeth find purchase, and you bite into the thick meaty flesh before you, feeling his heat and tasting his sweat upon your tongue. A roar erupts from within Skarnoth's chest, sounding more like a feral beast rather than a royal incubus of hell. The demon's hands quickly shoot up and wrap around your neck, holding you in place, not that you need any incentive to continue. Your mind begins to become foggy and even with your eyes closed, you're able to see a vision of a dark castle surrounded by lava and flames.";
	say "     [bold type][italic type]FLASH![roman type]";
	say "     After the bright light, the sight of the castle quickly melts and reforms into that of a room you can only assume is within the large fortress. The room that you are in now has a lush decor, overflowing with crimson silk, ebony velvet pillows and assorted animal furs across the floors. Laying on a large bed that could easily fit ten or more people is Skarnoth being waited on and entertained by the promiscuity of his demonic guests. Looking closer at the prince of hell, you are brought back to when you first met him. The arrogance and self entitlement the being before you still has all of those traits. The room around you begins to tremble, and it only continues to get worse, causing objects to fall off the walls and leading the demons to run screaming out of the room.";
	WaitLineBreak;
	say "     [bold type][italic type]FLASH![roman type]";
	say "     Glancing around the room, it appears that the disaster has already ended at this point. Nothing is left upright within the room and parts of the walls have even collapsed onto the stone floor. Standing in the middle of the room is Skarnoth, and the look on the demon's face is one of anger mixed with indignation, even when one of the doors calmly opens to reveal a beautiful succubus that you recognize immediately as Lilith from that decimated church. Seductively, she saunters over to Skarnoth. 'Lord Skarnoth, due to the chaos on Earth, a portal has opened up, connecting both heaven and hell to the mortal plane.' A dark smile replaces the rage that was on the demon prince's face a moment ago. 'Get the troops ready then. The last thing we want is to be impolite guests and not accept their eager invitation!'";
	say "     You're quickly brought back to reality, not even sure if what you just saw was a vision or a hallucination. Stepping back, you take in the sight of the writhing demon prince moaning in ecstasy as purple smoke works its magic across his muscled form, and your gaze still zeroes in on the mark you left on your subby demon. To be honest, you are a bit shocked that Skarnoth still managed to keep his eyes closed during the claiming bite. '[Master], what was that? It was so... primal. I feel different, [master]. I mean, I already felt that I belong to you, but after that bite, it feels as if every fiber of my being is yours to do with what you want.' With affection in your voice, you agree that he's right, he does belong to you, down to his very core, and a happy smile spreads across the prince's lips.";
	WaitLineBreak;
	say "     Part of you wants to think about what you just saw when you bit the sexy incubus, but looking down at the display your servants are putting on removes all those pesky thoughts from your mind. Reaching over, you rub and knead Skarnoth's thick thigh with your left hand, causing a grunt to rise from the prince's throat as he attempts to thrust his cock further into the tight grip of the demon brute's mist. Slowly, you dip your right into the purple smoke that is the demon brute's current form and swirl your fingers around, caressing the glowing entity. 'Feeling a bit playful, are you, [master]? I thought that you wanted us to focus on your little royal slut here?' Brutus's voice in your mind sounds teasing, but you can also hear the desire in his rumblings.";
	say "     A lust-driven smirk crosses your face as you submerge your hand fully into the glowing mist and begin to mimic a jerking off motion. You're not sure if your actions are having an effect on Brutus or if he is simply giving you what you want, but slowly, some of the smoke starts to corporealize before your eyes. You quickly pull your hand back, not wanting it to potentially be trapped within the solidifying mist, and in the wake of your excitement, you are presented with a dark-purple dick floating in mid-air. Oddly enough, the base is still connected to the mist via glowing tendrils. Watching the hardening cock, you can see the foreskin begin to pull back, revealing the hard ridges just underneath the helmet and the protruding bumps forming along the shaft.";
	WaitLineBreak;
	say "     Reaching out, you wrap your fingers around the thick piece of meat in front of you. Stroking it slowly, you are rewarded by a deep baritone purr inside of your head. Pearls of precum form at the head of Brutus's prick and begin to overflow, and without paying much attention, they dribble down onto Skarnoth's abs. '[Master], you're being awfully naughty. Ya'know that I don't need lube. My body is always ready for you!' With a hint of mirth in your voice, you explain that you must have forgotten and order him to get into a more [']subservient['] position while reminding him to keep his eyes closed. '[Master], you're so naughty, wanting a powerful guy like me to bow down to you like a horny little bitch!' With a chuckle, you inform him that [if carried of orc pill case > 0]if he's a good boy, you will in fact make him into your personal breeding slut, making sure that he is filled up with so many babies that he will never know what it feels like to not be knocked up[else]he's your personal slut, and it's good for him to always be the answer to your desires[end if].";
	say "     Skarnoth's only response is to moan and quickly getting on all fours, presenting his huge ass to your gaze, and you can't help but smack it firmly, enjoying the way his muscled rear jiggles. 'Please, [master], [if carried of orc pill case > 0]I want to be bred. I will give you the most powerful offspring you could ever imagine[else]I want my body to be a riddle that only your touch can unravel[end if]!' No sooner do those words leave the incubus's mouth than the demon brute's ghostly hands reach up and spread the royal's ass, exposing his small pink opening. Feeling wicked, you shoot your hand out in an attempt to grab one of Brutus's glowing incorporeal hands, and oddly enough, you're able to grab it as if it were solid. Pulling it back, you're rewarded with a full bodied demon brute forming from within the mist.";
	WaitLineBreak;
	say "     You had no idea that you could actually grapple the demon from its smoky state. 'Things have changed, [master]. By making me your champion, you have more power over me.' The voice in your mind sounds both amused and proud all at the same time, and you rush your mouth forward to claim his smiling lips, however, before you can fully enjoy the taste of your dark knight, a pleading voice can be heard from the decent-sized cot. '[Master], stop teasing me. Just ram [if player is male]your cock[else]that toy[end if] in, I need it!' Not sure exactly what Skarnoth is talking about, you peer around the demon's large body and are shocked by what you see. Hotdogging the incubus's ass is Brutus's hard cock. Your eyes follow the tendrils of smoke leading back to the brute's now mist-covered but empty crotch.";
	say "     A laugh bubbles out of your mouth, which leads to Skarnoth questioning you, '[Master], what's so funny? Is it amusing to push me to my limits and have me begging for it?!' You can hear the hurt in the incubus's voice and inform him that you are simply happy. This seems to do the trick and causes a smile to cross the prince's mouth. Crisis averted, you are about to lean forward and kiss Brutus, only to have the demon hold his hands up in front of you. With a wink of his crimson-slitted eye, the brute's hands fade into smoke and travel over to Skarnoth once again, spreading his ass open and making it easier for his cock to rub up against the royal hole in front of it. 'See, [master], no body needed.' A smirk forms on your lips at seeing this new playful side to the normally rage-engulfed hellspawn.";
	WaitLineBreak;
	say "     While it's strange to see the demon brute with only smoke for hands, it's certainly a fun turn of events. Stepping forward, you begin to back the demon up against the side of the cot furthest away from Skarnoth and push his large form down. The impact startles the incubus, who up until now thought that it was only the two of you in the room and believed that you were behind him. His gaze snaps open and takes in the sight of the two of you chuckling. '[Master], what's going on?!' Before you can respond, Brutus chooses that exact moment to penetrate his former prince, causing Skarnoth to release a guttural moan as his eyes roll into the back of his head. With a level of casualness that impresses you, the demon brute gets into a proper position with his back up against the wall as he tucks his feet under the groaning demon prince.";
	say "     Skarnoth's body starts to lurch back and forth quickly as Brutus begins to pummel his hole. The whole thing looks slightly odd as while the incubus is being fucked in the ass, his face is right over where the brute's cock [']should['] have been. '[Master], you certainly made the right choice in turning this thing into a dutiful hell slut. Its hole is so tight that it feels like it might break, haha!' While the demon's words arouse you, one thing sticks out in your mind. Ever since he was introduced to Skarnoth, he has referred to him as an it, never as a person. Walking behind the incubus, that at this point can't even keep his head up, your hand darts out and grabs the base of Brutus's cock. '[Master], what are you doing?! Let me fuck this dumb whore!' Those words call back to when you decided to break Skarnoth of his entitlement, however, if you had wanted him to be a dumb broken slut, you would have just destroyed his mind, but... you didn't.";
	WaitLineBreak;
	say "     You demand that Brutus say the incubus's name. 'Haha, is that all? Its name is hell slut. Has a nice ring to it, don't you think?' You explain that while that may be fine during sex time, he needs to also have a level of respect for the demon prince. 'Why should I? He treated all of us like fodder. He wasn't like you. He was a horrible master.' A swell of pride fills your chest at hearing that you are the superior choice, but you also explain to Brutus that the being in front of him is no longer his prince, and since they both belong to you, this in fact makes them brothers. The brute looks slightly uncomfortable by your words. 'Brothers? We are born from the lava pits of Hell. We don't... that word has no meaning to me.' Through the connection that you share with Brutus, you can feel something empty, and you comment on the fact that may have been his past, but not his present.";
	say "     The demon just lays there not moving, well, other than the occasional throbbing from his cock in your hand. 'So I can continue if I can say its... his name once?' You nod your head in agreement. 'Fine! Can I continue turning Skarnoth's ass into a cunt?!' His choice of words cause you to laugh out loud, and while it's not exactly what you had in mind, it's progress. You release your grip on the hellspawn's cock, and without any hesitation, he once again begins to pummel Skarnoth's insides. Walking back over to Brutus, you realize that there is no more room on the cot for your form and instead decide to straddle the brute's torso. The demon refuses to look directly into your eyes. You can only assume it's due to embarrassment from your talk, so you lean forward, gently pressing your lips to his own and allowing your tongue to rub and massage one of the demon's sharp canines, causing a rumbling purr to echo throughout the room.";
	WaitLineBreak;
	say "     Pulling back, Brutus now looks intently into your eyes, as if he wants to say something, so you wait till he is ready. 'Does this mean that I can still just do whatever I want to the rest of the city?' With a smirk, you explain to the brute that you have no intention of trying to turn him into a being of virtue and that Skarnoth is different than those other toys out in the city who are just waiting to be used and broken. A huge smile spreads across the demon's fanged mouth. 'So I can still grab anything I want out there and destroy its holes, well, other than those that belong to you?!' Smiling at how much he sounds like a kid at Christmas, you lean down and before you capture his lips, you whisper that he had better make sure that those whores' holes never recover from what he does to them.";
	say "     The demon brute's response is instant, and he passionately begins to kiss you. He must also have gone back to fucking Skarnoth in earnest, well, if the head shape that's hitting your backside is any indicator. You jump a bit when you feel something slick begin to[if player is female] rub and squirm at your clit[else if player is male] wrap around your cock[else] put pressure on the mound of flesh where your genitals would be located[end if], causing you to throw your head back and moan in pleasure. Looking at Brutus with desire, you see a line of mist leaving his mouth, and he opens it, revealing that his tongue found other uses. Before you can even adjust to this new feeling, another slick member joins the first, this one probing[if player is female] your soft netherlips, [else] the rim of your ass, [end if]invading your inner walls. You catch on to the fact that both Skarnoth and Brutus are both trying to make you feel pleasure and with a breathy moan, you tell them what good boys they are.";
	WaitLineBreak;
	say "     As the two demons continue to stimulate you, your hips grind back and forth, using Skornoth's tongue for penetration and Brutus's for masturbation. From behind, you hear a squeal from the incubus as his face is pushed hard into your backside, and the familiar scent of salty cum begins to fill the room. Not one to be outdone, you quicken your pace, pushing yourself closer to orgasm until it finally tears through your body. With a[if player is female]high-pitched squeal of your own, your femcum begins flooding onto [else if player is male]loud bellowing roar, your load shoots out in heavy ropes onto [else]loud bellowing roar, your shapeless mound spasms and leaves you lying on [end if]Brutus's abs. Completely exhausted by the passion that overtook the room, you collapse next to the demon brute, forcing him to lay on his side rather than on his back. With a sleepy glaze over your eyes, you notice that Brutus has [']reconstituted['] himself and looks equally satisfied. Reaching over, you pull the hulking male over, making his head rest on your[if Breast Size of Player > 0] soft, pillowy[else] hard, muscled[end if] chest.";
	say "     Glancing over with the intention of pulling Skarnoth onto the free side of your body, you are shocked to see the tan adonis huddled in a corner of the cot by himself. Calmly, you ask him why he doesn't come closer and lay with the two of you. 'Why would I come over there? I'm just a cumdump to be used and thrown away, aren't I?' The look of betrayal and sadness in the incubus's lava-like eyes pulls at your heartstrings, and you ask why he feels like that's the case. 'Well, I came here to spend time with you, but instead of what I was hoping for, you had that animal use me!' You can feel one of Brutus's claws tighten at your side either in rage or guilt. You attempt to reach out mentally but can't seem to get a good read, almost as if too many things are overlapping with each other. Not wanting to make Skarnoth any more frustrated than he already is, you inform him that it's a pity that he doesn't want to join because you were looking forward to some cuddle time with him.";
	WaitLineBreak;
	say "     With a huff, the incubus finally comes over and lays his head opposite the demon brute. 'Fine, well, here I am.' Wrapping your free arm around the fallen prince, you are surprised when it's Brutus that breaks the silence. 'So... it's me that made you feel that way?' Silence fills the room for a few tense moments. 'I don't see anyone else calling me nothing but an [']it[']? Do you? I mean, we are demons. It's not like we can ever do anything but try to beat down anyone that doesn't own us!' The venom in the incubus's voice is palpable, but you can't help but wonder if this means that Skarnoth didn't actually hear your earlier conversation with the demon brute. You slowly begin to rub the agitated demon's back in an effort to help comfort him, but before you speak your dark knight prevents you. 'Well... that's our past, not our present.'";
	say "     You're glad that neither of them are looking at your face at the moment. You're a bit blown away by Brutus using your own words, but even more so that he remembered. The brute must be feeling more confident in the conversation because he continues without pause, 'We both belong to the [master], and [SubjectPro of Player] chose us because we are the best at what we do. If you look at it that way, it makes us brother-in-arms.' Skarnoth is getting a bit jittery to your left, leading you to hold him tighter as he speaks, 'We're demons. We don't have brothers, and ya'know it.' The empty way that the former royal says those words forces you to speak, and you tell him that this is a new world for them both and that means that the old rules don't matter anymore. Finally, Brutus sends a solid feeling through the link that you share before he speaks out loud, oddly one of humor, 'Well, out of the two of us, it's a given that I'm the big brother anyway!'";
	WaitLineBreak;
	say "     The incubus prickles at those words. 'You dumbass. The older brother is always decided by who is older and that's me!' The brute seems to mull that over for a bit, until he finally voices his own opinion, 'Yeah, well, I'm bigger, and everyone knows that the bigger brother has to look out for the smaller one! Besides, everyone also knows that the sluttier bottom bitch one is always the little brother. I mean, why have one if you can't breed him?!' You can feel Brutus's face breaking out into a smile against your side. 'Oh yeah? Well why would I ever agree to that? That just makes it sound like I'm still just something to be used!' Skarnoth snaps. At this point, you begin to feel the warning signs of a headache from all of their bickering. Hopefully, the brute to your right can pick it up through the connection you share. 'How about this? You agree to be the lil bro, and I will sometimes bring you back some goodies from city?'";
	say "     You can feel Skarnoth start to shake next to you, but thankfully it's with laughter. 'Oh yeah, that's just what I've always wanted, someone to bring sweets, haha!' Brutus is silent for a moment, but eventually speaks up with a hint of darkness in his voice, 'Who said anything about candy? I meant toys. Ya'know the [master] gave me permission to use anyone out in the city I want, well, as long as they don't belong to them, right, [master]?' Wanting this conversation over so that you can rest, you simply nod your head in the affirmative. Unfortunately, this leads to debates on the best way to capture people, what sort of sluts are the best to turn into fuck toys, and finally what's the best method of shattering a person's will. If you weren't so tired, you may have been more scared by the things that were mentioned, but you still manage a smile before sleep finally overtakes you. The sight of your two demon boys huddled at your side while their tails are intertwined in sheer glee at the chaos they would unleash let you know that things would never be boring at least.";
	add "Master's Bite" to the Traits of Skarnoth;

Section 3 - Third Event


Table of GameEventIDs (continued)
Object	Name
Dark_Presence_Start	"Dark_Presence_Start"

Dark_Presence_Start is a situation.
ResolveFunction of Dark_Presence_Start is "".
The level of Dark_Presence_Start is 10.
Sarea of Dark_Presence_Start is "Nowhere".

when play begins:
	add Dark_Presence_Start to BadSpots of FemaleList;
	add Dark_Presence_Start to BadSpots of MaleList;
	add Dark_Presence_Start to BadSpots of HermList;
	add Dark_Presence_Start to BadSpots of TransList;
	add Dark_Presence_Start to BadSpots of FeralList;
	add Dark_Presence_Start to BadSpots of FurryList;
	add Dark_Presence_Start to BadSpots of IncestList;
	add Dark_Presence_Start to BadSpots of NonconList;
	add Dark_Presence_Start to BadSpots of MindcontrolList;

after going to Maintenance Storeroom while (Dark_Presence_Start is active and Dark_Presence_Start is not resolved and Skarnoth is booked and SkarnothMasterSlave > 1 and DBCaptureQuestVar is 5 and DemonBruteStatus is 0 and "Master's Bite" is listed in Traits of demon brute and "Master's Bite" is listed in Traits of Skarnoth and HP of Lilith > 0 and HP of Nala > 0 and Loyalty of Atticus is 1 and player is not submissive and energy of The-Voice - turns > 3):
	say "     Walking into the maintenance storeroom that now serves as your bedroom, the bed calls to you as the door closes, the stress of the day catching up to you. Tossing your bag onto the ground, you nearly collapse onto the small cot that now serves as your bed. Laying there and looking up at the ceiling, you start to feel the need for sleep almost like a heavy pressure behind your eyes. Listening to the familiar sounds of the library, you can make out someone softly having a conversation from above and a hard thud from outside your door, more than likely Brutus taking his place guarding you while you slumber. As your eyes begin to burn with the need to rest, you close them in an attempt to help hydrate them, however once you open them again, your vision is blurry, and you have to blink a few times to get your eyes to adjust. You quickly realize that something is wrong and sit up while looking around, The room was never very colorful to begin with, but now everything appears to be in shades of white, black, and gray, almost like one of those old-fashioned movies.";
	say "     Standing up from the cot, a lightheadedness sweeps through your mind causing you to grab onto one of the nearby shelves, and you wait for your equilibrium to finally settle. Once you feel alright to move, you begin to make your way for the door, each step feeling like gravity is pressing your body harder into the ground with much more intensity than it should. Finally at the door, you wrench it open, fully expecting to be met with Brutus's massive form, but instead you only see swirling black smoke beginning to creep through the open doorway. While investigating the anomaly, you stop just before the tendrils of smoke can make contact with your body. Contemplating on what to do next, you turn your head slowly and look behind you at the small storeroom. You notice that while its appearance may have changed, it's still somewhere that you've marked as your own, and it still has that air of safety to it.";
	LineBreak;
	say "     [bold type]Do you want to lay back down in the safety of your cot?[roman type][line break]";
	say "     ([link]Y[as]y[end link]) - Yes, this has to be a dream and you need to wake up.";
	say "     ([link]N[as]n[end link]) - No, something is wrong here and you need to push forward.";
	if Player consents: [This will eliminate the Master of Hell quest from continuing]
		LineBreak;
		say "     Taking a single step away from the swirling darkness, you turn around and make your way back to the small cot. Laying your head down on the small pillow, you close your eyes and do your best to focus on trying to wake up. Your own personal scent surrounds you but underneath that you can make out the smell of both Brutus and Skarnoth. Slowing your breathing and allowing your mind to go back to that moment the three of you shared, a strange static sound starts to build from within your mind until finally it becomes almost painful and jolts you completely upright in shock. Glancing around, you realize that the colors are back to normal, and in your attempt to get up, you almost fall off the cot. Rushing to the door and wrenching it open, you almost run right into Brutus's firm back and quickly wrap your arms around the demon brute as he turns around to face you. Finally pulling back, you happily inform him how grateful you are to see him. The only response you are met with is a single raised eyebrow, followed by a look of confusion.";
		say "     'Why can't I reach into your mind, [master]? Have you finally learned how to keep others out?' Confused yourself, you just stare at Brutus with your mouth hanging open, that is until you notice something different about his throat... Your bite mark is gone. The brute's face quickly clouds over with something akin to fear, the facial expression looking alien and out of place on your dark knight's visage. A ear-splitting roar bursts from Brutus's mouth, causing you to take a reflexive step back. Before you're able to ask him what's wrong, he interrupts you, 'What did you do?! My whole body feels like it's on fire again! You promised that the pain would end!' You don't know what to say, your jaw hanging open as you think of how to respond. 'You are liar!' Watching as the demon attempts to formulate his words, it's almost like the pain is too great for him to focus. 'You're not [master], you prey!'";
		WaitLineBreak;
		say "     A clawed hand swipes down at your face, but before you're able to duck down, it stops just short of colliding. The look of rage and betrayal never wavers from the demon brute's intense gaze. 'I... will... destroy... you!' With one final roar, Brutus bursts into a cloud of purple smoke and is sucked back into the pendant that you had promised that he would never have to return to. Trying to make sense of what exactly just happened, you're once again pulled from your thoughts as Skarnoth rushes down the stairs of the bunker. '[Master], what was that sound?! It sounded like Brutus was shouting about something.' Opening your mouth to explain what just happened, it quickly snaps shut as your eyes lock onto the royal incubus's throat... His mark is gone as well. '[Master], what's wrong? You don't look so good.' A strange flash washes over Skarnoth's face, just like it did with Brutus, causing his eyes to roll into the back of his head briefly. 'I... don't feel very well, [master].'";
		say "     The demon slumps to the floor and ragged breaths start to escape his chest. Remembering what happened with Brutus and how whatever gift that was passed onto him must have reverted somehow, you quickly leap into action and reach out to help the formal royal to his feet. Doing your best, you attempt to get the demon up the stairs of the bunker and back to his chair as fast as possible. Once he's seated, his breathing finally begins to return to normal, although he still appears slightly out of it. Not knowing what else to do, you start to explain to Skarnoth what had happened with Brutus and then to himself. 'Wait, Brutus? You mean that drooling beast that you enslaved?' You gape slightly and then proceed to ask why he would say that about someone that he apparently was able to form a bond of brotherhood with. 'A bond of brotherhood? You must be joking, [master]. I've never even talked with that animal.' It's almost as if the submissive demon somehow forgot everything that took place after you began to place those bite marks the hellspawn in your possession.";
		WaitLineBreak;
		say "     While processing what all of this could mean, a voice calls out from behind you, 'Is everything alright?' It's Elijah, his expression warm while meeting your gaze, but quickly turns cold as he takes in Skarnoth. 'You had best be staying out of trouble, demon, because if I find out otherwise, I will put you down before you can do any further damage.' The exhausted incubus merely mocks the angel and waves him off. Just as it looks as if Elijah's about to retaliate, you step in and explain to the angel that everything is fine and that you were simply checking in on him. With a shake of his head, the divine being's only response is, 'Don't pay these demons any mind. Remember that they are nothing but monsters, incapable of actually feeling anything other than the desire to destroy everything that they can.' With that, the angel gives you a slight smile and exits the room, leaving you to wonder if what Elijah said is true. A darker thought is quick to follow. If that's true then what does that make you, someone who gave them hope and a possible reason to feel, only to somehow rip it all away and erase those moments...";
		remove "Master's Bite" from Traits of Brutus;
		remove "Master's Bite" from Traits of Skarnoth;
		now HP of The-Voice is 99;
		move player to Half-Renovated Room;
		now A Dark Presence is resolved;
		now energy of The-Voice is turns; [saves when this event was done]
	else: [This will allow the Master of Hell quest to continue]
		LineBreak;
		say "     Steeling your nerves, you take a confident step forward, allowing the shadows to twist and wrap around your body, caressing your form. However, the further you walk into the seemingly endless darkness, the tighter the grip of the tendrils become, feeling almost as if they are attempting to halt your progress. After what feel like hours of walking, you finally are able to make out a light further ahead and using all of your strength, you push on, finally freeing yourself from the shadow tentacles that have slithered around your form. As you finally burst free, your eyes are hit with the dim light of the room, causing a grunt of pain to escape your lips. Bringing your hand up to offer them shelter from the brightness, you try to allow them to adjust to the contrast in light. Once you're able to look around without your eyes stinging, you can see that you're standing on what appears to be a strange plateau surrounded by swirling smoke. Turning back, you notice that the doorway that you came through has somehow vanished into thin air.";
		say "     Looking out across the vast emptiness, you can't help but wonder if passing through that door was the right choice. A slight tingle starts at the base of your skull and progressively makes its way down the rest of your spine. It's a familiar feeling, almost as if you're being watched. Whirling around in an attempt to catch whatever was spying on you, you're met with a haunting chuckle, well if you can even call it that, the sound being somewhere between the sound of a lunatic's ravings mixed with the sound of a wounded animal screeching. What you're met with is a semi-transparent shadow. At first, you aren't sure what to make of this discovery. While it's shocking to see a sentient shade, your time in the city has also taught you to pay attention to your surroundings. Looking closer at it, there is no way to figure out what exactly it's supposed to be a shadow of or if this thing even has a gender. A mouth forms on what you can only assume must be the shade's face, sharp, jagged teeth protruding outward from the freshly formed orifice.";
		WaitLineBreak;
		say "     Two bright-yellow orbs begin to travel up the being's form, passing by the long tentacles of darkness all around its body, eventually becoming lifeless-looking eyes that wobble back and forth, making this thing appear even more unsettling. The creature smiles at you, something that may have been intended to put you at ease, however it causes quite the opposite, and you enter a defensive position instead. 'Haha, well that's certainly rude, don't you think? Here I am, trying to help you be more comfortable and what's my thanks? You act as if you're going to attack me, buhaha.' The being looks absolutely giddy by your actions, meaning it either wants a fight, or it views your antics as hardly a threat and silly.";
		LineBreak;
		say "     [bold type]Do you want to hold your ground against this unknown enemy?[roman type][line break]";
		say "     ([link]Y[as]y[end link]) - Yes, you have no idea what this thing is, backing down would be a show of weakness.";
		say "     ([link]N[as]n[end link]) - No, this thing obviously doesn't fear you, perhaps you should listen to what it has to say.";
		if Player consents: [Rebel]
			LineBreak;
			say "     Holding your defensive stance, you await the creature to make the first move. 'I see that your arrogance is certainly something to be admired, especially considering the fact that you have no idea who or what I am... or what I may be capable of, and still you think that you can just pummel me into submission.' The being rises higher off the ground, dark tendrils emerging from the base of its form, each with their own private mouths that seemingly propel the creature's movement. Before you can react, the tentacled shadow begins to circle around you, maniacal laughter coming from every angle. While it's hard to focus on the beast itself, what with all of that shrieking piercing your ears, you finally thrust a fist outward and it appears to connect with... nothing. Your hand simply moved through the shades body, 'There, see? Wasn't that a fun little game to play? It's always fun to make new friends, don't you think?' Returning to its original spot, the shade continues to speak, 'As you can plainly see, I can't be touched. I am a being of the void. Think of it as a place that exists between the dream world and the real one.'";
			say "     Long clawed hands creep up from the being's side and cover its mouth as it continues to giggle. 'More power will be needed before you can beat anything into submission, little [master].' The term [master] catches you off guard, your thoughts instantly turning to both Skarnoth and Brutus. The two of them have both been using that term a lot recently. You are pulled from your thoughts by a deep guttural rumble. 'This goes deeper than your little pets. They are merely tools to achieve an even greater ambition, well if you're strong enough to claim it that is.' Knowing full well that the names of your demons, or even their existence, never passed from your lips, you raise an eyebrow at the shade. The only reply that you're given is simply more cackling.";
			decrease level of The-Voice by 1;
		else: [Compliant]
			LineBreak;
			say "     Leaving your defensive stance, you look at the creature, wondering what it will do next. 'I see that you're smart enough to realize when you are out of your element, especially considering that you have no idea who or what I am.... or what I may be capable of.' The being rises higher off the ground, dark tendrils emerging from the base of its form, each with their own private mouths that seemingly propel the creature's movement. Before you can react, the tentacled shadow begins to circle around you, maniacal laughter coming from every angle. While it's hard to focus on the beast itself, what with all of that shrieking piercing your ears, you hold yourself steady, waiting out whatever it is that this thing is trying to accomplish. 'There, see? Wasn't that a fun little game to play? It's always fun to make new friends, don't you think?' Returning to its original spot, the shade continues to speak, 'As you can plainly see, I am everywhere and nowhere all at the same time. I am a being of the void. Think of it as a place that exists between the dream world and the real one.'";
			say "     Long clawed hands creep up from the being's side and cover its mouth as it continues to giggle. 'I suppose more power will be needed before you will even attempt to beat anything into submission, little [master].' The term [master] catches you off guard, your thoughts instantly turning to both Skarnoth and Brutus. The two of them have both been using that term a lot recently. 'This goes deeper than your little pets. They are merely tools to achieve an even greater ambition, well if you're strong enough to claim it that is.' Knowing full well that the names of your demons, or even their existence, never passed from your lips, you raise an eyebrow at the shade. The only reply that you're given is simply more cackling.";
			increase level of The-Voice by 1;
		WaitLineBreak;
		say "     A slimy purple tongue emerges from between serrated teeth, licking the thing's non-existent lips. 'The truth is, while dreams are tasty, each filled with the hopes of mortals, nightmares are far more... delicious. All that fear, the adrenaline just under the surface, screaming to break free...' A vile-looking white mucus begins to drip from the shade's mouth. 'But I digress. Right now, we shouldn't be talking about my feeding habits, instead we should be discussing a potential symbiotic relationship that could be formed.' The disbelief has to be evident on your face. The way this creature jumps from topic to topic seems to have no real reason to it, almost as if it were purposefully attempting to be confusing. For the first time, the shade actually appears as if it's becoming frustrated. 'I suppose that since [']I['] already know the score, I never really expected that I would have to explain myself properly. How tedious. Well, even I can admit when I should be helping a lesser being to understand what should be obvious.'";
		say "     Finally finding your voice, you ask the creature for its name. 'Name?' The shade quickly looks down at one of its tentacles and half whispers in anger, 'No, not your name! The liberator asked my [']name['], you fool... No, I already told you that you can watch, but no touching!' Taking a step backwards, you can't be sure whether this thing is simply crazed, or if there is something else here that you simply can't see. Your movement however pulls the creature's attention. 'Ah yes, a name. Well I don't particularly like the idea of names. They are simply a method of control. You see, knowledge is power, and I don't much care for the thought of anyone having that sort of power over me. However, perhaps a different type of transaction can be made, hmm?' The whining sound that it ended its question with sends a chill down your spine, along with the fact that apparently this thing thinks that you're some kind of liberator.";
		WaitLineBreak;
		say "     The shade either doesn't notice, or simply doesn't care about the effect that it is having on you. 'Now, what could I offer you?' The way that the shadow talks makes it sound as if it already knows [']exactly['] what it plans on saying. 'This place is my own personal creation, somewhere that has a pull all of its own. You see, when mortals close their eyes, enter dreamland, and are full of intense emotions, their essence can find its way here.' Looking around at the vacant area, you aren't sure that you're able to hide how unimpressed you are by the place's appearance. 'Well what do you think of this space? I'm sure that it's a little bland by mortal standards, but maybe something could be done about that. If you could have a domain of your very own, what sort of residents would you enjoy watching?";
		say "     Silence fills the air between the two of you, as you're not really sure what they mean or how you should answer them. 'What I mean is that if I were to simply give you this realm, purely as an example mind you, what sort of dreamers would you want to see visit?' The condescending tone of the shade's voice causes your hackles to raise. 'I mean in simple terms, would someone like you prefer a world filled with beautiful females? Perhaps a paradise of manliness and testosterone? Or maybe you're someone that can find the pleasure in a little bit of everything, hmm?' A shudder goes through you before all of what the creature said sinks in. A world of your own choosing?";
		WaitLineBreak;
		say "[PlayerDarkSanctumSetting]"; [The-Voice file]
		say "     'I see, so that's the sort of thing that you're into? What a naughty little [master] you must be, hehe. Truth be told, I suppose I could see how adding a bit of [']flavor['] could help this place be less boring for a mortal.' A feeling of embarrassment washes over you at the idea that you actually played into this thing's game, but the shadow doesn't seem to be judging your choices, instead finding the whole situation more amusing than anything. Growing tired of the games that this creature is playing, you quickly shout at the shade to get to the point, demanding to know exactly why you're here! 'Tut-tut, that's a rather rude way to ask a question, don't you think? Besides, why should I tell you... when I can simply show you!' With lightning speed, the creature rushes at you, however rather than the impact that you're expecting, it fades into your body instead.";
		WaitLineBreak;
		say "     A shrieking laugh fills your head until it is the only thing that you can focus on, causing you to become dizzy, and you drop to your knees with nausea. Shaking your head and taking a few deep breaths, you stand up and brace yourself for whatever trick that shadow has planned. A light behind you catches your attention. Spinning around, you are met with a very familiar sight, although you have never seen it quite from [']this['] perspective. Looking forward, you can see a battlefield frozen in time. Both you and Skarnoth are in the heat of battle, grimaced mouths shouting out in silent rage. From inside your head, a voice vibrates through your skull 'I see that you remember this battle. The moment that you chose to get involved in things that were not your concern, and in doing so, decided the fate of this city... and perhaps much more.' Glancing at Skarnoth, it's almost like looking at someone totally different than the demon you've become used too. 'The demon prince was well on his way to claiming your realm. He had amassed his entire army in preparation.'";
		say "     The image hardens into ash, only to crumble and reform with the scene of you clasping the slave collar around the former royal demon's throat. 'The way leadership works in Hell is that when one master falls, the next in the bloodline absorbs the discarded energy and is able to take the throne. However, by sparing and enslaving him instead, you trapped his power.' Everything around you fades to black, until a scene unfolds: a huge hall filled with more demons than you can count. They all appear to be cheering and celebrating, however at the far back of the room is a large throne. A demon that looks surprising like Skarnoth is slumped over the side and judging by the wound to his throat, he's already dead. 'So now there are leaderless demons raging against the barrier to your realm and an empty throne that your pet's younger sibling could never properly fill.' Hearing that Skarnoth has a little brother shocks you since the last time you talked on the subject, he claimed that demons didn't have any brothers, but then again perhaps he didn't even know. Taking a deep breath at the thought of having to tell Skarnoth about his brother, you realize that you can't seem to suck in any oxygen.";
		WaitLineBreak;
		say "     Hacking and coughing, black smoke starts to pour out of every orifice that you have, centering in a single spot until it coalesces into the shade's original form 'So now you know the truth. The demons will break the barrier and swarm the city. Left unchecked, they will spread like a plague across your world... and it's all your fault, haha.' Without thinking, you rush at the shadow, your fist already pulled back and ready to strike. A single clawed hand rises, causing your entire body to freeze in place. 'You really are going to learn how to keep that rage in check, besides there is one other option. You see, fate had already decreed that the current Master of Hell would have won, or that he would have been killed by a being of light. You know what that means, right?' Your mind starts trying to piece the information together. Basically, what this thing is saying is that someone should have died, either Skarnoth or Elijah.";
		say "     'This is why I hate mortals. They always think about [']people['] rather than the big picture... You! You were not part of fate's design and thus you changed it!' Turning to the side, the shade once again mutters something to someone that you can't see. 'I know, I know, it can't help that it's a lower life form.' The creature finally calms down again and turns back to address you. 'Let me try to explain. Let's say that fate is a riddle, alright? The riddle is something like, what walks on four legs in the morning, two during the day, and three at night? Any normal person would answer that it's obviously the victim of a killer that is adding and removing parts for fun, but you might answer something ridiculous, like the life stages of a human being. That's what you are: an anomaly that makes no sense!' Personally, you think the shadow's answer is the more idiotic one, but you don't say anything, instead waiting for it to continue.";
		WaitLineBreak;
		say "     'I'm sure that you have noticed certain marks appearing on your pets, almost like a brand? Well that's your personal mark. By breaking the former Master of Hell, you've somehow inherited a part of his power. I brought you here to guide you in how to help it grow.' Finally you open your mouth to speak, the question on your tongue being why you would want their help, or better yet why they would want to help you. 'Oh, that's simple, either your power grows, or the beings that you seem to care so much about, yourself included, will be destroyed. As to your other question... I'm just a helpful sort of demon, that's all, haha!' The comment is made so simply, as if the creature is commenting on nothing more than the weather. 'Oh come now. If anything, you should be thrilled that I'm saying there is a shred of hope, hehe! Then again, saying a shred is still overselling your abilities by a great deal.' The warped smile on the being's face makes you want nothing more than to bash in each and every tooth.";
		say "     'The first act of generosity on my part is that I will give you this space for your own personal use, well as long as you understand that I will still be feeding from your pool.' You ask what they mean exactly by [']feeding[']? 'Only their energy. They may wake a little more tired than usual, but will be otherwise unaffected. Now, what was the next question I had planned?' The ground erupts as a huge stone monolith rises up with something already written on its surface. Taking a closer look, you can make out the roman numeral for one and next to that is the list of genders you seem to be interested in. 'Ah yes, well I know that you mortals are suckers for a good theme, so why don't we choose one for this little dark sanctum of yours, haha. Be warned though, only one can be chosen, well for now at least. These things take up a lot of energy to maintain, and you will need to amass much more energy to gain more. Before you start asking questions, yes, I can do anything within this space, regardless of the genders that you desire.'";
		LineBreak;
		First_DarkSanctum_Theme_Choice;

to First_DarkSanctum_Theme_Confirmed:
	say "     'Well I can't say that I'm all that shocked by your choice, seeing as what you will eventually become. With that decided, what's next on the list?' The shade turns its attention back towards the monolith, its long clawed fingers clicking together in a contemplative manner as it seems to be analyzing the huge stone tablet. 'Hmm, there are only two other topics that are in need of immediate attention. The first is a power base: you are going to need somewhere to build up your strength, somewhere with a natural connection to darkness.' Opening your mouth to speak, you comment on the fact that there is a burnt out church nearby that already has demons dwelling within. 'No, that simply won't do. Remember that this path will lead to you gaining many new enemies, and as such, you will need a much more defensive position. Lucky for you, I have already found the perfect location!' The creature's excitement puts your nerves on edge, but just the same, you ask the shadow to continue.";
	say "     'It just so happens that a huge demonic relic has arrived in the east part of the city, an ancient citadel that is the very incarnation of evil. It must have risen out of Hell from underneath the lava beds there. A word of warning though, it did not arrive alone... It would seem that a few demons must have been attempting to ride it as a means to breach your realm.' Rolling your eyes, you ask the shade if they are expecting you to fight your way through an army of demons to claim this relic? 'Well of course, but like all things in this world, it shall be easier said than done. The demons that [']were['] inhabiting the citadel well... they're all dead. Which is great news for you, however something much more dangerous has decided to claim the building for itself.' The shade comes closer and wraps its arm around you, and an extreme feeling of nausea floods throughout your stomach.";
	WaitLineBreak;
	say "     The creature quickly pulls its hand back and retreats a bit further away. 'Sorry about that, little [master]. I always forget that mortals don't do well with my touch. Anyways, as I was saying, there are many different types of hells, each with their own unique outlook on the world of mortals. The beast that has claimed our citadel is from one such place. His name is Shuten Dji, an oni of considerable power. Thankfully for you though, his name says it all as he is quite the drunkard. You will have to approach this enemy with slightly different methods than you're probably used too. The truth is that this beast can't be outright killed... well it can, but he would simply pop right back up. Trust me, he's been killed before and that didn't stop him in the slightest. Also something to keep in mind is that he will be guarded by his troops of fellow oni and kijo, so don't underestimate this endeavor.'";
	say "     Rising high up into the air, the shade begins to explain the next aspect of what you will need for victory. 'Besides claiming the citadel, you will be needing to... acquire five very important allies to our cause. The first two are already in your possession, that brute and his former master will do nicely, however you will also need to find another [']natural['] demon. That should be your first goal since they will most likely prove useful in taking the relic. Afterwards though, we will need two demons that were born human, so keep an eye out on your travels. You will also have to force ascension onto the five at some point. Think of it as a form of... demonic evolution that will increase their power. To do this, you will need to share your strength with them, either by blood or sexual fluids, your choice. As each one awakens, they will become your lords of Hell, an essential piece of the puzzle.' Gliding down, the shade floats right in front of your face 'So, what do you think? Do we have a deal?' Somehow, everything about this question, makes it feel as if this is a moment that you will never be able to take back.";
	LineBreak;
	say "     [bold type]Do you wish to agree with what the shade has proposed?[roman type][line break]";
	say "     ([link]Y[as]y[end link]) - Yes, the idea of gaining more power does excite you.";
	say "     ([link]N[as]n[end link]) - No, you want nothing to do with this shade or its plans.";
	if Player consents:
		LineBreak;
		say "     The creature begins to bounce around in excitement, its claws clicking as it claps and laughs manically. Once the shadow calms down a bit, it stops and tilts its head down towards one of the mouthed tentacles. Even though it is whispering, you are still able to make out what is being said. 'Yes, of course I remember, but I wanted to make sure that the mortal was willing to play the role intended for them.' Straightening back up, the shade looks directly at you, its normally wobbly eyes now completely still. 'I have been watching you for a while now, and I have seen the way you deal with situations. To be honest, it leaves much to be desired, so I have one final question for you. If you are able to claim the mantle of Master of Hell, what type of master do you think that you will become?'";
		LineBreak;
		DarkSanctum_Master_Choice;
	else:
		LineBreak;
		say "     Taking a single step away from the shade, you comment on the fact that you want nothing to do with any of this and demand that you be returned to the library. 'How dare you!? You miserable little insect! I offer you power, the ability to forge a new world and this is my thanks!? Consider yourself lucky that I don't simply trap you here and allow your physical body to rot and die!' With that, you are flung backwards into the darkness, the feeling of tentacles all around you, their harsh grip making it hard to breathe. A strange static sound starts to build from within your mind until it finally becomes almost painful and jolts you completely upright in shock. Glancing around, you realize that the colors are back to normal, and in your attempt to get up, you almost fall off the cot. Rushing to the door and wrenching it open, you almost run right into Brutus's firm back and quickly wrap your arms around the demon brute as he turns around to face you. Finally pulling back, you happily inform him how grateful you are to see him, but the only response you are met with is a single raised eyebrow followed by a look of confusion.";
		say "     'Why can't I reach into your mind, [master]? Have you finally learned how to keep others out?' Confused yourself, you just stare at Brutus with your mouth hanging open, that is until you notice something different about his throat... Your bite mark is gone. The brute's face quickly clouds over with something akin to fear, the facial expression looking alien and out of place on your dark knight's visage. A ear-splitting roar bursts from Brutus's mouth, causing you to take a reflexive step back. Before you're able to ask him what's wrong, he interrupts you, 'What did you do?! My whole body feels like it's on fire again! You promised that the pain would end!' You don't know what to say, your jaw hanging open as you think of how to respond. 'You are liar!' Watching as the demon attempts to formulate his words, it's almost like the pain is too great for him to focus. 'You're not [master], you prey!'";
		WaitLineBreak;
		say "     A clawed hand swipes down at your face, but before you're able to duck down, it stops just short of colliding. The look of rage and betrayal never wavers from the demon brute's intense gaze. 'I... will... destroy... you!' With one final roar, Brutus bursts into a cloud of purple smoke and is sucked back into the pendant that you had promised that he would never have to return to. Trying to make sense of what exactly just happened, you're once again pulled from your thoughts as Skarnoth rushes down the stairs of the bunker. '[Master], what was that sound?! It sounded like Brutus was shouting about something.' Opening your mouth to explain what just happened, it quickly snaps shut as your eyes lock onto the royal incubus's throat... His mark is gone as well. '[Master], what's wrong? You don't look so good.' A strange flash washes over Skarnoth's face, just like it did with Brutus, causing his eyes to roll into the back of his head briefly. 'I... don't feel very well, [master].'";
		say "     The demon slumps to the floor and ragged breaths start to escape his chest. Remembering what happened with Brutus and how whatever gift that was passed onto him must have reverted somehow, you quickly leap into action and reach out to help the formal royal to his feet. Doing your best, you attempt to get the demon up the stairs of the bunker and back to his chair as fast as possible. Once he's seated, his breathing finally begins to return to normal, although he still appears slightly out of it. Not knowing what else to do, you start to explain to Skarnoth what had happened with Brutus and then to himself. 'Wait, Brutus? You mean that drooling beast that you enslaved?' You gape slightly and then proceed to ask why he would say that about someone that he apparently was able to form a bond of brotherhood with. 'A bond of brotherhood? You must be joking, [master]. I've never even talked with that animal.' It's almost as if the submissive demon somehow forgot everything that took place after you began to place those bite marks the hellspawn in your possession.";
		WaitLineBreak;
		say "     While processing what all of this could mean, a voice calls out from behind you, 'Is everything alright?' It's Elijah, his expression warm while meeting your gaze, but quickly turns cold as he takes in Skarnoth. 'You had best be staying out of trouble, demon, because if I find out otherwise, I will put you down before you can do any further damage.' The exhausted incubus merely mocks the angel and waves him off. Just as it looks as if Elijah's about to retaliate, you step in and explain to the angel that everything is fine and that you were simply checking in on him. With a shake of his head, the divine being's only response is, 'Don't pay these demons any mind. Remember that they are nothing but monsters, incapable of actually feeling anything other than the desire to destroy everything that they can.' With that, the angel gives you a slight smile and exits the room, leaving you to wonder if what Elijah said is true. A darker thought is quick to follow. If that's true then what does that make you, someone who gave them hope and a possible reason to feel, only to somehow rip it all away and erase those moments...";
		remove "Master's Bite" from traits of Brutus;
		remove "Master's Bite" from traits of Skarnoth;
		now HP of The-Voice is 99;
		move player to half-renovated room;
		now A Dark Presence is resolved;
		now energy of The-Voice is turns; [saves when this event was done]

to DarkSanctum_Master_Confirmed:
	say "     The shade seems to be contemplating your choice, sharp claws tapping against the side of the creature's head as a slimy tongue rakes across the grotesque fangs protruding from its mouth. 'Hmmm, well that's all well and good, but before that can become a reality, you might need a little... push in the right direction!' With those words, the shadow smiles as a dark cloud begins to pour from within its maw. Even though you try to force your body to move, you stay rooted to the spot as the fog surrounds your form. As it swirls around you, it begins to lift your body off the ground and seems to be focusing in on your face. You attempt to struggle against the invisible force restraining you, but even then, the particles of darkness begin to seep into every orifice you have. Thankfully, it ends almost as quickly as it began, and your body drops back to the ground. You are left in coughing fit, spewing the remains of the black mist from your lungs.";
	say "     [if morale of The-Voice is 1]'You had better have a [']very['] good reason for assaulting me like that, you disgusting vermin!'[else if morale of The-Voice is 2]'So you decided to make your move then, trickster? I hope you're ready for the fight of your life!'[else if morale of The-Voice is 3]'You fucking piece of shit. I hope you understand that now I'm going to break you until there is nothing but a husk left!'[end if] On reflex, you clap a hand over your mouth to silence yourself, shocked by the voice that just spilled out. While you may have meant every word, the sound was slightly off, almost as if it were infused with something... extra. The shade seems to find your reaction amusing at the least, well if its cackling is to be trusted. 'Buhahaha, what did you think that evil was just something that happened? While yes, you did technically decide to follow the path of evil, all Masters of Hell must receive a small infusion of the original Heart of Darkness! If you don't, then your mortal body would eventually shrivel up and turn to dust, I mean your body is hardly built to handle that much power!'";
	WaitLineBreak;
	say "     While in a strange way that may make sense, at least the part about the whole [']mortal power combo['] thing, you still manage to give the shadow a dirty look for not warning you about what would be happening. 'Oh don't bother trying to make me feel guilty for what I did. Remember, evil here. I don't feel guilt, haha! Besides, don't you have something else you should be worrying about? Like, I don't know, convincing a [']natural['] demon to join your cause? You did mention something about a burned up church if memory serves, but don't worry, we will have much more to discuss later, after you have adapted to the darkness within you a bit more.' With that, the shade gives you a final maniacal smile, and with its boney hand opening up and facing you, you're immediately slammed backwards. Once again, you're surrounded by the darkness of the door, but this time rather than feeling suffocated, you feel strength welling up within you.";
	say "     Sitting up with a start, you realize that you're back in the bunker. All of the colors are back to normal and the place has the same familiar feeling that you have grown accustomed to. Getting up off the cot, you slowly make your way to the door and turn the handle with some trepidation. Once the door creaks open, you are met with Brutus's large body turning to face you. 'Is everything all right, [master]? You were making strange sounds in your sleep and... something seems different about you, what happened?' You can't help the dark smile that forms on your lips. 'Brutus, get ready to head out! We have some things to take care of. Oh and make sure Skarnoth is ready as well... We're going to pay a nice little visit to a church.' The look on Brutus's face is one of confusion, but he doesn't object to your orders and leaves to make the preparations. Meanwhile, you start to contemplate how best to deal with Lilith[if PlayerMet of Atticus is true] and Atticus[end if]...";
	if player is not dominant:
		FeatGain "Dominant";
	now HP of The-Voice is 1;
	now A Dark Presence is resolved;
	now energy of The-Voice is turns; [saves when this event was done]

Part 1 - Dark Sanctum Gender Setting

[Check The-Voice file in Luneth's folder]

Part 2 - Dark Sanctum First Theme

[Check The-Voice file in Luneth's folder]

Part 3 - MoH Type

[Check The-Voice file in Luneth's folder]

Section 4 - Fourth Event

[
Variables;
	say "     Right before you walk into the half-renovated room, you hear the familiar voices of both Skarnoth and Brutus, apparently in the middle of some sort of disagreement. 'I'm not going Brutus and that's the end of it! If I leave these walls, you know exactly what will happen to me. With my powers gone, I will be viewed as prey for the other hellspawn that are still left in the city!' The royal incubus's voice has an edge of desperation to it, as if at that exact moment he is imagining everything that those demons would do to him in his weakened state, however the demon brute is quick to silence him. 'You think me and the [master] are not strong enough to protect you?' Part of you wants to rush into the room to put this matter to rest, but there is another part of you, a part that wants to know if Skarnoth trusts you as completely as he claims.";
	if morale of The-Voice is 1: [Royal MoH: spying]
		say "     [SkarnothSpy01]";
		LineBreak;
		say "     [bold type]How should you handle Skarnoth's emotions?[roman type][line break]";
		say "     [link](1)[as]1[end link] - Treat him as an ally.";
		say "     [link](2)[as]2[end link] - Treat him as a lover.";
		say "     [link](3)[as]3[end link] - Treat him as a slut.";
		now calcnumber is 0;
		while calcnumber < 1 or calcnumber > 3:
			say "Choice? (1-3)>[run paragraph on]";
			get a number;
			if calcnumber is 1 or calcnumber is 2 or calcnumber is 3:
				break;
			else:
				say "Invalid choice. Type [link]1[end link] to ally, [link]2[end link] to lover or [link]3[end link] to slut.";
		if calcnumber is 1: [ally]
			LineBreak;
			say "     [SkarnothAlly01]";
		else if calcnumber is 2: [lover]
			LineBreak;
			say "     [SkarnothLover01]";
		else if calcnumber is 3: [slut]
			LineBreak;
			say "     [SkarnothSlut01]";
	else if morale of The-Voice is 2: [Commander MoH: choice of either]
		LineBreak;
		say "     [bold type]Do you want to listen in on the conversation?[roman type][line break]";
		say "     ([link]Y[as]y[end link]) - Yes, some things can only be learned when no one knows you're there.";
		say "     ([link]N[as]n[end link]) - No, you have no need to hide your presence.";
		if Player consents: [Commander MoH version of Royal scene]
			say "     [SkarnothSpy01]";
			LineBreak;
			say "     [bold type]How should you handle Skarnoth's emotions?[roman type][line break]";
			say "     [link](1)[as]1[end link] - Treat him as an ally.";
			say "     [link](2)[as]2[end link] - Treat him as a lover.";
			say "     [link](3)[as]3[end link] - Treat him as a slut.";
			now calcnumber is 0;
			while calcnumber < 1 or calcnumber > 3:
				say "Choice? (1-3)>[run paragraph on]";
				get a number;
				if calcnumber is 1 or calcnumber is 2 or calcnumber is 3:
					break;
				else:
					say "Invalid choice. Type [link]1[end link] to ally, [link]2[end link] to lover or [link]3[end link] to slut.";
			if calcnumber is 1: [ally]
				LineBreak;
				say "     [SkarnothAlly01]";
			else if calcnumber is 2: [lover]
				LineBreak;
				say "     [SkarnothLover01]";
			else if calcnumber is 3: [slut]
				LineBreak;
				say "     [SkarnothSlut01]";
		else: [Commander MoH version of Tyrant scene]
			LineBreak;
			say "     [SkarnothBurstIn01]";
			LineBreak;
			say "     [bold type]How should you handle Skarnoth's emotions?[roman type][line break]";
			say "     [link](1)[as]1[end link] - Treat him as an ally.";
			say "     [link](2)[as]2[end link] - Treat him as a lover.";
			say "     [link](3)[as]3[end link] - Treat him as a slut.";
			now calcnumber is 0;
			while calcnumber < 1 or calcnumber > 3:
				say "Choice? (1-3)>[run paragraph on]";
				get a number;
				if calcnumber is 1 or calcnumber is 2 or calcnumber is 3:
					break;
				else:
					say "Invalid choice. Type [link]1[end link] to ally, [link]2[end link] to lover or [link]3[end link] to slut.";
			if calcnumber is 1: [ally]
				LineBreak;
				say "     [SkarnothAlly01]";
			else if calcnumber is 2: [lover]
				LineBreak;
				say "     [SkarnothLover01]";
			else if calcnumber is 3: [slut]
				LineBreak;
				say "     [SkarnothSlut01]";
	else if morale of The-Voice is 3: [Tyrant MoH: Burst in]
		say "     [SkarnothBurstIn01]";
		LineBreak;
		say "     [bold type]How should you handle Skarnoth's emotions?[roman type][line break]";
		say "     [link](1)[as]1[end link] - Treat him as an ally.";
		say "     [link](2)[as]2[end link] - Treat him as a lover.";
		say "     [link](3)[as]3[end link] - Treat him as a slut.";
		now calcnumber is 0;
		while calcnumber < 1 or calcnumber > 3:
			say "Choice? (1-3)>[run paragraph on]";
			get a number;
			if calcnumber is 1 or calcnumber is 2 or calcnumber is 3:
				break;
			else:
				say "Invalid choice. Type [link]1[end link] to ally, [link]2[end link] to lover or [link]3[end link] to slut.";
		if calcnumber is 1: [ally]
			LineBreak;
			say "     [SkarnothAlly01]";
		else if calcnumber is 2: [lover]
			LineBreak;
			say "     [SkarnothLover01]";
		else if calcnumber is 3: [slut]
			LineBreak;
			say "     [SkarnothSlut01]";
	say "     Returning back up to the demons, you're pleased to see that they appear ready to head out. Deciding that it would be best to have your companions know what to expect, you begin to explain your mission out to the desecrated church. Starting off, you attempt to tell the two of them about the shade that you encountered, only to find that the words have somehow become stuck in your throat. Each time you attempt to the creature all that you can produce is random sounds that have no meaning, this of course leads to both Skarnoth and Brutus staring at you as if you had grown a second head. Taking a deep breath and clearing your throat, you choose to ignore that for the moment and instead move on to the next topic, 'A relic has apparently risen from hell and our goal will be to claim it for ourselves, however before we attempt that, we will heading out to an old church that has seen better days. The reason we're going there is to gain some more help, a succubus named Lilith has taken up residence there [if PlayerMet of Atticus is true]as well as my son Atticus and we will need their help to get the relic[else]and we will need her help to get the relic[end if].";
	say "     At Lilith's name you notice that Skarnoth's back goes rigid and an uneasy look forms on his face. After what you saw in the dreamscape you can't really blame the former royal, this is someone that he used to hold power over and now in his weakened state who knows what will happen.[if PlayerMet of Atticus is true] Brutus's voice filters through your mind, [italic type]'An heir to the throne has already been born?'[roman type] The words are said barely above a whisper, but a look of pride crosses over Brutus's face at the mention of your son.[end if] Looking both demons in the eyes, you explain to them that this shouldn't be a complicated mission and that you will be the one to deal with Lilith. Skarnoth speaks up at those words, '[Master], if you plan on being the one to deal with her, then why do you need us to go with you?' An honest question, but after you becoming tongue tied while attempting to mention the shade, you decide it would be best to avoid risking embarrassing yourself again and simply say, 'You will see.'";
	WaitLineBreak;
	say "     As the three of you are about to finally make your exit, a familiar voice echoes through the library, '[if Player is not defaultnamed][name of Player][else]Hello[end if]!? anyone in here?!' The voice is unmistakably that of Elijah, a quick glance to Brutus sees his body instantly become translucent as he reverts to his smoke form and takes refuge inside the pendant that once served as his prison. Skarnoth makes no move to hide his movements, instead he simply crosses his arms in annoyed fashion and rolls his eyes at the idea of being interrupted by the angel. As Elijah enters the room you are met with his normally cheerful smile, that is until his gaze falls on the former Master of Hell, 'I was just checking to see if you were around, I didn't expect to find you spending time with that... thing.' The look of disdain of the heavenborn's face couldn't be more evident if he tried. From within your mind Brutus comments on the current situation, [italic type]'[Master], shouldn't we be making our way to the church now? Wasting time dealing with the angel will get us nothing but a headache.'[roman type]";
	LineBreak;
	say "     [bold type]How should you deal with Elijah?[roman type][line break]";
	say "     [link](1)[as]1[end link] - Act friendly.";
	say "     [link](2)[as]2[end link] - Act amorous.";
	say "     [link](3)[as]3[end link] - Act dismissive.";
	now calcnumber is 0;
	while calcnumber < 1 or calcnumber > 3:
		say "Choice? (1-3)>[run paragraph on]";
		get a number;
		if calcnumber is 1 or calcnumber is 2 or calcnumber is 3:
			break;
		else:
			say "Invalid choice. Type [link]1[end link] to friendly, [link]2[end link] to amorous or [link]3[end link] to dismissive.";
	if calcnumber is 1: [friendly]
		LineBreak;
		say "     Walking up to the winged man, you place a hand on the side of his arm with a warm smile on your lips, 'Come on Elijah, you and me both know that no one is above being saved.' The angel's face scrunches up confusion, with just a hint of a pout. Not wanting to let him get the upper hand in the conversation you quickly continue speaking, 'I thought it might do Skarnoth some good to see the destruction of the city, to see what the path of evil leads to. Maybe this could be a turning point, a moment to finally have to see the repercussions of carnage.' Elijah's azure eyes soften at your explanation, 'I see, well I think it's wonderful that you want to help him see the light, just... if this doesn't work, promise me that you wont take it too personally, alright?' With that both you and Skarnoth make to leave the room, with a brand new type of smile forming on your face while your back is to the angel.";
	else if calcnumber is 2: [amorous]
		LineBreak;
		say "     Walking up to the winged man, you reach out and grab him by the back of his head and pull him into passionate kiss. The startled angel's eyes go wide and his wings spread out in a surprised manner, however both his eyes and wings quickly begin to tremble under your ministrations, finally his azure eyes close and he submits to your passions. Enjoying the brief moment of control over the heaven-born, you eventually pull back and look at his face, eyes still closed and lips still poised for the kiss. 'I thought it might do Skarnoth some good to see the destruction of the city, to see what the path of evil leads to. Maybe this could be a turning point, a moment to finally have to see the repercussions of carnage.' While Elijah quickly nods his head in the affirmative, you can tell that the meeting of your mouths is really the only thing that has filtered through his mind. With that both you and Skarnoth make to leave the room, with a brand new type of smile forming on your face while your back is to the angel.";
	else if calcnumber is 3: [dismissive]
		LineBreak;
		say "     Walking up to the winged man, you attempt to simply walk past him, but he instead side steps to block your path, 'Umm haha, you can see me can't you? I haven't somehow become invisible have I?' Elijah's attempt at a joke and the warm look in his gaze do nothing to change your mind, looking him directly in his azure eyes you open your mouth and the venom is palpable, 'Get out of my way! Incase you hadn't noticed, I'm the one in charge and I don't answer to you, do you understand?' The look on the angel's face would be comical if you weren't already annoyed by his presence. 'I'm sorry, I wasn't trying to make you upset, I was just worried about you is all...' You continue on your path with Skarnoth following quickly behind you, the feeling that it is important to make sure that the heaven-born understand his place in the pecking order sated.";
	say "     As soon as the two of you are outside of the library, a deep sigh of relief floods through your body with the knowledge that you doubt Elijah suspects anything. Brutus emerges from within the pendant, the large demon giving his whole body a violent shake as soon as he is once again fully formed. With the demon brute's back to you, it's hard not to notice the way his huge purple ass shakes and jiggles. Glancing over at Skarnoth from the corner of your eye, you notice that his gaze is transfixed on what could be confused with an impromptu twerking moment. When Brutus finally turns around to face the two of you a strange look of confusion passes over his face at the expressions on your faces, 'What's wrong [master]?' Looking over at the former royal you can see the mirth in his lava eyes and the two of you burst into a fit of laughter that has you holding your sides. The demon Brute still has no idea what is so funny and actually looks to be becoming slightly annoyed, 'Hmph, well you two seem way too amused for some reason, anyway we should start heading out and stop wasting time.'";
	WaitLineBreak;
	say "     With that Brutus turns to lead the way, which in turn puts his bare ass back on display, which only serves to bring the laughter back with a vengeance. Turning his head sidewise slightly to look at what must appear to be two nut-jobs, the brute rolls his eyes and walks back over, before simply scooping the two of you up and throwing each of you over a shoulder. However, this is not the smartest choice as you and Skarnoth are embracing the moment of immaturity. With your heads hanging over his back you are presented with the source of your amusement and eventually start a mini competition of reaching down and forcing each cheek to jiggle every time the demon takes a step. Brutus hardly seems to understand what is so funny about your antics, well at least going by his growls... and the fact that his tail will randomly whip around smacking each of your hands. Sadly this devolves into a new game, the name being: make the brute spank himself.";
	say "     After about ten minutes of walking, Brutus finally sets the two of you down, the laughing fit that you both experienced finally dying down a bit. 'Alright [master], now that you have calmed down, what caused all that laughter? I don't remember seeing you drink any liquor and I didn't hear anything said that was amusing enough to cause that reaction.' While Brutus is definitely a being of darkness, it's refreshing to see that even [']he['] still has a small amount of innocence... at least in this particular situation. The demon brute's crimson eyes look at you expectantly, you doubt that simply brushing him off will help the situation. The question is how best to approach this, in the past you've learned that Brutus is at least somewhat self conscious of his appearance.";
	say "     [bold type]How do you wanna let Brutus know what was so funny? [roman type]";
	LineBreak;
	say "     ([link]Y[as]y[end link]) - Simply explain the situation and go from there.";
	say "     ([link]N[as]n[end link]) - Embrace your inner pervert and [']showcase['] what exactly was so funny.";
	if Player consents:
		LineBreak;
		say "     With a smile creeping up on your face, you decide the best way to handle this is to simply be honest and explain the joke. 'Brutus, when you emerged from the pendant and appeared in front of us, what was the first thing that you did?' The demon brute thinks on this for a moment, opening and closing his mouth a few times, he finally answers you, 'I came out and shook off the remaining miasma, other than that, I didn't do anything strange.' Obviously noticing that your eyebrows raised at that information, he continues talking, 'The magic used on the pendant was made to lower my strength, at first the miasma was in the air constantly surrounding me, but after you marked me, it started to become a light powder that could easily be shaken off.' Well that's definitely something that you should have known about sooner, but there will be time to get into that later. Calmly you tell the demon that after stressing about having to deal with Elijah, your adrenaline was a little higher than usual and when he appeared in front of the two of you, he did a short impromptu twerking show.";
		say "     'Twerking? [Master], what is that?' Now it's your turn to open and close your mouth like a fish, glancing to the side and Skarnoth, you see a similar look of confusion on his face as well. This of course leads to explaining the finer aspects of twerking to both demons, Skarnoth seems to find the whole idea incredibly humorous and begins to chuckle at how silly mortals can be. Brutus however doesn't seem to be enjoying the new information, 'So you both were laughing at me? At the fact that you think my butt is too big?' The look on his face his hard to read, but it definitely doesn't look please. You attempt to calm your dark knight down and explain that it was just a silly moment, however Brutus brushes your assurances aside and comments on the fact that your group really should be heading to the church instead of just standing around. This conversation didn't go quite how you planned, but he's right and besides you can always talk to him later in private to attempt a better explanation.";
	else:
		LineBreak;
		say "     [BrutusTwerkPervert01]";
	WaitLineBreak;
	say "     As the three of you finally get close to the burned out church, you realize that the city around you is silent, almost eerily so. Skarnoth is the one that finally breaks the silence, '[Master], I don't like this, I mean... doesn't everything about this silence seem like a trap?' Wanting to keep all of your senses on the matter at hand, you simply nod your head in acknowledgement. A scream fills the air around your group, causing the three of you to turn in the same direction, that of the church itself. Brutus eventually speak up, '[Master], didn't you say that the succubus was needed to claim the relic? If so, then I recommend we hurry, that scream didn't sound like a good sign.' The three of you start running for the church, however now it all makes sense, the silence of the area is more than likely due to whatever is taking place within those charred walls.";
	say "     As your team enters the courtyard and make a beeline for the stairs leading up into the building, a shadow falls across the ground in front of you causing you to stop dead in your tracks. Looking up, you see a graceful and lithe demon jump from the roof of the church, his leathery wings spreading out and begins to glide through the air. When his form finally connects with the ground he instantly attempts to intimidate you, 'Who the hell do you think are to interrupt mo-, wait... DADDY?!' Before you can open your mouth to respond, you're immediately grappled with a tight bear hug, 'Daddy, I'm so glad you came to visit me! You have no idea how boring it is to have to guard the door while [']she's['] busy in there and doesn't wanna be disturbed.' The fact that your son is actually using air quotes as he speaks brings a smile to your lips and return the embrace as you decide to ask him what Lilith is doing that she would want that sort of privacy for.";
	WaitLineBreak;
	say "     'Wellll, see this guy showed up, and at first he looked pretty harmless. Actually he kinda reminded me of one of the guys from a magazine I saw awhile ago.' Knowing Atticus, it was more than likely a porn mag, still holding him close, you ask him if the guy looked like one of the [']stars['] in his magazines, however this causes him to pull back with a dirty look on his face. 'Of course not! This guy wishes that he could be like one of those studs haha. No, he looked like one of the guys in those machine magazines, ya'know where they build stuff? He even had those really big glasses and suspenders! Although the cape he was wearing was kinda strange.' You're still stuck on the thought of Atticus looking at any type of science magazine, 'Hey now, I know that look and I can have more than just sex on the brain, in fact I have [']many['] interests.' A pointed finger collides with your chest as he attempts to defend himself.";
	say "     'Anyway, so I went up to him and tried being nice, and you know what he said? [']Out of my way fag, I have come to claim your slut as my concubine![']' You can't help but chuckle at your sons attempt of doing an imposing and threatening voice, this of course leads to Atticus rolling his eyes, but the smile on his face betrays him. You ask him why exactly was he trying to be nice to this guy in the first place? 'Oh, cuz if he can build stuff, then he could prolly build me a super sweet fuck machine!' You don't have the heart to tell him that it still sounds like he has sex on the brain, 'Can I finish my story now without all the questions?' Making a motion of zipping your lips, you nod for him to continue, 'So yeah, he was an asshole, he went in, there was a lot of screaming and then [']she['] came out and told me to keep people from bothering her... mphtch' While it's muffled and you can't quite make out the last word that was said, it sounded an awful lot like bitch. At that moment Atticus seems to realize that you aren't alone and looks over your shoulder at both Skarnoth and Brutus with a curious look on his face, 'Who are those guys dad?'";
	say "     [bold type]How should you respond to Atticus? [roman type]";
	LineBreak;
	say "     ([link]Y[as]y[end link]) - Refer to them as your underlings.";
	say "     ([link]N[as]n[end link]) - Refer to them as your brother-in-arms.";
	if Player consents:
		LineBreak;
		say "     A smile forms on Atticus's lips, 'So like, you own them? That's kinda hot.' Your incubus son then saunters over to inspect the demons that you have claimed as your property. Looking at your servants, you can see that neither of them seem all that affected by your words, although Brutus's brow does furrow for a moment in disappointment before quickly returning to normal. Atticus begins to poke and prod the other two hellspawn, which the demon brute doesn't seem to mind to much, however the former Master of Hell is less than happy about all the touching. 'Hey daddy? Since you like, own them and everything, is it alright if I use them?' A laugh erupts from your chest at how truly insatiable your offspring is, 'Tell ya what, how about I go deal with your mother, and I'll think on it?' The incubus pouts at your response, but nods his head in acknowledgment, well at least until he notices the marks on the other demons jugulars.";
		say "     'Hey, what are these weird marks on their necks?' You explain to him that those are your bite marks and that they symbolize your ownership over the two hellspawn. 'Wait... so your bite can do that? You wouldn't bite me like that would you?' The look on your son's face is an odd mix of excitement and fear, you pull the young man close to you and whisper in his ear, 'Maybe I would, I bet that you'd be pretty tasty!' With that, you joking begin to make biting sounds into the soft part of the incubus's throat, 'No daddy, don't make me into a slave, haha!' The two of you share a familial hug as you both finish laughing, 'Alright son, you stay out here with Skarnoth and Brutus, they will keep you safe alright?' Atticus responds with a roll of his eyes, 'Dad, you know I'm an adult right? I can take care of myself!' With a chuckle you send out a mental message to your demons, [italic type]'You two keep him safe, and one wrong move in touching him... will not go unpunished.'[roman type] Brutus nods firmly while Skarnoth scoffs, but you can tell that he knows that you're not joking.";
	else:
		LineBreak;
		say "     A smile forms on Atticus's lips, 'So their sorta like my uncles then? That's kinda cool.' Your incubus son then saunters over to inspect the demons that you have claimed as part of the family. Looking at your allies, you can see that both of them were affected by your words. Skarnoth has an annoyed look on his face, but the reddening of his cheeks betrays his true feelings about being seen as family. Brutus though, you can't remember ever seeing such a look of pride on his demonic visage, while most would probably assume that he was furious, you know better, this is the look of one truly ecstatic demon. Atticus begins to poke and prod the other two hellspawn, which the demon brute doesn't seem to mind, even going so far as to awkwardly pat the much smaller incubus on the head, which is rewarded with a beaming smile from your son. The demon brute's fanged mouth opens in a smile and his voice comes out as a soft growl, '[Master], your offspring is certainly a curious one isn't he?'";
		say "     The former Master of Hell is less than happy about all the touching, every time Atticus attempts to poke him, Skarnoth is quick to lightly slap his hand away, however this simply ends up amusing the incubus and brings his more mischievous side to the forefront and the younger demons seems to enjoy annoying the elder. A vein begins to pulse on the formal royal's forehead, '[Master], there is no way that this annoying little creature could share your bloodline!' This however causes Atticus's smile to disappear and become replaced with a vicious snarl, 'Oh yeah?! Well at least I don't have some huge set of horns that make me look like some big dumb cow slut!' Placing a finger to each of his temples Skarnoth attempts to respond to Atticus in a frustrated voice, 'These horns are a symbol of my power and showcase my demonic pedigree, not that a tiny brat like you would understand.'";
		WaitLineBreak;
		say "     You can see Brutus off to the side rolling his eyes and you're fully prepared for the incubus to retaliate, but he simply rubs his much smaller horns, 'Well I'm still growing so that's why my horns are smaller, just you wait, my horns will make yours look like little pegs!' You can tell that the topic got under your sons skin, Atticus then walks back over to you and without thinking much on it you wrap him up in your arms. Glancing back at Skarnoth you see an almost pained smile form on his lips and through the mental link ask him if he's alright, [italic type]'Of course [master], he just... reminds me of someone is all.' [roman type]Once the incubus finally begins to calm down, he looks up into your face, 'Hey daddy? Since their part of the family, is it alright if I play with them?' Looking up at the other two demons a laugh erupts from your chest at the look of curious confusion on Brutus's face and the look of complete horror that graces Skarnoths, 'Tell ya what sport, how about I go deal with your mother, and while I'm taking care of that you can spend some time bonding with Brutus and Skarnoth.'";
		say "     With a huge smile on his face the incubus quickly runs off, to where, you have no idea. But it gives you a chance to talk with the other demons, 'Alright guys, I'm gonna go deal with Lilith, you guys keep an eye on Atticus for me. And not a hair on his head had better be out of place when I come back out. Also keep your dicks to yourselves got it?' Brutus looks mortified that you would even feel the need to mention that last part, but Skarnoth simply inspects his claws and comments that he has higher standards. Before you can reprimand the former royal for his response, Atticus comes running back with a large box... filled with an ungodly amount porn. Once the incubus is closer he finally sets the box down, he rushes over to his [']uncles['] and begins to pull them closer. This just so happens to be the moment that he notices the marks on the other demons jugulars.";
		WaitLineBreak;
		say "     'Hey, what are these weird marks on their necks?' You explain to him that those are your bite marks and that they symbolize the bond that the three of you share. 'Wait... so your bite can do that? Can you bite me too? I wanna be part of the team!' The look on your son's face is one of pure excitement, you pull the young man close to you and whisper in his ear, 'Maybe I would, I bet that you'd be pretty tasty!' With that, you joking begin to make biting sounds into the soft part of the incubus's throat, 'No daddy, don't nibble me, make me into a member of your super team, haha!' The two of you share a familial hug as you both finish laughing, 'Alright son, you stay out here with Skarnoth and Brutus, they will keep you safe alright?' Atticus responds with a roll of his eyes, 'Dad, you know I'm an adult right? I can take care of myself!' With a chuckle you look over where your unorthodox family sits on the ground surrounded... by porn.";
		say "     Atticus then proceeds to explain the game that they will be playing, 'Alright the game is called [']Nut or Not['], you just go through and place these stickers on the ones you would fuck!' The stickers are obviously old and covered in dust, some are hearts and others are stars, you can't stop yourself from asking if their is a difference, which leads to the incubus's face gaping like a fish 'Of course there's a difference daddy! Stars are for people that would be decent cumdumps and hearts are for ones with harem potential.' With that your son peels a heart sticker off and with a smile places it against Brutus's pec, 'See like that?' Brutus's expression is priceless, the normally dangerous and clawed hand gently feels the pathetic sticker on his skin, but treats it like it's something precious. While the moment does tug at your dark heartstrings, that quickly dissipates as Atticus peels two star stickers off and slams them down on both of Skarnoth's nipples.";
		WaitLineBreak;
		say "     The former royal is not amused, 'What the hell are these for?' The incubus shoots him an impish grin, 'Oh those weren't to say you would be a decent cumdump, I've just heard that cow sluts leak a lot, so I thought that I would help you out by putting a stopper there.' Skarnoth looks ready to spit bullets, but Brutus nods his head in a sage like way, either because he is humoring your son, or because now he is actually starting to wonder if Atticus is right about Skarnoth being some sort of demonic cow. Shaking your head at the image they all make, you can't keep the smile off of your face and tell them, 'You boys be good while I take care of business alright?'";
		say "     Brutus and Atticus nod their heads as they inspect the porn mags, while this causes Skarnoth to finally snap and stand up instantly, 'I was a Master of Hell goddamit, I refuse to play babysitter to this... thing!' His explosion is halted though by your son flashing a favorite star of his, which derails the former royal, causing him to sit back down and to further [']inspect['] the page, 'That... well that can't be natural at all.' With those parting words you begin to make your way towards the building, the thought of what you could find within making you slightly anxious.";
	WaitLineBreak;
	say "     As you pass through the charred ruins of the church, you are quickly surrounded by darkness and have to attempt to feel your way around the interior. Eventually you're able to catch a glimpse of candlelight just ahead of you and make your way towards it, finally entering the inner sanctum of the building, you are surprised by the sight that awaits you. You see Lilith standing off to the side, her stance and posture reminding you more of a regal queen, rather than just a simple succubus. Then again, just with what little you have learned about her through the memories that you've experienced, it's doubtful that there could be anything really [']simple['] about her. That's not the surprising part though, that would be what is laying on the ground a few feet away from her. Looking down at the... [']object['], it's basically just a huge cock laying on the ground, the only movement from it is an occasional throb. At first it appears to be one of those creepy cock cannon creatures, but as you peer closer, you realize that this thing still has a body underneath it's massive prick.";
	say "     The look on Lilith's face is one of annoyance and she leisurely strides over to the person on the floor, her heels clicking with each step towards... well as much of a person as is left that is, 'What's wrong stud? I thought you were going to come in here and claim some slut as your concubine, at least that's what you told my son...' The man starts to struggle from underneath his oversized appendage, while slightly muffled you are still able to make out the words of his screaming voice, 'You fucking psycho bitch! Change my dick back to normal, right goddamn now!' The succubus giggles slightly into the back of her hand, most likely at the simple fact that a mortal would make demands of her. She gracefully raises one leg up and plants her heel on top of one of his massive testicles, 'But I thought you wanted to be larger? Your mind revealed your true desire and I quote, [']I wish I had a bitch-breaker dick, then I could I could show everyone what a real man I am and how I deserve all of their sluts for my harem[']. Isn't that what you wanted?'";
	WaitLineBreak;
	say "     The man falls silent for a moment, probably attempting to process the fact that Lilith could read his desires like a book. As you wait to hear whatever the man's response will be, you are shocked when a hand lightly claps you on the shoulder in a friendly manner, 'Hey[if player is male] chico[else] chica[end if], sorry to startle ya, but your sorta in the way and I've got some business with the lady of house, haha.' While the building is still pretty dark, you can make out the face of a darker skinned demon, the only parts of him that really stand out are his horns, and the multiple piercings across his face that glisten in the candlelight. Before you can respond though, Lilith's lyrical voice can be heard, 'Come in Kev, you [']do['] realize that your late don't you?' Well if she knows that he's here then she must have also realized that you had arrived as well. The two of you step further into the room, finally within the circle of candles everything does seem a bit brighter, oddly enough the demon attempts to discreetly sniff you as he walks by.";
	say "     Now that your surrounded by light, you can see much more details about the male demon. His skin is a darker, more crimson red and paired with the yellow eyes, he seems closer to what you would expect of a demon, at least considering most of the ones you have seen so far. 'Sorry Lilith, but your message said that I would need a wheelbarrow? And those aren't exactly easy to find, haha. By the way, can you find a new way to get messages to me? Those [']thralls['] of yours are fucking weird, like seriously. I mean yeah, they sell pretty decently, but braindead sex zombies... creepy!' The succubus acknowledges what he said with a slight nod of her head, but her attention seems to be fixed on you, 'I'm going to assume that you being here isn't a social call, am I right?' With a firm nod of your head you tell her that it's pretty important, 'It always is isn't it? Well just let me wrap up this business arrangement and then I'm all yours.' The wink that she sends your way, on anyone else would seem corny, but for some reason coming from her it's charming.";
	WaitLineBreak;
	say "     The demon that you have now learned is named Kev steps forward, 'So what did this poor bastard do that pissed you off?' Lilith's eyes just seem to bore into the man that she is stepping on, 'He's a man, does there really need to be any other reason?' Her voice sounds almost vacant, like a practiced line that has been repeated time after time. Kev seems a little uncomfortable by her reply, 'Umm, yeah sure, that sounds like a decent enough reason. So uhh, lets talk payment.' The succubus rolls her eyes at his change in topics, 'You can just have him Kev, there is no need for payments.' The crimson demon pulls out a ratty looking notebook, 'Actually, I mean what your gonna pay for taking him. I mean it's nice of you to think of me for slaving needs, but I can already tell just by looking at this thing it's going to require a lot of extra work to take care of it. So either you gotta sell why I should take it.. or simply keep it. Sorry Lilith, you know how much I appreciate everything that you've done for me, but this is business.'";
	say "     While the succubus look a bit frustrated by what he said, she doesn't lash out which is saying something, 'Fine, you want a razzle-dazzle moment? Then lets begin shall we?' With a snap of her fingers the flames on candles surrounding you quickly change to every color of rainbow and start to brighten and dim at regular intervals. With the stage set Lilith starts her pitch with a completely fake cheerful enthusiasm 'So first things first, look at this massive cock and balls, the perfect companion for any buyer than enjoys aromatic cum-baths for them and their friends, but wait there's more, are you tired of having to sleep on that hard cold ground? Well this model can also be used as a makeshift heated bed!' Kev drops his book on the ground as he bursts into laughter, 'Haha, alright Lilith come on be serious, there's no need to be a smart ass.' The smile on his face is matched by your own, who would have thought that the succubus would have a playful side, usually you just see her well... [']horny['] side.";
	WaitLineBreak;
	say "     Lilith crinkles her nose cutely at the two of you, 'Spoil sport. Alright, so other than what I've already mentioned, there is a market for those with a pregnancy kink, I mean if this thing shoots inside of you... yeah your knocked up, hehe.' The man once again starts struggling and attempts to inform Lilith that her mother was a whore, little does he know demons don't usually procreate in hell. The demoness quickly moves around towards his head and leans down, grabbing the head of his massive cock, she jams as much of it as she can inside of his mouth, 'Now be quite, the more you attempt to make a big scene the more pain you will be inflicting on yourself... not to mention I could simply make you blow your load down your own throat and if that happens, well then you could drown in a sea of your own cum, hehe.' The smile on her face could almost appear sweet, however the look of pure terror in the mans eyes causes both you and Kev to once again burst into a fit of laughter.";
	say "     Eventually the two of you finally manage to calm down and the smirk on Lilith's lips shows her amusement at the reaction her actions provided, 'Alright Kev, how about one final offer to sweeten the pot? I can spread a slight demonic taint to this thing, meaning that no matter what anyone does to it, it will remain pure human... well at least on the outside, hehe. And since I do appreciate you coming out all this way to take out the trash for me, I will also double the payments that you can receive from it, I just need you two to roll the thing over.' You have no idea how you got dragged into helping Kev, but it's probably better to do as she asks, after all you will be asking for her help later. The two of you move over to the side of the poor guy and while it's pretty strenuous to roll this big bitch over, you both complete what was asked of you without too much difficulty.";
	WaitLineBreak;
	say "     The sight that awaits the three of you is laughable, while Lilith altered the man's genitals to become huge and grossly oversized, that was all she altered. The skinny boy has no real muscle or meat on his bones, leaving him to look more like he's just laying there on a huge cock pillow. The succubus walks over to a table just outside of the candlelight and quickly returns with a vial of liquid and offers you a wink, 'My own special blend.' With that she pours a liberal amount into her delicate looking hands and quickly rubs them together. You don't know what you expected to happen next, but it certainly wasn't for Lilith to begin smacking the kids flat ass as hard as she can. With every strike of her hand you can hear the man's muffled screaming at the pain being inflicted on his backside, however as you watch what is happening you quickly realize that this isn't just about hurting the guy, his ass is actually becoming larger and more round with each hit.";
	say "     While the show that the succubus is putting on is amusing at first, Lilith seems quite happy to just keep striking the boy over and over again. The demon at your side raises his hands up, 'Hey Lilith, that's enough! I mean damn, if you keep on like that eventually the product is just gonna be a cock and an ass, haha.' Not one to really follow the rules, the succubus offers one final hit to the already dark-red rear before backing off. At that moment you're able to hear the man sobbing into his dick head, while some small part of you may feel bad for what's happening to him, the larger part of you understands that this is his just reward for his arrogance. Finally catching her breath, Lilith swirls around on her heal to face you, 'Well I mean some people actually like a big ass I'll have you know, besides with the proper concoction you can alter any body parts size to suit the needs of a proper [master].' Her gaze bores into you for a moment as those words pass her lips. At this point you can't be sure if the succubus's action are more to make Kev happy, or if she's simply attempting to impress you with her skills.";
	WaitLineBreak;
	say "     Putting her forefinger under her chin and squinting her eyes, Lilith inspects the man, almost as if she is thinking of what fun new torture to inflict upon him, 'Hmm... that's it! Alright Kev, I hope your eyes are ready to see dollar signs! What if we make this thing able to be bred?' With a snap of her fingers, the boys legs are instantly spread as far as they can, fully exposing him to the gaze of his viewers. A muffled sob can be heard as the man once again attempts to struggle to get away. Sensuously, the succubus drops down to her knees and begins to lightly caress the area right behind his testicles, 'What if I a place a tight little virgin cunt right here? I mean that would bring some big money to your establishment, not to mention with this thing staying human, it would be the perfect breeding slut, just imagine the hybrids that could be born from it? It's a whole new market for people to get exactly what they pay for!'";
	if carried of orc pill case > 0:
		say "     [bold type]Should you mention the orc pills you have?[roman type]";
		LineBreak;
		say "     ([link]Y[as]y[end link]) - Yes, you're not really into seeing pussies.";
		say "     ([link]N[as]n[end link]) - No, who could say no to breaking in a tight virgin cunt.";
		if Player consents:
			say "     [EchiphonMpreg01]";
		else:
			say "     [EchiphonPussy01]";
	else:
		say "     [EchiphonPussy01]";
]

Section 5 - Extra Scenes

Part 1 - Spying

to say SkarnothSpy01:
	say "     [if Morale of The-Voice is 1]Placing your body flush against the wall, you listen in on the two demon's conversation in the hopes of learning something that could prove useful[else if Morale of The-Voice is 2]Quelling the part of you that wants nothing more than to strut through the open doorway, you instead listen further in the hopes of finding out exactly what Skarnoth has to say[end if]. 'I know that the two of you could protect me Brutus, but the point is that I shouldn't need to be defended! I should be able to stand on my own two feet, I mean I was a master of hell for fucks sake! Demons would scramble away just from my mere presence, and now, now they will look at me as nothing more than an easy mark.' [if Morale of The-Voice is 1]The idea of having all of the power that the royal incubus had at one point and then losing it, you can understand his frustration with the current situation. A part of you regrets his current predicament, however a larger part of you is happy with how things turned out, since you have come to enjoy having the former Master of Hell in a subservient role beneath you. Besides, part of being a noble is to properly understand ones place after all. Slowly you walk through the doorway and raise both demons awareness to your presence[else if Morale of The-Voice is 2]The idea of being a powerful warrior and a leader among the demons, then only to lose everything does stir emotions of camaraderie in you. A part of you regrets his current predicament, however a larger part of you knows that the strong will always overcome the weak, you bested the demon in battle and claimed your rightful place above him in the pecking order. Besides, he should be happy that now you're in charge since that means you will be able to properly keep him safe, the fact that he makes a perfect sub for you doesn't hurt matters either. Confidently you walk through the doorway and raise both demons awareness to your presence[end if].";
	say "     Skarnoth seems shocked by your sudden entrance, Brutus however doesn't show any sign of surprise. A gravely purr reverberates the word [italic type]'[Master]'[roman type] through your mind as the demon brute acknowledges you, he must have felt you through the master bond, however that begs the question of why the former royal seems so startled to see you, seeing as he also bears your mark. '[Master], I didn't expect to see you so soon... did... did you hear anything before you came in?' Looking into the lava colored eyes of you slave, you calmly walk forward and nod your head in the affirmative. 'I wasn't trying to go against your orders [master], but please understand where I'm coming from. Without my powers I'll be marked as an easy target... I have accepted my place under your ownership, but there are things out there that you have never encountered, things that...' Seeing the conflict on the demon's handsome tan face, you feel the need to reassure him from his fears, but the question is how to go about it.";

Part 2 - Burst In

to say SkarnothBurstIn01:
	say "     Pushing the thoughts of needing to spy on the demons within away, you walk with a confident [if Morale of The-Voice is 2]stride [else if Morale of The-Voice is 3]strut [end if]into the half-renovated room, your gaze instantly landing on both Skarnoth and Brutus. The former royal seems shocked by your sudden entrance, but the demon brute doesn't show any sign of surprise. A gravely purr reverberates the word [master] through your mind as the Brutus acknowledges you, he must have felt you through the master bond, however that begs the question of why the Skarnoth seems so startled to see you, seeing as he bears your mark as well. Looking around, you notice that neither of the demons have readied anything for your trip out to the burned out church, [if Morale of The-Voice is 2]'Are you two almost ready? We move out as soon as possible.' [else if Morale of The-Voice is 3]'Come on boys and move your asses, we've got places to be' [end if]Turning around to leave, intending to finish your own preparations, you come to a halt as neither demon makes any move to follow your orders.";
	say "     Turning back, you ask them if something is wrong with a [if Morale of The-Voice is 2]commanding tone to your voice, [else if Morale of The-Voice is 3]annoyed growl in your voice, [end if]Skarnoth is the one that finally speaks up, '[Master], would it be alright if I sat this one out?' Raising a single eyebrow, you proceed to ask the demon why he shouldn't [if Morale of The-Voice is 2]have to follow orders. [else if Morale of The-Voice is 3]have to do as you command. [end if]'It isn't that I'm trying to go against your orders [master], but please understand where I'm coming from. Without my powers I'll be marked as a easy target... I have accepted my place under your ownership, but there are things out there that you have never encountered, things that...' Finally understanding what has Skarnoth acting so skittish, you think for a moment on the best way to handle the situation. Seeing the conflict on the demon's handsome tan face, you feel the need to reassure [if Morale of The-Voice is 2]him from his fears, [else if Morale of The-Voice is 3]your property of his fears, [end if]but the question is how to go about it.";

[if Morale of The-Voice is 1] [else if Morale of The-Voice is 2] [else id Morale of The-Voice is 3]
[[italic type]yards[roman type]]
[Stamina of Skarnoth = whether they had a threesome or not]

Part 3 - Skarnoth Ally Scene

to say SkarnothAlly01:
	say "     Walking up to Skarnoth with a friendly smile on your lips, you place a firm hand on his shoulder, the act startling the former master of hell. Even though the demon attempts to shrink away from your touch, you don't release the grip on him, '[Master]?' The look of fear in his eyes spurs you to speak, 'Skarnoth, you need to trust in both me and Brutus. I know that there are things in this world that we have yet to see firsthand, but we shall face them head-on, together.' Glancing over at the demon brute, he acknowledges your words with a firm nod of approval before his voice fills your mind, [italic type]'Wise words [master].'[roman type] Skarnoth seems to calm down slightly at your declaration and brings his own hand up to cover your own in an act of camaraderie. 'Alright [master], you're right. We can handle this, I just wish I knew how to be of use now that I'm so much weaker than I used to be.'";
	say "     Surprisingly, you are able to hear something very faint in the back of your mind, but it steadily grows louder. ''";

Part 4 - Skarnoth Lover Scene
[expanded sex scene that will require knowledge of potential sex between Skarnoth and Brutus]

to say SkarnothLover01:
	say "     Walking up to Skarnoth with a smoldering look in your eyes, you quickly pull him flush against your body and lay a searing kiss against his full lips. As the former master of hell finally leans in and begins to respond with an almost hungry desperation, your tongue quickly dominates the meeting of your two mouths. While this moment is about the intimacy between the two of you, it is also about showing the demon that it's alright to rely on you and trust in your judgement. Pulling back, you look deep into his lava colored eyes, within them you can see both devotion, but also a question. '[Master], what was that for?' Raising your hand up, you cup the side of his tan face and allow your fingertips to caress his crimson hair, 'Skarnoth this is my way of showing you that I care, and that I would never allow anything to happen to you. You're special to me and I will always keep my things safe.'";

Part 5 - Skarnoth Slut Scene
[expanded sex scene that will require knowledge of potential sex between Skarnoth and Brutus]

to say SkarnothSlut01:
	say "     Walking up to Skarnoth with a look indignation on your face, with a single hand you grab one of his horns and push the former master of hell down to a kneeling position. Looking down into the demon's fearful eyes you allow a cruel smile to form on your lips, 'Listen up slut, I keep you around because you're a decent [if player is male]cocksleeve, [else]dildo, [end if] it's past the time that you have learned your place. Let's be honest here, I beat you, the master of hell and then enslaved you as my bitch, so whatever is out there I think I can handle.' From behind you a snicker can be heard from Brutus. Tears start to form in Skarnoth's lava colored eyes, 'Yes [master], I understand and your right. Just... please don't hurt me.'";

Part 6 - Brutus Pervy Twerk Scene
[expanded sex scene that will require knowledge of potential sex between Skarnoth and Brutus]

to say BrutusTwerkPervert01:
	say "     ...";

Part 7 - Echiphon's Mpreg Gain Scene
[add trait for him being Mpregable]

to say EchiphonMpreg01:
	say "     Not really liking where this is going, you open your mouth and mention to the demoness that you have a pill that could keep the being male while still making it possible to knock him up. This seems to upset Lilith, as a frown soon graces her face, 'Why wouldn't you want it to have a pussy? I mean I guess it still gets the job done, but personally I think this pig could use a little bit more sow inside of it to truly understand the mistakes that it made.' Snickering softly to yourself, you make your way over towards the mans head. Crouching down, you grab him by his short jet-black hair and yank his dickhead from his mouth. Staring deeply into the blue tear-stained eyes of the boy, you proceed to ask him his name, 'My, my name is Arn-' You quickly interrupt him and explain that he no longer has a name, whatever or whoever he was before no longer matter, he will now live as the property of others. This of course leads the man into a fresh burst of tears, 'But... but I don't wanna be anyone's property!' You lightly caress the youth's pale face before softly cupping his cheek.";
	say "     You ask him if he remembers the demon that he met outside? 'You mean that fag that tried hitting on me? Yeah I remember him... Hey why don't you enslave him instead! I mean those animals like that sorta thing right?!' Your hand tightens around the boy's face causing his eyes to squinch up in pain and you slowly explain to him that the [']fag['] outside is your son... Realization dawns on his face at what this must mean for him, 'Please, I'm sorry and I swear I wont ever do it again, just please let me go!' Glancing over at Lilith, she is glaring daggers at the man and you would be lying if you were to say that you didn't agree with her rage. Calming yourself, you explain to him that even though he's wronged you, you intend to take pity on him and give him a gift. Pulling out one of the orc pills that you have, you show the youth the small light-green pill and tell him that this capsule is his only option to stay fully male.";
	WaitLineBreak;
	say "     'Wait, but didn't you say something about it making it possible for me to still get knocked up? I don't wanna get pregnant! Besides, without a pussy no one can even have a baby!' You chuckle to yourself and explain to him that he has another hole that will grow a womb, 'Another hole! Wait you mean my ass! No you can't do that, I'm a virgin, you wouldn't do that to a virgin would you?!' The man's struggles begin anew, however this also gives you a proper opening and you jam the pill as far down his throat as you can. Quickly covering his mouth and nose, you inform him that it would be best to simply swallow his medicine, or he can try to fight you and be fed it while he's unconscious. While still crying the boy obediently swallows the pill, however you don't want him to forget the lesson that is meant to be learned here and leaning closer to his ear, you ask him how it feels to be a fag now? Standing up, you return to your earlier position with the others, a wicked grin on your face.";

Part 8 - Echiphon's Pussy Gain Scene
[add trait for him growing a fertile pussy]

to say EchiphonPussy01:
	say "     Lilith begins to talk to Kev about trivial things such as color, shape, the size that the clit should be, basically things that would matter to potential buyers. You watch as the words of their conversation seem to make the youth's body tremble in fear, snickering softly to yourself, you make your way over towards the mans head. Crouching down, you grab him by his short jet-black hair and yank his dickhead from his mouth. Staring deeply into the blue tear-stained eyes of the boy, you proceed to ask him his name, 'My, my name is Arn-' You quickly interrupt him and explain that he no longer has a name, whatever or whoever he was before no longer matter, he will now live as the property of others. This of course leads the man into a fresh burst of tears, 'But... but I don't wanna be anyone's property!' You lightly caress the youth's pale face before softly cupping his cheek.";
	say "     You ask him if he remembers the demon that he met outside? 'You mean that fag that tried hitting on me? Yeah I remember him... Hey why don't you enslave him instead! I mean those animals like that sorta thing right?!' Your hand tightens around the boy's face causing his eyes to squinch up in pain and you slowly explain to him that the [']fag['] outside is your son... Realization dawns on his face at what this must mean for him, 'Please, I'm sorry and I swear I won't ever do it again, just please let me go!' Glancing over at Lilith, she is glaring daggers at the man and you would be lying if you were to say that you didn't agree with her rage. Calming yourself, you explain to him that what he has done was wrong and how when people do bad things, they must also be ready to pay the price. With a cruel smile on your lips, you ask the youth if he's excited about gaining a tight little virgin cunt? 'Noooo! I don't want to have a pussy, I haven't ever had sex before and now your telling that I have to get a vagina?!'";
	WaitLineBreak;
	say "     'Wait, but didn't you say something about it making it possible for me to still get knocked up? I don't wanna get pregnant! Besides, without a pussy no one can have a baby!' You chuckle to yourself and explain to him that he has another hole that will grow a womb, 'Another hole! Wait you mean my ass! No you can't do that, I'm a virgin, you wouldn't do that to a virgin would you?!' The man's struggles begin anew, however this also gives you a proper opening and you jam the pill as far down his throat as you can. Quickly covering his mouth and nose, you inform him that it would be best to simply swallow his medicine, or he can try to fight you and be fed it while he's unconscious. While still crying the boy obediently swallows the pill, however you don't want him to forget the lesson that is meant to be learned here and leaning closer to his ear, you ask him how it feels to be a fag now? Standing up, you return to your earlier position with the others, a wicked grin on your face.";




Master-of-Hell-Quest ends here.
