Addicted Breeder by Voidsnaps begins here.


[Tapes unlock sequentially as you watch them. Messy Hideout Resolution controls the unlocks. 100 means you didn't take the tapes.]
[]
[]
[]
[]

Section 1 - First Tape

Table of GameEventIDs (continued)
Object	Name
Messy Hideout	"Messy Hideout"

Messy Hideout is a situation.
ResolveFunction of Messy Hideout is "[ResolveEvent Messy Hideout]".
Sarea of Messy Hideout is "Capitol".

when play begins:
	add Messy Hideout to BadSpots of MaleList;

to say ResolveEvent Messy Hideout:
	say "     Your attempts at exploration lead you into a dark building, but unfortunately, all of the rooms within appear to be locked. Disheartened, you decide to leave, only to hear a slight squeak that catches your attention. The basement door hangs ajar, and as you approach, you can't hear anything moving in the darkness despite a rather rank smell wafting from the open door.";
	say "     Judging by the smell, someone or something was soundly fucked in this basement. It could be a trap, or the mystery person might be long gone, leaving supplies for you to take! Do you want to risk it?";
	say "     ([link]Y[as]y[end link]) - Yes, who knows what might be waiting for you!";
	say "     ([link]N[as]n[end link]) - Hell no!";
	if Player consents:
		say "     Shrugging, you make your way down the stairs, wrinkling your nose at the overpowering stench of old cum that overwhelms everything. It's not as dark as you thought it would be, and you're thankful to whoever set up this place for placing construction lights along the walls, though most of them appear to be on their last legs, blinking and dim. The light is just enough for you to make out congealed puddles of slime on the floor below, which you give a wide berth. Eventually, you find the source of the majority of the smell- a pile of bedding that is visibly soaked, flanked by shredded pieces of clothing that appear to be burst open from the inside. Every last inch of the area surrounding it drips with dried cum, and chains lie discarded in a corner nearby, with several links showing signs of being chewed. Further investigation reveals a hole in the concrete nearby covered in dried fluids, with a busted camera in front of it and several tapes piled haphazardly at its side. As you pick up the camera, inspecting its destroyed surface and removing its tape to stash in your bag, you hear a cacophony of cries from within the hole, growing closer by the second. You know better than to stick around to find out what's making all that noise, so you grab the rest of the tapes and turn tail and flee, rushing back up the stairs, into the relative safety of the streets.";
		say "[bold type]' Demented Video Diary' has been added to your tape inventory![roman type][line break]";
		add "Demented Video Diary" to tapes of Player;
		now resolution of Messy Hideout is 1;
	else:
		say "     Shaking your head, you decide against wandering into the basement. Who knows what's down there?! You don't feel like becoming a random monster's fucktoy.";
		now Resolution of Messy Hideout is 100;

	now Messy Hideout is resolved;

to say AddictedBreederFucked:
	say "     Which tape would you like to watch?";
	LineBreak;
	let Breeder_Video_Choices be a list of text;
	if Resolution of Messy Hideout < 100:
		if Resolution of Messy Hideout > 0:
			add "Watch the first tape." to Breeder_Video_Choices;
		if Resolution of Messy Hideout > 1:
			add "Watch the second tape." to Breeder_Video_Choices;
		if Resolution of Messy Hideout > 2:
			add "Watch the third tape." to Breeder_Video_Choices;
		if Resolution of Messy Hideout > 3:
			add "Watch the fourth (and final) tape." to Breeder_Video_Choices;
	add "Nevermind." to Breeder_Video_Choices;
	let Breeder_Video_Choice be what the player chooses from Breeder_Video_Choices;
	if Breeder_Video_Choice is:
		-- "Watch the first tape.":
			LineBreak;
			say "[BreederTapeOne]";
		-- "Watch the second tape.":
			LineBreak;
			say "[BreederTapeTwo]";
		-- "Watch the third tape.":
			LineBreak;
			say "[BreederTapeThree]";
		-- "Watch the fourth (and final) tape.":
			LineBreak;
			say "[BreederTapeFour]";

to say BreederTapeOne:
	say "     Sliding the tape into your camera's deck, you flip it open, watching as a grainy picture comes into focus. An average man stares at the camera, and the field of view bounces in the unmistakable rhythm of a brisk walk. At first, you wonder if there will be any sound, but he clears his throat as the ambient light dims. 'It's been a few days since everything went to shit. I'm the only one left. Those green fucks took Tim, and Sandy became god-knows-what. She fuckin' roared, and I booked it.' Taking a shuddering breath as he stares into space, the camera's subject slumps against a nearby wall, giving a better view of his slim form, clad in shredded clothes so stained you can barely tell their original color. 'No place seems safe these days. Everyone's turning into a monster-' It seems the subject's voice has drawn some attention. You hear an animalistic squeal growing closer and the unmistakable sound of a trashcan clattering. The camera swings wildly, away from his terrified expression, and centers on a three-foot dragon hovering on woefully small wings. A massive swinging black cock dangles beneath it, releasing sticky streams of slime and bucking when its eyes light on the camera's holder.";
	say "     'F-Fuck off!' As it closes on him, the cameraman swings at the creature, sending the device sailing through the air and landing with a plastic thump. The video goes blurry for a second, then focuses on a different view, showing the cameraman falling flat on his ass as he fumbles at his pack, no doubt attempting to grab a weapon to defend himself. Unfortunately for him, he doesn't make it in time, and the creature's claws rake at his clothes, baring his chest and leaving long red scratches along his front. It seems the creature doesn't understand or care that he's struggling, and voracious teeth destroy the man's pants, showing off a skinny body as he desperately tries to crawl away. Unfortunately for him, the position bares his ass to the rapacious dragon, and it clings to him with sharp claws, perching on his defenseless ass. With a triumphant squeal, it rams itself home, parting his cheeks and slapping comically large balls against his upturned ass.";
	WaitLineBreak;
	say "     'Get the fuck off me. Fuck. How is something that big-' Trailing off into a yelp, the cameraman falls flat on his face, his cock flopping limply beneath him with every thrust of the beast's cock. His stomach shows the progress of that uncaring cock in stark outline, stretching pale skin farther than it should go and bloating with the torrent of fluids it gushes deep inside of him. 'You're going to break something...' Whimpering as the creature shreds his bare skin to stay perched, he soon resigns himself to his fate, likely hoping that it will be over more quickly. Ambient noise disappears in favor of wet plaps as the creature cores him out, and slowly but surely, the cameraman's cock swells, dripping with the river of slime overflowing from his stuffed ass. Ceaseless thrusts synchronize with the pulse of his growing erection, and before long, it appears his body adjusts to the sheer size of the monster dick, leaking approval that its owner doesn't share. With time, he even starts to push back, his desires overwritten by the pleasure of the shaft destroying his prostate.";
	say "     Soon enough, the scaled menace reaches its limit, flapping its wings and jackhammering the poor human until his legs give out, leaving his backward-facing cock and balls to endure the brunt of those massive swinging dragon nuts. The source of its renewed vigor becomes apparent as sloppy strings of bestial orange cum ooze out around its pistoning cock, then squirt in endless glowing streams, narrowly missing the camera with volume that seems more at home on an elephant. Once skinny, the overpowered human swells under the onslaught, his stomach growing plumper by the second until he balances on its bloated bulk, his cock slapping against stretched skin until it adds to the mess in a meager offering to his rapist. Sated, the dragon whelp releases its prey, flapping its wings and reversing itself until its softening cock flops free of the human's hopelessly gaped hole, bringing with it a deluge of cum that paints the concrete below with sticky puddles. Several flaps throw its perverse shape into the air, leaving the camera's view, its vocalizations retreating into the distance.";
	WaitLineBreak;
	say "     Perversely peaceful, the scene focuses on the cameraman's ruined ass as the hung dragon's molten orange seed leaves him in heavy squirts. It's a few minutes before he can move again, and when he does, he shakily crawls toward the camera, providing it with a view of a drool-coated chin and a face still dirty from pressing against the ground. With a shameful expression, he turns off the camera without a word.";
	if Resolution of Messy Hideout < 5:
		now Resolution of Messy Hideout is 2;

to say BreederTapeTwo:
	say "     Popping the second tape into the deck, you watch as the video focuses in on the cameraman from the first video from the shoulders up, staring directly into the camera. His face lacks the dirt and grit it had the last time you saw him, but he looks like he hasn't slept in days, and he fidgets uncomfortably before taking a shaky breath and starting to speak. 'I'm not sure why I'm doing this. Maybe it's for my sanity. I'm screaming into the void, I guess. No one else to talk to...' The cameraman clears his throat, then braces himself, his shoulders sagging slightly. 'My name's Calvin Benson. If you're finding this video, something's probably happened to me. Well, something already did, though I don't know what.' Carefully picking up the camera, he pants it down over a swollen stomach that pulses as you watch, showing the outline of some inner extremity. He looks about eleven months pregnant, and you doubt he can walk well, if at all.";
	say "     'Yesterday I was raped by this dragon... thing. I didn't get a good look, but I can still barely feel my legs.' A little choked up, Calvin shakes his head as he settles the camera back on his face, then continues. 'I don't know what it did to me, but there's something inside me. I can feel it moving. Guys can't get pregnant, but fuck, if it walks like a duck...' Groaning, Calvin leans back a bit, rubbing his stomach. His expression fades into something vaguely pleased, and then he catches himself panting. 'Worst thing is how damn good it feels when it moves. It's like it's pressing all these buttons inside me. Fuck. What am I supposed to do?' Holding his face in his hands, the survivor sits silently as the tape fades to black, his expression twisting as though he's feeling something he doesn't want. You wait for the tape to continue, but all you can see is black. Thinking that the video is over, you place your hands on the tape deck, stopping as you hear a soft thud from the screen. The tape starts again.";
	WaitLineBreak;
	say "     'I'm pregnant.' Calvin grimaces at the camera, sitting in a different location than the last. 'My fuckin' water broke outside this... candle shop? I snuck in, and thank fuck none of those freaks hid in here.' Twisting his expression, the cameraman moans aloud, tears gathering at the corners of his eyes. 'It, uh. It doesn't hurt, but fuck. I'm hard as a rock. I had to take off my clothes because it's so fucking hot.' Showing some corruption in his willingness to tape what's happening to him, Calvin sets the camera somewhere, giving it a view of his predicament. His hand is a blur on his cock, and sticky strings of cum have already painted his stomach from his constant self-pleasure. There's a puddle beneath him, and his ass is on display, his hole gaping wide. He can't seem to keep eye contact with the camera, but his face is flushed, and he's enjoying himself.";
	say "     Another contraction hits before he can speak again, and Calvin releases his cock, humping upward and covering himself in a fresh layer of cum. His hands twist, trying to find purchase on the concrete below, and as you watch, a muzzle pokes out of his hole, widening it by several inches. Each push brings his spawn further out of him, and his dick releases spurts with every movement, lubricating the way for the strange creature's exit. 'Why? I can't-' Covering his eyes with his hand, the unfortunate breeder whimpers through his sustained super-gasm, his legs spread cartoonishly wide by the passage of that massive creature. Thankfully for him, the apparent influence of the nanites has left him stretchy enough that even the widest part of the creature can't tear his ruined ass, but you can only imagine how strange it must feel to have something thicker than your hips bursting out of you!";
	WaitLineBreak;
	say "      Finally, with a wet plop, the creature slips the rest of the way out of its unfortunate 'mother,' scenting the air as it struggles to its feet. Unlike its progenitor, it doesn't appear interested in breeding the exhausted human in front of it, despite the fully developed cock and balls swinging between its rapidly growing legs, and it roar-squeaks as it reaches full size, shaking cum and amniotic fluid from its wings and flapping offscreen. Crashes and squeals ring out as it navigates the store outside, followed by the tinkling of broken glass, and it's gone. No doubt, within hours, it'll be impregnating another poor soul. The feed stills focused on Calvin's flagging cock and ruined, still-gaped hole, then ends shortly afterward as the exhausted man crawls to it, wiping sweat from his brow and licking his lips as he fiddles with the camera. Strangely, his eyes look a bit dull, as if he's drugged, and all shame seems to have left him. He doesn't even bother cleaning his cum from the stubble on his chin!";
	if Resolution of Messy Hideout < 5:
		now Resolution of Messy Hideout is 3;

to say BreederTapeThree:
	say "     Returning to the riveting saga of Calvin's encounters with the image of his soundly fucked expression still fresh in your mind, you pop the third tape into the camera's deck, settling in to watch the next part of his video diary. As his face pops into view, you can't help but notice the haggard expression and the haunted look in his eyes are gone. Calvin seems almost giddy as he clears his throat, sitting back in a lawn chair with the camera angled to show off. It seems the once terrified man has abandoned clothes, and his cock slaps eagerly against his once again slim stomach. 'It's been a while. I tried to resist, I did, but fuck. I can't stop thinking about it. How fucking right it felt when that thing tore its way out of me.' Stroking himself blatantly, Calvin licks his lips with a demented moan, running his hands over his stomach as if imagining it swollen with more unholy monstrosities.";
	say "     A soft squeal from off-camera catches his attention, and he swivels it with a grin, revealing a chained dragon whelp- much like the one that impregnated him in the first place- in the corner of the basement-like space, glaring at him and pacing with its muzzle covered and an angry-looking erection dragging on the smooth concrete below. It can't go far with several chains binding it in place, but from its demeanor, it's frustrated with breeding stock so close but out of reach. Judging by the depth of the glowing puddle of seed beneath it, it's been there for a while. You almost feel sorry for it once you catch a glimpse of the heavy, swollen balls beneath that cock. 'This should be safer. I can do it. The video should be enough to tide me over.' Kneeling in front of the camera, Calvin looks longingly at the dragon's cock, still stroking his reddened cock. 'Just one more time, and then I'm done.' He repeats himself in a tone that you recognize- an addict begging for a fix- and adjusts the camera. Cock leading the way, he turns around, pulling chains taut until the dragon's immobilized, its legs spread and its pose trapped in something resembling a rearing horse.";
	WaitLineBreak;
	say "     'Let's get you lubed up, big boy,' Calvin murmurs, barely audible. Kneeling between spread, scaly legs, he grips that proportionally massive cock, holding it with the sort of reverence a zealot would treat a holy relic with. Without hesitation, he laps at the free-flowing orange pre, smearing his face with it and nuzzling against the creature's flexing cockhead. Every inch receives a thorough tonguing, spreading the voluminous pre over its length, and the budding whore does nothing to stop the excess dripping down his chest, even gathering some to finger into his hole, showing the camera how easily he takes three digits. Scrabbling at the floor, the dragon squeals with frustration, steam billowing from its clamped muzzle. The position Calvin forced it in only allows the barest hip movements, but it does its best to fuck his face, narrowly missing penetration and slapping its flexing shaft against his face. Its bindings groan with effort, and its balls visibly churn, massaged by worshipful fingers.";
	say "     'Mmmph. Why does it taste so good?' Calvi murmurs as he transitions to all fours, licking his fingers clean and backing up until a wet squelch tells you the creature's cock has found its home. Kneeling, the desperately addicted man bounces on his prize, cradling the bulge in his stomach as it shows the progress of that draconic dick. His expression shows how little he's thinking, but his cock's so hard that it looks like it'll explode, and the fingers stroking his stretched stomach skin are almost maternal. Chuffing impatiently, the dragon rocks atop its human cocksleeve, its paws barely able to rest on Calvin's shoulders. The chains holding its forelegs creak as it tries to regain control, though it gives up after a few minutes, grumbling and squeaking as its cock unleashes the first spurts of tainted seed deep within Calvin's innards, sending orange streamers shooting out. Seemingly sated, it deflates slightly, its eyes crossing.";
	WaitLineBreak;
	say "     'Yes. Fuck. It's so hot.' Calvin moans as his stomach grows, rubbing the growing bulge. As it reaches pregnancy proportions, he abandons it, stroking himself madly and working himself along the creature's cock. It's not long before he joins his bestial beau in orgasm, slumping forward and letting its cock flop free of his depths with a lewd slurp. 'I can feel myself getting pregnant. Fuck me, why does this feel so damn good?' Calvin crawls out of the creature's range, leaning on his heavy stomach and attempting to catch his breath. One of his hands explores his ruined ass, wet sounds revealing his wanton fingering. Tilting its head as though slighted, the whelpling watches the show, squealing in frustration and lunging forward. Calvin's too engaged with his manic self-pleasure to notice, but the chains stretch to their limit, opening their links and finally snapping, letting the creature barrel forward. It wastes no time with its newfound freedom, mounting the defenseless human and stirring his already gooey hole into a syrupy, loud mess.";
	say "     'More. I need it. I don't care anymore!' Calvin barely reacts to the creature's claws scratching for purchase on his naked body, his tongue hanging out as one of its paws presses his face against the floor. Every thrust wrings a hoarse moan from his throat, adding to the mess below him, and his swollen stomach swells further until its ballooned size keeps his arms and legs from touching the floor, his body sloshing back and forth in an ocean of orange cum that stains his skin, glowing ominously. The creature uses him far longer than you'd expect, mounting his upturned ass as his glazed expression stares directly into the camera. He must have taken at least half a dozen loads when it finally yanks itself free from his ruined innards, and he lolls forward with a weak groan, holding his ballooned stomach as the sexually frustrated monster takes its leave. That swollen, impossibly round stomach whirls with activity, bulging horrifically in a body-horror-esque display of expedited pregnancy, and a wet gushing sound reveals something new.";
	WaitLineBreak;
	say "     'Here they come~!' Calvin coos in an exhausted tone, all semblance of sanity gone and a wide grin plastered across his sweat-drenched face. Kicking his legs ineffectively, he manages to turn himself around, facing the camera as his ass bloats, spreading wide in the unmistakable shape of one of the unholy whelps. What took days before seems to have happened in mere hours, and as you watch, his abused hole gushes with cum, unleashing one, two, three, and then a fourth creature in quick succession, giving some relief to his comically-domed stomach. All the while, he babbles incoherently, his softened cock unleashing an endless stream of cum. His feet twist for purchase as they finally reach the ground, and Calvin humps the puddle of cum as the final resident of his tainted innards worms its way out, its claws scrabbling at the mess painting his cheeks. He's so loose that it crawls out of him as though exiting a fleshy tunnel, and as it shakes itself clean and flaps its wings experimentally, the video fades to black, leaving you to guess what happens next.";
	if Resolution of Messy Hideout < 5:
		now Resolution of Messy Hideout is 4;

to say BreederTapeFour:
	say "     It seems you've reached the final tape in the series. After what you've seen, you're unsure what to expect, but morbid curiosity and perhaps a bit of desire drive you to take the final tape and slide it home. The camera blurs, then focuses on Calvin's face again. He seems excited, and it appears that he's given up on wearing clothes, the angle of the camera showing his bare chest crusted with what you assume to be old cum. He giggles- an insane, bone-chilling sound- and blows the camera a kiss, panning it over his bouncing, heavily pregnant stomach. 'I've been finding more of them. I think they might be mine. Somehow, that makes it better~.' Rolling his hand over his stomach and lingering on the kick of its resident, the brunette licks his lips. 'My babies, enjoying their daddy's pussy and making themselves some new siblings~. Such good boys- Sometimes I try to keep them around for a bit. They love cumming down my throat before their first flight.'";
	say "     Calvin continues on his stroll, blatantly jerking his cock as he muses on how much he loves to be bred by every whelp he can find. Mid-description of his last birth, he pauses, looking past the camera and taking on the expression of an alcoholic within easy reach of a fix. 'Hi there, sweety. Why don't you follow me?' He coos as though talking to a pet. The inhuman squeal of a whelp tells you what he's run into, and the camera shakes slightly, forgotten in his hand, while he continues to coax the creature. The camera clicks off, then returns to a familiar sight- the basement where Calvin's last pregnancy occurred. The concrete still holds the stain from countless breedings, though a makeshift camp lies around it. It seems he's been luring the small dragons down to his home and letting them have their way with him! With a giddy air, Calvin sets up the camera, beaming as he backs away from the aggressive approach of the creature he lured. Opening his arms wide, he lies on his back, welcoming the monster to mount him and wrapping all four limbs around its body as it penetrates his ass. It slides to the root so smoothly that you doubt he's spent a single day without dragon cock in his ass, and each push slaps heavy balls against his upturned ass, adding to his cooing desperation.";
	WaitLineBreak;
	say "     The wall behind Calvin's display catches your attention, crumbling slightly as two nostrils shove through the rock. It seems his sex den has attracted more attention, and though he's too far gone to notice, within moments, another of the dragon whelps works its way through, shaking the dust from its scales and scenting the air. Zeroing in on Calvin, it squeaks at the creature mounting him, stamping its foot, and attempting to push it away. With no desire to give up its prize, the monster in Calvin's ass shows its teeth, trails of drool dripping from its sharp fangs as it digs its claws into his hips, drawing reddened trails along sweat-covered skin and roaring a challenge in its high-pitched tone. Their fight turns Calvin around, showing his blissful expression and conveniently placing him beneath the intruder's manhood, and in his lust-addled state, he solves the disagreement, guiding the newcomer's shaft against his face. You doubt this is his first time in this situation, and he's too desperate for dragon cock to care about the logistics of deepthroating that monster cock.";
	say "     Taken aback by the sensation, the whelp squeals in triumph, surging forward and forcing a wet gag from Calvin's throat as it forces its way in, bloating his throat. A tug of war ensues between the horny dragon whelps, forcing the heavily pregnant man to spear onto one cock as the other withdraws, and you soon lose sight of him amid the squabbling dragons, with the only sign of his presence the occasional muffled moan and a glimpse of his swollen stomach, bloating more by the second. More draconic sounds join the first two as paws claw at the rubble. Half a dozen more whelps pour into the room, their keen senses of smell leading them to the orgy in the center of the room, and the poor human barely gets a half a second's break between his first two bestial paramours pulling out and the next set shoving into him. Stirring molten cum and coating every bare inch in the overflow, they force themselves into their brethren's mess, eager to breed their newest conquest. His stomach has swollen to the point where you can see it even among the press of the dragons' bodies, wobbling to and fro as its squirming inhabitants kick against dangerously stretched skin.";
	WaitLineBreak;
	say "     You're not sure how long you watch Calvin's body used and abused by the gaggle of dragons, but by the time the last one slides out of his gurgling mouth, he's more cum than man, his tongue barely visible beneath an ocean of cum that bubbles from his nose and mouth. You can't imagine any thoughts are going through his head, even as his legs spread and a whelp tears its way out of him in a gooey, wet show, only to mount its 'mother' after nothing but a shake to clear its eyes of amniotic fluid and mixed cum. By the time Calvin's stomach empties of its payload, the room teams with dragon whelps, all with heavy, perpetually hard cocks and screeching voices. They seem to have lost interest in the weakened human, and eventually, they begin to file out of the tunnel, heading into the darkness below. Within moments, the only evidence of their presence is the tip of a tail flicking as pitch black overtakes it, leaving nothing but a retreating din.";
	say "     Calvin lies there, breathing heavily and running his hands over his still-swollen stomach, murmuring something unintelligible. Struggling to find purchase in the sea of mixed dragon cum that used to be his belongings, he crawls to his knees, his still gaping asshole pointed toward the camera, and looks around, his eyes still glazed and his cock twitching beneath reddened balls, still raw from his ordeal. His eyes fix on the hole in the wall, and they follow the trail of orange cum, before staggering the rest of the way to his feet, his zombie-like walk taking him to the tunnel's entrance. With one last demented smile for the camera, he staggers forward, calling out loudly enough that the camera picks it up crystal clear. 'Wait for daddy!'";
	WaitLineBreak;
	say "     The camera looks on as Calvin disappears into the darkness, one hand on his stomach and the other bracing against the wall, following his draconic progeny in search of another fix. As the battery dies and everything fades to black, you realize that the intermittent moans you heard from that tunnel were probably his. Shuddering, you wonder how long he's been down there, stuck in a cycle of infinite birth and pregnancy, fed by nothing but his spawn's cum. Still, you can't help but wonder how it felt to be that heavily pregnant and to be nothing more than a brood mother for a horde of squealing creatures- Shaking your head, you dismiss the thought, hoping it's nothing more than the nanites' influence.";
	if Resolution of Messy Hideout < 5:
		now Resolution of Messy Hideout is 5;

Addicted Breeder ends here.