Alistair by Voidsnaps begins here.

[Thirst of Alistair: ButtSlut-O-Meter (Sub Alistair)             ]
[1: Made him blow you in first event after winning.              ]
[2: Sparred Again, beat him.Hotdogged his ass or pussyfrotted.   ]
[3: Full Buttslut mode. Sparred 2+ times. Considered your squire.]
[Hunger of Alistair: Dominant Alistair                           ]
[1: Blew him in first event after submitting.                    ]
[2: Fucked by Alistair once after losing spar.                   ]
[3: Fucked by Alistair repeatedly. You're his squire now.        ]

Section 1 - NPC Declaration and Room

Table of GameRoomIDs (continued)
Object	Name
Mystical Falls	"Mystical Falls"

Mystical Falls is a room.
It is fasttravel.
It is private.
Description of Mystical Falls is "[MysticFallsdesc]".

instead of sniffing Mystical Falls:
	say "     It smells like fresh water and the surrounding forest.";

to say MysticFallsdesc:
	say "     An idyllic waterfall surrounded by lush grass and brush sits in the middle of the forest. It's fed by no water source, and almost seems to be magical in nature judging by its inexhaustible supply of crystal-clear water. You can't really question its origin considering what else you've seen in this strange city, so you take it at face value.";

Table of GameCharacterIDs (continued)
object	name
Alistair	"Alistair"

Alistair is a man.
ScaleValue of Alistair is 3. [human sized]
Body Weight of Alistair is 5. [scale of 1-9 for body weight, grouped into low weight (1-3), mid weight (4-6) and high weight (7-9)]
Body Definition of Alistair is 9. [scale of 1-9 for body definition, grouped into low muscle (1-3), mid muscle (4-6), high muscle (7-9)]
[Body Adjective is generated out of the body weight and body definition and can be used in scenes - one word descriptive adjective depending on weight and definition groups: low weight group: skinny/slender/lithe; mid weight group: average/fit/muscled; high weight group: pudgy/husky/jacked]
Androginity of Alistair is 1. [Gender Adjective is generated out of androginity 1-9: hypermasculine/masculine/somewhat effeminate/effeminate/androgynous/feminine butch/tomboyish/feminine/hyperfeminine]
Mouth Length of Alistair is 5. [inches deep for face fucking; maximum possible will be double this number (when deep throating)]
Mouth Circumference of Alistair is 2. [mouth circumference 1-5, "tiny, small, normal, wide, gaping"]
Tongue Length of Alistair is 5. [length in inches]
Breast Size of Alistair is 0. [cup size as number, counting Flat Pecs = 0, A = 1, B = 2, ...]
Nipple Count of Alistair is 2. [count of nipples]
Asshole Depth of Alistair is 9. [inches deep for anal fucking]
Asshole Tightness of Alistair is 2. [asshole tightness 1-5, "extremely tight, tight, receptive, open, gaping"]
Cock Count of Alistair is 1. [number of cocks]
Cock Girth of Alistair is 3. [thickness 1-5, thin/slender/average/thick/monstrous]
Cock Length of Alistair is 10. [length in inches]
Ball Count of Alistair is 2. [allowed numbers: 1 (uniball), 2 or 4]
Ball Size of Alistair is 2. [size of balls 1-7: "acorn-sized", "dove egg-sized", "chicken egg-sized" "goose-egg sized", "ostrich-egg sized", "basketball-sized", "beachball-sized"]
Cunt Count of Alistair is 0. [number of cunts]
Cunt Depth of Alistair is 0. [penetrable length in inches; some minor stretching allowed, or more with Twisted Capacity]
Cunt Tightness of Alistair is 0. [size 1-5, generates adjectives of extremely tight/tight/receptive/open/gaping]
Clit Size of Alistair is 0. [size 1-5, very small/small/average/large/very large]
[Basic Interaction states as of game start]
PlayerMet of Alistair is false.
PlayerRomanced of Alistair is false.
PlayerFriended of Alistair is false.
PlayerControlled of Alistair is false.
PlayerFucked of Alistair is false.
OralVirgin of Alistair is false.
Virgin of Alistair is false.
AnalVirgin of Alistair is false.
PenileVirgin of Alistair is false.
SexuallyExperienced of Alistair is true.
TwistedCapacity of Alistair is false. [Twisted Characters can take any penetration, no matter the size]
Sterile of Alistair is true. [steriles can't knock people up]
MainInfection of Alistair is "Knight". [Always match the capitalization of the infection. Case sensitive.]
Description of Alistair is "[AlistairDesc]".
Conversation of Alistair is { "<This is nothing but a placeholder!>" }.
The scent of Alistair is "[AlistairScent]".

to say AlistairScent:
	say "     Alistair smells like honest sweat and masculinity. [if hunger of Alistair > 1]You want to bury your face in his sweatiest parts and clean them with your tongue. [else]You're sure he also smells a bit like you- As he should. A squire should smell like their master's satisfaction.[end if][line break]";

to say AlistairDesc:
	if debugactive is 1:
		say "     DEBUG -> Thirst(Submission): [thirst of Alistair] Hunger(Domination): [hunger of Alistair][line break]";
	say "     Alistair looks much like the rest of the knights you've seen around the forest, with boyishly short black hair and a matching goatee. Much of his body is covered in armor, and his shield is less sexually explicit than the other knights'. Flashes of tanned skin show through his collar, glistening with sweat from training and fighting 'monsters,' while green eyes shine with confidence, sizing you up. He looks ready for a fight!";

Section 2 - Meeting Alistair

Table of GameEventIDs (continued)
Object	Name
Gruff Gallant And Misguided	"Gruff Gallant And Misguided"

Gruff Gallant And Misguided is a situation.
ResolveFunction of Gruff Gallant And Misguided is "[ResolveEvent Gruff Gallant And Misguided]".
Sarea of Gruff Gallant And Misguided is "Forest".
The level of Gruff Gallant And Misguided is 10.
when play begins:
	add Gruff Gallant And Misguided to BadSpots of MaleList;

to say ResolveEvent Gruff Gallant And Misguided:
	say "     As you work through the forest, you hear rushing water. Curious, you pick your way through the dense brush, heading toward the sound. Any opportunity to fill a water bottle or two would be welcome, assuming some mutant hasn't contaminated it. Expecting to find a small creek, you stumble upon something far grander. Sitting in a clearing, seemingly fed by a nonexistent river, a waterfall rises before you. You're so distracted by the awe-inspiring sight that you nearly miss that you're not alone! Standing under the waterfall, a human runs his hands through black hair, letting the water cascade down over muscular, lightly hairy pecs and down to his bare midriff, barely obscuring his manhood. It's easy to recognize the dashing appearance of one of the forest's many knights, but somehow this one seems different, despite his identical appearance.";
	say "     If you wanted to, you could take a closer look.";
	say "     ([link]Y[as]y[end link]) - Ogle the knight and enjoy the sight of his nude body. What's the worst that could happen?";
	say "     ([link]N[as]n[end link]) - You're not really interested. Walk away.";
	if player consents:
		say "     Sneaking closer, you fix your eyes on the enchanting sight of battle-hardened muscles dripping with water. Thankfully the knight's eyes are closed, and you thank your lucky stars as his hand wanders lower and he steps out of the spray, revealing a half-hard foreskin-covered cock. The sight of his fingers stroking along it, innocently cleaning sweat from his shaft, and uncovering the pink cockhead in the process, soon has you touching yourself and imagining how it would feel in your hand. Shaking your head, you put the thought out of your mind. Sexual encounters with strange creatures seldom end well, and you don't even know if this man is friendly! Soon enough, the knight moves on from cleaning his manhood, turning around to dip his head beneath the spray and giving you an eyeful of a lightly hairy ass, perfectly toned and flexing butt. The sight drags a soft noise of appreciation from your mouth, and though you clap your fingers over your face, you realize that the knight has heard you. Still erect and dripping with water, he moves to the pool's edge, grabbing a hidden sword and shield and splashing toward you before you can react.";
		if kpstatus is 1: [Knight]
			say "     The knight visibly relaxes once he reaches you, his stance dropping and his weapons held loosely at his side. 'Hail, stranger. Judging by thy raiment, thou'rt a fellow knight. Excuse my state of undress.' The knight bows before you, looking quite comical with a half-hard cock swinging between his legs and a bare body. 'I s'pose I shall have to regain mine honor.' Gesturing with his sword, he readies himself for combat, wearing an amiable grin.";
		if kpstatus is 2: [Squire]
			say "     The knight visibly relaxes once he reaches you, his stance dropping, his weapons held loosely at his side, and a lazy grin on his face. 'Thou'rt a slip of a boy. Didst thou lose thy master? Allow me to test you, then. I've been in need of attendance for quite some time.' The knight bows before you, looking quite comical with a half-hard cock swinging between his legs and a bare body. 'Worry not, my boy. I shall be gentle.' Gesturing with his sword, he readies himself for combat, wearing an amiable grin and regaining his erection in anticipation of the fight's aftermath.";
		if kpstatus is 3: [Human]
			say "     The knight visibly relaxes once he reaches you, his stance dropping, his weapons held loosely at his side, and a lazy grin on his face. 'Art thou lost, peasant? I shall have to show you what it means to gaze upon nobility.' The knight looks down his nose at you, looking quite comical with a half-hard cock swinging between his legs and a bare body despite his attitude. 'Worry not. I shall be gentle, as my duty requires.' Gesturing with his sword, he readies himself for combat, wearing an amiable grin and regaining his erection in anticipation of the fight's aftermath.";
		if kpstatus is 4: [Monster (nonhuman)]
			say "     'Monsters, the lot of you. [']Tis impossible to gain a moment's peace without thy kind attempting to force themselves upon me.' With a cold expression, the knight looks you over, then readies his weapons with a grunt. 'Not this time, foul beast. Ready thyself. I shall sheathe one of these swords within thy body. [']Tis your choice which it might be.'";
		now inasituation is true;
		challenge "Knight";
		if fightoutcome < 20: [player won]
			say "     As you land the final blow, the knight falls to his knees, breathing heavily and holding himself by the edge of his shield. His manhood dangles obscenely, dripping with excitement, and his bare body is on display, allowing you to admire his battle-honed physique. Tilting his head upward and searching his eyes, you notice there's no small amount of lust in them. Is he getting off to the idea of being ravaged by someone that defeated him? Perhaps this is an opportunity to give the man what he wants while enjoying yourself.";
			say "     Do you want to take advantage of the defeated knight?";
			say "     ([link]Y[as]y[end link]) - Make the knight service you- whether he wants to or not.";
			say "     ([link]N[as]n[end link]) - On second thought, you don't want to fuck the knight."; [last chance to say no.]
			if player consents:
				if player is male:
					say "     Tossing aside your gear, you take advantage of the knight's vulnerable position, gripping his hair and smirking as the exhausted man lolls in your grasp. To the victor goes the spoils, as they say. Slowly, you guide the dazed man closer, lining yourself up with his mouth and parting his lips with the tip of your cock, hissing under your breath at the silky wetness of his tongue. With a grunt, you slide to the root without asking for permission, pausing to appreciate the tight squeeze of the knight's throat and his struggle to take you. It seems like the knight's a natural at sucking cock. Besides a sputtering gag at your first plunging thrust, he barely protests, relaxing his throat and taking on a dazed, faraway look as though cockdrunk. Rather than pushing you away as he regains his strength, he grips your ass with both calloused hands, dragging you into each thrust and rolling his tongue against the underside of your cock. Before long, at his urging, you're fucking his face, slurping wet sounds from his sucking lips and painting his beard and mustache with a sloppy mix of drool and pre.";
					say "     Widening your stance, you hump to your heart's content, gripping short black hair and ramming yourself home. Your balls slap against the knight's chin as his green eyes stare lifelessly up at you, too desperate to please to struggle, and a thought crosses your mind that nearly makes you cum on the spot- Every knight needs a squire. This knight's proven to be a cock-hungry squire, so why shouldn't you take his place as his master? You'd be doing him a favor. Unperturbed by the twisted thought of superiority that doesn't seem your own, you slam home, grunting as you empty yourself down the disgraced knight's throat. Holding him there, you wait until your cock softens, wiping it across his face and smirking as his tongue darts to clear the last pearly drops from your tip. You get the feeling that you've started something. Perhaps you should [italic type]come back here and see if you can continue to disgrace this poor knight? [roman type]Next time you might even ask his name.";
					say "     Grabbing your gear and re-dressing, you continue on your way, leaving the nameless knight in an exhausted heap with a raging erection and a need to wash himself again. You'll have to remember this place and return to claim him later.";
					NPCSexAftermath Alistair receives "OralCock" from Player;
					now thirst of Alistair is 1;
					now Resolution of Gruff Gallant And Misguided is 1; [Fucked the knight's face as a male.]
					AddNavPoint Mystical Falls;
				else if player is female:
					say "     Tossing aside your gear, you take advantage of the knight's vulnerable position, gripping his hair and smirking as the exhausted man lolls in your grasp. To the victor goes the spoils, as they say. Slowly, you guide the dazed man closer, lining yourself up with his mouth and pressing your clit against his parted lips, hissing under your breath at the silky wetness of his tongue swiping over it instinctually. With a grunt, you slide your wetness over the prickly surface of his beard without asking for permission, pausing to appreciate his slow tonguing. It seems like the knight's a natural at cunnilingus. Besides a soft gasp seconds before your first grind, he barely protests, relaxing against your pussy and taking on a dazed, faraway look as though drunk on your musk. Rather than pushing you away as he regains his strength, he grips your ass with both calloused hands, dragging you into each thrust of your hips and rolling his tongue against your entrance. Before long, at his urging, you're fucking yourself on his tongue, slurping wet sounds from his sucking lips and painting his beard and mustache with a sloppy mix of drool and pussy juice.";
					say "     Widening your stance, you hump to your heart's content, gripping short black hair and ramming throbbing pussy against his sloppy licking. Your thighs swallow the knight's face as his green eyes stare lifelessly up at you, too desperate to please to struggle, and a thought crosses your mind that nearly makes you cum on the spot- Every knight needs a squire. This knight's proven to be a pussy-hungry squire, so why shouldn't you take his place as his better? You'd be doing him a favor. Unperturbed by the twisted thought of superiority that doesn't seem your own, you slam home, grunting as you squirt, messing the knight's throat and chest with your nectar. Holding him there, you wait until your pussy stops clenching, wiping your sopping sex across his face and smirking as his tongue darts to clear the last clear drops from your clit. You get the feeling that you've started something. Perhaps you should [italic type]come back here and see if you can continue to disgrace this poor knight? [roman type]Next time you might even ask his name.";
					WaitLineBreak;
					say "     Grabbing your gear and re-dressing, you continue on your way, leaving the nameless knight in an exhausted heap with a raging erection and a need to wash himself again. You'll have to remember this place and return to claim him later.";
					now thirst of Alistair is 1;
					NPCSexAftermath Player receives "OralPussy" from Alistair;
					now Resolution of Gruff Gallant And Misguided is 4; [Player pussy eaten. Determines sex scenes in future encounters.]
					AddNavPoint Mystical Falls;
			else:
				say "     Shaking your head, you clear the thoughts of taking advantage of the knight from your head and turn your back on his nude form. You've seen where things like this go. You're not willing to lose your humanity for a piece of ass, as plump and well-muscled as it is.";
				now Resolution of Gruff Gallant And Misguided is 100;
		else if fightoutcome > 19 and fightoutcome < 30: [submitted]
			if fightoutcome is 22:
				say "     Stopping in your tracks, you hold up your arms, then drop to your knees, stating that you yield. You're sure the knight is more skilled in combat and would prefer not to be beaten any worse than you already are! Politely, you look away from his manhood, though you can't help but admire the way it sways when he tosses aside his sword and shield, throbbing at half-mast. The knight seems pleased at your submission, closing the distance between you and presenting the cock you've been lusting over. With an arrogant harrumph, he lords his superiority over you, smearing his cocktip against your face and marking your nose and lips with fragrant pre. 'S'pose it's natural to bow before nobility. Perhaps thou wouldst like some lessons? My sword could use a squire to shine it.' The knight punctuates his words with his cock, flopping it between your eyes and forcing you to breathe in the faint, freshly cleaned musk of his hairy balls. 'Though thou needst to prove thy devotion.' He doesn't phrase his need for worship as a question, as though he's sure you'll worship his cock either way. You'd be offended if you weren't already drooling, sucking in deep lungs full of his scent and barely resisting the urge to capture his hardening tip between your lips. You lose the battle with your libido before he has to ask you twice, and without bothering to disrobe, mouth at the maleness before you, coating the pink skin in a thick layer of drool as you work your way toward his dripping tip.";
				say "     'That's it. Polish every inch.' The knight sighs, tightening his grip on your head and working you toward its apex. He's quick to take what he wants when he feels your lips at his tip, pushing forward into your throat and slapping his balls against your chin. It's as if you already belong to him- He uses your mouth with little regard for comfort, coating your tongue in his arousal and ensuring you'll taste nothing else for hours. The slightest bit of protest is met with a trip to the base of his shaft until you apologize with your tongue, slathering the underside in slippery apologies and begging for more. You lose track of time speared on the man's cock, sucking away and letting him turn your face into a sloppy mess of pre and drool.";
				say "     The bittersweet sensation of his cock bucking like a wild bronco rouses your senses, and you stare up at him with pure need in your eyes as you realize you're about to taste the knight's- your new master's- seed. Your heart soars as you watch the warrior's jaw clench, and you moan as salty satisfaction paints your tongue, your involuntary reaction forcing the heady mix of masculinity and saliva out through your nostrils and making a further mess of your face, painting you as the knight's whorish new squire. You're so cockdrunk that it barely registers when the knight pulls himself free of your suckling mouth, wiping himself clean on your cheek and gathering his gear. Something inside of you tells you to follow him as he tucks himself into a suit of armor, hiding that delectable cock from your ravenous view, but your legs are made of gelatin, so you can only watch as he disappears into the forest. A few moments later, you follow suit, staggering to your knees and gathering your wits, spooning the mystery man's spilled seed into your mouth to join the warm load in your stomach and marking the waterfall's location in your mental map. Next time you'll have to ask your master's name.";
				now Resolution of Gruff Gallant And Misguided is 2; [Submission Sex. Become his Squire.]
				now hunger of Alistair is 1;
				NPCSexAftermath Player receives "OralCock" from Alistair;
				AddNavPoint Mystical Falls;
			else: [lost]
				say "     As you fall under the knight's attacks, he clicks his tongue, standing over you and balancing on his sword, sticking it into the ground in front of him. 'Thou art passable, but nothing special.' He looks over your sprawled form for a moment, then smirks. 'T'would serve you well to learn the basics. Shall I take on the role of teacher? Mine rates are... negotiable.' It's clear from his tone that he means giving up your body in exchange for these 'lessons.' As he gathers his clothing and disappears into the brush, you're left to ponder your options as you recover, eventually feeling well enough to stand and return to the Urban Forest.";
				now Resolution of Gruff Gallant And Misguided is 3; [Disappointed knight, no sex.]
				AddNavPoint Mystical Falls;
		else if fightoutcome > 30: [Fled. Storyline does not continue.]
			say "     Without looking back, you run through the brush, trusting that the knight won't want to chase after you in the nude. Soon enough you return to the entrance to the Urban Forest, pausing to catch your breath and confirming that you lost the man. You're not willing to risk your humanity on the outcome of a fight, and you doubt that whatever the knight had in mind is completely innocent.";
			now Resolution of Gruff Gallant And Misguided is 100; [Alistair isn't interested in cowards.]
		now inasituation is false;
	else:
		say "     Shaking your head, you decide not to bother with the waterfall or the man bathing in it. If there's one mutant here, no matter how human they look, it's likely that the water is tainted. Shouldering your pack, you click your tongue and continue on your way, making a mental note to avoid this area in the future.";
	now Gruff Gallant And Misguided is Resolved;

instead of conversing Alistair:
	if thirst of Alistair > 0:
		say "[PlayerKnightAlistairSquireMenu]";
	else if hunger of Alistair > 0:
		say "[PlayerSquireAlistairKnightMenu]";
	else:
		say "     'Enough talk- Thy showing was quite poor, last we met. Offer a challenge, then I shall entertain your idle chatter!' Before you can even open your mouth, the knight is readying his sword! You doubt you can change his mind, so all you can do is give it your all!";
		say "[AlistairSpar]";

instead of fucking Alistair:
	if thirst of Alistair > 0:
		say "[PlayerKnightAlistairSquireMenu]";
	else if hunger of Alistair > 0:
		say "[PlayerSquireAlistairKnightMenu]";
	else:
		say "     'Enough talk- Thy showing was quite poor, last we met. Offer a challenge, then I shall entertain your idle chatter!' Before you can even open your mouth, the knight is readying his sword! You doubt you can change his mind, so all you can do is give it your all!";
		say "[AlistairSpar]";

Table of NavInEvents (continued)
Priority	Name	EventObject	EventConditions	EventRoom	LastEncounterTurn	CoolDownTurns	EncounterPercentage
1	"Well Met"	Well Met	"[EventConditions_Well Met]"	Mystical Falls	2500	8	100

to say EventConditions_Well Met:
	now CurrentWalkinEvent_ConditionsMet is true;

Table of GameEventIDs (continued)
Object	Name
Well Met	"Well Met"

Well Met is a situation.
ResolveFunction of Well Met is "[ResolveEvent Well Met]".
Sarea of Well Met is "Nowhere".

to say ResolveEvent Well Met:
	say "     'Well met, ser.' A familiar voice calls from near the falls. The knight stands, his armor clattering and his body sadly far more covered than it once was. 'Thy bravery shan't be understated. Not many would indulge in further contact with an assailant.' Holding out his hand, the knight takes yours and shakes it vigorously, his grip hard enough to crack bones.'Ser Alistair Du Pont. At your service.' Alistair beams and bows like a nobleman in a tv show, but judging by his fully armored appearance, it seems he's here for combat, rather than idle chat. If you want to indulge yourself, you should probably spar with him first.";
	move Alistair to Mystical Falls;
	Now Well Met is Resolved;


Section 3 - Knight Path

to say PlayerKnightAlistairSquireMenu:
	say "     [bold type]What do you want to talk with [if Energy of Alistair is 1]Alistair [else]the knight [end if]about?[roman type][line break]";
	LineBreak;
	now sextablerun is 0;
	blank out the whole of table of fucking options;
	[]
	choose a blank row in table of fucking options;
	now title entry is "Ask to spar";
	now sortorder entry is 1;
	now description entry is "You want to fight the knight again! Ask if he's willing";
	[]
	if thirst of Alistair is 2 and "Training Alistair" is not listed in Traits of Alistair:
		choose a blank row in table of fucking options;
		now title entry is "Skip the fight";
		now sortorder entry is 2;
		now description entry is "You don't need to prove your superiority. Show Alistair your superiority another way";
	[]
	if "Training Alistair" is listed in Traits of Alistair:
		choose a blank row in table of fucking options;
		now title entry is "Train your Squire";
		now sortorder entry is 3;
		now description entry is "Take your newly minted squire on his first lesson";
		[]
	sort the table of fucking options in sortorder order;
	repeat with y running from 1 to number of filled rows in table of fucking options:
		choose row y from the table of fucking options;
		say "[link][y] - [title entry][as][y][end link][line break]";
	say "[link]0 - Nevermind[as]0[end link][line break]";
	while sextablerun is 0:
		say "Pick the corresponding number> [run paragraph on]";
		get a number;
		if calcnumber > 0 and calcnumber <= the number of filled rows in table of fucking options:
			now current menu selection is calcnumber;
			choose row calcnumber in table of fucking options;
			say "[title entry]: [description entry]?";
			if Player consents:
				let nam be title entry;
				now sextablerun is 1;
				if (nam is "Ask to spar"):
					say "[AlistairSpar]";
				else if (nam is "Skip the fight"):
					say "[AlistairCockSlut]";
				else if (nam is "Train your Squire"):
					say "[AlistairCockTraining]";
				wait for any key;
		else if calcnumber is 0:
			now sextablerun is 1;
			say "     You step back from the knight, deciding on a different course of action.";
			wait for any key;
		else:
			say "Invalid Option. Pick between 1 and [the number of filled rows in the table of fucking options] or 0 to exit.";
	clear the screen and hyperlink list;


Section 4 - Squire Path

to say PlayerSquireAlistairKnightMenu:
	say "     [bold type]What do you want to talk with Alistair about?[roman type][line break]";
	LineBreak;
	now sextablerun is 0;
	blank out the whole of table of fucking options;
	[]
	choose a blank row in table of fucking options;
	now title entry is "Ask to spar";
	now sortorder entry is 1;
	now description entry is "Alistair offered to be your teacher- Take him up on that offer";
	[]
	if hunger of Alistair is 2 and "Alistair's Knight Training" is not listed in Traits of Alistair:
		choose a blank row in table of fucking options;
		now title entry is "Offer yourself to your knight";
		now sortorder entry is 2;
		now description entry is "Your master is far too mighty. You can't hope to beat him, maybe you should worship him instead? Or perhaps he'll be more interested in training you";
	[]
	if "Alistair's Knight Training" is listed in Traits of Alistair:
		choose a blank row in table of fucking options;
		now title entry is "Offer yourself for training";
		now sortorder entry is 3;
		now description entry is "You can still remember what it felt like when Alistair forced you to kneel as a kinky sort of exercise. See what else he has in store for you";
	sort the table of fucking options in sortorder order;
	repeat with y running from 1 to number of filled rows in table of fucking options:
		choose row y from the table of fucking options;
		say "[link][y] - [title entry][as][y][end link][line break]";
	say "[link]0 - Nevermind[as]0[end link][line break]";
	while sextablerun is 0:
		say "Pick the corresponding number> [run paragraph on]";
		get a number;
		if calcnumber > 0 and calcnumber <= the number of filled rows in table of fucking options:
			now current menu selection is calcnumber;
			choose row calcnumber in table of fucking options;
			say "[title entry]: [description entry]?";
			if Player consents:
				let nam be title entry;
				now sextablerun is 1;
				if (nam is "Ask to spar"):
					say "[AlistairSpar]";
				else if (nam is "Offer yourself to your knight"):
					say "[AlistairFucksPlayer]";
				else if (nam is "Offer yourself for training"):
					say "[AlistairKnightKinkTraining]";
				wait for any key;
		else if calcnumber is 0:
			now sextablerun is 1;
			say "     You step back from the knight, deciding on a different course of action.";
			wait for any key;
		else:
			say "Invalid Option. Pick between 1 and [the number of filled rows in the table of fucking options] or 0 to exit.";
	clear the screen and hyperlink list;

to say AlistairSpar:
	if debugactive is 1:
		say "     DEBUG -> Thirst(Submission): [thirst of Alistair] Hunger(Domination): [hunger of Alistair][line break]";
	if thirst of Alistair is 1: [Fucked him once]
		say "     'Thy luck shan't hold.' Alistair crows as he readies his sword, then swings it toward you. Despite his defeat at your last meeting, it seems he wants to regain his honor. Perhaps you should show him his place?";
	else if hunger of Alistair is 1: [He fucked you]
		say "     'Worry not. I shall make a noble fighter out of thee yet, dutiful squire.' Alistair crows as he readies his sword, then swings it toward you. He wasn't kidding about training you. Hopefully, you can stop him from making a fool of you!";
	else if thirst of Alistair is 2: [Beaten and fucked him twice]
		say "     'Thy skill is vexing, but mine honor demands I accept your challenge.' Alistair says as he readies his sword, looking uncertain. Despite his defeat at your last meeting, it seems he wants to regain his honor, but he can barely look away from your crotch. It seems he wants to pretend he's not your dutiful servant. How cute.";
	else if hunger of Alistair is 2: [He beat you and fucked you twice]
		say "     'Worry not. I shall make a noble fighter out of thee yet, dutiful squire. Shall I even provide a handicap?' Alistair crows as he readies his sword, using his free hand to drop his pants and free his half-hard manhood. He wasn't kidding about training you, but you only have eyes for his freely flopping cock. Hopefully, you can stop him from making a fool of you, but somehow, you don't mind if he does!";
	else if thirst of Alistair > 2: [Beat him and fucked him at least 3 times]
		say "     'Thy skill is vexing, but mine honor demands I accept your challenge.' Alistair says as he readies his sword, openly ogling your crotch. Despite his defeat at your last meeting, it seems he wants to regain his honor, but he can barely stop himself from stripping and pleasuring you! How cute. Maybe you should skip sparring and give him what he wants, next time.";
	else if hunger of Alistair > 2: [He beat you and fucked you at least 3 times]
		say "     'Come now, squire. Thy desire is plain on thy face. Allow me to offer thee a pleasant view whilst I show you your place.' Throwing off his armor, the knight strips to the nude, stroking himself with his free hand as he readies his sword, forgoing his shield. You'd be embarrassed if you weren't struck by the sudden urge to fall to your knees and suck his cock!";
	now inasituation is true;
	challenge "Knight";
	if fightoutcome < 20: [player won]
		if hunger of Alistair > 0: [Other path already chosen. No sex.]
			say "     Alistair looks dumbfounded as he falls to his knees, defeated. As if he can't believe he's just lost, he sheepishly holds out his hand, his regret written across his face. You stammer out an apology and stroke his ego, telling him he must have pounded lessons into you well enough to stick. Quietly, you ponder throwing the fight next time. It wouldn't do for a squire to show up his knight!";
		else: [player is not on the other path]
			if thirst of Alistair is 0: [not on either path]
				increase thirst of Alistair by 1; [start of the sub path]
			if thirst of Alistair is 1: [Winning results in sex]
				say "     With a flourish, you knock the knight-turned-squire to his knees, sending his sword flying to the side to embed itself in mud. You can't help a sense of accomplishment as you look down at the defeated knight- no. You correct your thoughts. Alistair is no longer a knight; he's your squire. It's only fair that you demote him if he can't defeat you! It's only fair that a demotion comes with a punishment. As you look down on the knight, you ponder what to do with him. His mouth looks like it could use [if resolution of  Gruff Gallant And Misguided is 1]another [else]a [end if]coat of cum, but you dismiss the idea. If you want to show him his place, you should do something more hands-on. Circling his unmoving form, you let your eyes wander downward, then, on a whim, aim a kick between his shoulders, sending him falling forward to his knees. You know what you want to do first. Pantsing the knight, you admire his well-muscled, lightly hairy ass, smacking one cheek and leaving a red mark on tanned skin. It seems that Alistair's a seasoned buttslut, based upon his whimper and unwilling wiggle, but even more interesting is his cock's plump, dangling form. Is he enjoying your mistreatment? You could take this opportunity to have fun with the submissive former knight.";
				say "     How do you want to take advantage of the submissive 'squire?'";
				LineBreak;
				let Alistair_Sub_Scene_One_Choices be a list of text;
				if Player is kinky:
					add "Use the hilt of his sword to fuck him." to Alistair_Sub_Scene_One_Choices;
				if Player is female:
					add "Take charge and show him who his dick belongs to with a messy pussy frot." to Alistair_Sub_Scene_One_Choices;
				if Player is male: [neuters go home!]
					add "Hotdog his ass." to Alistair_Sub_Scene_One_Choices;
				let Alistair_Sub_Scene_One_Choice be what the player chooses from Alistair_Sub_Scene_One_Choices;
				if Alistair_Sub_Scene_One_Choice is:
					-- "Use the hilt of his sword to fuck him.":
						LineBreak;
						say "     The sword stuck at your side gives you an idea. What better way to disgrace your knight than to use his sword to defile him? Grabbing the weapon, you run your fingers over its pommel, announcing that you've found a new sheath for Alistair's weapon. As Alistair panics, anticipating what you're about to do and trying to escape your grip, you spread his cheeks with one hand, guiding the sword's rounded base and slotting it against his terrified, winking hole. Before he can speak, his words melt into a surprised yelp, morphing into a shameful moan as you spit on the tip and slide it home, burying the handle inches into Alistair's hole and carefully holding it in place. You can't help but laugh at the sight of his 'tail,' spanking his ass and telling him to man up. After all, with how easily it slipped in, it can't be the biggest thing that's spread his cheeks.";
						say "     An ashamed grunt is all you hear in response, prompting you to angle the strange insertion until Alistair's cock begins to drip. The whorish moans that your prostate stimulation drags from his mouth spur you on, and soon you're fucking the knight on his sword, weighing his balls with your free hand. He's so tense, and the expression on his face screams concentration despite the sounds dragged from his throat, so you can't help but attempt to ruin that, speeding your hand until Alistair's expression breaks, his mouth hanging open and drool dripping down his bearded chin. Your breakneck pace has the desired effect, and soon enough, you're holding churning balls in a gentle, massaging grip as he paints the ground below himself with seed. Slowly, you withdraw the sword from his ass, admiring the pink gape you gave that muscular butt and commenting on how well-behaved he is as you gather your things and prepare to walk away.";
						NPCSexAftermath Alistair receives "AssDildoFuck" from Player;
					-- "Take charge and show him who his dick belongs to with a messy pussy frot.":
						LineBreak;
						say "     [if Player is not barecrotch]Baring your crotch and t[else if player is barecrotch] T[end if]ouching your sex until your fingers come away with a layer of silken wetness, you slip beneath the knight, taking hold of Alistair's manhood and spreading your legs wide as you stare into confused green eyes. His expression quickly melts into lust as you guide his cockhead against your needy pussy, but as he maneuvers to slop in, you grip his dick hard enough to drag a groan from his mouth, stopping him in his tracks with nothing but your fingers. Gentle fingers stroke along his shaft once he behaves, and you raise your spare hand to his face, stroking his cheek and telling him he doesn't get to control how things go. Alistair huffs but nods, his face flushed with the realization that he's the submissive one, even if you're the one with a pussy. 'As you wish. I am thine to command, Mistress.' He mulls that last word around as though it leaves a bad taste in his mouth, but his cock deposits a heavy dribble of pre against your slick clit, throbbing in time with his words.";
						say "     You settle into a slow rhythm, grinding the knight's cock along your slit and dueling his rounded tip with your clit, delighting in the sopping wet mess your combined fluids make. Of course, it's not enough, and within a few moments, you're wrapping your legs around Alistair's waist, forcing his 'sword' to belch its virility against your mound while its swollen underbelly provides sweet friction. Panting, you attack the knight's neck with your mouth, biting and sucking at sensitive skin until you can feel his orgasm rising in the twitching shaft between your lower lips. You reach your peak just as your toy paints your stomach with seed, wasting his load inches from your needy hole. It feels too good to stop, so you buck like a wild horse, forcing Alistair to keep up until your orgasm fades and leaving him whimpering and soaked in your juices. Without further fanfare, you push him off of you to flop on the bank of the waterfall, pants down and cock softening. Gathering your juices and mixing them with his wasted seed, you taste your fingers as you stand over him, watching his manhood twitch and his breath quicken. You tell him what a good squire he's been as you dress, promising you'll let him finish inside you next time. Judging by his blushing face and subconscious swallow, he's looking forward to it.";
						NPCSexAftermath Player receives "Stroking" from Alistair;
					-- "Hotdog his ass.":
						LineBreak;
						say "     Slapping your cock between Alistair's wiggling cheeks, you tease his hole with your tip, delighting in its protesting clench. It seems he hasn't had his ass used in a while, but the way he spreads his legs and pushes back, he's taken one before! Still, an ass like this deserves a little love before the main event. Pulling your cock back, you spit onto the pink bullseye between his cheeks, then spread it around with the belly of your shaft, delighting in the muscular cheeks hugging either side of you. He's warm from your fight, and the hair on his ass gently tickles your sensitive skin, so before long, you're grinding hard, smearing spit and pre over that slick valley, and planting both hands on his hips.";
						say "     The stoic expression on Alistair's face draws your attention. He's blushing, but he looks like he's enduring what you're doing rather than enjoying it, despite his cock's eager bucking against his stomach and its drooling spiderwebs of pre. You can't have that. Releasing your grip on one hip, you slap his ass, asking him who he belongs to. Who defeated him? Who owns his ass? 'I am thine.' Alistair murmurs, his voice growing higher-pitched as you reward him with a rougher slap that clenches his cheeks and threatens to draw you over the edge. 'THINE!' He barks out, biting his lower lip and bucking back against you hard enough that your sawing cocktip parts his hole, popping your manhood into his sweltering depths even as it clamps to welcome you.";
						WaitLineBreak;
						say "     The admission draws you over the edge, and even as your cock slips free from its momentary penetration, you paint his pink entrance, your seed bathing his slightly parted hole and dripping down over his balls. Slowly, you prod and plunge your cockhead past his defenses, marking his first inch of silken innards with dribbling seed and reaching under him to grab his cock, jerking him hard and fast. Shortly after, he joins you in orgasm, his face melting into an expression of pure pleasure as he paints your fingers with his submission. You wipe your gooey hand on the knight's upturned ass, then clean your cock the same way, thanking him for his service. Next time, you promise to fuck him properly, as a  knight should, but for now, you have other things to do.";
						NPCSexAftermath Player receives "Stroking" from Alistair;
				infect "Knight";
				now thirst of Alistair is 2;
			else if thirst of Alistair > 1: [Stage 2/repeats. Can be expanded later.]
				say "     Without wasting any time, you ask Alistair to strip. You can't help but grin with pride as he quickly follows your orders, kneeling before you with a hard cock and a gaze that can't quite meet yours. Crossing the distance between you, you [if Player is not barecrotch]bare yourself and [end if]guide his face between your thighs, [if Player is male]rubbing your cock across his lips [else if Player is female]rubbing his bearded face against your pussy[end if]. As his tongue sets to work pleasing you, you relax your stance, gripping his hair and guiding him around to your sensitive spots, but before long, you want more. Yanking him back by his hair, you admire his wet lips and beard smeared with your scent, contemplating what you want to do with him.";
				say "     How should you use your slut knight?";
				LineBreak;
				let Alistair_Sub_Scene_Two_Choices be a list of text;
				if Player is female:
					add "Ride his dick." to Alistair_Sub_Scene_Two_Choices;
				if Player is male:
					add "Pound his ass." to Alistair_Sub_Scene_Two_Choices;
				let Alistair_Sub_Scene_Two_Choice be what the player chooses from Alistair_Sub_Scene_Two_Choices;
				if Alistair_Sub_Scene_Two_Choice is:
					-- "Ride his dick.":
						LineBreak;
						say "     Dropping down eye to eye with the kneeling knight, you straddle him, stroking his manhood and grinding it against your wetness. Pressing a teasing kiss to his cheek, you ask the knight if he thinks he's worthy of seeding you, even as you sway your hips, nestling his tip against your heated entrance. 'I will endeavor to stay in thine good graces.' The knight hisses through clenched teeth, his hands tentatively gripping your hips and his cock bucking, betraying his eagerness. 'Thy choice is mine.' How cute. He's trying so hard to hold back when even the slightest movement would send you plummeting to the base of his shaft.Taking advantage of his reluctance to tease the obedient 'squire,' you line yourself up, squishing Alistair's cock against your entrance and cooing as it splits you open. Slowly, you savor the penetration, enjoying every inch until you feel the unmistakable sensation of the man's cockhead kissing against your cervix. Like an excited puppy, his cock trembles, and you swear you can feel him start to leak.";
						say "     Gently, you begin to ride, ravaging your fallen knight with rough kisses that leave him no room to pretend he's not enjoying your domination. Instead, he meekly welcomes your tongue, sucking on it even as you use him to sate your lust. Forgoing a leisurely pace, you quicken your hips, continuing until he's right at the edge, desperate to finish and twitching madly in your slippery depths, only to stop your ministrations, pausing with his cock still half-buried inside you. Panting mischievously, you murmur in Alistair's ear, wondering aloud if he was planning to finish before you. Perhaps you should find a different sword for your sheath? 'Nay. I shall serve. Thine pleasure is mine.' The enraptured knight says as you guide him forward to lean over you. Slamming home, he hits the ground running, pounding your pussy as hard as he can and enfolding you in muscular arms. It would almost seem he were in charge if he weren't whimpering into your neck with every thrust and trying so hard not to cum that it must hurt.";
						WaitLineBreak;
						say "     Goading your submissive knight to the edge, you take every inch he's willing to give you, slapping his bare ass like a misbehaving horse and delighting in how much he seems to enjoy the punishment. Before long, you can feel your finish approaching, so you tell your eager lover to seed you, hanging on as he spears forward and cries out his desire, hilted for the last time. A flood soon follows as your orgasm washes over you, mixing with the thick seed that drools from your union to drip in a frothy mess to the ground below. Your noble former knight cleans up his mess with his tongue without your orders, worshiping your cunt until you're forced to push him away, then lying there with a half-hard cock, panting with a dreamy look on his face. You doubt he'll move soon, but you have places to be and people to see, so you cut your visit short, thanking him for servicing you properly and leaving him with horny daydreams and drained balls.";
						NPCSexAftermath Player receives "PussyFuck" from Alistair;
					-- "Pound his ass.":
						LineBreak;
						say "     Tugging Alistair forward with little regard for his dignity, you circle him and grip his hips, slapping one bare cheek when he doesn't present himself quickly enough for your liking. You waste no time slotting yourself against his hole, wondering aloud if he's been touching himself without your permission. Judging by his entrance welcoming you- relaxed and slightly wet, it seems he has. What a slut! With nothing to stop you from gliding to the hilt, you savor the knight's softened depths, cooing about how good of a squire he is to keep himself ready for your pleasure. Alistair's face says it all. From the moment you slipped inside of him, his jaw slackened, and his face reddened. Far from the strained pleasure you'd expect, he's lost himself to the sensations of being fucked. You can even hear him muttering under his breath. 'Thy... Thy cock is divine. 'Tis unfair. I can't-' He cuts himself off with a moan, clamping around your cock when you prod his sweet spot, his face buried in his arm to muffle the unmanly sounds dragged from his throat. Soon enough, it starts to feel like more of a game. You're not just fucking the knight; you're trying your best to drag more and more sounds from his throat and break his expression further. Angled thrusts abuse his prostate, and reddening slaps mark his ass as yours, but it doesn't feel like enough.";
						if thirst of Alistair is 2: [first time]
							say "     Leaning over the fallen knight, you abuse his ass, slamming down hard enough to destroy his poor pleasure spot and fixing your gaze on his shoulder. Suddenly, you know what the knight's body needs- a more permanent reminder of your coupling. Your teeth sink in, drawing a desperate whimper from the slutty knight, and you feel the telltale clamp of his inner walls milking your dick while wet splatters to the mud below confirm his orgasm. With a muffled growl more worthy of a beast than a human, you bury your 'sword' to the hilt, marking Alistair's innermost sanctum with evidence of his submission. You nearly black out from the pleasure, but thankfully the knight-turned-squire is sturdy, and he holds you up, though his legs shake and helpless groans vibrate through him in time with each creamy squirt. Moments later, you slip free of the knight's hole and pat his abused butt, wiping your cock clean on one spanking-blushed cheek. Praising him for his service as your squire, you redress, admiring the pretty sight of his cock dribbling to the ground below and his abused hole beginning to drool.";
						else if thirst of Alistair > 2: [any repeats]
							say "     Leaning over the fallen knight, you abuse his ass, slamming down hard enough to destroy his poor pleasure spot and fixing your gaze on his shoulder. Your teeth sink into the mark on his shoulder, reinforcing the mark of submission, drawing a desperate whimper from the slutty knight, and you feel the telltale clamp of his inner walls milking your dick while wet splatters to the mud below confirm his orgasm. With a muffled growl more worthy of a beast than a human, you bury your 'sword' to the hilt, marking Alistair's innermost sanctum with evidence of his sluttiness. You nearly black out from the pleasure, but thankfully the knight-turned-squire is sturdy, and he holds you up, though his legs shake and helpless groans vibrate through him in time with each creamy squirt. Moments later, you slip free of the knight's hole and pat his abused butt, wiping your cock clean on one spanking-blushed cheek. Praising him for his service as your squire, you redress, admiring the pretty sight of his cock dribbling to the ground below and his abused hole beginning to drool.";
						NPCSexAftermath Alistair receives "AssFuck" from Player;
						say "     Sadly, you don't have long to wallow in your post-orgasm bliss. Gathering your gear, you thank the knight for his service, then continue on your way. A knight's work is never done!";
				infect "Knight";
				now thirst of Alistair is 3;
	else if fightoutcome > 19 and fightoutcome < 30: [Lost.]
		if thirst of Alistair > 0: [Other path already chosen. No sex.]
			say "     Alistair looks dumbfounded as you fall to your knees, defeated by his sword. As if he can't believe he's just won, he sheepishly holds out his hand, his regret written across his face. Did he want to lose? Perhaps you've unlocked another side of him. Grinning inwardly, you pat the top of his head, telling him you won't go so easy on him next time. His blush shows you all you need to know.";
		else: [player is not on the other path]
			if hunger of Alistair is 0: [neither path picked yet]
				increase hunger of Alistair by 1; [start of the Dominant path]
			if hunger of Alistair is 1: [Losing results in sex]
				say "     Alistair wastes no time once his sword knocks you to your knees, dropping his pants and burying your face in his sweat-sheened balls. As you dutifully lick, seduced by his manly musk, he speaks, tapping his hardened cock between your eyes. ''Tis a shame that thy priorities are warped. Thy aim was never to learn, t'was simply a path to polish mine holy sword.' Still, as you suck his sack clean, he seems unbothered by your perceived slutty intentions, a cocky grin plastered across his face. 'It matters not. I shall gladly take advantage of thine proclivities.' Depriving you of the manhood you're so desperately cleaning with your tongue, the knight pushes you to your knees.";
				if Player is female:
					say "     Tugging your pants to your knees, the knight surveys your rear, spreading your cheeks as he maneuvers himself into position. His cock brushes against your asshole, and you fear that he's about to punish you by ignoring your sopping wet sex, but thankfully, his cock continues lower, slotting itself between your dripping lips. 'Thy hunger is plain. Shall I sate it?' The knight says in a gruff baritone as he spears forward, his human cock drilling to your core in one smooth thrust. He wastes no time in rutting you, his balls slapping against your clitoris in a stabbing rhythm that soon has your stomach in knots. It's not that he's skilled, but what he lacks, he makes up for in unrelenting stamina, abusing your poor pussy, and treating you like the whore you are.";
					WaitLineBreak;
					say "     Rutting in the dirt like a beast of burden, you can't help but enjoy yourself, losing yourself in the desperate rhythm of being used. You're so wet that your pussy nearly drowns out the sounds of the waterfall, and you can feel your juices dripping down your thighs as Alistair's balls send droplets flying. It's all too much, and soon enough, your orgasm rises, constricting your hole around the knight's cock and begging for his seed. Squirting helplessly, you moan aloud, gripping the ground below you and burying your face in the crook of your elbow to hide your shame at enjoying yourself like a wanton whore. The intense orgasm only heightens when you feel the knight's load basting your innermost depths, filling you to the brim and frothing your sex with a thick mixture of combined cum and juices, and you black out, overwhelmed. When you come to, you're still on your knees with your ass in the air, your pussy exposed to whoever might walk by with Alistair nowhere in sight. It seems your knight has no further use for you. Gingerly, you gather your gear, blushing at the dripping mess staining your thighs. You'll have to return later- after all, a squire should service their knight often.";
					NPCSexAftermath Player receives "PussyFuck" from Alistair;
				else if Player is male:
					say "     'Surely that's not thy best.' Alistair teases you as he tugs your pants down, spreading your cheeks and slotting his manhood against your hole. 'Perhaps thy goal is to service rather than learn? S'pose thy goals align with mine desires.' Prodding forward, he tests your tightness, slipping past your defenses with a dollop of spit unceremoniously plopped against your entrance. With practiced motions, the knight drills into your clamping hole, busting you open with no small amount of force. It stings, but you can't help but get into it as you hear his breath quicken and his cock throb against your sweet spot. It feels right to be his. Every inch that slides deep into you reinforces your place as his squire, and you can feel your manhood flex and drip in time with your master's, hurtling toward orgasm as he abuses your poor hole.";
					WaitLineBreak;
					say "     A calloused hand takes hold of your neck, dragging you backward against sweat-covered muscles and using gravity to slip deeper into your hopelessly clamping ass. 'Thy body pleads for seeding. Such a pretty whore.' He murmurs in your ear as his free hand takes hold of your cock, and the light scratch of his beard teases your sensitive neck. 'I shall grant thy wish.' He grunts, spearing upward and stroking you fast enough that you worry he'll start a fire with the friction he's inflicting on your poor shaft. You lose track of how long you endure the knight's masculine assault, but eventually, sweet release overtakes you, painting the ground in front of you with long strings of desire even as heat blooms in your bowels. Panting and exhausted, you melt backward against the man behind you, lolling your head into his neck kisses, and drooling as he squeezes your throat. Too soon, he pulls out, letting you fall forward, and you black out, exhausted and well-used.";
					WaitLineBreak;
					say "     When you come to, you're still on your knees with your ass in the air, your well-seeded ass exposed to whoever might walk by with Alistair nowhere in sight. It seems your knight has no further use for you. Gingerly, you gather your gear, blushing at the dripping mess staining your thighs. You'll have to return later- after all, a squire should service their knight often.";
					NPCSexAftermath Player receives "AssFuck" from Alistair;
				now hunger of Alistair is 2;
			else if hunger of Alistair > 1: [Stage 2/Repeats]
				say "     '[']Tis clear that thy focus is compromised.' Alistair pushes you into the dirt, leaning over you in all his naked glory and forcefully [if Player is barecrotch]spreading your legs [else]tearing off your lower garments [end if]with urgency in his movements. 'Worry not. Thy desire has not escaped attention.' Pressing his lips to yours, he forces his tongue past your lips, dominating you with a kiss that sets your body alight with desire and refusing to pull back until your lips burn from the rough scratch of his beard.";
				if Player is female:
					say "     Alistair wastes no time penetrating you, his cock gliding past your needy lips and spearing forward in a desperate rhythm. There's no foreplay, no talk, just the rough, rutting of a beast in human form. You know you shouldn't enjoy it as much as you do, but somehow, your body reacts more to his callous treatment, and you're so wet that you wonder if he can even feel anything. 'Thou art mine.' Alistair growls against your ear as his thrusts reach a crescendo. Digging calloused hands into your hips, he slaps his balls against your ass, stirring your pussy into a frothing mess and basting the entrance to your womb in gooey spurts of pre. You're not sure how long he uses you, but once you feel his member pulse and squirt inside, it feels like you're on fire, and you feel as though your body has endured one continuous orgasm. Gasping for air and covered in sweat, you go limp beneath your knight, closing your eyes and basking in his manly scent. Sadly, it seems he has finished with you, and despite your whimpered protest, he pulls out of your drooling cunt, removing the heavenly weight of his muscular body on top of yours.";
					NPCSexAftermath Player receives "PussyFuck" from Alistair;
				else if Player is male:
					say "     Alistair wastes no time penetrating you, his cock gliding past your tight ass and spearing forward in a desperate rhythm. There's no foreplay, no talk, just the rough, rutting of a beast in human form. You know you shouldn't enjoy it as much as you do, but somehow, your body reacts more to his callous treatment, and you're so relaxed and ready that you wonder if he can even feel anything. 'Thou art mine.' Alistair growls against your ear as his thrusts reach a crescendo. Digging calloused hands into your hips, he slaps his balls against your ass, stirring your inner walls into a frothing mess and basting the entrance the inner depths of your guts with gooey strings of pre. You're not sure how long he uses you, but once you feel his member pulse and squirt inside, it feels like you're on fire, and you feel as though your body has endured one continuous orgasm, painting your stomach with wasted seed countless times. Gasping for air and covered in sweat, you go limp beneath your knight, closing your eyes and basking in his manly scent. Sadly, it seems he has finished with you, and despite your whimpered protest, he pulls out of your seeded hole, removing the heavenly weight of his muscular body on top of yours.";
					NPCSexAftermath Player receives "AssFuck" from Alistair;
				WaitLineBreak;
				say "     As you open your eyes, you're greeted with the messy sight of the knight's manhood dripping before your face, covered in a glaze of cum and only partially hard. It's not hard to guess what he wants, and as you open your mouth, he stuffs himself inside, reducing your world to the drooping, sweaty masculinity of his balls and the salty tang of his cock. It soon becomes clear that Alistair isn't out for cleaning. Instead, he's burying himself to the hilt, gagging you on his shaft and fucking your throat until he forces you to accept every inch, filling the space around the waterfall with the lewd sounds of a sloppy facefuck. Desperate to please, all you can do is endure, sucking in breaths tainted by the stink of musky balls and the knight's perineum. You run out of air before the knight runs out of steam, and despite your weak protests, he still fucks your mouth, keeping up his breakneck pace until the world fades away. Waking up later with a face covered in cum and drool, you look around for your knight, licking your lips and tasting his manhood. Sadly, he's nowhere to be found, and you have to gather your things and leave, vowing to service him again tomorrow. For now, you'll have to enjoy the scent and taste of your knight, as saturated as it is.";
				now hunger of Alistair is 3;
				NPCSexAftermath Player receives "OralCock" from Alistair;
	now inasituation is false;
	move Player to Urban Forest;

to say AlistairCockSlut: [Alistair as your squire. Similar to Joey.]
	say "     Deciding to skip the farce of a fight that always results in Alistair losing to you, you instead tell him that you have a new task for him. His failure as a knight hasn't escaped your notice, and you think you should train him in his new role as a squire. Of course, it just so happens that worthy opponents roam the forest nearby. Raising an eyebrow and puffing his chest slightly, the now-submissive knight regains a bit of his bravado. 'Thou jest. Denizens of this forest have already tasted defeat at my hands several times each!' Stopping himself mid-boast, the knight stumbles over his words. 'Forgive me. I did not mean to question my knight. Though perhaps there's some other way? I fear training of this sort will not bear fruit.'";
	say "     Patting the knight's shoulder, you mull over the possibilities until the shiny glint of his armor catches your eye. Perhaps there IS a way to make things more of a fair fight? Acting quickly, you shed the knight's armor, pleased with how dutifully he moves to let you bare his body, though you ignore his attempts to entice you with spread legs and a hardening cock dangling between his legs. Having stripped the knight down to his bare, sweat-glistening skin, you contemplate his muscles with an appreciative eye, commenting on how well he's cared for himself. However, you wonder aloud if those muscles are simply for show. After all, without his armor, sword, and shield, he's nothing but an average man! Without those, can he even defeat a single wolf?";
	WaitLineBreak;
	say "     Alistair seems torn between his pride and compulsion to agree with you, falling for your trap. 'Perhaps I've relied on mine equipment. Should I learn to live without it? Thy strength is a testament to thy words.' The knight's posture has changed, projecting less confidence, matching his behavior when you put him in his place sexually. It seems you've hit a sore spot. Seeing an opportunity to further your domination of the knight-turned-squire, you needle further, telling him that you would like to see how he handles himself in a fight with the creatures of the urban forest! Of course, you'll be right there to help if he loses himself. You MAY wait until his opponent has fun with him first to teach him a little lesson.";
	say "     Maybe you should choose what sort of monsters Alistair should hunt before you attempt to do so?";
	let Alistair_Squire_Training_Monster_Gender_Choices be a list of text;
	add "Male monsters. You want to see Alistair get fucked by big bestial cocks!" to Alistair_Squire_Training_Monster_Gender_Choices;
	add "Female monsters. You want to see Alistair get dominated by pussy." to Alistair_Squire_Training_Monster_Gender_Choices;
	let Alistair_Squire_Training_Monster_Gender_Choice be what the player chooses from Alistair_Squire_Training_Monster_Gender_Choices;
	if Alistair_Squire_Training_Monster_Gender_Choice is:
		-- "Male monsters. You want to see Alistair get fucked by big bestial cocks!":
			say "    You'll be hunting for male monsters for Alistair to fight! <You can change this later by typing 'Alistair Monster Gender' without the quotation makes.>";
			TraitGain "Male Monsters" for Alistair;
		-- "Female monsters. You want to see Alistair get dominated by pussy.":
			say "    You'll be hunting for female monsters for Alistair to fight! <You can change this later by typing 'Alistair Monster Gender' without the quotation makes.>";
			TraitGain "Female Monsters" for Alistair;
	TraitGain "Training Alistair" for Alistair;

AlistairMonsterGender is an action applying to nothing.

Understand "Alistair Monster Gender" as AlistairMonsterGender.

check AlistairMonsterGender:
	if "Training Alistair" is not listed in Traits of Alistair:
		say "You're not training Alistair currently. Continue down his squire path first.";
	else:
		say "You've successfully changed the gender of monsters that you'll hunt with Alistair to ";
		if "Male Monsters" is listed in Traits of Alistair:
			say "female. Monsters will now have pussies.";
			TraitLoss "Male Monsters" for Alistair;
			TraitGain "Female Monsters" for Alistair;
		else if "Female Monsters" is listed in Traits of Alistair:
			say "male. Monsters will now have cocks.";
			TraitLoss "Female Monsters" for Alistair;
			TraitGain "Male Monsters" for Alistair;

to say AlistairFucksPlayer: [Alistair as your knight. Think perverted drill seargent.]
	say "     You can't bear to wait until after he defeats you in combat! Throwing aside your equipment and kneeling before him, you beg Alistair for mercy, telling him he's far too mighty for you to defeat. After all, you're nothing but a lowly squire. Instead, why doesn't he let you worship him in ways only you can? You'll do anything he wants! Alistair chuckles at your subservience, relaxing his stance and sheathing his sword in the dirt. Placing one hand on your head in a paternal display of affection, he slowly moves it downward to tilt your face upward. 'Such an eager squire. Thy devotion is double mine own.' Slipping his thumb into your mouth, the knight plays over your tongue with a pensive expression, his expression deep in thought. 'Shirking your training won't do, though perhaps I have another method that might fulfill thy wishes.' Turning his head, the knight gestures toward his dirt-sheathed sword. 'Hands on thy head. Kneel there.' A grin splits his face as he looks back into your eyes. 'After disrobing.'";
	if Player is female:
		WaitLineBreak;
		say "     Shuddering with anticipation, you follow the knight's instructions, stripping off everything that might get in the way of doing as he asked. The slightest hesitation crosses your mind as you squat downward, pausing as your lower lips tease over cold metal, but one glance at the knight's expectant expression steels your nerves. The height of the sword requires you to work your calves, but you take the hilt up to the guard without problems, face flushing at the sheer humiliation of the position. Pussy clamping on the cold metal and dribbling down the sword guard to shine the blade, you try your best to remain in that position, though your legs shake with the effort, wobbling the pommel inside of you and dragging an uncomfortable groan from your open mouth. It's more strenuous than it looks- your calves are screaming, and your pussy screams out for more stimulation, but you try your best to remain still, gritting your teeth with effort.";
		say "     'That's it. Hold thy position.' Blatantly touching himself, the knight tugs his armor out of the way, unsheathing his cock and stroking it inches from your face. Smearing a pearl of pre over your lower lip, he forces himself into your mouth with a masculine grunt. 'Once you swallow your knight's seed, you may stand up.' Whimpering around his shaft, you slowly move your lips from the base of that hard cock to the tip, your hands on your hips trembling with the effort of maintaining your precarious balance. You're so aroused that you're starting to enjoy the feeling of that sword handle inside of you, and the slightest movement drags your clit along rough leather and metal, sending electricity through your body.";
		WaitLineBreak;
		say "     'Faster.' Alistair grunts as he takes hold of the sides of your head, jabbing his dick into the back of your throat. There's nothing gentle about the way he's using your mouth, but somehow, the forceful rhythm steadies your lower half, keeping your aching legs from giving out on you. Using every thrust as a motivator, you swallow everything he has to give, staring up at him with an almost meditative stare. Moments before your Alistair finishes, your legs give out, sending the sword guard digging into your pussy lips and drawing a whimper from your stuffed throat at the sudden cold sensation. Squirming, you try your best to remain still, drinking down what he gives you with ragged gulps and reveling in the taste of a post-workout 'protein injection.'";
		say "     Exhausted by the unfamiliar position, you fall backward with Alistair's cum dripping down your chin, thighs squeezing together as your needy cunt protests the loss of the warm metal. Your legs won't stop shaking from the workout despite your body's demand for more stimulation. You can only sit there, pussy on display, while Alistair tucks his dick back into his pantaloons, clicking his tongue with an authoritarian expression. Thy performance is wanting.' Alistair touches the toe of his boot to your leg, drawing attention to their shaking. 'True knights could squat for hours until their superiors have their fill. Thy stamina barely held out for one.' With a grin cracking his handsome face, Alistair shows his enthusiasm for training fresh meat, shaking his head. 'We shall have to start with the basics. Rest up, squire. I will not be nearly as easy on you next time.' Shakily, you gather your things, resisting the urge to play with your throbbing vagina despite how turned on you are. You can only imagine what your knight will force on your exhausted body next time, but you can't wait to find out!";
	else if Player is male:
		WaitLineBreak;
		say "     Shuddering with anticipation, you follow the knight's instructions, stripping off everything that might get in the way of doing as he asked. The slightest hesitation crosses your mind as you squat downward, pausing as your ass teases over cold metal, but one glance at the knight's expectant expression steels your nerves. The height of the sword requires you to work your calves, but you take the hilt up to the guard without problems, aided by sweat but still feeling the burn of an improperly lubed object slipping inside your hole, face flushing at the sheer humiliation of the position. Inner walls clamping on the cold metal and dripping sweat down the sword guard to shine the blade, you try your best to remain in that position, though your legs shake with the effort, wobbling the pommel inside of you and dragging an uncomfortable groan from your open mouth as it tortures your poor prostate. It's more strenuous than it looks- your calves are screaming, and your bobbing dick screams out for more stimulation, but you try your best to remain still, gritting your teeth with effort.";
		say "     'That's it. Hold thy position.' Blatantly touching himself, the knight tugs his armor out of the way, unsheathing his cock and stroking it inches from your face. Smearing a pearl of pre over your lower lip, he forces himself into your mouth with a masculine grunt. 'Once you swallow your knight's seed, you may stand up.' Whimpering around his shaft, you slowly move your lips from the base of that hard cock to the tip, your hands on your hips trembling with the effort of maintaining your precarious balance. You're so aroused that you're starting to enjoy the feeling of that sword handle inside of you, and the slightest movement flops your cock to and fro, sending sticky strings of pre flying.";
		WaitLineBreak;
		say "     'Faster.' Alistair grunts as he takes hold of the sides of your head, jabbing his dick into the back of your throat. There's nothing gentle about the way he's using your mouth, but somehow, the forceful rhythm steadies your lower half, keeping your aching legs from giving out on you. Using every thrust as a motivator, you swallow everything he has to give, staring up at him with an almost meditative stare. Moments before Alistair finishes, your legs give out, sending the sword guard digging into your hole's rim and drawing a whimper from your stuffed throat at the sudden cold sensation. Squirming, you try your best to remain still, drinking down what he gives you with ragged gulps and reveling in the taste of a post-workout 'protein injection.'";
		say "     Exhausted by the unfamiliar position, you fall backward with Alistair's cum dripping down your chin, thighs squeezing together as your needy asshole protests the loss of the warm metal. Your legs won't stop shaking from the workout despite your body's demand for more stimulation. You can only sit there, erect cock on display, while Alistair tucks his dick back into his pantaloons, clicking his tongue with an authoritarian expression.'Thy performance is wanting.' Alistair touches the toe of his boot to your leg, drawing attention to their shaking. 'True knights could squat for hours until their superiors have their fill. Thy stamina barely held out for one.' With a grin cracking his handsome face, Alistair shows his enthusiasm for training fresh meat, shaking his head. 'We shall have to start with the basics. Rest up, squire. I will not be nearly as easy on you next time.' Shakily, you gather your things, resisting the urge to play with your throbbing cock despite how turned on you are. You can only imagine what your knight will force on your exhausted body next time, but you can't wait to find out!";
	NPCSexAftermath Player receives "Stroking" from Alistair;
	TraitGain "Alistair's Knight Training" for Alistair;

Section 5 - Alistair Training Routes

Chapter 1 - Training Squire Alistair

to say AlistairCockTraining:
	say "     Deciding that it's time to start Alistair's training as a squire, you tell him to strip down to nothing, watching with approval as he follows your orders without issue. It seems the time you've spent stripping away his dominance through defeat after defeat has paid off! Now it's time to push his limits and see how far you can make him go. After all, he's your squire. Your word is law! By the time Alistair strips himself down to bare skin, he's reached full mast. You pointedly ignore his excitement at following your orders, mulling over his potential opponents.";
	say "     [bold type]Who should be Alistair's opponent?[roman type][line break]";
	let Alistair_Training_Squire_Choices be a list of text;
	add "You'll start with something easy. In any fantasy story, a budding knight would be able to defeat a simple wolf!" to Alistair_Training_Squire_Choices;
	if "Wolf Training" is listed in Traits of Alistair:
		add "You think he's ready for something harder! You'll hunt a dryad this time!" to Alistair_Training_Squire_Choices;
	let Alistair_Training_Squire_Choice be what the player chooses from Alistair_Training_Squire_Choices;
	if Alistair_Training_Squire_Choice is:
		-- "You'll start with something easy. In any fantasy story, a budding knight would be able to defeat a simple wolf!":
			say "     You head off through the woods, happy that Alistair follows you without complaint. His first opponent will be a wolf, and thankfully, they don't seem to be all that uncommon. You only search for moments before a nearby bush growls, and a canine shape emerges from the darkness. With all of its bristling fur and flashing teeth, it squares off against you. You leave Alistair to fight the creature, sitting nearby and watching with appreciation as he fumbles, still unused to his nudity and lack of weapons.";
			say "     [bold type]If you wanted to, you could sabotage Alistair's fight and see what happens to him. Do you want to trip him up?[roman type][line break]";
			say "     ([link]Y[as]y[end link]) - Yes. Trip him. You want to see the wolf dominate him!";
			say "     ([link]N[as]n[end link]) - No. Let him succeed or fail on his own merits. You're enjoying his bare ass and sweaty manhood as he wrestles the canine anyway.";
			if player consents:
				say "     You decide that you don't want to leave things up to chance, instead waiting for an opportune moment and surreptitiously placing a branch behind one of the knight's feet. You suppress a giggle as you watch him fall on his ass, an expression of confused panic on his face as he confronts the slavering wolf without the advantage of his height.";
				LineBreak;
				if "Male Monsters" is listed in Traits of Alistair:
					say "     Thankfully for the hapless knight, the wolf seems less interested in taking a bite out of him and more interested in something else- his growing erection slapping against his stomach as he takes the knight's entire leg into his toothy maw and deftly twists its head, turning him over onto his stomach. Without skipping a beat, the canine makes its intentions known, wide tongue lapping between his cheeks and leaving thick streaks of dog drool. It doesn't take a rocket scientist to figure out what's coming next, so you settle in nearby, grinning at the knight's pleading expression 'I've seen the error of mine ways! Help! I will adhere to thy teachings. I will become stronger!' Alistair begs you to come to his aid, conflict written across his face as he grapples with the sensations forced on him by that insistent tongue. It's plain to see that he's enjoying it despite the redness blooming on his cheeks, and you can see his cock swinging as that broad tongue slurps over his balls, tasting his sweat.";
					say "     Telling the knight that this is part of his training, you wave away his concerns. He should have tried harder! After all, how will he learn if you fight all his battles for him? Alistair tries to appeal to your softer side, stammering words that turn into a long moan as the wolf hunches over his back. Wet slaps fill the clearing as the wolf's tongue drips wet drool on his bare back, and sloppy slurping sounds grow more intense by the second as he jackhammers away, an expression of contentment written across that feral face. Heavy paws scrabble for purchase, leaving long scratches on the knight's bare thighs, while the sheer power behind those hips forces him forward into the dirt, ass in the air like a common whore.";
					WaitLineBreak;
					say "     Alistair's expression melts away into the vacant stare of  well-fucked slut long before the wolf's finished with him, drool dripping down his handsome bearded face and one hand shamelessly finding his needy cock, jerking himself in time with his violation. It seems the time you spent training him to take cock has paid off! Snarling long and low, the wolf slows his hips, the intense thwap thwap thwap of furry balls against Alistair's taint morphing into a rhythmic, slow push that leaves nothing to the imagination. It seems he's ready to breed his new bitch, and he's having trouble slamming his knot home! Drawing unintelligibly whorish moans from the mounted knight, he finally succeeds with a lewd slurp, only to lift his leg and turn around so he's ass to ass with the limp knight, shaking himself and grunting with a pleased expression.";
					say "     Patting Alistair's cheek, you watch with approval as his hole squeezes and keeps that knot captive, visibly pulsing in and out as the wolf floods his innards. The knight's frantic masturbation reaches a crescendo as the wolf tests their tie, dragging Alistair backward and dragging a pained moan out of his fucked-silly expression. Tensing with each cruel tug, he stiffens, messing his already dirt-covered underside with cum when it finally slurps free, taking with it a deluge of cum and leaving the knight's muscular cheeks spread around a gaping, reddened hole. As the wolf wanders off, dick still dribbling a lewd trail, you help the knight to his feet, telling him he'll do better next time. After all, there will be plenty more training! More wolves and perhaps other monsters, if you think he's ready. The exhausted nod and slumped acceptance that Alistair responds with feel right, and you cup his bare ass with approval.";
				else if "Female Monsters" is listed in Traits of Alistair:
					say "     Thankfully for the hapless knight, the wolf seems less interested in taking a bite out of him and more interested in something else- nosing between the knight's legs and lathering his soft cock in a thick coat of dog drool. Insistent, the wolf doesn't stop long, rhythmic licks until the knight's cock slaps against his stomach, erect and ready for action. Watching you with wary eyes, the wolf brings her hind end to bear, tongue hanging out as the knight's dick finds the dripping entrance to her puffy cunt. Alistair grits his teeth, leaning his head back and pleading with you. 'I've seen the error of mine ways. Please! Don't let this creature sully a knight's honor.' Despite his words, you can see his cock twitch near hot canine pussy, twitching upward as that bestial cookie dribbles down the underside of his shaft, swabbing the tip of the human's cock while the wolf tries to find the right angle.";
					say "     Shaking your head, you tell Alistair that this is his punishment for failing to defeat the wolf. It's not like he's in any danger, and besides, what's a little humiliation in the face of a lesson learned? He'll have to grin and bear it. Satisfied with her preparations, the wolf grunts with effort, swiveling her feral hips and capturing the knight's cock between her lips. With one forward motion, she slams her pussy lips downward with a lewd, wet noise, tail lifted high and asshole clenching as the knight's dick disappears. Panting, she thrusts her hips forward like a male wolf rutting, instinct betraying her for a moment before she realizes that motion doesn't work, whining with frustration until she finds the right rhythm to slam the knight's cock into her drooling cunt.";
					WaitLineBreak;
					say "     Alistair tries his best to look like he's not enjoying himself, struggling uselessly, but the way his balls draw up on every downward swing betrays him. Clutching at hands full of dirt, he thrusts upward, stirring that canine pussy with desperate thrusts and kicking his legs for purchase, his shaft covered in slick juices that whip themselves into foam as he pounds. Alistair cums long before the wolf finishes with him, adding to the mess that drips down his balls and coating that ebony wolf pussy with thick, dripping webs of human seed. Begging wordlessly for mercy, he tries to extricate himself from beneath the growling wolfess, but a bite to his shoulder holds him down, and the wolf redoubles her efforts, throwing back her head and letting loose a guttural howl.";
					say "     The wolf's tail fans the air at warp speed, her hips moving at a breakneck pace while she tortures the knight's oversensitive cock, holding him down with the sheer violence of her passion while the knight's legs kick and struggle, his oversensitive shaft kept hard by plunging pussy lips. Thankfully for Alistair, the wolf doesn't take long to reach her peak, her frantic riding reaching a crescendo and then coming to a halt with a satisfied whine, stuffed hole visibly milking the poor knight's overworked dick. She perches there until Alistair's dick slips out of her, softened and defeated, then flicks her tail, baring her teeth at you before turning around to lope off into the brush, well-fucked pussy on display and still dripping Alistair's cum. You help Alistair to his feet, patting his bare ass and helping him toward the falls, where he can wash the scent of canine cunt and mud from his sweaty skin. Praising him for his efforts, you tell him he'll win next time. He's showing real promise as your squire. Exhausted, it seems all he can do is mumble his thanks, leaning heavily on you.";
			else:
				if a random chance of 1 in 5 succeeds: [Loss scene]
					say "     Alistair holds his own for longer than you'd expect. Looking quite comical with his ass and balls on display, he attempts to throw the wolf, suffering superficial wounds from claws and teeth across his chest and stomach. Sadly, he fails, falling on his ass after stepping in a mud puddle and sliding backward, leaving him with a bristling, angry ball of fur above him, pinning him to the forest floor.";
					LineBreak;
					if "Male Monsters" is listed in Traits of Alistair:
						say "     Thankfully for the hapless knight, the wolf seems less interested in taking a bite out of him and more interested in something else- his growing erection slapping against his stomach as he takes the knight's entire leg into his toothy maw and deftly twists its head, turning him over onto his stomach. Without skipping a beat, the canine makes its intentions known, wide tongue lapping between his cheeks and leaving thick streaks of dog drool. It doesn't take a rocket scientist to figure out what's coming next, so you settle in nearby, grinning at the knight's pleading expression 'I've seen the error of mine ways! Help! I will adhere to thy teachings. I will become stronger!' Alistair begs you to come to his aid, conflict written across his face as he grapples with the sensations forced on him by that insistent tongue. It's plain to see that he's enjoying it despite the redness blooming on his cheeks, and you can see his cock swinging as that broad tongue slurps over his balls, tasting his sweat.";
						say "     Telling the knight that this is part of his training, you wave away his concerns. He should have tried harder! After all, how will he learn if you fight all his battles for him? Alistair tries to appeal to your softer side, stammering words that turn into a long moan as the wolf hunches over his back. Wet slaps fill the clearing as the wolf's tongue drips wet drool on his bare back, and sloppy slurping sounds grow more intense by the second as he jackhammers away, an expression of contentment written across that feral face. Heavy paws scrabble for purchase, leaving long scratches on the knight's bare thighs, while the sheer power behind those hips forces him forward into the dirt, ass in the air like a common whore.";
						WaitLineBreak;
						say "     Alistair's expression melts away into the vacant stare of  well-fucked slut long before the wolf's finished with him, drool dripping down his handsome bearded face and one hand shamelessly finding his needy cock, jerking himself in time with his violation. It seems the time you spent training him to take cock has paid off! Snarling long and low, the wolf slows his hips, the intense thwap thwap thwap of furry balls against Alistair's taint morphing into a rhythmic, slow push that leaves nothing to the imagination. It seems he's ready to breed his new bitch, and he's having trouble slamming his knot home! Drawing unintelligibly whorish moans from the mounted knight, he finally succeeds with a lewd slurp, only to lift his leg and turn around so he's ass to ass with the limp knight, shaking himself and grunting with a pleased expression.";
						say "     Patting Alistair's cheek, you watch with approval as his hole squeezes and keeps that knot captive, visibly pulsing in and out as the wolf floods his innards. The knight's frantic masturbation reaches a crescendo as the wolf tests their tie, dragging Alistair backward and dragging a pained moan out of his fucked-silly expression. Tensing with each cruel tug, he stiffens, messing his already dirt-covered underside with cum when it finally slurps free, taking with it a deluge of cum and leaving the knight's muscular cheeks spread around a gaping, reddened hole. As the wolf wanders off, dick still dribbling a lewd trail, you help the knight to his feet, telling him he'll do better next time. After all, there will be plenty more training! More wolves and perhaps other monsters, if you think he's ready. The exhausted nod and slumped acceptance that Alistair responds with feel right, and you cup his bare ass with approval.";
					else if "Female Monsters" is listed in Traits of Alistair:
						say "     Thankfully for the hapless knight, the wolf seems less interested in taking a bite out of him and more interested in something else- nosing between the knight's legs and lathering his soft cock in a thick coat of dog drool. Insistent, the wolf doesn't stop long, rhythmic licks until the knight's cock slaps against his stomach, erect and ready for action. Watching you with wary eyes, the wolf brings her hind end to bear, tongue hanging out as the knight's dick finds the dripping entrance to her puffy cunt. Alistair grits his teeth, leaning his head back and pleading with you. 'I've seen the error of mine ways. Please! Don't let this creature sully a knight's honor.' Despite his words, you can see his cock twitch near hot canine pussy, twitching upward as that bestial cookie dribbles down the underside of his shaft, swabbing the tip of the human's cock while the wolf tries to find the right angle.";
						say "     Shaking your head, you tell Alistair that this is his punishment for failing to defeat the wolf. It's not like he's in any danger, and besides, what's a little humiliation in the face of a lesson learned? He'll have to grin and bear it. Satisfied with her preparations, the wolf grunts with effort, swiveling her feral hips and capturing the knight's cock between her lips. With one forward motion, she slams her pussy lips downward with a lewd, wet noise, tail lifted high and asshole clenching as the knight's dick disappears. Panting, she thrusts her hips forward like a male wolf rutting, instinct betraying her for a moment before she realizes that motion doesn't work, whining with frustration until she finds the right rhythm to slam the knight's cock into her drooling cunt.";
						WaitLineBreak;
						say "     Alistair tries his best to look like he's not enjoying himself, struggling uselessly, but the way his balls draw up on every downward swing betrays him. Clutching at hands full of dirt, he thrusts upward, stirring that canine pussy with desperate thrusts and kicking his legs for purchase, his shaft covered in slick juices that whip themselves into foam as he pounds. Alistair cums long before the wolf finishes with him, adding to the mess that drips down his balls and coating that ebony wolf pussy with thick, dripping webs of human seed. Begging wordlessly for mercy, he tries to extricate himself from beneath the growling wolfess, but a bite to his shoulder holds him down, and the wolf redoubles her efforts, throwing back her head and letting loose a guttural howl.";
						say "     The wolf's tail fans the air at warp speed, her hips moving at a breakneck pace while she tortures the knight's oversensitive cock, holding him down with the sheer violence of her passion while the knight's legs kick and struggle, his oversensitive shaft kept hard by plunging pussy lips. Thankfully for Alistair, the wolf doesn't take long to reach her peak, her frantic riding reaching a crescendo and then coming to a halt with a satisfied whine, stuffed hole visibly milking the poor knight's overworked dick. She perches there until Alistair's dick slips out of her, softened and defeated, then flicks her tail, baring her teeth at you before turning around to lope off into the brush, well-fucked pussy on display and still dripping Alistair's cum. You help Alistair to his feet, patting his bare ass and helping him toward the falls, where he can wash the scent of canine cunt and mud from his sweaty skin. Praising him for his efforts, you tell him he'll win next time. He's showing real promise as your squire. Exhausted, it seems all he can do is mumble his thanks, leaning heavily on you.";
				else:
					say "     You feel almost disappointed as you watch the knight wrestle with the wolf in the dirt. He manages to avoid sustaining more than a few superficial scratches, and despite his nudity, he seems fairly at-home wrestling with the creature, grappling with it and sending it flying into a nearby tree with a titanic heave. The wolf shakes its head, limping back to its feet, and regards the knight with a seeming respect, backing away without any further attempts to attack. Alistair turns to you as the creature disappears into the underbrush, tottering on his feet, and leans heavily against you, smelling of petrichor and sweat. 'Mine strength did not fail. Is thy respect earned?' He pants his words, clearly seeking praise, and you pat his bare ass as you help the dirty knight back to the falls, letting him know how impressive he was. You'll have to find him another worthy opponent next time!";
			TraitGain "Wolf Training" for Alistair;
		-- "You think he's ready for something harder! You'll hunt a dryad this time!":
			say "     Something more human should be a challenge for Alistair, but you worry that he might balk at showing himself at his most vulnerable to someone human. With that in mind, you have one specific enemy that should be perfect for him- something inhuman yet close enough to make him squirm. A dryad! You're sure you've seen at least one dryad nearby, so tell Alistair it's time to go, leading him off through the brush and using his old sword to hack at encroaching bushes.";
			if "Male Monsters" is listed in Traits of Alistair:
				say "     You don't have to go far to find a tree inhabited by one of the fae. Though, to your surprise, it's not a nude womanly figure that greets you. Glaring daggers at the sharp sword in your hands, a masculine figure materializes from the tree, body creaking as it detaches from the trunk. The male dryad doesn't seem as dedicated to beauty as its feminine counterpart, with skin that reminds you of bark in places and vines in others. Musculature dotted with thorns and bark creak with every movement, and eyes the color of fallen autumn leaves regard you with unprovoked anger beneath an unruly mop of hair dotted with flowers. It seems he thinks you're there to cut down his tree- a misunderstanding that works in your favor! It's a perfect opportunity to set your squire to work on his 'training.' Clearing your throat, you point toward the tree with your sword, not the figure in front of it, siccing your squire in a way that cements the misunderstanding, then sitting back on a nearby stump to watch the show, leaning on the sword-turned-prop.";
				say "     [bold type]This fight could take a while- do you want to sabotage Alistair to quicken the show? Or give him the opportunity to win on his own?[roman type][line break]";
				say "[link]Y[as]y[end link] Yes - Sabotage him. You want to see Alistair get fucked by this floral hunk.";
				say "[link]N[as]n[end link] No - Let him fight it out on his own! You're not that cruel.";
				if Player consents:
					say "     Too impatient for the end of the fight, you watch with bored eyes as the dryad and knight punch each other, eyes roaming over the knight's sweaty body and eyebrow twitching upward as he catches the dryad in a headlock, his cock thrust between green thighs and hardening despite the intense look of concentration on the former knight's face. Intrigued by the fact that he's trying so hard to ignore his manhood, you cup your hands, feigning concern and yelling out a warning, citing another dryad sneaking up on the busy knight as a reason for concern. That moment of broken concentration is all it takes for the dryad to knock himself loose, sending the knight flying backward with a haymaker punch. Vines appear from the ground below, trapping Alistair with his legs wide open, his hard cock on display, and the angry dryad raises him into the air, advancing with revenge no doubt on his mind.";
					say "     'Master? Might I request thy help?' Kicking uselessly at the plant's grip on his legs, the knight strikes a comical pose, his erect cock flopping from side to side as his body reacts to the proximity of the nude dryad. Of course, his efforts only cover his body in a thin sheen of sweat, highlighting his hard-won muscles and pooling in his abs. Cheering the knight on, you encourage him to take his punishment with less whining, waving your hand dismissively. You'll step in if he's actually in danger, but judging by the vengeful dryad's growing, verdant green cock, the creature's wants align with the show you want to see. Idly touching yourself, you settle in to watch as the distance between them closes.";
					say "     More vines join their compatriots in moments, firmly tying the knight at the right height to place his bare ass in the path of the amorous dryad's approaching dick, leaving him unable to resist as the tip settles in against his hole. Sheathing himself in one long thrust, the dryad grunts with desire, clawed fingers digging into the knight's flexing thighs and pert ass clenching as he tries to force more dick than he has past the knight's violated ring. Unfortunately, you're not at the right angle to watch the penetration, but you get a pleasant enough view of the dryad's bouncing cheeks as he humps away, treated to the deliciously naughty sight of the knight's gaping hole when the overexcited creature slips free and takes a moment to line himself back up. That pumping rear gives you an idea, and you shed your pants as you contemplate it. The dryad's ass looks lonely without someone to attend to it, and the way it gently bounces with boyish pertness promises that the hole between those cheeks will be a pleasant experience.";
					let Alistair_Sub_Scene_Two_Choices be a list of text;
					add "Eat the dryad's ass while he fucks your squire." to Alistair_Sub_Scene_Two_Choices;
					if Player is male: [neuters go home!]
						add "Fuck the dryad while he fucks Alistair." to Alistair_Sub_Scene_Two_Choices;
					add "Let things play out. You just want to watch." to Alistair_Sub_Scene_Two_Choices;
					let Alistair_Sub_Scene_Two_Choice be what the player chooses from Alistair_Sub_Scene_Two_Choices;
					if Alistair_Sub_Scene_Two_Choice is:
						-- "Eat the dryad's ass while he fucks your squire.":
							LineBreak;
							say "     Throwing caution to the wind, you decide to help things along, granting Alistair a reprieve from the dryad's relentless pounding by surprising the plant creature with your face between those modest cheeks. You waste no time with pleasantries, slathering your tongue over the confused creature's flexing hole and digging against it insistently, demanding entry.  Considering the tentacles currently holding the former knight could turn on you at a moment's notice, you're running the risk of joining him, but thankfully, the sex-drunk hunk only moans aloud, legs spreading to give you better access. It doesn't take long before those insistent hips start to move again, depriving you of the pleasantly floral taste of dryad ass for a moment before shoving backward, grinding on your face, smothering you in masculine but vaguely floral musk.";
							say "     Grinning to yourself, you raise your hands, squeezing those flexing cheeks and diving in as deep as you can go, tongue piercing that tight hole and wagging inside the dryad's ass. Slurping away with gusto, you control the dryad's rhythm, keeping that pistoning green cock buried deep in your squire and forcing him to use his tentacles to move the man's body like a human fleshlight. Tentacles slip out of the ground around your knees, but they push your face deeper rather than ripping you away, forcing your face up and down that softening hole in a rhythm that fills the air with a drooling symphony of wet noise. Thrusts grow ragged as your lungs scream for air. You tear away from that floral hole, leaving it gaping slightly and clenching indignantly. You have a new goal in mind- capturing the virile plant's swinging balls in your mouth and slathering them in drooling love. Slipping two fingers into that well-prepared ring, you finger it to the rhythm of the dryad's thrusts, feeling his sack pull up, tightening against your ravenous sucks.";
							say "     'Gods!' The dryad cries out under the triple-pronged assault of talented fingers, your hungry mouth, and Alistair's ass, stiffening, then ramming himself to the root. Those slippery balls leave your mouth with the violence of his breeding, but you keep your mouth open to catch the rain of syrupy cum that follows, drizzling down that pale green sack like a sugary reward. Anger sated by Alistair's ravaged body and your talented tongue, the dryad disengages with a wince, leaning against a nearby tree. It seems he's realized your threat to his tree was nothing but a ruse, but he watches you with drooping tentacles at the ready, surrounding his heaving, slim chest as if to say, 'Don't fuck with me.'";
						-- "Fuck the dryad while he fucks Alistair.":
							LineBreak;
							say "     Throwing caution to the wind, you set aside Alistair's sword along with your gear and sneak up on the distracted dryad, grabbing his hips from behind and smearing your cock between his cheeks. You cheekily ask if there's room for one more as you spit on your cock tip, kissing it against the dryad's hole and forcing him forward into Alistair hard enough to draw twin moans from the creature and the former knight. Taking his ass's tight clench and the lack of tentacles pulling you off of the floral hunk to mean that your intervention is welcome, you set the pace of the rough fuck, spurring the dryad's hips forward hard enough to send the clap of skin on skin echoing around the clearing. 'Yes! Please, get this foul creature off me!' Alistair mistakes your face appearing over the twink-fae's shoulder as a reprieve from his punishment for losing the fight, only to groan as you use your leverage to pound the dryad's cock deeper into his ass, making his rock-hard cock slap against his stomach and leave a guilty snail-trail of precum across his heaving abs.";
							say "     Digging your fingers into the dryad's hips for leverage, you work him over with greedy thrusts that force him to reinforce his vines, sending a lattice across your bare skin to keep the three of you upright. You're too far gone to care as the vines tickle the underside of your ass cheeks, and you grit your teeth as they slip past your defenses, twining inside of you and finding your prostate. The heaving mass of sweaty bodies writhes for mere moments before the pleasure overloads from an insistent prostate pounding and the wringing, slippery plant muscles set you off. Burying yourself to the root in the dryad, you plant your seed, bucking cock mimicking the greedy pulse of the tentacles in your ass. Your orgasm sets off a chain reaction in your little threesome, and before you know it, the dryad goes limp, slipping out of the captive knight mid-shot and joining him in orgasm, painting his front in a syrupy mix of sap and cum. You take a moment to relax, then slap the dryad's ass and extricate yourself from the grip of your herbaceous support, withdrawing and admiring the creamy, green gape of that well-fucked hole.";
						-- "Let things play out. You just want to watch.":
							LineBreak;
							say "     Giving in to the urge for laziness, you wave away any desire to intervene in the dryad's brutal pounding. Instead, you idly watch as Alistair struggles, trying to hide your self-satisfied expression. It wouldn't do to show him how much you enjoy his struggles. After all, you're supposed to be 'training' him. Without your intervention, the dryad grows bold in his humiliation of your obedient squire, spreading the poor man's ass wide with the addition of two smooth tentacles alongside his cock. From where you're sitting, you don't have the best view, but Alistair's expression is more than enough to fuel your lust. Indignance gives way to an open-mouthed pant, and before long, the poor knight-turned-squire loses all sense, drooling and going limp in his restraints, cock slapping against his stomach in time with every prostate-destroying plap. The dryad loses control long before the knight cums, shoving to the base and pumping him full of sticky, syrupy cum that drips in amber strings when he tugs his half-hard dick from Alistair's ruined butthole. It seems he's realized you mean him no harm, and he watches with curious eyes while you collect your squire and walk away, leaving him to lounge on his tree, still showing off his softening manhood.";
					WaitLineBreak;
					say "     With an insincere apology to the dryad, you gather Alistair from the ground, cupping his still-dripping ass as you whisk him away back to the waterfall to clean up and recuperate. He's still mumbling about toughening up, but you pay him no mind, already thinking up new ways to get him into compromising positions. After all, it's more fun that way.";
					CreatureSexAftermath "Alistair" receives "AssFuck" from "Dryad";
				else: [Alistair fights fair.]
					if a random chance of 1 in 2 succeeds: [Alistair wins.]
						say "     Alistair shows his prowess by deftly bobbing and weaving between plant strikes aimed at his nude midsection, though you can't help but notice that his cheeks are bright red from errant tentacle strikes by the end. Despite his 'war wounds' he looms over the plant man in all his nude, sweaty glory, looking to you with a cocky expression, as if to say 'bring it on, master.' You must admit that he looks rather handsome with that expression, even if this exercise was meant to cement his submission by forcing him into a battle he was guaranteed to lose, so you let him have his moment in the sun. With an arm around the triumphant squire's shoulders, you ignore the dryad's limp form, leaving the sylvan creature to recover in the arms of his tentacle-helpers, and walk back toward the waterfall, praising Alistair for his heroism all the while.";
					else: [Alistair loses.]
						say "     Despite his best efforts, Alistair doesn't seem to have the instincts needed to fight against a human target and several whipping tentacles at the same time. He puts up a heroic fight, but in due time, he finds himself entangled by playful plants, splay-legged. The dryad looms over him, clearly affected by the show, if the hard green dick between his legs is any indication.";
						say "     'Master? Might I request thy help?' Kicking uselessly at the plant's grip on his legs, the knight strikes a comical pose, his erect cock flopping from side to side as his body reacts to the proximity of the nude dryad. Of course, his efforts only cover his body in a thin sheen of sweat, highlighting his hard-won muscles and pooling in his abs. Cheering the knight on, you encourage him to take his punishment with less whining, waving your hand dismissively. You'll step in if he's actually in danger, but judging by the vengeful dryad's growing, verdant green cock, the creature's wants align with the show you want to see. Idly touching yourself, you settle in to watch as the distance between them closes.";
						WaitLineBreak;
						say "     More vines join their compatriots in moments, firmly tying the knight at the right height to place his bare ass in the path of the amorous dryad's approaching dick, leaving him unable to resist as the tip settles in against his hole. Sheathing himself in one long thrust, the dryad grunts with desire, clawed fingers digging into the knight's flexing thighs and pert ass clenching as he tries to force more dick than he has past the knight's violated ring. Unfortunately, you're not at the right angle to watch the penetration, but you get a pleasant enough view of the dryad's bouncing cheeks as he humps away, treated to the deliciously naughty sight of the knight's gaping hole when the overexcited creature slips free and takes a moment to line himself back up. That pumping rear gives you an idea, and you shed your pants as you contemplate it. The dryad's ass looks lonely without someone to attend to it, and the way it gently bounces with boyish pertness promises that the hole between those cheeks will be a pleasant experience.";
						LineBreak;
						let Alistair_Sub_Scene_Two_Choices be a list of text;
						add "Eat the dryad's ass while he fucks your squire." to Alistair_Sub_Scene_Two_Choices;
						if Player is male: [neuters go home!]
							add "Fuck the dryad while he fucks Alistair." to Alistair_Sub_Scene_Two_Choices;
						add "Let things play out. You just want to watch." to Alistair_Sub_Scene_Two_Choices;
						let Alistair_Sub_Scene_Two_Choice be what the player chooses from Alistair_Sub_Scene_Two_Choices;
						if Alistair_Sub_Scene_Two_Choice is:
							-- "Eat the dryad's ass while he fucks your squire.":
								say "     Throwing caution to the wind, you decide to help things along, granting Alistair a reprieve from the dryad's relentless pounding by surprising the plant creature with your face between those modest cheeks. You waste no time with pleasantries, slathering your tongue over the confused creature's flexing hole and digging against it insistently, demanding entry.  Considering the tentacles currently holding the former knight could turn on you at a moment's notice, you're running the risk of joining him, but thankfully, the sex-drunk hunk only moans aloud, legs spreading to give you better access. It doesn't take long before those insistent hips start to move again, depriving you of the pleasantly floral taste of dryad ass for a moment before shoving backward, grinding on your face, smothering you in masculine but vaguely floral musk.";
								say "     Grinning to yourself, you raise your hands, squeezing those flexing cheeks and diving in as deep as you can go, tongue piercing that tight hole and wagging inside the dryad's ass. Slurping away with gusto, you control the dryad's rhythm, keeping that pistoning green cock buried deep in your squire and forcing him to use his tentacles to move the man's body like a human fleshlight. Tentacles slip out of the ground around your knees, but they push your face deeper rather than ripping you away, forcing your face up and down that softening hole in a rhythm that fills the air with a drooling symphony of wet noise. Thrusts grow ragged as your lungs scream for air. You tear away from that floral hole, leaving it gaping slightly and clenching indignantly. You have a new goal in mind- capturing the virile plant's swinging balls in your mouth and slathering them in drooling love. Slipping two fingers into that well-prepared ring, you finger it to the rhythm of the dryad's thrusts, feeling his sack pull up, tightening against your ravenous sucks.";
								WaitLineBreak;
								say "     'Gods!' The dryad cries out under the triple-pronged assault of talented fingers, your hungry mouth, and Alistair's ass, stiffening, then ramming himself to the root. Those slippery balls leave your mouth with the violence of his breeding, but you keep your mouth open to catch the rain of syrupy cum that follows, drizzling down that pale green sack like a sugary reward. Anger sated by Alistair's ravaged body and your talented tongue, the dryad disengages with a wince, leaning against a nearby tree. It seems he's realized your threat to his tree was nothing but a ruse, but he watches you with drooping tentacles at the ready, surrounding his heaving, slim chest as if to say, 'Don't fuck with me.'";
							-- "Fuck the dryad while he fucks Alistair.":
								say "     Throwing caution to the wind, you set aside Alistair's sword along with your gear and sneak up on the distracted dryad, grabbing his hips from behind and smearing your cock between his cheeks. You cheekily ask if there's room for one more as you spit on your cock tip, kissing it against the dryad's hole and forcing him forward into Alistair hard enough to draw twin moans from the creature and the former knight. Taking his ass's tight clench and the lack of tentacles pulling you off of the floral hunk to mean that your intervention is welcome, you set the pace of the rough fuck, spurring the dryad's hips forward hard enough to send the clap of skin on skin echoing around the clearing. 'Yes! Please, get this foul creature off me!' Alistair mistakes your face appearing over the twink-fae's shoulder as a reprieve from his punishment for losing the fight, only to groan as you use your leverage to pound the dryad's cock deeper into his ass, making his rock-hard cock slap against his stomach and leave a guilty snail-trail of precum across his heaving abs.";
								say "     Digging your fingers into the dryad's hips for leverage, you work him over with greedy thrusts that force him to reinforce his vines, sending a lattice across your bare skin to keep the three of you upright. You're too far gone to care as the vines tickle the underside of your ass cheeks, and you grit your teeth as they slip past your defenses, twining inside of you and finding your prostate. The heaving mass of sweaty bodies writhes for mere moments before the pleasure overloads from an insistent prostate pounding and the wringing, slippery plant muscles set you off. Burying yourself to the root in the dryad, you plant your seed, bucking cock mimicking the greedy pulse of the tentacles in your ass. Your orgasm sets off a chain reaction in your little threesome, and before you know it, the dryad goes limp, slipping out of the captive knight mid-shot and joining him in orgasm, painting his front in a syrupy mix of sap and cum. You take a moment to relax, then slap the dryad's ass and extricate yourself from the grip of your herbaceous support, withdrawing and admiring the creamy, green gape of that well-fucked hole.";
							-- "Let things play out. You just want to watch.":
								say "     Giving in to the urge for laziness, you wave away any desire to intervene in the dryad's brutal pounding. Instead, you idly watch as Alistair struggles, trying to hide your self-satisfied expression. It wouldn't do to show him how much you enjoy his struggles. After all, you're supposed to be 'training' him. Without your intervention, the dryad grows bold in his humiliation of your obedient squire, spreading the poor man's ass wide with the addition of two smooth tentacles alongside his cock. From where you're sitting, you don't have the best view, but Alistair's expression is more than enough to fuel your lust. Indignance gives way to an open-mouthed pant, and before long, the poor knight-turned-squire loses all sense, drooling and going limp in his restraints, cock slapping against his stomach in time with every prostate-destroying plap. The dryad loses control long before the knight cums, shoving to the base and pumping him full of sticky, syrupy cum that drips in amber strings when he tugs his half-hard dick from Alistair's ruined butthole. It seems he's realized you mean him no harm, and he watches with curious eyes while you collect your squire and walk away, leaving him to lounge on his tree, still showing off his softening manhood.";
						WaitLineBreak;
						say "     With an insincere apology to the dryad, you gather Alistair from the ground, cupping his still-dripping ass as you whisk him away back to the waterfall to clean up and recuperate. He's still mumbling about toughening up, but you pay him no mind, already thinking up new ways to get him into compromising positions. After all, it's more fun that way.";
			else if "Female Monsters" is listed in Traits of Alistair:
				say "     A musical giggle alerts you to the presence of a dryad. Exposed breasts jiggle as the fae approaches, and with no clothing besides a few vines draped over it, that hourglass figure leaves nothing to the imagination, showing off plentiful green-tinged skin. It seems that the fae girl's different from other dryads you've seen, without the overtly hypersexual appearance and copious amounts of cum surrounding her chosen tree. 'That sword isn't for me, is it?' Pointing at the sword you used as a machete moments ago, the dryad pouts. 'Mortals always want to cut down my tree. I should teach you a lesson!' Summoning vines from below the dirt, she faces you with a determined expression, seemingly unaware of how unimposing her nude form is. Alistair intervenes before you can speak, readying his fists with a polite cough. 'Maiden. I won't enjoy subduing you, but I must. Please do not take mine transgression to heart.' Still chivalrous despite his 'demotion,' he tries to be apologetic even as he charges forward.";
				LineBreak;
				say "     Just like last time, you can choose to sabotage the knight. Should you?";
				say "[link]Y[as]y[end link] Yes - Trip him up. You want to watch the dryad have her way with Alistair!";
				say "[link]N[as]n[end link] No - You'll let it play out how it will.";
				if Player consents:
					say "     Whistling innocently, you stick out one foot, catching the charging knight's ankle and sending him flailing into the embrace of the angry dryad. After all, you're here for a show! You may be 'training' him, but you should get something out of the arrangement! Letting out a strangled yelp, the knight stumbles directly into the dryad's breasts, sputtering as he realizes where his face is. Indignantly, he tries to extricate himself, only to find himself face to face with the dryad, both hands on her chest and nude body pressed against hers. Taken aback by the soft assets teasing him, he attempts to regain his wits, only to be subdued by the dryad's summoned vines.";
					say "     'Ooh, I see now. You don't want to chop down my tree. You want to have some fun.' With one finger on her lower lip, the dryad looks over Alistair's prone body, idly petting a nearby vine as if it were a pet. 'It's been a while since I've seen a human boy near here. I suppose I'll grant your wish~.' Eyes sparkling with a girlishly predatory expression, she shoves Alistair onto a nearby stump, aided by her floral tentacles. She's not far behind, climbing atop him and perching on his thighs. Alistair tries to protest, but his words drown in the creature's bust, face shoved between her tits. He struggles at first, but when one of her tentacles slips between his thighs, stroking his manhood to hardness, he gives up with a frustrated, muffled groan. Ensnared by the botanical beauty's bountiful breasts, he rocks his hips, his cock on display between green cheeks, peeking from between the tentacle's coils.";
					WaitLineBreak;
					say "     'That's it. You boys are always so mean! All you have to do is ask nicely!' Stroking Alistair's hair with a strange sort of affection, the sylvan guides his cock between her legs, slipping him into her with an audible sigh. She wastes no time in riding the captive human, keeping his hands bound behind his back and his face buried in her bouncing bust. It's hard to see most of the action from where you're sitting, but you get the gist of it from peeking between the dryad's legs, watching Alistair's cock disappear into his dripping slit, and watching those floral titties bounce around the captive man's face. From what you can see, Alistair appears to be in heaven. Shortly after, though, the flashes of his expression you manage to glimpse around the dryad's ample bosom morph from pleasure to confused desperation, and he struggles against his bonds.";
					say "     'Oh no! Bad boy. Not yet.' Breathless from her constant rhythm, the dryad drags Alistair further into her embrace, licking her lips. 'I want more~!' Judging by the sloppy noises filling the clearing, the poor knight's already finished inside the dryad, but she shows no sign of slowing down, pinning him in place despite his white-knuckled struggles. You're not sure how long you watch the dryad drain your squire, but by the time she climbs off of him, he's gone limp, his expression slack and his cock reddened and half-hard. Thankfully for the poor guy, she appears to have lost all interest in either of you, allowing you to collect him while she lies in her chosen tree, humming to herself.";
					WaitLineBreak;
					say "    With an insincere apology to the dryad, you gather Alistair from the ground, cupping his ass as you whisk him away back to the waterfall to clean up and recuperate. He's still mumbling about toughening up, but you pay him no mind, already thinking up new ways to get him into compromising positions. After all, it's more fun that way.";
					CreatureSexAftermath "Dryad"receives "PussyFuck" from "Alistair";
				else:
					if a random chance of 1 in 2 succeeds: [Alistair wins.]
						say "     It quickly becomes apparent that Alistair is going to win his fight, once you decide not to interfere. Deftly dodging the tentacle's strikes, he drips with sweat as he tries to get closer to the dryad, and he only hesitates for a moment before sending her sprawling with a well-timed shove. From there, the fight starts to work in his favor, with the dryad's nubile body gaining bruise after bruise until she finally gives up, retreating to her tree with a wary expression. Taking his foe's retreat as an admission of loss, the squire puffs out his chest, stil nude and dripping with sweat, and struts over to you. You allow this short show of cockiness- after all, he did win- but tell him his training's far from over. Throwing an arm over his shoulder, you walk him back to the waterfall, sneaking a grope or two of the distracted squire's ass. You're already planning new compromising situations for Alistair, but you'll let him have this!";
					else:
						say "     Shaking your head, you decide not to interfere. You may be 'training' him for your own amusement, but you'd rather watch him fail on his own meric rather than jumping the gun and influencing the outcome. Your patience bears fruit after a few minutes of tentacle on squire battle, when one of the slippery plant appendages wraps around Alistair's ankle, sending him sprawling into the dryad. Letting out a strangled yelp, the knight stumbles directly into the dryad's breasts, sputtering as he realizes where his face is. Indignantly, he tries to extricate himself, only to find himself face to face with the dryad, both hands on her chest and nude body pressed against hers. Taken aback by the soft assets teasing him, he attempts to regain his wits, only to be subdued by the dryad's summoned vines.";
						say "     'Ooh, I see now. You don't want to chop down my tree. You want to have some fun.' With one finger on her lower lip, the dryad looks over Alistair's prone body, idly petting a nearby vine as if it were a pet. 'It's been a while since I've seen a human boy near here. I suppose I'll grant your wish~.' Eyes sparkling with a girlishly predatory expression, she shoves Alistair onto a nearby stump, aided by her floral tentacles. She's not far behind, climbing atop him and perching on his thighs. Alistair tries to protest, but his words drown in the creature's bust, face shoved between her tits. He struggles at first, but when one of her tentacles slips between his thighs, stroking his manhood to hardness, he gives up with a frustrated, muffled groan. Ensnared by the botanical beauty's bountiful breasts, he rocks his hips, his cock on display between green cheeks, peeking from between the tentacle's coils.";
						WaitLineBreak;
						say "     'That's it. You boys are always so mean! All you have to do is ask nicely!' Stroking Alistair's hair with a strange sort of affection, the sylvan guides his cock between her legs, slipping him into her with an audible sigh. She wastes no time in riding the captive human, keeping his hands bound behind his back and his face buried in her bouncing bust. It's hard to see most of the action from where you're sitting, but you get the gist of it from peeking between the dryad's legs, watching Alistair's cock disappear into his dripping slit, and watching those floral titties bounce around the captive man's face. From what you can see, Alistair appears to be in heaven. Shortly after, though, the flashes of his expression you manage to glimpse around the dryad's ample bosom morph from pleasure to confused desperation, and he struggles against his bonds.";
						say "     'Oh no! Bad boy. Not yet.' Breathless from her constant rhythm, the dryad drags Alistair further into her embrace, licking her lips. 'I want more~!' Judging by the sloppy noises filling the clearing, the poor knight's already finished inside the dryad, but she shows no sign of slowing down, pinning him in place despite his white-knuckled struggles. You're not sure how long you watch the dryad drain your squire, but by the time she climbs off of him, he's gone limp, his expression slack and his cock reddened and half-hard. Thankfully for the poor guy, she appears to have lost all interest in either of you, allowing you to collect him while she lies in her chosen tree, humming to herself.";
						WaitLineBreak;
						say "    With an insincere apology to the dryad, you gather Alistair from the ground, cupping his ass as you whisk him away back to the waterfall to clean up and recuperate. He's still mumbling about toughening up, but you pay him no mind, already thinking up new ways to get him into compromising positions. After all, it's more fun that way.";
						CreatureSexAftermath "Dryad"receives "PussyFuck" from "Alistair";
			TraitGain "Dryad Training" for Alistair;


Chapter 2 - Knight Alistair Training Squire Player

to say AlistairKnightKinkTraining:
	say "     Unable to get the sensation of complete surrender out of your head from the last time Alistair 'trained' you, you beg him to put you through your paces once again. You even get down on your knees to drive home how much you enjoy being dominated, staring up at him with your best 'puppy dog' eyes. Alistair shows disdain, turning up his nose at your blatant display of humility and scoffing. 'Hmmph. Thou shalt never be a knight with such a willingness to bow and scrape. Where's your pride? Though I suppose it IS important to show deference to thy betters.' You can tell he's enjoying your submission, however, as the bulge in the front of his pantaloons doesn't lie. Setting aside his sword and shield, the knight tilts your chin upward, running a rough finger over your lower lip. 'Should this knight keep thyself as mine squire forever?' Shrugging his shoulders, he doesn't wait for an answer. 'Only time will tell. Very well. Strip so that I might banish thy weakness.'";
	say "     Hurriedly throwing aside your gear, you bare every inch of yourself to the knight, doing nothing to hide your obvious arousal as you knee in front of him. This kinky training is what you've been waiting for, after all! There's no use in bashfulness. 'All fours. Straighten your body- Wider stance. Hold.' Barking orders, the knight circles you as you get into position, using his foot to spread your legs as you try your best to maintain that position, nearly sending you tumbling into the dirt. Your arms strain against the effort of holding yourself up, but you don't dare to let yourself fail. 'Perfect.' The rustle of cloth accompanies your silently screaming muscles, and you feel a familiar weight on your back accompanied by something hard and throbbing slipping between your ass cheeks. The nude knight shadows your movements- hands placed wider than yours, lips inches from your ear. 'Now, push thyself up and down. Touch thy back to mine chest until told to stop.'";
	WaitLineBreak;
	say "    Biting your lower lip, you try your best to focus on the knight's orders rather than the questing cock searching for entrance. Downward motion removes that hardness from between your cheeks, but on the way back up, it slips between your thighs, tickling your perineum and setting alight fantasies of how it'd feel inside you. Shaking your head, you ignore the rising heat in your stomach. 'That's it.' Alistair's breath grows ragged as you tease his manhood, effortlessly holding his position above you and forcing you to feel the masculine, musk-laden heat against your back with every repetition. You swear you can feel his abs against the small of your back, hard as steel.";
	if Player is female:
		say "     Angling his hips, Alistair teases his cockhead between your lower lips, letting you feel how hard he is with every push of your aching arms. You can't quite guide him into you, but the sensation of his swollen cocktip nudging against your entrance only to slide forward and tease your clit, glazing itself in your juices, is even better. Barely able to help yourself, you tilt your hips upward to increase that contact, your form growing shakier in an attempt to work your greedy pussy. 'Focus, whore.' Alistair says the words with a strange sort of affection, prodding your increasingly wet pussy with insistent thrusts that threaten to slide him home. 'Thy form is slipping. Is this all thou art capable of?' You try your best to follow the knight's instructions, but your legs spasm when an improperly done pushup sends his dripping dick into your greedy cunt. Unable to resist any further, you let your front half go downward, leaving your lower half speared on that steely dick. Whimpering for more, you beg your knight for mercy, promising to perform better in the future.";
		say "     Rough hand gathering your wrists, the knight growls in your ear. 'Is this all it takes to defeat a knight in training? Reduced to a mewling quim at the slightest hint of stimulation?' The knight's spare hand strikes your upturned ass, but he doesn't pull out of you, the weight of his body leaving your back in the process as he settles into a more conventional position. 'Reap your reward then.' Pistoning his hips, the knight stirs your pussy with deep strokes that leave no doubt as to how much of a whore you've become. You're so wet that there's no resistance, and your innards twist in a desperate attempt to wring everything they can from his manhood. You are a whore- it's undeniable- and every inch of your body wants more of that perfect cock. Nothing but a soft, wet hole for knights to pour their frustration into.";
		WaitLineBreak;
		say "     Grunting his approval, Alistair drops any pretense of training, dragging you backward with a firm hand on your chest and forcing you up and down his cock in a neverending bounce. Heavy balls slap against your clit with every thrust, and that heavenly cock churns your pussy juice to foam, but what you want is still to come. Slamming home, the knight buries himself to the root in your greedy pussy, hosing the entrance to your womb with gooey string after string of noble seed. His beard tickles your neck, rough and sweaty, as he buries his face in it, and the ragged, hot breath that grazes your cheek brings a strange sense of pride as you realize how worked up you've gotten him. Even if you're incapable of becoming a knight, it seems you can bring a knight to their knees! You rest in the afterglow, falling forward in a heap and whimpering as the knight's cum gushes from your empty cunt. Alistair seems to pay little attention now that you've completed your training. However, you can feel his gaze on your nude body, and the hard cock he tucks into his pants doesn't lose any of its vigor for the few minutes it takes to regain your breath, so you assume you've left a lasting impression. Maybe you should ask him for training again sometime soon.";
		NPCSexAftermath Player receives "PussyFuck" from Alistair;
	else if Player is male:
		say "     Angling his hips, Alistair teases his cockhead against the rim of your asshole, letting you feel how hard he is with every push of your aching arms. You can't quite guide him into you, but the sensation of his swollen cocktip nudging against your entrance only to slide further and tease the back of your balls, glazing itself in your sweat, is even better. Barely able to help yourself, you tilt your hips upward to increase that contact, your form growing shakier in an attempt to work your greedy ass onto his shaft. 'Focus, whore.' Alistair says the words with a strange sort of affection, prodding your increasingly tingling rim with insistent thrusts that threaten to slide him home. 'Thy form is slipping. Is this all thou art capable of?' You try your best to follow the knight's instructions, but your legs spasm when an improperly done pushup sends his dripping dick into your sweat-lubricated ass. Unable to resist any further, you let your front half go downward, leaving your lower half speared on that steely dick. Whimpering for more, you beg your knight for mercy, promising to perform better in the future.";
		say "     Rough hand gathering your wrists, the knight growls in your ear. 'Is this all it takes to defeat a knight in training? Reduced to a mewling quim at the slightest hint of stimulation?' The knight's spare hand strikes your upturned ass, but he doesn't pull out of you, the weight of his body leaving your back in the process as he settles into a more conventional position. 'Reap your reward then.' Pistoning his hips, the knight stirs your hole with deep strokes that leave no doubt as to how much of a slut you've become. You're so excited that there's no resistance, and your innards twist in a desperate attempt to wring everything they can from his manhood. You are a whore- it's undeniable- and every inch of your body wants more of that perfect cock. Nothing but a soft, clamping hole for knights to pour their frustration into.";
		WaitLineBreak;
		say "     Grunting his approval, Alistair drops any pretense of training, dragging you backward with a firm hand on your chest and forcing you up and down his cock in a neverending bounce. Heavy balls slap against your ass with every thrust, and that heavenly cock churns your ruined butt, but what you want is still to come. Slamming home, the knight buries himself to the root in your greedy hole, hosing your deepest depths with gooey string after string of noble seed. His beard tickles your neck, rough and sweaty, as he buries his face in it, and the ragged, hot breath that grazes your cheek brings a strange sense of pride as you realize how worked up you've gotten him. Even if you're incapable of becoming a knight, it seems you can bring a knight to their knees! You rest in the afterglow, falling forward in a heap and whimpering as the knight's cum gushes from your gaping ass. Alistair seems to pay little attention now that you've completed your training. However, you can feel his gaze on your nude body, and the hard cock he tucks into his pants doesn't lose any of its vigor for the few minutes it takes to regain your breath, so you assume you've left a lasting impression. Maybe you should ask him for training again sometime soon.";
		NPCSexAftermath Player receives "AssFuck" from Alistair;


Section 6 - Debug code

[For those that don't want to restart to see the alternate path!]

AlistairReset is an action applying to nothing.

understand "zKnightReset" as AlistairReset.

check AlistairReset:
	if debugactive is 0:
		say "You aren't currently debugging.";
		stop the action;

carry out AlistairReset:
	say "     <Alistair will now act as though you lost to him the first time. This allows you to try out his Submissive (Player winning) and Dominant (Player losing/submitting during first spar) routes, starting after the event where he tells you his name. Your first spar determines his path!>";
	now thirst of Alistair is 0;
	now hunger of Alistair is 0;
	now Resolution of Gruff Gallant And Misguided is 3;
	TraitLoss "Training Alistair" for Alistair;
	TraitLoss "Alistair's Knight Training" for Alistair;

Alistair ends here.


