Cassian by Voidsnaps begins here.

[Loyal Lad Resolutions]
[1- Helped him out.   ]
[2- Not interested.   ]

Table of GameCharacterIDs (continued)
object	name
Cassian	"Cassian"

Cassian is a man.
ScaleValue of Cassian is 3. [human sized]
Body Weight of Cassian is 2. [scale of 1-9 for body weight, grouped into low weight (1-3), mid weight (4-6) and high weight (7-9)]
Body Definition of Cassian is 5. [scale of 1-9 for body definition, grouped into low muscle (1-3), mid muscle (4-6), high muscle (7-9)]
[Body Adjective is generated out of the body weight and body definition and can be used in scenes - one word descriptive adjective depending on weight and definition groups: low weight group: skinny/slender/lithe; mid weight group: average/fit/muscled; high weight group: pudgy/husky/jacked]
Androginity of Cassian is 2. [Gender Adjective is generated out of androginity 1-9: hypermasculine/masculine/somewhat effeminate/effeminate/androgynous/feminine butch/tomboyish/feminine/hyperfeminine]
Mouth Length of Cassian is 5. [inches deep for face fucking; maximum possible will be double this number (when deep throating)]
Mouth Circumference of Cassian is 3. [mouth circumference 1-5, "tiny, small, normal, wide, gaping"]
Tongue Length of Cassian is 3. [length in inches]
Breast Size of Cassian is 0. [cup size as number, counting Flat Pecs = 0, A = 1, B = 2, ...]
Nipple Count of Cassian is 2. [count of nipples]
Asshole Depth of Cassian is 8. [inches deep for anal fucking]
Asshole Tightness of Cassian is 2. [asshole tightness 1-5, "extremely tight, tight, receptive, open, gaping"]
Cock Count of Cassian is 1. [number of cocks]
Cock Girth of Cassian is 2. [thickness 1-5, thin/slender/average/thick/monstrous]
Cock Length of Cassian is 8. [length in inches]
Ball Count of Cassian is 2. [allowed numbers: 1 (uniball), 2 or 4]
Ball Size of Cassian is 3. [size of balls 1-7: "acorn-sized", "dove egg-sized", "chicken egg-sized" "goose-egg sized", "ostrich-egg sized", "basketball-sized", "beachball-sized"]
Cunt Count of Cassian is 0. [number of cunts]
Cunt Depth of Cassian is 0. [penetrable length in inches; some minor stretching allowed, or more with Twisted Capacity]
Cunt Tightness of Cassian is 0. [size 1-5, generates adjectives of extremely tight/tight/receptive/open/gaping]
Clit Size of Cassian is 0. [size 1-5, very small/small/average/large/very large]
[Basic Interaction states as of game start]
PlayerMet of Cassian is false.
PlayerRomanced of Cassian is false.
PlayerFriended of Cassian is false.
PlayerControlled of Cassian is false.
PlayerFucked of Cassian is false.
OralVirgin of Cassian is false.
Virgin of Cassian is true.
AnalVirgin of Cassian is false.
PenileVirgin of Cassian is false.
SexuallyExperienced of Cassian is true.
TwistedCapacity of Cassian is false. [Twisted Characters can take any penetration, no matter the size]
Sterile of Cassian is false. [steriles can't knock people up]
MainInfection of Cassian is "Squire".
Description of Cassian is "[CassianDesc]".
Conversation of Cassian is { "<This is nothing but a placeholder!>" }.
The scent of Cassian is "     Cassian smells like sweat and hard work, with a hint of metal from his sword.".

to say CassianDesc:
	say "     Cassian is a blonde human man with boyishly tousled hair, grey eyes and a wiry build. It's obvious that he takes pride in his appearance, and his body shows it, tightly wound with toned muscles honed in battle. He wears a medieval undershirt that you'd expect to see beneath a suit of armor and blue pantaloons that do little to hide the bulge of his manhood. Covering his feet are featureless leather shoes tied around his ankle with a leather tie.";


Table of GameEventIDs (continued)
Object	Name
Loyal Lad	"Loyal Lad"

Loyal Lad is a situation.
ResolveFunction of Loyal Lad is "[ResolveEvent Loyal Lad]".
Sarea of Loyal Lad is "Outside".
The level of Loyal Lad is 10.
when play begins:
	add Loyal Lad to BadSpots of MaleList;

to say ResolveEvent Loyal Lad:
	say "     'Godsdamn you!' A voice rings out as you walk through a small strip of clothing stores. Curious, you follow the sounds of tinkling glass and cursing, finding a jumbled mass of mannequins and clothing around a broken shop window. The source of the racket sits a few feet inside the shop: By all appearances, it is an uninfected human male, slender but lightly muscled. He's bloody and wounded, wearing some archaic-looking clothing, and is currently tearing at a dress with his teeth and trying to bandage a wicked-looking gash on one arm. A sword sits at the blonde man's side, but you don't think the man is dangerous in his current condition. With his wounds, he'd be lucky to stand up without falling face-first to the tile below him. If you wanted to, you could help the poor wretch. His clumsy attempts at bandaging are only making his wounds worse, and he looks demented, ripping into a sundress with his teeth and creating the world's most colorful bandage in the process.";
	LineBreak;
	say "      [bold type]What do you want to do?[roman type][line break]";
	LineBreak;
	let Cassian_Save_Choices be a list of text;
	if medkit is owned:
		add "You have a medkit that would help sigificantly more than some improvised bandages. Use that!" to Cassian_Save_Choices;
	add "Calm him down. Use your words!" to Cassian_Save_Choices;
	add "Walk away. There's no telling what someone that agitated would do." to Cassian_Save_Choices;
	let Cassian_Save_Choice be what the Player chooses from Cassian_Save_Choices;
	if Cassian_Save_Choice is:
		-- "You have a medkit that would help sigificantly more than some improvised bandages. Use that!":
			LineBreak;
			say "     Approaching the distraught man, you speak calmly and hold out the medkit, opening it to show him its contents. Trying to stay out of range of a not-yet-flailing sword, you explain that you only want to help and treat his wounds if he promises not to attack you. ";
			say "[SquireBandage]";
		-- "Calm him down. Use your words!":
			LineBreak;
			if a charisma check passes 14:
				say "     You try to remain calm and explain your intentions, but the squire keeps his guard up, staring you down warily and gripping his sword. You're about to give up on approaching him, but your eye catches a red plastic box peeking from below the shop's register, and you swiftly retrieve it. Pointing to the white cross on its front, you flip it open, explaining that you're here to help. ";
				say "[SquireBandage]";
			else:
				say "     Shaking your head at his display of aggression, you explain to the squire that you're not there to harm him. You're sure that there's a first aid kit behind the register. If he calms down, you'll grab it and help him bandage himself. Anything must be better than that garish monstrosity he's soaking with blood. ";
				say "[SquireBandage]";
		-- "Walk away. There's no telling what someone that agitated would do.":
			LineBreak;
			say "     Shrugging, you decide not to risk a fight with the bloody young man. If he wants to threaten you, HE can treat his wounds. You've got your hands full, keeping yourself out of the hands of horny monsters!";
			now Resolution of Loyal Lad is 2; [Walked away]
	now Loyal Lad is resolved;


to say SquireBandage:
	if BodyName of Player is "Knight" and Player is pure:
		say "The blonde man grunts as he notices your coat of arms, then sighs, hanging his head. 'I suppose I should shun the help of a rival knight, but... Loyalty to a ghost serves no one. On with it, then.' Gesturing his head rudely toward his wound, the squire closes his eyes and winces, letting his makeshift efforts flutter into a bloody heap. It probably hurts more than he's letting on, but he's learned the prideful ways of his master. Approaching him slowly, you remark on his rudeness, clearing away blood from the bite marks covering the young man's biceps and binding them with gauze. If he were your squire, he would respect his betters! Still, you're glad that he didn't let his pride get in the way of keeping himself safe. Bleeding to death on a department store floor serves no one.";
		say "     After you bandage the lad's wounds, he sags against the wall, looking as though all the adrenaline has worn off and he's exhausted. He's silent for a few moments, but eventually, his voice rings out, cracked and on the edge of breaking. 'Thank you. I'm not used to this sort of kindness. Master Marius taught me to fear rival knights, they'd only try to entice me from my path, but I suppose he was wrong. If only...' Curious, you ask the squire what happened to his knight. His wounds were dire, and he looked like something mauled him. What sort of foul beast were they fighting that they couldn't win with swords and shields? 'We were training in the forest, and we heard the sounds of something fighting. Master wanted to be sure that nothing untoward was happening and...' The squire takes a deep breath, then continues, clutching his knees to his chest. 'The most beautiful creature. A unicorn, surrounded by wolves, defiled, fighting for its life. We couldn't stand by...' Trailing off, he lets you fill in the blanks. In the best-case scenario, the knight was now a breeding bitch for a gang of wolves alongside the unicorn. Not the most fitting end for a noble knight.";
	else if BodyName of Player is listed in infections of HumanList:
		say "The blonde man grunts as he notices your approach, then sighs, hanging his head as he scans your face for malice. 'I suppose I should shun the help of a civilian, but... Loyalty to a ghost serves no one. On with it, then.' Gesturing his head rudely toward his wound, the squire closes his eyes and winces, letting his makeshift efforts flutter into a bloody heap. It probably hurts more than he's letting on, but he's learned the prideful ways of his master. He can't show weakness to others, now, can he? Approaching him slowly, you remark on his rudeness, clearing away blood from the bite marks covering the young man's biceps and binding them with gauze. If he's planning to become a knight, he should respect others! Still, you're glad that he didn't let his pride get in the way of keeping himself safe. Bleeding to death on a department store floor serves no one. After all, a strapping lad like himself would be a terrible waste if he died.";
		say "     After you bandage the lad's wounds, he sags against the wall, looking as though all the adrenaline has worn off and he's exhausted. He's silent for a few moments, but eventually, his voice rings out, cracked and on the edge of breaking. 'Thank you. I'm not used to this sort of kindness. Master Marius taught me to fear rival knights, they'd only try to entice me from my path, but I suppose he was wrong. If only...' Curious, you ask the squire what happened to his knight. His wounds were dire, and he looked like something mauled him. What sort of foul beast were they fighting that they couldn't win with swords and shields? 'We were training in the forest, and we heard the sounds of something fighting. Master wanted to be sure that nothing untoward was happening and...' The squire takes a deep breath, then continues, clutching his knees to his chest. 'The most beautiful creature. A unicorn, surrounded by wolves, defiled, fighting for its life. We couldn't stand by...' Trailing off, he lets you fill in the blanks. In the best-case scenario, the knight was now a breeding bitch for a gang of wolves alongside the unicorn. Not the most fitting end for a noble knight.";
	else:
		say "The blonde man shuffles backward when he notices your inhuman face. 'Back off, monster. It's because of your kind that I lost Master Marius!' Reaching for his sword, the squire closes his eyes and winces, letting his makeshift bandage efforts flutter into a bloody heap as his strength fails him, sending his sword back to the floor with a clatter. It probably hurts more than he's letting on, but he's learned the prideful ways of his master. Approaching him slowly, you remark on his rudeness, clearing away blood from the bite marks covering the young man's biceps and binding them with gauze. You weren't the one that bit him. Even 'monsters' have feelings! Still, you're glad he didn't let his unfounded prejudice get in the way of keeping himself safe. Bleeding to death on a department store floor serves no one. It would be a terrible waste for such a handsome man to die without experiencing the fun a 'monster' could have with his toned body.";
		say "     After you bandage the lad's wounds, he sags against the wall, looking as though all the adrenaline has worn off and he's exhausted. He's silent for a few moments, but eventually, his voice rings out, cracked and on the edge of breaking. 'Thank you. I'm not used to this sort of kindness. Master Marius taught me to fear rival knights, they'd only try to entice me from my path, but I suppose he was wrong. If only...' Curious, you ask the squire what happened to his knight. His wounds were dire, and he looked like something mauled him. What sort of foul beast were they fighting that they couldn't win with swords and shields? 'We were training in the forest, and we heard the sounds of something fighting. Master wanted to be sure that nothing untoward was happening and...' The squire takes a deep breath, then continues, clutching his knees to his chest. 'The most beautiful creature. A unicorn, surrounded by wolves, defiled, fighting for its life. We couldn't stand by...' Trailing off, he lets you fill in the blanks. In the best-case scenario, the knight was now a breeding bitch for a gang of wolves alongside the unicorn. Not the most fitting end for a noble knight.";
	WaitLineBreak;
	LineBreak;
	say "      [bold type]Seems like he's preparing to go after his master. What do you want to do?[roman type][line break]";
	LineBreak;
	say "     [link](Y)[as]y[end link] - Help him look for his knight.";
	say "     [link](N)[as]n[end link] - Wish him the best and leave.";
	if Player consents:
		if BodyName of Player is "Knight" and Player is pure:
			say "     Gently, you encourage the squire to his feet, pressing his sword into his hands. You can't bear to see him so depressed, and while you're unsure whether you can save his master, perhaps a bit of closure can help the poor lad move on. Announcing that you'll help him recover his knight's gear, at the very least, you clap him gently on the back and tap your chest with your fist, giving him a wink. Of course, he'll have to reward you for your efforts!";
		else if BodyName of Player is listed in infections of HumanList and Player is pure:
			say "     You can't help but feel bad for the squire. You're sure he's not the only one to lose someone in this crazy new world. Even if their relationship was strange and likely caused by the nanites, it wasn't any less powerful of a connection. You decide you'll help the poor guy recover a memento of his master, at least. If he's anything like the rest of the city's inhabitants, he'll have left behind clothes.";
		else:
			say "     Despite his insult toward your species, you can't help but feel bad for the squire. You're sure he's not the only one to lose someone in this crazy new world, and if anyone understands going through a change, it's you. Hell, you're not even human anymore! Even if their relationship was strange and likely caused by the nanites, it wasn't any less powerful of a connection.";
		LineBreak;
		say "[UnicornFucksMarius]";
		now Resolution of Loyal Lad is 1;
	else:
		say "     What the squire is suggesting sounds dangerous, and you've learned that nothing is as it seems in this place. You don't know what he'll do when he gets you alone in the woods! Wishing the lad luck, you turn your back on him and leave without another word. While you're more than happy to help someone in need, that doesn't mean you'll put your life on the line for them. You've done all you can, and you're too busy providing for yourself to talk someone out of doing something foolish, or risk your life following them into who-knows-what.";
		now Resolution of Loyal Lad is 3; [let him leave (bandaged)]

to say UnicornFucksMarius:
	say "     Cassian, the squire, leads you to the spot where he last saw his master as soon as his wounds begin to close, opening up to you on the way. You can see why someone took him on as their apprentice. Even now, a few hours after his loss, all Cassian seems to think about is avenging him. You gently remind him that he's no match for a pack of wolves, and they're likely long gone with his master in tow. Your words drive home once you reach the clearing and find a pile of torn, bloody and cum-covered clothes, along with signs of a struggle. Cassian falls to his knees, his face contorting, and you decide it's better to let him grieve for a few moments. Patting his head, you say you'll be back, then head into the nearby brush, politely ignoring the sobbing that follows you. He'll call out if he needs you.";
	say "     Soon, you hear the sloppy sounds of something having fun. Curious, you step closer to the sound, peeking through waist-high bushes and spying a tangled mass of bodies centered around a stump. Is that a white unicorn in the middle? Surrounded by wolves and something you can't quite make out. Startled, you almost stand but stop as a baritone voice chuckles from the mass of writhing bodies. 'Good boys. You played your part so well.' Cooing his words and punctuating them with unmistakably sexual grunts, the black unicorn in the middle of the orgy, behind the white, comes into view as he lifts his muscled arms, letting two eager canines settle into his pits and slurp away. Like a king on a throne, he sighs, taking hands full of furry butts and wringing a whine from each of them. 'Fucking this new mare is quite the workout.' He says, abandoning the fluffy butts to yank on the fourth creature's head, revealing a mostly transformed, drooling equine.";
	WaitLineBreak;
	say "     You realize the white unicorn must be the former knight. His body's transformed into something more at home on a gym bunny twink, and his mouth hangs open while he drools like an empty-headed slut, but the tattered tabard draped over his shoulders allows no doubt. The grunting equine currently spearing himself on the black unicorn's cock, slapping hefty onyx balls against his ass and dripping with sweat and drool, is Marius. You wince as the former knight's stomach bulges with cock. You doubt the four will finish soon, and Marius looks too far gone to save...";
	LineBreak;
	say "     [italic type]Do you watch him get fucked, or do you return to Cassian?[roman type][line break]";
	LineBreak;
	say "     [link](Y)[as]y[end link] - Fuck yeah. A free show.";
	say "     [link](N)[as]n[end link] - No. You've seen enough.";
	if Player consents:
		LineBreak;
		say "     It won't hurt anybody if you watch the show. At least you can be sure that Marius is happy in his new position as a unicorn's fucktoy- or so you tell yourself as you settle in and lower your pants. [if Player is female]Slipping two fingers into yourself, you peek through the bushes, watching the orgy unfold, [else if Player is male]Taking your cock in your hands, you stroke yourself in time with the rhythm of the four horny beasts,[end if]careful to keep your motions as silent as possible.";
		say "The two wolves have moved from polishing the unicorn's armpits to slathering his pecs in drool since your attention drifted, nursing at his nipples like two eager puppies, and his hands have drifted down to take a grip of his new bottom's jiggling rump, dragging him back into punishing thrusts with self-satisfied grunts. Licking his lower lip free of flecks of drool with a smirk and letting his manhood slip free, visibly prodding into the newly-changed man's hole, the not-so-pure unicorn continues his gloating, fingers moving up to slip into Marius's mouth and hooking the side of it. 'You fuckin' love this, don't you? I bet I didn't have to trick you and that brat into coming to my rescue. One glance at this hard cock, and you'd be on your knees, begging for breeding.' The unicorn's practically puffing steam as he speaks, and his body's dripping with sweat, swiftly licked up by canine tongues that worship the curves of sculpted muscles. 'You want another load, bitch? Beg for it. Admit the only sword you need is this foul beast's cock.'";
		WaitLineBreak;
		say "     Marius answers without hesitation, his voice distorted by fingers. 'Yesh shir. Fuck me, pleashe!' He moans, willingly pushing himself down the unicorn's shaft with a sloppy slurp that sends the first load of mythical seed dripping down heavy onyx balls. Splurting desperation works him up and down the sticky shaft, and there's no denying he's too far gone to return to his knightly ways. There are worse ways to go. The worshiping wolves are determined to catch the bounty dripping down their master's balls. With twin whimpers, they drop to their knees, burying their muzzles under those dripping balls and sucking leathery orbs into greedy muzzles. Your view disappears, obscured by wagging tails and gaped holes, yawning from their exploits with their equine master, and it fans the scent of pure sex toward you, fueling your masturbation. If you weren't sure you'd become like Marius, you wish you could join them.";
		say "     Marius's furry stomach distends with every pump, cored out by the unicorn's violent thrusts. It isn't until his eyes roll back and his smaller shaft paints the wolves between his legs that you realize the newly converted slut's gotten his wish, his stuffed stomach bloating into a slightly jiggling dome that sloshes with seed. Helpless before the pleasure, he lolls his head, unresisting, meeting his stud's maw for a sloppy kiss that sends drool dripping down equine chins. Lapping sounds follow, and you realize the two smitten wolves are drinking the overflow, fueling their thrusting hips and coaxing pre from their dangling, unattended canine shafts. The sight that finally sends you over the edge, sending [if Player is female]your fluids dripping to the ground below and coating your fingers in fem-cum[else if Player is male]your cum painting the leaves of the bush you're hiding in like juicy spiderwebs[end if] is the equine tugging himself free of his mare to let his half-hard cock flop between eager muzzles. You pause, lazily touching yourself as you come down from your orgasm, watching the wolves clean their master, and tuck yourself back into your pants, shuffling backward until you can stand and pick your way back to Cassian. You suppose you should feel guilty about enjoying yourself while he's grieving, but you couldn't help yourself.";
	else:
		LineBreak;
		say "     You decide against watching Marius receive a pounding from his new master. It's the least you can do for him, though you can't save him. It would only upset Cassian to see him the way he is right now, and you're not confident that you can fight off three to four horny beasts if the poor squire wanders over and picks a fight.";
	LineBreak;
	say "     [italic type]Now the only question floating in your head as you walk back is whether or not to tell Cassian what happened to Marius. [roman type]Should you let the grieving squire know his master is nothing more than an equine cumdump? Somehow you think it will be more upsetting than the alternative, though more devastating- if he finds out you lied.";
	LineBreak;
	say "     [link](Y)[as]y[end link] - He's been through enough.";
	say "     [link](N)[as]n[end link] - He deserves the truth.";
	if Player consents:
		LineBreak;
		say "     Before you can find the words to lie to Cassian, he shuffles over to a nearby bush, attracted by a gleaming object. Dumbfounded, he pulls a sticky, cum covered sword and shield from the underbrush. He stares at them for a second, then lets out a sharp, short bark of a laugh, wiping his face across his arm and looking back at you. 'My master didn't die. There's no blood, no sign of a fight. He was a fraud.' Standing and kicking dirt at the sticky equipment, he shakes his head, a slightly sad grin crossing his face. 'Master- no. Marius always said that if you let yourself fall to sin and allow yourself to become a beast, then you're not a knight. By his teachings, he's unworthy.' Wiping away the byproducts of his sorrow, the squire looks up at you, chuckling ruefully. 'I suppose I should thank you. You've freed me from the teachings of a fraud. Would you help me find a suitable place to give you your reward?'";
	else:
		LineBreak;
		say "     As soon as Cassian comes back into view, you try to straighten yourself up, brushing twigs from your front and clearing your throat. It's hard to find the right words to explain his master's fall from grace, but you explain what you saw, conveniently leaving out the spot where you saw them last. Best that he doesn't see round three of his master's degradation. Cassian would only get himself converted to another member of the nameless unicorn's harem. Cassian's head falls as you reach the end of your story. He seems strangely relieved as he wipes his eyes, and quite a bit of the anger in his expression has faded. Perhaps it's because his master isn't dead? Confused, you ask him if he's alright. 'It's awful, but somehow this is better than Master Marius's death. If I follow his teachings, I shouldn't put any stock in his words. If he wasn't strong enough to fight to the last- If he let himself be tainted, then he's not a knight.' Wiping away the byproducts of his sorrow, the squire looks up at you, chuckling ruefully. 'I suppose I should thank you. You've freed me from the teachings of a fraud. Would you help me find a suitable place to give you your reward?'";
	say "[Cassian First Fuck]";

to say Cassian First Fuck:
	say "     'A suitable place' can be tough to find in the apocalypse, as it turns out. Though Cassian seems at ease as you return from the forest, he vetoes the spots you point out, citing his travels with his master as reasons to avoid them. (And more than once being right as you see glowing eyes from within dark spaces.) You suppose he must have a knack for survival if he managed to get by this long with such a handsome face. Finally, you reach the same building that you found Cassian in. There's an air of an 'after date' scene on a tv show, and you can't help but wonder if there will be a kiss at the end of your time with him. Now that you think about it, what Cassian said about 'rewarding you for your help' sounds vaguely sexual. Perhaps you should set boundaries if you want to take him for a roll in the proverbial hay!";
	LineBreak;
	say "     [link](Y)[as]y[end link] - Go with the flow. The blonde is handsome enough. You want to see what's hiding beneath those old-timey clothes!";
	say "     [link](N)[as]n[end link] - Head things off. Make it clear you were helping the knight-less squire because it was the right thing to do!";
	if Player consents:
		LineBreak;
		say "     Silently, you follow Cassian through the broken storefront and into the clothing shop. He moves with purpose, his shirt falling away as practiced fingers unbutton it, and he beckons you to the secluded area behind the register, flashing his bare, perfectly muscled ass as he leaves his pants behind him. There's no doubt that what he wants from you is sexual, so you drop any pretense of shyness [if Player is barecrotch]touching yourself [else]baring your body [end if]as you follow him and imagining what that toned body can do. You leave your gear in the doorway, confident that you can reach it in an emergency.";
		if BodyName of Player is "Knight" and Player is pure:
			say "     Cassian meets you as soon as you walk into the gloomy room, placing both hands on your [if breast size of Player is 0]masculine [else]soft [end if]chest and massaging it as his lips seek yours. His tongue is active but slow and dances around yours, showing no end of skill. You can guess what his master was teaching him besides swordplay- you would have done the same as his knight. Still, it feels nice, and the sensation of his manhood [if Player is male]pressing against your excited shaft [else if Player is female]prodding between your pussy lips without slipping in [end if]isn't bad either, drawing a muffled moan from your lips as your hands lower, taking hold of that muscular, hairless ass and encouraging his gentle grind, slipping a finger into his ass to show him who's in charge. He's tight, but loosens up almost immediately, melting around your finger, and you wonder just how experienced he is.";
			if Player is male:
				say "     Cassian takes hold of your shaft as your kiss breaks, stroking you slowly and meandering his tongue over your nipples, then lower until it reaches your muscular stomach, pausing to circle your navel before he slips down to his knees. His lips pout in a soft welcome, cradling the tip of your manhood, and he swipes away pre with his tongue before trailing it downward, his lips opening to mouth at the base of your shaft. Still stroking you with careful, soft hands, the lad sucks one of your balls into his mouth, polishing it with an eager tongue and breathing deeply of your musk, his pretty grey eyes staring up at you as he lavishes care on your churning nuts. Finally, just as you're about to beg him to take your cock into his mouth, he abandons your balls, allowing the head of your cock to slip past saliva-slickened lips and welcoming it into slick, heavenly depths. Well-trained and eager, he doesn't gag, even when his efforts earn a bucking thrust into his throat. The two of you settle into a gentle, wet rhythm, slathering your shaft in slickness, and before long, you grip his hair, speeding your thrusts and making him grope your ass for support, his sucking mouth adding a sloppy, echoing refrain to your eager grunts. Succulent moments pass, and you feel like you're about to finish, so you grip his head with both hands, pumping your balls against his chin with wild abandon and lingering at the edge, your face screwing up in concentration.";
				WaitLineBreak;
				say "     What finally brings you over the edge is a sneaky finger between your cheeks, rolling against the rim of your hole, then diving in, finding your prostate, and pressing it like a buzzer in a game show. Your eyes cross as you fire one shot, then two, then several more in quick succession, painting the eagerly swallowing boy's throat until sensitivity forces you to slow your punishing thrusts, leaving your cocktip between foamed, well-fucked lips. Slumping against the wall, you watch Cassian swallow your load without complaint, kissing your softening member as he tends to his needs and licking the sweat beneath your balls as his hand blurs on his cock. There's just something so right about watching him nurse at your sated cock, licking every last drop of cum from it and cleaning your groin with his tongue, and when he shivers through his orgasm, you debate taking him on as your squire. You would enjoy more worship, and you doubt Cassian would complain, judging by the pearly puddle of cum cooling between your feet.";
				NPCSexAftermath Cassian receives "OralCock" from Player;
			else: [female only]
				say "     Cassian pauses as he reaches your feminine lips, almost seeming disappointed in your lack of a penis to worship. Still, he doesn't let that stop him, nuzzling between your thighs and staring up at you as he mouths at your clitoris with soft lips. Your spread legs and hissing breath encourage him, bringing his hands up to cup your ass as his tongue follows your lips from your clit down to your needy entrance, tasting your nectar. The next few moments blur as Cassian's talented mouth works your increasingly slippery sex, trailing over sensitive spots you didn't know you had. It's so good that you can't stop your hips from grinding, smearing your cunt against his face, and leaving his chin wet with your juices. Like a coiled spring between two fingers, your orgasm winds tighter until you clamp your thighs around his face, moaning through your finish and flooding his mouth with fem-cum until it drips onto his toned chest, marking him with the scent of his betters. Cassian prolongs your pleasure, nuzzling into your vagina and caressing your clit with gentle lips as he collects some of your juices, tending to his needs with the slickness to aid him, as though thanking you for painting him in the scent of your womanhood. It isn't until you feel him shiver and moan into your snatch that he pulls back, painting the floor between your feet with his load and looking up at you with a lust-drunk, irresistibly adorable expression.";
		else if BodyName of Player is listed in infections of HumanList and Player is pure:
			say "     Cassian meets you as soon as you walk into the gloomy room, placing both hands on your [if breast size of Player is 0]masculine [else]soft [end if]chest and massaging it as his lips seek yours. His tongue is active but slow and dances around yours, showing no end of skill. You can guess what his master was teaching him besides swordplay. Still, it feels nice, and the sensation of his manhood [if Player is male]pressing against your excited shaft [else if Player is female]prodding between your pussy lips without slipping in [end if]isn't bad either, drawing a muffled moan from your lips as your hands lower, taking hold of that muscular, hairless ass and encouraging his gentle grind, admiring his muscles with squeezing fingers. Only a warrior would have a body this perfectly honed.";
			if Player is male:
				say "     Cassian takes hold of your shaft as your kiss breaks, stroking you slowly and meandering his tongue over your nipples, then lower until it reaches your muscular stomach, pausing to circle your navel before he slips down to his knees. His lips pout in a soft welcome, cradling the tip of your manhood, and he swipes away pre with his tongue before trailing it downward, his lips opening to mouth at the base of your shaft. Still stroking you with careful, soft hands, the lad sucks one of your balls into his mouth, polishing it with an eager tongue and breathing deeply of your musk, his pretty grey eyes staring up at you as he lavishes care on your churning nuts. Finally, just as you're about to beg him to take your cock into his mouth, he abandons your balls, allowing the head of your cock to slip past saliva-slickened lips and welcoming it into slick, heavenly depths. Well-trained and eager, he doesn't gag, even when his efforts earn a bucking thrust into his throat. The two of you settle into a gentle, wet rhythm, slathering your shaft in slickness, and before long, you grip his hair, speeding your thrusts and making him grope your ass for support, his sucking mouth adding a sloppy, echoing refrain to your eager grunts. Succulent moments pass, and you feel like you're about to finish, so you grip his head with both hands, pumping your balls against his chin with wild abandon and lingering at the edge, your face screwing up in concentration.";
				WaitLineBreak;
				say "     What finally brings you over the edge is a sneaky finger between your cheeks, rolling against the rim of your hole, then diving in, finding your prostate, and pressing it like a buzzer in a game show. Your eyes cross as you fire one shot, then two, then several more in quick succession, painting the eagerly swallowing boy's throat until sensitivity forces you to slow your punishing thrusts, leaving your cocktip between foamed, well-fucked lips. Slumping against the wall, you watch Cassian swallow your load without complaint, kissing your softening member as he tends to his needs and licking the sweat beneath your balls as his hand blurs on his cock. There's just something so right about watching him nurse at your sated cock, licking every last drop of cum from it and cleaning your groin with his tongue, and when he shivers through his orgasm, you debate taking him on as your squire. You would enjoy more worship, and you doubt Cassian would complain, judging by the pearly puddle of cum cooling between your feet.";
				NPCSexAftermath Cassian receives "OralCock" from Player;
			else: [female only]
				say "     Cassian pauses as he reaches your feminine lips, almost seeming disappointed in your lack of a penis to worship. Still, he doesn't let that stop him, nuzzling between your thighs and staring up at you as he mouths at your clitoris with soft lips. Your spread legs and hissing breath encourage him, bringing his hands up to cup your ass as his tongue follows your lips from your clit down to your needy entrance, tasting your nectar. The next few moments blur as Cassian's talented mouth works your increasingly slippery sex, trailing over sensitive spots you didn't know you had. It's so good that you can't stop your hips from grinding, smearing your cunt against his face, and leaving his chin wet with your juices. Like a coiled spring between two fingers, your orgasm winds tighter until you clamp your thighs around his face, moaning through your finish and flooding his mouth with fem-cum until it drips onto his toned chest. Cassian prolongs your pleasure, nuzzling into your vagina and caressing your clit with gentle lips as he collects some of your juices, tending to his needs with the slickness to aid him. It isn't until you feel him shiver and moan into your snatch that he pulls back, painting the floor between your feet with his load and looking up at you with a lust-drunk, irresistibly adorable expression.";
		else:
			LineBreak;
			say "     Cassian meets you as soon as you walk into the gloomy room, placing both hands on your [if breast size of Player is 0]masculine [else]soft [end if]chest and massaging it as his lips seek yours, hesitating for a moment at the difference in your mouths' shapes. His tongue is active but slow and dances around yours, showing no end of skill. You can guess what his master was teaching him besides swordplay, and idly you wonder if he's as skilled in (s)laying beasts as he is with his body. Still, it feels nice, and the sensation of his manhood [if Player is male]pressing against your excited shaft [else if Player is female]prodding between your pussy lips without slipping in [end if]isn't bad either, drawing a muffled moan from your lips as your hands lower, taking hold of that muscular, hairless ass and encouraging his gentle grind, admiring his muscles with squeezing fingers. Idly, you wonder if he'd keep this wonderful physique should his species change. Somehow, you don't think anything would be an improvement on soft, supple, pale skin.";
			if Player is male:
				say "     Cassian takes hold of your shaft as your kiss breaks, stroking you slowly and meandering his tongue over your nipples, then lower until it reaches your muscular stomach, pausing to circle your navel before he slips down to his knees. His lips pout in a soft welcome as he contemplates your unfamiliar manhood, but he leans in nonetheless, letting his tongue show you that he's not afraid to try new things. He swipes away pre before trailing it downward, his lips opening to mouth at the base of your shaft. Still stroking you with careful, soft hands, the lad sucks one of your balls into his mouth, polishing it with an eager tongue and breathing deeply of your musk, his pretty grey eyes staring up at you as he lavishes care on your [if Player is InternalBalls]the lips of your slit[else]churning nuts[end if]. Finally, just as you're about to beg him to take your cock into his mouth, he abandons his worshipful tonguing, allowing the head of your cock to slip past saliva-slickened lips and welcoming it into slick, heavenly depths. Well-trained and eager, he doesn't gag, even when his efforts earn a bucking thrust into his throat. The two of you settle into a gentle, wet rhythm, slathering your shaft in slickness, and before long, you grip his hair, speeding your thrusts and making him grope your ass for support, his sucking mouth adding a sloppy, echoing refrain to your eager grunts. Succulent moments pass, and you feel like you're about to finish, so you grip his head with both hands, pumping your balls against his chin with wild abandon and lingering at the edge, your face screwing up in concentration.";
				WaitLineBreak;
				say "     What finally brings you over the edge is a sneaky finger between your cheeks, rolling against the rim of your hole, then diving in, finding your prostate, and pressing it like a buzzer in a game show. Your eyes cross as you fire one shot, then two, then several more in quick succession, painting the eagerly swallowing boy's throat until sensitivity forces you to slow your punishing thrusts, leaving your cocktip between foamed, well-fucked lips. Slumping against the wall, you watch Cassian swallow your load without complaint, kissing your softening member as he tends to his needs and licking the sweat beneath your balls as his hand blurs on his cock. There's just something so right about watching him nurse at your sated cock, licking every last drop of cum from it and cleaning your groin with his tongue, and when he shivers through his orgasm, you debate taking him on as your squire. You would enjoy more worship, and you doubt Cassian would complain, judging by the pearly puddle of cum cooling between your feet. Not bad for someone that only a short while ago called you a 'foul beast.'";
				NPCSexAftermath Cassian receives "OralCock" from Player;
			else:[female only]
				say "     Cassian pauses as he reaches your feminine lips, almost seeming disappointed in your lack of a penis to worship and more than a little worried about the taste of a non-human. Still, he doesn't let that stop him, nuzzling between your thighs and staring up at you as he mouths at your clitoris with soft lips. Your spread legs and hissing breath as he tastes your inhuman cunt encourage him, bringing his hands up to cup your ass as his tongue follows your lips from your clit down to your needy entrance, tasting your nectar. Despite his qualms about your species, he certainly isn't complaining now! The next few moments blur as Cassian's talented mouth works your increasingly slippery sex, trailing over sensitive spots you didn't know you had. It's so good that you can't stop your hips from grinding, smearing your cunt against his face, and leaving his chin wet with your juices. Like a coiled spring between two fingers, your orgasm winds tighter until you clamp your thighs around his face, moaning through your finish and flooding his mouth with fem-cum until it drips onto his toned chest. Cassian prolongs your pleasure, nuzzling into your vagina and caressing your clit with gentle lips as he collects some of your juices, tending to his needs with the slickness to aid him. It isn't until you feel him shiver and moan into your snatch that he pulls back, painting the floor between your feet with his load and looking up at you with a lust-drunk, irresistibly adorable expression.";
		say "     You spend a few moments doting on Cassian, rolling your finger over his lips to guide stray flecks of sexual fluids and spit to his tongue and caressing his cheek as he swallows dutifully. Neither of you needs to speak, and eventually, you gather your clothes and pull him into a kiss that tastes just like your cum, then leave him to recover after giving him the library's location. You know he probably won't come to stay, but it's only fair that he knows where you live in case of an emergency.";
	else:
		LineBreak;
		say "     As Cassian stares at you expectantly, as though inviting you into the store, you rub the back of your head, then sigh. Maybe it's better to rip the bandage off. Before he can speak, you tell him that, while you're sure he'd give you a fun time, you didn't help him for a reward- you aren't interested in something like that. You'd prefer to leave things friendly and wish him well. Cassian blinks at your confession, his expression unsure and slightly hurt before it returns to normal. 'Ah. Right. Sorry for being presumptuous. I should remember that not everyone is as demanding as my master once was, nor as interested in bonding through pleasure. Perhaps we'll see each other again? I'm not sure where I'll be or if I'll continue pursuing knighthood, but the city isn't so vast.' As you say your goodbyes, you get the feeling that you may not see him again, nevertheless. Hopefully, he finds a master worth his devotion.";

Cassian ends here.