Doctor Mouse by Voidsnaps begins here.

Section 1 - Transplants from Hospital file

DrMouseSlutTest is an action applying to nothing.
understand "zDrMouseSlutTest" as DrMouseSlutTest.

check DrMouseSlutTest:
	if debugactive is 0:
		say "You aren't currently debugging.";
		stop the action;

carry out DrMouseSlutTest:
	Choose a blank row from Table of StoredSluts;
	now name entry is "Doctor Mouse";
	now PaymentType entry is 2;
	now WhoredOut entry is false;
	now Resistant entry is true;
	now Constraints entry is true;
	now Sluttyness entry is 1; [resistant]
	now ProgressPercentage entry is 0;
	now SexCount entry is 0;

[Winning against Doctor Mouse]
to say hospvictory:
	say "     The monstrous Dr. Mouse has been dazed by your final blow and has collapsed against a worktable at the far end of the room. He's overturned the nearby water dish and broken the chemical toilet. As the pair of mismatched chimera poke their heads around behind it, having hidden during the fight, you realize just where he's landed.";
	say "     They scramble over to him, moaning softly with sexual need, their hard cocks and dripping pussies leaking their fluids onto him. One presses its breast to his lips and the addled doctor nurses from it, making the chimera coo happily. The other grabs the doctor's cock and sinks itself down onto it, spurting cum onto his chest as it does.";
	if "PlayerInterested" is listed in Traits of Mortimer:
		say "     Do you want to leave Doctor Mouse to his fate or keep him for yourself?";
		say "     [link](Y)[as]y[end link] - Let the chimeras have him.";
		say "     [link](N)[as]n[end link] - Take him as your slut.";
		if Player consents: [original path]
			say "[DoctorMouseChimeraTaken]";
		else: [Slut Storage Mouse]
			say "     Tugging the rambunctious chimera from its penile prize, you shoo it away from Doctor Mouse, taking a moment to survey the sight of his defenseless body. His features are still in flux, pulsating slightly from the introduction of his nanite cocktail and a fresh dose of chimera fluids dripping from his cock. Labcoat in tatters, he's swollen to a brutish size, with a long mane and two forward-curving horns inches away from his rounded rodent ears. It would be a shame to waste such a handsome appearance in favor of something randomized. Looking around, you search for the spot where the former mouse grabbed his brutish formula, smirking as you find a second identical vial. What are the odds it's anything different than his 'secret weapon?' Shrugging, you decide to try it out anyway. Taking hold of the semi-conscious former mouse's left horn, you tug him upward to his knees, forcing the vial between his lips and stating that if he doesn't want you to kick his ass again, he'll drink. As the hybrid sheepishly chugs his [']medicine['], you nod your approval, watching his vibrating form clarify and his fur standing on end. It seems your gamble was right, even though the creature's expression is even foggier, and his cock spits to the floor below, denied and untouched. If you didn't have a goal, you would play with his body, but you assume it's better to get him to Mortimer's establishment before he comes to.";
			say "[DrMouseSlutStorage]";
	else:
		say "[DoctorMouseChimeraTaken]";
	wait for any key;
	now HP of Doctor Mouse is 2;
	now Locked stairwell is locked;
	now hospquest is 13;
	if mattcollection is 0: [Player did not finish bringing Dr. Matt all the samples before kicking off the fight with Dr. Mouse]
		now mattcollection is 2; [incomplete sample handin, no further samples available]
	increase the score by 50;
	if HP of Doctor Matt is not 100:
		now Player is in Primary Lab;
	else:
		move Player to Grey Abbey Library;

to say DoctorMouseChimeraTaken:
	WaitLineBreak;
	if HP of Doctor Matt is 100:
		say "     Feeling that the doctor is in good hands, you quickly look around the room, gathering any notes and samples you can find from the doctor's work area into one big pile. Worried that someone may notice the commotion and come up to investigate, you don't take any time to look at the stuff. You toss the contents from the doctor's storage case onto the heap. After tearing open his notebook and breaking his laptop, you add them to it.";
		say "     Reluctant to set a fire that could spread and take out the whole hospital, you instead pour a variety of chemicals onto the accumulated research. Thankfully there are several strong acids used for testing which do an effective job of destroying the material. Having seen what this twisted work has created, you don't want to leave someone else finding it and restarting it, nor do you know anyone you could trust with it. That done, you turn back to check in on the mad doctor and his mismatched lovers.";
	else:
		say "     Feeling that the doctor is in good hands, you quickly look around the room, grabbing what notes and samples you can from the doctor's work area. Worried that someone may notice the commotion and come up to investigate, you rush to find as much as you can carry. You take several interesting vials and concoctions from the storage case, carefully stowing them in some padding. The doctor's laptop and research notebook go in there as well.";
		say "     Having gathered what you could and breaking or spilling chemicals onto the other stuff to keep anyone from following Dr. Mouse's research, you turn back to see take another look at the mad doctor and his mismatched lovers.";
	WaitLineBreak;
	say "     The chimeras have continued to feed and fuck him, resulting in a seemingly random array of changes to his body starting to arise. His head has lost its mouse-like qualities entirely and becomes leonine. While his right arm becomes that of some kind of lizard, his left one bifurcates into a pair of smaller limbs, one an avian wing and the other a monkey's arm. One leg gains a horse's hoof while the other has a goat's. His tail becomes long and serpentine, covered in red scales.";
	say "     When breasts start to form on what was once the mouse's chest, the chimera riding him pulls off his cock, which is now wholly canine in form, and drives its cock into the new pussy under his balls. That is enough to stir Dr. Mouse to wakefulness, but what little intelligence there is in those eyes is fading rapidly as the infection takes over fully. The new herm moans lustfully and wraps her mismatched legs around the chimera's waist, yowling with mindless need.";
	say "     The second hybrid pulls its breast from their captive's muzzle and replaces it with its cock instead. The ex-mouse takes it into its mouth eagerly, licking and sucking with need. As the new hybrid continues to be mated by the fractured creatures of its own creation, there is nothing but lust in those vacant eyes as she succumbs fully.";
	WaitLineBreak;
	say "     Satisfied that the mouse is no longer a threat, you step over to the worktable and break off the anchor points for the chains. The trio, too engrossed in sex, don't react more than looking up at you and mewling enticingly for you to join them. Now freed, you are satisfied that the two unfortunate creatures will not be trapped to starve, and that they and their new companion can instead join the others like them in the hospital, where the doctor will never be heard from again.";
	say "     Your task done, you decide to linger no longer and quickly go down the stairs. Acting as if nothing is amiss, you walk past the jaguar guarding the stairwell and exit the hospital.";
	WaitLineBreak;
	now the Player is in City Hospital;
	if hospquest is 10:		[Refused upon offer]
		say "     Outside, you find the pink raccoon waiting for you fretfully on the steps. Seeing you come out alive and well, he dashes into your arms and hugs you tightly. Not wanting to cause a scene, you whisper to him to be quiet and come with you. He takes your hand in his, prancing happily beside you.";
		if pink raccoon is tamed:
			say "     You go down a side street with him and duck into a vacant building to collect your thoughts safely away from the hospital. The pink coon cuddles up to you, vacant eyes looking up at you with admiration, somehow knowing that you've dealt with the mouse that filled him with such fear. You pet his ears and he churrs softly[if HP of Doctor Matt is not 100]. You know that you need to go see Dr. Matt right away, wanting to turn over the research material to him before doing anything else[else]. Now without scientific help, you wonder what to do next[end if].";
		else:
			say "     You go down a side street with him and duck into a vacant building to collect your thoughts safely away from the hospital. The pink coon cuddles up to you, thanking you again for helping to get him out of there. While he doesn't say anything about it, he looks at you with considerable admiration, somehow knowing that you've dealt with the mouse that filled him with such fear. As he starts to fret about where he can now go, you decide, on impulse to tell him about the bunker under the abbey library and give him directions[if HP of Doctor Matt is not 100]. You know that you need to go see Dr. Matt right away, wanting to turn over the research material to him before doing anything else[else]. Now without scientific help, you wonder what to do next[end if].";
	else:
		say "     Outside, you go down the steps and walk across the large parking lot quietly but quickly. You try not to draw attention to yourself, but want to flee the area as soon as possible, lest the events upstairs are discovered sooner rather than later. As you walk off down a side street, you [if HP of Doctor Matt is not 100]know that you need to go see Dr. Matt right away, wanting to turn over the research material to him before doing anything else[else]wonder what to do next now that you are without scientific help[end if].";


Section 2 - Slut Storage

to say DrMouseSlutStorage:
	WaitLineBreak;
	say "     As the hybrid sheepishly chugs his 'medicine, fixing you with a stare that could kill, you nod your approval, watching his vibrating form clarify and his fur standing on end. It seems your gamble was right, even though the creature's expression is even foggier, and his cock spits to the floor below, denied and untouched. If you didn't have a goal, you would play with his body, but you assume it's better to get him to Mortimer's establishment before he comes to. Unfortunately, it's far too unwieldy for you to carry or drag him, but thankfully, the hybrid monstrosity once known as Dr. Mouse is as quiet as his namesake on the way to his new home, surprising you with his willingness to follow your orders. With paws bound in strips of his shredded lab coat, he placidly walks behind you, his gait shaking the ground slightly and his naked body bare for all to see. His hateful stare seems to bore a hole in the back of your head as you pass through the rows of filled storage containers, and just before you flag down one of Mortimer's many clones, you catch him muttering under his breath in a deep baritone at odds with his overly verbose speaking style. Before you can correct the soon-to-be slut's attitude, a well-timed slimy hello catches your attention.";
	say "     'I see you've been busy.' Mortimer looks over your trophy mouse as though inspecting livestock. 'Certainly larger than most. Might I suggest something more heavy-duty to contain this, erm, sturdy gentleman?' Circling the hybrid mouse, he motions several of his clones over, whispering in one's ear and grinning that wide, slightly unnerving businessman's smile. 'In fact, I insist! I won't be liable if this slab of muscle breaks free in your absence! I'll 'extract my fee.' at your earliest convenience. Or, you can cough up five chits next time!' You can see the slime's point. Who knows what the villain would do if given the chance? Doctor Mouse's new body would give him more than enough opportunities for mischief, and you doubt that Doctor Matt or your library would be safe! Sheepishly, you ponder what you want to do.";
	say "     Will you let Mortimer milk Doctor Mouse? Or would you prefer to pay another way and keep him to yourself?";
	say "     [link](Y)[as]y[end link] - Allow Doctor Mouse to be milked for the price of his bondage";
	say "     [link](N)[as]n[end link] - Pay with other methods. The mouse is yours.";
	if Player consents:
		say "     Nodding, you state that you're okay with Mortimer milking his payment out of your new toy. After all, it'll only reinforce his role! Chatting with the slimy caretaker, you decide how the hybrid should be stored, mulling over a few decisions before settling on heavy-duty chains and a ceiling fixture to bind him properly. 'Excellent! Leave him in our hands, and we'll have him ready for you in a few hours, tops!' Mortimer surrounds Doctor Mouse with clones and forces him into a nearby unit as one of them flashes you a thumbs up. With nothing else to see until he's settled in, you return to the library and remind yourself to return in a few hours.";
		Choose a blank row from Table of StoredSluts;
		now name entry is "Doctor Mouse";
		now PaymentType entry is 2;
		now WhoredOut entry is false;
		now Resistant entry is true;
		now Constraints entry is true;
		now Sluttyness entry is 1; [resistant]
		now ProgressPercentage entry is 0;
		now SexCount entry is 0;
	else:
		say "     Shaking your head, you state that you're not okay with Mortimer milking his payment out of your new toy. After all, he belongs to you! With that out of the way, you chat with the slimy caretaker, deciding how the hybrid should be stored, mulling over a few decisions before settling on heavy-duty chains and a ceiling fixture to bind him properly. 'Excellent! Leave him in our hands, and we'll have him ready for you in a few hours, tops! You can bring your payment by when you visit him next.' Mortimer surrounds Doctor Mouse with clones and forces him into a nearby unit as one of them flashes you a thumbs up. With nothing else to see until he's settled in, you ready yourself to leave.";
		now energy of DrMouse is turns;
		Choose a blank row from Table of StoredSluts;
		now name entry is "Doctor Mouse";
		now PaymentType entry is 1;
		now WhoredOut entry is false;
		now Resistant entry is true;
		now Constraints entry is true;
		now Sluttyness entry is 1; [resistant]
		now ProgressPercentage entry is 0;
		now SexCount entry is 0;
		say "     Now that you think about it, you should also set some ground rules on how you pay for Dr. Mouse's confinement. Do you want Mortimer to milk Doctor Mouse at all? Before you leave, you should tell him your preference!";
		say "     [link](Y)[as]y[end link] - Allow Mortimer to milk Doctor Mouse weekly.";
		say "     [link](N)[as]n[end link] - Pay normally.";
		if Player consents:
			now PaymentType entry is 2;
			say "     You don't mind Mortimer taking a weekly fee from the captive mouse-hybrid, despite your misgivings about a larger payment. He seems professional enough that he won't ruin your plans! You tell him so, then chat about the specifics, ensuring that your soon-to-be-slut will be properly cared for. With your mind at ease, you ready yourself to leave, making a mental note to return after a few hours have passed.";
		else:
			say "     You want Mortimer to take care of Doctor Mouse, but under no circumstances do you want him to 'milk' your property, and you tell him so. The slime reassures you, and you spend a few moments talking specifics, then ready yourself to leave, making a mental note to return with payment in a few hours, once he's settled in.";
	now Doctor Mouse is nowhere;
	move Player to Grey Abbey Library;
	add "Doctor Mouse" to StoredSluts_Other;


Section 3 - Character Declaration

[Changed version of him. Reference Hospital.i7x for the pre-slut storage version]
Table of GameCharacterIDs (continued)
object	name
DrMouse	"Dr. Mouse"

DrMouse is a man.
ScaleValue of DrMouse is 3. [human sized]
Body Weight of DrMouse is 5. [scale of 1-9 for body weight, grouped into low weight (1-3), mid weight (4-6) and high weight (7-9)]
Body Definition of DrMouse is 6. [scale of 1-9 for body definition, grouped into low muscle (1-3), mid muscle (4-6), high muscle (7-9)]
[Body Adjective is generated out of the body weight and body definition and can be used in scenes - one word descriptive adjective depending on weight and definition groups: low weight group: skinny/slender/lithe; mid weight group: average/fit/muscled; high weight group: pudgy/husky/jacked]
Androginity of DrMouse is 2. [Gender Adjective is generated out of androginity 1-9: hypermasculine/masculine/somewhat effeminate/effeminate/androgynous/feminine butch/tomboyish/feminine/hyperfeminine]
Mouth Length of DrMouse is 6. [inches deep for face fucking; maximum possible will be double this number (when deep throating)]
Mouth Circumference of DrMouse is 3. [mouth circumference 1-5, "tiny, small, normal, wide, gaping"]
Tongue Length of DrMouse is 4. [length in inches]
Breast Size of DrMouse is 0. [cup size as number, counting Flat Pecs = 0, A = 1, B = 2, ...]
Nipple Count of DrMouse is 2. [count of nipples]
Asshole Depth of DrMouse is 12. [inches deep for anal fucking]
Asshole Tightness of DrMouse is 3. [asshole tightness 1-5, "extremely tight, tight, receptive, open, gaping"]
Cock Count of DrMouse is 1. [number of cocks]
Cock Girth of DrMouse is 4. [thickness 1-5, thin/slender/average/thick/monstrous]
Cock Length of DrMouse is 12. [length in inches]
Ball Count of DrMouse is 2. [allowed numbers: 1 (uniball), 2 or 4]
Ball Size of DrMouse is 3. [size of balls 1-7: "acorn-sized", "dove egg-sized", "chicken egg-sized" "goose-egg sized", "ostrich-egg sized", "basketball-sized", "beachball-sized"]
Cunt Count of DrMouse is 0. [number of cunts]
Cunt Depth of DrMouse is 0. [penetrable length in inches; some minor stretching allowed, or more with Twisted Capacity]
Cunt Tightness of DrMouse is 0. [size 1-5, generates adjectives of extremely tight/tight/receptive/open/gaping]
Clit Size of DrMouse is 0. [size 1-5, very small/small/average/large/very large]
[Basic Interaction states as of game start]
PlayerMet of DrMouse is false.
PlayerRomanced of DrMouse is false.
PlayerFriended of DrMouse is false.
PlayerControlled of DrMouse is false.
PlayerFucked of DrMouse is false.
OralVirgin of DrMouse is false.
Virgin of DrMouse is false.
AnalVirgin of DrMouse is false.
PenileVirgin of DrMouse is false.
SexuallyExperienced of DrMouse is true.
TwistedCapacity of DrMouse is false. [Twisted Characters can take any penetration, no matter the size]
Sterile of DrMouse is true. [steriles can't knock people up]
MainInfection of DrMouse is "Albino Mouse".
Description of DrMouse is "[DrMouseChimeradesc]".
Conversation of DrMouse is { "<This is nothing but a placeholder!>" }.
The scent of DrMouse is "     He smells masculine, with a strange mix of scents that makes it impossible to nail down his species. If you were to describe him in one word, you think 'musky' would be the most applicable.".
Energy of DrMouse is 2500.

to say DrMouseChimeradesc:
	say "     Standing at the upper limit of a regular human's height, roughly seven feet tall, Doctor Mouse is significantly larger than his original size. Muscles bulge from all of his extremities, and a handsome square jaw framed by horns stares down at you. His species is hard to pinpoint, with the horns of a ram, a mane like a lion, and various other bits and bobs borrowed from other creatures all patchworked together into what can only be described as an anthro chimera.";
	if "Boyfriend" is listed in Traits of DrMouse:
		say "     His expression as he stares at you softens, and you catch him looking at you like a lost puppy. There's no doubt he's your boyfriend now.";
	else if "Bodyguard" is listed in Traits of DrMouse:
		say "     His expression hardens as you look at him, and he scoffs at your attention before returning to a lookout position, but you can't help but notice the twitch below the belt, as though he's remembering all the times you've taken advantage of your employee/boss relationship. There's no doubt that he enjoys your little arrangement as much as you do.";

instead of conversing DrMouse:
	say "[MouseTalkMenu]";

instead of fucking DrMouse:
	say "[Mouse_Pet_Fuck_Menu]";

to say MouseTalkMenu:
	say "     Tapping Doctor Mouse on the shoulder, you get his attention, ready to ask him a question.";
	now sextablerun is 0;
	blank out the whole of table of fucking options;
	[]
	choose a blank row in table of fucking options;
	now title entry is "Ask how he's feeling";
	now sortorder entry is 1;
	now description entry is "Ask the hunky chimera how he's feeling?";
	[]
	sort the table of fucking options in sortorder order;
	repeat with y running from 1 to number of filled rows in table of fucking options:
		choose row y from the table of fucking options;
		say "[link][y] - [title entry][as][y][end link][line break]";
	say "[link]0 - Nevermind[as]0[end link][line break]";
	while sextablerun is 0:
		say "Pick the corresponding number> [run paragraph on]";
		get a number;
		if calcnumber > 0 and calcnumber <= the number of filled rows in table of fucking options:
			now current menu selection is calcnumber;
			choose row calcnumber in table of fucking options;
			say "[title entry]: [description entry]?";
			if Player consents:
				let nam be title entry;
				now sextablerun is 1;
				if (nam is "Ask how he's feeling"):
					say "[DrMouseTalk]";
				wait for any key;
		else if calcnumber is 0:
			now sextablerun is 1;
			say "     You step back from the chimera and shake your head, deciding on a different course of action.";
			wait for any key;
		else:
			say "Invalid Option. Pick between 1 and [the number of filled rows in the table of fucking options] or 0 to exit.";
	clear the screen and hyperlink list;

To say DrMouseTalk:
	say "     Asking the chimera hunk how he's been feeling since he woke up in the storage room the other day, you express that you're worried he's been feeling strange. Of course, you don't admit that you're worried whether his brainwashing has stuck, but you're still searching for signs of the old, over the top villain you bested.";
	if "Boyfriend" is listed in Traits of DrMouse:
		say "     [one of]'You know, now that you mention it, I can't remember anything about our first date.' Shaking his head with a sad look on his face, Doctor Mouse sighs as he speaks. 'I hope I don't become one of those sitcom boyfriends that forgets our anni-' With a sudden horrified look, he trails off, counting something on his fingers. You don't have the heart to press the issue further, but you're happy enough with how much his new personality has stuck.[or]'You know, I can't remember what attacked us. It must have been something big if it made me forget.' Shrugging, Doctor Mouse looks you over. 'Now that you mention it, whatever it was might have hurt you. Hopefully I kicked its ass.' You don't have the heart to tell him the truth, so you assure him that he fought off your attacker like a real hero, chuckling at the way he puffs out his chest.[at random]";
	else if "Bodyguard" is listed in Traits of DrMouse:
		say "     'Does it matter?' Doctor Mouse says with a shrug, cracking his neck like an action movie star attempting to look tough. 'I can't remember shit, but I'm sure I beat his ass. Wouldn't still be here if I didn't.' You're a bit exasperated at his bravado, but at least he seems to be adjusting well to his new personality. Maybe with time he'll become a bit less grating, but at least he's a hell of a fuck.";

to say Mouse_StorageVisit:
	choose a row with name of "Doctor Mouse" in the Table of StoredSluts;
	if (energy of DrMouse - turns < 1):
		say "     You stop yourself as you remember that you still need to pay Mortimer for Doctor Mouse's 'accommodations ";
		if carried of Storage Chit < 5:
			say "and shake your head sadly as you realize you didn't bring enough to pay the slime. Next time, you'll remember to bring [italic type]five storage chits [roman type]so that you can visit your hulking slut!";
		if carried of Storage Chit > 5:
			say "and present the chits before he can ask for them, eager to be on your way to your prize. You can't wait to see what Mortimer has done to restrain your newest conquest!";
			ItemLoss Storage Chit by 5;
	else:
		say "     After you tell him that you want to visit Doctor Mouse, Mortimer leads you through the expansive storage facility, past countless almost indistinguishable doors. As you move along, you see several more copies of him either working, guiding other customers, and stepping into or out of various units. Given that you just counted [one of]five[or]six[or]seven[or]eight[or]nine[or]ten[or]eleven[at random] duplicates of the guy, you can't help but idly wonder just how many times he's split like that. 'This is it,' the slimy businessman says with a broad smile, indicating a nearby sliding door and coming to a stop before it. As Mortimer starts to rummage around in himself to retrieve the key ring, you have some time to think...";
		if Sluttyness entry is 1:
			say "     'I recommend staying out of range of his legs if he's not locked in. He's not the most polite.' Mortimer says as he unlocks your storage unit and raises the shutter to let you in. Bathed in fluorescent light and nude save for a plain-looking jockstrap Mortimer fitted over his maleness, your scientist-turned-beast awaits you, staring balefully at you and tossing his lion's mane. He's secured to the ceiling by manacles hooked through a chain, and his legs are attached to a spreader bar, pushing his masculinity forward and allowing you to see the dangerous twitch of his tail between his legs, flicking like an annoyed cat's appendage despite its mouse-like appearance. 'I trust you have come to mete out justice?' He taunts, flexing his muscles impotently. 'The conquering hero, holding their morals above all as they attempt to reason with a villainous monster?' The hybrid bares sharpened teeth at you, spitting on the floor at your feet.Pondering the doctor's appearance, you can't help but feel a tingle of satisfaction at bringing him low. He's all bluster now, but his body's clearly on display, and there's a bit of a tremble in his legs from being forced to stay in this position. You could break him and make him your slut, or you could show him what being a good boy will get him.";
			say "     [bold type]How do you want to go about breaking in Doctor Mouse?[roman type][line break]";
			LineBreak;
			let Mouse_Slut_Choices be a list of text;
			add "Make him love you. Overwhelm him with pleasure until he can't live without your touch." to Mouse_Slut_Choices;
			add "Punish him for his evil deeds. Use him as you see fit." to Mouse_Slut_Choices;
			let Mouse_Slut_Choice be what the Player chooses from Mouse_Slut_Choices;
			if Mouse_Slut_Choice is:
				-- "Make him love you. Overwhelm him with pleasure until he can't live without your touch.": [Gentle dom. Softer touch.]
					LineBreak;
					say "     You catch more flies with honey than vinegar, as they always say! With that in mind, you disrobe, leaving your things in a corner far from Doctor Mouse's reach. Crossing the distance between you, you step in close, trailing your hands over shuddering fur and stopping to caress soft, pink nipples peeking from the yellow that overtook his formerly snow-white coat. Pausing to tweak and massage them, you remark that you don't plan to punish the good doctor. The hybrid tries his best to ignore your efforts, eyeing you with contempt shining in his calculating gaze, but his manhood tells another story, filling out to press against your bare stomach and leak through the fabric of his black jockstrap. 'Your attempts at bribery are insulting. Why would I allow myself to participate in such debaucherous drivel?' Despite his protests, it's working, and he's subconsciously pressing his chest into your touch as if begging for more.";
					say "     Slowly, you lower your mouth to the mouse's chest, letting the heat of your breath tease the pebbled mound of his nipple before dragging your tongue along it, delighting in his barely contained moan. You explain that it doesn't matter whether he allows himself to participate- you'll keep it up until he melts, then dive forward, suckling at his muscular pec and rolling your tongue over it in soft circles. It isn't long before the hybrid brute is under your spell, humping forward as his wits fade in favor of desperate need. His jockstrap threatens to rip with the sheer force of his erection, and a river of precum drips from the tip, causing it to cling to the shape of his knotted erection and leaving nothing to the imagination. Still, it isn't enough for you to stop, so you switch sides, weighing his hefty balls in one hand and staring up at him as you lavish care on his lonelier pec.";
					WaitLineBreak;
					say "     'Please.' Comes a gasped statement of sheer pleasure, torn from the hybrid brute's throat along with drool that drips from predatory teeth. It seems he's had enough of your teasing, but the look on his softened face tells you exactly how effective it's been. Gone is the look of contempt, replaced by desperate uncertainty. How sweet. You pat the former mouse's heaving stomach as he tries desperately to hump into your hand, pulling back before he can achieve any friction and grabbing hold of the waistband of his jockstrap. Softly, you tell him that there's one more thing you need out of him if he wants to cum. A promise. Exactly three words might mean nothing to him but will imprint into his mind like a brand. Doctor Mouse's eyes widen as you explain what you want from him, and he visibly struggles with his choices, too engrossed in his cock's pulsing and begging for freedom to think things through. With a cracking voice, he looks away and closes his eyes, shaking his head as if denying the words already leaving his mouth. 'I love you.' He states with a hollow, desperate tone, trailing off into a whimper.";
					say "     Tugging the hulking man's underwear down, you reward his speech with two hands on his pulsing shaft, massaging its slick length with the help of his steady river of pre and squeezing his knot as it grows beneath your palms. He's been such a good boy that you wouldn't feel right keeping him waiting, so you jerk him faster and faster, working the slick juices into a white foam that covers his canine-like shaft in frothy desire. It's easy to tell when he's close- he's willingly humping your hands, and his balls draw up tight against his shaft- but you feel like the doctor could use one more reminder before he gets his treat. Again, you ask him to say the magic words, holding his cock hostage in a gentle but firm grip and feeling his heartbeat race in the rock-hard shaft. It likely almost hurts to be denied when he's this excited, but that only adds to the appeal. Why wouldn't he want to feel good?";
					WaitLineBreak;
					say "     'I love you!' This time the mouse's words seem more sincere, mixed with outright begging and a throaty grumble that vibrates to his dick. It's not quite the most convincing, but you're pleased with the results, so you resume your efforts, aiming his cock between your legs and praising him for his honesty. When Doctor Mouse erupts, you can't help but feel a sense of pride at how worked up you've gotten him. A fountain of jizz slaps your lower stomach hard enough that it almost stings, and each rope that follows clings to your [if Player is male]cock[else if Player is female]pussy mound[else] crotch[end if], bathing it in pure masculinity and heat. He's like a firehose, spurting without end, and his eyes have gone glazed, taken over by his orgasm, while his hips shake uncontrollably, trying desperately to ram his knot into a hole that isn't there.";
					TraitGain "GentleDommed" for DrMouse;
					NPCSexAftermath DrMouse receives "Stroking" from Player;
					say "     You milk your captive hunk for several minutes before his cock slips back into its plush sheath, and you gently clean him off with a towel you find nearby, then redress him, patting him on the ass in a comforting gesture. Promising to return, you caress his bulge one last time, then dress, ignoring your arousal in a show of goodwill. It'll take time to earn your new toy's trust, and for now, the thrill of watching his eyes roam over your partially nude body as his expression flits between confusion and softening hatred, tinged with guilty arousal, gives you hope that you'll break him yet. Perhaps you should try to [italic type]push things further next time. [roman type]For now, however, you have other things to do, so you lock up the storage unit, blowing your hunky fucktoy a kiss that he scoffs at, muttering something about 'Blasted psychological manipulation tactics.' just loud enough for you to hear. He'll be in good hands until your return.";
					now Sluttyness entry is 2;
					now SexCount entry is 1;
				-- "Punish him for his evil deeds. Use him as you see fit.": [Spank him and make him beg to cum]
					LineBreak;
					say "     Screw the soft approach. You won, fair and square, and the mouse's inability to resist following you to the storage site proves Dr. Mouse is your property. So what if he's not willing to admit it? You'll MAKE him admit it! Setting your jaw, you meet the hybrid's defiance with a derisive snort. Taunting him as you circle behind him and tug his tail upward, you tell him that you don't think of yourself as the hero of this story nor of him as the villain. He's just a slut that needs punishment, and you just happen to be willing to provide it. 'Punishment? Hah. Your asinine efforts to intimidate are laughably transparent-' Doctor Mouse starts, trailing off into a yelp as your hand comes down on his exposed ass cheek, setting the muscular man-meat jiggling and causing his rodent tail to curl around your other appendage, trying to escape your grasp. 'Your show of barbarism will not-' He tries to say, interrupted again by the rough crack of your palm over his wriggling rump.";
					say "     Smirking, you taunt the flustered hybrid, pulling on his tail until his legs spread and his ass is upturned, showing off a fearfully twitching pink hole between yellow-furred cheeks. Casually, you remark that he's being a bad boy, trailing your fingers over the stinging flesh your rough treatment left and delighting in his shivering reaction. He should admit that he wants to be touched- maybe you'll relent and let him have a treat! 'Animalistic brute. I shall not fall for your manipulation-' You punish the mouse again for speaking out of turn, raining another set of blows onto his upturned rump with each attempt to sass you, the resounding clap of your hand on furred cheeks echoing around the concrete space. He bites his lip by the time his ass pulses bright red, his cheeks blushing under their fur, and his tail falling limp in your fist.";
					WaitLineBreak;
					say "     Disappointed by how easily the mouse fell under some light discipline, you fondle his balls, tracing your fingers over the bulge of his hardening cock. Remarking that his body knows what it wants far more than he does, you relocate your fingers from his tail to his dangling shaft, forcing him onto his tiptoes and milking fat globs of pre to the floor below. Now, for the next step of your plan. Calmly, you state what you want from the hybrid hunk, focusing your fingerwork around his growing knot. It's easy enough. You want him to say four little words. 'Hedonistic bastard. I won't-' Doctor Mouse trails into a whimper as you stop stroking, squeezing his balls in a warning. Your command wasn't a suggestion. Should he want more than blue-balls and a reddened ass, he should do as you say. You'll even let him cum!";
					say "     The whimpering, overstimulated hunk grows more incoherent by the second, spurred by your rough groping touch on his bare ass and your insistent hand. His eyes glaze over as he nears his edge, and his mouth hangs open, his tongue dripping much like his manhood as it grinds helplessly into your palm, pointed tip weeping. The silent, huffing hulk gives in long before you tire of teasing him, spurred on by another round of cheek-burners. In a squeaking voice at odds with his baritone voice, he manages to form a sentence, hanging his head and staring at the floor. 'I-I'm a bad boy. Please.' He says, adding his begging to the end as if asking for mercy. Redoubling your efforts to get the hulking slut off, you thank him for his honesty, leaning in to kiss one of his churning balls and kneeling to milk him with both hands. When he tenses up, you don't stop, nipping the fuzzy orbs and admiring the silky ropes of masculinity that pour from his tip, painting the ground with musky submission. He did as you asked, so it's only fair that he receives a reward!";
					WaitLineBreak;
					say "     Retrieving a towel that Mortimer so thoughtfully left for you, you clean the hunk's manhood, then tuck it back into his jockstrap, weighing his balls with your fingers and listening to his exhausted panting. You wipe the floor as best you can, then gather your things, patting the former doctor's cheek as he hangs there, too exhausted from his release to speak. Next time, you promise you'll allow him to be a good boy without punishment, but secretly, you hope Doctor Mouse misbehaves. It's so much more fun if he does! For now, however, it's time to go on with your day, leaving Doctor Mouse to think about how much he enjoyed his reward- and punishment.";
					TraitGain "HardDommed" for DrMouse;
					now Sluttyness entry is 2;
					NPCSexAftermath DrMouse receives "Stroking" from Player;
					now SexCount entry is 1;
		else if Sluttyness entry is 2: [Used once. Repeatable for phase 1.]
			if "HardDommed" is listed in Traits of DrMouse:
				say "     After a short walk, Mortimer brings you to the storage unit that houses Doctor Mouse. You thank him for caring for your slut in your absence, then open the door, greeting the freshly cleaned, still-bound man with a hearty hello. You don't hide your intentions this time, setting aside your gear and disrobing before him, then closing the distance between you, tweaking his pecs, groping and massaging the heaving muscle as you ask whether he missed you. 'Your absence was pleasant.' Doctor Mouse huffs, trying his best to ignore the soft sensations you're forcing on him, even though his cock stands at attention, dribbling its desire. At least his dick knows how to show its affection for its master!";
				LineBreak;
				say "     [bold type]Now that you've greeted your hulking fucktoy, what would you like to do with him?[roman type][line break]";
				let Mouse_FuckSlut_Choices be a list of text;
				add "Ride his cock with your ass." to Mouse_FuckSlut_Choices;
				if Player is male:
					add "Fuck his ass." to Mouse_FuckSlut_Choices;
				if Player is female:
					add "Ride his cock with your pussy." to Mouse_FuckSlut_Choices;
				add "Take things to the next level and change his attitude with drugs." to Mouse_FuckSlut_Choices;
				let Mouse_FuckSlut_Choice be what the Player chooses from Mouse_FuckSlut_Choices;
				if Mouse_FuckSlut_Choice is:
					-- "Ride his cock with your ass.":
						LineBreak;
						say "     Tugging down the mouse's jockstrap to his knees, you admire his bouncing cock, nuzzling the tip of its throbbing length and complimenting him on how hard he is for you. Remarking that it must be further proof that he loves you, you swear you see the flow of precum increase, despite the scoffing mouse's reaction. He can deny it all he wants, but his dick loves your attention! Deciding to reward his cock's loyalty, you stand, turning around and carefully nuzzling the massive member between your cheeks until the pointed tip glazes your hole with sticky love. Slowly, you push back, delighting in the confused gasp you wring from your captive even as the heat of his member increases your arousal, sending a spurt of gooey approval drooling from your [if Player is male]excited member [else if Player is female]lonely, empty pussy.[end if][line break]";
						say "     You don't stop until he's nestled deep in your hole, his knot brushing against your entrance and his balls' heat teasing [if Player is not InternalBalls]the back of yours[else if Player is female]your needy lower lips[else if Player is InternalBalls]your genital slit[end if]. Tilting your hips forward, you slip along his length, giving him a show and teasing him, asking how it feels to be a good boy toy. 'I am NOT-' Interrupted with a groan as your ass clenches tight, the hybrid barely resists surging forward as his cock twitches hard, gooey desire painting your guts. '-not yours. I will escape these bonds and make you pay for your insolence.' These seem like empty threats, though, as you look over your shoulder and find his body limp and unresisting as he stares down at your union. That won't do. You're not just trying to get the hybrid off. Doctor Mouse needs to know who he's falling for! With that in mind, you increase your rhythm, accepting every inch into your relaxed, massaging innards and sending his balls slapping against your nethers. Settling into a heavy rhythm, you set his toes curling and his cock squirting its submission into you, grinding your ass against his knot to milk him of every drop.";
						WaitLineBreak;
						say "     Doctor Mouse cums before you do, but you don't bother stopping. Grunting your satisfaction, you milk his oversensitive cock, your efforts growing sloppier and filling the air with sounds reminiscent of stirring pasta. With a devilish grin, you look over your shoulder, delighting in the shameful desire shining on your toy's face. As he starts to squirm, desperate to pull out and save his poor cock from the torture of a slick, tight hole on sensitive flesh, you demand to hear those three little words. If he says what you want, you promise to let his knot inside! 'I won't-' uncertainty fills the grunting baritone voice as you milk him lovingly, nuzzling your ass against his knot and giving him a glimpse of just how well you could take him. 'I'm not-' Trying desperately to avoid saying those magic words, he struggles, drool dripping from his muzzle to your back and his abs heaving with every labored breath. 'Please.' He whimpers, clearly on the edge of another orgasm. That's not what you want to hear. Taunting the mouse hunk, you settle your ass against his lap, stilling yourself just as you're sure he's about to tip over the edge and massaging his churning, cumslicked balls. If he isn't a good boy, you could leave him wanting and return when he's willing to behave.";
						say "     'No. Please, I-' Swallowing hard, Doctor Mouse grumbles under his breath, his extensive vocabulary forgotten in the heat of the moment. 'I love you, okay? Please let me-' He manages to squeeze the words out through clenched teeth, his cock throbbing in time with his words and showing just how much he's enjoying himself, despite his reluctance. Touching yourself to the mouse's masculine voice admitting his desire, you nuzzle yourself backward until you hear a wet slurp and feel his member lock into your hole, panting as you feel a second orgasm filling your stuffed insides until your stomach swells and sloshes. It feels so good that you can't help adding to the mess, joining your toy in orgasm, and leaking satisfaction to the floor below. You hang from the hunk's cock as long as your legs can stand, thanking him for admitting his place and reinforcing his role by slowly milking his cock and clenching rhythmically to milk every drop from him. Sadly, you can't enjoy your reluctant slut forever, so you tug yourself from his knot, releasing a deluge of cum from your overstuffed hole and leaving him to await Mortimer's cleaning services, gathering your gear as he avoids your gaze like a blushing maiden. Once you've reequipped yourself, you caress the mouse's ass, promising you'll be back to reward him again and leaving him to ponder his circumstances, still hard and shivering in the afterglow.";
						NPCSexAftermath Player receives "AssFuck" from DrMouse;
					-- "Fuck his ass.":
						LineBreak;
						say "     Circling to your captive slut's rear, you set aside your gear, admiring the muscled rump beneath his stubbornly tucked tail. It may not be one of the most welcoming asses you've ever seen, but it's appealing! With tight, clenched cheeks that shudder beneath your touch and just enough give for your fingers to have something to hold onto, it piques your cock's interest. How tight will he be until you work him open? 'Unhand me.' Your charge growls as you grab his tail, tugging it upward to reveal the fearfully clenching pink hole between his cheeks. It's adorable that he thinks he can stop you from taking what's yours, but you can't tolerate disobedience.";
						say "     Dragging the captive doctor's tail until it's stretched taut, forcing his hips backward to ease the discomfort, you flop your cock between those cheeks, kissing your tip against his puckered hole. Letting a generous dollop of spit drool down onto the delectable sight, you prod forward, testing his slickess and working him looser, delighting in the heated clench against your tip. You tell him he has no choice- you're going to show him how much you love him. His best chance at getting some enjoyment out of the act is to relax and let you in. 'Fuck you, insolent-' Squeaking through gritted teeth at your penetration, the rodent clamps his inner muscles tight, trying to stop your cock's progression into heated depths. With how crushingly clenched he is, it's nearly impossible, but thankfully your cock is productive enough, leaking a slippery path that lets inch after inch nuzzle into his colon.";
						WaitLineBreak;
						say "     There's no need to hold back your orgasm, and you doubt you could, with his innards threatening to rip your cock off. You work him loose with patient thrusts, and when you feel your balls drawing up, you slip in to the hilt, baptizing his relaxing hole with a thick layer of seed. 'Kindly fuck off. You've ejaculated. Now leave me.' The rodent says as you rest against his back, throbbing deep inside of him and pumping him full of satisfaction. You can't see his face, but his tone holds a bit of embarrassment, as though he wants to deny what happened, and his vocabulary seems just as shaken. Does he enjoy being mated?";
						say "     Reaching around the muscled stud as you test his freshly lubricated insides with tender thrusts that massage his prostate, you're delighted to find his canine cock standing at attention in its cloth prison, bucking eagerly into your palm. Stroking him in time with a slow rhythm, you smirk, asking your slut why he won't admit how good he's feeling. Could it be he's too shy to admit he loves your cock? 'Such base desires are beneath me. I-' The slut rodent starts, only to trail off as you manipulate Doctor Mouse's knot and gently stroke his sweet spot with your renewed erection. 'Unhand me before I-' Moaning aloud, he involuntarily humps your hand, responding to your methodical rhythm as his innards soften, giving you greater freedom of movement to pleasure your hunky bottom. You don't believe him for a second, and you tell him so, using the hybrid's widened stance to pleasure his swollen prostate with gentle but firm pressure and sending trails of cum leaking down his balls with every thrust. You think he likes being your toy; you think he loves his new master and he's too afraid to admit it.";
						WaitLineBreak;
						say "     On your way to a second volley of seed, you stir the slut's innards with a quickening rhythm, until he goes limp before you, squirting into your palm and firing off a submissive mess. Stroking him to prolong his orgasm, you egg him on, congratulating him on finally being honest with himself. It's not long before you join him, filling his softened, well-worn rump with another load, but this time, you pull out, painting him with evidence of his submission and marring yellow fur. Patting your unwilling slut's well-used rump, you promise to return and give him what he secretly desires, delighting in his shudders and staring at the floor, avoiding your gaze. Breaking him shouldn't be difficult, but you're in no hurry. Something is intoxicating about convincing the rodent that he's in love with you, and it's clear its working. For now, though, you gather your gear, leaving Doctor Mouse covered in the evidence of your enjoyment, and leave him to ponder his newfound desire.";
						NPCSexAftermath DrMouse receives "AssFuck" from Player;
					-- "Ride his cock with your pussy.":
						LineBreak;
						say "     Tugging down the mouse's jockstrap to his knees, you admire his bouncing cock, nuzzling the tip of its throbbing length and complimenting him on how hard he is for you. Remarking that it must be further proof that he loves you, you swear you see the flow of precum increase, despite the scoffing mouse's reaction. He can deny it all he wants, but his dick loves your attention! Deciding to reward his cock's loyalty, you stand, turning around and carefully nuzzling the massive member between your cheeks until the pointed tip glazes your pussy with sticky love. Slowly, you push back, delighting in the confused gasp you wring from your captive even as the heat of his member increases your arousal, sending a spurt of gooey approval drooling from your stuffed cunt and lubricating that thick shaft.";
						say "     You don't stop until he's nestled deep in your hole, his knot brushing against your entrance and his balls' heat teasing your throbbing clit. Tilting your hips forward, you slip along his length, giving him a show and teasing him, asking how it feels to be a good boy toy. 'I am NOT-' Interrupted with a groan as your ass clenches tight, the hybrid barely resists surging forward as his cock twitches hard, gooey desire painting your guts. '-not yours. I will escape these bonds and make you pay for your insolence.' These seem like empty threats, though, as you look over your shoulder and find his body limp and unresisting as he stares down at your union. That won't do. You're not just trying to get the hybrid off. Doctor Mouse needs to know who he belongs to! With that in mind, you increase your efforts, rolling your hips to work every inch of his cock and grind his knot against your pussy lips. Settling into a heavy rhythm, you set his toes curling and his cock squirting its submission into you, barely heeding the warning of his impending orgasm and groaning aloud at the heavy squirts of pre against the entrance to your womb.";
						WaitLineBreak;
						say "     Doctor Mouse cums before you do, but you don't bother stopping. Grunting your satisfaction, you milk his oversensitive cock, your efforts growing sloppier and filling the air with sounds reminiscent of stirring pasta as you kiss his fountaining tip against your cervix. With a devilish grin, you look over your shoulder, delighting in the shameful desire to impregnate you shining on your toy's face. As he starts to squirm, desperate to pull out and save his poor cock from the sweet torture of a slick, tight pussy on sensitive flesh, you demand to hear who he belongs to. If he says what you want, you promise to let his knot inside and let him paint your womb! 'I won't-' uncertainty fills the grunting baritone voice as you milk him savagely, slamming your hole against his knot but not quite letting it inside. 'I'm not-' Trying desperately to avoid saying those magic words, he struggles, drool dripping from his muzzle to your back and his abs heaving with every labored breath as his body tells him to give in and become your mate. 'Please.' He whimpers, clearly on the edge of another forced orgasm. That's not what you want to hear. Taunting the mouse hunk, you settle your ass against his lap, stilling yourself just as you're sure he's about to tip over the edge. If he isn't a good boy, you could leave him wanting and return when he's willing to behave. After all, you can get yourself off with a cunt full of mouse spunk without his help. You might even make him watch.";
						say "     'No. Please, I-' Swallowing hard, Doctor Mouse grumbles under his breath, his extensive vocabulary forgotten in the heat of the moment. 'I'm yours. I love you.' He manages to squeeze the words out through clenched teeth, his cock throbbing in time with his words and showing just how much he's enjoying himself, despite his reluctance. Rubbing your pleasure button to the mouse's masculine voice admitting his new place, you grind yourself backward until you hear a wet pop and feel his member lock into your hole, panting as you feel a second orgasm filling your stuffed insides until your womb swells and sloshes with virile seed. It feels so good that you can't help adding to the mess, joining your toy in orgasm, and leaking satisfaction to the floor below. You hang from the hunk's cock as long as your legs can stand, thanking him for admitting his place and reinforcing his role by milking his cock with clamping inner muscles until he softens inside you. Sadly, you can't enjoy your reluctant slut forever, so you tug yourself from his knot, releasing a deluge of cum from your overstuffed hole and leaving him to await Mortimer's cleaning services, gathering your gear as he avoids your gaze. Once you've reequipped yourself, you fondle the mouse's softened caine cock and clean its tip with your mouth, promising you'll be back to use him again and leaving him to ponder his circumstances, still hard and shivering in the afterglow with the memory of your lips on his tip.";
						NPCSexAftermath Player receives "PussyFuck" from DrMouse;
					-- "Take things to the next level and change his attitude with drugs.": [Makes him available as a pet.]
						say "     It seems like your efforts have made some headway in taming the twisted chimera before you, but you can't help but wonder if it's enough. You're tired of his resistance and decide to do something to hurry things along. Forcing his obedience will require something more drastic than anything you've tried! But the question remains: How should you do it? Is there any way to make a genius capable of turning himself into a monster follow your orders without the possibility of betrayal? If you could tame him, you might even be able to use those bulging muscles to fend off mutants, though you'll miss out on the opportunity to mess with his mind further.";
						say "[Doctor_Mouse_Drugging]";
						now Mouse Chimera is tamed;
						TraitGain "Drugged Up" for DrMouse;
			else if "GentleDommed" is listed in Traits of DrMouse:
				say "     After a short walk, Mortimer brings you to the storage unit that houses Doctor Mouse. You thank him for caring for your slut in your absence, then open the door, greeting the freshly cleaned, still-bound man with a smirk and an evil grin. You don't hide your intentions this time, setting aside your gear and disrobing before him, then closing the distance between you, tweaking his pecs hard enough to draw a squeak of pain, groping and digging your nails into the heaving muscle as you ask whether he missed you. 'Your absence was pleasant.' Doctor Mouse huffs, trying his best to ignore the rough sensations you're forcing on him, even though his cock stands at attention, dribbling its desire. At least his dick knows how to show its affection for its master, even if the man it's attached to is being a bit of a brat!";
				let Mouse_FuckSlut_Choices be a list of text;
				add "Make him fuck your ass." to Mouse_FuckSlut_Choices;
				if Player is male:
					add "Pound his ass." to Mouse_FuckSlut_Choices;
				if Player is female:
					add "Make him fuck your pussy." to Mouse_FuckSlut_Choices;
				add "Take things to the next level." to Mouse_FuckSlut_Choices;
				let Mouse_FuckSlut_Choice be what the Player chooses from Mouse_FuckSlut_Choices;
				if Mouse_FuckSlut_Choice is:
					-- "Make him fuck your ass.":
						LineBreak;
						say "     Tugging down the mouse's jockstrap to his knees, you admire his bouncing cock, nuzzling the tip of its throbbing length and complimenting him on how hard he is for you. Remarking that it must be further proof that he loves you, you swear you see the flow of precum increase, despite the scoffing mouse's reaction. He can deny it all he wants, but his dick loves your attention! Deciding to reward his cock's loyalty, you stand, turning around and carefully nuzzling the massive member between your cheeks until the pointed tip glazes your hole with sticky love. Slowly, you push back, delighting in the confused gasp you wring from your captive even as the heat of his member increases your arousal, sending a spurt of gooey approval drooling from your [if Player is male]excited member [else if Player is female]lonely, empty pussy.[end if][line break]";
						say "     You don't stop until he's nestled deep in your hole, his knot brushing against your entrance and his balls' heat teasing [if Player is not InternalBalls]the back of yours[else if Player is female]your needy lower lips[else if Player is InternalBalls]your genital slit[end if]. Tilting your hips forward, you slip along his length, giving him a show and teasing him, asking how it feels to be a good boy toy. 'I am NOT-' Interrupted with a groan as your ass clenches tight, the hybrid barely resists surging forward as his cock twitches hard, gooey desire painting your guts. 'not yours. I will escape these bonds and make you pay for your insolence.' These seem like empty threats, though, as you look over your shoulder and find his body limp and unresisting as he stares down at your union. That won't do. You're not just trying to get the hybrid off. Doctor Mouse needs to know who he belongs to! With that in mind, you increase your rhythm, slamming your hips hard enough to knock the breath out of the unprepared hunk and send his balls slapping against your nethers. Settling into a heavy rhythm, you set his toes curling and his cock squirting its submission into you, barely heeding the warning of his impending orgasm.";
						WaitLineBreak;
						say "     Doctor Mouse cums before you do, but you don't bother stopping. Grunting your satisfaction, you milk his oversensitive cock, your efforts growing sloppier and filling the air with sounds reminiscent of stirring pasta. With a devilish grin, you look over your shoulder, delighting in the shameful desire shining on your toy's face. As he starts to squirm, desperate to pull out and save his poor cock from the torture of a slick, tight hole on sensitive flesh, you demand to hear who he belongs to. If he says what you want, you promise to let his knot inside! 'I won't-' uncertainty fills the grunting baritone voice as you milk him savagely, slamming your hole against his knot but not quite letting it inside. 'I'm not-' Trying desperately to avoid saying those magic words, he struggles, drool dripping from his muzzle to your back and his abs heaving with every labored breath. 'Please.' He whimpers, clearly on the edge of another forced orgasm. That's not what you want to hear. Taunting the mouse hunk, you settle your ass against his lap, stilling yourself just as you're sure he's about to tip over the edge. If he isn't a good boy, you could leave him wanting and return when he's willing to behave.";
						say "     'No. Please, I-' Swallowing hard, Doctor Mouse grumbles under his breath, his extensive vocabulary forgotten in the heat of the moment. 'I'm yours. I'm your fucking slut.' He manages to squeeze the words out through clenched teeth, his cock throbbing in time with his words and showing just how much he's enjoying himself, despite his reluctance. Touching yourself to the mouse's masculine voice admitting his new place, you shove yourself backward until you hear a wet pop and feel his member lock into your hole, panting as you feel a second orgasm filling your stuffed insides until your stomach swells and sloshes. It feels so good that you can't help adding to the mess, joining your toy in orgasm, and leaking satisfaction to the floor below. You hang from the hunk's cock as long as your legs can stand, thanking him for admitting his place and reinforcing his role by mercilessly milking his cock with clamping inner muscles until he squeaks for mercy. Sadly, you can't enjoy your reluctant slut forever, so you tug yourself from his knot, releasing a deluge of cum from your overstuffed hole and leaving him to await Mortimer's cleaning services, gathering your gear as he avoids your gaze. Once you've reequipped yourself, you slap the mouse's ass, promising you'll be back to use him again and leaving him to ponder his circumstances, still hard and shivering in the afterglow.";
						NPCSexAftermath Player receives "AssFuck" from DrMouse;
					-- "Pound his ass.":
						LineBreak;
						say "     Circling to your captive slut's rear, you set aside your gear, admiring the muscled rump beneath his stubbornly tucked tail. It may not be one of the most welcoming asses you've ever seen, but it's appealing! With tight, clenched cheeks that shudder beneath your touch and just enough give for your fingers to have something to hold onto, it piques your cock's interest. How tight must this slut be? 'Unhand me.' Your charge growls as you grab his tail, tugging it upward to reveal the fearfully clenching pink hole between his cheeks. It's adorable that he thinks he can stop you from taking what's yours, but you can't tolerate disobedience.";
						say "     Dragging the captive doctor's tail until it's stretched taut, forcing his hips backward to ease the discomfort, you flop your cock between those cheeks, kissing your tip against his puckered hole. You don't bother to lube him up, instead prodding forward and using your free hand to punish the willful slut's cheek, delighting in the heated clench against your tip. You tell him he has no choice- he'll be fucked, whether he likes it or not. His best chance at getting some enjoyment out of the act is to try to please you. 'Fuck you, insolent-' Squeaking through gritted teeth at your penetration, the rodent clamps his inner muscles tight, trying to stop your cock's progression into heated depths. With how crushingly clenched he is, it's nearly impossible, but thankfully your cock is productive enough, leaking a slippery path that lets inch after inch violate him.";
						WaitLineBreak;
						say "     There's no need to hold back your orgasm, and you doubt you could, with his innards threatening to rip your cock off. You use your toy with wild abandon, humping hard and reveling in his ass's attempts to force you out, and when you feel your balls drawing up, you force yourself to the hilt, baptizing his uncooperative colon with a thick layer of seed. 'Kindly fuck off. You've ejaculated. Now leave me.' The rodent says as you rest against his back, throbbing deep inside of him and pumping him full of satisfaction. You can't see his face, but his tone holds a bit of embarrassment, as though he wants to deny what happened, and his vocabulary seems just as shaken. Does he secretly enjoy being used?";
						say "     Reaching around the muscled stud as you test his freshly lubricated insides, you're delighted to find his canine cock standing at attention in its cloth prison, bucking eagerly into your palm. Stroking him in time with a slow rhythm, you smirk, asking your slut what he's been hiding from you? Could it be he craves punishment? 'Such base desires are beneath me. I-' The slut rodent starts, only to trail off as you manipulate Doctor Mouse's knot and pound forward, crushing his swollen prostate with your renewed erection. 'Unhand me before I-' Moaning aloud, he involuntarily humps your hand, responding to your quickening rhythm as his innards soften, giving you greater freedom of movement. You don't believe him for a second, and you tell him so, mercilessly fucking the hybrid's muscled ass and sending trails of cum leaking down his balls with every thrust. You think he likes being your toy; you think he's only resisting because he wants you to be rough- and you're all too willing to oblige a needy brat.";
						WaitLineBreak;
						say "     On your way to a second volley of seed, you stir the slut's innards with a quickening rhythm, mercilessly pounding his prostate until he goes limp before you, squirting into your palm and firing off a submissive mess. Slapping his upturned ass with your seed-covered hand, you egg him on, congratulating him on finally being honest with himself. It's not long before you join him, filling his softened rump with another load, but this time, you pull out, painting him with evidence of his submission and marring yellow fur. Spanking your unwilling slut's well-used rump, you promise to return and give him what he secretly desires, delighting in his shudders and staring at the floor, avoiding your gaze. Breaking him shouldn't be difficult, but you're in no hurry. Something is intoxicating about raping the former doctor and knowing he'll be here, waiting for you to abuse him. For now, though, you gather your gear, leaving Doctor Mouse covered in the evidence of your enjoyment, and leave him to ponder his punishment.";
						NPCSexAftermath DrMouse receives "AssFuck" from Player;
					-- "Make him fuck your pussy.":
						LineBreak;
						say "     Tugging down the mouse's jockstrap to his knees, you admire his bouncing cock, nuzzling the tip of its throbbing length and complimenting him on how hard he is for you. Remarking that it must be further proof that he loves you, you swear you see the flow of precum increase, despite the scoffing mouse's reaction. He can deny it all he wants, but his dick loves your attention! Deciding to reward his cock's loyalty, you stand, turning around and carefully nuzzling the massive member between your cheeks until the pointed tip glazes your pussy with sticky love. Slowly, you push back, delighting in the confused gasp you wring from your captive even as the heat of his member increases your arousal, sending a spurt of gooey approval drooling from your stuffed cunt and lubricating that thick shaft.";
						say "     You don't stop until he's nestled deep in your hole, his knot brushing against your entrance and his balls' heat teasing your throbbing clit. Tilting your hips forward, you slip along his length, giving him a show and teasing him, asking how it feels to be a good boy toy. 'I am NOT-' Interrupted with a groan as your ass clenches tight, the hybrid barely resists surging forward as his cock twitches hard, gooey desire painting your guts. '-not yours. I will escape these bonds and make you pay for your insolence.' These seem like empty threats, though, as you look over your shoulder and find his body limp and unresisting as he stares down at your union. That won't do. You're not just trying to get the hybrid off. Doctor Mouse needs to know who he belongs to! With that in mind, you increase your rhythm, slamming your hips hard enough to knock the breath out of the unprepared hunk and send his balls slapping against your clit. Settling into a heavy rhythm, you set his toes curling and his cock squirting its submission into you, barely heeding the warning of his impending orgasm and groaning aloud at the heavy squirts of pre against the entrance to your womb.";
						WaitLineBreak;
						say "     Doctor Mouse cums before you do, but you don't bother stopping. Grunting your satisfaction, you milk his oversensitive cock, your efforts growing sloppier and filling the air with sounds reminiscent of stirring pasta as you slam his fountaining tip against your cervix. With a devilish grin, you look over your shoulder, delighting in the shameful desire to impregnate you shining on your toy's face. As he starts to squirm, desperate to pull out and save his poor cock from the torture of a slick, tight pussy on sensitive flesh, you demand to hear who he belongs to. If he says what you want, you promise to let his knot inside and let him paint your womb! 'I won't-' uncertainty fills the grunting baritone voice as you milk him savagely, slamming your hole against his knot but not quite letting it inside. 'I'm not-' Trying desperately to avoid saying those magic words, he struggles, drool dripping from his muzzle to your back and his abs heaving with every labored breath. 'Please.' He whimpers, clearly on the edge of another forced orgasm. That's not what you want to hear. Taunting the mouse hunk, you settle your ass against his lap, stilling yourself just as you're sure he's about to tip over the edge. If he isn't a good boy, you could leave him wanting and return when he's willing to behave. After all, you can get yourself off with a cunt full of mouse spunk without his help.";
						say "     'No. Please, I-' Swallowing hard, Doctor Mouse grumbles under his breath, his extensive vocabulary forgotten in the heat of the moment. 'I'm yours. I'm your fucking slut.' He manages to squeeze the words out through clenched teeth, his cock throbbing in time with his words and showing just how much he's enjoying himself, despite his reluctance. Rubbing your pleasure button to the mouse's masculine voice admitting his new place, you shove yourself backward until you hear a wet pop and feel his member lock into your hole, panting as you feel a second orgasm filling your stuffed insides until your womb swells and sloshes with virile seed. It feels so good that you can't help adding to the mess, joining your toy in orgasm, and leaking satisfaction to the floor below. You hang from the hunk's cock as long as your legs can stand, thanking him for admitting his place and reinforcing his role by mercilessly milking his cock with clamping inner muscles until he squeaks for mercy. Sadly, you can't enjoy your reluctant slut forever, so you tug yourself from his knot, releasing a deluge of cum from your overstuffed hole and leaving him to await Mortimer's cleaning services, gathering your gear as he avoids your gaze. Once you've reequipped yourself, you slap the mouse's ass, promising you'll be back to use him again and leaving him to ponder his circumstances, still hard and shivering in the afterglow.";
						NPCSexAftermath Player receives "PussyFuck" from DrMouse;
					-- "Take things to the next level.": [become the player's pet]
						say "     It seems like your efforts have made some headway in taming the twisted chimera before you, but you can't help but wonder if it's enough. You're tired of his resistance and decide to do something to hurry things along. Forcing his obedience will require something more drastic than anything you've tried! But the question remains: How should you do it? Is there any way to make a genius capable of turning himself into a monster follow your orders without the possibility of betrayal? If you could tame him, you might even be able to use those bulging muscles to fend off mutants, though you'll miss out on the opportunity to dominate him further.";
						say "[Doctor_Mouse_Drugging]";
						now Mouse Chimera is tamed;
						TraitGain "Drugged Up" for DrMouse;
		else if Sluttyness entry is 3:
			if "Drugged Up" is listed in Traits of DrMouse: [Bypasses player Dom status. Possibly route split here later.]
				if "Boyfriend" is listed in Traits of DrMouse:
					say "     <Placeholder. Not updated as of 4/12/2024. Please see the pet menu for doctor mouse for his sex scenes for now.>";
				else if "Bodyguard" is listed in Traits of DrMouse:
					say "     <Placeholder. Not updated as of 4/12/2024. Please see the pet menu for doctor mouse for his sex scenes for now.>";
			else: [not available yet]
				say "     ";

to say Doctor_Mouse_Drugging:
	say "     Mortimer offered the use of his stores of sex toys and other fun objects. Perhaps you should call him and see if he has anything that helps. Leaving Doctor Mouse behind for now, you step out of the warehouse, flagging down one of Mortimer's many clones. As he flashes you the seediest used-car-salesman grin, at odds with the sticky mop loosely held in one hand, you explain that you want a selection of tools to break in a slut.Mortimer hands off the still-dripping mop to another version of himself, running his fingers along his chin in a thoughtful expression before holding up one finger and flashing a toothy grin. 'I have just the thing. Let me bring you my kit.' Pursing his lips, he whistles, walking off into the sea of storage units.";
	say "     You wait a few minutes, but just as you wonder if Mortimer's forgotten about you, you feel a tap on your shoulder from behind. Whirling, you find a toolbox hastily pressed into your hands, catching a glimpse of a gooey wave before he disappears around the corner, no doubt kept busy by the sheer volume of customers coming and going from the do-it-yourself brothel. Sure that you won't be disappointed by the box's contents, you shrug and re-enter the storage unit, shaking your head at the glare the bound hunk gives you. Hopefully, these things work fast- you might have to punish him if you see that nasty expression any longer. Dumping out the toolbox on a conveniently placed nearby table that smells of citrusy cleaner, you rifle through a set of syringes filled with gaudily colored liquids. Strips of masking tape with writing in permanent marker denote the contents but don't tell you exactly what's in them, leaving you to guess at what sort of concoctions Mortimer came up with. A few seem less usable than the rest, but you narrow it down to 'Aphrodisiac,' 'Control,' and 'Tranquilizer.' You certainly don't want to put your chimera sex slave to sleep, but knocking him out could be a good idea if the others make him rowdy.";
	WaitLineBreak;
	say "     Eyes widen as you take hold of the first syringe, and Doctor Mouse swallows, all his silent hatred melting away into fear. 'Now, let's not be hasty. If submission is what you require, I'm sure I can attempt-' Shutting his mouth at the slow shake of your head, he settles his gaze on the bead of liquid at the tip of the needle. 'I could assist you. You're not a trained medical professional.' Taking hold of one of the protesting man's horns and wrenching his head to the side, you silence him with a soft admonishment. You've allowed him to give himself to you, and he threw the opportunity back in your face. You're not a saint, and you don't have the patience of one. With that said, you push the syringe into his neck, depressing the plunger until all of the liquid drains into his vein. An almost immediate effect comes over Doctor Mouse. Shivering, his eyes narrow to a slit, and his body begins to shake, rattling his bonds until suddenly, he goes still, his eyes glazed over, staring straight ahead. It's as if his soul has drained out of his body, and all that's left is an empty husk. 'Control' was an apt name for whatever drug was in that syringe! You doubt he could fight back even if he wanted to.";
	say "     Shrugging, you grab the other two syringes, throwing caution to the wind and draining them one by one into the unresisting former mouse. It couldn't hurt to have the good Doctor nice and doped up! Who knows what would happen if he broke free of the first drug while otherwise occupied? Tossing aside the used medical supplies, you watch their effect, slowly removing your gear until you stand naked before the slowly panting Doctor. His eyes don't wander even as you stand before him nude, but the stiffening erection between his legs throbs angrily all the same. It's strangely hot to watch him so clearly in need but not attempting to deal with himself, but you have other plans. Confident in your ability to deal with the drugged chimera, you free him from his bonds, letting him sag downward in a stupor. He's unresponsive, almost unblinking, and all trace of the malevolently intelligent Doctor has disappeared in favor of a drooling husk. You could do whatever you like to him, but first, it might be a good idea to see how much the drugs have loosened him up.";
	WaitLineBreak;
	say "     Deciding to start with something easy, you ask Doctor Mouse to lift his head. As expected, he complies immediately, staring at you with unblinking, empty eyes. It's almost creepy how much of him is gone, but as you ask him to do various other things, you realize he's as malleable as you want him to be. Even asking him to move to all fours and bark like a dog doesn't phase him, though his voice cracks at the first woof, and his cock jumps between his spread legs, as though, on some level, he's enjoying the humiliation. Satisfied that Doctor Mouse is properly drugged, you kneel to his level, stroking your chin as you contemplate how to take advantage of him. It wouldn't do to let him access his formidable intellect, and you have more use for a bodyguard, but surely, it can't be as easy as telling him to 'be dumb,' though, perhaps if you're more detailed with your instructions, your words may stick.";
	let DrMouseDrugs be a list of text;
	add "Tell him he's your bodyguard." to DrMouseDrugs;
	add "Tell him he's your boyfriend." to DrMouseDrugs;
	let DrMouseDrug be what the player chooses from DrMouseDrugs;
	if DrMouseDrug is:
		-- "Tell him he's your bodyguard.": [Boss.]
			LineBreak;
			say "     Taking on a more professional air, you snap your fingers for Doctor Mouse's attention. Explaining that you're his boss and he's your bodyguard, you lie out his duties, including pleasuring you whenever you ask. Patting his head, you ask whether he understands, trying to contain your excitement. It would be best not to count your chickens before they hatch. The fog clears from the chimera's eyes within a few moments, and he shakes his head, looking around, then focusing on you. 'Boss? Where are we? What happened?' Like a different person, he does a strange caricature of a bodyguard from a movie, scanning the room and taking on a defensive posture made comical by his dribbling manhood, still rock hard from the aphrodisiac. Patting the former Doctor's cheek, you explain that he's in his new apartment. This place will be where he stays when you don't need him. When you ask whether he's grateful, you have to hold back a laugh at his sudden behavioral change. It's as if he thinks you're paying him to bend to your whims!";
			if Player is purefemale:
				say "     Speaking of your whims, you can't keep your eyes off of the good Doctor's cock, licking your lips and rolling the tip in your palm, smearing precum over it. You coyly mention that he's been ignoring his duties. After all, you've been naked in front of him for at least a few minutes now, and you've yet to have a single orgasm. You might have to find a new bodyguard capable of fulfilling his duties. 'Fuck that.' Huffing, Doctor Mouse takes the bait, darting forward and leaning over you. 'No one else can do it the way you like.' Wrenching your legs apart with an indignant growl, he drags you forward only to bury his face between your thighs, lapping at your cunt without hesitation. You would almost think he's showing dominance if it wasn't for the desperate-to-please gaze staring up at you with every lick.";
				WaitLineBreak;
				say "     Wrapping your legs around heaving shoulders, you guide that hungry maw to your clit, hissing through your teeth as he slathers it in drool. Somehow, he's as good as you say, varying pressure as you grow closer to coating his muzzle in femcum and bringing you to the edge with deep licks that nearly touch your cervix. It's too good to stop him, even as you overflow, giving him plenty to lick up, and as your body coils and tenses, you smother him in wet pussy, taking hold of his horns and nearly humping his face with excitement. Tearing himself away from your death grip, Doctor Mouse awkwardly positions himself, smearing his cock between your pussy lips. You can feel how excited he is, but he looks to you for instructions like a well-trained animal, hotdogging your slit and dueling with your pleasure-buzzer. 'Can I... You know?' He asks with the air of a teenage boy with his first love, his white knuckle grip holding him over you even as his tongue hangs out of his wet muzzle, still stained with your orgasm.";
				say "     A quick nod later, the desperate male sheathes himself inside you, stretching your inner walls in a heavy rhythm that bruises the entrance to your womb. His expression melts into one of pure bliss, his eyes crossing and his fur dripping with sweat as he pounds you into the ground, but it's clear from his angle that he's taking into account your pleasure, tensing every muscle in his body. It's clear that he's already on the edge, but he trembles with the effort of holding back, no doubt worried about offending you. Cresting your finish as wet sounds reverberate through the cramped space, you tease him by clenching your inner walls, feeding into his desperation with murmured taunts. This half-hearted fuck couldn't be his best effort. You're not satisfied. He'd better try harder to earn his 'bonus.'";
				say "     [bold type]Make him pull out, or let him cum inside you?[roman type][line break]";
				say "     [link](Y)[as]y[end link] - Make him cum all over himself.";
				say "     [link](N)[as]n[end link] - Let him breed you.";
				if Player consents:
					LineBreak;
					say "    Right when Doctor Mouse looks like he's going to pop like an overexpanded balloon, you relent, pushing at his flexing chest and slurping your overworked cunt from his rock-hard shaft. With a pleased coo, you pat his cheek, telling him to finish for you, where you can watch. After all, what's better than watching him get off to his subservience? Without complaint, Doctor Mouse takes hold of his cock, his mouth opening in a drooling, slack expression. It's still slick from your combined juices, though the breakneck pace he strokes, his fist could start a fire. Within seconds, his balls draw up, and he falls to the side, off balance, with only one arm to lean on. Unfortunately for him, he erupts at the same time, his dick spasming and letting loose the thickest strand of cum you've ever seen, followed by a litany of arcing ropes that splatter on his fur, marking him with his masculinity.";
					say "     Panting through your pleasure, you finger yourself to the sight, wondering what such a productive load would feel like in your stretched cunt. It's almost enough to trigger another session, but when you attempt to climb onto Doctor Mouse, your legs give out, planting your ass on his softening cock. One arm covering his face, the good Doctor looks up at you with unabashed desire. 'Told you.' Taking a deep breath between pants, he swallows and continues. 'I'm the right man for the job.' His cock seems to agree, belching its last gooey strands onto your ass cheeks, and you can't help but agree. He'll make one hell of a bodyguard with benefits.";
					NPCSexAftermath Player receives "PussyFuck" from DrMouse;
				else:
					LineBreak;
					say "     Unable to resist proper breeding, you don't heed Dr. Mouse's telltale panting, slamming your hips against his to match his vigorous pumps. Clamping your legs against his ass and grabbing hold of his tail, you welcome him into your deepest depths, groaning your pleasure as the first spurt paints the entrance to your womb with enough force to bloat your inner walls. One, two, three, then half a dozen more heavy ropes of chimera cum pump into you before he collapses on top of you, still sheathed to the root. It's several minutes before Dr. Mouse can speak, but he still holds that bit of cocky swagger. 'Told you.' He murmurs as he props himself on shaky hands, his balls firmly pressed against your ass and still flexing in the aftermath of emptying themselves so thoroughly. 'I'm the only man for the job.' Relaxing under the behemoth of a man, you can't help but agree. He'll make one hell of a bodyguard- with benefits.";
					NPCSexAftermath Player receives "Stroking" from DrMouse;
			else if Player is male:
				say "     You can't help but take advantage of the loyal bodyguard in front of you, taking hold of your cock and wagging it with one hand. Still all business, you ask why he hasn't fulfilled his end of your contract. After all, he should take care of you sexually, as well as ensure your safety. At this rate, you might have to find someone else with a stronger sense of duty. Face twisting at your words as though you've insulted his professionalism, the Doctor sneers. 'As if anyone else could please you.' His attention settling between your legs, he grips your thighs in strong paws, spreading them apart as hot breath crests your throbbing shaft. Taking it to the root in his mouth, he stares defiantly up at you as he bobs his head, his tongue savaging the underside and teeth teasing the root. Admittedly, the doctor-turned-bodyguard is one hell of a cocksucker. Holding you in place with an iron grip, he seeks out every sensitive spot with his roaming tongue, slurping the tip on every upstroke and lingering with your shaft buried in his throat whenever his lips meet your base. It wouldn't be hard to lose yourself in that expert blowjob, but you have other ways of testing his loyalty to explore first.";
				WaitLineBreak;
				if Player is dominant:
					say "     With considerable effort, you manage to drag the dutiful chimera's mouth from your now dripping cock, admiring the single-minded fixation those eyes show, never wavering from your erection. Tapping his nose with your cock, you tell your sexy bodyguard to sit on it, patting your lap with your spare hand and sparing him a grin. He should be used to your whims by now, shouldn't he? Almost immediately upon hearing your command, the brainwashed bodyguard turns, lifting his tail to reveal the flexing hole beneath it. Doctor Mouse wastes no time pressing it against your drooling tip, showing none of the reticence you'd expect. Before you have time to amend your command to ask for a bit of mercy, he sits down, swallowing your manhood into clutchingly tight depths with a grunt and nearly crushing your pelvis in his exuberance. Bracing himself against your legs, the colossal slut rams his ass up and down your shaft at a breakneck pace, filling the storage unit with sloppy, wet sounds. His entrance clutches your cock like it's going to tear it off, but his insides are soft like velvet, massaging and milking every inch, and before long, you're weakly rolling your hips upward to meet the ground-shaking ride, grunting your pleasure.";
					say "     Judging by the heavy panting and the quaking behemoth's balls slapping against yours with each downward movement, he's not going to last long, so you give up any pretense of holding yourself back, gripping flexing hips and giving your all to fuck that jiggling, muscly rump. It isn't long before you reach your end, but you let it come, sheathing yourself to the root as your cock fires off thick, sticky approval. The rapacious whore never stops riding for a second of your orgasm, demanding more seed until, with a roar of triumph, he grinds downward, his asshole clamping down. The telltale gooey splat of his orgasm against the far wall shows he enjoyed having his prostate pounded as much as you enjoyed the ride, and as he relaxes backward on his palms, he looks over his shoulder with a cocky grin. 'What was that, boss? Am I behind in my duties? I could always go again.' He punctuates his words with a gooey clench, his well-lubed hole threatening your sensitive cock. Patting that well-stuffed rump, you relent. The former Doctor's done everything you asked for, so of course, you can't complain. You think you'll enjoy having an 'employee' like him.";
					NPCSexAftermath DrMouse receives "AssFuck" from Player;
				else:
					say "     Patting the brainwashed bodyguard's cheek, you encourage him up and off of your shaft before you finish down his throat, turning over and waggling your rump at him. As you show off, you lament that he's forgotten his duties. He's not going to stop at just giving you a blowjob, is he?	Growling and flopping his cock between the offered cheeks, Doctor Mouse presses against your entrance, pushing your head down against the floor as the bloated head pops into you. 'Don't worry. I know just what a bitch like you needs. You want to get fucked hard, don't you? That's why you picked me.' Without an ounce of care, he forces more of his shaft past your entrance, stinging your insides before the copious flow of precum lubes the way.";
					say "     Biting your lower lip, you nod your assent even as he rams himself to the root, assaulting your raised rump with long, heavy thrusts that send his balls careening into yours. He's far from gentle, grabbing your hips and dragging you backward like a human-sized fleshlight, but you can tell he's still holding back. Claws that could rip your flesh remain sheathed, and a grip that could crush bones holds your wriggling body in place without damage. 'I know what a fuckin' slut like you wants.' Hissing through his teeth, Doctor Mouse humps you fast enough that your ass stings from the slap of his hips. 'You want me to fuckin' use your hole. Fill you up. That boss thing is just an act. Greedy whore.' Growing more foulmouthed by the second, he throbs within your violated depths, turning your hole into a sloppy mess with every gush of pre. 'Cum dumps like you are only good for one thing.'";
					WaitLineBreak;
					say "     Slapping your ass, the roughly rutting beast slams to the root, emptying his balls as deep as he can go and shrouding your body with his, letting you feel the difference in your size even as his toothy maw pants against your ear. Your stomach swells with one, two, then a dozen spurts, sloshing with masculine seed. Never once stopping his rough pumping, he brutalizes your prostate until you add a meager contribution to the mess below, clamping down on that rampaging cock. Shivering through your orgasm underneath the spent beastly bodyguard, you pat his paws, telling him he did a good job. If he's like this every time, he'll make one hell of a bodyguard with benefits.";
					NPCSexAftermath Player receives "AssFuck" from DrMouse;
			TraitGain "Bodyguard" for DrMouse;
		-- "Tell him he's your boyfriend.": [Babe.]
			LineBreak;
			say "     Injecting an air of affection into your voice, you squeeze the drugged Doctor's cheeks, draping yourself over him and spreading your legs to let his cock dribble between your thighs. Stroking him softly as you speak, you explain that he's your dutiful boyfriend. You've been together for so long that people around you assume you're a married couple, and he just lost his memory when he fought off a bunch of monsters for you. He should remember you now that he's woken up. Blinking in confusion, the Doctor looks around before focusing on you, his arms slowly encircling your waist. 'Babe? Is that you? How'd we get here?' The lie seems to cement itself in seconds, and he's already quite affectionate, stroking his paws down on your back to cup your ass cheeks. 'Why are we naked? We should be looking-' Quieting the mixed-up man with a kiss, you grind yourself suggestively on his rod, nipping at his lower lip. Explaining that you've found a safe place to stay for now, you ask whether he plans to walk around such a dangerous city with his erection standing so proudly. He might attract more monsters. If he doesn't want to get knocked out again by some sexed up creature, he should let you take care of it first!";
			if Player is purefemale:
				say "     Looking from side to side with his ears flicking slowly, Doctor Mouse acts quite different from his usual malevolently intelligent self. Swallowing nervously, he asks, 'Here? What if someone walks in on us? We could maybe find a hotel or something?' Despite his protests, it seems that the idea of doing things in public has him excited, judging by his bouncing erection slapping against his stomach like an overeager puppy jumping at its owner's face. Climbing up on the bashful man's lap, you let that juicy cock slide along your nether lips, dueling with your clit for a moment before slotting itself against your entrance, kissing pre against your wetness. Coyly, you ask whether it's a problem if someone walks in on you. After all, it's natural for your big, handsome boyfriend to breed you. Wouldn't they be the weird ones for watching?";
				WaitLineBreak;
				say "     'Maybe. Mmph.' Biting his lower lip, Doctor Mouse looks down at your almost-connection, letting out a strangled sound between a growl and a whimper, struggling with hastily configured morales at odds with more pressing desires. He doesn't protest further, instead pressing up into you, slipping inside and sliding to the hilt in one smooth motion that clenches your insides. 'Just a quickie, then.' He grumbles, unable to meet your eyes. Placing your hand on that broad chest, you take the lead, slowly lifting yourself to ride his shaft with deep, grinding strokes. It's fun to tease the blushing behemoth, so you prod at him, asking if he's hoping someone will walk in and see that blushing brute balls deep inside you. After all, you can't remember if you locked the door. It'd be a shame if he had to stop to fight someone off.";
				say "     'Don't think I could if I wanted to. Feels like you'll rip my dick off.' Huffing, Doctor Mouse settles into your rhythm, his hands reaching around to grab your ass cheeks. 'Fuck, babe. You're so wet.' Lolling his tongue out, the former Doctor grinds into every movement, his eyes nearly rolling back in his head. Unable to resist testing the depths of your brainwashing, you quicken your hips, leaning over to meet the former mouse's crossed, over-pleasured gaze. Turning Doctor Mouse's face with one insistent hand, you capture his mouth in a kiss, stirring your connection with insistent motions that juice his sheath and balls with your excitement, filling the space with the deliciously sweet sound of aroused cunt getting what it wants. He's just as eager as you are, taking the lead with the kiss even as his grip tightens and his hips piston, shaking your rhythm into something far more primal and greedy. Bruising your pussy with the sheer weight of the balls slapping against your rump, he stuffs his tongue into your mouth, twirling it expertly around yours and filling your mouth with the exotic taste of chimera spit. You can tell he's not far from his end, and you're not far behind!";
				WaitLineBreak;
				say "     You crest your finish right as you feel the first splash of seed bathing your womb, gripping the convenient horns that wreathe your new boy toy's face as you shiver through it. He's one productive boy, filling you full to bursting until the remainder splashes down his balls to puddle below, but you don't mind the mess, holding him hostage with spasming inner muscles until his cock gives up the ghost, flopping out of you with one last weak dribble. His chest makes a comfortable pillow for you to rest on while you catch your breath, and you can't help but pat yourself on the back for landing such a good 'boyfriend.' Hopefully, the quick brainwashing takes on a more permanent hold with the help of the nanites.";
				NPCSexAftermath Player receives "PussyFuck" from DrMouse;
			else if Player is male:
				if Player is submissive:
					say "     Nuzzling that throbbing shaft between your cheeks, you let it kiss against your clenching hole, enjoying the warmth of the drooling pre that coats it. Turning up your charm, you ask whether your big, strong man will keep you waiting. After all, he's always been there when you wanted him. Is he going to deny you? 'B-But, if someone walks in...' Trailing off, Doctor Mouse bites his lower lip, his hips bucking involuntarily and testing your tightness. The sheer size of his manhood would usually be a problem, though a combination of cooperative nanites and his leaking desire allow him to breach your 'defenses' with little effort. His protest dies in his throat in favor of a rumbling growl as he tastes your inner walls with just the tip, and you feel his paws take hold of your ass.";
					WaitLineBreak;
					say "     Taking advantage of his moment of weakness, you roll your hips to capture the rest of that massive shaft, starting up a slow rhythm that taps your shaft against sculpted abs, mussing his fur. The expression on his face is too priceless to pass up, so you play with his embarrassment, mentioning that you might have forgotten to lock the door. Hopefully, no one decides to peek in on you getting bred by your hunky boyfriend. 'We'd better finish quick, then.' Suddenly all hands, the former Doctor grips your waist, bouncing you on his dick at breakneck speed and brutalizing your prostate. He's got a cocky grin on his face, but judging by the sweat dripping down his fur, he's just as worked up as you are.";
					say "     Chuckling, you match the hunky chimera's movements, following his lead and clamping your inner muscles to tease the bucking shaft buried deep enough inside you that you swear it's tickling your lungs. You'll give him the fast finish he wants! With that in mind, you ride him like an unbroken horse, seizing hands full of fur to use as reins and trying your best to send him over the edge. It doesn't take long- a few minutes at most- before you feel the telltale twitch of orgasm shuddering its way along that hefty meat. The warm bloom of seed accompanies the base of that shaft bloating just inside your stretched hole, and you collapse forward as the blasts of warmth hammer your prostate, wringing pleasure from your poor, untouched cock and messing the man in front of you with streaks of approval. Sated, you relax against his heaving chest, patting it gently and luxuriating in its surprisingly soft fur. If he's like this all the time, he'll make a perfect 'boyfriend!'";
					NPCSexAftermath Player receives "AssFuck" from DrMouse;
				else:
					say "     Pushing Doctor Mouse back against the floor behind him, you forgo his manhood, straddling his chest and bringing him face-to-face with yours instead. Tapping the tip of his nose and grinning at the string of pre that stretches from it to your cock, you interrupt his attempts at protesting with a dramatic sigh. Playing on his new personality and nanite-given backstory, you ask whether he's still the dutiful boyfriend you love so much. If not, you could always find someone willing to help you if he's willing to give you up.'That's not fair.' Grumbling, your captive-turned-boyfriend licks his lips, blatantly sniffing your manhood. 'If someone walks in, we'll be sitting ducks. How do you know this place is safe? Maybe if we went somewhere else?' Despite his protests, he licks away the taste of your masculinity, staring hungrily at it as if begging for you to take the lead.";
					WaitLineBreak;
					say "     Guiding your tip between his lips before he can speak again, you take hold of Doctor Mouse's horns, wiggling your hips to center your cock before taking the plunge into his throat. Teasing the horny man with a heavy rhythm that coats your shaft in drool and vibrates a silenced protest along your cockhead, you lament the fact that he doesn't trust you. You've been together for so long now, he should trust you! Have you ever led him astray before? Unable to meet your gaze, Doctor Mouse slurps your cock to the root, grabbing your ass in both hands and quietly accepting his fate. If you didn't know better, you'd think he was a professional at this, with nary a gag in sight despite your rough rhythm and the embarrassment written across his face. He can pretend he's not into it, but your cock knows better!";
					say "     Deciding to return the favor, you turn around, plapping your balls against the chimera's nose with each thrust as you reach out to take care of his unattended shaft. Matching the rhythm of stroking fingers along every inch, you fuck his face, delighting in the muffled moans that vibrate along your manhood as he starts to buck his hips. That's more like it! It's not long before those muffled sounds reach a crescendo, air blowing from flared nostrils tickling your bruising cum-factories as the pinned hunk struggles and wiggles. Thick, heavy ropes of cum soon grace your fingers, flinging themselves far enough that they reach your cheek, and that heavenly mouth stalls at the base of your cock, throating you in a desperate attempt to beg for your load. It's clear what he wants, even if he can't say it, and you're not about to deny him the experience.";
					WaitLineBreak;
					say "     Any pretext of holding back dies as you fuck that desperately swallowing maw, sending occasional solitary gags down your length and bubbling spit and pre through his nose to mess your balls. It's too good. Within moments, you pin his face between your thighs, resting your cheek on his heaving abs as you unload all your pent-up seed directly into his stomach. Lounging on the well-fucked former captive's body, you slowly stroke his shaft, satisfied with the slightly rough tongue cleaning your manhood. If you'd known he'd make such a great 'boyfriend,' you would have pursued this method earlier!";
					NPCSexAftermath Player receives "OralCock" from DrMouse;
			TraitGain "Boyfriend" for DrMouse;
	say "     (Dr Mouse, the mouse chimera is now a possible ally! You can make him your active ally by typing [bold type][link]ally mouse[end link][roman type] or [bold type][link]ally mouse chimera[end link][roman type] and initiate sex with him while active by typing [bold type][link]fuck mouse[end link][roman type]. You can see all the allies you have with the [bold type][link]allies[end link][roman type] command. Allies will lower the XP you gain from battle, but can gain levels themselves to be more useful in a scrap. Want to get rid of an ally? Use [bold type][link]ally dismiss[end link][roman type], or just [bold type][link]dismiss[end link][roman type])[line break]";
						

DrMouseReset is an action applying to nothing.

understand "zMouseReset" as DrMouseReset.

check DrMouseReset:
	if debugactive is 0:
		say "You aren't currently debugging.";
		stop the action;

carry out DrMouseReset:
	if "GentleDommed" is listed in traits of DrMouse:
		say "     <Dr. Mouse will now switch paths! One path is gentle dom, one is rough dom! Please note: This does not applied to the drugged boyfriend or bodyguard routes.>";
		TraitGain "HardDommed" for DrMouse;
		TraitLoss "GentleDommed" for DrMouse;
	else if "HardDommed" is listed in traits of DrMouse:
		say "     <Dr. Mouse will now switch paths! One path is gentle dom, one is rough dom! Please note: This does not applied to the drugged boyfriend or bodyguard routes.>";
		TraitGain "GentleDommed" for DrMouse;
		TraitLoss "HardDommed" for DrMouse;

DrMouseSluttery is an action applying to nothing.

understand "zMouseSluttery" as DrMouseSluttery.

check DrMouseSluttery:
	if debugactive is 0:
		say "You aren't currently debugging.";
		stop the action;

carry out DrMouseSluttery:
		Choose a blank row from Table of StoredSluts;
		now name entry is "Doctor Mouse";
		now PaymentType entry is 2;
		now Resistant entry is true;
		now Sluttyness entry is 1; [resistant]
		now Doctor Mouse is nowhere;
		add "Doctor Mouse" to StoredSluts_Other;

Section 4 - Turning Dr Mouse into a pet

Table of GameCharacterIDs (continued)
object	name
Mouse Chimera	"Mouse Chimera"

Mouse Chimera is a pet.
NPCObject of Mouse Chimera is DrMouse.
understand "Dr Mouse" as Mouse Chimera.
IDList of Mouse Chimera is { "Dr Mouse", "Dr. Mouse", "Mouse Chimera", "mouse chimera", "dr mouse", "Mouse", "mouse", "Chimera", "chimera" }.
printed name of Mouse Chimera is "Mouse".
Description of Mouse Chimera is "[MouseDesc]".
Weapon Damage of Mouse Chimera is 15.
level of Mouse Chimera is 1.
Dexterity of Mouse Chimera is 15.
summondesc of Mouse Chimera is "[SummonMouse]".
dismissdesc of Mouse Chimera is "[DismissMouse]".
assault of Mouse Chimera is "[one of]Doctor mouse punches with all his might, sending your opponent sprawling![or]Doctor Mouse lowers his head like a ram and headbutts your foe directly in the stomach, knocking the breath out of them![or]Doctor Mouse picks up a heavy piece of nearby debris and chucks it at your enemy, hitting them squarely in the face![at random]".

to say SummonMouse:
	if Player is not booked and Player is not bunkered: [regular calling]
		if "Boyfriend" is listed in Traits of DrMouse:
			say "     Calling out to your hunky chimera boyfriend, you wait for him to come running. As a dutiful boyfriend, it makes sense that he's staying nearby to keep an eye on you, but it warms your heart to see how quickly he appears. You'll have to reward him later!";
		if "Bodyguard" is listed in Traits of DrMouse:
			say "     Calling out to your stalwart chimera bodyguard, you wait for him to appear, suppressing the urge to jump out of your skin when he melts out of a nearby shadow. It's nice to see that he's staying nearby, but you might have to put a bell on him if he doesn't start announcing himself!";
	else: [calling Mouse in the abbey]
		if "Boyfriend" is listed in Traits of DrMouse:
			say "     Moving to the library door to avoid any unfortunate meetups with any residents, you call out to your brainwashed chimera boyfriend, smiling as genuinely as you can when he appears from a nearby storefront and waves. You'll have to reward him for being so dilligent, when you have time!";
		if "Bodyguard" is listed in Traits of DrMouse:
			say "     Moving to the library door and calling out to your stalwart chimera bodyguard as quietly as you can to avoid drawing attention, you wait for him to appear, suppressing the urge to jump out of your skin when he melts out of a nearby shadow like a ninja in a B movie. It's nice to see that he's staying nearby, but you might have to put a bell on him if he doesn't start announcing himself!";
		move DrMouse to Grey Abbey Library;
		move Player to Grey Abbey Library;

to say DismissMouse:
	if Player is not booked and Player is not bunkered: [regular dismiss]
		if "Boyfriend" is listed in Traits of DrMouse:
			say "     Patting your hunky chimera boyfriend on the shoulder, you tell him he should go back to following you at a safe distance for now! You don't need his help right now, but you'll let him know when you do! The expression on his face as he walks away like a kicked puppy is a bit heartbreaking, but you swear to make it up to him later. After all, why would you be cruel to your 'boyfriend?'";
		if "Bodyguard" is listed in Traits of DrMouse:
			say "     Patting your dilligent bodyguard on the shoulder, you tell him that you're not in need of his services right now. He scoffs, but follows your instructions, disappearing from sight in seconds, but you get the feeling he's still keeping watch. Silently, you tell yourself that you need to discuss boundaries with him, but allow him to do as he likes for now.";
	else: [dismissing Mouse in the abbey]
		if "Boyfriend" is listed in Traits of DrMouse:
			say "     Patting your hunky chimera boyfriend on the shoulder, you tell him he should go back to following you at a safe distance for now! You don't need his help right now, but you'll let him know when you do! Then you escort the brainwashed chimera to the library exit. he expression on his face as he walks out sidelike a kicked puppy is a bit heartbreaking, but you swear to make it up to him later. After all, you don't want to cause a scene. Others might find out about your little brainwashing!";
		if "Bodyguard" is listed in Traits of DrMouse:
			say "     Escorting the brainwashed chimera to the libary exit, you pat your dilligent bodyguard on the shoulder, and tell him that you're not in need of his services right now. He shrugs and leaves the abbey without another word, but you get the feeling he's still nearby. You might have to have a discussion about employer-employee boundaries later... Perhaps after you do something more fun with him?";
		move Player to Grey Abbey Library;
	now DrMouse is nowhere;

to say Mouse_Pet_Fuck_Menu:
	if LastFuck of DrMouse - turns < 4:
		say "     Shaking his head before you can ask him for anything, Doctor Mouse holds you at arm's length. 'Listen, I'm usually up for anything, but I need some time. ";
		if "Boyfriend" is listed in Traits of DrMouse:
			say "You're hot as hell, though. Maybe I can watch if you decide to do something about it yourself?' Giving your ass a squeeze, the mixed-species hunk gives you a wink, though he doesn't try anything further, making it clear that if you want a release you'll have to take care of it yourself.";
		else if "Bodyguard" is listed in Traits of DrMouse:
			say "Didn't our contract only call for sex once a day? You planning on paying me overtime?' Grinning cockily, your bodyguard looms over you with a grin, one hand on your ass and the other under your chin. 'I don't come cheap, you know. Don't think you could afford me.' It's clear you're not going to get anything out of the hunky bodyguard for now, so you give up the idea. Maybe he'll be up for it later!";
	else if "Boyfriend" is listed in Traits of DrMouse:
		say "     Calling over your hunky chimera boyfriend, you find a nearby secluded corner and ask if he's up for a little fun. Judging by the instantly semierect cock greeting you from between his legs and his bashful expression, you don't think consent will be a problem, but the question remains:";
		say "      [bold type]What do you want to do with him?[roman type][line break]";
		let Mouse_PetSex_Choices be a list of text;
		add "Ask for oral sex." to Mouse_PetSex_Choices;
		let Mouse_PetSex_Choice be what the Player chooses from Mouse_PetSex_Choices;
		if Mouse_PetSex_Choice is:
			-- "Ask for oral sex.":
				if Player is purefemale:
					say "     Guiding Doctor Mouse down to his knees, you get rid of any obstacles between him and your womanhood, draping one leg over his shoulder. With a teasing smile, you ask him whether he'll help you scratch the itch you've been feeling for a little while now. Of course, if he's too bashful to do this in public, you'll stop and let him walk away. With a strangled sound between a whine and a growl, the mixed-up hunk has already stopped listening, nuzzling between your thighs and gently scraping his feline-like tongue along your slit, tasting your wetness. Digging claws into your thighs to hold you in place, he delves deeper with each lap, like a hungry dog slurping away at something tasty.";
					say "     Sloppy sounds fill the area as your dutiful boyfriend chows down on your most intimate area. You barely hear them, though, trying your best to hold your stance but growing increasingly jelly-legged until you collapse against his face, nearly sitting on his shoulders. It's just so good that you can barely focus on anything but the growing heat between your thighs, and before long, the only thing keeping you in place is an iron grip on his ram's horns. Drawn to the spots that make your breath come in needy pants, that wonderful tongue works you to a lather, flicking away every bit of your juices and cradling your clit on every lap. Crystalline pulses race through your midsection, culminating in a hard clench that feels like your innards are turning themselves into pretzels.";
					say "      You clamp down just as it becomes too much to bear, cumming hard enough that you worry you'll snap your 'boyfriend's' neck with your thighs, but you're too far gone to care, shivering and groaning in bliss before slumping backward. 'Mmph.' The chimera hunk sucks in a breath through a wet, messy muzzle as he pushes his way out of your iron grip. 'Maybe we can do that again. I don't mind the risk of getting caught if it's with you.' Still stroking himself, he reveals that he shared in your moment of pleasure if the puddle beneath his flexing tip is any indication. Maybe next time, you'll let him shove that inside you again, but for now, you shoulder your pack and adjust yourself, still shivering in the aftershocks of orgasm. You've got other things to do!";
					NPCSexAftermath Player receives "OralPussy" from DrMouse;
				else if Player is male:
					if Player is dominant:
						say "     Tossing aside your gear, you take hold of your hardening cock, waggling it at the slightly shy chimera. Asking him if he'll give you some quick head, you stick your tongue out at him, watching his eyes follow every sway of your balls. He wants this as much as you do! 'Maybe just a taste...' Falling under the spell of your cock's swaying, the former Doctor drops to his knees, breathing in a hefty dose of your musk with an appreciative look on his face. For someone so concerned with being caught, the way that he noses into your balls and snorts their scent is delightfully slutty.";
						say "     Taking hold of those convenient horn handlebars, you guide the horny man to your tip, kissing your cockhead between his lips and giving him a wink. Explaining that he's taking too long, you barge through what little resistance is left, occupying his throat in a smooth thrust and silencing him before he can talk himself out of it. Satisfied with the lack of complaints, you test the waters, grinding your balls against his chin until a slight gag draws you back. Not bad. Like a real trooper, Doctor Mouse accepts your speeding thrusts, his eyes crossing as he swallows eagerly, tongue rolling over every inch of your shaft as it barges in. Wet, lewd sounds slurp from below, and you realize he's eagerly masturbating to you using his face. His eagerness is intoxicating, and before you know it, you're slamming home at a pace that would snap a lesser man's neck.";
						say "     Thankfully for you, your cockslut of a boyfriend is quite sturdy, and by the time you feel your orgasm boiling in your stomach, he's taking every inch of you at Mach speed, wet gags messing his nose and chin with bubbling saliva. The imagery is too hot, and before you know it, you're burying yourself to the root, blasting the back of his throat with rope after rope of gooey cream, some of which snorts out of his nose as he swallows. By the time you pull out, you feel as though most of the moisture in your body has fled through your oversensitive cock, barely able to stand on two legs as you let the former Doctor suck in grateful, though cum-tainted, breaths. Patting his head, you thank him for servicing you, but he's too lost in licking up the mess to notice your words, only helping himself to his feet when you shoulder your pack and walk away. It seems he enjoyed himself even more than you did!";
						NPCSexAftermath DrMouse receives "OralCock" from Player;
					if Player is Submissive:
						say "     Shrugging out of your gear, you stroke yourself and wiggle your cock at the increasingly excited hunk, laughing as his eyes follow your fingers. Asking whether he'll help you with your little problem, you wink suggestively and spread your legs, shamelessly using your spare hand to tease your head. 'Fuck. Just this once.' Dropping to his knees, Doctor Mouse wastes no time, kissing over the apex of your cock and taking twin hands full of your ass in greedy paws, his tongue swirling over the underside. He knows what he's doing, despite his dominant attitude, and before long, you're sheathed to the root in that bobbing muzzle, wrapped in wet silk.";
						say "     Greedy groping paws roll your ass cheeks as your dutiful boyfriend slurps away, but soon enough, two mischievous fingers wiggle their way between them. Aided by a quick coating of chimera drool, they jab against your unprepared hole, spreading it and making your legs wobbly. Soft kneading motions find and exploit your prostate, and before long, you're jelly in capable paws, barely able to stand without your desperate grip on his curved horns. 'Mmm.' With his mouth too full to say anything, your dutiful boyfriend still teases you with his greedy expression, winking at you while he expertly milks you toward your finish.";
						say "      It's not long before you reach your limit, shaking as that talented muzzle brings you careening to the edge. Even when you finish, the talented Doctor doesn't release your cock, keeping the first few inches trapped with intense suction even as you let loose, barely holding yourself up with a desperate grip on those makeshift horn handles. Long after the last drops of your orgasm have disappeared down his throat, he releases you, fingers leaving your ass with one final flick against your sensitive spots. Catching your breath, you thank Doctor Mouse for indulging your whims, noticing the mess he made near your feet. It seems he enjoyed your little public rendezvous as much as you did! You'd love to return the favor, but for now, you shoulder your pack and continue, followed by your ever-dutiful chimera companion.";
						NPCSexAftermath DrMouse receives "OralCock" from Player;
	if "Bodyguard" is listed in Traits of DrMouse:
		say "     Finding a secluded spot nearby, you call over your chimera bodyguard. Quick to set aside your gear and stand before him in the nude, you favor the waiting man with a pat on his bare chest, asking whether he's willing to fulfill the conditions of his contract. You're hazy on the details, but you do believe it said something about keeping you satisfied?";
		say "     [bold type]Now that you have the aroused bodyguard's attention, what do you want to ask for?[roman type][line break]";
		let Mouse_PetSex_Choices be a list of text;
		add "Ask for a quickie." to Mouse_PetSex_Choices;
		let Mouse_PetSex_Choice be what the Player chooses from Mouse_PetSex_Choices;
		if Mouse_PetSex_Choice is:
			-- "Ask for a quickie.":
				if Player is purefemale:
					say "     Blatantly fingering your moistening slit, you ask if the doctor-turned-bodyguard is willing to give you a quick and dirty fuck. You don't need anything special- you just want the Doctor to cum inside you before you move on with your day. He won't leave you high and dry when it's his job to satisfy you often and well, will he? 'Oh, is that all you want?' Pulling your hands away from your sex, Doctor Mouse pins them above your head as he speaks, lifting your body until you feel the stinging flop of his erect cock against your needy clit. Sawing his manhood between your lower lips, he tests your wetness with a gentle prod, letting you feel the steel-like hardness of that bucking tip. 'A slut like you should be able to handle me in a rush, right? I'm not holding back.' Punctuating his words with his first punishing thrust, Doctor Mouse slaps his balls against your poor rump, stretching your dripping cunt in a flash and filling every inch of your inner walls with hot flesh. True to his word, there's nothing gentle about his rhythm, bruising your cunt with heavy hips that keep your legs spread around his waist.";
					say "     Pinned against the rutting beast, you can only groan and cling to him for support, feeling the steady pulse of that massive manhood battering your innermost depths and claiming them with juicy squirts of precum. It hurts, but it's so good that you can't help but drool your excitement down his shaft, lubing the way for him to fuck you deep and hard. Who knew that such a crazed creature hid beneath the newly dutiful bodyguard? 'This is what you wanted, right?' Panting in your ear, Doctor Mouse slams you down his length even faster, bullying your cervix with a battering ram of cock. 'Sluts like you just want to be used up and tossed aside. Bet you'll cum when I fill you the fuck up.' Tightening his grip on your captive hands, he grits his teeth, hips moving in a blur that leaves your thighs and ass stinging with the impact of each thrust. Soon enough, true to his word, he cums inside you, never stopping his heavy rhythm even as he stirs your cunt into a creamy crater.";
					say "     The mixture of dirty talk and bludgeoning cock brings you to the edge, and that first splash of cum against your bruised womb sends you over it. Stomach coiling in knots and mouth open in a squeaky cry, you cream that shaft, adding your contribution to the dripping cum below and painting the rutting monster's balls in satisfaction. It's so good that it takes several minutes to come down off your high, but you use the bodyguard's bulging physique to hold yourself up, clutching him as tightly as you can with shaking hands. 'Let me know next time you want it. I know how to earn my pay.' Murmuring in your ear as he lets you down a few moments later, Doctor Mouse slaps your ass for good measure as you gather your gear, giving you a cocky grin as you look back at him. He's settled into the mindset of a crude, warrior-like bodyguard better than you thought he would.";
					NPCSexAftermath Player receives "PussyFuck" from DrMouse;
				else if Player is male:
					if Player is dominant:
						say "     Motioning for Doctor Mouse to turn around, you ask if he'll let you blow off steam. It's part of his contract to let you have some ass whenever you like, right? You promise you'll make sure he enjoys it, too. 'Hmmph. Make it quick.' Quick to drop to all fours, Doctor Mouse lifts his tail up and to the side, exposing his pink hole. The expression on his face reeks of exasperation, but the dripping cock between his thighs betrays how much he enjoys this situation, bouncing with his heartbeat. Taking twin hands full of muscular cheeks, you tease the reluctant slut with the tip of your cock, kissing it against his tight asshole. Musing aloud that for such a big guy, he sure is a buttslut, you swivel your hips to hotdog his cheeks, enjoying the deceptively soft space between them. Satisfied with your foreplay, you spit on your cock, working it past his defenses with slow thrusts to let him feel every inch.";
						say "     'Fuck. Just shut up.' Grumbling, the bodyguard strokes himself in time with your exploring thrusts, his hole softening by the second until you slide right in, kissing the base of your cock against his milking entrance. 'I'm not doing this because I want to.' He groans out, desperate to keep his dignity despite his body's desire for a good fuck. Following Doctor Mouse's suggestion, you stop verbally teasing, instead giving the greedy hole in front of you the attention it deserves. Slamming your hips against his ass in a quickening rhythm, you put the sturdy slut to use, invading his silky insides and marking them with your arousal. You probably won't last long with such a talented hole milking your shaft, but it doesn't matter- You planned to finish quickly anyway.";
						say "     Rutting hard and fast, you careen toward your finish, gripping that thrashing tail and using it as an anchor to drag Doctor Mouse back, sheathing yourself to the root just as you let loose. You swear it feels like his ass is sucking you dry as you pump him to overflowing, and by the time you finish, your balls ache, but you're happy with the result when you flop free of that greedy hole, leaving it gaping and clenching as a trickle of white dribbles down the back of his balls. Saving that image in your spank bank for later, you pat the shaking slut's butt cheek, grinning when you notice the puddle beneath him. It seems he enjoyed himself as much as you did, but it's time to move on!";
						NPCSexAftermath DrMouse receives "AssFuck" from Player;
					if Player is Submissive:
						say "     Stroking that big chimera cock with one hand, you place your other hand on the muscular man's chest, asking whether he's willing to satisfy your needs. After all, it's part of his contract- he needs to please you if he wants to stay employed. Of course, you could always find someone else if he doesn't want to perform. The chimera picks you up in an iron grip with a challenging growl, splitting your legs around his waist and thrusting eagerly between them, penetrating you in one long thrust that leaves your poor ass stinging. 'Yeah, yeah. I know what a slut like you needs. You don't want it sweet and gentle, do you? You want me to use you like a fuckin' fleshlight.' Mouth open and an expression of contempt on his face, the bodyguard works you open with insistent thrusts, using nothing but a steady trickle of pre to lube the way. 'Don't worry, bitch. I'll fill you the fuck up.'";
						say "     Fucked silly in seconds, you can only hold on for dear life, your cock flopping against flexing abs with every thrust and messing them with measly squirts of arousal. He certainly knows how to treat a submissive partner! Every push rams directly into your prostate, and the hands around your waist drive you wild, letting you lose yourself in the sheer joy of being used. You're not sure how long he uses your hole, but by the time you feel the first blast of cum in your poor, bruised ass, you've already finished at least once, painting the space between your sweaty bodies white with approval. Of course, the pressure on your prostate from that heavy cock's orgasmic pulsing milks weak spurts from your softening cock, but you're too far gone to react to the pleasure, clutching at him for dear life and shaking with oversensitivity.";
						say "     'Quick enough for you?' Letting you down, Doctor Mouse wipes his cock off on your lower back, one arm around your shoulder to hold you up. 'I can always speed up next time~.' He teases you, knowing full well that as you gather your gear, you're so well-fucked that you can barely walk. Silently, you make a mental reminder to find out what he means next time as you attempt to pull yourself together. Thankfully, the nanites do their job, and your soreness fades before you have to ask your bodyguard to carry you.";
						NPCSexAftermath Player receives "AssFuck" from DrMouse;

to say MousePetStatus:
	if "Boyfriend" is listed in Traits of DrMouse:
		say "boyfriend ";
	if "Bodyguard" is listed in Traits of DrMouse:
		say "bodyguard ";

Doctor Mouse ends here.
