Leon by Voidsnaps begins here.

[Hunger of Leon: Controls his talk menu. 0 means it's not available.                                           ]
[Lust of Leon: Controls the breeding scenes for male PCs. New scene every 2 lust until final repeatable at 5.  ]
[Thirst of Leon: Counter to show how close you are to the bad end. Cap is 10, where sex will cause the bad end.]
[Stamina of Leon: Formerly used to trigger a double series of bad ends. Now unlocks special bad ends for the   ]
[ram/ewe infections if you've reached 5 libido in his sex scenes.                                              ]
[Traits: vvvvvvvvvvvvvvvvvvvvvvvvvvvvvvvvvvvvvvvvvvvvvvvvvvvvvvvvvvvvvvvvvvvvvvvvvvvvvvvvvvvvvvvvvvvvvvvvvvvvvv]
["Joined The Flock": Allows the player to access Leon's fuck menu.                                             ]
["Bondage Talk": Unlocks spanking scene.                                                                       ]

an everyturn rule:
	if lastfuck of Leon - turns > 6 and Thirst of Leon > 0:
		decrease Thirst of Leon by 1;

Section 1 - NPC

Table of GameCharacterIDs (continued)
object	name
Leon	"Leon"

Leon is a man.
[physical details as of game start]
ScaleValue of Leon is 3. [scalevalue 1-5: "tiny(under 1 foot)", "small(under 4 feet)", "average(around 6 feet)", "large(around 10 feet)", "huge(over 11 feet)"]
Body Weight of Leon is 5. [scale of 1-9 for body weight, grouped into low weight (1-3), mid weight (4-6) and high weight (7-9)]
Body Definition of Leon is 6. [scale of 1-9 for body definition, grouped into low muscle (1-3), mid muscle (4-6), high muscle (7-9)]
[Body Adjective is generated out of the body weight and body definition and can be used in scenes - one word descriptive adjective depending on weight and definition groups: low weight group: skinny/slender/lithe; mid weight group: average/fit/muscled; high weight group: pudgy/husky/jacked]
Androginity of Leon is 2. [Gender Adjective is generated out of androginity 1-9: hypermasculine/masculine/somewhat effeminate/effeminate/androgynous/feminine butch/tomboyish/feminine/hyperfeminine]
Mouth Length of Leon is 7. [inches deep for face fucking; maximum possible will be double this number (when deep throating)]
Mouth Circumference of Leon is 4.  [mouth circumference 1-5, "tiny, small, normal, wide, gaping"]
Tongue Length of Leon is 7. [length in inches]
Breast Size of Leon is 0. [cup size as number, counting Flat Pecs = 0, A = 1, B = 2, C = 3, D = 4 DD = 5, ...]
Nipple Count of Leon is 2. [count of nipples]
Asshole Depth of Leon is 6. [inches deep for anal fucking]
Asshole Tightness of Leon is 1. [asshole tightness 1-5, "extremely tight, tight, well-used, open, gaping"]
Cock Count of Leon is 1. [number of cocks]
Cock Girth of Leon is 4. [thickness 1-5, thin/slender/average/thick/monstrous]
Cock Length of Leon is 8. [length in inches]
Ball Count of Leon is 2. [allowed numbers: 1 (uniball), 2 or 4]
Ball Size of Leon is 3. [size of balls 1-7: "acorn-sized", "dove egg-sized", "chicken egg-sized" "goose-egg sized", "ostrich-egg sized", "basketball-sized", "beachball-sized"]
Cunt Count of Leon is 0. [number of cunts]
Cunt Depth of Leon is 0. [penetrable length in inches; some minor stretching allowed, or more with Twisted Capacity]
Cunt Tightness of Leon is 0. [size 1-5, generates adjectives of extremely tight/tight/well-used/open/gaping]
Clit Size of Leon is 0. [size 1-5, very small/small/average/large/very large]
[Basic Interaction states as of game start]
PlayerMet of Leon is false.
PlayerRomanced of Leon is false.
PlayerFriended of Leon is false.
PlayerControlled of Leon is false.
PlayerFucked of Leon is false.
OralVirgin of Leon is true.
Virgin of Leon is true.
AnalVirgin of Leon is true.
PenileVirgin of Leon is false.
SexuallyExperienced of Leon is true.
TwistedCapacity of Leon is false. [Twisted Characters can take any penetration, no matter the size]
Sterile of Leon is false. [steriles can't knock people up]
MainInfection of Leon is "Ram".
Description of Leon is "[LeonDesc]".
The scent of Leon is "[LeonScent]".
Conversation of Leon is { "Baa, baby!" }.
Leon is in New Ewe Storeroom.

to say LeonDesc:
	say "     A strong and relatively rugged looking ram person is hanging around near the registers, keeping an eye on you. You recall his name was Leon.";

instead of sniffing Leon:
	say "[LeonScent]";

to say LeonScent:
	say "     Leon smells like a virile male ram, sweaty and masculine.";

instead of conversing Leon:
	if Hunger of Leon is 0:
		if Libido of Mary > 0:
			say "     'Hey there, good to see you,' Leon says, 'But I'm not the one you should be talking to. You wouldn't want your little lamb over there to get lonely, would you?";
		else:
			if PlayerMet of Leon is true:
				say "     [one of]'Welcome back to our store!'[or]'Ah you came back to the flock like a good little ewe.'[or]'Be careful out there, I wouldn't want to see one of my flock get hurt.'[or]'Are you sure all you want to do is talk?'[or]'If you don't want to go back out into the city, you can stay here anytime.'[or]'I heard there was a big wolf out there, you be careful.'[or]'How is it out there today?'[or]'Almost shearing time again.'[or]Leon bleats at you absentmindedly, before blushing when he realizes what happened.[or]'If you need your ram to [']take care['] of you, just let me know.'[or]'Want to head back to the break room with me?'[or]'I wonder when rescue will arrive.'[at random]";
			else:
				say "     'Ah great, I'm glad you came to talk to me, I assume this means you'd like to join our little flock?'";
				say "     [link](Y)[as]y[end link] Yes, you'd like to join the flock, if he'll have you.";
				say "     [link](N)[as]n[end link] No, you're still a bit suspicious.";
				if Player consents:
					say "     'Wonderful!' he says, rubbing his rough hooflike hands together. 'I was hoping you'd decide to join us, and we could definitely use someone like you around here!' quickly calling over another of his ewes to watch the storefront, he takes your unresisting arm and leads you through a door with a sign someone had recently changed from [']employees only['] to [']flock only[']. Entering a short narrow hallway, Leon leads you to the left where the same person has changed the break room sign to [']the breaking room['], making you feel a little nervous as he leads you inside.";
					say "     The room is well lit from the overhead lights, though that seems to be the only constant with most other break rooms you've seen. At some point most of the furniture seems to have been replaced with low benches, and the rest of the room is stuffed with what appears to be fresh piles of wool made into bedding. The room is covered in a strong musk of sheep and sex, making your head swim and your body tingle. Your attention is once more drawn back to Leon as he runs his hand along your neck, before carefully helping you remove your clothes, leaving you blushing as all of your [Skin of Player] skin is exposed for him to see.";
					WaitLineBreak;
					say "     Leon grins as he looks you up and down, before guiding you over to one of the benches to sit.";
					if Player is male:
						say "     'Hmm looks like you won't fit in here quite yet...' he says, eyeing your male attributes, 'only room in a flock for one Ram at a time. Nothing we can't fix though!'";
						if Cock Length of Player >= 9:
							say "     Stepping closer, Leon forces your legs apart and pushes you back on a nearby bench. He's uncomfortably close, and you can't help but notice the ram's cock as it swamps yours, filling the space between you with the scent of powerful male musk. You can't help your cock's reaction to the warmth of his half-hard monster, squirming as you harden and barely resisting the urge to grind them together. 'You'd certainly never please an ewe with this. You need the right tool for the job.' Crowing about his cock's superiority, the ram slaps the underbellies of your shafts together, his powerfully-scented cock swamping even your larger one. 'I bet you can't even shove it in. Useless thing.' Smearing pre over your length, he punishes it with his own. Soft, stinging slaps of cock on cock leave sticky strings of virility that mark your appendage, rolling down to your balls, and you endure the rough treatment, excited despite his words.";
						else:
							say "     Stepping closer, Leon forces your legs apart and pushes you back on a nearby bench. He's uncomfortably close, and you can't help but notice the ram's cock as it swamps yours, filling the space between you with the scent of powerful male musk. You can't help your cock's reaction to the warmth of his half-hard monster, squirming as you harden and barely resisting the urge to grind them together. He's so big that your cock looks positively tiny compared to his, and somehow that turns you on. 'You'd certainly never please an ewe with this. You need the right tool for the job.' Crowing about his cock's superiority, the ram slaps the underbellies of your shafts together, his powerfully-scented cock swamping even your larger one. 'I bet she wouldn't even feel it. Useless thing.' Smearing pre over your length, he punishes it with his own. Soft, stinging slaps of cock on cock leave sticky strings of virility that mark your appendage, rolling down to your balls, and you endure the rough treatment, excited despite his words.";
						WaitLineBreak;
						say "     'Yeah. All you're good for is...' Suddenly grabbing your thighs, the ram presses closer, his breath coming in long pants as his fingers worm their way between your asscheeks, his cock thrusting against yours in a show of dominance over your inferior manhood. He doesn't finish his sentence, but the fingertips, wet with pre, that invade your ass tell you what he means. You're not a ram. You're nothing but an inferior male. Desperate for more, you wrap your legs around the rutting male, moaning your approval for his rough treatment and biting your lip as his gooey arousal coats your cock, marking it with a thick layer of musk that's unlikely to wash off. It feels so good to submit, and you can't deny that the wet slap of his balls on the base of your shaft is exciting. If it weren't for your throbbing, needy cock, you could almost imagine the ram breeding you properly. 'This is what a real ram can do.' Leon huffs as his cock's belly gooily grinds against yours, its tip fountaining enough pre that it would put a lesser man's cum to shame. With a heave, it explodes, the slit bulging, then unleashing a maelstrom of cum that coats your stomach, cock, and the cleft between your ass cheeks in a clinging coat of cum, lubricating the ramming fingers that abuse your prostate. Pleased with his handiwork, he steps back, leaving you hard and wanting, violated hole on display. 'Let that soak in. Can't have the flock smelling another male.'";
						say "     You attempt to take care of your needy shaft, but a scathing look from the ram stops you, and you lay there as his seed cools, your excited cock going soft despite the clinging layer of cum dying it white. Attempting to get some relief, you rub his seed into your skin, avoiding the offending appendage and resorting to fingering yourself when the softer pleasure of rubbing your sensitive parts can't get you off. Eventually, you give up despite your aching balls, staring sheepishly at the ram as if asking for permission to continue your day. Leon forces you to stay there until his cum has soaked into your skin, the remainder left in a cool, rapidly drying puddle in the shape of your ass. Once satisfied that you stink of him, he allows you to re-dress, smacking you on the ass. 'Deal with that thing, or next time, I won't be so lenient.' He nods his head toward your crotch and shakes his head. 'I won't tolerate rogue rams trying to steal my ewes.' With that warning, he's gone, leaving you to find your way back to the store front, rubbing your smarting cheek where his hand landed.";
						WaitLineBreak;
						say "     As you get wander back to the front of the shop, you can't help but notice you smell a bit like a sheep now yourself, just like all the other flock members in the store. For some reason, it doesn't seem to bother you to smell like your fellow sheep; you all belong to the same ram, after all... Blushing at that thought, you return to the main store area.";
					else:
						say "     'Oh yeah, that's what I like to see in a woman,' he says, eyeing you lewdly, 'Now we just need to fix the rest of you...'";
						say "     'First thing we need to do is mark you as part of the flock,' Leon says as he pulls off a bit of wool from his side. 'Need to make sure you smell right to the rest of the flock after all.' You watch as he begins to rub the wool over his cock, pumping it more and more until finally he lets out a low bleating noise as he coats it in his seed. The smell intensifies and the erotic sight makes you unable to protest as he moves closer and begins rubbing the wool he just [']treated['] all over your body. You moan as he massages you with the soft wool, you can swear you almost feel the rams seed sinking into you, marking you as his ewe, his property to do with as he wishes.";
						say "     The erotic massage continues, until you almost can't take it anymore, only to stop right before you can reach orgasm, leaving you panting and moaning in protest as Leon looks down at you with a grin on his muzzle. 'That should be enough for now,' he says. 'Welcome to my flock little, lamb. I'm definitely going to enjoy having you around. You are welcome to stay as long as you like now,' Leon smiles as he turns to leave, 'and if you need, I'd be happy to [']take care['] of you anytime you want. I take goood care of all my flock members, after all. You know where to find me when you're ready.' He winks one of his big, innocent looking sheep eyes at you before closing the door behind him, leaving you to gather your equipment and your dignity back up.";
						WaitLineBreak;
						say "     As you're getting ready to leave, you can't help but notice you smell a bit like a sheep now yourself, just like all the other flock members in the store. For some reason, it doesn't seem to bother you to smell like your fellow sheep; you all belong to the same ram, after all... Blushing uncertainly at that thought, you return to the main store area.";
					increase Libido of Player by 10;
					increase Hunger of Leon by 1;
					now PlayerMet of Leon is true;
					if FemaleList is not banned and "Male Preferred" is not listed in feats of Player:
						infect "Ewe";
						infect "Ewe";
					else:
						infect "Ram";
						infect "Ram";
					TraitGain "Joined The Flock" for Leon;
				else:
					say "     'Ah well, I thought you would make a great addition to the flock. Think it over some more, would you?'";
	else:
		say "[Leon_Talk_Menu]";

instead of fucking Leon:
	say "[Leon_Fuck_Menu]";

Section 2 - Leon's Menus

to say Leon_Talk_Menu:
	say "     Favoring you with a cocky grin, the ram tilts his head toward the back room. 'Business is slow. If you like, I can breed you in the back.' Embarassed, you tell him that's not what you're here for, you'd prefer to talk to him this time.";
	now PlayerMet of Leon is true;
	LineBreak;
	now sextablerun is 0;
	blank out the whole of table of fucking options;
	[]
	choose a blank row in table of fucking options;
	now title entry is "Ask about rough sex";
	now sortorder entry is 1;
	now description entry is "You liked the lash of Leon's wrath, perhaps a bit too much. Explore that fact?";
	[]
	if "Bondage Slut" is not listed in Traits of Leon:
		choose a blank row in table of fucking options;
		now title entry is "Ask about the bondage gear you saw around the breaking room";
		now sortorder entry is 2;
		now description entry is "You're curious if Leon ever uses all that bondage gear you've seen lying around.";
		sort the table of fucking options in sortorder order;
	[]
	repeat with y running from 1 to number of filled rows in table of fucking options:
		choose row y from the table of fucking options;
		say "[link][y] - [title entry][as][y][end link][line break]";
	say "[link]0 - Nevermind[as]0[end link][line break]";
	while sextablerun is 0:
		say "Pick the corresponding number> [run paragraph on]";
		get a number;
		if calcnumber > 0 and calcnumber <= the number of filled rows in table of fucking options:
			now current menu selection is calcnumber;
			choose row calcnumber in table of fucking options;
			say "[title entry]: [description entry]?";
			if Player consents:
				let nam be title entry;
				now sextablerun is 1;
				if (nam is "Ask about rough sex"):
					say "[LeonSpanking]";
				else if (nam is "Ask about the bondage gear you saw around the breaking room"):
					say "[Leon Bondage Talk]";
				wait for any key;
		else if calcnumber is 0:
			now sextablerun is 1;
			say "     You step back from the dominant ram, deciding on a different course of action. He snorts at your indecision, and you barely stop yourself from apologizing, goaded by your natural urge to submit.";
			wait for any key;
		else:
			say "Invalid Option. Pick between 1 and [the number of filled rows in the table of fucking options] or 0 to exit.";
	clear the screen and hyperlink list;

to say Leon_Fuck_Menu:
	if Player is neuter:
		say "     You're ill-equipped to play with him right now.";
	else if Libido of Mary is 0 and "Joined The Flock" is not listed in traits of Leon:
		say "     You should [bold type]talk[roman type] to him for a bit first.";
	else if Libido of Mary > 0:
		say "     'Well that sounds like an interesting offer,' Leon says, 'But I'm not the one you should be talking to, now am I? You wouldn't want your little lamb over there to get lonely, would you?'";
	else if lastfuck of Leon - turns < 6:
		say "     Leon smiles at you as you approach, before shaking his head sadly at you. 'Much as I'd like to spend some more time with you, you aren't the only one in the flock that needs my personal attention. And it wouldn't be fair to the rest of them for me to neglect them like that. But if you come back later, I'm sure we could find some time,' your handsome flock leader says with some amusement.";
	else:
		say "     'Well, if it isn't the newest member of the flock.' Leon says as you approach the shop's counter. Looking you up and down, he holds up his hand before he can speak. 'Let me guess, you want to fulfill your duties as 'one of the girls?' Ever crass, he spreads his legs before you can refute his words, and as you stare at his manhood, you can't help but feel a bit irked that he's right. The question is, what exactly do you want to do with him?";
		now PlayerMet of Leon is true;
		LineBreak;
		now sextablerun is 0;
		blank out the whole of table of fucking options;
		[]
		choose a blank row in table of fucking options;
		now title entry is "Ask him to fuck you";
		now sortorder entry is 1;
		now description entry is "You can't take it anymore, you need your ram to breed you.";
		[]
		if "Bondage Slut" is listed in Traits of Leon:
			choose a blank row in table of fucking options;
			now title entry is "Ask to be punished";
			now sortorder entry is 2;
			now description entry is "You liked Leon's rough treatment. You'd like to explore more rough things with him.";
		[]
		if "Bondage Slut" is listed in Traits of Leon:
			choose a blank row in table of fucking options;
			now title entry is "Beg Leon to tie you up again";
			now sortorder entry is 3;
			now description entry is "Leon's rough ways really turned you on. Tell him you'd like to see more of that.";
		[]
		if "Bondage Slut" is listed in Traits of Leon:
			choose a blank row in table of fucking options;
			now title entry is "Worship Leon";
			now sortorder entry is 4;
			now description entry is "Leon's body is calling out for your tongue. Show him just how much you appreciate your ram.";
		[]
		sort the table of fucking options in sortorder order;
		[]
		repeat with y running from 1 to number of filled rows in table of fucking options:
			choose row y from the table of fucking options;
			say "[link][y] - [title entry][as][y][end link][line break]";
		say "[link]0 - Nevermind[as]0[end link][line break]";
		while sextablerun is 0:
			say "Pick the corresponding number> [run paragraph on]";
			get a number;
			if calcnumber > 0 and calcnumber <= the number of filled rows in table of fucking options:
				now current menu selection is calcnumber;
				choose row calcnumber in table of fucking options;
				say "[title entry]: [description entry]?";
				if Player consents:
					let nam be title entry;
					now sextablerun is 1;
					if (nam is "Ask him to fuck you"):
						say "[SexWithLeon]";
					else if (nam is "Ask to be punished"):
						say "[LeonSpanking]";
					else if (nam is "Beg Leon to tie you up again"):
						say "[LeonBondage]";
					else if (nam is "Worship Leon"):
						say "[LeonWorship]";
					wait for any key;
			else if calcnumber is 0:
				now sextablerun is 1;
				say "     You step back from the dominant ram, deciding on a different course of action. He snorts at your indecision, and you barely stop yourself from apologizing, goaded by your natural urge to submit before his domineering aura.";
				wait for any key;
			else:
				say "Invalid Option. Pick between 1 and [the number of filled rows in the table of fucking options] or 0 to exit.";
		clear the screen and hyperlink list;

Section 3 - Sex scenes

to say SexWithLeon:
	say "     Leon looks up from what he was doing as you approach and smiles. 'I can tell what you want, just head on back to the back room and I'll be right there,' he says as he calls over one of the other ewes to take over his work. Shuddering in anticipation, you find yourself heading through the doorway as your ram suggested, unable to disobey.";
	if Player is female: [female + herm. Revisionist's note: Sorry female PCs, but this is where the old content ends for those with vaginas. I know, it's ironic that the ladies' man has more content for gay pairings.]
		say "     Leon reaches the room right behind you, giving you little time to get comfortable. Noting you still have your clothes on, he quickly gestures for you to strip. You eagerly remove what little clothing you were wearing, your body tightening in pleasure in spite of yourself, when commanding praise echoes from the strong and dominant ram. 'Now that's what I like to see,' he says as he takes in your naked body, his eyes lingering on your now exposed slit. Leon grins as he slowly stalks forward, something in the way he moves tightening your stomach and sending a throb to your unattended femininity as he draws close to you, his strong masculine musk filling your nose and making your insides clench in need. Reaching out he rests his three fingered hand on your shoulder for a minute, before turning you to face away from him, his grip gentle, but firm.";
		say "     Being unable to see what's happening adds an extra erotic flavor to the experience as he gently pushes you forward until you are braced on one of the low padded benches in the room, causing you to shudder in anticipation. Your body tenses as you can feel the tip of his hard cock pressed up against your ass. Almost unconsciously, you find yourself lifting your ass up higher to provide your ram with easier access to your increasingly wet opening, your face flushing at the sensation of your dripping juices. You hear Leon chuckle softly behind you at your obvious wantonness, and before you can turn your head to look behind you, you feel your lower lips split as he impales you with his rod in one swift move, stretching your innards and scratching your awakening itch. Gasping in shock and pleasure, you lower your head as he begins to slowly slide himself in and out of your needy pussy, tongue hanging out in wanton desire. You can only moan as you feel your insides shudder and grip his cock, his every move sending shockwaves of pleasure through your body and stoking the heat radiating from your greedy womb.";
		WaitLineBreak;
		say "     As Leon begins to rock his hips forward even faster, you can feel him draping himself over you, pressing you down into the bench, his rod taking advantage of the position to dig deeper into you, forcing his balls against your clit with loud, wet slaps. You feel your mind emptying out of everything else except for the strong ram above you and his wonderful tool as he breeds you, your body signaling its total submission to his dominance and your mind quickly following suit.";
		say "     Nothing seems quite as important to you anymore as being just another mindless part of the flock, surrendering body and soul to the strong male above you. As if sensing your readiness to submit, Leon thrusts forward one last time, his voice rising in a triumphant groan as his cock explodes within you, your mind exploding with pleasure as he fertile seed fills every inch of your inner walls, soaking your pussy and almost guaranteeing conception. Moaning at the feel of his fertile treasure within you, you find yourself unable to do anything but shudder as aftershocks run through you, your pussy stroking his softening member as though begging for every last drop. He pats your back as he slips out, but you lie there helplessly, unable to do anything but listen to the door open and shut as he leaves you alone to recover and pull your shattered mind back together. Eventually you recover and manage to clean up and drag yourself back outside, a little bit worried at how easily he reduced you to just another mindless ewe, and a little bit excited by it as well.";
		NPCSexAftermath Player receives "PussyFuck" from Leon;
	else: [male]
		if Lust of Leon is 0: [First time scene. Sloppy Blowjob.]
			say "     As you reach the 'Breaking Room,' Leon is hot on your heels, locking the door behind you and grinning when you turn to face him. His cock's already beginning to flag upward, slapping against his stomach and leaving a splatter of excitement, and you can see sweat shining on its length. 'Strip.' He commands, pointing toward the ground as if telling you to throw aside your gear and bare yourself to him. Unable to resist a command from the overbearing male, you do as he tells you, tossing your clothes in one of the bare corners of the room. Standing there with your manhood front and center for his discerning gaze, you can't help but show your arousal, barely resisting the urge to cover the offending appendage. Leon told you to part with it, but you disobeyed, and now you're ready to face the consequences.";
			say "     Sighing as he notices your eager erection, Leon shakes his head, clicking his tongue and placing his hand under your chin, tilting your eyes up toward his disapproving expression. 'I thought I told you to deal with that, my disobedient little ewe.' Stroking his finger over your lower lip, he presses it inward to stroke your tongue before you can apologize, rolling it in and out and giving you a taste of rough skin flavored by the unmistakable taste of his manhood. 'As punishment, I won't be breeding you today. Instead, you'll learn how to please a real man.' His tone allows no protest, though you doubt you could. Immediately soothed by the ram's rough finger fuck, you suckle at his thumb, a blush coloring your cheeks as you realize exactly how close his manhood is, his tip almost grazing your stomach as he strokes your cheek, then shoves you backward onto a nearby bench. Standing over you and licking his lips, he presents you with his masculine shaft, tapping the tip of your nose with the gooey head and assaulting your senses with the unwashed, musky scent of horny ram.";
			WaitLineBreak;
			say "     You take the hint, drawing in grateful breaths and engraving that wonderous stink into your memory. Judging by Leon's expression, he doesn't want a simple blowjob, and a cock this perfect deserves nothing less than worship, so you run your nose over every inch, flicking your tongue out to taste droplets of sweat and feel the heartbeat thundering through that rock-hard manhood. His balls look so heavy, and as you raise your hands to cup them, they churn against your fingers, the sagging weight of his virility warming your digits. 'That's it- This is a real ram's cock. A lost little ewe like you could never compare.' Leon seems to approve of your treatment, placing his hands on his hips and thrusting forward to smear the underbelly of his endowment along your face. 'Lick it clean.' He commands, flexing to slap the fat cumvein against your nose and marking the space between your eyes with drooling pre.";
			say "     Too cock-drunk to protest and too enamored to care, you lap along his shaft obediently, rolling a thin layer of saliva over every inch and shuddering as masculine musk fills your mouth. He tastes salty, and the heat rolling off his manhood makes your face sweat, but somehow, that adds to the experience, driving you to more frenzied laps until all that's left is the gooey, pulsing head. Sizing it up, you shudder as his slit drips onto your nose, licking away what falls to your lips and pressing your lips against the source in a perverted facsimile of a chaste kiss. 'Fuck. You're better at this than the other ewes.' Leon praises your cocksluttery even as his impatience gets the best of him, mashing his cockhead against your pursed lips and forcing it in with a slurp. Moving his hands to your head, he delves into your welcoming mouth, testing your throat with that weeping tip. 'Maybe I'll look the other way about that little problem. Use you as stress relief when the rest are too sore to take it. You'd like that, wouldn't you?' Hungry, almost predatory eyes stare down at you as he rams his dick past your lips, wringing a soft gag from your mouth and bringing tears to your eyes as drool drips down his length, mixed with what feels like gallons of precum.";
			WaitLineBreak;
			say "     Nodding as best you can, you nuzzle into his pubic fur when he attempts to hilt, throating his cock to show your support for his plan. He's so big and so rough that you can't take him for long, heaving and struggling against his grip, but all the while, your tongue lashes his underside, begging for him to cum.'Fuck yeah. Little cockslut. Fuckin' perfect. Fuck.' Leon's words grow less coherent as he destroys your throat with punishing thrusts. His balls slap against your chin with increasingly wet sounds, covered in the evidence of his arousal, and you swear they're drawing up. It won't be long until he baptizes your throat with the contents of those massive orbs.";
			say "     When Leon cums, he forces his entire length past your lips, thrusting hard enough that your poor, abused throat protests with rolling gags. Unfortunately, he doesn't heed your body's warning, and you can only struggle against his grip as the first firehose blast of seed soaks the entirety of your throat, so forceful that it blasts through your nose. Thick, creamy masculinity fills your stomach until you're sure you'll burst, and you gulp every drop, escorting each load down his shaft with your overworked tongue until the last dregs paint your tastebuds. More affectionate in the afterglow, Leon slips from your lips, stroking the top of your head as he brings your messy mouth to his balls, nodding in approval as you kiss and nuzzle their slick fur. 'Clean up your mess. I've got a shop to get back to.' He asks, releasing his grip on you and spreading his legs so you can lick up the mess he made.";
			WaitLineBreak;
			say "     You spend what feels like an hour polishing those fat nuts, only stopping once he's gone completely soft. Cock and balls still shiny with your spit and cock still leaking the occasional dribble of seed, he leaves you there to gather your things, heading back to the shop and leaving you to contemplate your submission. Shivering as you clean yourself off, you lick your lips, wondering if Leon will let you do that again. Maybe being his 'male ewe' isn't so bad... You'll have to come back later and see what other perks it entails.";
			say "[LeonInfect]";
		else if Lust of Leon < 3 and Lust of Leon > 0: [1-2 lust]
			if Lust of Leon is 1: [only happens the first time]
				say "     Leon reaches the room right behind you giving you little time to get comfortable, noting you still have your clothes on he quickly gestures for you to strip. You remove what little clothing you were wearing, unable to resist a command from the flock's dominant male. Leon smiles, then takes a look at you before shaking his head sadly, 'Now this just won't do,' he says as he gestures to your [Cock of Player] cock. 'I thought I told you there'd only be room for one ram at a time. I guess I'm going to have to try a little harder to show you your place,' he says as he puts his three-fingered hand on your shoulder and pushes you down, leaving your face pressed to the ground and your ass in the air. His other hoof-hand moves down to grab your ass, drawing a little bleat from you as he pulls your cheeks apart to inspect your hole.";
			else: [for any after the first time]
				say "     Leon reaches the room right behind you, leaving you little time to get comfortable. Noting you still have your clothes on he quickly gestures for you to strip. You quickly remove what little clothing you were wearing, finding yourself unable to resist a command from the dominant ram. Leon shakes his head as he sees your [Cock of Player] cock, but seems to grin as well. 'Still sporting that, are you?' he says. 'I think I'd best show you your place in this flock again. Remind you that you're nothing but an ewe,' he says as he puts his three-fingered hand on your shoulder and turns you to face away from him. His other hoof-hand moves down to grab your ass, drawing a little bleat from you.";
			say "     Your inability to see what's happening adds an extra erotic flavor to the experience as he firmly pushes your front half until you are braced on one of the low padded benches in the room with your cheek against the meager padding, causing you to shudder in anticipation. Your body tenses as you can feel the tip of his hard cock pressed up against your ass, and almost unconsciously, you find yourself lifting it higher, giving him the perfect angle to enter you, barely resisting the urge to shove backward and impale yourself. You hear Leon chuckle softly behind you at your obvious wanton behavior, but before you can turn your head to look behind you, you feel your domineering ram's hard cock press at your tight ring and push into you in one swift and smooth motion. Gasping in shock, pleasure and pain, you quickly lower your head as he begins to slowly shove himself in and out of your tight rump. You can only moan as you feel your insides shudder and grip his cock tightly, clinging to his shaft as though your innards don't want him to leave, his every move sending shockwaves of pleasure through your body. 'Mmm... you like that, don't you? You're no ram. You're just a cumdump ewe. Can't even get pregnant.' He taunts you mid-thrust, his words punctuated by deep grunts and the hard slap of his balls against your perineum.";
			WaitLineBreak;
			say "     His rough hands run over your [Skin of Player], massaging your [Body of Player] body as his cock massages your insides with each thrust. Leon's strong musk fills the air around you, arousing you further and clouding your senses. As Leon begins to rock his hips forward with wild abandon, you can feel him leaning over you, pressing you down into the bench, his rod stirring your colon and making your eyes close in pleasure as your mouth hangs open, unleashing breathy moans of approval. You feel your mind emptying out of everything else except for the strong ram above you and his wonderful tool as he breeds you, your body signaling its total submission to his dominance, with your mind quickly following suit. Nothing seems quite as important to you anymore as being just another mindless part of the flock, surrendering body and soul to the strong male above you.";
			say "     You can feel Leon's hot breath at your ear and hear his bleating grunts as he pounds into you like the virile ram he is. 'Mmm... that feels good, doesn't it? You want to be my ewe, don't you? Say it,' he pants in your ear. You nod eagerly and moan over and over that you're a horny ewe begging to be bred, your lust-drunk mind wanting nothing more than to be an ewe for this big stud of a ram. Clearly pleased with your response, he thrusts forward one last time, his voice rising in a triumphant bleat as his cock explodes within you, your mind exploding with pleasure as he coats your insides with his fertile, dominant seed. Moaning at the feel of his virile treasure within you, you find yourself unable to do anything but shudder as aftershocks run through you. You cum with a high-pitched whimper, emptying your lesser seed onto the floor and clamping down on that wonderous cock. After pulling out, he pats your ass, telling he looks forward to having you as a proper ewe soon. You can only lie there helplessly, giving a soft bleat and nod before hearing the door open and shut as he leaves you alone to recover and pull your shattered mind back together. Eventually you recover and manage to clean up and drag yourself back outside, a little bit worried at how easily he reduced you to just another mindless ewe, and perhaps a little bit excited by it.";
			NPCSexAftermath Player receives "AssFuck" from Leon;
		else if lust of Leon >= 3 and lust of Leon < 5:
			say "     Leon follows right on your heels as you go into the back room. When you don't strip right away, he quickly gestures for you to get undressed. Unable to resist your ram's orders, you pull off your clothes, trying to make a sensual show of it in the hopes of pleasing him. But when you reveal yourself to still be male, he is unimpressed, pushing you down firmly on the bench before you can even finish undressing. 'I was quite clear about what was expected of you, my slutty ewe. There's only going to be one ram in this here flock, one way or another. Now luckily for you, I have a little extra time today to devote to your on-the-job training,' he says in your ear, his voice quite firm despite its low volume.";
			say "     Keeping you pinned to the bench, he grabs some bands of cloth and binds your hands and feet. By the time he's done, you're spread eagle on the bench with your ass in the air thanks to a raised pad. His hands run across your body, lightly at first, before grabbing your ass hard enough that it almost hurts, drawing a moaning bleat from you. Being bound and manhandled by the dominant ram is such a turn on, and you bite your lower lip, silently wishing for more.";
			say "     Shall you beg him to punish you, or fuck you?";
			say "     [link](Y)[as]y[end link] Yes, you want him to be rough.";
			say "     [link](N)[as]n[end link] No, you just want to be fucked.";
			if Player consents:
				say "     Bleating for him to punish you like the disobedient male ewe you are, he grins and gives your ass a rough spank. 'You do deserve some proper punishment, don't you? Luckily, I have a few things for more... recalcitrant ewes like you,' he says, swatting your ass hard before striding over to a black cabinet you noticed on your way in, now out of your field of view. You can hear him unlock and open the cabinet, take out a few heavy items and then return to you. Your ass is struck again, this time ";
				if Lust of Leon is 3:
					say "with a loud crack as he uses a thick leather paddle. You bleat loudly and pull at your bonds, but are held tightly by them. Tears wet the corners of your eyes at the sting of his blow, but you are also filled with a rush of arousal. Another blow, this time across your other cheek and you're crying out again, even louder.";
					say "     Leon grabs your chin roughly and squeezes it. 'You're being too loud. Do you want the rest of the staff to know you're being disciplined?' And while there is a kinky rush of excitement at the thought of all the other ewes knowing you're getting punished, Leon doesn't give you a chance to respond, instead forcing a ball gag into your mouth. It proves to be quite effective when he gives you a hard lashing with the leather paddle across your back. Satisfied that your cries are muffled, he strides around you, letting the paddle drag across your [bodytype of Player] body, striking you from time to time on various parts of your person.";
					WaitLineBreak;
					say "     Each time you're hit, you moan and grow more aroused. Your [Cock of Player] penis is rock hard, pulsing and spurting precum with every blow. While a few tears leak down your cheeks from the pain, that is far exceeded by the precum drooling from your cock. Leon stops behind you, dropping the leather paddle heavily across your back before grabbing your ass in both hands. He grinds his cock between your cheeks and presses it to your tight hole, pushing it in with an uncaring grunt and enough force to bring fresh tears to your eyes. You release a moaning bleat as you're buggered by the dominant ram, your lust-addled mind loving your deserved punishment. 'That's right, you're going to be my ewe, one way or another,' he groans lustfully as he pounds away at you.";
					say "     As the powerful ram drives his cock into you again and again, several of his thrusts are punctuated by blows from the paddle across your ass and thighs. Each blow causes your bound body to buck and your anus to clench down around his cock, much to your ram's obvious delight. And your delight as well, your erection rock hard and your balls aching for release. All the while, his husky voice constantly reminds you, again and again, that your place is here as one of his ewes. His eventual release is quite powerful, shooting a hot, thick load of his virile semen into you, claiming you once again. The feel of his musky cum filling you finally pushes you over the edge and, while your cries are muffled by the ball gag, you're quite certain the other ewes know that you've been seeded again.";
					NPCSexAftermath Player receives "AssFuck" from Leon;
					say "     After he's finished draining the last drops of his virility into your abused hole, he removes the gag only to replace it with his cock, forcing you to suck him clean with an authoritative hand on the back of your head. Only once you've cleaned the last of his musky gift from that pulsing, halfhard shaft,  does he untie you and allow you to return to the store with the rest of the staff, reeking of sex, shame, and your own perverted enjoyment.";
				else: [four]
					say "by the multiple strikes of a leather lash. You bleat like a lamb in the jaws of a wolf and pull at your bonds, but they hold tight. The lingering sting of the impact's many strands cause your cheek to ache, a warm reminder of your submission that also fills your loins with a rush of arousal. Another blow, this time to the other cheek, makes you squirm, your voice cracking as you cry out.";
					say "     Leon strides around to your front and raises your head up to look at him. 'It's time you serviced your ram to help you learn your place,' he says as he forces a ring gag into your mouth. Once secured, your jaw aches as its forced agape, leaving you open for the ram's cock. His shaft is forced fully into your mouth and down your throat, burying your nose in the musky scent of his woolen crotch. Losing yourself in his scent, you lick and suck at his cock as best you can.";
					WaitLineBreak;
					say "     Even as he thrusts into your restrained mouth, he continues to flog you. Each blow across your sides, back or ass cause your [bodytype of Player] body to stiffen, though it is your [Cock of Player] cock that stiffens most of all. Your manhood throbs and pulses with every lashing, precum dribbling from your unattended erection. You release moaning bleats around his pulsing rod as you're made to suck off the dominant ram, your lust-addled mind loving your deserved punishment. 'That's right, you're going to be my ewe, one way or another,' he groans lustfully as he pounds away at you.";
					say "     As the powerful ram drives his cock into your mouth again and again, he reminds you that your place is here as one of his ewes. And you respond to your punishment like a good ewe by slurping all the harder, eventually earning your reward as he cums with a loud bleat, blasting shot after shot of hot, musky semen into your mouth and down your throat. As you swallow it all down, the excitement of it all sends you over the edge as well, your [Cock of Player] penis releasing your load even as Leon whips your ass all the harder for it.";
					NPCSexAftermath Player receives "OralCock" from Leon;
					say "     After he drains his balls into your willing innards, he removes the ring gag, grinding his cock against your ass while calling you a good ewe, marking it with the sticky evidence of your subservience. Only then does he untie you and allow you to return to the store, sore and reeking of sex.";
				say "[LeonInfect]";
			else: [fuck]
				say "     Bleating for him to fuck you like the needy male ewe you are, he grins and gives your rear a light swat. Climbing atop you, he licks the edge of your ear while grinding against your ass. 'At least you know your place is right here,' he says softly, 'beneath me.' You shiver with excitement and try to push your ass back against that hard rod of his, but you're too tightly bound. Only when he's good and ready does he thrust into you, an act that causes you to bleat and moan in lustful ecstasy despite the sudden pain of the quick penetration.";
				say "     With you bound beneath him, you can do nothing but moan in pleasure as your inner walls squeeze and grip his cock tightly while he fucks you with rough zeal. He grips your shoulders, pressing you down hard onto the bench as he rams you like the rutting male he is. Leon's strong musk fills the air around you, arousing you further and clouding your senses. As Leon pounds his cock into your yielding asshole even faster, a growing feeling of submissive bliss fills you, your mind losing itself in the scent of the rutting male atop you. Your mind loses the threads of thought you try to hold onto until only your need for a strong ram inside you is all you can think about. At this moment, you are nothing more than another submissive member of his flock, another needy ewe for him to fuck and breed, even if but a male one.";
				say "     Between his bleating grunts as he pounds into you like the virile ram he is, he echoes your own woolly thoughts, reinforcing them further. 'Mmm... that's how you like it, isn't it? Being fucked like an ewe all the time is what you really want. Deep down, all you are is a weak male who'd much rather be my ewe,' he pants in your ear. You nod eagerly and moan over and over that you're a horny ewe, your lust-addled mind wanting nothing more than to be a sheep in this big stud's flock. Satisfied with your response, he thrusts forward one last time with a loud bleat and cums hard. His balls unleash their heavy payload, sending thick ram semen into your bowels. You are filled with pleasure as he coats your insides with his fertile, dominant seed and cum yourself soon after. Your lesser seed sprays out onto the floor, unworthy of claiming ewes like yourself or the other girls.";
				NPCSexAftermath Player receives "AssFuck" from Leon;
				say "     After pulling out, he struts around to your front and wipes his messy cock across your cheeks, leaving smears of his musky semen on your cheeks. With the scent of it right there, you are left in a lustful daze of submissive urges long after he's untied you and left you alone in the room. It is much later before you've regained enough of your senses to stagger out and join the other ewes in the store.";
				say "[LeonInfect]";
		else if Lust of Leon >= 5: [final in the series]
			say "     Leon follows you into the back room and pushes you towards one of the mounds of fragrant wool. Pushing you down onto it, he makes sure your face is buried in the soft, sheep-scented pile. 'Smell that. Take that in. It's the scent of your flock... where you belong,' he says firmly. With your nose buried in it, you can't help but smell the heady scent of sheep and arousal. Clearly you're not the first to be fucked on this pile, the scents of your ram, the ewes and rutting embedded in the wool. It makes you aroused and woolly-headed, your mind over-written by increasingly sheep-like thoughts.";
			say "     Keeping one hoof-hand at the back of your head, he pushes aside any obstructing clothes and brings his erect penis to your rear. He grinds it between your cheeks and you can feel the wet dribbles of his precum running down to your exposed pucker. 'Now, we only need one ram for this flock... but you're my slutty male ewe, aren't you? You wouldn't challenge my position even if you could.' he gloats, grinding his glans against your asshole in preparation. Lost in the scent of the wool, you moan and do your best to nod while being held down. You find it easier to answer by pushing your rear back, popping his tip past your pucker. Leon chuckles at this and rewards your eagerness by thrusting into you, pushing the first few inches into your needy bottom. 'Good girl.' And after a few thrusts, he sinks the rest of it into you with a lustful bleat.";
			WaitLineBreak;
			say "     As the ram ruts you, you moan and pant with growing arousal. Your heavy breathing draws in more of the hot, musky scent of sheep and sex impregnating the wool. It makes you both more aroused and more confused, losing track of yourself in a hazy bliss. 'Nnggg... yeah... you make a fine ewe... and you've got a big, strong ram to fuck you right here. No more need to roam and wander, my slutty lambchop.' His words sink into your woolly mind, eroding your waning resistance as the desire to stay with your flock grows.Leon moves his hands to your shoulders as he ruts you harder and faster. No longer held down, you're able to bring your head up. The air is only slightly clearer though, the scent of Leon's strong musk filling the room as he fucks you. It matters little though, at this point, you're lost in the joy of rut and want nothing more than to be another submissive member of his flock.";
			WaitLineBreak;
			say "     Between his bleating grunts as he pounds into you like the virile ram he is, he reinforces your own woolly thoughts with his words. 'Mmm... that's right, my needy ewe. Stop this defiance and just stay with your flock. It's where you belong.' You nod eagerly and affirm that you're his needy ewe, hoping that your words spur him to fuck you even harder. Tightening his grip on you, he thrusts forward one last time with a loud bleat and cums hard. His balls unleash their heavy payload, sending thick ram semen rocketing into your innermost and triggering your own orgasm, wasting your seed on the wool below.";
			NPCSexAftermath Player receives "AssFuck" from Leon;
			say "[LeonInfect]";
			say "     After pulling out, the chuckling ram goes to swipe his sticky cock across your well-used ass, but you beg for more with a plaintive groan. The smile on his white muzzle grows and he instead moves around to let you mouth at his shaft. You engulf his cum-slick pole in your mouth, licking and sucking on it eagerly in your desire to prove your need to be with your studly ram. You can tell he's pleased with his eagerness as he rubs a hoof-hand on the top of your head.";
			WaitLineBreak;
			say "     'Mmmm... I don't usually give my ewes this much... mmm... attention all at once. But for you, I'll make a special exception,' he says, his cock swelling and grinding between your cheeks. 'But only if you'll promise to stop resisting and join your flock. Do that and I'll give you the thorough fucking you clearly need, my horny male ewe. At this point, you're too lost in your lust to refuse and you moan lustfully about how you want him, promising to be his good slut and needy ewe if he'll only fuck you again. This is enough to get him excited, and you moan as his cock finds its mark, shoving back into your already creamy hole. Clearly pleased with your submission and eagerness, he clambers onto you and hilts himself. Already hot and slick from the earlier rutting, he goes in easily, like he belongs there. You bleat happily into the warm mound of wool, breathing in its heady scents of the sheep and sex. You lose yourself more and more in the bliss of submission and the soft embrace of the scents of your flock as you contemplate just how right it feels to be a stress relief toy for a more worthy male.";
			say "     'That's right, my horny ewe. You can stop your roaming ways; you're part of my flock now,' the confident ram says as he pounds your ass. 'No more resisting it. No more need for defiance. Stay here and your big ram'll give you all the fucking you need.' You can only pant, baa and bleat as he fucks you completely senseless, the last fragments of your mind being worn away by the rut and smell of sheep and sex overwhelming you. Your ram is here. Your flock is here. There's no need to worry about leaving, or thinking, or anything other than being a good, submissive, male ewe for Leon. Having already gotten off recently, Leon has a lot of stamina, pounding you for a long, long time. Any attempt by your waning humanity to recover is disrupted by the steady rutting, ram musk, soft wool and sheep scents absorbing all your focus. These moments become weaker and less frequent until they stop altogether, not missed at all by your submissive sheep mind. By the time Leon's reached his second orgasm and pumps a fresh, full load of ram semen into your wanton ass, all that's left is the male ewe he desires you to be. His climax is just as powerful as the last, filling your bowels with his virile seed even as you moan and cum again from being filled by your ram.";
			WaitLineBreak;
			say "     When he's done and pulls out this time, you're too weak and worn to manage to ask for more. All you can manage is a baaing moan before passing out in the mound of scented wool, excess semen leaking from your overfilled ass. Confident that you're fully his now, he leaves you there to return to the store. Left surrounded in the cum-stained wool and filled with infected semen, your body changes, completely becoming the flock's male ewe in body as well as mind. It is some time later before one of the sheep comes to collect you, bringing you out to join the others in working the store like the loyal, loving ewe you are through and through.";
			say "[RamEweSplit]";
			say "     It's hours before you awaken in the pile of wool, your body bruised and sore, and your ass gaped and leaking what feels like gallons of cum. Standing, you attempt to recall what happened after Leon bred you, but a soft, woolly feeling prevents much more than a lustful haze and vague memories of a deep rutting frenzy. Shaking your head, you shiver, wondering whether it was a good thing that you woke up, or if you would have been happier as a submissive sheep. Maybe you should [italic type]submit further to your ram. [roman type] if you want to explore that side of yourself, though it might result in the loss of what little desire you have left.";
			now stamina of Leon is 1; [Leave this in, it affects ewe and Ram endings]

[Rewritten as of 10/2/2023 above this point.]

to say LeonSpanking:
	say "     <Content past this point has not been reviewed and is filled with issues. It was written by the original author, not the revision's author. It has been left in for those that enjoyed it, but there aren't plans to fix it as of yet. Sorry!>";
	say "     Leon follows you into the back room, which is filled with mounds of fragrant wool, and in the center of the room is a single chair that you haven't seen before. You expect the dominant ram to grab you, claiming your body for his own, however the assault never comes. Instead, Leon simply walks past you, taking a seat in the chair and looks directly into your eyes. Your first instinct is to bow your head in submission in front of the powerful master of the flock. A harsh bleat echoes through the room, startling you and drawing your attention back to the male in front of you. His earlier somewhat relaxed expression has changed to one of annoyance. 'While I'm happy that you know your place is to submit to me, I have other plans for you today.'";
	say "     You aren't sure what to make of this turn of events. The normally aggressive ram usually doesn't even give you a moment to fully register the sensations that he inflicts upon your body. Your mind instantly begins to pull up images of the pain and pleasure that the dominant male has inflicted on you in the past, the sickly sweet feeling of being controlled and owned. You can feel your blood rushing to the surface with the knowledge that those same feelings are so close to coming to fruition again. 'While it's nice to know that I can have this kinda effect on you without even touching you, I need you to focus on me, my slutty little ewe.' Instantly, a wave of embarrassment rushes over you. Here, the master of the flock is being so patient with you, and you aren't even giving him the appreciation that he deserves.";
	WaitLineBreak;
	say "     Quickly rushing forward, you drop to your knees and wrap your arms around one of his thick, powerful thighs. You aren't sure what to say to apologize for your rudeness, instead choosing to rub your face fully into Leon's musky wool, taking in his scent and feeling the power behind the intoxicating aroma. Without warning, your head is pulled back, forcing you to gaze up into the ram's eyes. 'This isn't about a punishment. This is about you listening to what I have to say and doing your best to obey, understand!?' The hooves on each of his fingertips scrape against your head is soothing, almost feeling like a massage for your scalp. You nod in agreement to what Leon is asking, all while you attempt to keep your eyes open during his ministrations.";
	say "     'I've been thinking about you a lot lately, how you came to join the flock and what that really means. You've been braving the city, even went out of your way to find Mary for us and eventually decided to become a member of my flock... albeit a more roguish one than what I would personally prefer.' Your head dips in shame at the knowledge that you have displeased your master, but you are startled a bit by the bleating laughter that booms from the ram's chest. 'Don't get that look on your face. I actually sort of like the fact that you go out into the city. It shows just how badass my flock is, haha. Anyway, the whole point of this talk of ours is to discuss a [']reward[']!' A smile spreads across Leon's muzzle. While still ruggedly handsome, it also has a hint of something dangerous that just makes your heart beat just a bit faster.";
	WaitLineBreak; [in the future this will lead to a choice point, however the choice point will only appear if you have the wool to actually be shaved.]
	say "     'So, now let's figure out what kind of reward I wanna offer you.' The ram raises his hoof-hand up and lazily scratches his small beard in thought. 'I was gonna give you a choice in the matter. It was between a nice and slow spanking suitable for someone being such a good [boygirl], or a nice relaxing shave, but I'm not really feeling a shave at the moment. So it looks like your ass is gonna get some [']affection['] today, haha.' A blush quickly spreads across your cheeks at the master's implication, and you can't help the [if Player is female]wetness that you can already feel dripping down your thighs. [else if Player is herm]wetness that you can already feel dripping down your thighs, along with the hardening of your shaft. [else if Player is male]tingle that starts at the base of your cock as it begins to harden. [else]desire that is welling up from within you. [end if]The thought of what your master has in store for you is already enough to put you on edge, as a jittery energy starts to flood through your body.";
	say "     'Well, what are waiting for? Just because this is your reward doesn't mean that [']I['] should have to be the one to lay ya across my lap, now does it?' You quickly shake your head and rush to get up off your knees. This causes you to get up far too fast and unfortunately lose your balance. Thankfully, before you can injure yourself however, a powerful hand reaches out and stops you from colliding with the ground. Without pause, you are pulled up and over Leon's lap as if you weigh nothing. 'It amazes me that you haven't managed to get turned into someone's slut by one of those monsters out there, seeing how clumsy you can be!' While the ram's voice sounds mildly irritated, you can't help but notice the slight upturn to the sides of his mouth. It could be that he just enjoys proving how much you need him, or... maybe he's simply starting to like some of the odd quirks that just make up who you are.";
	WaitLineBreak;
	say "     That last thought causes a happy and content feeling to spread from your chest out to the rest of your extremities, however while lost in thought, you are startled by the feeling of Leon's hoof-tipped fingers slowly being dragged down your back. While relaxing, there is still a hint of pain with each caress, causing your back to arch slightly in response. You can't decide whether you wanna beg to be spanked right away, or if you simply want him to continue. Suddenly your body is jolted forward, a breathy moan escaping your lips as the pain from your ass quickly dissipates into a throbbing ache. 'You looked way too relaxed, and I just wanted to make sure that ya didn't think about passing out on me, haha!' Leon sounds pleased with himself and in all honesty, part of you loved being surprised by the quick yet firm swat to your backside.";
	say "     It's rare to see the master of the flock in such a playful mood, and apparently, it's contagious as a soft chuckle escapes from your mouth. 'Now, why don't you just lay back and let your master take care of you, my pretty little [if Player is female]ewe. [else]male-ewe. [end if]I promise that you're gonna enjoy this reward.' His final words come out in a baritone whisper. The combination of his rough fingertips and the throbbing heat on your ass have you arching your back. Taking in the heavy scent of the room makes you start to feel lightheaded, and your senses feel like they are in overdrive. 'Mmmm, that's a good little slut. You definitely know how to please your master, don't you?'";
	WaitLineBreak;
	say "     Fighting to get yourself under control, your eyes finally snap open, and you realize that while you were enjoying being petted, you had been writhing on Leon's lap. You feel your cheeks begin to flush with heat and immediately stop moving your body, however it seems that the ram has other plans, and he roughly grabs your body, holding you tightly against himself. 'Now, why would you wanna stop doing something that pleases me? This may be a treat for you, but that doesn't mean you shouldn't be giving me one in return now, does it?' Quickly, you nod your head in agreement, and while still slightly embarrassed, you begin to gyrate your body against the wool of your master. Closing your eyes in an attempt to calm down, you slowly start to lose yourself once again to your instincts.";
	say "     A grunt from your master is the only warning that you receive, before a hard swat to your ass forces your body to go rigid, and a squeal is ripped from your lungs. You can feel Leon's deep chuckle reverberate through his chest, and it excites you, knowing that the reactions of your body are making the master of the flock happy. You allow your hands to squeeze the thick thigh of the ram, enjoying the powerful muscles that you find inside his fluffy wool. He continues giving you your reward for quite awhile, each smack forcing your [if Player is female]clit to rub [else if Player is male]erection to grind [else]sensitive bundle of nerves to grind [end if]against the ram's leg, pushing you closer to orgasm.";
	WaitLineBreak;
	say "     Before you're able to find sweet release however, Leon roughly grabs ahold of your body, forcing you to straddle his lap and look him directly in the eye. 'So are you enjoying your [']reward['], my slutty little [if Player is female]ewe[else]male-ewe[end if]?' The ram's large hoof-like hands slowly begin to knead your hips and ass, causing a breathy moan to escape your lips, and instinctively, your thighs spread further apart. 'Such a good [boygirl]. I bet what you truly desire is to end our little game and receive the mark just like all your sisters, isn't that right, baby?'";
	say "     You almost stumble in your attempts to quickly give the ram exactly what he wants. A bleating laugh forces your face to heat up with embarrassment, and your eyes slowly turn towards Leon. 'No need to be shy, slut. I find it adorable that you are so eager to please your master, but perhaps you should just let me put you where I want you!' While his voice sounds jovial, there is an intenseness behind it that lets you know that this isn't a request. Without waiting for a response, your body is picked up as if it were nothing and laid back across the ram's lap. As you lay there and wait for your [']reward['] to continue, you're caught off guard by the sheer force of the smack to your backside, and your whole body is thrust forward when it finally arrives.";
	WaitLineBreak;
	say "     Before you can even recover from the rough attack to your backside, another is already connecting. The ram releases a dark laugh as he keeps up the speed and force of each impact, almost as if he's working out, but instead of using weights, he's using your ass. Feeling your butt begin to heat up from the savage treatment, you attempt to say something, however with each smack, the wind gets stolen from your lungs and only a squeal escapes your lips. Tears start to run down your cheeks, whether from the pain or simply from being thankful of the treatment that Leon is pushing onto you, you're not sure.";
	say "     Finally, the spankings stop, and a feeling of calm settles within the room. Your body is exhausted after what it has been put through, and even though your [if Player is female]pussy is still trembling with desire, [else if Player is herm]cock and pussy are both still throbbing, [else if Player is male]cock is still hard and leaking, [else]sensitive mound of nerve endings are pulsating, [end if]you can't even bring yourself to care at the moment. Your body is gathered up by the ram quickly, but with care and laid down on one of the piles of aromatic wool. The smell mixed with the softness is enough to force a breathy moan to escape you. Slowly coming back to yourself, you can make out panting from behind your body, and you realize that you've been placed face down in the wool with your backside sticking up in the air.";
	WaitLineBreak;
	say "     'That's right, you little [if Player is female]ewe[else]male-ewe[end if] whore, present that tight [if Player is female]pussy[else]ass[end if] for your master! The only true reward that you need is to serve me, isn't that right, slut!?' With those final words, you feel hot liquid begin to paint stripes over your backside, and the same scent of the wool begins to intensify. Realizing that Leon is shooting his load all over your abused ass, you can't help but also notice that the cum is also having a soothing effect on the inflamed flesh there. Your mind is going into overload with the mixture of pain, pleasure, and the scent of the flock, and you lose yourself to the need between your legs. While your scream is muffled by the wool, you feel your [if Player is female]pussy contract and femcum squirt out. [else if Player is herm]cock and pussy both begin to throb before a mixture of cum and femcum begin to squirt out. [else if Player is male]cock throb and start shooting cum everywhere. [else]sensitive mound pulsates, sending you into a dry cum.[end if]";
	say "     Laying there, you attempt to recover from the intense orgasm that the head of the flock put you through. 'I feel much better, my little [if Player is female]ewe[else]male-ewe[end if]. So, did you enjoy your reward?' Too tired to really move that much, you simply shake your ass slightly side to side in answer. 'I thought that you would, haha. And since I was happy with how well you took to my own style of affection, I think that I will be rewarding you more in the future, but only if you stay a good [boygirl]!' With that, he stops talking, and you hear a door shut. Leon must have left. After what your body went through, you're too tired to get up, and you simply close your eyes and take a nap to recover, the whole time your ass still in the air, covered by your master's cum.";

to say Leon Bondage Talk:
	say "     Timidly, you look away from Leon's hungry expression, unconsciously spreading your legs as though you can feel his hands on your ass. The truth is that you're curious about something- all of the bondage equipment that you've seen lying around. Does he ever use those with the rest of the flock? 'Hmm. I've tried it out, though my ewes are disappointingly fragile. All they do is complain about being sore and beg me to 'do it the normal way.' Why? Feeling adventurous?' Leon winks and licks his lips. You feel a bit of trepidation and excitement as his eyes take on a shine, and you can't help but feel like you've opened up a can of worms.";
	TraitGain "Bondage Talk" for Leon;

to say LeonInfect:
	SanLoss 10;
	if "Strong Psyche" is listed in feats of Player, increase humanity of Player by 2;
	if "Weak Psyche" is listed in feats of Player, decrease humanity of Player by 2;
	if FemaleList is not banned and "Male Preferred" is not listed in feats of Player:
		infect "Ewe";
	else:
		infect "Ram";

to say RamEweSplit:
	if FemaleList is not banned and "Male Preferred" is not listed in feats of Player:
		turn the Player into an "Ewe" silently;
	else:
		turn the Player into a "Ram" silently;

Section 4 - Bad End Scene Progression

Table of NavInEvents (continued)
Priority	Name	EventObject	EventConditions	EventRoom	LastEncounterTurn	CoolDownTurns	EncounterPercentage
1	"Ram's New Toy"	Ram's New Toy	"[EventConditions_Ram's New Toy]"	New Ewe Storeroom	2500	3	100

to say EventConditions_Ram's New Toy:
	if "Bondage Talk" is listed in Traits of Leon:
		now CurrentWalkinEvent_ConditionsMet is true;

Table of GameEventIDs (continued)
Object	Name
Ram's New Toy	"Ram's New Toy"

Ram's New Toy is a situation.
ResolveFunction of Ram's New Toy is "[ResolveEvent Ram's New Toy]".
Sarea of Ram's New Toy is "Nowhere".

to say ResolveEvent Ram's New Toy:
	say "     When you walk into the New Ewe Store Room, you can't help but notice that Leon isn't there. In his place is one of the nameless ewes he works with, and when she sees your confused expression, she smiles- though there's a strange sense of pity in her eyes. Wordlessly, she points you toward the back. Curious but unable to resist the pull of the mysterious summons, you leave the storefront, traveling through the darker back rooms until you're standing in front of the Breaking Room. Almost immediately, you hear Leon's voice calling out from inside. 'Oh good, you're here. Get your ass in here.' Leon calls out, his voice echoing from just inside the door. When you step through the door, you can't help but notice that there's been a remodel. The musky piles of sheep's wool have moved away from the center of the room, and in their place, a contraption stands. You only have a moment to contemplate shiny black leather and straps before you feel a hard shove from behind, sending you sprawling into the strange setup.";
	say "     'It's time to test your loyalty, my stubborn little ewe.' Leon's voice echoes in your ear as he grabs your arms, pulling them back behind you and sheathing them in something leathery and tight. 'Since it appears that you won't lose the most troublesome bit of your anatomy, and you've shown such interest in my toys...' Cinching the armbinder tight as he speaks, the ram strips off anything in the way, flopping his cock between your ass cheeks as he tosses your gear aside. 'Perhaps it's time that you become one.' Shivering with anticipation, you barely resist the urge to shove backward onto that perfect cock, asking in a shaking voice what the ram intends to do with you. It's not like you could struggle, even if you wanted to, but it seems like the correct thing to do. That's what he would expect from you, right?";
	WaitLineBreak;
	say "     'You, my wannabe ram, will satisfy me in a way that my girls never want to.' Leon murmurs as he straps your legs into the rectangular, leather-covered contraption, leaving your ass spread wide and your cock stuffed between your legs, leaving no room for privacy. Even your neck straps in, leaving you unable to see anything the amorous ram wants to do to your helpless body. 'Hopefully, you enjoy this as much as I do. My girls always complain that I'm too rough. They're so sore- that I'll hurt the lambs I've pumped into them.' The weight on your back disappears, and the soft click of hooves on concrete heralds your ram's reappearance, his cock leading the way and flopping on your exposed nose. Your world reduces to nothing but his wondrously scented cock, and you let your mouth hang open, your tongue rolling against those heavy balls. He tastes like pure musk and cum, bringing to mind all the breeding he must do without washing them, and you can't help moaning and polishing them like precious gems.";
	say "     'Greedy whore.' Leon says, mashing his ramhood against your face and rubbing the dripping river of pre rolling from the tip into your skin. 'You're more than just an ewe, aren't you?' He continues as he slots his cock against your tongue, fingers stroking your cheek as you obediently lap up the evidence of his arousal. Grunting, he stuffs himself to the root, slapping his balls against your chin in a heavy rhythm that makes you gag and sputter. As he plunders your throat, he never stops talking, sprinkling compliments among references to your sluttiness and staring down at your face with a strangely obsessive expression. You don't have time to contemplate the consequences of letting Leon unleash his rougher side, swallowing for your life as his pre threatens to drown you. A thick cloud of masculine musk covers every corner of your mind, and each gag brings up a thick wad of precum-flavored spit to lubricate his brutal shoves while your neglected cock flexes between your legs, untouched and leaking its approval down the leather surface. It's getting harder to breathe by the second, but it's impossible to escape, so you let your vision go cloudy, slackening your throat in hopes that he'll finish before you pass out.";
	WaitLineBreak;
	say "     Thankfully, Leon pulls out before you drift away, flopping his slick, shiny cock against your nose and giving your cheek a gentle smack. 'None of that, now. It's better if you can feel it.' He coos, the stinging impact of his hand melting into a gentle stroke that sends a jolt of electricity straight to your cock. That impossibly alluring ram cock disappears, replaced by a view of the wall before you. You wonder if you'll be left there, but a resounding slap on your upturned ass reveals Leon's intentions. It wasn't his hand that hit you, judging by the wet spot you can feel slowly drying. 'You were such a thorn in my side.' Leon muses as he slots his cock between your cheeks, his cock kissing the base of yours for a moment before you it finds your hole. 'But perhaps I was hasty in thinking of you that way. You've been such a good girl.' Cupping your ass cheeks, he presses forward, sheathing his spit-slicked cock in your ass, one agonizingly perfect inch at a time. 'Maybe I can overlook your flaws.' His voice wavers as he hilts, and you feel his cock flexing inside you, its heavy underbelly crushing your prostate. 'Fuck. I could get addicted to this.'";
	say "     Face flush and ass burning with the stretch of the ram's cock; you apologize to Leon for not living up to his expectations, urged on by your natural instinct to submit. It's hard to think as he breeds you, and your body calls out for you to welcome his advances, but all you can do is tighten your hole, clamping around his base and shivering as his cock responds, bucking like an angry horse. Something about this situation feels so right, being a toy for your ram and letting him work off his stress in your eager ass. 'Greedy ewe.' Leon's voice drips with affection as he starts up a heavy rhythm, crushing your prostate and slapping his low-hanging balls against the base of your shaft with every hilt. Hands move upward to your bound arms, and he takes hold of them, using them as a hand to give him the leverage to pound you. 'You're not too sore for me, are you? You'll let me fuck you as long as I want.' It feels less like a question and more like an expression of admiration, but he's right.";
	WaitLineBreak;
	say "     Even though it hurts a little, you can't help how much you want him inside you. The smell and taste of his cock still lingering on your face, the sensation of his muscles slapping against your backside, and even the strain on your shoulders adds to the naughty thrill of being fucked like an animal. It's all perfect, and you can't help your body's reaction, letting out a needy whimper as your cock unleashes its pitiful load to the ground below. 'Fuck.' At a loss for words, Leon takes advantage of your spasming innards, ramming your upturned ass until the impacts bruise your bound body. All premise of restraint has let him, and he yanks your arms back cruelly, his cock bucking and spitting its claim so deep inside you that you're sure even your deepest reaches stink of horny ram.";
	say "     When he cums, your mind blanks, your overstimulated body milking every blast. Nothing else exists but that perfect cock and the evidence that you pleased it. Your ram's pleasure is yours, and your cock dribbles its approval, unable to stop as long as the bloated shaft inside you continues its rampage. Coming to a few hours later on a pile of sheep's wool, you find Leon stroking your hair, his ramhood serving as a perverse pillow for your sticky face. Noticing you're awake, he favors you with a surprisingly gentle smile. 'Such a sweet little thing. You're going to make such a great toy.'";
	WaitLineBreak;
	say "     Lulled by Leon's deep voice, you nuzzle into his manhood, kissing it as though thanking it for the gift oozing out of your sore rear. Sadly, he returns to the storefront before you can coax his shaft back into your mouth, but the sticky evidence of your fun still clings to your face and rump, a sweet reminder of your submission. As the horny fog clears, you can't help but wonder what Leon means by making you into a 'toy.' The possibilities whirl through your head, and your erection leads the way after you gather your gear, joining him in the store. Would it be so bad to allow Leon to use you more often? [italic type]He might keep you as a permanent sex toy. [roman type][line break]";
	TraitLoss "Bondage Talk" for Leon;
	TraitGain "Bondage Slut" for Leon;

to say LeonBondage: [Repeatable scene.]
	if Thirst of Leon > 10:
		say "[LeonBadEnding]";
	else:
		say "     Shuffling in place, you mention that you liked the rough treatment you received from your ram last time. With your mind wandering to that musky leather bondage set up, you can't help the erection growing in your pants, but you doubt that Leon wants to see it. Surprisingly though, when you meet his eyes, a certain level of hunger shines in his eyes, and he's staring directly at your crotch. 'Let me call one of the girls over. Hope you're ready.' His words echo like a warning, clenching your innards as if he's already inside you, and you follow him to the back, almost limping from your erection's painful throb.";
		say "     'It's time to test your loyalty, my stubborn little ewe.' Leon's voice echoes in your ear as he grabs your arms, pulling them back behind you and sheathing them in something leathery and tight. 'Since it appears that you won't lose the most troublesome bit of your anatomy, and you've proven to be such a good toy...' Cinching the armbinder tight as he speaks, the ram strips off anything in the way, flopping his cock between your ass cheeks as he tosses your gear aside. 'Perhaps it's time that you become one.' Shivering with anticipation, you barely resist the urge to shove backward onto that perfect cock, asking in a shaking voice what the ram intends to do with you. It's not like you could struggle, even if you wanted to, but it seems like the correct thing to do. That's what he would expect from you, right?";
		WaitLineBreak;
		say "     'You, my wannabe ram, satisfy me in a way that my girls never want to.' Leon murmurs as he straps your legs into the rectangular, leather-covered contraption, leaving your ass spread wide and your cock stuffed between your legs, leaving no room for privacy. Even your neck straps in, leaving you unable to see anything the amorous ram wants to do to your helpless body. 'Hopefully, you enjoy this as much as I do. My girls always complain that I'm too rough. They're so sore- that I'll hurt the lambs I've pumped into them.' The weight on your back disappears, and the soft click of hooves on concrete heralds your ram's reappearance, his cock leading the way and flopping on your exposed nose. Your world reduces to nothing but his wondrously scented cock, and you let your mouth hang open, your tongue rolling against those heavy balls. He tastes like pure musk and cum, bringing to mind all the breeding he must do without washing them, and you can't help moaning and polishing them like precious gems.";
		say "     'Greedy whore.' Leon says, mashing his ramhood against your face and rubbing the dripping river of pre rolling from the tip into your skin. 'You're more than just an ewe, aren't you?' He continues as he slots his cock against your tongue, fingers stroking your cheek as you obediently lap up the evidence of his arousal. Grunting, he stuffs himself to the root, slapping his balls against your chin in a heavy rhythm that makes you gag and sputter. As he plunders your throat, he never stops talking, sprinkling compliments among references to your sluttiness and staring down at your face with a strangely obsessive expression. You don't have time to contemplate the consequences of letting Leon unleash his rougher side, swallowing for your life as his pre threatens to drown you. A thick cloud of masculine musk covers every corner of your mind, and each gag brings up a thick wad of precum-flavored spit to lubricate his brutal shoves while your neglected cock flexes between your legs, untouched and leaking its approval down the leather surface. It's getting harder to breathe by the second, but it's impossible to escape, so you let your vision go cloudy, slackening your throat in hopes that he'll finish before you pass out.";
		WaitLineBreak;
		say "     Thankfully, Leon pulls out before you drift away, flopping his slick, shiny cock against your nose and giving your cheek a gentle smack. 'None of that, now. It's better if you can feel it.' He coos, the stinging impact of his hand melting into a gentle stroke that sends a jolt of electricity straight to your cock. That impossibly alluring ram cock disappears, replaced by a view of the wall before you. You wonder if you'll be left there, but a resounding slap on your upturned ass reveals Leon's intentions. It wasn't his hand that hit you, judging by the wet spot you can feel slowly drying. 'You were such a thorn in my side.' Leon muses as he slots his cock between your cheeks, his cock kissing the base of yours for a moment before you it finds your hole. 'But perhaps I was hasty in thinking of you that way. You've been such a good girl.' Cupping your ass cheeks, he presses forward, sheathing his spit-slicked cock in your ass, one agonizingly perfect inch at a time. 'Maybe I can overlook your flaws.' His voice wavers as he hilts, and you feel his cock flexing inside you, its heavy underbelly crushing your prostate. 'Fuck. I could get addicted to this.'";
		say "     Face flush and ass burning with the stretch of the ram's cock; you apologize to Leon for not living up to his expectations, urged on by your natural instinct to submit. It's hard to think as he breeds you, and your body calls out for you to welcome his advances, but all you can do is tighten your hole, clamping around his base and shivering as his cock responds, bucking like an angry horse. Something about this situation feels so right, being a toy for your ram and letting him work off his stress in your eager ass. 'Greedy ewe.' Leon's voice drips with affection as he starts up a heavy rhythm, crushing your prostate and slapping his low-hanging balls against the base of your shaft with every hilt. Hands move upward to your bound arms, and he takes hold of them, using them as a hand to give him the leverage to pound you. 'You're not too sore for me, are you? You'll let me fuck you as long as I want.' It feels less like a question and more like an expression of admiration, but he's right.";
		WaitLineBreak;
		say "     Even though it hurts a little, you can't help how much you want him inside you. The smell and taste of his cock still lingering on your face, the sensation of his muscles slapping against your backside, and even the strain on your shoulders adds to the naughty thrill of being fucked like an animal. It's all perfect, and you can't help your body's reaction, letting out a needy whimper as your cock unleashes its pitiful load to the ground below. 'Fuck.' At a loss for words, Leon takes advantage of your spasming innards, ramming your upturned ass until the impacts bruise your bound body. All premise of restraint has let him, and he yanks your arms back cruelly, his cock bucking and spitting its claim so deep inside you that you're sure even your deepest reaches stink of horny ram.";
		say "     When he cums, your mind blanks, your overstimulated body milking every blast. Nothing else exists but that perfect cock and the evidence that you pleased it. Your ram's pleasure is yours, and your cock dribbles its approval, unable to stop as long as the bloated shaft inside you continues its rampage. Coming to a few hours later on a pile of sheep's wool, you find Leon stroking your hair, his ramhood serving as a perverse pillow for your sticky face. Noticing you're awake, he favors you with a surprisingly gentle smile. 'Such a sweet little thing. You're going to make such a great toy.'";
		WaitLineBreak;
		say "     Lulled by Leon's deep voice, you nuzzle into his manhood, kissing it as though thanking it for the gift oozing out of your sore rear. Sadly, he returns to the storefront before you can coax his shaft back into your mouth, but the sticky evidence of your fun still clings to your face and rump, a sweet reminder of your submission. As the horny fog clears, you can't help but wonder what Leon means by making you into a 'toy.' The possibilities whirl through your head, and your erection leads the way after you gather your gear, joining him in the store. Would it be so bad to allow Leon to use you more often? [italic type]He might keep you as a permanent sex toy. [roman type][line break]";
		if thirst of Leon < 10:
			increase thirst of Leon by 2;

to say LeonWorship:
	if Thirst of Leon > 10:
		say "[LeonBadEnding]";
	else:
		say "     Tripping over your words, you recall that Leon's scent is addictive. Unable to look the cocky ram in the eye, you twiddle your thumbs, mentioning that you'd like another hit of his musk. After all, he's your ram, and you should smell like him! Leon chuckles at your forwardness, leaning over the counter and beckoning you closer. Once you're inches from the ram's face, he leans into your ear, his hot breath tickling it. 'Meet me in the breaking room in 5 minutes. I've got some boxes to move first, but I'm sure you won't mind a little sweat.' Swallowing hard, you nod, shuddering at the warm caress of hot breath on your ear. The promise of more concentrated ram stink excites you, and you almost run to the back of the store, planting your ass on one of the benches in the breaking room and stripping away anything that might stand in the way of your fun. Thankfully for your throbbing balls, you don't have to wait long with your erection pressed between your thighs.";
		say "     'You know, you're more needy than the girls.' Leon's voice breaks you out of your daydreaming. His fur's dripping with sweat, and you can't stop your gaze from following a particularly fat drop down over his abs to collect at the lower curve of his balls, dripping to the concrete below. 'Begging for my dick, asking to be used, asking for a sniff? If I didn't know better, I'd think you were the perfect toy.' Crossing the distance between you, Leon places a hand on your head, bringing your nose into his dripping balls. 'Smell that, ewe? That's a real man's stink. It's just what you asked for. Get your tongue in there.' Swallowing a mouthful of drool, you nuzzle into the earthy scent of the ram's balls, burying your face in loose, heated skin. It's so strong that your head swims, but you keep enough of your wits to follow his command, tracing a long, worshipful path along each orb and sucking each one into your mouth for a long, slow polish. His cock hardens between your eyes, but you're too enamored with the rest of his anatomy to pay attention, letting it droop in your hair and mark you with a steady stream of pre.";
		WaitLineBreak;
		say "     You doubt that Leon would stop you now if you decided to bury your face in other parts of his body. Do you want to bathe any other part of the sweaty ram's body with your tongue?";
		let Leon_Worship_Choices be a list of text;
		add "Follow Leon's taint to his ass." to Leon_Worship_Choices;
		add "Stand up and lick his pits." to Leon_Worship_Choices;
		let Leon_Worship_Choice be what the player chooses from Leon_Worship_Choices;
		if Leon_Worship_Choice is:
			-- "Follow Leon's taint to his ass.":
				LineBreak;
				say "     Hungry for Leon's manly stink, you nuzzle under his balls, lapping at the sensitive, plump flesh behind them. Emboldened by his pleased grunt, you continue along the seam that starts at his balls, his widened stance bringing you to his ass. It's so tempting that you can't help but drag your tongue along that tight, unused star. Sadly, you only get the merest taste before he twitches away. 'Woah there. I might be coming around to your little 'surprise,' but I'm not just going to let you-' Stiffening, Leon seems to contemplate the new sensation, looking down at your musk-drunk face and stroking his cock. 'Fuck, I can't say no to that face. Tongue only. Nothing else.'";
				say "     A muscular rump mashes against your face in moments, giving you unfettered access to the ram's sweaty ass. Steadying yourself with two hands on his hips, you nuzzle between them, seeking the tight tail star beneath his fluttering tail and rewarding his 'sacrifice' with gentle laps that tease his twitching entrance. His flavor's powerful but not unpleasant, and before long, you're spit-shining the entirety of it, your face sandwiched between flexing cheeks. 'Fuck.' The ram relaxes backward into your grip, his hole loosening as your expert tongue work teases him and his hoof hands hard at work stroking his cock. 'Deeper, ewe. Fucking hell.' It seems he's at a loss for words, but judging by his balls drawing up, churning with a pent-up load, you're doing a great job.";
				WaitLineBreak;
				say "     Deciding it's time to show Leon how much you love his scent, you grip his thighs tight, stuffing your tongue past his weakened ring. Swirling over his inner walls, you find his prostate with the tip of your tongue, rolling it mercilessly as more of his weight strains your neck, using your face as a seat. He's bucking like an unbroken bronco, but you refuse to let his ass escape, determined to get him off. Wrenching his ass out of your grip and tearing you away from that tasty hole, the ram whirls, splashing your face with a hefty load as your efforts bring him to orgasm. String after string of musky seed sticks your eyes closed, and all you can do is sit there with your mouth open, swallowing what lands in your mouth and leaving the rest to drip down your chest, marking you with Leon's manly musk. Amid the lusty clouds, you can't help but feel a bit of pride that his load's heftier than usual, courtesy of your efforts.";
			-- "Stand up and lick his pits.":
				LineBreak;
				say "     Sucking in a grateful breath as you break away from Leon's insistent humping and heavenly balls, you stand with difficulty, nuzzling under his arm and burying your face in the sweaty fur there. Sucking at the wooly underarm, you taste his sweat, worshipping the masculine scent that coats your whole world. 'Woah.' Seeming flattered, Leon flexes his bicep, giving you something to hang off of while you slurp his sweat. 'Trying to show off, dirty girl?' He taunts you as you worship, his free arm taking hold of your ass as you grind your excited cock against his leg, feeling his against your stomach. 'Let's give you a better place to sit, then.' Yanking you down to the bench, Leon stuffs his cock between your ass cheeks, claiming your needy hole with authoritative shoves.";
				say "     Riding the raunchy ram with increasingly greedy shoves, you spear yourself on his cock, then mash your face against his underarm, smearing drool and sweat across your messy lips. At some point, you switch sides, moaning into a fresh pit as you snort pure ram, but it isn't enough. You need Leon to claim you more than you need his scent. The ram seems to pick up on your cock-hungry behavior, pinning your face in his underarms and ramming himself home with a grunt. Animalistic rutting ensues, culminating in enough seed to impregnate a parking lot of sheep. Once his cock falls free of your hole, your stomach is visibly swollen, and his balls drip with a heady mix of cum and sweat.";
		if thirst of Leon < 10:
			increase thirst of Leon by 1;
		say "     After a quick suck to clean the evidence of your fun off of Leon's flagging cock, Leon leaves you to marinate in his scent, thanking you for being a good little slut. As he bids you adieu, you can't help but notice that his gaze is hungry, maybe even predatory. Perhaps your submission is [italic type]having an effect. [roman type][line break]";

to say LeonBadEnding:
	say "     Wordlessly, before you can say what you want from him, Leon beckons you into the back, taking a firm grip on your arm. He stays silent as you walk, but his other hand roams downward, slipping between your ass cheeks and stuffing a finger into your twitching hole. The moment Leon has you behind closed doors, the ram whirls you around, ripping your gear from your body and slipping his cock between your ass cheeks. Producing a blindfold, he covers your view, his hand covering your mouth as you attempt to protest his rough treatment. 'I'm tired of pretending, little ewe- Pretending that I'm alright with this sweet little ass wandering the streets when it should be here.' Leon growls in your ear, shoving you up against a nearby locker and stuffing his cock into your fearfully clenched hole. Brutally splitting you open with rough thrusts, he continues. 'You don't want to lose your cock? That's fine. You make a better girl than the others, anyway. But teasing me? Showing me how good it can be, then walking away?' Leaning into your ear as he grabs both of your arms, pinning them against your back in one rough motion that threatens to pop your shoulders from their sockets, he pants in your ear. 'You're about to take on the highest responsibility in this flock.'";
	say "     Torn between wanting to apologize for your perceived behavior and melting against the rough treatment, you only manage to whimper, your sore hole milking that pistoning cock despite the ear setting your chest ablaze. Leon's never been this forceful, but the unfiltered stink of aroused ram screams at your body to submit, resulting in nothing more than a halfhearted squirm and soft spasms around his manhood. Twisting your face to the side as he rams you into the locker, nearly lifting you from the ground with every thrust, Leon mashes his lips against yours, his tongue invading your mouth so deep that his herbivorous teeth clank against yours. It's too hard to think, and the telltale throb of that manhood against your sweet spot has you seeing stars in the darkness, but you tell yourself to at least say something- contemplating biting your ram's tongue to free your mouth from the feral display of affection. Still, it feels so good that nothing comes of your token resistance, naturally widening your stance to take every inch of Leon's cock and pushing your hips back as you feel the first spurts of his orgasm baptizing your innards.";
	say "     You can feel your sanity slipping away as Leon's thrusts speed, showing no signs of stopping. Wet sounds fill the air, and cum drips down your thighs, but you think nothing of it, unable to focus on anything besides the ram's addictive scent, the promise of more loads to fill the aching void in your core soothing your mind.";
	WaitLineBreak;
	say "     'Why don't you stop using that thing? You barely ever want to play with us anymore.' A feminine voice cuts through the darkness. You awaken from your sleep, but even as you open your eyes, you can't see past the soft leather blindfold Leon places on you every night. It's been weeks since he took you as his pet, and every day's been non-stop fucking. You've sucked Leon's cock at least a hundred times by now, and even the thought of it is enough to make your stomach rumble and your tail twitch, begging for your ram to stuff either of your holes. 'I'll toss you a pity fuck later. Learn how to take cock like my toy can, and I'll consider doing it more often.' Tearing away your blindfold, Leon makes his presence known, that beautiful stink cloying around his hard cock as he brings it to bear. It's a daily routine at this point, one that he never breaks.";
	say "     You know the drill- opening your mouth as he grips the curved horns sweeping back along your forehead. Every morning, you worship that delicious cock, suckling at the head and trailing your tongue over its entire length, but days like this are always the best. Leon never fails to fill your stomach with a soothing load whenever he takes charge, and today, he seems worked up, bypassing your lips to delve deep into your throat. 'Time for breakfast, my little ewe. Normally, I'd take you for a shower when you're starting to get this ripe, but it's so fucking hot seeing your muzzle caked in my cum.' Mashing your nose against his pubic fur, Leon takes full advantage of your well-trained throat, dumping what feels like gallons of pre straight to your stomach. Your horns make perfect handlebars for his rough use, and you can't help but feel a bit of pride. You've made your ram very happy with your service. Maybe he'll even let you cum.";
	WaitLineBreak;
	say "     You squirm with delight and grumble around his cock, staring up at him with adoration as your soft member throbs within the prison of its chastity belt, dribbling sticky strings of useless arousal to the thick, damp layer of wool padding your knees as it tries in vain to stiffen within the tight confines of the leather pouch that keeps you from getting aroused. It's been so long since you've gotten hard, but there's something so satisfying about giving up your ability to feel pleasure until Leon gives it back to you, and you can't fault him for teasing you so. Your chained appendages rattle as you try your best to take more of the ram's cock, despite your lips pressing firmly against his base and the comforting warmth of the armbinder keeping you sitting pretty for him, your legs forced wide by a spreader bar. At first, the position you sit in most of your waking hours was uncomfortable, but as the leather gear softened with use and with the copious amounts of cum soaking into it, you've begun to seek comfort in it. Nothing feels better than kneeling for your ram. Nothing matters as much as pleasing his cock.";
	say "     Even on the rare occasion your master offered to let you free, to join him in his bed, you found yourself begging to return. The comforting spurt of Leon's first shot of the day brings you back to the present, and you dutifully fight the urge to swallow his gift. Instead, to show your appreciation, you open your mouth, letting him watch your tongue wiggle in the gooey meal before letting yourself gulp it down, thanking your ram's cock with gentle kisses and nuzzling against his slackening grip as if asking for more. As he takes a firmer grip, his flagging erection dragging across your lips, you sink back into depraved servitude, allowing your consciousness to melt away again, possibly for the last time.";
	wait for any key;
	end the story saying "You have joined the flock as Leon's newest stress relief toy, affectionately referred to as his 'Male Ewe.'";
	now battleground is "void";
	wait for any key;
	now skipturnblocker is 1;
	follow the turnpass rule;
	stop the action;

Leon ends here.