Version 3 of Angie by Sarokcat begins here.
[Version 3 - Whole file rebuilt and expanded - by Wahn]

[ Variables:                                   ]
[                                                             ]
[ AngieHappy - location + readiness for sex                   ]
[  0: starting stage                                          ]
[  1: Angie NPC moved to the Gift Shop                        ]
[  2: player found the catnip                                 ]
[  3: player delivered the catnip to Angie                    ]
[  4: mated to the player                                     ]

[ AngieTalk - reward for saving her                           ]
[  0: starting stage                                          ]
[  1: player got a medkit                                     ]

[ Dexterity of Angie - feline porn                            ]
[  0: not told the player yet                                 ]
[  1: told the player about it                                ]

[ AngieAroused - sex/relationship                             ]
[  0: starting stage                                          ]
[  1: player+Angie had sex                                    ]
[  3: often had sex with the player, developing attraction    ]
[  6: often had sex with the player, admitting attraction     ]
[  7: Angie in anthro partner for the player mode             ]
[ 50: Angie in wild panther mode                              ]
[                                                             ]

AngieHappy is a number that varies.
AngieTalk is a number that varies.
AngieAroused is a number that varies.
LastAngieLearned is a number that varies. LastAngieLearned is usually 250.

Section 1 - Finding Angie

Table of GameEventIDs (continued)
Object	Name
AngieTrapped	"AngieTrapped"

AngieTrapped is a situation.
The sarea of AngieTrapped is "Zoo".
when play begins:
	add AngieTrapped to badspots of hermaphrodite;
	add AngieTrapped to badspots of furry;

Instead of Resolving a AngieTrapped:
	if AngieHappy is 0:
		say "     Wandering along the zoo pathways, you hear several of the creatures roaming the zoo apparently fighting nearby. Curious, you move slightly closer to investigate and see that a few of the beasts are indeed fighting outside one of the smaller animal pens. You really aren't sure what they are fighting about, but it could be dangerous to interfere. Do you do so anyways?";
		if player consents:
			LineBreak;
			say "     Deciding that whatever this is about, it might be best if you intervened. You step forward and prepare to fight!";
			fight;
			fight;
			project the figure of Angie_icon;
			say "     As you recover from your recent exertions, you hear a voice call out from the small den the creatures were fighting outside of. 'Is it safe now?' the voice calls, causing you to turn your head and see the face of a female black panther wearing a zookeeper's hat stick itself out, looking around before the rest of the body follows. You find yourself staring at her changed body as she steps into sight fully and comes to stand before you on digitigrade paws. The woman's face is a blend of panther and human, bearing a friendly expression as she examines you in turn. She is wearing the remains of what was obviously a zookeeper's uniform.";
			say "     The clothes have seen better days however, as her beige mesh vest hangs open, revealing a shirt that is torn almost all the way down and now does nothing to conceal the rather large breasts that obviously expanded enough to tear it apart. Her shorts are in even worse shape, having obviously had something large claw a hole in the crotch for easier access. The gap reveals not only her new panther snatch, damp with obvious arousal, but also shows the hermaphrodite's erect, panther-like cock, its soft barbs easily visible.";
			WaitLineBreak;
			say "     Noticing where your gaze has strayed, the former zoo employee coughs, drawing your attention back to her muzzle. 'Thanks for driving those two off. I was sure I was about to get mounted and bred, and this time I don't think I would have managed to get away again. To be honest... I'm not sure I would have wanted to if it was as good as...' Her voice trails off, before she catches herself daydreaming and continues.";
			say "     'Err - sorry for zoning out on you like that. My name's Angie. We really should get to a safer spot. Staying in the open isn't a good idea - who knows what other creatures might have been attracted by the fighting here? Hm, I know that the zookeeper's office and the storage sheds at the back of the zoo are... occupied. How about the exhibits near the entrance? Ah, or the gift shop! That was clear when you came in? Great, let's go!'";
			increase AngieHappy by 1;
			move Angie to the Zoo Giftshop;
			move player to the Zoo Giftshop;
			now Resolution of AngieTrapped is 1; [rescued Angie]
		else:
			LineBreak;
			say "     Deciding it might be best to let them fight amongst themselves, you continue on your way.";
			now Resolution of AngieTrapped is 2; [didn't rescue Angie (yet?)]
	else if AngieHappy is 1:
		say "     Traveling down the zoo pathways, you hear some strange sounds coming from one of the enclosures. Taking a cautious look, you see what appears to be a large, panther-like beast, growling and chuffing as it tries to reach something that appears to have fallen into a narrow space beside the den. You watch for a while as the beast tries increasingly desperate measures to get at whatever is stuck in there, before he eventually gives up and stalks off in a huff. Curiosity getting the better of you, you go down to investigate and find that some small, cloth-wrapped packet has rolled into the crack.";
		say "     Grabbing a nearby branch, you manage to push the small bundle far enough to the front for you to reach and take it, finding the packet surprisingly light. As you take a look at it, you see that it's filled with some kind of dried plant matter. [if facename of player is listed in infections of Felinelist]The smell of the stuff in there is just amazing, waking the desire to sniff it, eat it, roll around in it in you. Only with some willpower do you manage to wrap it up tight again, tucking the packet away for later investigation, then[else]While it seems to exude a nice, pleasantly minty odor, you can't quite tell why the big panther wanted it so badly. Shrugging, you decide to tuck it away for further investigation later and[end if] continue through the zoo.";
		LineBreak;
		say "[bold type]You gain a package of catnip![roman type][line break]";
		increase carried of catnip by 1;
		now AngieHappy is 2;
		now Resolution of AngieTrapped is 3; [found catnip]
		now AngieTrapped is resolved;

catnip is a grab object. It is not temporary.

Table of Game Objects (continued)
name	desc	weight	object
"catnip "	"A small packet of catnip. It's pretty light, containing only dried, fragrant leaves."	0	catnip

the usedesc of catnip is "[catnip use]";

instead of sniffing catnip:
	say "[catnip use]";

to say catnip use:
	say "You open the packet of catnip and take a deep whiff. ";
	if facename of player is listed in infections of Felinelist:
		say "As you're feline yourself, the intoxicating scent of the plant hits you like a sledgehammer. You're so taken with the heavenly stuff that you can't help yourself but rub your nose in the dried leaves, licking some of them up and chewing them. As buzzed and horny as you are from the effects, you barely notice - or care - that you're scattering most of the dried catnip on the ground as you do so.";
		increase libido of player by 100;
		decrease carried of catnip by 1;
	else:
		say "It smells nice, somewhat like mint, but you don't see how a cat could go crazy over this. Maybe you have to be a feline yourself to understand...";



Section 2 - Zoo Giftshop

Table of GameRoomIDs (continued)
Object	Name
Zoo Giftshop	"Zoo Giftshop"

Zoo Giftshop is a room.
Zoo Giftshop is west of Zoo entrance.

the scent of Zoo Giftshop is "[zoogiftscent]".
The earea of Zoo Giftshop is "Zoo".

to say zoogiftscent:
	if AngieAroused > 0:
		say "     The musky scent of panther sex fills the air in here.";
	else if AngieHappy > 0:
		say "     As Angie's new home, the gift shop smells of panther.";
	else:
		say "     The air is thick with the scent of the many animals that have been through here.";

The invent of Zoo Giftshop is { "chips", "soda" }.

The description of Zoo Giftshop is "[shopappearance]".

to say shopappearance:
	if AngieAroused is 50: [ Angie + Midnight in the gift shop ]
		say "     The zoo's gift shop looks decidedly different now. Much of the destroyed merchandise has been thrown out at this point, and the floor is relatively clear and clean. The destroyed soda and snack machines are still standing over in the corner, although it looks like Angie has probably gone through and recovered anything of use from them already. The walls of the shop are now decorated with posters of large cats running and posing, with the pictures of panthers being the most prominently displayed, and various other feline-themed merchandise has been scattered over the shelves. It looks like Angie has laid out a number of animal print blankets over in the corner near the register counter for her and Midnight to sleep on, although from the musky scent of feline arousal filling the air, you doubt that sleeping is the main priority for either of them.";
	else if AngieHappy > 0: [ Angie moved into the gift shop ]
		say "     The zoo's gift shop is looking much better now that Angie is here. Much of the destroyed merchandise has been swept into one corner to be sorted through at some point, leaving the rest of the floor relatively clear. The destroyed soda and snack machines are still standing over in the corner, although it looks like Angie has probably gone through and recovered anything of use from them already. The shelves that once held the books on the various animals throughout the zoo now hold stacks of rescued papers instead, Angie obviously saving the most legible pieces from the various destroyed books in case they might be useful later. There is a small [']Employees Only['] door behind the counter, leading to the break-room and the employees bathroom.";
	else: [ base state without Angie ]
		say "     The zoo's own little gift shop, this place is decorated in safari paraphernalia and merchandise bearing the images of various animals. Unfortunately, it seems several of the animals have decided to pay the shop a visit themselves, and much of the merchandise has been clawed or strewn around the floor. Special attention seemed to have been paid to the soda and snack machines, which have been smashed open and their contents mostly emptied around the room, though you think there might be a few items left if you look hard enough. Looking around, you spot a section that at one time was full of books detailing the habits and practices of many of the zoo animals. These could have at one point been very useful to you in your current situation, if they weren't already clawed near to bits. There is a locked door behind the cashier's counter marked [']Employees Only['].";


Table of Game Objects (continued)
name	desc	weight	object
"feline porn"	"     A small stack of pages from various nature books, describing the mating habits of the different types of big cats, intermixed with a number of photographs of a majestic lion. The beast is shown in his enclosure in the zoo, then a few of him mounting a lioness and a picture of him rolled on his back, with a human hand rubbing his belly. The following pics depict said hand (which must be Keith's) rubbing quite a bit lower and soon wrapping around the lion's erect cock. This is definitely a collection for enthusiasts about felines..."	1	feline porn

feline porn is a grab object. It is part of the player. It is not temporary.

the scent of the feline porn is "The bundle of pornographic texts and photos have a lingering scent of sex to them.".

instead of using feline porn:
	if player is neuter:
		say "     Lacking any real gender of your own, you find the photos and stories rather unsatisfying and put them away.";
	else if libido of player < 25:
		say "     You're not that turned on and really should focus on more important things right now.";
	else if libido of player < 50:
		say "[SimpleFelineMast]";
	else:
		say "     Pulling out your feline porn, you look over the assorted stories and photos in search of something of interest. Shall you have a quick session to relieve a little pressure (Y) or do you want to draw it out and really let off some steam (N)?";
		if player consents:
			say "[SimpleFelineMast]";
		else:
			say "     You settle yourself down to really enjoy some personal time and relieve your excess arousal. You pull out a selection of the merchandise showing graceful feline shapes, in addition to a few of Keith's pictures, and begin playing with yourself. You start by rubbing over your [bodyname of player] body[if breast size of player > 8], caressing your nipples and teasing your huge breasts, running your fingers over their sensitive flesh[else if breast size of player > 5], caressing your nipples and teasing your large breasts, running your fingers over their sensitive flesh[else if breast size of player > 2], caressing your nipples and teasing your large breasts, running your fingers over their sensitive flesh[else] and teasing your nipples[end if][if breasts of player > 2]. You lavish attention upon each pair in turn, helping to get yourself wound up for a bigger release[end if].";
			if player is herm:
				say "     Being a herm, you place a hand at your cock[smn] and the other at your cunt[sfn] and start playing with them. You stroke your [cock size desc of player] [cock of player] shaft slowly at first while fingering the wet folds of your puss[yfn]. Precum dribbles onto you while your feminine juices soak your other hand. You move your hand away from time to time to rub your [ball size], feeling the pressure build up in them.";
				if companion of player is mouse girl:
					say "     As you continue to play with yourself, your mind wanders to thinking of sexy mice and all the fun things you could do with them. Glancing over, you spot Rachel sitting nearby, playing with herself as she watches you. She grins at you knowingly as fresh images of you surrounded by horny mice fill your mind. Moaning, you become even more aroused and play with yourself even more vigorously. You even start to share in the mouse girl's sensations as well.";
				say "     You keep teasing yourself, holding back your orgasm a little longer, wanting to really enjoy it... until finally you moan loudly and cum hard, releasing a [if cock width of player < 12]sizable blast[else if cock width of player < 25]stream[else]veritable torrent[end if] of thick semen, creating a messy pool of your seed as you spray it onto yourself and the ground nearby. Your cunt quivers and squeezes down around your fingers, [if libido of player < 75]soaking your hand[else if libido of player < 90]sending your juices down your legs until a small puddle is formed[else]blasting a gush of feminine juices that soaks your thighs and runs down your legs to form a large, musky puddle[end if]. You keep stroking and pumping until you're left panting and moaning, almost passing out from the much-needed release.";
			else if player is male:
				say "     You take hold of your [if cocks of player > 1]cocks and start playing with them[else]cock and start playing with it[end if]. You stroke your [cock size desc of player] [cock of player] shaft[smn] slowly at first, pleasing yourself as only you can, knowing just what feels right. Precum dribbles down your meat to get spread over it as you stroke yourself. You move a hand away from time to time to rub your [ball size], feeling the pressure build up in them.";
				if companion of player is mouse girl:
					say "     As you continue to play with yourself, your mind wanders to thoughts of sexy mice and all the fun things you could do with them. Glancing over, you spot Rachel sitting nearby, playing with herself as she watches you. She grins at you knowingly as fresh images of you surrounded by horny mice fill your mind. Moaning, you become even more aroused and play with yourself even more vigorously. You even start to share in the mouse girl's sensations as well.";
				say "     You keep teasing yourself, holding back your orgasm a little longer, wanting to really enjoy it... until finally you moan loudly and cum hard, releasing a [if cock width of player < 12]sizable blast[else if cock width of player < 25]stream[else]veritable torrent[end if] of thick semen, creating a messy pool of your musky seed as you spray it onto yourself and the ground nearby. You keep stroking and pumping until you're left panting and moaning, almost passing out from the much-needed release.";
			else if player is female:
				say "     You move your hands down to start fingering the wet folds of your puss[yfn]. You work [if cunt width of player is 1]a finger[else if cunt width of player < 4]a pair of fingers[else if cunt width of player < 6]a trio of fingers[else]a trio of fingers and eventually your whole hand[end if] into your gripping, squeezing vagina. You rub and tease along your inner walls and make sure to pay proper attention to your sensitive clit.";
				if companion of player is mouse girl:
					say "     As you continue to play with yourself, your mind wanders to thinking of sexy mice and all the fun things you could do with them. Glancing over, you spot Rachel sitting nearby, playing with herself as she watches you. She grins at you knowingly as fresh images of you surrounded by horny mice fill your mind. Moaning, you become even more aroused and play with yourself even more vigorously. You even start to share in the mouse girl's sensations as well.";
				say "     You keep teasing yourself, holding back your orgasm a little longer, wanting to really enjoy it... until finally you moan loudly and cum hard, [if libido of player < 75]soaking your hand[else if libido of player < 90]sending your juices down your legs until a small puddle is formed[else]blasting a gush of feminine juices that soaks your thighs and runs down your legs to form a large, musky puddle[end if] as your cunt quivers and squeezes down around your fingers. You keep rubbing and fingering yourself until you're left panting and moaning, almost passing out from the much-needed release.";
			let muskwave be ( libido of player + ( cock width of player * 3 ) + ( cunt width of player * 5 ) );
			now libido of player is libido of player / 4;
			decrease humanity of player by a random number between 2 and 5;
			if "Strong Psyche" is listed in feats of player, increase humanity of player by a random number between 0 and 1;
			if "Weak Psyche" is listed in feats of player, decrease humanity of player by a random number between 0 and 1;
			if the companion of player is mouse girl:
				decrease humanity of player by 2;
				if "Strong Psyche" is listed in feats of player, increase humanity of player by a random number between 0 and 1;
				if a random chance of 2 in 3 succeeds:
					if a random chance of 1 in 2 succeeds, now researchbypass is 1;
					infect "Mental Mouse";
					decrease humanity of player by 1;
					now researchbypass is 0;
				now libido of player is ( 5 * libido of player ) / 6;
			if the location of player is not sleepsafe:
				while muskwave > 50:
					if a random number between 1 and 200 < muskwave:
						say "     As you're resting and recovering from your massive orgasm, a nearby creature is drawn in by the musky aroma of your sexual fluids before the scent can dissipate.";
						let l be a random visible dangerous door;
						if l is not nothing, now battleground is the marea of l;
						if l is nothing, now battleground is "Outside";
						fight;
					decrease muskwave by 75;
			follow the turnpass rule;

to say SimpleFelineMast:
	say "     You settle yourself down to [if player is herm]play around with your junk for a bit[else if player is male]jerk yourself off briefly[else]give yourself a quick fingering[end if]. You grab one of the photos for added inspiration and get yourself off, relieving some of your excess arousal";
	if the companion of player is mouse girl:
		say ". Partway into your masturbatory session, thoughts of sexy mice slip into your mind.";
		decrease humanity of player by 1;
		if a random chance of 1 in 2 succeeds:
			if a random chance of 1 in 2 succeeds, now researchbypass is 1;
			infect "Mental Mouse";
			decrease humanity of player by 1;
			now researchbypass is 0;
		now libido of player is ( 9 * libido of player ) / 10;
	else:
		say ".";
	now libido of player is ( 4 * libido of player ) / 5;


Section 3 - Angie

Table of GameCharacterIDs (continued)
object	name
Angie	"Angie"

Angie is a woman.
The description of Angie is "[AngieAppearance]".
The conversation of Angie is { "Mewl!" }.
The icon of Angie is the figure of Angie_icon.


to say AngieAppearance:
	if debugactive is 1:
		say "DEBUG -> ANGIEHAPPPY: [AngieHappy], ANGIEAROUSED: [AngieAroused], ANGIETALK: [AngieTalk], DEXTERITY: [Dexterity of Angie] <- DEBUG[line break]";
	if AngieAroused is 50: [ Angie in wild-panther mode with Midnight ]
		say "     The six-foot tall black panther herm that you brought back from the zoo-grounds is happily wandering around the gift shop. She looks slightly more bestial now that she has given in to her new body's urges so completely. Her large, black furred breasts swinging freely as she moves things around in the shop, Angie has obviously abandoned any pretense of being human, as she is now clad only in her soft black fur. Her long panther tail lashes behind her teasingly, and her half-erect feline cock pokes seductively out of its sheath above her damp female sex.";
		say "     She shoots you a teasing smile as she notices you watching her, pausing for a minute to stretch and give you good view of her partially feline body, balancing easily on her large paws as she stalks around the shop with fluid grace.";
	else if AngieAroused is 7: [ Angie in anthro partner mode with the player ]
		say "     The six-foot tall black panther herm that you brought back from the zoo-grounds is happily wandering around the gift shop. She sports a nice rack of large breasts, more presented than hidden by the tight, purple tube top she's started wearing recently. Below, she has a pair of comfortable pants on, held up by a loose drawstring that allows her to strip them off at a moment's notice. It's pretty obvious why she feels the need for that - the bulge of her sizeable cock is easily visible through the fabric, showing a lengthy outline that promises quite a bit of fun for anyone who gets to ride it. Behind her, Angie's long black tail lashes idly from left to right.";
		say "     She shoots you a teasing smile as she notices you watching her, pausing for a minute to stretch and give you good view of her partially feline body, balancing easily on her large paws as she stalks around the shop with fluid grace.";
	else:
		say "     Standing over by the counter, eyeing the destruction in the store sadly, is a six-foot tall black panther. She sports a nice rack of large breasts, barely hidden by her stretched and torn shirt. Layered on top of that, she wears her zoo worker's vest, though it too is several sizes too small for her new frame. She has replaced her torn shorts with a short khaki skirt that features a cheerful, waving little lion on it. The skirt does little to hide the bulge where her new cock presses against the fabric, and her long black tail lashes idly behind her, lifting the rear of it up for easier access. Despite her somewhat disheveled appearance, she seems to balance easily on her paws, her movements swift and smooth like that of the hunting cat she now resembles.";

the scent of Angie is "Angie's scent is that of a hermaphrodite panther[if AngieAroused > 1], heavy with the smell of sex and[else] with a hidden scent of suppressed[end if] arousal.".

instead of conversing the Angie:
	if carried of catnip > 0 and AngieHappy < 3:
		say "     Angie smiles at you and says, 'Hey, welcome back. Did things... go... ok... Wait... what's that wonderful smell?' Her panther-like nose twitches as she takes in the scent of the air around her, then focuses on you, sniffing down your clothes until she finds the small wrapped packet of leaves in your pocket. 'That smell... his smell... and something else... please, can I have it? I just... need more of it...' Angie says with a slightly dreamy look on her face.";
		LineBreak;
		say "     Do you give her the packet?";
		if player consents:
			LineBreak;
			say "     'Thanks, I just... I have to smell more of that,' Angie says in a slightly distracted tone, watching intently as you fish the packet out and hand it to her. As soon as you hold the packet out to her, she snatches it up and immediately brings it too her muzzle for a good long sniff. You watch as her eyes close in pleasure as she inhales, then almost absentmindedly begins rubbing the small packet over her nose and face with one of her hands, while the other reaches under her skirt and begins stroking herself. Seeming to have completely forgotten your presence, Angie moans as she leans back against the shop counter, her large breasts heaving as she fills her lungs with the intoxicating scent of the bag's contents.";
			say "     'God this... smell, I should know this smell,' Angie gasps out, her voice sounding strangely unfocused and happy. 'Never smelled... anything... so good... before, it's making me... so very hot,' she moans, the hand stroking her cock rising up to play with her large breasts. You find yourself transfixed by the strange erotic show Angie is putting on for you without even realizing it. Suddenly her eyes shoot open, and her hands stop moving for a second, 'Catnip! Dammit, I knew it!' Angie exclaims, then moans again, unable to stop herself from taking another long sniff from the wrapped packet. 'God! It's good! Oh damn,' Angie says, beginning to run her free hand down her body again.";
			WaitLineBreak;
			say "     'This, this is what we kept for the big cats...,' she continues absentmindedly, and you aren't even sure if she remembers you are in the room with the way she is panting and moaning as she touches herself. 'Big cats... like him... mmm I can smell him on it... smells so good... mmm what was it about catnip, something, should remember... but it's making me... need him more...' The panther herm moans as she seems to be reliving some erotic memory as she rubs the panther scented catnip on herself.";
			say "     'So strong... mmm, his cock, harder,' Angie moans, obviously lost in lust, her free hand now rubbing underneath her stiff barbed cock as she massages her female opening, 'So aroused, catnip, mild aphrodisiac... mmm... to cats, mmm that was it, oh fuck me,' Angie yowls, her hands both lowering to her genitals as she drops the catnip packet somewhere on the floor and she pumps her cock with one hand and her pussy with the other. She lets out another long cat-like yowl as she sprays her seed over her chest, and a rush of wetness explodes out from between her thighs.";
			WaitLineBreak;
			say "     Panting, she leans back against the counter, her tail lashing behind her in satisfaction as she just stands there for a moment, before finally coming back to herself. 'Oh shit,' Angie says as she takes a look down her front, covered in her own sticky panther cum, and then glancing up at you. 'Wow that was... um I had better get cleaned up now I guess,' she says, seeming embarrassed slightly, but also still seeming even more aroused than ever. 'Thanks for finding that catnip though, God, I guess I just didn't know what I was missing there, sex like this, is just so... amazing...' Angie says with a happy grin.";
			say "     'I almost wish I knew where that panther was so I could go and... Well never mind, I better get cleaned up and put that catnip somewhere safe for now... until next time anyways,' Angie says as she begins to head to the shop bathroom, although you don't think she intended you to hear that last part.";
			now AngieHappy is 3;
			decrease carried of catnip by 1;
		else:
			say "     Angie sighs as you cover the small bundle up more securely, 'Maybe, maybe that's for the best,' she says, her feline eyes still fixed on where you put the packet. 'That scent is very... distracting,' she continues, half panting as her nipples press out, spreading her vest open even farther. Still, no matter how relieved at your decision she tries to act, she still seems somewhat disappointed, though you decide not to press her on that, for now at least.";
			LineBreak;
			say "     You doubt you can have a normal conversation with Angie when she's in a state like this. Maybe you should just give her the packet, or stash it somewhere else...";
	else:
		say "[AngieTalkMenu]";

to say AngieTalkMenu:
	now sextablerun is 0;
	blank out the whole of table of fucking options;
	[]
	choose a blank row in table of fucking options;
	now title entry is "Ask about her past";
	now sortorder entry is 1;
	now description entry is "Have her tell you what happened before you found her";
	[]
	choose a blank row in table of fucking options;
	now title entry is "Talk about the zoo";
	now sortorder entry is 2;
	now description entry is "Speak with her about the zoo and gift shop";
	[]
	choose a blank row in table of fucking options;
	now title entry is "Ask about her";
	now sortorder entry is 3;
	now description entry is "Ask how she feels about being an anthro panther";
	[]
	choose a blank row in table of fucking options;
	now title entry is "Just chat with her";
	now sortorder entry is 4;
	now description entry is "Do a bit of small-talk with Angie";
	[]
	if AngieAroused > 0:
		choose a blank row in table of fucking options;
		now title entry is "Tell her about your adventures";
		now sortorder entry is 5;
		now description entry is "Tell Angie what's going on in the city";
	[]
	choose a blank row in table of fucking options;
	now title entry is "Learn from Angie";
	now sortorder entry is 6;
	now description entry is "Let her teach you something useful about animals";
	[]
	if AngieAroused is 7 and AngieHappy < 4:
		choose a blank row in table of fucking options;
		now title entry is "Agree to be her mate";
		now sortorder entry is 7;
		now description entry is "Become Angie's mate";
	[]
	sort the table of fucking options in sortorder order;
	repeat with y running from 1 to number of filled rows in table of fucking options:
		choose row y from the table of fucking options;
		say "[link][y] - [title entry][as][y][end link][line break]";
	say "[link]0 - Nevermind[as]0[end link][line break]";
	while sextablerun is 0:
		say "Pick the corresponding number> [run paragraph on]";
		get a number;
		if calcnumber > 0 and calcnumber <= the number of filled rows in table of fucking options:
			now current menu selection is calcnumber;
			choose row calcnumber in table of fucking options;
			say "[title entry]: [description entry]?";
			if player consents:
				let nam be title entry;
				now sextablerun is 1;
				if (nam is "Ask about her past"):
					say "[AngieTalk1]";
				if (nam is "Talk about the zoo"):
					say "[AngieTalk2]";
				if (nam is "Ask about her"):
					say "[AngieTalk3]";
				if (nam is "Just chat with her"):
					say "[AngieTalk4]";
				if (nam is "Tell her about your adventures"):
					say "[AngieTalk5]";
				if (nam is "Learn from Angie"):
					say "[AngieTalk6]";
				if (nam is "Agree to be her mate"):
					say "[AngieTalk7]";
				wait for any key;
		else if calcnumber is 0:
			now sextablerun is 1;
			say "     You step back from the pantheress, shaking your head slightly as she gives a questioning look.";
			wait for any key;
		else:
			say "Invalid Option. Pick between 1 and [the number of filled rows in the table of fucking options].";
	clear the screen and hyperlink list;

to say AngieTalk1: [talking about her past]
	let randomnumber be a random number from 1 to 4;
	if randomnumber is:
		-- 1:
			say "     Angie explains, 'I work here, or at least I used to, as one of the big cat handlers. Of course that all changed a little bit ago, when I went to take care of the panthers, and I found out that Midnight, one of the male cat was waiting there to take care of me instead. He was on me so fast, forcing me down and then fucking me, god it was so good,' Angie says, her eyes going unfocused for a minute as she pants at the memory. 'I didn't know what was going on, but I couldn't bring myself to stop him, it was probably the best I've ever felt in my life, being his feline fuck toy,' she says with a moan.";
			say "     'But he wasn't the only one of the cats that got loose, and before he could finish making me into his pet fully, he got interrupted by one of the other cats. While the two of them squabbled over me, I managed to crawl away and lock myself in one of the side rooms while my changes finished. Once I managed to recover I started sneaking around the zoo-grounds, to see if I can figure out what's going on, or if I can find some supplies. Unfortunately,' Angie says with a sigh, 'That's when those other two managed to find and corner me, and then you showed up. I'm grateful to you for your help there.'";
		-- 2:
			say "     Angie explains, 'I've always loved animals, so I did an internship here while still in school, then later went on to study zoology at Tenvale College and got a real job here. Caring for all these animals is a very fulfilling job, a bit dirty sometimes when you have to clean up the enclosures, but nothing I can't live with.' Her face takes on a thoughtful expression as she continues, 'I really hope my animals are okay - may they be in the zoo or out in the city. Even though a few tried to jump and mount me - and Midnight did much more than try - I do still care about all of them.'";
		-- 3:
			say "     Angie explains, 'There were some reports about strange occurrences on the radio the morning of the day everything went to hell, but I didn't listen too closely and just switched over to some nice music. Who was I to know what would happen next...'";
		-- 4:
			say "     Angie muses, 'I think us zookeepers must have been the first to be transformed, with almost everyone in the animal enclosures when this chaos started. Or maybe it was someone in the petting zoo area - I can only imagine the scenes when the animals suddenly started petting back...'";

to say AngieTalk2: 		[talking about the zoo]
	if AngieTalk is 0: [giving the player a reward medkit in here]
		say "     Looking around in the gift shop, Angie says, 'It's sad to see this place is in such a state. Still, it's no surprise considering what the rest of the zoo is like.' She sighs wistfully as she looks over the devastation before turning her golden eyes back to you. 'Thanks again for your help out there. I really appreciate it,' Angie says, a grateful smile crossing her muzzle. 'I'm still getting used to all the changes, both in me and in the zoo itself, but I'll help you out any way I can to pay you back for earlier. There might still be some useful supplies out in the zoo as well.' She pats her forehead with a paw and says, 'Oh, that reminds me - I recovered a couple med-kits from the employees room. You should take one of them,' she says, then hands you a medkit.";
		increase carried of medkit by 1;
		now AngieTalk is 1;
		say "You received a medkit!";
	else if AngieTalk is 1: [already gave the player a medkit]
		say "     'If you see anything else out there you need help with let me know, I'm going to be staying around here for a while trying to see if I can find some of the emergency stashes, I know there are several around here,' Angie says, then sighs and admits, 'Plus I just can't really bear to leave the zoo, I really loved this place you know? It's hard seeing it like this, and I worry about the animals out there in the city, of course,' she says as she pauses to think about it for a second, 'I suppose I count as one of those animals now myself too, it's almost scary how tempting it is sometimes to just give in to these new instincts...'";
		say "     'I just don't think I can trust myself to go out there with you, if it got to be too much I might actually end up helping some of those wonderful beasts hold you down and fuck you while I...' Her voice trails off a minute as she blushes in embarrassment, although you note her cock is pushing up on the front of her skirt as her tail lashes behind her excitedly. 'Um yeah let's just say it's best if I stay here for now.'";

to say AngieTalk3: [ask about her]
	if AngieAroused is 50: [ Angie in wild panther mode]
		say "     'Hey, welcome back,' Angie says with a bit of a purr. 'It's great to see you again, and I can't thank you enough for bringing Midnight here!' The large panther herm stretches her naked feline form out for you to watch, giving you a seductive smile while playing with her nipples. 'It's soo good to be together with him at last, be a sexy play-toy for him to mount. And you too, whenever you want. That's the last thing I can do for you. Unless you wanna let Midnight mount you and join me as his playmate?'";
	else if AngieAroused is 7: [ Angie in anthro partner mode]
		say "     'Hey sexy,' Angie says with a loud purr, walking up to you to pull you into a kiss. 'It's great to see you again, and I can't thank you enough for showing me how much fun this new body of mine could be!' the large panther herm says as she stretches her feline form out. 'God! I just love my anthro shape now, and all the fun we've had. Must have been fate that I first got transformed by Midnight and then ran into more trouble, only for you to come along and save me. From there, it just seems so right that we got to know each other... and then REALLY got to know each other.' Lust flares up in her eyes as she looks up and down your body, a hand moving to rub the bulge in her pants. 'Mmmh - I'm horny again. You wouldn't believe how much I look forward to feeling you stretched around my shaft,' she adds, arousal at that fantasy clearly audible in her voice.";
		say "     The sexy pantheress steps up to you, brushing her curvy body against your side. While stroking your chest with one hand, she says in a husky whisper, 'Why don't you just stay here with me instead of going out into the city again? I miss you when you're out... and your help would be great for me to get this zoo under control too. Even if you just stayed here in the shop, you know. Having a sexy lover to return to after wrestling bears and catching zebras. I'd be looking forward to it every minute - coming back here and... relaxing with you.' Snaking an arm around your hips and giving your ass a quick grope, Angie winks suggestively, her tail lashing behind her excitedly.";
		WaitLineBreak;
		if Dexterity of Angie is 0:
			say "     'Don't you miss me when you go out there too? I bet you're getting hungry for some feline loving when you're away so long. But while I would of course prefer you to come here - or stay here - I do have something to help you with your desires if you can't, my love. You see, I've been moving all the cat merchandise I could find into the break room here. That and... some photos I found in Keith's locker when I ducked outside and checked the zookeeper lockerroom. Since I saw Keith strip and offer himself willingly to get mounted by our lion Kusabi when everything started going crazy, I guess he was pretty into the big, proud beast. Never would have thought it of him, but... I see the attraction now. Well, with him becoming a lioness ready to bear her first litter soon, I've inherited his pics to add to my own stash of big cat porn. You can take a few select pieces I put over there on the counter. Just think of me when you use it...' She gives you a wink and nods towards the stack of feline porn as her tail lashes behind her excitedly.";
		say "     Then she composes herself, changing the topic to shake off the urge to just whip out her cock right now and grab you. Angie says, 'I could train you to be my assistant too. Teach you a few things about how to handle yourself and the animals out there.' Then she adds with a feline smile, 'But I know you'll want to go out into the city again, so... don't be away too long - I'll be waiting for your return to have some more fun,' she purrs with a teasing wink before going back to what she was doing, showing off with a sultry sway of her hips and tail as she walks away.";
		if Dexterity of Angie is 0:
			now Dexterity of Angie is 1;
			add "feline porn" to invent of Zoo Giftshop;
	else if AngieAroused > 5: [ admitted feelings for the player ]
		say "     'Hey, welcome back,' Angie says with a bit of a purr. 'It's great to see you again, and I can't thank you enough for showing me how much fun this new body of mine could be!' the large panther herm says as she stretches her feline form out for you. 'God! I just love my anthro shape now, and all the fun we've had. Maybe it's for the best that I didn't stay with Midnight, so we could meet. I like being with you and...' Lust flares up in her eyes as she looks at you and moves a hand to rub the bulge under her skirt. 'Mmmh - I'm horny again. You wouldn't believe how much I look forward to feeling you stretched around my shaft. Although... there is this voice at the back of my mind, telling me I should be Midnight's willing sex toy and let him mount me again and again,' she adds, arousal at both these scenarios clearly audible in her voice. 'Still, I think I better stay here for now since someone has to take care of this place. And - well,' she admits, looking around a bit guiltily, ";
		if Dexterity of Angie is 0:
			say "'I have kinda been moving all the cat merchandise I could find into the break room here. That and... some photos I found in Keith's locker when I ducked outside and checked the zookeeper lockerroom. Since I saw Keith strip and offer himself willingly to get mounted by our lion Kusabi when everything started going crazy, I guess he was pretty into the big, proud beast. Never would have thought it of him, but... I see the attraction now. Well, with him becoming a lioness ready to bear her first litter soon, I've inherited his pics to add to my own stash of big cat porn. You can take a few select pieces I put over there on the counter. Just think of me when you use it...' She gives you a wink and nods towards the stack of feline porn as her tail lashes behind her excitedly.";
		else:
			say "'there's always my stash of sexy cat pictures in the break room. Nothing against the real thing with you, but... it'll tide me over while you're out.' She gives you a wink as her tail lashes behind her excitedly.";
		say "     Changing the topic to shake off the urge to just whip out her cock right now and grab you, Angie says, 'If you need any help, just let me know, and maybe I can teach you a few things about how to handle yourself and the animals out there sometime. It's the least I can do.' She then adds with a feline smile, 'But if you do go out, don't be away too long - I'll be waiting for your return to have some more fun,' she purrs with a teasing wink before going back to what she was doing, showing off with a sultry sway of her hips and tail as she walks away.";
		if Dexterity of Angie is 0:
			now Dexterity of Angie is 1;
			add "feline porn" to invent of Zoo Giftshop;
	else if AngieAroused > 2: [ starting feelings for the player ]
		say "     'Hey, welcome back,' Angie says with a bit of a purr. 'It's great to see you again, and I can't thank you enough for showing me how much fun this new body of mine could be!' the large panther herm says as she stretches her feline form out for you. 'God! I just love my anthro shape now, and all the fun I've had with you. Thanks again for that - you've been absolutely amazing. Of course, I also wish I knew where that panther was so I could thank him properly. He gave me this sexy fur in the first place, as well as... well, you know,' Angie says, rubbing the bulge under her skirt with one hand. 'I couldn't imagine not having a cock now,' she adds with a feline grin as she looks you up and down. 'Still, I think I better stay here for now since someone has to take care of this place. And - well,' she admits, looking around a bit guiltily, ";
		if Dexterity of Angie is 0:
			say "'I have kinda been moving all the cat merchandise I could find into the break room here. That and... some photos I found in Keith's locker when I ducked outside and checked the zookeeper lockerroom. Since I saw Keith strip and offer himself willingly to get mounted by our lion Kusabi when everything started going crazy, I guess he was pretty into the big, proud beast. Never would have thought it of him, but... I see the attraction now. Well, with him becoming a lioness ready to bear her first litter soon, I've inherited his pics to add to my own stash of big cat porn. You can take a few select pieces I put over there on the counter. Just think of me when you use it...' She gives you a wink and nods towards the stack of feline porn as her tail lashes behind her excitedly.";
		else:
			say "'there's always my stash of sexy cat pictures in the break room. Nothing against the real thing with you, but... it'll tide me over while you're out.' She gives you a wink as her tail lashes behind her excitedly.";
		say "     'If you need any help, just let me know, and maybe I can teach you a few things about how to handle yourself and the animals out there sometime. It's the least I can do,' Angie says with a feline smile. 'Don't be away too long, though - I'll be waiting for your return to have some more fun,' she purrs with a teasing wink, before she goes back to what she was doing with a little bit of a new sultry sway to her hips and tail.";
		if Dexterity of Angie is 0:
			now Dexterity of Angie is 1;
			add "feline porn" to invent of Zoo Giftshop;
	else if AngieAroused > 0: [ had sex with the player ]
		say "     'Hey, welcome back,' Angie says with a bit of a purr. 'It's great to see you again, and I can't thank you enough for showing me how much fun this new body of mine could be!' the large panther herm says as she stretches her feline form out for you. 'God! I just love my anthro shape now, and I wish I knew where Midnight was so I could thank him properly, let the sexy beast mount me again and again. Maybe you could come along too - I'm sure he'd be on top of you in a second and we'd be a pair of horny pantheresses for him to enjoy,' she says with a feline grin as she looks you up and down. 'Still, I think I better stay here for now since someone has to take care of this place, although,' she admits, looking around a bit guiltily, ";
		if Dexterity of Angie is 0:
			say "'I have kinda been moving all the cat merchandise I could find into the break room here. That and... some photos I found in Keith's locker when I ducked outside and checked the zookeeper lockerroom. Since I saw Keith strip and offer himself willingly to get mounted by our lion Kusabi when everything started going crazy, I guess he was pretty into the big, proud beast. Never would have thought it of him, but... I see the attraction now. Well, with him becoming a lioness ready to bear her first litter soon, I've inherited his pics to add to my own stash of big cat porn. You can take a few select pieces I put over there on the counter. Just think of me when you use it...' She gives you a wink and nods towards the stack of feline porn as her tail lashes behind her excitedly.";
		else:
			say "'There's always my stash of sexy cat pictures in the break room. Nothing against the real thing with you, but... it'll tide me over while you're out.' She gives you a wink as her tail lashes behind her excitedly.";
		say "     'If you need any help, just let me know, and maybe I can teach you a few things about how to handle yourself and the animals out there sometime. It's the least I can do,' Angie says with a feline smile. 'Though if you find any hot, sexy panthers out there, be sure to lead them back here,' she purrs with a teasing wink, before she goes back to what she was doing with a little bit of a new sultry sway to her hips and tail.";
		if Dexterity of Angie is 0:
			now Dexterity of Angie is 1;
			add "feline porn" to invent of Zoo Giftshop;
	else:
		say "     'Hey, welcome back,' Angie says with a bit of a purr. 'Being an anthro panther is pretty great once one gets used to it. Soft fur, a lithe figure, and the senses I have now are so much sharper than a human's,' the large panther herm says as she stretches her feline form out for you. 'God! I just love my anthro shape now, and I wish I knew where Midnight was so I could thank him properly...' she says with a feline grin. 'Still, I think I better stay here for now since someone has to take care of this place,' she admits.";
		say "     'If you need any help, just let me know, and maybe I can teach you a few things about how to handle yourself and the animals out there sometime. It's the least I can do,' Angie says with a feline smile.";

to say AngieTalk4: [chatting]
	if AngieAroused is 50:
		say "     [one of]'Interested in Learning some new tricks? I would be more than happy to teach you,' Angie purrs happily, before grinning, 'And I am sure Midnight could teach you a few tricks as well, if you wanted him to,' she says with a soft feline chuckle.[or]Angie purrs and rubs herself up against you absently, before continuing to poke around the store as she makes it into a proper feline den.[or]'I knew you would be back to play with us soon,' Angie says with a feline grin.[or]'You should stay and play a while, he is sure to make a proper cat out of you,' she says as she gestures at the large panther next to her.[or]'Wouldn't you love to have a sleek panther-like form just like mine?'[or]'I just can't thank you enough for bringing Midnight back to me!' Angie says with a happy purr of contentment.[or]'Being a big cat trainer was never as much fun as letting Midnight train me is,' the panther herm says with a teasing smile.[or]'You know, if you let him make you a proper panther as well, we could be mates together...' Angie says teasingly...[or]'I just love acting like a nice slutty kitty with Midnight,' Angie purrs as she rubs herself happily, 'I bet you would like it too If you just let yourself play a little.'[or]'I love watching the way Midnight moves,' Angie says with a happy smile, 'I often find myself actually mimicking Midnight when he prowls around the shop, it makes me feel so much more like a proper little panther when I do...'[or]'I bet you're having all sorts of adventures in the city. You should tell me about them sometime.'[or]'My fur is wonderful and I know Midnight loves me the way I am but sometimes I wonder how I'd look in red.'[or]Angie looks out the window with longing, 'Oh I want to be out there but then who would look after my sexy Midnight? Tell me about the other felines out there?'[or]Angie closes her eyes and breathes in a long drag of your scent. 'Ooooh, what have you playing with? You must tell me.'[at random]";
	else if AngieAroused is 7:
		say "     Angie says, 'Welcome back, my love. [one of]I've missed you. It sure gets lonely here without you.' Her gaze wandering over to the door to the break-room while her hand rubs the bulge in her pants, she adds, 'Jerking off to my little stash of cat porn is fun, but nothing against actually spending time with you.' Angie's eyes flash with lust as she says that, then gives an enticing purr and shake of her upper body that draws your eyes to her breasts.[or]Been out patrolling the zoo while you were out. It's pretty wild out there, but I think I can get a handle on things over time. Many of the transformed visitors can be talked to, if one really tries, and I am trained in handling the flat out animals.'[or]You know, I haven't thought back to being a human in a while now. I don't think I'd even want to go back. It's so strange to imagine seeing the world like that again... without all the smells and noises I can sense as a panther.'[or]I hope those of my animals that got out into the city are okay... they belong here in the zoo where I can take care of them...[or]You know, some of the animals stayed right in their enclosures even after all the changes. But then, this is their home, so why should they leave.'[or]I wonder what happened to the rest of the staff...'[or]Be careful, some of the animals here were pretty dangerous before, now I don't even want to imagine how bad it could get.'[or]You know...' Angie stares off into the distance, a thoughtful expression on her face while her hand inches down to rub her bulge. 'Sometimes I wonder how it would have been to just stay with Midnight, become his pet. Simpler, easier - for sure. Just letting the sexy beast mount me whenever he wants to...' Her breath comes a bit faster, showing obvious arousal. Then she blows out her breath and steps up to you, drawing you in for a loving kiss. Pulling back after that, she looks deep in your eyes and caresses the side of your face. 'But then I remember how good it is to be with you, as well as my duty to the zoo and the animals.'[or]Why don't you tell me a bit about the things going on out there in the city? That's important to know for me too, if I want to take care of the zoo.'[or]God! I've been thinking about ravishing you in all kinds of ways. You're in for some fun the next time we hit the sheets.'[or]Did you see the elephant enclosure while you were out in the zoo? They must have really had a lot of fun. The ground is completely covered in white... I'm amazed even they could come that much. Nanite regeneration powers I guess...'[or]Some tigertaurs gave me a bit of trouble while you were out, but I dealt with them. This is my zoo!'[at random]";
	else:
		say "     Angie says, '[one of]Back again? I haven't found anything useful here yet.[or]Hey, I'm glad your back. It can get kind of lonely here.[or]Oh thank goodness your back, I was starting to talk to the animal pictures on the wall![or]I hope someone finds some kind of cure for this soon, I keep having the strangest thoughts.[or]I hope the animals are all right out there... oh and the people too I suppose...[or]Strangely enough, I think some of the animals stayed in their enclosures even after all the changes, maybe they liked it here?[or]I wonder what happened to the rest of the staff...[or]Be careful, some of the animals here were pretty dangerous before, now I don't even want to imagine how bad it could get.[or]Mmmmmm,' Angie says, staring off into the distance, her hand under her skirt and her eyes unfocused. 'Panthers... mmmm...[or]If you find out what's going on let me know ok?[or]God! I need a break. For some reason, I keep fantasizing about the panther in the poster over there.[or]If you find any of the hyenas be careful, they were some of the first animals to change, I gather.[or]I wonder what happened over at the elephant cages, the ground was covered in white when I ran by...[or]I swear I think I saw one of the tigers go by on all fours, only it had the upper body of a humanoid tiger instead of a tiger head, like some weird kind of what did they call them... centaurs?[at random]'";

to say AngieTalk5: [telling her adventure stories]
	say "     Angie listens raptly as you tell her about your adventures in the city. She seems particularly interested when you tell her about the other feline mutants you've seen around, so you expand on your experiences, rendering your encounters in intimate detail. As you do so, the panther-herm's cock begins to rise as Angie strokes it unconsciously. 'Oh all those cats sound so beautiful,' she purrs[if AngieAroused is 50], glancing back at Midnight guiltily[end if]. 'Listen, I know you love me as I am, but I've been craving a little,' Angie licks her lips and smiles naughtily, 'variety. Those rubber tigresses sound like just the thing. If you came in here looking like that...' she grins, leaving the rest to your imagination.";

to say AngieTalk6: [learn from Angie]
	if LastAngieLearned - turns < 8:
		say "     'Sorry,' Angie says as she looks you up and down, 'But I don't think you have fully mastered the last lesson yet, why don't you try coming back a bit later.'";
	else:
		now LastAngieLearned is turns;
		say "     Asking Angie for helpful tips for surviving out in the city, she happily grabs several pages from the shredded nature books she has managed to salvage while here. With those as lecture notes, she begins to teach you all kinds of tricks about both animal behavior and how to survive handling wild beasts safely. She is a surprisingly good teacher, and soon you feel like you have a better grasp on the intricacies of combat and survival!";
		LineBreak;
		say "     Your XP has increased slightly!";
		increase XP of player by a random number between 5 and 30;

to say AngieTalk7: [be her mate]
	say "     Angie's ears twitch and her eyes get wide with elation as you say that you want to be her mate. The panther herm draws you close to herself with a purr, then rubs her feline muzzle against your cheeks before giving you a deep kiss. 'That's wonderful! Thank you, my love. I've dreaded a time when you might not be with me anymore. Now we can be together, always.' Saying that, she embraces you tightly and the two of you make out, touching and stoking each other's bodies while your tongues wrestle with each other. It doesn't take long until the rising lust you both feel makes things escalate to clothing and gear being pulled - or sometimes even ripped - off and thrown aside. Soon you're fully naked, panting and moaning as you share kisses with the horny pantheress.";
	say "     Her strong arms reach around you to put both of Angie's hand-paws on your shapely behind, allowing her to lift you up and carry you a short distance while you keep making out. Sweeping all kinds of assorted merchandise off a low counter with an impatient brush of her arm, your future mate lowers you down on the hip-height counter and pushes softly against your chest to make you lie down. Her eyes flare in lust as she looks over your naked form lying before her and with a deep mrowl, she grabs your legs, lifting and spreading them. Crouching down in a flash, she starts lapping away at your [if player is female]pussy[else]asshole[end if] in an urgent tempo, eager to get you ready...";
	WaitLineBreak;
	if player is female:
		say "     Angie's tongue is wet and soft, but also a bit rough and tickling from the thousands of small nubs all over its surface - all of which together creates amazing sensations as she licks your swollen folds and seeks out the little clit with her probing appendage. She goes down on you for a short while, making you lean back and gasp while holding on to the edge of the counter, before eventually her own urges take command. With a lusty growl that might just have come from an actual wild panther, she stands up again and leans forward, licking your face as a hand aims her erect cock at your nether lips.";
		say "     And then... with a throaty roar and a deep thrust, it's in - Angie's cock stretching your passage tight around its girth, rubbing your sensitive walls with the flexible spines along her shaft. As the panther-herm bottoms out inside you a moment later, she holds still for a short file after that, straining to hold her urges back to let you get used to her cock. He pants into your ear, 'I love you... my mate... mine...' - then the floodgates break and she fully gives in to her male instincts and begins fucking you in earnest.";
		WaitLineBreak;
		say "     She starts pulling out and thrusting into you again and again in short rough movements, the barbs pulling and tugging at your inner folds in a strangely pleasurable manner. Then she leans her body down over you, a purr in her chest as she nuzzles and licks you, arms sliding under yours to grab your shoulders and back tightly and allow her to hold you as her thrusts increase in both speed and force. You are panting in desire as she covers you and fucks you roughly, with an almost bestial abandon. At an incredible high-point of your coupling, acting on some inner instinct of her own, Angie lets out a growl, and unsheathes her sharp claws - just a little bit - drawing them down your back to leave thin lines of claw-marks that mark you as hers.";
		say "     It is somewhat painful at first, but before those signals mange to penetrate your pleasure-flooded mind, already the light tingle of nanite healing lessens the sting, leaving behind nothing but a satisfying feeling of belonging, owed to being marked as your lover's mate forever. With this sexy feline on top of you, almost feral as she is right in this moment, you feel like you know what it must have been like for her, trapped helplessly under a wild beast, a beast intent on fucking you roughly just like the animal it is, your will and desires completely secondary to its bestial needs... and it feels wonderful. As your wild coupling continues, you soon find yourself screaming in orgasm and getting wet with femcum, just as Angie lets loose her own beast-like roar above you, her cock shooting its changed seed deep into your body.[fimpregchance]";
		WaitLineBreak;
		say "     You lie there for a minute, Angie leaning over you and still purring loudly as her shaft pulses inside you with the quickly ebbing spurts of cum. Slowly, reason returns to her eyes, banishing her inner animal's intense stare to replace it with a much softer, loving expression. She gives you a loving kiss on the mouth, then pants 'Now you're my mate, truly my mate. Ah, how I love you for all you did - saving me and being with me. I - I'm sorry for scratching your back, that was just something that seemed... like I had to do it then. Forgive me?' A beaming smile spreads over Angie's face as you look up at her and nod, then she kisses you again and softly caresses your cheek with a paw.";
		say "     Eventually her cock starts to soften and she pulls it back out of you, then looks down at your now cum-dripping hole. From the aroused mrowl she makes at that moment, it becomes obvious that her libido is prodding her to have another go, but exhaustion wins out over it and she just steps forward to help you up again. 'That was unbelievably amazing,' she says with a smile at you, stroking her fur happily. 'Stay here with me and let's do that again soon. I know I just can't wait,' Angie says with a dreamy smile as she looks down at your naked and sweaty form, her words speaking to some part of you that imagines all kinds of sexy things to do with her as your girlfriend. The increasingly erotic images fill your mind and make your body tingle with desire again even as you try to recover from your intense orgasm.";
	else:
		say "     Angie's tongue is wet and soft, but also a bit rough and tickling from the thousands of small nubs all over its surface - all of which together creates amazing sensations as she licks your hole and works the tip of her probing appendage in between your pucker's trembling folds. She goes down on you for a short while, making you lean back and gasp while holding on to the edge of the counter, before eventually her own urges take command. With a lusty growl that might just have come from an actual wild panther, she stands up again and leans forward, licking your face as a hand aims her erect cock at your hole.";
		say "     And then... with a throaty roar and a deep thrust, it's in - Angie's cock stretching your passage tight around its girth, rubbing your sensitive walls with the flexible spines along her shaft. As the panther-herm bottoms out inside you a moment later, she holds still for a short file after that, straining to hold her urges back to let you get used to her cock. He pants into your ear, 'I love you... my mate... mine...' - then the floodgates break and she fully gives in to her male instincts and begins fucking you in earnest.";
		WaitLineBreak;
		say "     She starts pulling out and thrusting into you again and again in short rough movements, the barbs pulling and tugging at your inner folds in a strangely pleasurable manner. Then she leans her body down over you, a purr in her chest as she nuzzles and licks you, arms sliding under yours to grab your shoulders and back tightly and allow her to hold you as her thrusts increase in both speed and force. You are panting in desire as she covers you and fucks you roughly, with an almost bestial abandon. Acting on some inner instinct of her own, Angie lets out a growl, and unsheathes her sharp claws - just a little bit - drawing them down your back to leave thin lines of claw-marks that mark you as hers.";
		say "     It's somewhat painful at first, but before those signals mange to penetrate your pleasure-flooded mind, already the light tingle of nanite healing lessens the sting, leaving behind nothing but a satisfying feeling of belonging from being marked as your lover's mate forever. With this sexy feline on top of you, almost feral as she is right in this moment, you feel like you know what it must have been like for her, trapped helplessly under a wild beast, a beast intent on fucking you roughly just like the animal it is, your will and desires completely secondary to its bestial needs... and it feels wonderful. As your wild coupling continues, you soon find yourself screaming in orgasm[if player is male], your cock erupting with spurts of cum that hit you in the chest[end if] just as Angie lets loose her own beast-like roar above you, her cock shooting its changed seed deep into your body.[mimpregchance]";
		WaitLineBreak;
		say "     You lie there for a minute, Angie leaning over you and still purring loudly as her shaft pulses inside you with the quickly ebbing spurts of cum. Slowly, reason returns to her eyes, banishing her inner animal's intense stare to replace it with a much softer, loving expression. She gives you a loving kiss on the mouth, then pants 'Now you're my mate, truly my mate. Ah, how I love you for all you did - saving me and being with me. I - I'm sorry for scratching your back, that was just something that seemed... like I had to do it then. Forgive me?' A beaming smile spreads over Angie's face as you look up at her and nod, then she kisses you again and softly caresses your cheek with a paw.";
		say "     Eventually her cock starts to soften and she pulls it back out of you, then looks down at your now cum-dripping hole. From the aroused mrowl she makes at that moment, it becomes obvious that her libido is prodding her to have another go, but exhaustion wins out over it and she just steps forward to help you up again. 'That was unbelievably amazing,' she says with a smile at you, stroking her fur happily. 'Stay here with me and let's do that again soon. I know I just can't wait,' Angie says with a dreamy smile as she looks down at your naked and sweaty form, her words speaking to some part of you that imagines all kinds of sexy things to do with her as your girlfriend. The increasingly erotic images fill your mind and make your body tingle with desire again even as you try to recover from your intense orgasm.";
	add "Angie's Mate" to feats of player;
	now AngieHappy is 4;


Instead of fucking the Angie:
	if AngieHappy < 3: [no catnip, no sex]
		say "     'Sorry, but I think I'll pass, that might just be a bit too much for my mind to take right now,' Angie says apologetically as you approach her about sex, although you can easily see your offer has definitely got her interested. She even begins to pant slightly and from the bulge in her short skirt, her cock is at least half-hard.";
	else if lastfuck of Angie - turns < 6:
		say "     'Sorry, I know you want to try that again just as much as I do,' Angie says with a soft purr of remembrance, 'But it seems like I still need a bit of time to recover before I can do anything like that again.' Giving you a hug to soothe your disappointment, she then goes back to what she was doing.";
	else if bodyname of player is "Panther Taur" and player is pure and AngieAroused is 50:
		say "[AngiePTFun]";
	else if bodyname of player is "Rubber tigress" and player is pure and AngieAroused is 50:
		say "[AngieRTFun]";
	else if player is neuter:
		say "     Seems like you're currently not quite equipped to have sex with anyone. Maybe try this again when you've got a cock or pussy...";
	else:
		say "[AngieSexMenu]";

to say AngieSexMenu:
	now sextablerun is 0;
	blank out the whole of table of fucking options;
	[]
	choose a blank row in table of fucking options;
	now title entry is "Give Angie a blowjob";
	now sortorder entry is 3;
	now description entry is "Let the sexy pantheress fuck your mouth";
	[]
	if AngieAroused is not 7:
		if player is puremale:
			choose a blank row in table of fucking options;
			now title entry is "Fuck her";
			now sortorder entry is 1;
			now description entry is "Mount the sexy pantheress";
		if player is purefemale:
			choose a blank row in table of fucking options;
			now title entry is "Get fucked by her";
			now sortorder entry is 2;
			now description entry is "Let the sexy pantheress mount you";
		if player is herm:
			choose a blank row in table of fucking options;
			now title entry is "Herm sex with Angie";
			now sortorder entry is 3;
			now description entry is "Have some fun with the other hermaphrodite";
	else:
		[]
		if player is male:
			choose a blank row in table of fucking options;
			now title entry is "Let Angie mount your cock";
			now sortorder entry is 1;
			now description entry is "Let the sexy pantheress mount your cock";
		[]
		choose a blank row in table of fucking options;
		now title entry is "Get fucked by Angie";
		now sortorder entry is 2;
		now description entry is "Let the sexy pantheress pound you with her cock";
		[]
		choose a blank row in table of fucking options;
		now title entry is "Let her go down on you";
		now sortorder entry is 3;
		now description entry is "Enjoy some oral stimulation by your sexy pantheress";
		[]
	sort the table of fucking options in sortorder order;
	repeat with y running from 1 to number of filled rows in table of fucking options:
		choose row y from the table of fucking options;
		say "[link][y] - [title entry][as][y][end link][line break]";
	say "[link]0 - Nevermind[as]0[end link][line break]";
	while sextablerun is 0:
		say "Pick the corresponding number> [run paragraph on]";
		get a number;
		if calcnumber > 0 and calcnumber <= the number of filled rows in table of fucking options:
			now current menu selection is calcnumber;
			choose row calcnumber in table of fucking options;
			say "[title entry]: [description entry]?";
			if player consents:
				let nam be title entry;
				clear the screen and hyperlink list;
				now sextablerun is 1;
				if (nam is "Fuck her"):
					say "[AngieSex1]";
				if (nam is "Get fucked by her"):
					say "[AngieSex2]";
				if (nam is "Herm sex with Angie"):
					say "[AngieSex3]";
				if (nam is "Let Angie mount your cock"):
					say "[AngieSex4]";
				if (nam is "Get fucked by Angie"):
					say "[AngieSex5]";
				if (nam is "Give Angie a blowjob"):
					say "[AngieSex6]";
				if (nam is "Let her go down on you"):
					say "[AngieSex7]";
				wait for any key;
				now lastfuck of Angie is turns;
		else if calcnumber is 0:
			now sextablerun is 1;
			say "     You step back from the pantheress, shaking your head slightly as she gives a questioning look.";
			wait for any key;
		else:
			say "Invalid Option. Pick between 1 and [the number of filled rows in the table of fucking options].";
	clear the screen and hyperlink list;

to say AngieSex1: [fucking her]
	if AngieAroused is 0:
		say "     Angie looks at you with desire, though she is still hesitant about this and says, 'I'm not really sure it's ok to just give in to the urges like this, but it does feel so very, very good. Do you really think it's ok?' Seems like she'll need a little bit of convincing yet before you can fuck her. Doing your best to calm and reassure her, you...";
		LineBreak;
		let bonus be (( the Charisma of the player minus 10 ) divided by 2);
		let diceroll be a random number from 1 to 20;
		say "You roll 1d20([diceroll])+[bonus]: [diceroll + bonus] (Charisma-Check)";
		increase diceroll by bonus;
		say "     [line break][line break]";
		if diceroll > 12:
			say "     ...manage to get her over that last reluctance. 'Just a little bit of fun couldn't hurt...' Angie almost moans as she leans towards you, lust rising in her eyes. She continues, 'I just can't keep denying myself what I need.' Then she shrugs her vest off onto the floor and steps up close. Her large breasts rub up against you as she reaches down between your legs, her large slightly paw-like hands finding your erect cock, and stroking it several times, making you gasp.";
			say "     'Oh god, I need that in me so bad!' Angie says with a moan, before backing off and turning away from you. You are slightly surprised for a moment, but her intent instantly becomes clear as she leans over and braces herself over the shop's counter, her large breasts pressed up against its glass top. Her panther tail lifts straight up above her raised ass, giving you a tantalizing view of her winking lips. When you don't move forward immediately, she shoots a pleading back at you over her shoulder. 'Please, I need you. God! I need you to mount me with that wonderful [cock of player] cock so badly, and take me like an animal just like HE did, please!'";
			WaitLineBreak;
			say "     She keeps begging as she wiggles her hips at you, her tail lashing in arousal and need. You find yourself unable to turn down such an obviously desperate plea for your attention and decide it would be best to give her what she wants. Moving up behind her large form, you grin as she wiggles her ass at you, the tail lashing and teasing you until you pin it down. You find yourself gripping her hips tightly and Angie moans as you rub your cock over her needy hole.";
			say "     Delighted by her reaction to your member, you swiftly sheath yourself inside her, letting out a gasp of pleasure as her hot velvet folds part readily for your cock. Angie moans and writhes underneath you like a cat in heat, and you pull out slightly, then begin to pump your hard cock into her over and over again. The feeling of her soft furred body underneath you as you fuck her tight hole is amazing, and Angie seems to be loving the feeling even more, as she gasps and pants for you to take her harder, and faster, and to pin her down and take her like an animal.";
			WaitLineBreak;
			say "     You can't help but grin as you respond to her need by doing what she asks, increasing your pace as you lean over her form, pressing her down against the shop counter as she yowls out her pleasure to the empty room, each lusty and needful sound another sign of your total victory over her body. All too soon, you reach the point of no return and orgasm within her hot folds, your seed shooting into her needy passage triggering Angie's own earth-shattering orgasm. She lets loose a loud cat-like scream of pleasure, as her cock covers the front of the counter with her own seed, and her trembling folds milk seem to milk every last bit of cum out of you.";
			say "     Eventually you both manage to come back to your senses, and as you pull out of her, Angie looks back at you with a self-satisfied look on her face. Her skirt still hangs uselessly on her well-fucked body as she regains her balance after your exertions. 'That was amazing! We have to do this again and again soon. God, I can't believe I ever didn't want to give in to anything that feels this good!' Angie says with a happy smile as she looks at you in thanks. 'And I owe it all to your help. If I can ever do anything to repay you, you let me know!' she tells you with obvious sincerity before staggering towards the restroom to clean herself up.";
			now lastfuck of Angie is turns;
			if AngieAroused < 6:
				increase AngieAroused by 1;
		else:
			say "     ...can't quite manage to quell her fears. Biting her lip, the pantheress gives a shake of her head and moves back a few steps with a sigh.";
	else if AngieAroused > 0 and AngieAroused < 7: [undecided Angie without Midnight]
		say "     'Oh god yes, I can't wait!' Angie says with a moan, her paw trailing over your [cock of player] cock one last time, then she backs off and turns away from you. You are slightly surprised for a moment, but her intent instantly becomes clear as she leans over and braces herself over the shop's counter, her large breasts pressed up against its glass top. Her panther tail lifts straight up above her raised ass, giving you a tantalizing view of her winking lips. When you don't move forward immediately, she shoots a pleading back at you over her shoulder. 'Please, I need you. God! I need you to mount me with that wonderful [cock of player] cock so badly, and take me like an animal just like HE did, please!'";
		WaitLineBreak;
		say "     She keeps begging as she wiggles her hips at you, her tail lashing in arousal and need. You find yourself unable to turn down such an obviously desperate plea for your attention and decide it would be best to give her what she wants. Moving up behind her large form, you grin as she wiggles her ass at you, the tail lashing and teasing you until you pin it down. You find yourself gripping her hips tightly and Angie moans as you rub your cock over her needy hole.";
		say "     Delighted by her reaction to your member, you swiftly sheath yourself inside her, letting out a gasp of pleasure as her hot velvet folds part readily for your cock. Angie moans and writhes underneath you like a cat in heat, and you pull out slightly, then begin to pump your hard cock into her over and over again. The feeling of her soft furred body underneath you as you fuck her tight hole is amazing, and Angie seems to be loving the feeling even more, as she gasps and pants for you to take her harder, and faster, and to pin her down and take her like an animal.";
		WaitLineBreak;
		say "     You can't help but grin as you respond to her need by doing what she asks, increasing your pace as you lean over her form, pressing her down against the shop counter as she yowls out her pleasure to the empty room, each lusty and needful sound another sign of your total victory over her body. All too soon, you reach the point of no return and orgasm within her hot folds, your seed shooting into her needy passage triggering Angie's own earth-shattering orgasm. She lets loose a loud cat-like scream of pleasure, as her cock covers the front of the counter with her own seed, and her trembling folds milk seem to milk every last bit of cum out of you.";
		say "     Eventually you both manage to come back to your senses, and as you pull out of her, Angie looks back at you with a self-satisfied look on her face. Her skirt still hangs uselessly on her well-fucked body as she regains her balance after your exertions. 'That was just amazing,' the pantheress purrs happily. 'Almost as good as having a real cat mount me,' Angie says teasingly as she rubs her dark-furred body up against you. 'I almost can't wait till you can fuck me like that again, holding me down and making me a proper kitty toy for you to use whenever you want...' She murrs softly with excitement at the thought, and you find the image of the strong panther-woman submitting to you again and again to be rather enticing as well, even as she rubs up against you one last time before relaxing back on the counter with a happy smile on her muzzle...";
		if AngieAroused < 6:
			increase AngieAroused by 1;
	else if AngieAroused is 7: [player-Angie relationship]
		say "     <sex>";
	else if AngieAroused is 50: [Midnight present]
		say "     'That sounds like a wonderful idea!' the naked and obviously excited panther herm says at your proposition, purring as she leans close to you, her soft warm body rubbing up against yours. 'I just can't thank you enough for all you've done for me, but maybe I can start by showing you just how much fun I can be now?' Angie says teasingly, her enticing scent filling your nose and making you pant eagerly even as she runs her softly furred hand over your [skin of player] skin. You find your hands stroking her soft black fur almost on their own, and soon she lowers her muzzle down to yours and kisses you enthusiastically, her feral feline taste exploding in your mouth while her rumbling purr rolls through your body.";
		say "     The two of you get interrupted by another soft rumbling noise, and Angie breaks the kiss, still panting with lust, so the two of you can turn to look to where Midnight is watching with obvious interest. The large black feline is lying sprawled on his side, his golden eyes gleaming in the dimly lit gift shop, the tip of his tail lashing from side to side behind him as he lets out another low rumbling purr. 'Mmmm, I think Midnight wants to play too. What do you think, should we let join in?' Angie purrs out, obviously excited by the idea of the large cat being with her at the same time you are. 'Or should we just give the big kitty a nice show instead?' she says as she playfully strokes your cheek with the back of her slightly paw-like hand.";
		LineBreak;
		say "     Do you let Midnight join you in mounting Angie?";
		if player consents:
			LineBreak;
			say "     'Oh yes this is going to be such fun,' Angie purrs as she moves closer to you, her paws slowly stroking down over your chest as she lowers herself to kneel before. Her face level with your groin, she slowly traces her tongue over your already erect cock, the slightly raspy texture making you shudder as it trails across your member. 'Mmm! I want this, I want your cock in my mouth while his cock fills me up,' Angie moans, her rear lifting up teasingly as she looks up at you. Your erection twitches in agreement, and you find yourself sitting down on the ground in front of Angie.";
			say "     Purring eagerly, the pantheress moving towards you on all fours, her tail lashing behind her in sinuous movements even as Midnight stalks forward to take advantage of her teasing invitation. You are distracted from the large cat as Angie gently rubs the soft fur of her muzzle along the sides of your cock, her whiskers brushing against your thighs and making you moan and thrust your hips up instinctively. Bracing yourself with your hands on the floor, you lean back slightly, groaning in lust as her tongue licks over your cock again.";
			WaitLineBreak;
			say "     Angie lets out a low yowl of pleasure of her own as Midnight takes advantage of her position to mount the lusty pantheress himself. The sight of the large cat thrusting into her body is incredibly erotic, making you even harder for when she lowers her muzzle back down to your crotch. You moan as she opens her muzzle slightly and slips her lips around the tip of your cock, the feel of her soft lips rubbing across your shaft while her tongue teases its tip making your eyes roll back with pleasure.";
			say "     You pant as Angie begins to bob her head over your cock in time to the thrusting of the feral panther on top of her, her lips slipping a little further down your rod with each motion, the soft fur of her muzzle brushing against your body teasingly as she takes more and more of your maleness into her mouth. Lowering your gaze from the ceiling, you find yourself staring into Midnight's eyes, the large cat panting loudly and bearing a knowing grin at your pleasure of feeling Angie's muzzle engulfing your shaft and sucking on it eagerly.";
			WaitLineBreak;
			say "     You can feel your climax building, the feel of her tight warm mouth and slightly textured tongue making you groan in pleasure as Angie lavishes your shaft with attention. Soon you cry out as the building orgasm explodes throughout your body and your cock releases its fertile cream into Angie's waiting mouth, making the feline zookeeper moan in pleasure as she eagerly tries to swallow it all down. Midnight lets out a low cry of his own just moments later, and you can feel Angie shudder in pleasure as her moan of orgasm slips out from around your cock.";
			say "     Not much later, your cock begins to soften, and Angie gives it a few last eager licks as Midnight dismounts from her well-fucked body. The former zookeeper smiles up at you happily as she licks the last of your cream off her lips, and you smile back as you realize just how much more fun she is now as a lovely little panther pet for you and Midnight to play with...";
		else:
			LineBreak;
			say "     'Oh god yes, I can't wait!' Angie says with a moan, her paw trailing over your [cock of player] cock one last time, then she backs off and turns away from you. You are slightly surprised for a moment, but her intent instantly becomes clear as she leans over and braces herself over the shop's counter, her large breasts pressed up against its glass top. Her panther tail lifts straight up above her raised ass, giving you a tantalizing view of her winking lips. When you don't move forward immediately, she shoots a pleading back at you over her shoulder. 'Please, I need you. God! I need you to mount me with that wonderful [cock of player] cock so badly, and take me like an animal just like HE did, please!'";
			WaitLineBreak;
			say "     She keeps begging as she wiggles her hips at you, her tail lashing in arousal and need. You find yourself unable to turn down such an obviously desperate plea for your attention and decide it would be best to give her what she wants. Moving up behind her large form, you grin as she wiggles her ass at you, the tail lashing and teasing you until you pin it down. You find yourself gripping her hips tightly and Angie moans as you rub your cock over her needy hole.";
			say "     Delighted by her reaction to your member, you swiftly sheath yourself inside her, letting out a gasp of pleasure as her hot velvet folds part readily for your cock. Angie moans and writhes underneath you like a cat in heat, and you pull out slightly, then begin to pump your hard cock into her over and over again. The feeling of her soft furred body underneath you as you fuck her tight hole is amazing, and Angie seems to be loving the feeling even more, as she gasps and pants for you to take her harder, and faster, and to pin her down and take her like an animal.";
			WaitLineBreak;
			say "     You can't help but grin as you respond to her need by doing what she asks, increasing your pace as you lean over her form, pressing her down against the shop counter as she yowls out her pleasure to the empty room, each lusty and needful sound another sign of your total victory over her body. All too soon, you reach the point of no return and orgasm within her hot folds, your seed shooting into her needy passage triggering Angie's own earth-shattering orgasm. She lets loose a loud cat-like scream of pleasure, as her cock covers the front of the counter with her own seed, and her trembling folds milk seem to milk every last bit of cum out of you.";
			say "     Eventually you both manage to come back to your senses, and as you pull out of her, Angie looks back at you with a self-satisfied look on her face. Her skirt still hangs uselessly on her well-fucked body as she regains her balance after your exertions. 'That was just amazing,' the pantheress purrs happily. 'Almost as good as having a real cat mount me,' Angie says teasingly as she rubs her dark-furred body up against you. 'I almost can't wait till you can fuck me like that again, holding me down and making me a proper kitty toy for you to use whenever you want...' She murrs softly with excitement at the thought, and you find the image of the strong panther-woman submitting to you again and again to be rather enticing as well, even as she rubs up against you one last time before relaxing back on the counter with a happy smile on her muzzle...";
		Infect "Pantherherm";
		now lastfuck of Angie is turns;
		now lastfuck of Midnight is turns;

to say AngieSex2: [getting fucked by Angie]
	if AngieAroused is 0:
		say "     Angie looks at you with desire, though she is still hesitant about this and says, 'I'm not really sure it's ok to just give in to the urges like this, but it does feel so very, very good. Do you really think it's ok?' Seems like she'll need a little bit of convincing yet before you can fuck her. Doing your best to calm and reassure her, you...";
		LineBreak;
		let bonus be (( the Charisma of the player minus 10 ) divided by 2);
		let diceroll be a random number from 1 to 20;
		say "You roll 1d20([diceroll])+[bonus]: [diceroll + bonus] (Charisma-Check)";
		increase diceroll by bonus;
		say "     [line break][line break]";
		if diceroll > 12:
			say "     ...manage to get her over that last reluctance. 'Just a little bit of fun couldn't hurt...' Angie almost moans as she leans towards you, lust rising in her eyes. She continues, 'I just can't keep denying myself what I need.' Then she leans closer, shrugging her vest off onto the floor as she rubs herself up against you. 'And I can tell from the way you are acting just what you need as well,' she adds in a teasing voice. 'You want to find out just what it's like to be mounted by a nice big cat yourself I see. I really can't say that I blame you for that, and I have to admit I AM looking forward to trying this wonderful new cock of mine out on you.'";
			say "     Angie runs her hands over your body, focusing her attentions on your breasts and your already a bit moist sex, before leaning over and giving you a long kiss, her tongue teasing yours as her large breasts press up against your body. And they are not the only thing pressing up against you - Angie's thick panther cock brushes against your belly, obviously erect and ready for the fun to come. Breaking the kiss, you find yourself panting almost as much as she is, the scent of her strong feline arousal overwhelming you, immediately vanquishing any thoughts you might have to resist her attentions.";
			WaitLineBreak;
			say "     Indeed, you aren't able to resist her at all, just going along with it as she moves behind you, her large paws pushing you down onto the ground in front of her, where you can't resist hiking your ass up in the air and bracing yourself on your hands and knees for what is to come. Angie wastes no time in gripping your hips and rubbing her cock against your rear, 'Now I've never done this before,' Angie says with a moan as her cock brushes up between your thighs, making you shiver at the soft barbs rubbing up against your skin, 'This is all just instinct on my part, so just bear with me.'";
			say "     Immediately after her admission, she begins to thrust herself against you, her cock rubbing against your crotch several times before it finally finds its way inside your swollen nether lips. You gasp in lust and Angie lets out a yowl of pleasure as her cock plunges into you, the barbs on her feline member sending miniature explosions of pleasure through you as they press into your inner walls. After a second of the two of you on all fours with Angie mounted atop you, coming to grips with the wonderful new feelings, Angie fully gives in to her male instincts and begins fucking you in earnest.";
			WaitLineBreak;
			say "     She starts pulling out and thrusting into you again and again in short rough movements, the barbs pulling and tugging at your inner folds in a strangely pleasurable manner. Then she leans her body down over you, her large breasts pressing into your back as she rests more and more of her weight on you, forcing your face down to the ground as her thrusts increase in both speed and force. You are panting in desire as she covers you and fucks you roughly, with an almost bestial abandon, and then acting on some inner instinct of her own, Angie lets out a growl, and grips the back of your neck with her teeth.";
			say "     Pleasure shoots through you as her teeth lightly but firmly grip your skin, and the feral sex exposes that Angie's transformation and your encouragement have stripped her of some of her humanity. You realize you are trapped helplessly under a wild beast and that your will and desires are completely secondary to her bestial needs while she claims you with such rough fucking... and it feels so wonderful that you can't help but arch your back and present yourself more fully to the creature that is mastering your body, encouraging her thoughtless, animal dominance. As your wild coupling continues, you soon find yourself screaming in orgasm, just as Angie lets loose her own beast-like roar above you, her cock shooting its changed seed deep into your body.[impregchance]";
			WaitLineBreak;
			say "     You both lie there for a minute, panting as you try to absorb what just happened. Eventually her cock starts to soften and she pulls it back out of you, then staggers back to lean on the counter, while you stare up at her from your position on the floor. Angie looks down at you with a self-satisfied look on her face, her skirt still hanging uselessly on her tired body as she regains her balance after her recent exertions.";
			say "     'That was unbelievably amazing,' she says with a lusty grin on her face. 'God, we have to do this again soon. I just can't believe I ever didn't want to give in to feelings this amazing. Hell, I wish I had gained a cat cock even sooner!' Angie says with a dreamy smile as she looks down at you in thanks. 'And I owe it all to you and your help. I never would have discovered how good it could be if it wasn't for you. If I can ever do anything to repay you, you let me know!' she tells you with obvious sincerity, before staggering towards the restroom to clean herself up.";
			now lastfuck of Angie is turns;
			if AngieAroused < 6:
				increase AngieAroused by 1;
		else:
			say "     ...can't quite manage to quell her fears. Biting her lip, the pantheress gives a shake of her head and moves back a few steps with a sigh.";
	else if AngieAroused > 0 and AngieAroused < 7: [undecided Angie without Midnight]
		say "     'Mmm, yes! It looks like you're definitely ready,' she says as she runs one of her soft paws teasingly over your increasingly damp pussy, her claw rubbing across your clit and making you gasp with renewed arousal as the panther herm chuckles at your eager response. 'I knew you couldn't resist the temptation to be mated like a needy female in heat,' Angie says happily, as a large feline grin spreads across her muzzle, 'It's the most amazing feeling ever, a strong male cat pinning you down while his cock enters your body again and again...'";
		say "     Angie runs her hands over your body, focusing her attentions on your breasts and your already a bit moist sex, before leaning over and giving you a long kiss, her tongue teasing yours as her large breasts press up against your body. And they are not the only thing pressing up against you - Angie's thick panther cock brushes against your belly, obviously erect and ready for the fun to come. Breaking the kiss, you find yourself panting almost as much as she is, the scent of her strong feline arousal overwhelming you, immediately vanquishing any thoughts you might have to resist her attentions.";
		WaitLineBreak;
		say "     Indeed, you aren't able to resist her at all, just going along with it as she moves behind you, her large paws pushing you down onto the ground in front of her, where you can't resist hiking your ass up in the air and bracing yourself on your hands and knees for what is to come. Angie wastes no time in gripping your hips and rubbing her cock against your rear, 'So very eager, you need it just as badly as I did,' Angie says teasingly, with a soft moan as her cock brushes up between your thighs, making you shiver at the soft barbs rubbing up against your skin. You can hear her whisper teasingly into your ear through her harsh panting, 'Don't worry, it only gets better from here, and soon you won't be able to imagine being anything other than a proper little mate for the cats. Wanting them to pin you down, and fill you with that wonderful feline cock again and again like a cat in heat...'";
		say "     You would respond, but she gives you no time to think about her incredibly erotic words, as she begins to thrust herself against you, her cock rubbing against your crotch several times before it finally finds its way inside your swollen nether lips. You gasp in lust and Angie lets out a yowl of pleasure as her cock plunges into you, the barbs on her feline member sending miniature explosions of pleasure through you as they press into your inner walls. After a second of the two of you on all fours with Angie mounted atop you, coming to grips with the wonderful new feelings, Angie fully gives in to her male instincts and begins fucking you in earnest.";
		WaitLineBreak;
		say "     She starts pulling out and thrusting into you again and again in short rough movements, the barbs pulling and tugging at your inner folds in a strangely pleasurable manner. Then she leans her body down over you, her large breasts pressing into your back as she rests more and more of her weight on you, forcing your face down to the ground as her thrusts increase in both speed and force. You are panting in desire as she covers you and fucks you roughly, with an almost bestial abandon, and then acting on some inner instinct of her own, Angie lets out a growl, and grips the back of your neck with her teeth.";
		say "     Pleasure shoots through you as her teeth lightly but firmly grip your skin, and the feral sex exposes that Angie's transformation and your encouragement have stripped her of some of her humanity. You realize you are trapped helplessly under a wild beast and that your will and desires are completely secondary to her bestial needs while she claims you with such rough fucking... and it feels so wonderful that you can't help but arch your back and present yourself more fully to the creature that is mastering your body, encouraging her thoughtless, animal dominance. As your wild coupling continues, you soon find yourself screaming in orgasm, just as Angie lets loose her own beast-like roar above you, her cock shooting its changed seed deep into your body.[impregchance]";
		WaitLineBreak;
		say "     You both lie there for a minute, panting as you try to absorb what just happened. Eventually her cock starts to soften and she pulls it back out of you, then staggers back to lean on the counter, while you stare up at her from your position on the floor. Angie looks down at you with a self-satisfied look on her face, her skirt still hanging uselessly on her tired body as she regains her balance after her recent exertions.";
		say "     'That was unbelievably amazing,' she says with a self-satisfied look on her face, stroking her soft fur happily. 'Don't you want to do that again soon? Maybe even with a real panther as well? I know I just can't wait,' Angie says with a dreamy smile as she looks down at you panting on the floor, her teasing words speaking to some part of you and making you imagine being held down and fucked by both Angie, and several other large masculine cats, the increasingly erotic images filling your mind and making your body tingle with desire again even as you try to recover from your intense orgasm.";
		WaitLineBreak;
		say "     'A nice, large panther mounting me while I mount you - doesn't that sound nice? Mating you again and again until both our bellies are nice and full of little panthers...' Angie purrs, obviously lost in thought for a minute before focusing on you again. 'Or maybe I could just mount you again soon and make you my mate, and you could submit to me every night...' the large panther herm says teasingly, obviously seriously interested in the erotic idea as she looks at you with a happy smile on her muzzle.";
		now lastfuck of Angie is turns;
		if AngieAroused < 6:
			increase AngieAroused by 1;
	else if AngieAroused is 7: [player-Angie relationship]
		say "     <sex>";
	else if AngieAroused is 50: [Midnight present]
		say "     'That sounds like a wonderful idea!' the naked and obviously excited panther herm says at your proposition, purring as she leans close to you, her soft warm body rubbing up against yours. 'I just can't thank you enough for all you've done for me, but maybe I can start by showing you just how much fun I can be now?' Angie says teasingly, her enticing scent filling your nose and making you pant eagerly even as she runs her softly furred hand over your [skin of player] skin. You find your hands stroking her soft black fur almost on their own, and soon she lowers her muzzle down to yours and kisses you enthusiastically, her feral feline taste exploding in your mouth while her rumbling purr rolls through your body.";
		say "     The two of you get interrupted by another soft rumbling noise, and Angie breaks the kiss, still panting with lust, so the two of you can turn to look to where Midnight is watching with obvious interest. The large black feline is lying sprawled on his side, his golden eyes gleaming in the dimly lit gift shop, the tip of his tail lashing from side to side behind him as he lets out another low rumbling purr. 'Mmmm, I think Midnight wants to play too. What do you think, should we let join in?' Angie purrs out, obviously excited by the idea of the large cat being with her at the same time you are. 'Or should we just give the big kitty a nice show instead?' she says as she playfully strokes your cheek with the back of her slightly paw-like hand.";
		LineBreak;
		say "     Do you let Midnight join you?";
		if player consents:
			LineBreak;
			say "     'Mmm, yes! This is going to be so fun,' Angie purrs as she lowers her paw down to rub it over your already damp passage. 'I think I want to play with your lovely little pussy myself, fill that nice body of yours up with my big cock and make you beg for more,' the sexy panther whispers into your ear teasingly, her whiskers brushing across your cheek as she rubs her erect cock up against your side. You moan with arousal as her paws trace up your body, rubbing across your breasts several times, as she lowers you down onto one of the nearby blankets.";
			say "     'That's right, why don't you lie back and spread your legs wide for me, and then we can see if Midnight wants to play too,' Angie purrs out eagerly, her teasing suggestion sounding incredibly erotic to your sex-fogged mind. Spreading your legs out wide, you lean back as the obviously aroused panther herm moves over you eagerly, her rumbling purr filling your ears as she rubs her soft fur up against your body. Angie grins as she lowers her hips down to meet your own, her tail lashing eagerly in anticipation. As her feline member rubs against your nether lips, she pants, 'Soon you'll be all mine,' rubbing her cheek against yours as she continues, 'Just feel that wet little pussy, so eager for me to sink my new cock into.' She purrs with pleasure as the tip of her shaft pushes into your body, making you gasp with pleasure at her entry.";
			WaitLineBreak;
			say "     Suddenly Angie groans above you, and you can feel her weight press you down as she shifts forward in a sudden lurch, her cock driving deep into your body and making you shudder with pleasure. Angie groans again, her eyes half closed in ecstasy, and looking down you can see that Midnight has taken advantage of her position to mount the pantheress and settle himself onto her back. You are distracted from the erotic sight as Angie's cock shifts within you again, rocking back and forth inside you and causing you to gasp in pleasure as her feline barbs brush across your g spot with each thrust.";
			say "     Panting breathlessly, you find in a deep kiss as Angie suddenly covers your mouth with her own, her feline tongue teasing your own even as her cock thrusts into you again and again. Groaning, you realize faintly that each time Midnight thrusts into Angie's body, the feline zookeeper thrusts into yours as well. The strange threesome including a feral beast turns you on quite a bit, and you hold Angie's body close, your hands running over her soft fur, even as her own paw-like hands rub against your sides.";
			WaitLineBreak;
			say "     The three of you rub up against each other, your pleasure building with each soft touch, and hard thrust, until finally you hear Midnight roar in triumph above you, his orgasm obviously triggering Angie's own, as the pantheress yowls and shudders with pleasure, her cock stiffening within you as it spills its seed into your body. You shudder in built-up arousal and let out a low cry of your own, the feel of Angie's warm seed coating your womb triggering your own intense orgasm, pleasure sweeping across your mind as she holds you to her, her mouth finding your own as she kisses you deeply again.";
			say "     Eventually you feel some of the weight shift off of you, as Midnight dismounts from his mate, and then you shudder when Angie shifts and slowly pulls herself out of you, your pussy tingling and feeling slightly empty as she rolls over to rest on the blanket beside you. Feeling something settle onto your other side, you look over to see Midnight sprawled out beside you as well, and as Angie pulls you close and whispers into your ear what a good mate you are for her, you realize how nice it is just to lie here like this, with your mates['] soft fur rubbing up against your sides.[impregchance]";
			WaitLineBreak;
			say "     The three of you relax together like that for a while, until with a sigh you finally haul yourself back up onto your feet to go back to your searching through the city, though as you look back at Angie and Midnight sprawling comfortably out and looking at you with interested eyes, you wonder idly if it wouldn't be a better idea just to stay here with them and become the lusty little feline mate they so obviously want you to be...";
		else:
			LineBreak;
			say "     'Mmm, yes! It looks like you're definitely ready,' she says as she runs one of her soft paws teasingly over your increasingly damp pussy, her claw rubbing across your clit and making you gasp with renewed arousal as the panther herm chuckles at your eager response. 'I knew you couldn't resist the temptation to be mated like a needy female in heat,' Angie says happily, as a large feline grin spreads across her muzzle, 'It's the most amazing feeling ever, a strong male cat pinning you down while his cock enters your body again and again...'";
			say "     And they are not the only thing pressing up against you - Angie's thick panther cock brushes against your belly, obviously erect and ready for the fun to come. Breaking the kiss, you find yourself panting almost as much as she is, the scent of her strong feline arousal overwhelming you, immediately vanquishing any thoughts you might have to resist her attentions.";
			WaitLineBreak;
			say "     Indeed, you aren't able to resist her at all, just going along with it as she moves behind you, her large paws pushing you down onto the ground in front of her, where you can't resist hiking your ass up in the air and bracing yourself on your hands and knees for what is to come. Angie wastes no time in gripping your hips and rubbing her cock against your rear, 'So very eager, you need it just as badly as I did,' Angie says teasingly, with a soft moan as her cock brushes up between your thighs, making you shiver at the soft barbs rubbing up against your skin. You can hear her whisper teasingly into your ear through her harsh panting, 'Don't worry, it only gets better from here, and soon you won't be able to imagine being anything other than a proper little mate for the cats. Wanting them to pin you down, and fill you with that wonderful feline cock again and again like a cat in heat...'";
			say "     You would respond, but she gives you no time to think about her incredibly erotic words, as she begins to thrust herself against you, her cock rubbing against your crotch several times before it finally finds its way inside your swollen nether lips. You gasp in lust and Angie lets out a yowl of pleasure as her cock plunges into you, the barbs on her feline member sending miniature explosions of pleasure through you as they press into your inner walls. After a second of the two of you on all fours with Angie mounted atop you, coming to grips with the wonderful new feelings, Angie fully gives in to her male instincts and begins fucking you in earnest.";
			WaitLineBreak;
			say "     She starts pulling out and thrusting into you again and again in short rough movements, the barbs pulling and tugging at your inner folds in a strangely pleasurable manner. Then she leans her body down over you, her large breasts pressing into your back as she rests more and more of her weight on you, forcing your face down to the ground as her thrusts increase in both speed and force. You are panting in desire as she covers you and fucks you roughly, with an almost bestial abandon, and then acting on some inner instinct of her own, Angie lets out a growl, and grips the back of your neck with her teeth.";
			say "     Pleasure shoots through you as her teeth lightly but firmly grip your skin, and the feral sex exposes that Angie's transformation and your encouragement have stripped her of some of her humanity. You realize you are trapped helplessly under a wild beast and that your will and desires are completely secondary to her bestial needs while she claims you with such rough fucking... and it feels so wonderful that you can't help but arch your back and present yourself more fully to the creature that is mastering your body, encouraging her thoughtless, animal dominance. As your wild coupling continues, you soon find yourself screaming in orgasm, just as Angie lets loose her own beast-like roar above you, her cock shooting its changed seed deep into your body.[impregchance]";
			WaitLineBreak;
			say "     You both lie there for a minute, panting as you try to absorb what just happened. Eventually her cock starts to soften and she pulls it back out of you, then staggers back to lean on the counter, while you stare up at her from your position on the floor. Angie looks down at you with a self-satisfied look on her face, her skirt still hanging uselessly on her tired body as she regains her balance after her recent exertions.";
			say "     'That was unbelievably amazing,' she says with a self-satisfied look on her face, stroking her soft fur happily. 'Don't you want to do that again soon? Maybe even with a real panther as well? I know I just can't wait,' Angie says with a dreamy smile as she looks down at you panting on the floor, her teasing words speaking to some part of you and making you imagine being held down and fucked by both Angie, and several other large masculine cats, the increasingly erotic images filling your mind and making your body tingle with desire again even as you try to recover from your intense orgasm.";
			WaitLineBreak;
			say "     'A nice, large panther mounting me while I mount you - doesn't that sound nice? Or maybe he could mount you while I put that lovely little mouth of yours to use, or maybe we could even have him mount you while I mount him...' Angie purrs, obviously lost in thought for a minute before focusing on you again. 'Or maybe I could just mount you myself every time and make you my sexy little mate, and you could submit to me every night and be my little sexy panther pet, and I could be his...' the large panther herm says teasingly, obviously seriously interested in the erotic idea as she looks at you with a happy smile on her muzzle.";
		Infect "Pantherherm";
		now lastfuck of Angie is turns;
		now lastfuck of Midnight is turns;

to say AngieSex3: [herm sex with Angie]
	if AngieAroused is 0:
		say "     Angie looks at you with desire, though she is still hesitant about this and says, 'I'm not really sure it's ok to just give in to the urges like this, but it does feel so very, very good. Do you really think it's ok?' Seems like she'll need a little bit of convincing yet before you can fuck her. Doing your best to calm and reassure her, you...";
		LineBreak;
		let bonus be (( the Charisma of the player minus 10 ) divided by 2);
		let diceroll be a random number from 1 to 20;
		say "You roll 1d20([diceroll])+[bonus]: [diceroll + bonus] (Charisma-Check)";
		increase diceroll by bonus;
		say "     [line break][line break]";
		if diceroll > 12:
			say "     ...manage to get her over that last reluctance. 'Just a little bit of fun couldn't hurt...' Angie almost moans as she leans towards you, lust rising in her eyes. She continues, 'I just can't keep denying myself what I need.' Then she leans closer, shrugging her vest off onto the floor as she rubs herself up against you. 'Mmm! It feels like you need it too,' Angie says as she rubs your cock, before one of her hands drifts down farther to your excited pussy before stroking it a few times as well. 'And just like me it looks like you have two different sets of equipment to play with now don't you,' Angie says as she lets out a sultry purr, obviously anticipating the upcoming fun.";
			say "     'Of course the real question then is, how do we want to do this? I know I would just love it if you mounted me with that wonderfully stiff cock, just like HE did when he changed me, though I could try putting my own cock to good use on you as well,' Angie says, her mouth open and panting as she stares at you. 'So what do you want to do first? Do you want to mount me like an animal in heat?' she asks you, the thought obviously getting her even more aroused as she waits for your answer.";
			LineBreak;
			say "     Fuck Angie (Y), or get fucked by her (N)? ";
			if player consents:
				LineBreak;
				say "     'Oh god, I need that in me so bad!' Angie says with a moan, before backing off and turning away from you. You are slightly surprised for a moment, but her intent instantly becomes clear as she leans over and braces herself over the shop's counter, her large breasts pressed up against its glass top. Her panther tail lifts straight up above her raised ass, giving you a tantalizing view of her winking lips. When you don't move forward immediately, she shoots a pleading back at you over her shoulder. 'Please, I need you. God! I need you to mount me with that wonderful [cock of player] cock so badly, and take me like an animal just like HE did, please!'";
				WaitLineBreak;
				say "     She keeps begging as she wiggles her hips at you, her tail lashing in arousal and need. You find yourself unable to turn down such an obviously desperate plea for your attention and decide it would be best to give her what she wants. Moving up behind her large form, you grin as she wiggles her ass at you, the tail lashing and teasing you until you pin it down. You find yourself gripping her hips tightly and Angie moans as you rub your cock over her needy hole.";
				say "     Delighted by her reaction to your member, you swiftly sheath yourself inside her, letting out a gasp of pleasure as her hot velvet folds part readily for your cock. Angie moans and writhes underneath you like a cat in heat, and you pull out slightly, then begin to pump your hard cock into her over and over again. The feeling of her soft furred body underneath you as you fuck her tight hole is amazing, and Angie seems to be loving the feeling even more, as she gasps and pants for you to take her harder, and faster, and to pin her down and take her like an animal.";
				WaitLineBreak;
				say "     You can't help but grin as you respond to her need by doing what she asks, increasing your pace as you lean over her form, pressing her down against the shop counter as she yowls out her pleasure to the empty room, each lusty and needful sound another sign of your total victory over her body. All too soon, you reach the point of no return and orgasm within her hot folds, your seed shooting into her needy passage triggering Angie's own earth-shattering orgasm. She lets loose a loud cat-like scream of pleasure, as her cock covers the front of the counter with her own seed, and her trembling folds milk seem to milk every last bit of cum out of you.";
				say "     Eventually you both manage to come back to your senses, and as you pull out of her, Angie looks back at you with a self-satisfied look on her face. Her skirt still hangs uselessly on her well-fucked body as she regains her balance after your exertions. 'That was amazing! We have to do this again and again soon. God, I can't believe I ever didn't want to give in to anything that feels this good!' Angie says with a happy smile as she looks at you in thanks. 'And I owe it all to your help. If I can ever do anything to repay you, you let me know!' she tells you with obvious sincerity, before adding, 'And maybe next time I can help you feel so happily full of cum yourself,' she says with a glance at your unused female parts. Then she starts to clean up the new mess the two of you made.";
			else:
				LineBreak;
				say "     'Mmm! You would rather experience being mounted yourself, I see,' Angie says with a feline grin, 'I really can't say that I blame you for that, and I have to admit I AM looking forward to trying this wonderful new cock of mine out on you.' Angie runs her hands over your body, focusing her attentions on your breasts and your already a bit moist sex, before leaning over and giving you a long kiss, her tongue teasing yours as her large breasts press up against your body.";
				say "     And they are not the only thing pressing up against you - Angie's thick panther cock brushes against your belly, obviously erect and ready for the fun to come. Breaking the kiss, you find yourself panting almost as much as she is, the scent of her strong feline arousal overwhelming you, immediately vanquishing any thoughts you might have to resist her attentions.";
				WaitLineBreak;
				say "     Indeed, you aren't able to resist her at all, just going along with it as she moves behind you, her large paws pushing you down onto the ground in front of her, where you can't resist hiking your ass up in the air and bracing yourself on your hands and knees for what is to come. Angie wastes no time in gripping your hips and rubbing her cock against your rear, 'Now I've never done this before,' Angie says with a moan as her cock brushes up between your thighs, making you shiver at the soft barbs rubbing up against your skin, 'This is all just instinct on my part, so just bear with me.'";
				say "     Immediately after her admission, she begins to thrust herself against you, her cock rubbing against your crotch several times before it finally finds its way inside your swollen nether lips. You gasp in lust and Angie lets out a yowl of pleasure as her cock plunges into you, the barbs on her feline member sending miniature explosions of pleasure through you as they press into your inner walls. After a second of the two of you on all fours with Angie mounted atop you, coming to grips with the wonderful new feelings, Angie fully gives in to her male instincts and begins fucking you in earnest.";
				WaitLineBreak;
				say "     She starts pulling out and thrusting into you again and again in short rough movements, the barbs pulling and tugging at your inner folds in a strangely pleasurable manner. Then she leans her body down over you, her large breasts pressing into your back as she rests more and more of her weight on you, forcing your face down to the ground as her thrusts increase in both speed and force. You are panting in desire as she covers you and fucks you roughly, with an almost bestial abandon, and then acting on some inner instinct of her own, Angie lets out a growl, and grips the back of your neck with her teeth.";
				say "     Pleasure shoots through you as her teeth lightly but firmly grip your skin, and the feral sex exposes that Angie's transformation and your encouragement have stripped her of some of her humanity. You realize you are trapped helplessly under a wild beast and that your will and desires are completely secondary to her bestial needs while she claims you with such rough fucking... and it feels so wonderful that you can't help but arch your back and present yourself more fully to the creature that is mastering your body, encouraging her thoughtless, animal dominance. As your wild coupling continues, you soon find yourself screaming in orgasm, just as Angie lets loose her own beast-like roar above you, her cock shooting its changed seed deep into your body.[impregchance]";
				WaitLineBreak;
				say "     You both lie there for a minute, panting as you try to absorb what just happened. Eventually her cock starts to soften and she pulls it back out of you, then staggers back to lean on the counter, while you stare up at her from your position on the floor. Angie looks down at you with a self-satisfied look on her face, her skirt still hanging uselessly on her tired body as she regains her balance after her recent exertions.";
				say "     'That was unbelievably amazing,' she says with a lusty grin on her face. 'God, we have to do this again soon. I just can't believe I ever didn't want to give in to feelings this amazing. Hell, I wish I had gained a cat cock even sooner!' Angie says with a dreamy smile as she looks down at you in thanks. 'And I owe it all to you and your help. I never would have discovered how good it could be if it wasn't for you. If I can ever do anything to repay you, you let me know!' she tells you with obvious sincerity. 'And maybe next time you can take a turn mounting me,' she adds with a glance at your cum-dripping cock. She then starts to clean up the new mess the two of you made.";
			now lastfuck of Angie is turns;
			if AngieAroused < 6:
				increase AngieAroused by 1;
		else:
			say "     ...can't quite manage to quell her fears. Biting her lip, the pantheress gives a shake of her head and moves back a few steps with a sigh.";
	else if AngieAroused > 0 and AngieAroused < 7: [undecided Angie without Midnight]
		say "     'Ready to play with the kitty again?' Angie says, trailing one of her claws down your chest teasingly. Her soft rumbling purr fills the gift shop and the scent of her arousal spikes even higher, making you grin at how eager she is to play as she tosses her vest to the side without hesitation. 'I haven't been able to think of much else since you showed me what I was missing,' she purrs as she rubs her large breasts up against your body, the formerly reluctant pantherherm obviously having no remaining inhibitions. Lowering her muzzle down to yours and kissing you eagerly, her feline tongue teases your own as she clutches you tightly to her.";
		say "     Eventually she breaks the kiss, panting needily and obviously aroused, looking at you with her slit-pupiled eyes already filling with bestial lust. 'It looks like your nice and ready to play with me too,' Angie moans seductively as she rubs your cock, before one of her paws drifts down farther to your excited pussy before stroking it a few times as well. 'And just like me you have two different sets of equipment to play with now don't you,' Angie teases as she lets out a sultry purr, her pawlike hands stroking your body eagerly, obviously anticipating the upcoming fun.";
		WaitLineBreak;
		say "     'Of course the real question then is, how do we want to do this? I know I would just love it if you mounted me with that wonderfully stiff cock, just like HE did when he changed me, mating me like the wonderful slutty little beast I am.' She murrs slightly at the obviously arousing thought, before continuing, 'Though I could try putting my lovely new cock to good use on you as well, it would make me sooo happy to help you feel the pleasure of being mated properly, down on all fours like a proper panther,' Angie says, her muzzle hanging open as she pants with lust as she stares at you. 'So what do you want to do first? Do you want to mount me like an animal in heat?' she asks you, the thought obviously getting her even more aroused as she waits for your answer.";
		LineBreak;
		say "     Fuck Angie (Y), or get fucked by her (N)? ";
		if player consents:
			LineBreak;
			say "     'Oh god yes, I can't wait!' Angie says with a moan, her paw trailing over your [cock of player] cock one last time, then she backs off and turns away from you. You are slightly surprised for a moment, but her intent instantly becomes clear as she leans over and braces herself over the shop's counter, her large breasts pressed up against its glass top. Her panther tail lifts straight up above her raised ass, giving you a tantalizing view of her winking lips. When you don't move forward immediately, she shoots a pleading back at you over her shoulder. 'Please, I need you. God! I need you to mount me with that wonderful [cock of player] cock so badly, and take me like an animal just like HE did, please!'";
			WaitLineBreak;
			say "     She keeps begging as she wiggles her hips at you, her tail lashing in arousal and need. You find yourself unable to turn down such an obviously desperate plea for your attention and decide it would be best to give her what she wants. Moving up behind her large form, you grin as she wiggles her ass at you, the tail lashing and teasing you until you pin it down. You find yourself gripping her hips tightly and Angie moans as you rub your cock over her needy hole.";
			say "     Delighted by her reaction to your member, you swiftly sheath yourself inside her, letting out a gasp of pleasure as her hot velvet folds part readily for your cock. Angie moans and writhes underneath you like a cat in heat, and you pull out slightly, then begin to pump your hard cock into her over and over again. The feeling of her soft furred body underneath you as you fuck her tight hole is amazing, and Angie seems to be loving the feeling even more, as she gasps and pants for you to take her harder, and faster, and to pin her down and take her like an animal.";
			WaitLineBreak;
			say "     You can't help but grin as you respond to her need by doing what she asks, increasing your pace as you lean over her form, pressing her down against the shop counter as she yowls out her pleasure to the empty room, each lusty and needful sound another sign of your total victory over her body. All too soon, you reach the point of no return and orgasm within her hot folds, your seed shooting into her needy passage triggering Angie's own earth-shattering orgasm. She lets loose a loud cat-like scream of pleasure, as her cock covers the front of the counter with her own seed, and her trembling folds milk seem to milk every last bit of cum out of you.";
			say "     Eventually you both manage to come back to your senses, and as you pull out of her, Angie looks back at you with a self-satisfied look on her face. Her skirt still hangs uselessly on her well-fucked body as she regains her balance after your exertions. 'That was just amazing,' the pantheress purrs happily. 'Almost as good as having a real cat mount me,' Angie says teasingly as she rubs her dark-furred body up against you. 'I almost can't wait till you can fuck me like that again, holding me down and making me a proper kitty toy for you to use whenever you want...' She murrs softly with excitement at the thought, and you find the image of the strong panther-woman submitting to you again and again to be rather enticing as well. 'I wish you could know what it was like to feel this good, nice and mated by a hot sexy panther,' she murrs teasingly even as she rubs up against you one last time, her paw trailing down over your damp female opening teasingly, before relaxing back on the counter, with a happy smile on her muzzle, leaving you feeling strangely aroused at the thought.";
			now lastfuck of Angie is turns;
		else:
			LineBreak;
			say "     'Oh yes, I knew you couldn't resist the temptation to be mated like a needy female in heat,' Angie says happily, as a large feline grin spreads across her muzzle, 'It's the most amazing feeling ever, a strong male cat pinning you down while his cock enters your body again and again...' Angie runs her hands over your body, focusing her attentions on your breasts and your already a bit moist sex, before leaning over and giving you a long kiss, her tongue teasing yours as her large breasts press up against your body.";
			say "     And they are not the only thing pressing up against you - Angie's thick panther cock brushes against your belly, obviously erect and ready for the fun to come. Breaking the kiss, you find yourself panting almost as much as she is, the scent of her strong feline arousal overwhelming you, immediately vanquishing any thoughts you might have to resist her attentions.";
			WaitLineBreak;
			say "     Indeed, you aren't able to resist her at all, just going along with it as she moves behind you, her large paws pushing you down onto the ground in front of her, where you can't resist hiking your ass up in the air and bracing yourself on your hands and knees for what is to come. Angie wastes no time in gripping your hips and rubbing her cock against your rear, 'So very eager, you need it just as badly as I did,' Angie says teasingly, with a soft moan as her cock brushes up between your thighs, making you shiver at the soft barbs rubbing up against your skin. You can hear her whisper teasingly into your ear through her harsh panting, 'Don't worry, it only gets better from here, and soon you won't be able to imagine being anything other than a proper little mate for the cats. Wanting them to pin you down, and fill you with that wonderful feline cock again and again like a cat in heat...'";
			say "     You would respond, but she gives you no time to think about her incredibly erotic words, as she begins to thrust herself against you, her cock rubbing against your crotch several times before it finally finds its way inside your swollen nether lips. You gasp in lust and Angie lets out a yowl of pleasure as her cock plunges into you, the barbs on her feline member sending miniature explosions of pleasure through you as they press into your inner walls. After a second of the two of you on all fours with Angie mounted atop you, coming to grips with the wonderful new feelings, Angie fully gives in to her male instincts and begins fucking you in earnest.";
			WaitLineBreak;
			say "     She starts pulling out and thrusting into you again and again in short rough movements, the barbs pulling and tugging at your inner folds in a strangely pleasurable manner. Then she leans her body down over you, her large breasts pressing into your back as she rests more and more of her weight on you, forcing your face down to the ground as her thrusts increase in both speed and force. You are panting in desire as she covers you and fucks you roughly, with an almost bestial abandon, and then acting on some inner instinct of her own, Angie lets out a growl, and grips the back of your neck with her teeth.";
			say "     Pleasure shoots through you as her teeth lightly but firmly grip your skin, and the feral sex exposes that Angie's transformation and your encouragement have stripped her of some of her humanity. You realize you are trapped helplessly under a wild beast and that your will and desires are completely secondary to her bestial needs while she claims you with such rough fucking... and it feels so wonderful that you can't help but arch your back and present yourself more fully to the creature that is mastering your body, encouraging her thoughtless, animal dominance. As your wild coupling continues, you soon find yourself screaming in orgasm, just as Angie lets loose her own beast-like roar above you, her cock shooting its changed seed deep into your body.[impregchance]";
			WaitLineBreak;
			say "     You both lie there for a minute, panting as you try to absorb what just happened. Eventually her cock starts to soften and she pulls it back out of you, then staggers back to lean on the counter, while you stare up at her from your position on the floor. Angie looks down at you with a self-satisfied look on her face, her skirt still hanging uselessly on her tired body as she regains her balance after her recent exertions.";
			say "     'That was unbelievably amazing,' she says with a self-satisfied look on her face, stroking her soft fur happily. 'Don't you want to do that again soon? Maybe even with a real panther as well? I know I just can't wait,' Angie says with a dreamy smile as she looks down at you panting on the floor, her teasing words speaking to some part of you and making you imagine being held down and fucked by both Angie, and several other large masculine cats, the increasingly erotic images filling your mind and making your body tingle with desire again even as you try to recover from your intense orgasm.";
			WaitLineBreak;
			say "     'A nice, large panther mounting me while I mount you, doesn't that sound nice, or maybe you could mount me while he mounts you...' Angie purrs, obviously lost in thought for a minute before focusing on you again, 'Or maybe I could just mount you again soon, and make you my mate, then we could take turns being on top' the large panther herm says teasingly, obviously seriously interested in the erotic idea as she looks at you with a happy smile on her muzzle.";
			now lastfuck of Angie is turns;
		if AngieAroused < 6:
			increase AngieAroused by 1;
	else if AngieAroused is 7: [player-Angie relationship]
		say "     <sex>";
	else if AngieAroused is 50: [Midnight present]
		say "     'That sounds awesome!' the naked and obviously excited panther herm says at your proposition, purring as she leans close to you, her soft warm body rubbing up against yours. 'I just can't thank you enough for all you've done for me, but maybe I can start by showing you just how much fun I can be now?' Angie says teasingly, her enticing scent filling your nose and making you pant eagerly even as she runs her softly furred hand over your [skin of player] skin. You find your hands stroking her soft black fur almost on their own, and soon she lowers her muzzle down to yours and kisses you enthusiastically, her feral feline taste exploding in your mouth while her rumbling purr rolls through your body.";
		say "     The two of you get interrupted by another soft rumbling noise, and Angie breaks the kiss, still panting with lust, so the two of you can turn to look to where Midnight is watching with obvious interest. The large black feline is lying sprawled on his side, his golden eyes gleaming in the dimly lit gift shop, the tip of his tail lashing from side to side behind him as he lets out another low rumbling purr. 'Mmmm, I think Midnight wants to play too. What do you think, should we let join in?' Angie purrs out, obviously excited by the idea of the large cat being with her at the same time you are. 'Or should we just give the big kitty a nice show instead?' she says as she playfully strokes your cheek with the back of her slightly paw-like hand.";
		LineBreak;
		say "     Do you let Midnight join you?";
		if player consents:
			LineBreak;
			say "     'This sounds like so much fun, and it gives me a wonderful idea,' Angie says with a purr as she moves over to you, taking your hand in her paw and leading you over to where Midnight is lying sprawled out on the floor. 'A wonderfully naughty idea,' she says with a soft chuff as she pulls you down next to the panther with her. Midnight looks over at the two of you curiously as Angie rubs herself up against him, slowly pushing the large cat over onto his back. 'Mmm, yes! I want to play with him, while you pound yourself into me nice and rough...'";
			say "     Angie moans as she trails her hand down your chest, the tip of one claw gently rubbing across your erect cock for a second, then she turns to face Midnight, shifting her hips so that they rub up against your body teasingly. You groan with increasing arousal as she rub's Midnight's pussy and the cat get the idea of what she wants to do and starts to purrs happily. As Angie moves up between the herm feline's legs and positions herself above the panther, you waste no time in following her. With a feline grin at you over her shoulder, she reaches back and guides your stiff cock to her damp passage. She moans as you slide your arms around her body and grip her close, your cock sinking into her waiting female opening, its warm folds welcoming you into her body eagerly.";
			WaitLineBreak;
			say "     You find yourself groaning in pleasure as she shifts her hips slightly, rubbing them up against you as she lines herself up, then she shifts forward, pulling you with her as she sheathes her own cock into the panther beneath you both. Midnight lets out a soft yowl of pleasure and the feline's front paws rub across Angie's furred shoulders as the panther tries to pull her close. The sight of the woman you're having sex with mating a feral beast at the same time is strangely erotic and you find yourself gripping Angie tightly as you begin to thrust into her.";
			say "     The herm panther woman yowls in pleasure and runs her hands over the panther under her, even pulling Midnight's muzzle to her own for a deep kiss as she moves eagerly between the two of you. The sight of the formerly reluctant zookeeper giving herself over so completely to the pleasures of her new form only excites you even more, and you groan as you thrust into her body with increased vigor. Lust fills your mind as Angie writhes between your bodies, her soft fur pressing up against your chest even as her tail rubs up against your side and her tight pussy gripping your cock tightly with every wonderful thrust into the pantheress's body.";
			WaitLineBreak;
			say "     Soon she is unable to hold out under the dual stimulation you and Midnight are giving her, and Angie yowls with pleasure as she orgasms between you. Feeling her orgasm is just too much for you to resist, and you groan with pleasure as your own intense climax wracks your body, your cock spilling its seed into her even as Midnight yowls and paints her chest with the panther's own seed. Groaning, you pull yourself out of her, completely spent, only to smile at her nearly boneless collapse on top of Midnight, her rumbling purr of sexual satisfaction filling the room even as Midnight licks the top of her head several times in approval.";
			say "     Helping Angie off the large cat, you are surprised by her sudden turn to give you a deep kiss as well. Midnight chuffs in amusement as she kisses you, then collapses back down onto the blanket next to the black panther. With the happy look of a well-fucked feline on her face, Angie relaxes next to you for a while, making you feel rather proud of your efforts.";
		else:
			LineBreak;
			say "     'Well then, let's put on a nice and exciting show for him. It looks like you are certainly ready to perform,' Angie says teasingly as she rubs your cock, before one of her paws drifts down farther to your excited pussy before stroking it a few times as well. 'And just like me you have two different lovely sets of equipment to play with now don't you,' Angie teases as she lets out a sultry purr, her paw-like hands stroking your body eagerly, obviously anticipating the upcoming fun.";
			say "     'Of course the real question then is, how do we want to do this? I know I would just love it if you mounted me with that wonderfully stiff cock, filling me up with that wonderfully stiff cock, just like he does, rutting me like the slutty little beast I am.' She murrs slightly at the obviously arousing thought, before continuing, 'Though I could try putting my lovely new cock to good use on you as well, it would make me sooo happy to help you feel the pleasure of being mated properly, down on all fours like a proper panther,' Angie says, her muzzle hanging open as she pants with lust as she stares at you. 'So what do you want to do first? Do you want to mount me like an animal in heat?' she asks you, the thought obviously getting her even more aroused as she waits for your answer.";
			LineBreak;
			say "     Fuck Angie (Y), or get fucked by her (N)? ";
			if player consents:
				LineBreak;
				say "     'Oh god yes, I can't wait!' Angie says with a moan, her paw trailing over your [cock of player] cock one last time, then she backs off and turns away from you. You are slightly surprised for a moment, but her intent instantly becomes clear as she leans over and braces herself over the shop's counter, her large breasts pressed up against its glass top. Her panther tail lifts straight up above her raised ass, giving you a tantalizing view of her winking lips. When you don't move forward immediately, she shoots a pleading back at you over her shoulder. 'Please, I need you. God! I need you to mount me with that wonderful [cock of player] cock so badly, and take me like an animal just like HE did, please!'";
				WaitLineBreak;
				say "     She keeps begging as she wiggles her hips at you, her tail lashing in arousal and need. You find yourself unable to turn down such an obviously desperate plea for your attention and decide it would be best to give her what she wants. Moving up behind her large form, you grin as she wiggles her ass at you, the tail lashing and teasing you until you pin it down. You find yourself gripping her hips tightly and Angie moans as you rub your cock over her needy hole.";
				say "     Delighted by her reaction to your member, you swiftly sheath yourself inside her, letting out a gasp of pleasure as her hot velvet folds part readily for your cock. Angie moans and writhes underneath you like a cat in heat, and you pull out slightly, then begin to pump your hard cock into her over and over again. The feeling of her soft furred body underneath you as you fuck her tight hole is amazing, and Angie seems to be loving the feeling even more, as she gasps and pants for you to take her harder, and faster, and to pin her down and take her like an animal.";
				WaitLineBreak;
				say "     You can't help but grin as you respond to her need by doing what she asks, increasing your pace as you lean over her form, pressing her down against the shop counter as she yowls out her pleasure to the empty room, each lusty and needful sound another sign of your total victory over her body. All too soon, you reach the point of no return and orgasm within her hot folds, your seed shooting into her needy passage triggering Angie's own earth-shattering orgasm. She lets loose a loud cat-like scream of pleasure, as her cock covers the front of the counter with her own seed, and her trembling folds milk seem to milk every last bit of cum out of you.";
				say "     Eventually you both manage to come back to your senses, and as you pull out of her, Angie looks back at you with a self-satisfied look on her face. Her skirt still hangs uselessly on her well-fucked body as she regains her balance after your exertions. 'That was just amazing,' the pantheress purrs happily. 'Almost as good as having a real cat mount me,' Angie says teasingly as she rubs her dark-furred body up against you. 'I almost can't wait till you can fuck me like that again, holding me down and making me a proper kitty toy for you to use whenever you want... I can be a proper pet for you and Midnight.' She murrs softly with excitement at the thought, and you find the image of the strong panther-woman submitting to you again and again to be rather enticing as well. 'I wish you could know what it was like to feel this good, nice and mated by a hot sexy panther,' she murrs teasingly even as she rubs up against you one last time, her paw trailing down over your damp female opening teasingly, before relaxing back on the counter, with a happy smile on her muzzle, leaving you feeling strangely aroused at the thought.";
			else:
				LineBreak;
				say "     'Oh yes, I knew you couldn't resist the temptation to be mated like a needy female in heat,' Angie says happily, as a large feline grin spreads across her muzzle, 'It's the most amazing feeling ever, a strong male cat pinning you down while his cock enters your body again and again...' Angie runs her hands over your body, focusing her attentions on your breasts and your already a bit moist sex, before leaning over and giving you a long kiss, her tongue teasing yours as her large breasts press up against your body.";
				say "     And they are not the only thing pressing up against you - Angie's thick panther cock brushes against your belly, obviously erect and ready for the fun to come. Breaking the kiss, you find yourself panting almost as much as she is, the scent of her strong feline arousal overwhelming you, immediately vanquishing any thoughts you might have to resist her attentions.";
				WaitLineBreak;
				say "     Indeed, you aren't able to resist her at all, just going along with it as she moves behind you, her large paws pushing you down onto the ground in front of her, where you can't resist hiking your ass up in the air and bracing yourself on your hands and knees for what is to come. Angie wastes no time in gripping your hips and rubbing her cock against your rear, 'So very eager, you need it just as badly as I did,' Angie says teasingly, with a soft moan as her cock brushes up between your thighs, making you shiver at the soft barbs rubbing up against your skin. You can hear her whisper teasingly into your ear through her harsh panting, 'Don't worry, it only gets better from here, and soon you won't be able to imagine being anything other than a proper little mate for the cats. Wanting them to pin you down, and fill you with that wonderful feline cock again and again like a cat in heat...'";
				say "     You would respond, but she gives you no time to think about her incredibly erotic words, as she begins to thrust herself against you, her cock rubbing against your crotch several times before it finally finds its way inside your swollen nether lips. You gasp in lust and Angie lets out a yowl of pleasure as her cock plunges into you, the barbs on her feline member sending miniature explosions of pleasure through you as they press into your inner walls. After a second of the two of you on all fours with Angie mounted atop you, coming to grips with the wonderful new feelings, Angie fully gives in to her male instincts and begins fucking you in earnest.";
				WaitLineBreak;
				say "     She starts pulling out and thrusting into you again and again in short rough movements, the barbs pulling and tugging at your inner folds in a strangely pleasurable manner. Then she leans her body down over you, her large breasts pressing into your back as she rests more and more of her weight on you, forcing your face down to the ground as her thrusts increase in both speed and force. You are panting in desire as she covers you and fucks you roughly, with an almost bestial abandon, and then acting on some inner instinct of her own, Angie lets out a growl, and grips the back of your neck with her teeth.";
				say "     Pleasure shoots through you as her teeth lightly but firmly grip your skin, and the feral sex exposes that Angie's transformation and your encouragement have stripped her of some of her humanity. You realize you are trapped helplessly under a wild beast and that your will and desires are completely secondary to her bestial needs while she claims you with such rough fucking... and it feels so wonderful that you can't help but arch your back and present yourself more fully to the creature that is mastering your body, encouraging her thoughtless, animal dominance. As your wild coupling continues, you soon find yourself screaming in orgasm, just as Angie lets loose her own beast-like roar above you, her cock shooting its changed seed deep into your body.[impregchance]";
				WaitLineBreak;
				say "     You both lie there for a minute, panting as you try to absorb what just happened. Eventually her cock starts to soften and she pulls it back out of you, then staggers back to lean on the counter, while you stare up at her from your position on the floor. Angie looks down at you with a self-satisfied look on her face, her skirt still hanging uselessly on her tired body as she regains her balance after her recent exertions.";
				say "     'That was unbelievably amazing,' she says with a self-satisfied look on her face, stroking her soft fur happily. 'Don't you want to do that again soon? Maybe even with a real panther as well? I know I just can't wait,' Angie says with a dreamy smile as she looks down at you panting on the floor, her teasing words speaking to some part of you and making you imagine being held down and fucked by both Angie, and several other large masculine cats, the increasingly erotic images filling your mind and making your body tingle with desire again even as you try to recover from your intense orgasm.";
				WaitLineBreak;
				say "     'A nice, large panther mounting me while I mount you - doesn't that sound nice? Or maybe you could mount me while he mounts you...' Angie purrs, obviously lost in thought for a minute before focusing on you again. 'Or maybe I could just mount myself every time and make you my mate. Then we could take turns being on top,' the large panther herm says teasingly, obviously seriously interested in the erotic idea as she looks at you with a happy smile on her muzzle.";
		Infect "Pantherherm";
		now lastfuck of Angie is turns;
		now lastfuck of Midnight is turns;

to say AngieSex4: [Angie rides the player's cock]
	say "     'You want to fuck me, lover? Drive that [cock of player] shaft deep into my pussy? Mmmh - I can't wait!' Angie gives an aroused mrowl and starts making out with you while her hands roam over your body, pulling off your clothes in eager haste. Soon, you're both completely naked and Angie steps back, letting her eyes roam over your shapely form. 'Mmm, yes! It looks like you're definitely ready,' she says as she runs one of her soft paws teasingly over your crotch, paw-pads gently stroking over your balls and cock, making you gasp with renewed arousal as the panther herm chuckles at your eager response. 'It'll be so great to feel this hard pole inside me. I wanna ride you like a needy female in heat,' Angie says happily, a large feline grin spreading across her muzzle, 'Ready to have your world rocked, baby?'";
	say "     Angie runs her hands over your body, focusing her attentions on your chest and nipples, as well as the rapidly hardening manhood between your legs, before leaning over and giving you a long kiss, her tongue teasing yours as her large breasts press up against your body. And they are not the only thing pressing up against you - Angie's thick panther cock brushes against your belly, obviously erect and ready for the fun to come. Breaking the kiss, you find yourself panting almost as much as she is, the scent of her strong feline arousal overwhelming you, forgetting everything but the exaltation of being together with her right now.";
	WaitLineBreak;
	say "     Eager to be under her again, you allow her take command as gently pushes down on your shoulders, directing you to get on the ground in front of her and lie on your back. Looking at her sexy body and swollen nether lips from below, you ready yourself for what is to come as you see her step over you putting her digitigrade paws left and right of your hips. Angie wastes no time and quickly gets down on the ground with you, kneeling over you and rubbing her soft folds teasingly against your proudly standing [cock of player] shaft. 'So very eager,' she mrowls amusedly as you pant in lust and give a reflexive thrust of your hips, 'I'm not gonna let you wait one second more.' With that, she grasps your manhood in a paw-hand, holding it up so she can sink down on top of it and take it deep into her pussy. The two of you moan loudly as your hips meet and for a moment you can do nothing but just take in the feelings this intimate connection with the pantherherm gives you. Meanwhile, Angie leans over you, her tongue licking your cheek as she softly mrowls, 'I just want to be with you, always. Stay with me, [if AngieHappy < 4]be [end if]my mate. Let me take you inside again and again...'";
	say "     You would respond, but she gives you no time to think about her incredibly erotic words as she begins to rock back and forth on top of you, making your cock rub against her warm and tight insides. You gasp in lust from the sensations she gives you and reach up, cupping and kneading the pantheress['] round breasts. A moment later, Angie lets out a yowl of pleasure as your manhood touches a very sensitive spot inside her and the trembling of her inner walls around your cock. That flare of arousal wakes a deep sexual need in Angie, making her ride you like an untamed beast, truly a feline in heat now.";
	WaitLineBreak;
	say "     It is a wild bit of fun to get taken by Angie like this, seeing the beautiful pantheress rear up on top of you, leaning back while rubbing her breasts, then suddenly pounce down on you again, her muzzle licking and kissing while she rocks on your hips. A resounding purr from her throat fills the air in the gift shop, and you can even feel it resonate through her body and give your cock a nice little extra tingle. Your own hands meanwhile get busy stroking the sides of her legs, rubbing over soft and warm fur, then move on to grope the full pair of furry balls dangling just above Angie's pussy, as well as her full and erect panther cock.";
	say "     Feeling the muscular feline's body on top of you, having her pant hotly against your face and lightly nip your lip after kissing you... feels wonderful. It still amazes you how far she has come from a shy woman hiding from roaming beasts when you found her, to become this sexy creature straddling your hips. Caring and friendly, but also wild and insatiable, plus just a bit dominating. More than willing to let her have the lead, you simply enjoy the coupling with her, and before much longer, you find yourself screaming in orgasm, bucking up your hips as you blast spurt after spurt of your seed into the large black pussy's pussy. Just seconds later, Angie lets loose her own beast-like roar above you, her cock shooting its changed load to splash down all over your chest and face.";
	WaitLineBreak;
	say "     You both lie there for a minute, panting to catch your breath while Angie cools down from her mating frenzy. Eventually, a measure of calm and reason returns into her eyes and after giving you a kiss, she pulls off your softening shaft and staggers to lean on the counter. You just keep where you are and stare up at her from your position on the floor, eyes taking in those shapely breasts and everything else of your sexy beast of a friend. Angie looks down at you with a self-satisfied look on her face, standing there proudly in the nude, her fur matted a bit with cum and sweat.";
	say "     'That was unbelievably amazing,' she finally says after taking a few more deep breaths, stroking her fur happily. 'Stay here with me and let's do that again soon. I know I just can't wait,' Angie says with a dreamy smile as she looks down at you panting on the floor, her words speaking to some part of you that imagines all kinds of sexy things to do with her as your girlfriend. The increasingly erotic images fill your mind and make your body tingle with desire again even as you try to recover from your intense orgasm.";
	Infect "Pantherherm";

to say AngieSex5: [Angie fucks the player]
	setmonster "Pantherherm";
	choose row monster from the Table of Random Critters;
	if player is herm:
		say "     As you step up to Angie ant tell her you want to get fucked, the pantheress draws you into an eager kiss, then pants, 'Of course, my love. Do you want to take my cock in your pussy, or rather that tight and sexy ass of yours? (Y = pussy, N = ass)'";
		if player consents:
			say "[Angie5PussyFuck]";
		else:
			say "[Angie5AssFuck]";
	else if player is female:
		say "[Angie5PussyFuck]";
	else:
		say "[Angie5AssFuck]";
	Infect "Pantherherm";

to say Angie5PussyFuck:
	say "     Angie gives an aroused mrowl and starts making out with you while her hands roam over your body, pulling off your clothes in eager haste. Soon, you're both completely naked and Angie steps back, letting her eyes roam over your shapely form. 'Mmm, yes! It looks like you're definitely ready,' she says as she runs one of her soft paws teasingly over your increasingly damp pussy, paw-pads rubbing across your clit and making you gasp with renewed arousal as the panther herm chuckles at your eager response. 'You're like a needy female in heat and I'm the one who gets to mount you,' Angie says happily, a large feline grin spreading across her muzzle, 'Every time I sink my shaft into you, it feels so good... so right...'";
	say "     Angie runs her hands over your body, focusing her attentions on your breasts and your already a bit moist sex, before leaning over and giving you a long kiss, her tongue teasing yours as her large breasts press up against your body. And they are not the only thing pressing up against you - Angie's thick panther cock brushes against your belly, obviously erect and ready for the fun to come. Breaking the kiss, you find yourself panting almost as much as she is, the scent of her strong feline arousal overwhelming you, forgetting everything but the exaltation of being together with her right now.";
	WaitLineBreak;
	say "     Eager to be under her again, you allow her take command as she moves behind you, her large paws pushing you down onto the ground in front of her, where you can't resist hiking your ass up in the air and bracing yourself on your hands and knees for what is to come. Angie wastes no time in gripping your hips and rubbing her cock against your rear, 'So very eager, you need it just as badly as I did,' Angie says teasingly, with a soft moan as her cock brushes up between your thighs, making you shiver at the soft barbs rubbing up against your skin. You can hear her whisper teasingly into your ear through her harsh panting, 'I just want to be with you, always. Stay with me, [if Angiehappy < 4]be[end if] my mate. Let me pin you down and mount you with this feline cock again and again...'";
	say "     You would respond, but she gives you no time to think about her incredibly erotic words as she begins to thrust herself against you, her cock rubbing against your crotch several times before it finally finds its way inside your swollen nether lips. You gasp in lust and Angie lets out a yowl of pleasure as her cock plunges into you, the barbs on her feline member sending miniature explosions of pleasure through you as they press into your inner walls. After a second of the two of you on all fours with Angie mounted atop you, coming to grips with the wonderful new feelings, Angie fully gives in to her male instincts and begins fucking you in earnest.";
	WaitLineBreak;
	say "     She starts pulling out and thrusting into you again and again in short rough movements, the barbs pulling and tugging at your inner folds in a strangely pleasurable manner. Then she leans her body down over you, her large breasts pressing into your back as she rests more and more of her weight on you, forcing your face down to the ground as her thrusts increase in both speed and force. You are panting in desire as she covers you and fucks you roughly, with an almost bestial abandon, and then acting on some inner instinct of her own, Angie lets out a growl, and grips the back of your neck with her teeth.";
	say "     Pleasure shoots through you as her teeth lightly but firmly grip your skin, and the feral sex exposes that Angie's transformation and your encouragement have stripped her of some of her humanity. You realize you are trapped helplessly under a wild beast and that your will and desires are completely secondary to her bestial needs while she claims you with such rough fucking... and it feels so wonderful that you can't help but arch your back and present yourself more fully to the creature that is mastering your body, encouraging her thoughtless, animal dominance. As your wild coupling continues, you soon find yourself screaming in orgasm, just as Angie lets loose her own beast-like roar above you, her cock shooting its changed seed deep into your body.[fimpregchance]";
	WaitLineBreak;
	say "     You both lie there for a minute, panting as you try to absorb what just happened. Eventually her cock starts to soften and she pulls it back out of you, then staggers back to lean on the counter, while you stare up at her from your position on the floor. Angie looks down at you with a self-satisfied look on her face, standing there proudly in the nude, her fur matted a bit with cum and sweat.";
	say "     'That was unbelievably amazing,' she says after getting her breath back with a self-satisfied look on her face, stroking her fur happily. 'Stay here with me and let's do that again soon. I know I just can't wait,' Angie says with a dreamy smile as she looks down at you panting on the floor, her words speaking to some part of you that imagines all kinds of sexy things to do with her as your girlfriend. The increasingly erotic images fill your mind and make your body tingle with desire again even as you try to recover from your intense orgasm.";

to say Angie5AssFuck:
	say "     Angie gives an aroused mrowl and starts making out with you while her hands roam over your body, pulling off your clothes in eager haste. Soon, you're both completely naked and Angie steps back, letting her eyes roam over your shapely form. 'Mmm, yes! It looks like you're definitely ready,' she says as she runs one of her soft paws teasingly over your crotch, [if player is male]paw-pads gently stroking over your balls and cock,[else]paw-pads gently stroking over your genderless but still sensitive pubic area,[end if] making you gasp with renewed arousal as the panther herm chuckles at your eager response. 'You're like a needy female in heat and I'm the one who gets to mount you,' Angie says happily, a large feline grin spreading across her muzzle, 'Every time I sink my shaft into you, it feels so good... so right...'";
	say "     Angie runs her hands over your body, focusing her attentions on your chest and nipples[if player is male], as well as the rapidly hardening manhood between your legs[end if], before leaning over and giving you a long kiss, her tongue teasing yours as her large breasts press up against your body. And they are not the only thing pressing up against you - Angie's thick panther cock brushes against your belly, obviously erect and ready for the fun to come. Breaking the kiss, you find yourself panting almost as much as she is, the scent of her strong feline arousal overwhelming you, forgetting everything but the exaltation of being together with her right now.";
	WaitLineBreak;
	say "     Eager to be under her again, you allow her take command as she moves behind you, her large paws pushing you down onto the ground in front of her, where you can't resist hiking your ass up in the air and bracing yourself on your hands and knees for what is to come. Angie wastes no time in gripping your hips and rubbing her cock against your rear, 'So very eager, you need it just as badly as I did,' Angie says teasingly, with a soft moan as her cock brushes up between your thighs, making you shiver at the soft barbs rubbing up against your skin. You can hear her whisper teasingly into your ear through her harsh panting, 'I just want to be with you, always. Stay with me, [if Angiehappy < 4]be[end if] my mate. Let me pin you down and mount you with this feline cock again and again...'";
	say "     You would respond, but she gives you no time to think about her incredibly erotic words as she begins to thrust herself against you, her cock rubbing against your crotch several times before it finally catches on your puckered hole and presses inside. You gasp in lust and Angie lets out a yowl of pleasure as her cock plunges into you, the barbs on her feline member sending miniature explosions of pleasure through you as they press into your inner walls. After a second of the two of you on all fours with Angie mounted atop you, coming to grips with the wonderful new feelings, Angie fully gives in to her male instincts and begins fucking you in earnest.";
	WaitLineBreak;
	say "     She starts pulling out and thrusting into you again and again in short rough movements, the barbs pulling and tugging at your inner folds in a strangely pleasurable manner. Then she leans her body down over you, her large breasts pressing into your back as she rests more and more of her weight on you, forcing your face down to the ground as her thrusts increase in both speed and force. You are panting in desire as she covers you and fucks you roughly, with an almost bestial abandon, and then acting on some inner instinct of her own, Angie lets out a growl, and grips the back of your neck with her teeth.";
	say "     Pleasure shoots through you as her teeth lightly but firmly grip your skin, and the feral sex exposes that Angie's transformation and your encouragement have stripped her of some of her humanity. You realize you are trapped helplessly under a wild beast and that your will and desires are completely secondary to her bestial needs while she claims you with such rough fucking... and it feels so wonderful that you can't help but arch your back and present yourself more fully to the creature that is mastering your body, encouraging her thoughtless, animal dominance. As your wild coupling continues, you soon find yourself screaming in orgasm[if player is male], splattering the floor between your legs with cum[end if] just as Angie lets loose her own beast-like roar above you, her cock shooting its changed seed deep into your body.[mimpregchance]";
	WaitLineBreak;
	say "     You both lie there for a minute, panting as you try to absorb what just happened. Eventually her cock starts to soften and she pulls it back out of you, then staggers back to lean on the counter, while you stare up at her from your position on the floor. Angie looks down at you with a self-satisfied look on her face, standing there proudly in the nude, her fur matted a bit with cum and sweat.";
	say "     'That was unbelievably amazing,' she says after getting her breath back with a self-satisfied look on her face, stroking her fur happily. 'Stay here with me and let's do that again soon. I know I just can't wait,' Angie says with a dreamy smile as she looks down at you panting on the floor, her words speaking to some part of you that imagines all kinds of sexy things to do with her as your girlfriend. The increasingly erotic images fill your mind and make your body tingle with desire again even as you try to recover from your intense orgasm.";

to say AngieSex6: [giving her a blowjob]
	if AngieAroused is 0:
		say "     Angie looks at you with desire, though she is still hesitant about this and says, 'I'm not really sure it's ok to just give in to the urges like this, but it does feel so very, very good. Do you really think its ok?' Seems like she'll need a little bit of convincing yet before you can fuck her. Doing your best to calm and reassure her, you...";
		LineBreak;
		let bonus be (( the Charisma of the player minus 10 ) divided by 2);
		let diceroll be a random number from 1 to 20;
		say "You roll 1d20([diceroll])+[bonus]: [diceroll + bonus] (Charisma-Check)";
		increase diceroll by bonus;
		say "     [line break][line break]";
		if diceroll > 12:
			say "     ...manage to get her over that last reluctance. 'Just a little bit of fun couldn't hurt...' Angie almost moans as she leans towards you, lust rising in her eyes. She continues, 'I just can't keep denying myself what I need.' Then she leans closer, shrugging her vest off onto the floor as she rubs herself up against you, her hard cock resting hotly against your skin. 'This new cock of mine is making me feel so very hot and horny... sometimes I can barely think of anything but sinking it into a tight, wet pussy - or even ass.' Her face takes on an intense expression, looking at you as she dwells on an imagined coupling for a second, casually stroking her long feline shaft and drawing your gaze down to its meaty length. As she shakes off the fantasy a moment later and sees you staring at her cock, the pantherherm adds with a mrowl, 'I know you want it... and I'll give it to you. Come on, let's find out how much fun my wonderful new cock can be.'";
			if player is female:
				say "     Angie runs her hands over you, focusing her attentions on your breasts and your already a bit moist sex, before leaning over and giving you a long kiss, her tongue teasing yours as her large breasts press up against your body. And they are not the only thing pressing up against you - Angie's thick panther cock brushes against your belly, now fully erect and ready for the fun to come. Breaking the kiss, you find yourself panting almost as much as she is, the scent of her strong feline arousal overwhelming you, immediately vanquishing any thoughts you might have to resist her attentions.";
			else if player is male:
				say "     Angie runs her hands over you, focusing her attentions on your chest and your quickly hardening shaft, before leaning over and giving you a long kiss, her tongue teasing yours as her large breasts press up against your body. And they are not the only thing pressing up against you - Angie's thick panther cock brushes against your belly, now fully erect and ready for the fun to come. Breaking the kiss, you find yourself panting almost as much as she is, the scent of her strong feline arousal overwhelming you, immediately vanquishing any thoughts you might have to resist her attentions.";
			else:
				say "     Angie runs her hands over you, focusing her attentions on your chest and your sexless, but nevertheless quite sensitive crotch, before leaning over and giving you a long kiss, her tongue teasing yours as her large breasts press up against your body. And they are not the only thing pressing up against you - Angie's thick panther cock brushes against your belly, now fully erect and ready for the fun to come. Breaking the kiss, you find yourself panting almost as much as she is, the scent of her strong feline arousal overwhelming you, immediately vanquishing any thoughts you might have to resist her attentions.";
			WaitLineBreak;
			say "     Indeed, you aren't able to resist her at all, just going along with it as she move her large paws to push down on your shoulders, making you kneel on the ground in front of her. Having put you in the submissive position, looking up at her magnificent figure with its full and ripe breasts and black-furred sleek shape, Angie gives another lusty mrowl and starts to rub her erection against your face. One hand on your head as she moves her hips back and forth, she says, 'Now I've never done this before, but it sure feels nice.' And it is, even from your perspective - Angie's entrancing musk lies heavy in the air, and thankfully, the little spines on her shaft are pretty soft and nubby, only something that creates some extra sensations while fucking, not the wicked barbs some creatures sport. 'This is all just instinct on my part, so just bear with me.'";
			say "     Wanting to help the pantheress get over her inexperience with having such a big whopper of a cock as she has, you quickly take hold of the mighty organ and run your tongue up its underside, making Angie lean her head back and give a loud moan. 'Oooh yes - just like that,' she pants, letting a clawed hand sink to your head, pulling you close against her crotch. You just continue to service her, playing the tip of your tongue over the veins of her long shaft, then making your way further up and soon engulfing the tip of her shaft with your lips. 'Mmmmh,' the pantherherm mrowls with lust in her voice, giving an instinctive thrust with her hips.";
			WaitLineBreak;
			say "     As she buries her shaft for the first time in a warm and wet cave, it is as if something bestial and wild awakes inside the usually rather shy zookeeper. Angie lets out a yowl of pleasure as her cock plunges deeper, the nubby barbs on her feline member tickling your tongue as her cockhead pushes down your throat. Soon finding your nose firmly pressed into the anthro panther's black bush, you can't help but take deep whiffs of her aroused musk, giving you a heady, almost a little bit drunk feeling yourself. After a second or two in which you huff pantherherm pheromones and Angie comes to grips with the wonderful new feelings of her male half, the transformed zookeeper fully gives in to her new instincts and begins fucking your face in earnest.";
			say "     She starts pulling out and thrusting into you again and again in short rough movements, the soft barbs on her cock rubbing and tugging at your tongue and cheeks in a strangely tingling but still pleasurable manner. Soon, Angie then moves on to experimenting different ways to enjoy your mouth, from just leaving the tip in and growling at you to play your tongue over it, to pushing as deep as she can get, making you deep-throat her erection. She seems to love holding on to you like that for a while, feeling the tightness of your throat around her cock until you have to squeeze her furred legs to indicate that she needs to let go so you can take a breath. After some time of playing around with you like a cat would do with a mouse, Angie moves back to flat out face-fucking you, roughly and with an almost bestial abandon.";
			WaitLineBreak;
			say "     Your arousal rises alongside Angie's own as you breathe in her musk and get off a bit on servicing her like this, though even so, you realize that sex exposes the fact that Angie's transformation - and your own encouragement - have stripped her of some of her humanity. Finding your head tightly gripped by sharp-clawed hands, you become aware that you are helplessly in the grasp of a wild, sexual beast and that your will and desires are completely secondary to her needs right now. Not that you care that much... it feels wonderful to give her what she needs and you can't help but give a content hum, lips tightly wrapped around her cock while your tongue plays over it inside your mouth. The sound draws the former zookeeper's attention and she gives you a dominant grin showing an impressive set of teeth, then continues to face-fuck you.";
			say "     As the wild coupling continues, you soon find yourself trembling in orgasm, your [if player is male]hard cock spurting out its load between Angie's footpaws[else if player is female]pussy dripping femcum to form a little puddle between Angie's footpaws[else]whole body shivering a little as you come[end if], closely followed by Angie letting loose with a beast-like roar above you. The hard cock in your mouth pulses as spurt after spurt of cum shoots out of it, first down your throat, then covering your whole tongue as she pulls back a little.";
			WaitLineBreak;
			say "     You stay as you are for a minute, panting as you try to absorb what just happened. Eventually, Angie's cock starts to soften and she pulls it back out of you, then staggers back to lean on the counter, while you stare up at her from your position on the floor. Angie looks down at you with a self-satisfied look on her face, her skirt still hanging uselessly on her tired body as she regains her balance after her recent exertions.";
			say "     'That was unbelievably amazing,' she says with a lusty grin on her face. 'God, we have to do this again soon. I just can't believe I ever didn't want to give in to feelings this amazing. Hell, I wish I had gained a cat cock even sooner!' Angie says with a dreamy smile as she looks down at you in thanks. 'And I owe it all to you and your help. I never would have discovered how good it could be if it wasn't for you. If I can ever do anything to repay you, you let me know!' she tells you with obvious sincerity, before staggering towards the restroom to clean herself up.";
			now lastfuck of Angie is turns;
			if AngieAroused < 6:
				increase AngieAroused by 1;
			Infect "Pantherherm";
			now lastfuck of Angie is turns;
		else:
			say "     ...can't quite manage to quell her fears. Biting her lip, the pantheress gives a shake of her head and moves back a few steps with a sigh.";
	else if AngieAroused > 0 and AngieAroused < 7: [undecided Angie without Midnight - repeat BJ]
		say "     'Ready to play with the kitty again?' Angie says, trailing one of her claws down your chest teasingly. Her soft rumbling purr fills the gift shop and the scent of her arousal spikes even higher, making you grin at how eager she is to play as she tosses her vest to the side without hesitation. 'I haven't been able to think of much else since you showed me what I was missing,' she purrs as she rubs her large breasts up against your body, the formerly reluctant pantherherm obviously having no remaining inhibitions. Lowering her muzzle down to yours and kissing you eagerly, her feline tongue teases your own as she clutches you tightly to her.";
		say "     Eventually she breaks the kiss, panting needily and obviously aroused, looking at you with her slit-pupiled eyes already filling with bestial lust. 'It looks like your nice and ready to play with me too,' Angie moans seductively as she [if player is male]rubs your cock[else if player is female]strokes her fingers over your pussy lips[else]makes you shiver with lust as she strokes your bare crotch[end if]. 'But I know what you want most right now is to wrap your lips around my stiff cock - isn't that right?' Angie teases as she lets out a sultry purr and kisses you deeply, while at the same time having her paw-like hands stroke your body eagerly, showing the pantheress's anticipation of the upcoming fun.";
		WaitLineBreak;
		say "     As Angie breaks the kiss a long moment later, you find yourself panting almost as much as she is, the scent of her strong feline arousal overwhelming you, immediately vanquishing any thoughts you might have to resist her attentions. Indeed, you find yourself just going along with it as she move her large paws to push down on your shoulders, making you kneel on the ground in front of her. Having put you in the submissive position, looking up at her magnificent figure with its full and ripe breasts and black-furred sleek shape, Angie gives another lusty mrowl and starts to rub her erection against your face. One hand on your head as she moves her hips back and forth, she says, 'Now wrap those sexy lips around my cock.' Angie's entrancing musk lies heavy in the air, and thankfully, the little spines on her shaft are pretty soft and nubby, only something that creates some extra sensations while fucking, not the wicked barbs some creatures sport.";
		say "     Getting hungry for the big whopper of a cock yourself, you quickly take hold of the mighty organ and run your tongue up its underside, making Angie lean her head back and give a loud moan. 'Oooh yes - just like that,' she pants, letting a clawed hand sink to your head, pulling you close against her crotch. You just continue to service her, playing the tip of your tongue over the veins of her long shaft, then making your way further up and soon engulfing the tip of her shaft with your lips. 'Mmmmh,' the pantherherm mrowls with lust in her voice, giving an instinctive thrust with her hips.";
		WaitLineBreak;
		say "     As she buries her shaft in the warm and wet cave of your mouth, it is as if something bestial and wild awakes inside the usually rather shy zookeeper. Angie lets out a yowl of pleasure as her cock plunges deeper, the nubby barbs on her feline member tickling your tongue as her cockhead pushes down your throat. Soon finding your nose firmly pressed into the anthro panther's black bush, you can't help but take deep whiffs of her aroused musk, giving you a heady, almost a little bit drunk feeling yourself. After a second or two in which you huff pantherherm pheromones and Angie comes to grips with the flare-up of strong feelings her male half brings with it, the transformed zookeeper fully gives in to her untamed instincts and begins fucking your face in earnest.";
		say "     She starts pulling out and thrusting into you again and again in short rough movements, the soft barbs on her cock rubbing and tugging at your tongue and cheeks in a strangely tingling but still pleasurable manner. Soon, Angie then moves on to experimenting different ways to enjoy your mouth, from just leaving the tip in and growling at you to play your tongue over it, to pushing as deep as she can get, making you deep-throat her erection. She seems to love holding on to you like that for a while, feeling the tightness of your throat around her cock until you have to squeeze her furred legs to indicate that she needs to let go so you can take a breath. After some time of playing around with you like a cat would do with a mouse, Angie moves back to flat out face-fucking you, roughly and with an almost bestial abandon.";
		WaitLineBreak;
		say "     Your arousal rises alongside Angie's own as you breathe in her musk and get off a bit on servicing her like this, though even so, you realize that sex exposes the fact that Angie's transformation - and your own encouragement - have stripped her of some of her humanity. Finding your head tightly gripped by sharp-clad hands, you become aware that you are helplessly in the grasp of a wild, sexual beast and that your will and desires are completely secondary to her needs right now. Not that you care that much... it feels wonderful to give her what she needs and you can't help but give a content hum, lips tightly wrapped around her cock while your tongue plays over it inside your mouth. The sound draws the former zookeeper's attention and she gives you a dominant grin showing an impressive set of teeth, then continues to face-fuck you.";
		say "     As the wild coupling continues, you soon find yourself trembling in orgasm, your [if player is male]hard cock spurting out its load between Angie's footpaws[else if player is female]pussy dripping femcum to form a little puddle between Angie's footpaws[else]whole body shivering a little as you come[end if], closely followed by Angie letting loose with a beast-like roar above you. The hard cock in your mouth pulses as spurt after spurt of cum shoots out of it, first down your throat, then covering your whole tongue as she pulls back a little.";
		WaitLineBreak;
		say "     You stay as you are for a minute, panting as you try to absorb what just happened. Eventually, Angie's cock starts to soften and she pulls it back out of you, then staggers back to lean on the counter, while you stare up at her from your position on the floor. Angie looks down at you with a self-satisfied look on her face, her skirt still hanging uselessly on her tired body as she regains her balance after her recent exertions.";
		say "     'That was unbelievably amazing,' she says with a lusty grin on her face. 'God, we have to do this again soon. I just can't believe I ever didn't want to give in to feelings this amazing. Hell, I wish I had gained a cat cock even sooner!' Angie says with a dreamy smile as she looks down at you in thanks. 'And I owe it all to you and your help. I never would have discovered how good it could be if it wasn't for you. If I can ever do anything to repay you, you let me know!' she tells you with obvious sincerity, before staggering towards the restroom to clean herself up.";
		if AngieAroused < 6:
			increase AngieAroused by 1;
		Infect "Pantherherm";
		now lastfuck of Angie is turns;
	else if AngieAroused is 7: [player-Angie relationship]
		say "     'Ready to play with the kitty again?' Angie says, trailing one of her claws down your chest teasingly. 'I can't wait!' Her soft rumbling purr fills the gift shop and the scent of her arousal spikes even higher, making you grin at how eager she is to play as she tosses her purple top to the side without hesitation. 'I haven't been able to think of much else since you showed me what I was missing,' she purrs as she rubs her large breasts up against your body, the formerly reluctant pantherherm obviously having no remaining inhibitions. Lowering her muzzle down to yours and kissing you eagerly, her feline tongue teases your own as she clutches you tightly to her.";
		say "     Eventually she breaks the kiss, panting needily and obviously aroused, looking at you with her slit-pupiled eyes already filling with bestial lust. 'It looks like your nice and ready to play with me too,' Angie moans seductively as she [if player is male]rubs your cock[else if player is female]strokes her fingers over your pussy lips[else]makes you shiver with lust as she strokes your bare crotch[end if]. 'But I know what you want most right now is to wrap your lips around my stiff cock - isn't that right?' Angie teases as she lets out a sultry purr and kisses you deeply, while at the same time having her paw-like hands stroke your body eagerly, showing the pantheress's anticipation of the upcoming fun.";
		WaitLineBreak;
		say "     As Angie breaks the kiss a long moment later, you find yourself panting almost as much as she is, the scent of her strong feline arousal overwhelming you, immediately vanquishing any thoughts you might have to resist her attentions. Indeed, you find yourself just going along with it as she move her large paws to push down on your shoulders, making you kneel on the ground in front of her. Having put you in the submissive position, looking up at her magnificent figure with its full and ripe breasts and black-furred sleek shape, Angie gives another lusty mrowl and starts to rub her erection against your face. One hand on your head as she moves her hips back and forth, she says, 'Now wrap those sexy lips around my cock.' Angie's entrancing musk lies heavy in the air, and thankfully, the little spines on her shaft are pretty soft and nubby, only something that creates some extra sensations while fucking, not the wicked barbs some creatures sport.";
		say "     Getting hungry for the big whopper of a cock yourself, you quickly take hold of the mighty organ and run your tongue up its underside, making Angie lean her head back and give a loud moan. 'Oooh yes - just like that,' she pants, letting a clawed hand sink to your head, pulling you close against her crotch. You just continue to service her, playing the tip of your tongue over the veins of her long shaft, then making your way further up and soon engulfing the tip of her shaft with your lips. 'Mmmmh,' the pantherherm mrowls with lust in her voice, giving an instinctive thrust with her hips.";
		WaitLineBreak;
		say "     As she buries her shaft in the warm and wet cave of your mouth, it is as if something bestial and wild awakes inside the usually rather shy zookeeper. Angie lets out a yowl of pleasure as her cock plunges deeper, the nubby barbs on her feline member tickling your tongue as her cockhead pushes down your throat. Soon finding your nose firmly pressed into the anthro panther's black bush, you can't help but take deep whiffs of her aroused musk, giving you a heady, almost a little bit drunk feeling yourself. After a second or two in which you huff pantherherm pheromones and Angie comes to grips with the flare-up of strong feelings her male half brings with it, the transformed zookeeper fully gives in to her untamed instincts and begins fucking your face in earnest.";
		say "     She starts pulling out and thrusting into you again and again in short rough movements, the soft barbs on her cock rubbing and tugging at your tongue and cheeks in a strangely tingling but still pleasurable manner. Soon, Angie then moves on to experimenting different ways to enjoy your mouth, from just leaving the tip in and growling at you to play your tongue over it, to pushing as deep as she can get, making you deep-throat her erection. She seems to love holding on to you like that for a while, feeling the tightness of your throat around her cock until you have to squeeze her furred legs to indicate that she needs to let go so you can take a breath. After some time of playing around with you like a cat would do with a mouse, Angie moves back to flat out face-fucking you, roughly and with an almost bestial abandon.";
		WaitLineBreak;
		say "     Your arousal rises alongside Angie's own as you breathe in her musk and get off a bit on servicing her like this, though even so, you realize that sex exposes the fact that Angie's transformation - and your own encouragement - have stripped her of some of her humanity. Finding your head tightly gripped by sharp-clad hands, you become aware that you are helplessly in the grasp of a wild, sexual beast and that your will and desires are completely secondary to her needs right now. Not that you care that much... it feels wonderful to give her what she needs and you can't help but give a content hum, lips tightly wrapped around her cock while your tongue plays over it inside your mouth. The sound draws the former zookeeper's attention and she gives you a dominant grin showing an impressive set of teeth, then continues to face-fuck you.";
		say "     As the wild coupling continues, you soon find yourself trembling in orgasm, your [if player is male]hard cock spurting out its load between Angie's footpaws[else if player is female]pussy dripping femcum to form a little puddle between Angie's footpaws[else]whole body shivering a little as you come[end if], closely followed by Angie letting loose with a beast-like roar above you. The hard cock in your mouth pulses as spurt after spurt of cum shoots out of it, first down your throat, then covering your whole tongue as she pulls back a little.";
		WaitLineBreak;
		say "     You stay as you are for a minute, panting as you try to absorb what just happened. Eventually, Angie's cock starts to soften and she pulls it back out of you, then staggers back to lean on the counter, while you stare up at her from your position on the floor. Angie looks down at you with a self-satisfied look on her face, her skirt still hanging uselessly on her tired body as she regains her balance after her recent exertions.";
		say "     'That was unbelievably amazing,' she says after getting her breath back with a self-satisfied look on her face, stroking her fur happily. 'Stay here with me and let's do that again soon. I know I just can't wait,' Angie says with a dreamy smile as she looks down at you panting on the floor, her words speaking to some part of you that imagines all kinds of sexy things to do with her as your girlfriend. The increasingly erotic images fill your mind and make your body tingle with desire again even as you try to recover from your intense orgasm.";
	else if AngieAroused is 50: [Midnight present]
		say "     'You... want to suck me off?' the naked and instantly excited panther herm says at your proposition, purring as she leans close to you, her soft warm body rubbing up against yours. Seems that even though she's not fully accepted her role as Midnight's breeding pet, Angie still has all the strong urges that come from having one big shaft of a cock swinging between her legs. 'I can't thank you enough for all you've done for me, and you even keep giving more!' Angie says happily, an enticing scent from her wet pussy and hardening cock starting to fill your nose and making you pant eagerly even as she runs her softly furred hand over your [skin of player] skin. You find your hands stroking her soft black fur almost on their own, and soon she lowers her muzzle down to yours and kisses you enthusiastically, her feral feline taste exploding in your mouth while her rumbling purr rolls through your body.";
		say "     The two of you get interrupted by another soft rumbling noise, and Angie breaks the kiss, still panting with lust, so the two of you can turn to look to where Midnight is watching with obvious interest. The large black feline is lying sprawled on his side, his golden eyes gleaming in the dimly lit gift shop, the tip of his tail lashing from side to side behind him as he lets out another low rumbling purr. 'Mmmm, I think Midnight wants to play too,' Angie purrs out, obviously excited by the idea of the large cat being with her at the same time you are.";
		WaitLineBreak;
		say "     'This will be so much fun, let's do it right now,' Angie says with a purr as she takes your hand in her paw and leading you over to where Midnight is lying sprawled out on the floor. Then she goes down on all fours, lowering her front half far enough to lap at the large cat's exposed erection and making him give a satisfied mrowl. You yourself enjoy the look of your sexy pantherherm friend's backside for a moment, those round and furred orbs of her butt, the inviting hole of her ass under a wildly swaying tail, then further down a swollen pussy, dripping with fluids - and finally, Angie's proudly erect maleness, dangling oh so enticingly between her legs.";
		say "     You find yourself crouching down behind her, rubbing a finger along the panterherm's nether lips before pushing it in between them and wiggling around a bit, then move on to grasp the thick shaft of her erection. It rests in your hand hotly, tickling your palm with the nubby spines along its length as you give it a few strokes. Being touched like this while she services her feral master drives Angie's arousal higher and higher, soon causing her to leak precum, with a little glistening bead forming at the tip of her shaft and more fluids running down from her swollen pussy. This pushes the strength of feline musk in the air to a whole new level, and after just a few breaths of the heady mixture of two aroused herm's pheromones, you find your mouth watering with the desire to taste Angie - so much so that you throw yourself on the ground and wiggle under her right away, then catch the pantheress's cockhead between your lips.";
		WaitLineBreak;
		say "     As she feels the warm, wet cave of your mouth around her shaft, it is as if something bestial and wild awakes inside the usually rather submissive pantheress and her hips thrust down against your face. Angie lets out a yowl of pleasure as her cock plunges deeper, the nubby barbs on her feline member tickling your tongue as her cockhead pushes down your throat. Soon finding your nose firmly pressed into the anthro panther's black bush, you can't help but take more deep whiffs of her aroused musk, giving you a heady, almost a little bit drunk feeling. After a second or two in which you huff pantherherm pheromones and Angie comes to grips with the flare-up of strong feelings her male half brings with it, the transformed zookeeper fully gives in to her untamed instincts and begins fucking your face in earnest.";
		say "     She starts pulling out and thrusting into you again and again in short rough movements, the soft barbs on her cock rubbing and tugging at your tongue and cheeks in a strangely tingling but still pleasurable manner. Soon, Angie then moves on to experimenting different ways to enjoy your mouth, from just leaving the tip in and pulling off Midnight's prick for a second to growl at you about playing your tongue over it, to pushing as deep as she can get, making you deep-throat her erection. She seems to love holding on to you like that for a while, feeling the tightness of your throat around her cock until you have to squeeze her furred legs to indicate that she needs to let go so you can take a breath. After some time of playing around with you like a cat would do with a mouse, Angie moves back to flat out face-fucking you, roughly and with an almost bestial abandon.";
		WaitLineBreak;
		say "     Your lust soars alongside Angie's own as you get off quite bit on servicing her like this, though even so, you realize that sex exposes the fact that Angie's transformation - and your own encouragement - have stripped her of some of her humanity. Finding yourself lying on the ground with her pounding into your mouth, you become aware that you are helplessly in the grasp of a wild, sexual beast and that your will and desires are completely secondary to her needs right now. Not that you care that much... it feels wonderful to give her what she needs and you can't help but give a content hum, lips tightly wrapped around her cock while your tongue plays over it inside your mouth. Rolling your eyes up, you can see past her magnificent breasts that Angie herself feels the same way about Midnight, eagerly bobbing down on his prick just like you're doing for her.";
		say "     As the wild coupling continues, you soon find yourself trembling in orgasm, your [if player is male]hard cock spurting out its load to arch up and then splatter down on your chest[else if player is female]pussy dripping femcum to form a little puddle between your legs[else]whole body shivering a little as you come[end if], closely followed by Angie letting loose with a beast-like roar above you. The hard cock in your mouth pulses as spurt after spurt of cum shoots out of it, first down your throat, then covering your whole tongue as she pulls back a little. Midnight is the last to reach his own climax, giving a deep-throated, purring rumble as he blasts his load into Angie's waiting mouth.";
		WaitLineBreak;
		say "     You stay as you are for a minute, panting as you try to absorb what just happened, now that the lust and feline musk that clouded your mind is slowly fading. Eventually, Angie's cock starts to soften and she pulls it back out of you, then moves to kneel next to you on the floor. The pantheress looks down at you with a self-satisfied look on her face, her still half-hard cock dangling distractingly from side to side as she sways a bit from her recent exertions. 'That was unbelievably amazing,' the former zookeeper says with a lusty grin on her face. 'God, we have to do this again soon. I just can't believe I ever didn't want to give in to feelings this amazing. Hell, I wish I had gained a cat cock even sooner!' Angie says with a dreamy smile as she looks down at you in thanks. 'And I owe it all to Midnight - and your help of course...'";
		say "     Hearing his name spoken, the big cat gives a commanding rumble, prompting Angie to move over to him and cuddle up against Midnight's warm belly fur. As he pushes a front paw to lie over her, the panther gives you a look that seems to say, 'You may play with her now, but this bitch is mine, in the end. I'll breed her before much longer. She'll bear my pride of pantherherms.' After giving a low growl to emphasize his meaning, Midnight starts to lick Angie's fur, cleaning her and spreading his scent all over. As you get up and collect your clothes, you can't help but think that you still have a pretty nice deal here - being able to fuck around with Angie when you want to, even though she's truly got another master.";

to say AngieSex7:
	setmonster "Pantherherm";
	choose row monster from the Table of Random Critters;
	if player is herm: [herms]
		say "     <just a placeholder for herm players for now, sorry>";
	else if player is male:
		say "     Angie gives an aroused mrowl and starts making out with you while her hands roam over your body, pulling off your clothes in eager haste. Soon, you're both completely naked and Angie steps back, letting her eyes roam over your shapely form. 'Mmm, yes! It looks like you're definitely ready,' she says as she runs one of her soft paws teasingly over your rock-hard and ready cock, paw-pads rubbing along its length and making you gasp with renewed arousal as the panther herm chuckles at your eager response. 'A bit pent up, hm? You need someone to take care of you...' Angie says happily, a large feline grin spreading across her muzzle as she wiggles her tongue at you. 'Let this big pussy taste your cock, baby...'";
		say "     Angie runs her hands over your body, focusing her attentions on your chest and erection, before leaning over and giving you a long kiss, her tongue teasing yours as her large breasts press up against your body. And they are not the only thing pressing up against you - Angie's thick panther cock brushes against your belly, obviously erect and ready for the fun to come. Breaking the kiss, you find yourself panting almost as much as she is, the scent of her strong feline arousal overwhelming you, forgetting everything but the exaltation of being together with her right now.";
		WaitLineBreak;
		say "     Eager to be taken care of by the pantheress, you allow her take command as she moves close to you, her large paws pushing down softly on your shoulders, making you lie down on the ground. Seeing the sexy herm kneel down, you can't resist spreading your legs a little more and raising your hips in invitation, baring it all for your feline partner. Angie wastes no time in gripping your hips and [if anallevel > 1]rubbing her cock between your buttcheeks, brushing over your pucker with her own hard length. 'So very eager, you need it just as badly as I did,' Angie says teasingly, drawing a soft moan from you as her cock brushes up and down over your asshole[else]laying her own cock against yours, stroking them together with your hand. You can't help but join in a bit, giving extra stimulation by rubbing against her shaft with your own. 'So very eager, you need it just as badly as I did,' Angie says teasingly, drawing a soft moan from you as her hand cups your balls[end if]. You can hear her whisper teasingly between her harsh panting, 'I just want to be with you, always. Stay with me, [if Angiehappy < 4]be [end if]my mate. Let me take care of your needy body whenever you feel the need...'";
		say "     You would respond, but she gives you no time to think about her incredibly erotic words as she presses her erection against your pucker, slowly increasing the pressure until she - almost - pushes her cock inside. She then suddenly pulls back and drops down to all fours as she starts to attack your cock with eager licks. As her wet and slightly rough tongue plays over your shaft, you gasp and shiver, keeping your hips elevated for her to reach you easily. It soon becomes clear that the former zookeeper has given quite a few blowjobs before - as she knows just how to handle a man, licking and teasing it with eager attention. Soon, she brings her fingers into the mix too, rubbing and caressing your thighs and crotch, then pushing two of them in against your pucker, probing your rear entrance for sensitive spots to rub.";
		WaitLineBreak;
		say "     The expertly performed blowjob drives your arousal through the roof in no time at all, making you moan and gasp, then eventually bellow in lust as Angie takes you deep-throat. With one so very sexy pantherherm going down on you, it's no big wonder that soon, you reach the limit of your endurance and come - come hard, shouting Angie's name and clutching at her head while you blast a massive load of cum directly into her stomach. As you sink back to lie on your back when your cumshots start running out of steam eventually, the former zookeeper says, 'Yeah, you did good, stud,' leaning over you to plant a kiss on your lips. As she does so, her erect cock comes to rest against your crotch with hot intensity and you can almost see the lust flare up in Angie's eyes at the sudden contact.";
		say "     One paw-hand of your sexy companion slides down between your bodies as she continues to kiss you, then you can feel her cockhead rub over your asshole and press in against it. Angie's lips are tightly pressed against yours in a hungry kiss as she gives her erection a few quick jerks and finally blows her own load. With the tip of her cock pressed right against your muscle and it being a little bit pre-stretched, the force of Angie's cumshots is enough to make it through and you can feel shot after shot jet deep into your body. A warm feeling starts spreading in your insides as the pantherherm fills you up.[mimpregchance]";
	else if player is female:
		say "     Angie gives an aroused mrowl and starts making out with you while her hands roam over your body, pulling off your clothes in eager haste. Soon, you're both completely naked and Angie steps back, letting her eyes roam over your shapely form. 'Mmm, yes! It looks like you're definitely ready,' she says as she runs one of her soft paws teasingly over your increasingly damp pussy, paw-pads rubbing across your clit and making you gasp with renewed arousal as the panther herm chuckles at your eager response. 'You're like a needy female in heat and I'm the one who gets to make you whimper in arousal,' Angie says happily, a large feline grin spreading across her muzzle as she wiggles her tongue at you. 'Let this big pussy taste your pussy, baby...'";
		say "     Angie runs her hands over your body, focusing her attentions on your breasts and your already a bit moist sex, before leaning over and giving you a long kiss, her tongue teasing yours as her large breasts press up against your body. And they are not the only thing pressing up against you - Angie's thick panther cock brushes against your belly, obviously erect and ready for the fun to come. Breaking the kiss, you find yourself panting almost as much as she is, the scent of her strong feline arousal overwhelming you, forgetting everything but the exaltation of being together with her right now.";
		WaitLineBreak;
		say "     Eager to be taken care of by the pantheress, you allow her take command as she moves close to you, her large paws pushing down softly on your shoulders, making you lie down on the ground. Seeing the sexy herm kneel down, you can't resist spreading your legs a little more and raising your hips in invitation, baring it all for your feline partner. Angie wastes no time in gripping your hips and rubbing her cock against your crotch, touching your already pretty moist nether lips with its hot and hard shaft. 'So very eager, you need it just as badly as I did,' Angie says teasingly, drawing a soft moan from you as her cock brushes up and down over your sex and making you shiver with the soft barbs rubbing up against your skin. You can hear her whisper teasingly between her harsh panting, 'I just want to be with you, always. Stay with me, [if Angiehappy < 4]be [end if]my mate. Let me take care of your needy pussy whenever you're in heat...'";
		say "     You would respond, but she gives you no time to think about her incredibly erotic words as she nudges your nether lips apart and - almost - pushes her cock inside, before then suddenly pulling back and dropping down to all fours as she attacks your pussy with eager licks. As her wet and slightly rough tongue plays over your sex, you gasp and shiver, keeping your hips elevated for her to reach you easily. Being a woman, the former zookeeper knows just how to handle your pussy, licking and teasing it with eager attention. Soon, she brings her fingers into the mix, rubbing and caressing your thighs and crotch, then pushing two of them deep inside your pussy to probe for the most sensitive spots inside.";
		WaitLineBreak;
		say "     The expertly performed bout of cunnilingus drives your arousal through the roof in no time at all, making you moan and whimper, then eventually scream in lust as Angie starts to nibble on your clit. With one so very sexy pantherherm going down on you, it's no big wonder that soon, you reach the limit of your endurance and come - come hard, shouting Angie's name and clutching at the ground as the orgasm makes your muscles twitch. As you lie on your back, still in the grip of the amazing feelings coursing through your body, the former zookeeper says, 'Yeah, that's my baby,' leaning over you to plant a kiss on your lips. As she does so, her erect cock comes to rest against your crotch with hot intensity, and you can almost see the lust flare up in Angie's eyes at the sudden contact.";
		say "     One paw-hand of your sexy companion slides down between your bodies as she continues to kiss you, then you can feel her cockhead rub over your nether lips before it nudges them apart slightly. Angie's lips are tightly pressed against yours in a hungry kiss as she gives her erection a few quick jerks and finally blows her own load directly into your waiting opening. Burst after burst of her feline seed splashes into you, and you can feel it shoot deep into your body, hitting your cervix, followed by another shot, and another, until your vagina is almost overflowing. Mrowling, Angie keeps making out with you the whole time while her shaft pulses, and you can almost feel her deposit seep through the opening of your cervix and soak into your womb.[fimpregchance]";
	else:
		say "     <just a placeholder for neuter players for now, sorry>";


[Angie + Panther Taur fun]
to say AngiePTFun:
	repeat with y running from 1 to number of filled rows in Table of Random Critters:
		choose row y in Table of Random Critters;
		if name entry is "Pantherherm":
			now monster is y;
			break;
	say "     Angie rears up in place as you approach before the poofed fur on her tail settles down, 'Oh! I thought you were one of the mutants for a moment there.' She pauses, then laughs a little. 'I guess you are. You look...' she approaches you and begins to circle around you, eyeing your every contour. A soft purr announces Midnight's approach as he joins the inspection, sniffing at you curiously a moment.";
	if player is male:
		say "     Angie turns around and flags her tail, 'I have to have it,' she says in a needy tone, almost begging. 'I want to be under a panther with hands.' Midnight gives a sudden loud huff, as if insulted somehow, and hops up onto your back with his forepaws, grabbing at your hips even as you stumble forward onto Angie. 'Bad kitty!' calls Angie, but he doesn't seem to be minding her anymore, jabbing at you with a pointed feline shaft.";
		WaitLineBreak;
		if player is female:
			say "     Midnight's shaft sinks into your black furred cunt, sinking deep as he grabs at your feline hips to draw you back into his powerful breeding motion, growling with delight. You're nudged forward with each slam as he starts to rapidly piston against your hot panther cunt. ";
		else:
			say "     Midnight aligns his heavy tool with your ass and penetrates you in a bright flash of pain. He draws back and the barbs pull lightly at your innards, sending strange trembles of pleasure through you as he begins thrusting with wild abandon. ";
		say "Despite Midnight's attention, you rear up enough to grab Angie's firm feline ass and draw her under yourself to shove your [cock size desc of player] shaft into her. She yowls as it spreads her heated vulva, trembling with increasing desire. Each time you draw back, you can feel those barbs tugging lightly at her sensitive walls, playing her like a fine instrument as you begin to rock between your two lovers, taking and being taken like a well oiled machine of eroticism.";
		say "     You slide up against Angie's back, pressing your furry chest against her as you reach around and take hold of her lovely curves. Your greedy fingers cup and explore across each hill, taking time to tug lightly at the thick teats, half hidden in the dense black fur on your way to the next. Under your eager rutting motions, Angie screeches like the cat she is, moans mixed with feline roars as she flexes powerfully around you.";
		WaitLineBreak;
		say "     Midnight, not to be outdone, begins to pull you back more urgently as he grinds his sheath against your rump, tail arched up over his back as he pistons gracefully in time with your withdrawals from Angie, pushing you between being surrounded by wet heat and having the feral beast's firmness sunk deep inside your sensitive body. It starts to feel like too much, the tension growing higher and higher before it breaks like a dam before the flood. You fill Angie's waiting cunt with seed as your cock barbs dig into the sensitive flesh, holding you still for a moment. The sensation of your fluttering passage around Midnight's shaft pushes him to the edge and his teeth find your back, nipping harshly even as he buries to the hilt and begins to fill you with thick blasts of his feline cream.[impregchance]";
		say "     As the moment of fulfillment passes, you draw from Angie, and Midnight dismounts from your back, both falling back to fours on the store room floor. Midnight moves up between your legs, nuzzling your belly affectionately. Angie turns to face you, reaching for your cheeks and pulling you in for a fierce, purring, kiss. 'It was everything I hoped for,' she whispers to you, before finally getting back to work with a smile on her face.";
	else:
		say "     Angie circles you once more before she rears up and sets her paws on your furry back, pulling your lower body towards herself. 'Mine,' she says, nudging at your bottom with her increasingly firm feline shaft. A soft growl comes from her and, looking over your shoulder, you can see her tail lashing agitatedly with her building lust. ";
		if player is female:
			say "Without hesitation, she sinks her thick shaft into you, testing your ability to contain it as she leans onto your tauric back, sinking that meat into your body in a swift slide. ";
			if cunt length of player > 15:
				say "Your large feline cunt accepts the shaft without problem, and though it is a massive pole, it slides wetly along your sensitive, trembling, passage, forcing a cooing purr from deep in your chest.";
			else:
				say "You feel your cunt being stretched painfully around the shaft, pain and pleasure mixing in sharp tingly spikes as she works her way to the hilt regardless, stretching you without reservation in her goal to embed herself fully in your sleek panther body.";
				increase cunt length of player by 3;
			say "     As she rocks against you, her barbs tug harshly at you, at first sending shivers of displeasure, but with each tug, the sensation seems to shift subtly, until you are rocking against her, trying to get more of it. Your cunt weeps your fluids with a maddening arousal as you and she rock together intently.";
			WaitLineBreak;
			say "     A soft meow distracts you from the pleasure behind, and Midnight rears up, placing his paws on your fore shoulders and leaning up to give you a licking across your black snout and nose. You lick back at him, reaching to hug the beast in close as you rise higher and higher in pleasure. Midnight scooches closer, draping his paws over you as he grinds upwards, driving his erection between your low hanging breasts, starting to tit fuck you eagerly. He leaves drops of pre-cum across your pelt, glittering like pearls on the dark background.";
			say "     Behind you, Angie drives home powerfully, and her shaft swells several inches at the base, a ripple that flows up into you, bursting into a jet of seed that is soon followed by several fresh offerings of creamy fluid, filling you to capacity with her hot fluids. Those barbs lock into your tender flesh, and you wobble in place, only held up by Angie and Midnight's paws as your womb cries out in purest delight. A fresh warmth across your front alerts you to the fact that Midnight found his own satisfaction, painting your front with his gray spunk with a sudden roar of release. He slips loose of you and curls up close by, suddenly disinterested.[impregchance]";
			WaitLineBreak;
			say "     Angle relaxes against your back, snuggling against you, 'You were just what I needed. I wanted to mount a nice kitty for so long.' Her forelegs squeeze against your barrel of a lower body and she reaches under herself to get at your tail, tugging lightly before she pulls free wetly and settles down behind you, purring like a motor with satisfaction and leaving you to drip her fluid.";
		else:
			say "She finishes her inspection and seems a little disappointed, 'You're missing a little something there, hon, why don't you get a little... something, and come back. I really want to give that a test run if you know what I mean.";
			continue the action;
	Infect "Pantherherm";
	Infect "Pantherherm";
	now lastfuck of Angie is turns;
	now lastfuck of Midnight is turns;


[Angie + Rubber tigress fun]
to say AngieRTFun:
	if player is female:
		say "     Angie blinks when she notices you. 'Oh my! You weren't kidding, were you?' You shake your head as you spread your arms, then slowly turn in a circle showing off your rubbery body to the pantheress. Intrigued, she drops to all fours and circles around you, nipping and pressing against your body, testing the smooth texture of your skin. Being touched like that and breathing in her feline scent quickly begins to arouse you.";
		say "     Sweet juices begin to dribble down your inner thighs. Angie laps at it, her rough tongue slipping over your smooth skin, growling in encouragement as you spread your legs to allow her better access to you dripping cunt. She gives you one long lap which makes you squeak with pleasure. You beg for more but instead she stands, pressing her huge throbbing cock against your stomach. She kisses you, your tongue twists around hers briefly before Angie pulls back. Her eyes are wide with amazement and lust. 'My god, you really are a living toy!' Her grin turns wicked, 'Time to play!'";
		WaitLineBreak;
		say "     Before you know what is happening, the panther herm seizes you by the ears and forces you down to your knees, rubbing your nose against her rock-hard cock. 'Suck it, toy!' she growls without a trace of that niceness you know, 'Suck it or I pop you!' You feel the needle sharp points of her claws prick the rubber skin of your head. You consider resisting, but her cock smells so good, it wouldn't hurt to take a few licks to help your stressed friend. Opening your mouth to take a lick, you quickly find out that the pantheress isn't in the mood to go slow - as she forcefully thrusts into you, driving the shaft of her erection past your flexible teeth and up into your skull. Your vision blurs as your entire head deform around her thick shaft, like a baker punching a pizza in midair.";
		say "     'Yes!' Angie cries and pulls you up before slamming you back down on to her, and this time the shaft threads down your throat, making your neck bulge with its thickness. Your eyes bulge as her spines rake against your wind pipe, not hurting but rather giving you a strange pleasurable feeling as the nanites reshape your mouth and jaws into a round channel, perfect for Angie's cock. She continues to slam your face into her crouch, making your nose squeak with every thrust. The noise attracts Midnight's attention and just a moment later, you feel his cock pierce your nethers. Both panthers thrust into you with abandon and your mouth is too full to scream as you feel both cocks swell. Angie roars as she cums first, followed by Midnight, your body swelling like a balloon with the torrent of their cum.[impregchance]";
	else:
		say "     Angie blinks when she notices you. 'Oh my! You weren't kidding, were you?' You shake your head as you spread your arms, then slowly turn in a circle showing off your rubbery body to the pantheress. Intrigued, she drops to all fours and circles around you, nipping and pressing against your body, testing the smooth texture of your skin. Being touched like that and breathing in her feline scent quickly begins to arouse you.";
		say "     Beads of precum start to form at the tip of your quickly hardening shaft, to drip down to the floor below. Angie laps at your cock and balls, her rough tongue slipping over your smooth skin, growling in encouragement as you spread your legs to allow her better access. She gives you one long lap along your erection, then sucks on its head for a moment, which makes you squeak with pleasure. You beg for more but instead she stands, pressing her huge throbbing cock against your stomach. She kisses you, your tongue twists around hers briefly before Angie pulls back. Her eyes are wide with amazement and lust. 'My god, you really are a living toy!' Her grin turns wicked, 'Time to play!'";
		WaitLineBreak;
		say "     Before you know what is happening, the panther herm seizes you by the ears and forces you down to your knees, rubbing your nose against her rock-hard cock. 'Suck it, toy!' she growls without a trace of that niceness you know, 'Suck it or I pop you!' You feel the needle sharp points of her claws prick the rubber skin of your head. You consider resisting, but her cock smells so good, it wouldn't hurt to take a few licks to help your stressed friend. Opening your mouth to take a lick, you quickly find out that the pantheress isn't in the mood to go slow - as she forcefully thrusts into you, driving the shaft of her erection past your flexible teeth and up into your skull. Your vision blurs as your entire head deform around her thick shaft, like a baker punching a pizza in midair.";
		say "     'Yes!' Angie cries and pulls you up before slamming you back down on to her, and this time the shaft threads down your throat, making your neck bulge with its thickness. Your eyes bulge as her spines rake against your wind pipe, not hurting but rather giving you a strange pleasurable feeling as the nanites reshape your mouth and jaws into a round channel, perfect for Angie's cock. She continues to slam your face into her crouch, making your nose squeak with every thrust. The noise attracts Midnight's attention and just a moment later, you feel his huge cock pierce your asshole. Both panthers thrust into you with abandon and your mouth is too full to scream as you feel both cocks swell. Angie roars as she cums first, followed by Midnight, your body swelling like a balloon with the torrent of their cum.[impregchance]";
	WaitLineBreak;
	SanLoss 20;
	now thirst of player is 0;
	Infect "Pantherherm";
	Infect "Pantherherm";
	Infect "Pantherherm";
	Infect "Pantherherm";
	Infect "Pantherherm";
	LineBreak;
	say "     As your bones settle back into place Angie cuddles up to you, licking your new fur. 'Oh that was wonderful,' she purrs. 'Tiger's aren't as sexy as panthers, but they'll do in a pinch, right?' She laughs as you rub your throat, which still feels stretched. 'Was I a little rough? It's funny, you know. You touch my cock, then suddenly I'm all dominant and growly. You lick my pussy and I'm a needy little whore. It's a switch.' She sighs and leans her head onto your chest. 'Thanks for being my toy, felt good to be in charge for once. Midnight's a very top cat panther.";
	now lastfuck of Angie is turns;
	now lastfuck of Midnight is turns;

when play ends:
	if AngieAroused is 2:
		if humanity of player < 10:
			say "     Following your example, Angie quickly gives in to her baser urges as well, roaming the city with you for a short time, and proving an eager and enthusiastic mate. After a bit though, she finds her desires focusing more and more on the black cat she was originally changed by, and she abandons you to search for his feline company.";
		else:
			say "     Angie is happy to come with you when you are rescued, and is an eager and enthusiastic companion as you make your way back into normal society. It's nice to have another city survivor with you who understands what you went through, and the strong carnal desires you managed to wake in her make her an eager and passionate lover as well. Still, you eventually lose her once again to her first love, as she finally manages to get a job at one of the major zoos in the area. Her cat-like attributes will be a major plus, she tells you eagerly, as the zoo she managed to get a job at has one of the best large cat programs around. Feeling happy for her though somewhat more lonely now, you wish her well as she goes off to her new job, seeming happy and eager, and obviously very interested in a little 'after hours' work with some of the larger cats. But as she did say you could come by and visit anytime, and she might even introduce you to some of her 'favorites' among the big cats if you do, hmmm...";

Angie ends here.
