Version 3 of Colleen by Sarokcat begins here.
[Version 2.4 - Meredith preg dialog & Gwen dialog]
[Version 3   - Partial re-write by Wahn to conform to the new Sarah path]
"Adds a military NPC to Flexible Survival with a variety of responses and goals."

Section 1 - Colleen Events

Table of GameEventIDs (continued)
Object	Name
WomanFruitTree	"WomanFruitTree"

WomanFruitTree is a situation.
The sarea of WomanFruitTree is "Park".
ColleenDeclined is a number that varies.

Instead of resolving a WomanFruitTree:
	if ColleenDeclined is 1:
		say "     Wandering back through the park, you spot the large tree in the distance, and decide to wander over to see what became of the stranded military woman. Upon reaching the tree you find that ";
		if a random chance of 1 in 2 succeeds:
			say "[one of]large scratches mar the tree from where something large and winged clawed at it, and the woman is gone, parachute and all. It looks like one of the wyverns stopped by to roost and found itself a new pet[or]as you expected the woman is gone when you return, her parachute straps slashed open by something with sharp claws. Looking around the area you can see where a large cat of some kind climbed up the tree to get to her and there are plenty of scratches and signs of clawing at the ground under the tree nearby. The beast obviously took her as his mate right there, the scent of felinoid musk lingering in the area where you find several scraps from her uniform[or]the woman is gone, and the entire area reeks with the scent of one of those strange large skunks. It looks like one of the creatures wandered upon the trapped woman and decided to spray the area several times. The straps of her parachute seem to have stretched and finally broken off the woman as she likely changed under the influence of the skunk's spray, letting her fall to the ground to get to know the skunk better[or]the woman is gone, though it seems like she finally managed to find her way down on her own as her booted footprints lead off towards the city. It isn't likely she will survive out there unprepared for long, and you are a little sorry you won't get to know what kind of creature finally manages to catch her[or]there is a brand new drone wasp still tangled up in the straps of a parachute, wings waving futilely as she tries to escape. Apparently one of the wasps in the park found her and flew up to sting the female soldier a few times while she couldn't dodge. You find yourself smiling slightly at her silly antics as she tries to escape, before continuing on your way[or]someone came and found the woman hanging here and took her with them. From all the hoof-prints surrounding the tree, it looks like a small herd of equinoids came along and decided she would be a nice addition to the herd[or]the parachute straps are now empty. From the looks of things something climbed up the tree and helped her out of them. Examining the tree and the surrounding area, you find signs that it might have been a lizardwoman. Even more amusingly, the tracks that lead away from the tree seem to belong to two of the humanoid reptiles[at random].";
		else:
			say "[one of]the woman is gone. The ground underneath where she was hanging is still damp and you see small pools of white liquid dotting the grass. Taking a closer look at the liquid you realize it is fresh milk. A smile spreads over your face as you realize one of the bovines wandering the park must have found her and given her a nice udder full of milk all her own[or]there are large claw marks all over the trunk where something large climbed it. Obviously, the woman has vanished although there are some shreds of her harness hanging empty from the tree. Examining the scene, you finally conclude that one of the bears in the area decided to climb the tree to claim itself a different kind of honey[or]the woman's empty harness is has been dragged up among the branches of the tree. Looking up you see a flash of a large fluffy squirrel tail among the branches. A grin spreads over your face as you leave the area before the new squirrel woman spots you[or]the harness is hanging empty up among the branches of the tree. From the looks of things someone or several someones had a lot of fun with the helpless woman. Bits blue fur and a few scattered feathers make you assume that one of those gryphons flying around found her here and enjoyed the nice treat the tree caught for it[at random].";
		now WomanFruitTree is resolved;
	else if mtp > 2:
		say "     Wandering through the park, you hear a bit of a commotion in the distance and spot one of the park creatures trying to get at something in a rather large tree. After a moment or two the creature gives up in disgust and wanders off into the park. Curious about the scene, you find yourself venturing closer to see what was so interesting. Looking up through the tree branches, you are surprised to see a woman dressed in military camouflage is stuck up in the tree, hanging by the remains of her parachute straps from several branches like some kind of fruit.";
		say "     As you stare with your mouth open at the strange woman bearing tree, the woman notices you and begins to talk. 'Hey! You down there, you seem a bit more stable than most of the beasts and things in these parts, would you mind helping me out a little here? I kind of got stuck up here when that big wind scattered my squad. It blew me right into this damn tree and I lost my knife and most of my gear when I hit the branches. If you could find a way to help me down I would really appreciate it.' As you look closer it seems she is indeed more than a little beat up from her ordeal, and many of her pockets were ripped and torn by the branches. Inspecting the tree, you think you see an easy way up to where she is stuck.";
		LineBreak;
		say "     [bold type]So... you have a way to help her. The only question is - do you want to do so?[roman type][line break]";
		say "     ([link]Y[as]y[end link]) - You can't just leave her hanging there. Of course you help her!";
		say "     ([link]N[as]n[end link]) - Nah, you're not gonna climb all the way up there. Let her hang and get out of it on her own.";
		if player consents:
			say "     Deciding that you might as well help the stranded woman, you look around for anything that might help. After a bit of poking around, you do find a small military knife lying partially hidden in the grass a little ways away. Snatching up the knife, you realize it must have been knocked loose from the woman's uniform when she hit the tree. Smiling at your good fortune, you carefully climb up the tree to help the female soldier out. Reaching the area where her chute strings are tangled about the branches, you carefully cut through the strings while the woman watches you intently, the tree groaning and shaking underneath you.";
			say "     When the last string is finally cut, the paratrooper drops out of the tree, landing badly on the clawed-up dirt underneath. Although she manages to soften the landing at least a little bit thanks to her training, there is a scream of pain, showing that she got hurt on impact. Meanwhile, the branches of the tree shake and lash about as they are freed from the extra weight pulling them down, knocking you out of the tree as well. You groan as you land heavily on the ground, seeing stars for a minute before dragging yourself back to your feet.";
			WaitLineBreak;
			say "     Looking over to the woman, she seems to be in even worse shape than you are and is clutching her ankle in pain. Her trip through the branches and then falling to the ground seem to have left her in no shape to fight or travel through the city safely. Looking up, the woman notices you watching her, and gives a wry grin, 'Thanks for the help there, still it doesn't look like I am going to get very far like this, but at least I'm out of the tree now. The name's Colleen by the way. I guess it's pretty obvious we were sent in to see what the city was like and report back, course my radio is totally smashed now, so I guess I just have to wait for them to eventually move in and secure the city.'";
			say "     With a sigh, she tries to stand, only to wince as she puts weight on her injured ankle. 'Of course I probably won't make it that long like this. But I still have to try,' she says and starts looking around for any of her gear that the creatures in the area might not have taken. Feeling somewhat sorry for her, you hand her back the knife and mention that you know a relatively safe bunker in the city and that you can help her get there. She seems surprised at your generous offer, and happily takes you up on it. Allowing the female soldier to lean on you, the two of you make your way back to the bunker.";
			decrease HP of player by 30;
			now ColleenFound is 1;
			now Colleen is in Bunker;
			now battleground is "void";
			move player to Bunker;
			now WomanFruitTree is resolved;
			if Meredith is bunkered and Vanessa is bunkered:
				say "     As Colleen comes in, she stops short and stares at Vanessa and Meredith talking to one another for several breaths before rushing over to them. 'Sarge, is it really you?' She comes briefly to attention before relaxing. 'Cpl Colleen Varna reporting, sarge,' she says with a big grin. 'It looks like you [if HP of Meredith > 3]both [end if]had quite the run-in with something out there[if HP of Vanessa is 3], her eyes drawn to her very pregnant belly[else if HP of Vanessa > 3], her eyes drawn to her centaur lower body[end if]. 'Look, do you know what's going on? My radio was destroyed when I hit the trees, so I don't know what happened to the rest of the squad once we were blown off course.'";
				say "     'Yeah, a centaur stallion out on the plains got a little too amorous with me and started me down this path. Quite a ride he was and left me with a little something extra as well,' she says, patting her [if HP of Vanessa is 3 or HP of Vanessa is 4]pregnant [end if]belly. '[if HP of Meredith > 3]There was a bit of an accident and Mere's picked it up from me[else]Mere managed to stay hidden until we could track her down and rescue her[end if].'";
				say "     'At least you still seem to be clean. As for my radio, it ran out of juice a while ago. Come over here and I'll fill you in on what I know until that point,' she says, glancing at you. 'After that, you'd best keep a little distance so you don't get infected[if HP of Meredith > 3] as well[end if].'";
				say "     Knowing they'll be discussing military matters and remembering their lost squad-mates, you decide to give them some privacy for a little while[if HP of Vanessa > 3]. As you're walking away, you do catch Vanessa saying 'And you need to hear all about my encounter with that centaur stud - literally hung like a horse,' she giggles excitedly[end if].";
			else if Vanessa is bunkered:
				say "     As Colleen comes in, she stops short and stares at Vanessa for several breaths before rushing over to her. 'Sarge, is it really you?' She comes briefly to attention before relaxing. 'Cpl Colleen Varna reporting, sarge,' she says with a big grin. 'It looks like you had [if HP of Vanessa < 3]a bit of a[else]quite the[end if] run-in with something out there[if HP of Vanessa is 3], her eyes drawn to her very pregnant belly[else if HP of Vanessa > 3], her eyes drawn to her centaur lower body[end if]. 'Look, do you know what's going on? My radio was destroyed when I hit the trees, so I don't know what happened to the rest of the squad once we were blown off course.'";
				say "     'Yeah, a centaur stallion out on the plains got a little too amorous with me[if HP of Vanessa > 3] and started me down this path[end if]. Quite a ride he was and left me with a little something extra as well,' she says, patting her [if HP of Vanessa is 3 or HP of Vanessa is 4]pregnant [end if]belly. 'At least you still seem to be clean. As for my radio, it ran out of juice a while ago. Come over here and I'll fill you in on what I know until that point,' she says, glancing at you. 'After that, you'd best keep a little distance so you don't get infected.'";
				say "     Knowing they'll be discussing military matters and remembering their lost squad-mates, you decide to give them some privacy for a little while[if HP of Vanessa > 3]. As you're walking away, you do catch Vanessa saying 'And you need to hear all about my encounter with that centaur stud - literally hung like a horse,' she giggles excitedly[end if].";
		else:
			say "     You decide not to interfere with the dangling woman. After all, the military is obviously not doing much for you right now - so why should you climb a tree for one of them. You could fall down, or some sort of critter could arrive while you're up in the branches. Turning your back on the woman and tuning her calls for help out, you keep walking. As you wander through the woods, you do find yourself rather curious as to just what creature will eventually manage to reach that woman up in the tree and just what she will look like afterwards. Maybe you should come back and see later...";
			now ColleenDeclined is 1;
	else:
		say "     Traveling through the park, you come across a rather large tree, its branches spreading out to cover a wide area and providing excellent shade and protection from the elements. You stop for a minute to enjoy the nice shady cover the tree provides as you look out over the park. Eventually, though, you realize you need to keep moving and continue on down the trail, leaving the tree behind.";


Section 2 - Colleen the Husky Paratrooper

ColleenTalk is a number that varies.
ColleenFound is a number that varies.
ColleenCollared is a number that varies.
ColleenAlpha is a number that varies.
ColleenSlut is a number that varies.
ColleenSpray is a number that varies.

Table of GameCharacterIDs (continued)
object	name
Colleen	"Colleen"

Colleen is a woman.
The description of Colleen is "[CollenStatus]".
The conversation of Colleen is { "Woof!" }.
the linkaction of Colleen is "[ColleenLinkAction]".

to say ColleenLinkAction:
	if ColleenTalk > 0:
		say "Possible Actions: [link]talk[as]talk Colleen[end link], [link]smell[as]smell Colleen[end link], [link]fuck[as]fuck Colleen[end link], [link]spray[as]spray Colleen[end link][line break]";
	else:
		say "Possible Actions: [link]talk[as]talk Colleen[end link], [link]smell[as]smell Colleen[end link], [link]fuck[as]fuck Colleen[end link][line break]";

the scent of Colleen is "[ColleenScent]".

to say ColleenScent:
	if ColleenAlpha > 0:
		say "Colleen smells of aroused female husky. The scents of her roaming the city for sex linger on her. Something in her scent makes you consider submitting to the lustful husky.";
	else if ColleenSlut is 1:
		say "Colleen smells of aroused female husky. The scents of her roaming the city for sex linger on her.";
	else if ColleenCollared is 1:
		say "Colleen smells of aroused female husky. The scents of her lustful escapades with you and Sarah cling to her thickly.";
	else if SarahSlut is 4 or SarahSlut is 3:
		say "Colleen smells increasingly of aroused female husky, though some lingering traces of her human scent remain.";
	else if SarahSlut is 2 or SarahSlut is 1:
		say "Colleen smells mostly human, though faintly female husky as well.";
	else:
		say "Colleen smells like a human female.";

to say CollenStatus:
	if ColleenAlpha > 0:
		project the Figure of Colleen_face_icon;
		say "     The nervous military woman you rescued from the tree is completely gone now, and in her place is a happy little husky bitch. The new bitch doesn't seem to mind the changes a bit however, reveling in the lovely feel of her new hyper-sexualized body, her damp slit still showing signs of her latest mating as she prances happily around the bunker in just her bare fur. She seems to have acquired a small pile of trophies and toys stacked up in her corner of the bunker, evidence of her many trips outside to hunt and fuck, although you never can actually manage to catch her outside of the bunker when you come back. Still she seems to be the happiest husky bitch you have ever come across, and her teasing glances and the way she wiggles her ass at you with abandon makes you wonder what it would be like to just give in and become a happy little bitch yourself...";
	else if ColleenSlut is 1:
		project the Figure of Colleen_face_icon;
		say "     The nervous military woman you rescued from the tree is completely gone now, and in her place is a happy little husky bitch. This new bitch doesn't seem to mind the changes a bit however, reveling in the lovely feel of her new hyper-sexualized body, her damp slit still showing signs of her latest mating as she prances happily around the bunker in just her bare fur. She seems to have acquired a small pile of trophies and toys stacked up in her corner of the bunker, evidence of her many trips outside to hunt and fuck, although you never can actually manage to catch her outside of the bunker when you come back. Still she seems to be the happiest stray slut you have ever come across, and the thought of your part in helping her become that way makes you smile.";
	else if ColleenCollared is 1:
		project the Figure of Colleen_face_icon;
		say "     The nervous military woman you rescued before is completely unrecognizable now, in her place is a happily collared husky bitch, her damp slit leaking slowly onto the floor as she crawls around the bunker on all fours. She seems to be especially submissive, and seems to really be getting into her new role as your happily collared pet. Her soft golden fur is perfect for petting and the tag hanging off her collar proudly proclaims her to be 'Bitch'. The sight of the tag she picked out and how much it suits her new form and attitude brings a smile to your face.";
	else if SarahSlut is 4:
		project the Figure of Colleen_face_icon;
		if SarahPregnant > 0:
			if SarahPups > 0:
				say "     The nervous military woman you rescued from the tree seems to be doing massively better now, although you can hardly recognize her as the same woman anymore. The close proximity to your happy bitch seems to have affected her profoundly, even after such a short time together, and it certainly shows, especially since she has recently abandoned any attempt at wearing clothing. Looking her over you smile to see that Colleen's face now resembles that of a husky far more than that of a human, and her nice coat of soft white fur has fully grown in now, the most amusing part is how eagerly her fully husky tail lifts whenever you glance at her, as she exposes her dripping slit to you without even thinking about it.";
				say "     Looking back and forth between her and Sarah it is easy to tell however that she isn't a full husky yet, still having proper hands and legs. Also, she has some semblance of self left, but you have the feeling from the way she glances longingly at your other pet, that she won't take much effort to fully transform if you decide you want to. Her gaze seems to linger on your pet's full belly as she unconsciously rubs her own empty belly. Colleen's body apparently wants some handsome stud to give her puppies of her own, and her desires are strong enough for her to have taken to helping your pregnant pet take care of and watch the puppies you already sired.";
			else:
				say "     The nervous military woman you rescued from the tree seems to be doing massively better now, although you can hardly recognize her as the same woman anymore. The close proximity to your happy bitch seems to have affected her profoundly, even after such a short time together, and it certainly shows, especially since she has recently abandoned any attempt at wearing clothing. Looking her over you smile to see that Colleen's face now resembles that of a husky far more than that of a human, and her nice coat of soft white fur has fully grown in now, the most amusing part is how eagerly her fully husky tail lifts whenever you glance at her, as she exposes her dripping slit to you without even thinking about it.";
				say "     Looking back and forth between her and Sarah it is easy to tell however that she isn't a full husky yet, still having proper hands and legs. Also, she has some semblance of self left, but you have the feeling from the way she glances longingly at your other pet, that she won't take much effort to fully transform if you decide you want to. Her gaze seems to linger on your pet's full belly as she unconsciously rubs her own empty belly. Colleen's body apparently wants some handsome stud to give her puppies of her own...";
		else if SarahPups > 0:
			say "     The nervous military woman you rescued from the tree seems to be doing massively better now, although you can hardly recognize her as the same woman anymore. The close proximity to your happy bitch seems to have affected her profoundly, even after such a short time together, and it certainly shows, especially since she has recently abandoned any attempt at wearing clothing. Looking her over you smile to see that Colleen's face now resembles that of a husky far more than that of a human, and her nice coat of soft white fur has fully grown in now, the most amusing part is how eagerly her fully husky tail lifts whenever you glance at her, as she exposes her dripping slit to you without even thinking about it.";
			say "     Looking back and forth between her and Sarah it is easy to tell however that she isn't a full husky yet, still having proper hands and legs. Also, she has some semblance of self left, but you have the feeling from the way she glances longingly at your other pet, that she won't take much effort to fully transform if you decide you want to. She seems to even enjoy your puppies bouncing around her and playing with her and Sarah, and is helping your happy pet watch over and take care of the puppies almost eagerly.";
		else:
			say "     The nervous military woman you rescued from the tree seems to be doing massively better now, although you can hardly recognize her as the same woman anymore. The close proximity to your happy bitch seems to have affected her profoundly, even after such a short time together, and it certainly shows, especially since she has recently abandoned any attempt at wearing clothing. Looking her over you smile to see that Colleen's face now resembles that of a husky far more than that of a human, and her nice coat of soft white fur has fully grown in now, the most amusing part is how eagerly her fully husky tail lifts whenever you glance at her, as she exposes her dripping slit to you without even thinking about it.";
			say "     Looking back and forth between her and Sarah it is easy to tell however that she isn't a full husky yet, still having proper hands and legs. Also, she has some semblance of self left, but you have the feeling from the way she glances longingly at your other pet, that she won't take much effort to fully transform if you decide you want to...";
	else if SarahSlut is 3:
		project the Figure of Colleen_face_icon;
		say "     The nervous military woman you rescued from the tree seems to be doing massively better now, although she definitely doesn't look the same anymore. Quite likely the close proximity to a slutty husky pet has already started her changing, and her body isn't fully human anymore. The sight of the former military woman is somewhat amusing to you as she appears more and more like your new pet. Her head has started to change and now sprouts soft canine ears and is pushing forward in the beginnings of a soft muzzle her longer tongue hanging out occasionally as she shoots lustful glances as your husky pet with her new blue eyes when she thinks you aren't looking. The rest of her body is also showing evidence of the change as well, her ripped uniform clearly showing you where patches of soft husky fur have started to spread across her body, and her tail has fully grown in now, lifting straight up behind her in an unconscious invitation for someone to take advantage of her new body.";
	else if SarahSlut is 2:
		say "     The nervous military woman you rescued from the tree seems to be doing much better now, although she is definitely starting to show signs of the infection in her body, and since you got her back to the bunker safely, you are pretty sure her changes are entirely as a result of proximity to your sexy husky friend. Her ears are now rather canine and have moved to the top of her head, and her eyes seem much more lust filled and are now husky blue, the most telling sign though, is her nice thick husky tail, wagging happily behind her whenever she looks at you or Sarah.";
	else if SarahSlut is 1:
		say "     The nervous military woman you rescued from the tree seems to be doing much better now, and her ankle seems professionally wrapped. Perhaps Sarah helped her with that at some point. She seems slightly nervous about sharing her safe haven with a nude sexy husky bitch, and can't stop glancing at Sarah, although you think you detect a bit of lust in her gaze as well as worry. You are about to look away from Colleen when you notice that she has a new slit in the back of her already damaged uniform, letting her obviously new husky tail wag slightly behind her. Giving her another closer look, you notice that her eyes seem slightly bluer and her ears are most definitely pointed and slightly fur tipped, perhaps the close proximity to Sarah is having an effect on her.";
	else if Sarah is in the bunker and SarahSlut is 0 and (SarahCured is 0 or SarahCured is 1):
		say "     The female soldier you rescued from her treetop predicament seems to be doing somewhat better now, with her ankle being professionally wrapped. Apparently Sarah helped her with that at some point. She seems slightly nervous to be sharing her safe haven with a husky however, even one as newly changed as Sarah, and shoots her occasional nervous glances while she reads a book from the library.";
	else if Sarah is in the bunker and (SarahCured is 2 or SarahCured is 3):
		say "     The female soldier you rescued from her treetop predicament seems to be doing somewhat better now, with her ankle being professionally wrapped. Apparently Sarah helped her with that at some point. She seems slightly less nervous than before about sharing her safe haven with a husky, now that Sarah has gotten her urges a little bit better under control. Still, Colleen shoots the female husky occasional glances, as if to check for any sign of relapse.";
	else if Sarah is in the bunker and SarahCured > 3:
		say "     The female soldier you rescued from her treetop predicament seems to be doing somewhat better now, and her ankle seems professionally wrapped. Perhaps Sarah helped her with that at some point. She seems to have accepted sharing her safe haven with a husky and often can be seen in friendly conversation with the other woman, although Colleen tries to keep physical contact to a minimum. The two of them now are friends, but that doesn't mean Colleen isn't nervous about contracting the nanite infection herself.";
	else:
		say "     This nervous woman is still dressed in her damaged military attire, though she has managed to find some bandages to wrap her ankle with. She also seems to have relaxed somewhat though due to the safety of the bunker, and has acquired a small pile of books from the library outside she seems to be happily reading through.";


Section 3 - Conversation

instead of conversing the Colleen:
	if ColleenTalk is 0:
		if Sarah is in the bunker:
			if SarahSlut > 2:
				say "     'Thanks again for all your help out there,' Colleen says, as she gestures to her already healed ankle, where a very light dusting of white fuzz can be seen. 'I am really glad you came by to help, instead of some other creature out there. The guy briefing us didn't even hint at what was going on in the city.' Colleen sighs and mutters, 'Need-to-know asshole.' Trying to hide her slip, she looks around the bunker and smiles, her eyes lingering for a moment on your pet husky. 'Seems you found a nice place to hole up here at least, it even seems kind of cozy and warm in here. And I'm not sure what that nice relaxing smell is in here, but I really like it too,' she says as she sniffs the air lightly.";
				say "     'Actually it kind of makes me a little too warm, and very comfortable, I almost want to just take my clothes off and relax...' she says, her voice trailing off slightly much to your amusement. 'Oh sorry,' she says as she blushes again, 'I don't know what's coming over me here, it seems kind of nice though...' she says softly, her eyes scanning the bunker again looking for a change in topic, before settling on Sarah. 'I like your pet though! She makes the place feel more comfortable, and I always have loved dogs! I even used to have one once, a nice... big... handsome... stud of a dog named Roscoe,' she mutters as her voice trails off again for a second, and you grin as you note she seems to be looking a bit canine herself at this point. 'Oh one last thing, I found a medkit in the library, but I obviously don't need it now. Your pet got pretty interested in my leg and almost seemed to lick it better, so I figure you might be able to use it,' she says as she hands you a medkit.";
				WaitLineBreak;
				increase carried of medkit by 1;
				say "You received a medkit!";
				say "     'Other than that, there is something else I might be able to do to help out. They gave me this experimental spray that they said should help me out in the city. From what I can tell now, I think it might be able to help you fight off the infection somewhat,' Colleen says as she brandishes a small spray can. 'Fortunately it seems to have survived my accident with the tree intact, and while I could probably use it myself, it just doesn't seem like the right thing to do... I can use it on you if you want me to. Just come and ask me to [bold type]spray[roman type] you with it if you want to try it out, be careful though, there are only a couple doses in a can this size, and I don't have any more,' she says as she tucks the can back away safely.";
				say "     'You won't have to worry about leaving me here either, I have enough MREs left they should hold me until the rescue. Sadly I don't have enough to really share, but I won't have to leave the bunker at least and will keep the door shut tight until you return. Besides, I'm sure your pet will help keep me company in here...' the woman says as she gives you a small smile. You might be imagining things, but her mouth seems slightly longer than normal as she turns to look at your little husky pet, giving you a good view of a swiftly forming tail as it pushes out of the back of her uniform.";
				increase ColleenTalk by 1;
			else:
				say "     'Thanks again for all your help,' Colleen says as she gestures to her freshly bound ankle before glancing over at Sarah. 'Your friend helped me out in getting patched up and told me a little bit about what's going on in the city. I don't want to think about what might have happened to me if you hadn't shown up to help out. We soldiers were given no real clue what we were up against - they just sent us in to gather information,' Colleen says with a sigh, then looks around in the bunker and smiles. 'Seems you found a nice place to hole up in though, and I'm not the only stray you have been picking up, eh? At least there is plenty of room here, even if it is a bit sparse.'";
				say "     Lowering her voice a bit, Colleen continues, 'I am just a little bit worried about sharing a room with someone that heavily infected. I mean - she seems to be holding out ok, but you never know.' She eyes Sarah with a bit of worry, though you think you might notice hint of interest there as well. 'At least she is something relatively safe like a dog. I don't mind dogs at all really, I even used to have one when I was little,' Colleen says with a fond smile, before turning back to look at you. 'I'm seriously grateful to you for all you've done, for both of us, she told me how you helped her too. Although I know it isn't much, I found a medkit in the library, and I want you to have it,' she says as she hands you a medkit.";
				WaitLineBreak;
				increase carried of medkit by 1;
				say "You received a medkit!";
				say "     'Other than that, there is something else I might be able to do to help out. They gave me this experimental spray that they said should help me out in the city. From what I can tell now, I think it might be able to help you fight off the infection somewhat,' Colleen says as she brandishes a small spray can. 'Fortunately it seems to have survived my accident with the tree intact, and while I could probably use it myself, it just doesn't seem like the right thing to do... I can use it on you if you want me to. Just come and ask me to [bold type]spray[roman type] you with it if you want to try it out, be careful though, there are only a couple doses in a can this size, and I don't have any more,' she says as she tucks the can back away safely.";
				say "     'You won't have to worry about leaving me here either, I have enough MREs left they should hold me until the rescue. Sadly I don't have enough to really share, but at least it should be enough that neither I nor Sarah will need to leave the bunker,' the woman says as she gives you a bright smile, then goes to settle herself down on a bed in one corner of the main bunker room.";
				increase ColleenTalk by 1;
		else:
			say "     'Thanks again for all your help,' Colleen says, as she gestures to her freshly bound ankle, 'I don't want to think about what might have happened to me if you hadn't shown up to help out. Just seeing all that happened as we passed through the city was a real eye opener. My troop had no real clue what was going on in here when they sent us to gather information.' Colleen shudders slightly at that, before looking around the nice secure bunker and smiling. 'Seems you found a nice place to hole up though, it seems kind of sparse but it's downright cozy compared to sleeping out in the city. Thanks again for bringing me here. I know it isn't much, but I found a medkit in the library, and there are still plenty of supplies left in it even after taking care of my ankle, so I figure you might be able to use it,' she says as she hands you a medkit.";
			increase carried of medkit by 1;
			say "You received a medkit!";
			say "     'Other than that, there is something else I might be able to do to help out. They gave me this experimental spray that they said should help me out in the city. From what I can tell now, I think it might be able to help you fight off the infection somewhat,' Colleen says as she brandishes a small spray can. 'Fortunately it seems to have survived my accident with the tree intact, and while I could probably use it myself, it just doesn't seem like the right thing to do... I can use it on you if you want me to. Just come and ask me to [bold type]spray[roman type] you with it if you want to try it out, be careful though, there are only a couple doses in a can this size, and I don't have any more,' she says as she tucks the can back away safely.";
			say "     'You won't have to worry about leaving me here either, I have enough MREs left they should hold me until the rescue. Sadly I don't have enough to really share, but I won't have to leave the bunker at least and I will keep the door shut tight until you return,' the woman says as she gives you a bright smile, then goes to settle herself down on a bed in one corner of the main bunker room.";
			increase ColleenTalk by 1;
	else if a random chance of 1 in 4 succeeds:
		say "[Colleen_Vanessa_msg]";
	else if Meredith is bunkered and a random chance of 1 in 4 succeeds:
		say "[Colleen_Meredith_msg]";
	else if HP of Gwen > 0 and a random chance of 1 in 5 succeeds:
		say "[Colleen_Meredith_msg]";
	else if ColleenTalk is 1:
		if Sarah is in the bunker:
			if ColleenAlpha > 0:
				project the Figure of Colleen_face_icon;
				say "     [one of]'Thanks for showing me what life as a husky is like!'[or]'I'm sure you will make a lovely little bitch!'[or]The husky bitch just grins at you, before pulling you down into a deep dirty kiss.[or]'You must have enjoyed training such a nice submissive pet!'[or]'I love being a bitch...'[or]'Mmmm when we get out of here I want to get a bunch of dogs to keep me company...' Colleen says with a sly glance at you and your pet. 'Would you two like to volunteer?'[or]'I am so glad the military sent me into the city, I would never have been able to find myself otherwise...'[or]'I have been looking around for the rest of my squad out there... I hope I can find them before they become something else... it would be nice to have some more husky company...'[or]'I am seeing a lot of strange stuff out there in the city, but not enough canine studs...'[or]'Are you ready to become a husky bitch yet?'[or]'Won't it be fun to all be bitches together?'[or]'I just love running through the city on all fours hunting! You should try it soon too!'[Or]She is too busy to respond to you as she appears to be playing with a large, canine-shaped dildo she acquired somewhere... the sight is somewhat arousing.[or]'Do you think I would make a good alpha?' she asks you with a wink as she strokes your body with her paws.[or]'We should find a way to share this with the rest of the military, I can think of several people I would love to see down on all fours...'[or]'I can't wait to find more members for our pack!'[or]'I threw away that dirty old human spray. Who would ever want to go back to being a boring old human anyways?'[at random]";
			else if ColleenSlut is 1:
				project the Figure of Colleen_face_icon;
				say "     [one of]'I am so glad I followed you home!'[or]'You wouldn't believe all the fun things there are out there to fuck!'[or]'I love being a husky slut!'[or]'Maybe someday I'll find an owner... I just have to keep looking!'[or]She is too busy rubbing herself and panting in need to respond.[or]'I found out that I just love sucking [one of]Feline[or]Equine[or]cat[or]dog[or]horse[or]gryphon[or]bear[or]rat[or]Satyr[or]gator[at random] cock! I would have never been able to find that out before you helped me out. So thanks!'[or]'I wish my old dog were still here, I would be on all fours before him in an instant...' she says with a dreamy look on her face.[or]'Won't you please use me like a bitch?'[or]'I wish more people could know just how great it is to be a bitch...'[or]'My pussy feels so empty...' she moans as she looks at you pleadingly.[or]'Maybe one day if I am a good enough husky, someone will put a collar on me!'[or]'I hope the rescue comes soon, I just can't wait for all those lovely military men to come play with me!'[or]'Do you know a good area of the city to look for canine studs?'[or]'Those damn tigress hookers keep chasing me away from the Red light district!' Colleen fumes. 'They say I am slutting up all of their business!'[or]'I found this zoo last time I was out there and saw this really big panther herm roaming around. His cock looked so tasty...'[at random]";
			else if ColleenCollared is 1:
				project the Figure of Colleen_face_icon;
				say "     [one of]'I am so glad you brought me home!'[or]'Please fuck me master!'[or]'Thank you for making me your pet!'[or]'I am so glad you found me in the tree instead of leaving me to one of those beasts in the city, it would be horrible to not have a proper owner!'[or]'I love my collar master!'[or]She fiddles with her collar with one paw, while her other paw rubs her leaking slit lustfully.[or]'Do you think I make as good a pet as your slut over there?' Colleen asks you nervously.[or]'Your bitch loves her master!'[or]'Mmmmm, puppies...' she says as she rubs absently at her belly.[or]'Do you want to play with your pet?'[or]'Thank you for teaching bitch how to be a proper husky!' she says, fingering her nametag lovingly.[or]'Colleen is a pet, Colleen is a good pet. Colleen is bitch, Colleen is a good bitch,' she is muttering over and over to herself.[or]'Master, would you mind looking for the rest of your bitch's teammates out there in the city? I just know they would make more good little bitches for you, master!'[or]'Can nom lolcat master? Is looks tasty...'[or]She just stares at you, panting, a somewhat vacant expression on her canine face as she waits for you to tell her what to do.[at random]";
			else if SarahSlut is 4:
				project the Figure of Colleen_face_icon;
				if SarahPups > 0:
					if a random chance of 1 in 2 succeeds:
						say "     [one of]'Thanks again for all your help sexy!'[or]'I hope we can all make out in here safely,' she says, then blinks, 'make out in here...' she pants as she rubs her softly furred legs together, glancing at Sarah and you in speculation.[or]'I'm loving the company in here. It's so nice to have a horny little bitch to keep me company...' she says as she smiles happily at the naked Sarah.[or]'Let me know if you find any other members of my team out there, I can't wait to share this wonderful feeling with them,' she says with a lusty moan. 'Maybe they will become lovely little bitches for you too...'[or]'It surprised me at first how very happy your pet was just to be a slutty little bitch, but now I can't stop wishing I was one too...'[or]'Sarah seems to be really happy with her new status. It was really nice of you to make her such a happy, slutty bitch for her master...' Colleen says, obviously excited by the prospect.[or]'I wonder what being a husky bitch is like...' Colleen says absently, even as her tail wags and her husky nose twitches with curiosity. 'Would I find a good sexy master to fuck me and make me his pet too?' she says, glancing at you speculatively.[or]'Found any other strays to take in?' she says with a lewd grin. 'Particularly sexy male canine ones?' [or]'She is such a happy little bitch,' she says with an envious nod at Sarah. 'I wish I was a happy, slutty little husky bitch for my master, too...'[at random]";
					else:
						say "     [one of]'Is that what you have planned for me too?' Colleen asks eagerly as she nods at your naked husky bitch, 'Are you going to make me your slutty little husky pet, and fuck me again and again until all I can think about is being a lovely little bitch whelping you litter after litter of handsome pups?' she pants out as she rubs herself lewdly at the idea, her tail wagging eagerly and body obviously terribly excited by the thought.[or]'My body is changing so very fast,' Colleen says with a happy smile as she looks at you, 'And I just can't wait, it feels so good to be becoming a dog!'[or]'She is just so very happy,' Colleen says, nodding at Sarah, 'I wonder what it would be like to be a happy little pet like that, I wish someone would help me find out...'[or]'I love the collar! It's the perfect fashion accessory for a slutty little bitch like her!' Colleen says as she stares enviously at Sarah while one of her hands unconsciously rubs at her own naked furred throat.[or]'I wonder what I would have to do to get someone to put a collar on me...' she says as she stares at you eagerly.[or]Colleen doesn't respond to you, being far too busy rubbing her new husky body with her hands.[or]'Puppies,' Colleen says as she pets one of your pups, 'What I wouldn't give to have puppies,' she says absently, her tail wagging at the thought.[or]'I wish my old dog Roscoe was here...' she says in wistful tone of voice, 'Then he could mount my slutty little body and fill it up with his puppies...' Her voice trails off as she loses herself in her fantasy.[or]'I love playing with the puppies!' Colleen says happily as she looks at you, 'But I can't help feeling like it would be even more fun If I could have some puppies of my own for some reason...'[at random]";
				else:
					say "     [one of]'Thanks again for all your help sexy!'[or]'I hope we can all make out in here safely,' she says, then blinks, 'make out in here...' she pants as she rubs her softly furred legs together, glancing at Sarah and you in speculation.[or]'I'm loving the company in here. It's so nice to have a horny little bitch to keep me company...' she says as she smiles happily at the naked Sarah.[or]'Let me know if you find any other members of my team out there, I can't wait to share this wonderful feeling with them,' she says with a lusty moan. 'Maybe they will become lovely little bitches for you too...'[or]'It surprised me at first how very happy your pet was just to be a slutty little bitch, but now I can't stop wishing I was one too...'[or]'Sarah seems to be really happy with her new status. It was really nice of you to make her such a happy, slutty bitch for her master...' Colleen says, obviously excited by the prospect.[or]'I wonder what being a husky bitch is like...' Colleen says absently, even as her tail wags and her husky nose twitches with curiosity. 'Would I find a good sexy master to fuck me and make me his pet too?' she says, glancing at you speculatively.[or]'Found any other strays to take in?' she says with a lewd grin. 'Particularly sexy male canine ones?'[or]'She is such a happy little bitch,' she says with an envious nod at Sarah. 'I wish I was a happy, slutty little husky bitch for my master, too...'[or]'Is that what you have planned for me too?' Colleen asks eagerly as she nods at your naked husky bitch, 'Are you going to make me your slutty little husky pet, and fuck me again and again until all I can think about is being a lovely little bitch whelping you litter after litter of handsome pups?' she pants out as she rubs herself lewdly at the idea, her tail wagging eagerly and body obviously terribly excited by the thought.[or]'My body is changing so very fast,' Colleen says with a happy smile as she looks at you, 'And I just can't wait, it feels so good to be becoming a dog!'[or]'She is just so very happy,' Colleen says, nodding at Sarah, 'I wonder what it would be like to be a happy little pet like that, I wish someone would help me find out...'[or]'I love the collar! It's the perfect fashion accessory for a slutty little bitch like her!' Colleen says as she stares enviously at Sarah while one of her hands unconsciously rubs at her own naked furred throat.[or]'I wonder what I would have to do to get someone to put a collar on me...' she says as she stares at you eagerly.[or]Colleen doesn't respond to you, being far too busy rubbing her new husky body with her hands.[or]'I wish my old dog Roscoe was here...' she says in wistful tone of voice, 'Then he could mount my slutty little body and...' Her voice trails off as she loses herself in her fantasy.[at random]";
			else if SarahSlut is 3:
				project the Figure of Colleen_face_icon;
				say "     [one of]'Thanks again for all your help sexy!'[or]'I hope we can all make out in here safely,' she says, then blinks, 'make out in here...' she says with a thoughtful glance at Sarah.[or]'I'm enjoying the company in here, but she is making it hard to concentrate...' she says as she nods at the naked Sarah.[or]'Let me know if you find any other members of my team out there, especially if they are male,' she says with a soft blush[or]'It surprised me at first how much fun many of the infected seemed to be having, but after watching your pet I can almost envy them...'[or]'Sarah seems to really happy with her new status, it was really nice of you to make her such a happy bitch...'[or]'I wonder what being a husky is like...' Colleen says absently, even as her tail wags and her husky nose twitches with curiosity[or]'Found any other strays to take in?' she says with a grin. 'Particularly sexy male ones?' [or]'She is such a little happy dog,' she says with an envious nod at Sarah.[or]'Is that what you have planned for me too?' Colleen asks as she nods at your naked husky bitch, her body obviously terribly excited by the thought.[or]'My body is starting to change too,' Colleen says with a happy smile as she looks at you, 'And I just can't wait, it feels so good!.'[or]'She is just so very happy,' Colleen says, nodding at Sarah, 'I wonder what it would be like to be a happy little pet like that...'[or]'I love the collar! It's the perfect fashion accessory for her!' Colleen says as she stares enviously at Sarah while one of her hands unconsciously rubs at her own throat.[or]'That wonderful smell in here keeps getting stronger...' she says, her new husky nose twitching as it takes in the scent of a bitch in heat.[at random]";
			else if SarahSlut is 1 or SarahSlut is 2:
				say "     [one of]'Thanks again for all your help!'[or]'I hope we can all make out in here safely,' she says, then blinks, 'out OF here I meant...' she says with a blush.[or]'I'm enjoying the company here, but she is starting to make me pretty nervous,' she says as she nods at the naked Sarah.[or]'Let me know if you find any other members of my team out there.'[or]'It surprised me a lot how much fun many of the infected seemed to be having.'[or]'Sarah seems to still be hanging in there barely, are you really sure you should be doing this to her?'[or]'I wonder what being a husky is like...'[or]'Found any other strays to take in?' she says with a grin.[or]'I'm not sure she can take much more of this,' she says with a nod at Sarah.[or]'Is that what you have planned for me too?' Colleen asks as she nods at the naked husky, seemingly worried, though her wagging tail makes you think she might be slightly excited by the idea.[or]'I think my body is starting to change too,' Colleen says in worry as she looks at you, 'And the worst part is, I think I kind of like it.'[or]'Well at least she seems happy,' Colleen says, nodding at Sarah.[at random]";
			else:
				say "     [one of]'Thanks again for all your help!'[or]'I hope we can all make it out of here safely.'[or]'I'm enjoying the company here,' she says as she nods at Sarah.[or]'Let me know if you find any other members of my team out there.'[or]'It surprised me a lot how much fun many of the infected seemed to be having.'[or]'Sarah seems to still be holding in there, don't worry!'[or]'I wonder what being a husky is like...'[or]'Found any other strays to take in?' she says with a grin.[at random]";
		else:
			say "     [one of]'Thanks for all the help!'[or]'Glad to see you back again.'[or]'Be careful out there. It would be pretty lonely here without you.'[or]'Damn, I found some fun books here to read!'[or]'Let me know if you find any other members of my squad out there.'[or]'Try to be careful out there. This place is much more dangerous than they warned us.'[or]'It surprised me a lot how much fun many of the infected seemed to be having.'[or]'Sometimes I find myself wondering what it would be like to just wander outside and find one of infected to fuck...'[at random]";


to say Colleen_Vanessa_msg:
	if ColleenAlpha > 0 or ColleenSlut > 0 or ColleenCollared > 0:
		project the Figure of Colleen_face_icon;
		say "     [if Vanessa is bunkered and a random chance of 1 in 4 succeeds]'Thanks for finding the sarge out there. Those centaurs probably would have added her to their herd if you'd not helped her out.'[else if Vanessa is bunkered and HP of Vanessa >= 4 and a random chance of 1 in 3 succeeds]'It's nice that the sarge and I can hang out together. We both seem pretty firmly set in our forms, so it's safe for us to enjoy one another's company again,' she says with an excited wag of her tail. From the scent of arousal, it's clear just what kind of company they're sharing together.[else if Vanessa is bunkered and a random chance of 1 in 3 succeeds]'Once the sarge is fully transformed, then we think it should be safe enough for the two of us to get close again. I'm really looking forward to that,' she says with an excited wag of her tail. From the scent of arousal, it's quite clear exactly what she's looking forward to.[else if Vanessa is bunkered and HP of Vanessa < 4]'The sarge's pregnancy might be a problem if she's not transformed enough to deal with birthing a foal.'[else if Vanessa is bunkered and HP of Vanessa >= 4]'The sarge looks quite nice now that she's fully transformed, don't you think? She seems to be having nearly as much fun being a breeding mare as I am with being a slutty husky,' she says with a grin and a wag of her fluffy tail.[else if HP of Vanessa is 51]'I feel bad that Vanessa didn't make it back. I guess you kind of expected that things wouldn't go well.'[else]'I wonder what happened to the rest of my squad mates. We'd gotten pretty scattered when the drop went bad. I hope they're having as much fun as I am with whatever's probably infected them.'[end if]";
	else if SarahSlut >= 4:
		project the Figure of Colleen_face_icon;
		say "     [if Vanessa is bunkered and a random chance of 1 in 4 succeeds]'Thanks for finding the sarge out there. Those centaurs probably would have added her to their herd if you'd not helped her out.'[else if Vanessa is bunkered and a random chance of 1 in 3 succeeds]'It'd probably be best to wait until I've got a master like Sarah before I go play with the sarge, just to be sure I stay a sexy husky,' she says with an alluring pose and an enticing grin.[else if Vanessa is bunkered and HP of Vanessa < 4]'The sarge's pregnancy might be a problem if she's not transformed enough to deal with birthing a foal.'[else if Vanessa is bunkered and HP of Vanessa >= 4]'The sarge looks quite nice now that she's fully transformed, don't you think? She seems to be having nearly as much fun being a breeding mare as I am with being a slutty husky,' she says with a grin and a wag of her fluffy tail.[else if HP of Vanessa is 51]'I feel bad that Vanessa didn't make it back. I guess you kind of expected that things wouldn't go well.'[else]'I wonder what happened to the rest of my squad mates. We'd gotten pretty scattered when the drop went bad. I hope they're having as much fun as I am with whatever's probably infected them.'[end if]";
	else if SarahSlut > 0:
		say "     [if Vanessa is bunkered and a random chance of 1 in 4 succeeds]'Thanks for finding the sarge out there. Those centaurs probably would have added her to their herd if you'd not helped her out.'[else if Vanessa is bunkered and a random chance of 1 in 3 succeeds]'I'm still going to keep some distance between the sarge and myself for the moment. It'd be nice to talk to her more, but it just wouldn't be safe.'[else if Vanessa is bunkered and HP of Vanessa < 4]'The sarge's pregnancy might be a problem if she's not transformed enough to deal with birthing a foal.'[else if Vanessa is bunkered and HP of Vanessa >= 4]'The sarge seems pretty happy with being transformed. Maybe I'll enjoy being a cute husky as much as she's enjoying being a mare. I mean, if that's how it turns out, you know...' she trails off, blushing a little.[else if HP of Vanessa is 51]'I feel bad that Vanessa didn't make it back. I guess you kind of expected that things wouldn't go well.'[else]'I wonder what happened to the rest of my squad mates. We'd gotten pretty scattered when the drop went bad. I think I saw one of the paratroopers heading down in the direction of the dry plains at the outskirts of the city.'[end if]";
	else:
		say "     [if Vanessa is bunkered and a random chance of 1 in 4 succeeds]'Thanks for finding the sarge out there. Those centaurs probably would have added her to their herd if you'd not helped her out.'[else if Vanessa is bunkered and a random chance of 1 in 3 succeeds]'It's too bad the sarge has gotten infected. It'd be nice to talk to her more, but it just wouldn't be safe.'[else if Vanessa is bunkered and HP of Vanessa < 4]'The sarge's pregnancy might be a problem if she's not transformed enough to deal with birthing a foal.'[else if Vanessa is bunkered and HP of Vanessa >= 4]'The sarge seems pretty happy with being transformed. I'm not really into horses, but maybe something else wouldn't be so bad. I mean, if it happens, you know...' she trails off, blushing a little.[else if HP of Vanessa is 51]'I feel bad that Vanessa didn't make it back. I guess you kind of expected that things wouldn't go well.'[else]'I wonder what happened to the rest of my squad mates. We'd gotten pretty scattered when the drop went bad. I think I saw one of the paratroopers heading down in the direction of the dry plains at the outskirts of the city.'[end if]";

to say Colleen_Meredith_msg:
	if HP of Meredith is 0 or HP of Meredith is 100:
		say "ERROR-Colleen-[HP of Meredith]M: We should not be able to discuss Meredith!";
		now Meredith is nowhere;
	if ColleenAlpha > 0 or ColleenSlut > 0 or ColleenCollared > 0:
		project the Figure of Colleen_face_icon;
		if a random chance of 4 in 6 succeeds:
			say "     [one of]'Thanks for helping to rescue [if HP of Meredith < 6]Mere[else]Mare[end if]. I feel much better knowing our mission wasn't a complete failure.'[or]'I'm glad Meredith's somewhere safe. Her research is apparently important, not that a slutty husky like me can make heads or tails of any of it.'[or][if HP of Meredith < 4]'It'd be fun to play around a bit with Mere, but she's trying to avoid infection. She's been treated to be resistant so it should be safe for her to get some husky lovin['],' Colleen says, pouting a bit.[else if HP of Meredith is 4]'I couldn't help noticing that Mere's become a bit horsey, but she's still refusing to play around. She's been treated to be resistant so it should be safe for her to get some husky lovin['],' Colleen says, pouting a bit. 'Say, maybe you could get her to relax and have some fun. You've got a bit of a knack for it, hot stuff,' she says, running a paw down your chest before reaching around to grope your ass.[else if HP of Meredith is 5]'I've noticed that Mere's gotten transformed some more. I'd like to play around with her, but she's still refusing the husky lovin['] I know she wants,' Colleen says, pouting a bit. 'You should see if you can get in the sack with her again to help her along.'[else if HP of Meredith >= 6]'Mare's so cute as a sexy centaur. You did a good job helping her out of her shell. It's so nice to be able to give her the husky lovin['] she needs. Vanessa and I are going to take good care of our playful Mare,' she says with a happy grin on her doggy face.[end if][cycling]";
		else:
			say "     [one of][if HP of Meredith < 4]'Mere's been running some tests on me and examining my sexy new body. I've tried to tempt her into some fun, but I haven't been able to get her to play with the horny husky quite yet.'[else if HP of Meredith is 4]'Mere's been running some tests on me and examining my sexy new body. I can tell she wants to play with the horny husky, but I haven't been able to tempt her into some fun quite yet.'[else if HP of Meredith is 5]'Mere's examinations of my body have been getting hotter and more fun though I haven't been able to quite tempt her into playing with the horny husky quite yet.'[else if HP of Meredith >= 6 and Meredith_Colleen_fun1 is false]'Mare's been running some tests on me and examining my sexy new body. We're making a game out of her playing with the horny husky while she does. You should really watch some time,' she says with a wink.[else if HP of Meredith >= 6 and Meredith_Colleen_fun1 is true]'As you've seen, Mare's been running some tests on me and examining my sexy new body and they can get pretty intense as she plays with the horny husky while she does,' she says, fingering her pussy as she remembers the last time.[end if][or][if HP of Meredith < 4]'I think Meredith's a little too focused on her notes and research and should get some hands-on experience. I mean, at her age and she hasn't even been fucked yet? How does she even survive?'[else if HP of Meredith is 4]'I think Meredith's a little too focused on her notes and research and should get some hands-on experience. Maybe now that she's been transformed a bit she'll go for it. I mean, at her age and she hasn't even been fucked yet? How does she even survive?'[else if libido of Meredith is 2]'I'm glad Meredith's getting some hands-on experience instead of just being focused on her notes and research. I can tell that getting fucked's done a world of good to loosen her up. Good job.'[else if libido of Meredith is 1]'I'm glad Meredith's getting some hands-on experience instead of just being focused on her notes and research. I can tell that getting fucked's done a world of good to loosen her up.'[else]'I'm glad Meredith's getting some hands-on experience instead of just being focused on her notes and research, but I think she needs to get a proper fucking and her cherry popped. I mean, at her age and she hasn't even been fucked yet? How does she even survive?'[end if][cycling]";
	else if SarahSlut >= 4:
		project the Figure of Colleen_face_icon;
		if a random chance of 4 in 6 succeeds:
			say "     [one of]'Thanks for helping to rescue [if HP of Meredith < 6]Mere[else]Mare[end if]. I feel much better knowing our mission wasn't a complete failure.'[or]'I'm glad Meredith's somewhere safe. Her research is apparently important, not that a silly husky like me can make heads or tails of any of it.'[or][if HP of Meredith < 4]'I'm looking forward to trying to coax Mere into some husky lovin[']. But I should probably wait until I've got a master like Sarah before that,' she says with a grin and a wink at you.[else if HP of Meredith is 4 or HP of Meredith is 5]'I'm looking forward to trying to coax Mere into some husky lovin[']. She's turning into one cute horsey. But I should probably wait until I've got a master like Sarah before that,' she says with a grin and a wink at you.[else if HP of Meredith >= 6]'I'm looking forward to trying to coax Mare into some husky lovin[']. She's become quite the cute centaur. But I should probably wait until I've got a master like Sarah before that,' she says with a grin and a wink at you.[end if][cycling]";
		else:
			say "     [one of][if HP of Meredith < 4]'Mere's been running some tests on me and examining my sexy new body. I'm quite tempted to coax her into some fun... once I've got a master of my own like Sarah, that is,' [else if HP of Meredith is 4 or HP of Meredith is 5]'Mere's been running some tests on me and examining my sexy new body. I know she's excited by it too and I'm quite tempted to coax her into some fun... once I've got a master of my own like Sarah, that is,' [else if HP of Meredith >= 6]'Mere's been running some tests on me and examining my sexy new body. She's been hinting that she'd like to have some fun during them, and it's so tempting, but I've told her only once I've got a master of my own like Sarah,' [end if]she says, pressing her body to yours with a soft moan of desire.[or][if HP of Meredith < 4]'I think Meredith's a little too focused on her notes and research and should get some hands on experience. I mean, at her age and she hasn't even been fucked yet? I know I'm going to need a proper pounding soon,' she says, turning to flash her rear at you with a wag of her tail.[else if HP of Meredith is 4]'I think Meredith's a little too focused on her notes and research and should get some hands-on experience. Maybe now that she's been transformed a bit she'll go for it. I mean, at her age and she hasn't even been fucked yet? I know I'm going to need a proper pounding soon,' she says, turning to flash her rear at you with a wag of her tail.[else if libido of Meredith is 2]'I'm glad Meredith's getting some hands-on experience instead of just being focused on her notes and research. I can tell that getting fucked's done a world of good to loosen her up. Good job.'[else if libido of Meredith is 1]'I'm glad Meredith's getting some hands-on experience instead of just being focused on her notes and research. I can tell that getting fucked's done a world of good to loosen her up.'[else]'I'm glad Meredith's getting some hands-on experience instead of just being focused on her notes and research, but I think she needs to get a proper fucking and her cherry popped. I mean, at her age and she hasn't even been fucked yet? How does she even survive?'[end if][cycling]";
	else if SarahSlut > 0:
		if a random chance of 4 in 6 succeeds:
			say "     [one of]'Thanks for helping to rescue Mere. I feel much better knowing our mission wasn't a complete failure.'[or]'I'm glad Meredith's somewhere safe. Her research is apparently important, not that a grunt like me can make heads or tails of any of it.'[or][if HP of Meredith < 4]'I've always thought Mere was pretty cute and that it'd be fun to coax her into having some fun once all this is over. But now that I'm transforming, I'm not sure if that's such a good idea.'[else if HP of Meredith is 4 or HP of Meredith is 5]'I've always thought Mere was pretty cute and that it'd be fun to coax her into having some fun once all this is over. But now that we're both transforming, I'm not sure if that's such a good idea.'[else if HP of Meredith >= 6]'I've always thought Mere was pretty cute and that it'd be fun to coax her into having some fun once all this is over. But now that I'm transforming, I'm not sure if that's such a good idea. I mean, I can tell she'd be up for it, but I need to keep my head on straight.'[end if][cycling]";
		else:
			say "     [one of][if HP of Meredith < 6]'Mere's been running some tests on me and examining my transforming body. When she does, I can't help but feel tempted to have her [']play doctor['] with me,' she says, blushing a bit at the admission.[else if HP of Meredith >= 6]'Mare's been running some tests on me and examining my transforming body. When she does, I can't help but feel tempted to have her [']play doctor['] with me,' she says, blushing a bit at the admission. 'I know she'd be up for it now that she's loosened up and having sex.'[end if][or][if HP of Meredith < 4]'I think Meredith's a little too focused on her notes and research and should get some hands on experience. I mean, at her age and she hasn't even been fucked yet? It might be my changes talking, but I'm feeling more turned on all the time.'[else if HP of Meredith is 4]'I think Meredith's a little too focused on her notes and research and should get some hands-on experience. Maybe now that she's been transformed a bit she'll go for it. I mean, at her age and she hasn't even been fucked yet? It might be my changes talking, but I'm feeling more turned on all the time.[else if libido of Meredith is 2]'I'm glad Meredith's getting some hands-on experience instead of just being focused on her notes and research. Maybe it's just my changes talking, but I can tell that getting fucked's done a world of good to loosen her up. Good job.'[else if libido of Meredith is 1]'I'm glad Meredith's getting some hands-on experience instead of just being focused on her notes and research. Maybe it's just my changes talking, but I can tell that getting fucked's done a world of good to loosen her up.'[else]'I'm glad Meredith's getting some hands-on experience instead of just being focused on her notes and research, but I think she needs to get a proper fucking and her cherry popped. I mean, at her age and she hasn't even been fucked yet? It might be my changes talking, but I'm feeling more turned on all the time.'[end if][cycling]";
	else:
		if a random chance of 4 in 6 succeeds:
			say "[one of]'Thanks for helping to rescue Mere. I feel much better knowing our mission wasn't a complete failure.'[or]'I'm glad Meredith's somewhere safe. Her research is apparently important, not that a grunt like me can make heads or tails of any of it.'[or][if HP of Meredith < 4]'I've always thought Mere was pretty cute. Maybe once we're out of the city, I'll see if I can help her out of that shell and get her to have some fun.' She blushes a bit at having admitted her lesbian crush on the researcher.[else if HP of Meredith is 4 or HP of Meredith is 5]'I've always thought Mere was pretty cute and I was hoping to help her out of her shell once we were both safely out of the city, but now that she's changing, I don't know if it'll be safe to try it.' Colleen blushes a bit at having admitted her lesbian crush on the researcher.[else if HP of Meredith >= 6]'I've always thought Mare was pretty cute and I was hoping to help her out of her shell once we were both safely out of the city. Well, at least now that she's a centaur like Vanessa, the sarge will be able to take care of her and her needs even if I'm left out.'[end if][cycling]";
		else:
			say "[one of]'[if HP of Meredith < 6]Mere[else]Mare[end if]'s done a few quick tests on me, confirming that I'm still not infected yet. Apparently anyone in and around the city's got nanites in them by this point and it's just a matter of whether or not they've come into contact with an infection source to make them active. I need to be careful. Even casual contact might start my transformation[if HP of Meredith >= 4]. I mean, Meredith's supposed to be resistant to it and even she's ended up changing[end if].'[or][if HP of Meredith < 4]'I think Meredith's a little too focused on her notes and research. She's going to have to get some hands on experience sometime, otherwise she'll be a virgin forever.'[else if HP of Meredith is 4]'I think Meredith's a little too focused on her notes and research. Maybe now that she's gotten infected she at least won't be a virgin much longer. I mean, she's going to have to get some hands on experience sometime.'[else if libido of Meredith is 2]'I'm glad Meredith's getting some hands-on experience instead of just being focused on her notes and research. I was worried that even with this crazy sex thing going on she'd stay a virgin forever. Good job.'[else if libido of Meredith is 1]'I'm glad Meredith's getting some hands-on experience instead of just being focused on her notes and research. I was worried that even with this crazy sex thing going on she'd stay a virgin forever.'[else if player is male]'I'm glad Meredith's getting some hands-on experience instead of just being focused on her notes and research. Hopefully she'll find someone to pop her cherry before she ends up staying a virgin forever.' She puts a particular emphasis on the [']someone['], letting you know who she's got in mind for the job.[else]'I'm glad Meredith's getting some hands-on experience instead of just being focused on her notes and research. Hopefully she'll find someone to pop her cherry before she ends up staying a virgin forever.'[end if][cycling]";

[		***reorganize these into the above?		]
[	else if HP of Meredith is 10:
		say "***ub'd Gwen";
	else if HP of Meredith is 11:
		say "***not preggers yet/ub over";
	else if HP of Meredith is 12:
		say "***has been knocked up at least once";
		if XP of Meredith is 0:
			say "***not presently knocked up.";
		else if XP of Meredith < 13:
			say "***early preg.";
		else if XP of Meredith > 12:
			say "***late preg.";
]


to say Colleen_gwen_msg:
	if ColleenAlpha > 0 or ColleenSlut > 0 or ColleenCollared > 0:
		project the Figure of Colleen_face_icon;
		say "     [if HP of Gwen is 2]'That thing Mare did with Gwen seems pretty kinky. I wonder what it must be like.'[else if HP of Gwen <= 35]'Gwen makes for such a cute centaur. I can hardly wait until she's all grown up so we can celebrate her joining the herd.'[else if HP of Gwen <= 60]'Gwen is so hot now. We're going to have lots of fun together.'[else if HP of Gwen is 1 or HP of Gwen > 60]'I'm going to miss all the sex I could be having with Gwen, but Vanessa's right that she needs to go out and scout for us. We can play once the rescue comes.'[end if]";
	else if SarahSlut >= 4:
		project the Figure of Colleen_face_icon;
		say "     [if HP of Gwen is 2]'That thing Mare did with Gwen seems pretty kinky. I wonder what it must be like.'[else if HP of Gwen <= 35]'Gwen makes for such a cute centaur. I can hardly wait until she's all grown up and I'm a proper pet so we can celebrate her joining the herd.'[else if HP of Gwen <= 60]'Gwen is so hot now. We're planning to have lots of fun together to celebrate my becoming a proper husky girl.'[else if HP of Gwen is 1 or HP of Gwen > 60]'It's too bad I missed out on all the hot sex with Gwen, but Vanessa's right that she needs to scout for us.'[end if]";
	else if SarahSlut > 0:
		say "     [if HP of Gwen is 2]That thing Meredith did with Gwen is pretty far out. I'd have never believed anyone could do something like that before this mess.'[else if HP of Gwen <= 35]'Gwen seems quite happy with her transformation. At least it's much better than turning into a sex demon out to corrupt others.'[else if HP of Gwen <= 60]Gwen's become surprisingly beautiful. I don't mean to say she was ugly before, but she was nowhere near the knockout she is now. I'd love to hit that,' she says, then blushes brightly when she realizes what she'd said. 'I miss Gwen, but Vanessa was right to send her on that special scouting mission. She's got her growing herd to worry about.'[else if HP of Gwen is 1 or HP of Gwen > 60][end if]";
	else:
		say "     [if HP of Gwen is 2]'Vanessa and Meredith weren't quite clear on why they needed to do that to Private Washington, but if you say it had to be done, then I guess it's alright. At least Gwen will be back with us soon.'[else if HP of Gwen <= 35]'Gwen seems quite happy with her transformation. At least it's much better than turning into a sex demon out to corrupt others.'[else if HP of Gwen <= 60]Gwen's become surprisingly beautiful. I don't mean to say she was ugly before, but she was nowhere near the knockout she is now,' she says, blushing a bit.[else if HP of Gwen is 1 or HP of Gwen > 60]'I miss Gwen, but Vanessa was right to send her on that special scouting mission. She's got her growing herd to worry about.'[end if]";


Section 4 - Restorative Spray

ColleenSpraying is an action applying to nothing.

Understand "Spray me" as ColleenSpraying.
Understand "Colleen spray" as ColleenSpraying.
Understand "Spray Colleen" as ColleenSpraying.

check ColleenSpraying:
	if Colleen is not visible, say "How?" instead;

carry out ColleenSpraying:
	if ColleenSpray is 0:
		if Sarah is in the bunker:
			if ColleenAlpha > 0:
				project the Figure of Colleen_face_icon;
				say "     'Sorry there, little one,' she says with mock sincerity. 'I got rid of that silly little canister a while ago. It's not like anyone here was going to be needing it after all,' Colleen says with a soft husky laugh as she rubs herself up against your body suggestively.";
			else if ColleenSlut is 1:
				project the Figure of Colleen_face_icon;
				say "     'You want to undo some of these wonderful changes? That sounds pretty strange to me...' Colleen says with a sad look on her husky face. 'Well ok, I suppose, but I won't use it on either myself or your pet there,' she says with a gesture at where your happy little bitch is sitting in the corner. 'It is waaay too much fun being a bitch for us to want to be anything else... but I suppose I can still use it on you if you want.'";
				if player consents:
					say "     'Well ok, here goes nothing,' the husky slut says nervously as she uncaps the small spray bottle, being careful to make sure it is pointed well away from her, before spraying you with the strange antiseptic smelling liquid. You can feel the strange liquid burn and tingle as it sinks into your body, surprisingly you find yourself feeling a little better and more human almost immediately.";
					now face of player is "human";
					now facename of player is "human";
					now body of player is "human";
					now bodyname of player is "human";
					now skin of player is "human";
					now skinname of player is "human";
					now scalevalue of player is 3;
					now bodydesc of player is "unchanged";
					now bodytype of player is "human";
					now SleepRhythm of player is 0;
					increase humanity of player by 20;
					increase ColleenSpray by 1;
				else:
					say "     'See isn't it just better to be like this!' Colleen says as she wags her tail happily at you. 'I'm so glad you agree with me!'";
			else if SarahSlut > 3:
				project the Figure of Colleen_face_icon;
				say "     'Well ok, I admit the spray might still work on you, but it certainly won't work on your little pet over there, and I definitely feel too good to want to use it on myself, so I can use it on you if you really want me to... But it seems so boring if you ask me...' Colleen says as she pants slightly, her tail wagging eagerly behind her, obviously enjoying her infection and probably hoping you do as well. Do you ask her to spray you anyways?";
				if player consents:
					say "     'Well ok, here goes nothing,' Colleen says with a drooping tail as she uncaps the small spray bottle before spraying you with the strange antiseptic smelling liquid. You can feel the strange liquid burn and tingle as it sinks into your body, surprisingly you find yourself feeling a little better and more human almost immediately.";
					now face of player is "human";
					now facename of player is "human";
					now body of player is "human";
					now bodyname of player is "human";
					now skin of player is "human";
					now skinname of player is "human";
					now scalevalue of player is 3;
					now bodydesc of player is "unchanged";
					now bodytype of player is "human";
					now SleepRhythm of player is 0;
					increase humanity of player by 20;
					increase ColleenSpray by 1;
					stop the action;
				else:
					say "     'See!' Colleen says happily. 'I knew you would understand how much fun being like this is!' she says as she wags her naked body at you.'";
			else if SarahSlut > 0:
				say "     'Well ok, the spray bottle is full so it should still work on you, and it might work to help Sarah over there regain a bit of her sanity as well, but treating someone as far gone as her would take the whole bottle at once. So you need to decide what you want to do,' Colleen says as she uncaps the small spray bottle and holds it up. Do ask her to help Sarah?'";
				if player consents:
					say "     'Ok! You're the boss!' Colleen says, as she turns and ambushes Sarah with the spray can, a chemical smell fills the bunker, warring with the scent of needy husky, as she unloads the can on the husky. Sarah looks offended at first, and then somewhat embarrassed as she blushes and clutches her clothes tightly to her. Soon the can clicks empty, and you can see that Sarah looks about as clearheaded now as she did right after you first found her...";
					now SarahSlut is 0;
					now ColleenSpray is 3;
				else:
					say "     'Well ok, you're the boss, and it probably would have only been a temporary fix for her anyways, so here goes nothing,' Colleen says as she uncaps the small spray bottle before spraying you with the strange antiseptic smelling liquid. You can feel the strange liquid burn and tingle as it sinks into your body. Surprisingly, you find yourself feeling a little better and more human almost immediately.";
					now face of player is "human";
					now facename of player is "human";
					now body of player is "human";
					now bodyname of player is "human";
					now skin of player is "human";
					now skinname of player is "human";
					now scalevalue of player is 3;
					now bodydesc of player is "unchanged";
					now bodytype of player is "human";
					now SleepRhythm of player is 0;
					increase humanity of player by 20;
					increase ColleenSpray by 1;
			else:
				say "     'Well ok, the spray bottle is full so it should still work on you. Want me to spray you now?'";
				if player consents:
					say "     'Well ok, here goes nothing,' Colleen says as she uncaps the small spray bottle before spraying you with the strange antiseptic smelling liquid. You can feel the strange liquid burn and tingle as it sinks into your body. Surprisingly, you find yourself feeling a little better and more human almost immediately.";
					now face of player is "human";
					now facename of player is "human";
					now body of player is "human";
					now bodyname of player is "human";
					now skin of player is "human";
					now skinname of player is "human";
					now scalevalue of player is 3;
					now bodydesc of player is "unchanged";
					now bodytype of player is "human";
					now SleepRhythm of player is 0;
					increase humanity of player by 20;
					increase ColleenSpray by 1;
				else:
					say "     'Okay, I'll hold on to it some more then,' Colleen tells you and tugs the small spray bottle away.";
		else:
			say "     'Well ok, here goes nothing,' Colleen says as she uncaps the small spray bottle before spraying you with the strange antiseptic smelling liquid. You can feel the strange liquid burn and tingle as it sinks into your body. Surprisingly, you find yourself feeling a little better and more human almost immediately.";
			now face of player is "human";
			now facename of player is "human";
			now body of player is "human";
			now bodyname of player is "human";
			now skin of player is "human";
			now skinname of player is "human";
			now scalevalue of player is 3;
			now bodydesc of player is "unchanged";
			now bodytype of player is "human";
			now SleepRhythm of player is 0;
			increase humanity of player by 20;
			increase ColleenSpray by 1;
	else if ColleenSpray is 1:
		say "     'Ok, let's try that again! I only have about enough for one more dose after this,' Colleen warns you as she once again sprays you with the foul smelling liquid again, the tingling feeling spreading through you again, although strangely it seems to be much less strong this time. Perhaps the chemicals are losing their effectiveness?";
		now body of player is "human";
		now bodyname of player is "human";
		now scalevalue of player is 3;
		now bodydesc of player is "unchanged";
		now bodytype of player is "human";
		now SleepRhythm of player is 0;
		increase humanity of player by 20;
		increase ColleenSpray by 1;
	else if ColleenSpray is 2:
		say "     'Well, alright. It didn't seem to help as much last time though, and there isn't much left either,' Colleen says as she once again sprays that strange liquid on you, making your body tingle slightly. Although you can't seem to notice any real changes, you still somehow feel slightly more human afterwards.";
		increase humanity of player by 10;
		increase ColleenSpray by 1;
	else if ColleenSpray is 99 and Sarah is bunkered:
		say "     'Sorry, but I don't have any left. I tried to use my spray to change back after these husky features started to appear, but it never seemed to last. I ended up using it all to try and go back to normal, but it still came back after a little while. This means we probably shouldn't have any more fun, even as great as it was. If we go at it again, I might end up another slutty husky bitch.' She tries to stay calm, but she's clearly upset that she's going to be stuck like this. Though her tail wags happily at the mention of becoming a bitch, so it seems her body's interested even if her mind's not accepted it yet.";
		now ColleenSpray is 100;
	else if ColleenSpray is 99:
		say "     'Sorry, but we'd already agreed to use it on me so we could have sex. It's kind of late to back out now.'";
	else:
		say "     'Sorry, but that's it,' she says as she shakes the empty can helplessly. 'It's all gone now sadly, and I don't think it was working all that well there at the end anyways,' Colleen says with a sigh.";


Section 5 - Sex with Colleen

the fuckscene of Colleen is "[SexWithColleen]".

to say SexWithColleen:
	if player is neuter:
		say "     Now's not a good time to go looking for sex from Colleen, seeing how you're genderless at the moment.";
	else if lastfuck of Colleen - turns < 4:
		if ColleenAlpha > 0:
			project the Figure of Colleen_face_icon;
			say "     'Sorry, I know you want to hurry up and be a lovely little husky bitch just like me and your pet there,' Colleen says with a soft smile on her muzzle, 'But you look like you still need some time to recover, and I still have some things in the city to do...' she says as she gives you a soft lick on the cheek, before heading out into the city, her tail wagging behind her eagerly.";
		else if ColleenSlut is 1:
			project the Figure of Colleen_face_icon;
			say "     'Ready again already?' Colleen says with a lusty look, before looking at you more closely and pouting, 'It doesn't look like you have recovered enough for another go yet... and you went and got me all excited too,' she pants out as she rubs her slutty body with her canine paws for a minute, before her eyes drift to the door... 'Maybe I'll go out for a bit to find some fun. I'll definitely be back to play with you when you're ready to go again though!' she says as she saunters out of the bunker, her tail wagging as she goes out to find someone else to 'play' with.";
		else if ColleenCollared is 1:
			project the Figure of Colleen_face_icon;
			say "     'Your bitch is very sorry master,' Colleen says with a sad look on her face as she looks at you with her bright blue husky eyes. 'She was just playing with master's slut over there,' she says as she gestures at a very happy Sarah, 'and isn't ready for her master again yet... Bitch is very sorry,' she whines as she lowers her head, so sad at disappointing you that you can't help but feel sorry for her and pet her on the head to let her know she is still a good bitch. You decide you will just have to wait a little while before you can enjoy your newest pet after all.";
		else if ColleenSpray is 99:
			say "     'We should... probably take a break for a while. I don't want to end up overdoing it. I mean, I should still be careful,' Colleen says.";
	else if Sarah is in the bunker:
		if ColleenCollared is 1:
			project the Figure of Colleen_face_icon;
			if player is male:
				say "     'Master wants to play with his bitch?' the bitch formerly known as Colleen asks eagerly, as she quickly spreads herself before you, panting as she stretches her legs apart to show you her damp and needy pussy, just waiting for you to fill it up with your cock. You grin at the sight as you stalk forward slowly, enjoying how wantonly this formerly strong willed woman submits herself to your every desire, happily becoming just another pet for you to use whenever you want. You decide to enjoy this situation to the fullest, as you gesture for your other pet to join the two of you as you slowly begin to crawl between the spread legs of your 'Bitch', as her collar proudly proclaims.";
				say "     Your Slut crawls over to join the two of you eagerly, moving up behind Colleen even as you lift one of her legs up onto your shoulders, holding her slightly off the floor as your [cock of player] begins to rub up against her soft passage. The newly collared husky bitch moans in pleasure, her head rolling back as she lets out a long lustful cry, as Sarah reaches around her body and begins playing with her soft breasts, pulling her back until Colleen is resting her back on Sarah's chest and soft full breasts. The sight of one of your pets teasing and massaging the others breasts, even as she licks and nibbles at the back of her neck, makes your cock even harder than before. Unable to wait any longer, you shift your position slightly, and then slide your cock forward and into her warm welcoming passage, her body parting before your cock eagerly making you both moan in sheer carnal bliss.";
				WaitLineBreak;
				say "     You can see your pet Sarah whispering soft words of encouragement to your newest bitch, even as she runs her own husky paws through the fur of your latest fuckpet, the sight making you feel a swell of pride in your well trained little slutty first pet as she helps you train your newest pet properly. Enjoying the moment, you begin rolling your hips forward, pushing yourself into her again and again and making her rock back up against Sarah behind her as you fuck her like the animalistic little pet you are training her to be, a lusty little toy for your pleasure. You grin as she orgasms around you from the feel of your cock within her, and the soft teasing of her body by Sarah, her mind obviously clouded with pleasure as she stares at you dreamily through half lidded eyes, her long canine tongue hanging out the side of her mouth as she pants eagerly for more.";
				say "Her orgasm only serves to encourage you to go harder and faster, as her passage massages your cock with every thrust, as if begging you to spill your fertile seed deep into her body. Before long you are more than ready to do so, and with a soft grunt your body tenses as your cock fires its load deep into her slutty bitches womb, making her cry out as a second orgasm rushes through her body so soon after the first. A tired grin spreads across your face as you hold yourself inside her shaking body, the pleasure obviously more than Colleen can bear as she has her eyes closed and is panting harshly.";
				WaitLineBreak;
				say "     You notice with approval that your other pet is taking this opportunity to whisper more lovely words into her ears, telling your newest pet all about the joys of being filled with your wonderful seed, and how much fun it would be to grow round and pregnant with their master's lovely puppies... Maybe you should reward your other little pet with a good fuck of her own after all this, you think, as you eventually pull yourself out of your exhausted new bitch, and go to clean yourself up. Glancing back you can see that Sarah has taken it upon herself like a good little pet to lick your newest pet clean on her own, the sight of your two pets on the floor together making you smile at what a lucky master you are...";
				now lastfuck of Colleen is turns;
				infect "Alpha Husky";
			else:
				say "     'Master wants to play with his bitch?' the bitch formerly known as Colleen asks eagerly, as she looks up to see just how you want to play with her body today. Smiling at your eager little bitch, you decide it wouldn't be fair to just play with one of your pets, and gesture for your other pet to come over even as you gesture for Colleen to lie down on her back. Your happy bitch lies back eagerly, spreading her legs wide before you as she lies back down on the ground, her tail wagging along between her legs as you slowly move between them. The heat scent of her damp pussy calls to you, even as it leaks a soft trickle of eager juices out into her fur, you grin as you lower your face down to play with your pet, as you can see your other pet moving up to lick and suckle at your newest bitch's breasts, making her gasp.";
				say "     Deciding to enjoy your play time properly, you slowly tease your bitch by running your hands through the fur of her inner thighs, watching her buck her hips helplessly as Sarah tugs and licks at her breasts. The sight of your newly collared bitch writhing underneath your soft touches makes your own pussy dampen in arousal, as you begin to tease her slit with your hands, occasionally leaning closer to run your tongue across them as she shudders in pleasure above you. You can hear your first pet whispering soft words of encouragement to your newest acquisition, telling her all about the joys of being a lovely little slutty pet, with a kind and caring owner to take care of all your kinky husky needs. The words make you smile even as Colleen moans in pleasure at the happy and slutty images your pet paints for her of life as a collared pet.";
				WaitLineBreak;
				say "     You bask in pride at having trained your little slutty Sarah pet so well that she is eagerly helping you break in your newest of pets, and decide to give your newest bitch a treat to go along with her training. Burying your face in your bitches crotch again, you begin to lick and tease her damp sex with vigor, your hands working her clit pleasurably, even as your tongue expertly probes her warm velvety depths. You savor the lovely lusty taste of her husky juices on your tongue even as you probe into her deeper, using your fingers as well as your tongue now to tease and excite her body. She obviously can't much of this treatment, or the soft whispers of your other pet, and soon fills the bunker with a loud howl of orgasm as her body spasms underneath you, and you lick your lips even as your hands and face are drenched in her soft juices.";
				say "     Even after your pet has had her own orgasm, you still need to enjoy your own. Gesturing for your other pet to back off slightly, you crawl up your pets shaking body, enjoying her look of submissive joy as you move all the way up her body, until you can position your own aroused sex in front of her husky muzzle. Colleen needs no further encouragement, and has her muzzle buried in your snatch like a good little pet as soon as you settle yourself above her. You moan as she licks and teases your clit with her soft lips, before beginning to lap happily at your juices, her tongue probing your slit eagerly.";
				WaitLineBreak;
				say "     She gasps underneath you and begins to lick even more enthusiastically, making you shudder as you look back over your shoulder to see that your other pet has taken your place between her legs, and is licking at teasing at your bitch's swollen, heat-filled sex even as your bitch lashes your own with her soft tongue. Enjoying this powerful moment with your two pets, and your body already hot and excited, it isn't long before your own orgasm wracks your body with pleasure, your newly collared bitches muzzle is coated in your juices even as she tries to eagerly swallow as much of it as she can. Your legs unsteady with the intense pleasure, you manage to stagger to your feet, and look back even as your first pet brings your newest pet to another orgasm of her own with her talented husky tongue, and smile at what good little well trained pets you have.";
				now lastfuck of Colleen is turns;
				infect "Alpha Husky";
		else if ColleenSlut is 1: [stray Colleen, fucked by the player]
			project the Figure of Colleen_face_icon;
			if player is male:
				say "     'You want to play too?' the slutty little husky asks as you approach her, her eyes wandering over your male body with interest as her tail wags eagerly behind her, as she begins to crawl towards you on all fours. Her position makes her breasts seem even more prominent as they hang straight down from her chest, as she slowly stalks forward, her eyes fixed on your [cock of player] shaft. You can feel a grin tugging at your face as you watch the formerly strong military woman reduced to a panting bitch, begging and whining for a cock to fill her up. As she rubs her softly furred side up against you, you decide to take her up on her offer, and push her down to the ground as you move around behind her, deciding that if she really wants to play the role of a slutty little beast, you might as well take her like one. You can hear her groan eagerly as you position yourself above her, her rear wagging at you eagerly as you ram your cock into her in one swift movement, making her howl out in pleasure.";
				say "     You grin and groan in pleasure as you reach forward and grip and massage her soft breasts where they hang down from her chest, using them as handholds as you lean forward over her back. Her tail wags against the side of your chest as she pushes herself back to meet your every thrust, obviously as eager and wanton a bitch now, as any you have ever seen. You enjoy the changes in her personality almost as much as you are enjoying the changes to her body, loving the way she yips and whines and begs underneath you as she submits just as willingly to you as you know she now would to anything with a cock, her mind truly matching her body now, a slutty bitch both inside and outside.";
				WaitLineBreak;
				say "     Each thrust inside her hot, tight form brings you closer and closer to completion, as you pant and play with her body eagerly, the pressure and pleasure building up ever higher until with one last thrust your cock explodes within her, sending your seed straight into her needy womb as she lets loose another long howl of pleasure as she orgasms as well. You lie there locked with your bitch for several minutes as you both recover, before pulling yourself out of her slutty form, letting her collapse to the ground helplessly as she pants from the sheer pleasure acting out her role as a husky slut brings her.";
				now lastfuck of Colleen is turns;
			else:
				say "     'You want to play too?' the slutty little husky asks as you approach her, her eyes wandering over your female body with interest as her tail wags eagerly behind her, as she begins to crawl towards you on all fours. Her position makes you grin as you can feel your own body wanting to go down on all fours and join her down there to play. Deciding to give in to the desire, you are soon on all fours just like Colleen, and you grin as she rubs her body up against your own, enjoying the play as you stroke and pet the stray bitch in return. Soon your soft touches have her so excited that she pounces on you eagerly, knocking you both to the ground as you roll around together on the floor touching and tickling each other as you play together on the ground like dogs.";
				say "     Given how needy Colleen is, it isn't any surprise to you when the play takes a more intimate turn, as you both kiss at each other's faces, and your hands roam over each other's bodies. She licks and sucks at your soft breasts, even as you return the favor and lick and tease her own swollen husky teats. Eventually the two of you end up shuddering in orgasm together as you lie there on the floor, and she pulls you close and whispers into your ear softly, 'That was so fun, I almost thought I was playing with another husky bitch just like me, you responded so eagerly. Maybe you want that? To be just another happy, slutty husky like Colleen?' she asks you, panting in renewed arousal as she rubs herself up against your body. 'I found so many fun creatures and pleasures outside as a lovely little husky, so many lovely males ready and eager to mount my slutty little body. I could show them all to you and we could have such fun hunting and finding them together... what do you say?'";
				say "     She moans as she asks you, and you have to admit, the offer does sound rather tempting... Do you say yes to becoming a husky bitch like her?";
				if player consents:
					LineBreak;
					say "     'I knew you would love it,' she says as you nod eagerly in agreement, before she brings her muzzle down to give you a sloppy husky kiss. 'Just the idea of you running with me out there in the city, as we have fun teasing all the males into filling us up with their lovely cocks, makes me sooo hot again...' she moans, as she renews her carnal assault on your body. Her soft touches and kisses making you moan as you begin to return the favor, the two of you soon writhing on the floor again in pleasure, while your other pet looks on in amusement, seeming to happily watch you as you accept your true desire to be a husky slut just like your pet...";
					infect "Female Husky";
					now lastfuck of Colleen is turns;
					now SarahSlut is 5;
					increase ColleenAlpha by 1; [stray Colleen, alpha bitch for the player]
					now ColleenSlut is 0;
				else:
					LineBreak;
					say "     'That's too bad,' Colleen pants as she lies back on the ground to recover from your rough lovemaking and play session, 'But maybe we can at least play like this again sometime soon,' she says hopefully, as you slowly get to your feet and begin to gather up your belongings to head out again.";
					infect "Female Husky";
					now lastfuck of Colleen is turns;
		else if ColleenAlpha > 0: [stay Colleen that the player agreed to join as a husky]
			project the Figure of Colleen_face_icon;
			if player is male:
				say "     'You will never become a happy, slutty husky bitch like us with that!' Colleen says as she stares at your manhood, 'Though it does look very nice on you... Maybe I should help you out with your problems, and get a little treat at the same time...' the stray husky says as she grins at you for a minute, before dropping to all fours and burying her face in your crotch. You groan in pleasure as the slutty husky takes charge of your body and wraps her muzzle around your new cock, licking and sucking eagerly even as she rubs your balls with her paws.";
				say "     The pleasure builds quickly as her expert mouth works your shaft, and soon you are panting in pleasure as you shoot your seed into her eager mouth, her muzzle locking tight around your shaft as she suckles on it happily. All too soon your powerful orgasm is spent, and while she massages your balls for minute longer as if trying to coax every drop of male seed out of you, she soon releases your shaft and sits back on her haunches happily, licking her lips. As you recover from your orgasm, you realize your shaft almost seems to be shorter, and you shudder as your body starts to change.";
				infect "Female Husky";
				infect "Female Husky";
				increase ColleenAlpha by 1;
				now ColleenFound is 2; [husky Colleen fucked]
			else:
				say "     'Back again?' the feisty husky slut that used to be Colleen says in amusement as she looks over your eager body. 'I just knew you couldn't resist the idea of being a lovely little bitch just like us,' she says as she stalks towards you with a grin on her husky face as the smell of canine heat intensifies in the room. 'And look what I found from a mousetaur out in the city, just for you!' Colleen says with a grin, as she produces a thick pointed dildo with a large knot at the base. You find your eyes focusing on the canine cock-shaped toy even as she slowly backs you up against the wall, feeling slightly worried, but at the same time you can feel your body tensing in anticipation as she slowly lowers the dildo down to rub the tip against your damp slit. 'Doesn't that feel so good?' she whispers as she presses her softly furred body up against yours, her muzzle rubbing up against your cheek as she presses the tip of the fake cock into your body.";
				say "You find yourself nodding helplessly, as the husky bitch again brings your body to a state of needy arousal with little effort. Colleen chuckles at your quick admission of lust, as she begins to push more and more of the canine toy up into your body, licking your neck with her long tongue even as she moves the cock in and out in soft thrusts. You groan in pleasure as your female passage grips the cock eagerly, your juices running down its surface and onto Colleen's paw, and you find your hands gripping the husky bitch to you tightly, the fact that your slutty husky pet is watching your own wanton submission to a canine cock only seems to make the moment even better to your lust fogged mind.";
				WaitLineBreak;
				say "     Soon you can feel the large knot at the base of the cock pressing up against your outer lips, and Colleen lifts her head up from your neck to whisper into your ear again. 'Feel that thick knot? Doesn't it make you feel so good as it rubs up against you?' she says as she presses the cock into you even further, your lips starting to part to allow the thick bulge into you. 'Just imagine how much better it would be if it was a real cock, a real dogs knot swelling up as it pushes into your body, the warm thick cock throbbing with life as he shoves it into you with one swift push,' she whispers, as suiting actions to words she draws the cock toy back and then shoves it into you in one swift movement, the knot forcing its way into you, as your pussy closes up behind it, sealing it into you.";
				say "     The feeling makes you gasp in pleasure at being so very tightly filled and the idea of an actual living cock throbbing with warmth within you fills your mind. 'Just imagine that lovely living dog cock, its knot swelling so he can ensure none of his warm life giving seed can escape from your needy husky womb, making sure with each short swift thrust into you that you are going to carry his pups like a good little husky bitch,' she says as she moves the trapped toy within you in time to her words, making you moan as you writhe under her touch and the dirty images that her words are painting. Before you know it you are panting and shuddering in orgasm, as Colleen brings you again and again with that canine cock and her hands. Eventually she pulls the toy out of you with a sodden, popping noise, before smiling down at you where you lie slumped up against the wall in exhaustion. 'Wouldn't the life of a husky bitch just be great? Why don't you come back and talk to me about it again sometime,' she says with a chuckle as she walks off, idly licking your juices off of the canine toy as she does.";
				increase ColleenAlpha by 1;
				infect "Female Husky";
				infect "Female Husky";
				now lastfuck of Colleen is turns;
				now ColleenFound is 2; [husky Colleen fucked]
		else if SarahSlut is 4: [transformed Colleen, first time sex]
			project the Figure of Colleen_face_icon;
			say "     'Sorry but... no, I just can't lie, I want it so badly,' she says, her tongue hanging out of her mouth as she pants eagerly, before glancing at Sarah, 'Please! I just can't stop thinking about sex, and about how wonderful it would be to be just like her,' she says her changed body shuddering in desire, her tail lifting up instinctively. 'I know it will change me, and make me just another horny little husky just like your pet,' she says as she nods eagerly at Sarah. 'Just the very idea of being a horny husky bitch, spreading my legs for dogs or beasts, being mounted like an animal, maybe even bearing them puppies... God it makes me so hot,' Colleen moans as she rubs her naked fur covered body, her slit obviously wet and needy even as her soft heat scent fills the room.";
			say "     'Please, I just have one request, just one thing I want you to do for me first...' she says pleadingly as she looks up at you with her husky eyes. 'Please make me your pet too, just like you did Sarah, take me and make me yours instead of just another stray bitch in the city,' Colleen says with a blush as she reaches over into a pile of books she has been reading and pulls out a soft leather dog collar, a silver tag saying 'Bitch' in the shape of a dog bone hanging from the collar. 'I was feeling good enough to go out for a bit a little while ago... and I found one of those machines that let you make your own tag in a pet store on 7th street,' she says as she lowers her head, blushing beneath the fur of her cheeks. 'And I just couldn't resist... Please won't you keep me?' she says as she looks up at you hopefully, the little husky you brought home earlier asking if she can stay with you forever... Do you keep her?";
			if player consents:
				LineBreak;
				if player is male:
					say "     Colleen's face brightens and her husky muzzle pulls back in a happy smile as you fix the collar around her throat, settling it securely so her new nametag can shine out proudly for all to see. 'Now Colleen's name is Bitch!' the newly collared Bitch proclaims proudly as she stares up at you in adoration. 'Thank you so much for taking me in master! Bitch will work hard to be a good bitch for her master!' the formerly independent husky girl says even as she rubs herself up against your body eagerly. 'How would master like to use his new little bitch?' Your pet asks you as she looks up at you eagerly, her position in front of you giving you an idea of a better use to put her mouth to. You grin as you reach down to stroke your cock, her eyes following your every movement eagerly as your [cock of player] rod quickly grows erect at just a touch, the heat scent of a needy bitch all the encouragement it needs to rise to the occasion.";
					say "     'Why don't you worship your new master's rod,' you say with a grin. Her face lights up eagerly at your suggestion, as she eagerly crawls forward to nuzzle your cock with her soft nose, before running her tongue along it eagerly. You groan in pleasure as she begins to lick and suck on the tip of your cock, tracing her teeth along the base of your cock lightly and making you squirm and thrust forward into her mouth as she does her best to swallow your entire cock into her muzzle. Your new bitch moans around your cock, loving the taste of your thick meat, even as she applies herself to it with renewed vigor, taking to her new submissive role like she was born to it as she begs for you to fill her mouth with your seed. Soon you reward your newest pet with her treat, as your cock sends its sperm shooting deep into her mouth, while she works hard to swallow every drop. Eventually spent, you relax backwards, your newest bitch licking your cock and balls clean even as she enjoys the feel of your seed filling her stomach. You can feel a smile tugging on your face as you look down on her on all fours before you, happy to have yet another good little pet to keep you company and train.";
					now ColleenCollared is 1; [pet Colleen]
					now lastfuck of Colleen is turns;
					now ColleenFound is 2; [husky Colleen fucked]
				else:
					say "     Colleen's face brightens and her husky muzzle pulls back in a happy smile as you fix the collar around her throat, settling it securely so her new name tag can shine out proudly for all to see. 'Now Colleen's name is Bitch!' the newly collared Bitch proclaims proudly as she stares up at you in adoration. 'Thank you so much for taking me in mistress! Bitch will work hard to be a good bitch for her owner!' the formerly independent husky girl says even as she rubs herself up against your body eagerly. 'How would mistress like to use her new little bitch?' Your pet asks you as she looks up at you eagerly, her position in front of you giving you an idea of a better use to put her mouth to than talking. You lie back down on the ground, and slowly spread your legs before your newest pet, her eyes lock on your soft slit, as you whisper softly to her, 'Why don't you come have a taste of your new mistress?'";
					say "     The transformed woman's face lights up happily at your suggestion as she crawls over to you on all fours, quickly lowering her head to stick her muzzle into your damp crotch. Deciding to have some fun involving your other pet in this, you quickly gesture to Sarah to join the fun, even as Colleen runs her tongue across your soft pussy lips. The feeling makes you gasp and pet your newest bitches head in encouragement, as she begins to lick and nip at your outer lips eagerly, her tongue starting to tease its way inside your body with every pass. You groan as your new pet gasps and pushes her tongue into you even further, and you smile as you see your other pet has her own husky muzzle buried between Colleen's legs as well.";
					WaitLineBreak;
					say "     Your new bitch renews her assault on your sex even as her own is being licked and teased, the sensations making you moan in pleasure as you rock your hips upward with each probing stroke of her tongue. Your new pet's slutty husky instincts come to the fore as she whines and pants eagerly as she slurps and laps at your pussy, savoring every taste of your body, even as her own hips rock back in time with the tongue licking at her own slit. Your body can only take so much of this wanton assault before you find yourself clenching your fingers in her fur as you orgasm, holding her head down in your crotch as she tries to lick up every bit of your juices even as they coat her muzzle. Panting you can see that your newest pet has had her own orgasm as well, and your other pet is just as happily licking up the mess she made on the floor behind her. You can feel a smile tugging at your face as you look down on your two happily licking pets, glad to have such wonderful company to play with and train...";
					now ColleenCollared is 1; [pet Colleen]
					now lastfuck of Colleen is turns;
					now ColleenFound is 2; [husky Colleen fucked]
			else:
				say "     'You don't want to keep me?' she says as her ears and tail droop slightly, 'You just want to use me and fuck me like a bitch whenever you want, and let me roam the city like a stray animal, spreading my legs for whatever beast I can find?' Colleen moans as her tail lifts up again in excitement, her damp sex growing even damper as she realizes that she will be a stray bitch. 'That sounds so good too,' Colleen says with a moan as she rubs herself, obviously giving in to the infection mentally, and embracing her new role. 'I can't wait to start,' she pants out, and you can see her body shifting slightly as the changes accelerate, her hands shifting into a more paw-like form as her legs shift to better support the new bitch in the all fours stance you are sure she will be assuming regularly from now on.";
				say "     'Don't worry though, I'll still come back here so you can use your stray bitch whenever you want,' she says as she pants eagerly at you, 'I mean the least I can do for you for helping me become such a wonderful slutty bitch, is let you play with me whenever you want to...' Colleen says as she gives you an eager canine smile, 'And speaking of playing, didn't you want to play with me just a second ago...' she says suggestively, her eyes locked on your crotch.";
				WaitLineBreak;
				if player is male:
					say "     Before you can respond, the new bitch has dropped to all fours, and has turned her rear to you, her tail lifting up eagerly in an unspoken invitation as she looks back at you over her shoulder. 'Why don't you come play hide the bone, with a bitch...' she says as her she wiggles her rear at you, her damp lips winking at you as the scent of a bitch in need fills the air. The invitation is just to perfect to decline, your rod stiffening eagerly as you move over to her needy body, and you rub the tip of your cock up against her heat swollen lips, making her moan. Her animalistic posture, and her acceptance of the bestial changes within, make you feel almost like an animal yourself as you sheathe your [cock of player] cock in her warm silken passage, Colleen yipping and whining in pleasure underneath you.";
					say "     You grip her hips tightly as she lifts her rear up even higher to allow you better access to her body, her tail brushing across your chest as it wags eagerly, even as her body shifts to become a full husky bitch underneath you, nearly indistinguishable from all the other slutty little huskies roaming the city. The pleasure of the rough sex fills your mind as you take her from behind like an animal, thrusting into her again and again as she yips and pants underneath you, her every sound proof of your victory over her body and mind as she embraces her new role as a husky slut. Soon your eyes close and your head swims with pleasure as you shoot your seed into her waiting body, making her howl in pleasure underneath you as you fill her womb up with your fertile sperm.";
					WaitLineBreak;
					say "     Panting from the exertion, you slowly release the new husky slut as you pull yourself out of her, and she twists around to lick at her well used passage with her long canine tongue. You sit down to rest for a minute while she cleans herself up, before she turns to you and wags her tail happily. 'Thanks so much! I hope we can do this again lots!' she says with a happy look on her lust filled canine face. 'Now I'm going to go see what other kinds of fun I can find in the city! Don't worry though! I won't be far from here and your wonderful cock for long!' she says as she wanders out the bunker door, her tail wagging happily as she goes to explore, although you know that she will always end up back here whenever you return to the bunker, her needy cunt leading her right back to where your cock filled her up for the first time...'";
					now ColleenSlut is 1; [stray Colleen, fucked by the player]
					if Sandra is in Bunker, now lust of Sandra is turns - 4;
					now ColleenFound is 2; [husky Colleen fucked]
					now lastfuck of Colleen is turns;
				else:
					say "     Not waiting for a response, the stray bitch quickly buries her muzzle in your crotch, nipping and lapping eagerly at your damp passage, making you moan in pleasure at her rapid assault. After a second you push the horny bitch back slightly while you gasp and try to collect your thoughts. 'You taste so wet and needy already,' Colleen says as she licks her lips, obviously savoring the taste of your arousal. 'Are you sure you don't want to be a husky bitch yourself? A nice little slutty bitch for all the male dogs to fuck?' she says as she moves close to you again, rubbing her soft husky fur up against your [skin of player] skin as she rubs her newly formed paw up against your damp crotch making you gasp.";
					say "     'It's the most wonderful feeling to just give in and embrace life as a bitch,' she says as she whispers softly into your ear even as she presses herself up against your horny body. 'Trust me I should know how much fun it is to just let it all go.' Before you can respond to that she has locked her new muzzle over your mouth and is kissing you soundly, her canine tongue teasing your own even as she presses you back into the side of the bunker. Out of the corner of your eye you can see Sarah watching this new development with interest, as Colleen rubs herself up against you in lusty need. You try to take control of the situation briefly, but find that you can't help but moan helplessly, your resistance melting under the military husky's soft touches, and you find yourself clutching her even tighter to you instead of pushing her away.";
					WaitLineBreak;
					say "     Colleen's paws roam your body, massaging and tweaking your nipples pleasantly, before dropping down to rub and tease at your increasingly damp slit. Soon your heavily aroused body is shuddering in orgasm under her hands, as your world explodes in pleasure. Breaking the deep kiss at last, Colleen puts her husky muzzle right next to your ear and whispers 'See how much the idea of being a husky slut turns you on already? Why don't you just admit to yourself how much you want to be just like me and your pet over there?' she asks you quietly, her paws still roaming your sensitive body as she waits for your response.";
					if player consents:
						LineBreak;
						say "     Unable to resist the images the strong husky bitch in front of you is evoking, you find yourself nodding eagerly even as you hold Colleen tight. 'See, that wasn't so hard to admit, now was it?' the sexy husky whispers into your ear, making you smile even as you nod in agreement, the heat-filled scent of two other husky bitches making it seem so very easy to admit how much you want to be happy and slutty like them. 'I knew you would see it my way,' Colleen says with a grin. 'And helping you admit what you really wanted is the least I can do for you after you brought me here and helped me realize how much I really wanted to be a slutty little bitch deep down inside,' the new bitch says as she runs her paws over her own new body. 'Now I think I need to go try this new body out some more in the city,' she says as she turns to the bunker entrance eagerly. 'But don't worry! I'll be here to help you out as much as you helped me out whenever you are ready!' she calls back as she heads outside, her tail wagging eagerly, giving you a good view of her wet husky slit as she vanishes into the streets.";
						infect "Female Husky";
						increase ColleenAlpha by 1;
						if Sandra is in Bunker, now lust of Sandra is turns + 4;
						now SarahSlut is 5;
						now lastfuck of Colleen is turns;
					else:
						LineBreak;
						say "     You manage to shake your head, trying to fight off the images of lusty husky bitchdom that Colleen's words are creating. 'That's too bad,' the new slutty stray bitch says as she stares at you for a moment. 'After you helped me realize how good it feels to be a husky bitch, I just wanted to help you realize how good it was as well,' she says with a soft smile as she runs her paws over her new canine body. 'But now I think I need to go try this new body out some more in the city,' she says as she turns to the bunker entrance eagerly. 'But don't worry! I'll be sure to come back here often to tell you all about how much fun I am having being a husky bitch, and play with you any time you want!' she calls back over her shoulder as she heads outside, her tail wagging eagerly giving you a good view of her wet husky slit as she vanishes into the streets.";
						infect "Female Husky";
						now lastfuck of Colleen is turns;
						increase ColleenSlut by 1;
						if Sandra is in Bunker, now lust of Sandra is turns - 4;
						now ColleenFound is 2; [husky Colleen fucked]
		else if SarahSlut is 3:
			project the Figure of Colleen_face_icon;
			if ColleenSpray is 99:
				say "     'Sorry, I know we had lots of fun before, but I don't think that'd be a very good idea anymore. I've tried to use my spray to change back, but it doesn't seem to last anymore. I... I used it all up trying to clear up this husky thing I've picked up from Sarah, but it just reappears after a little while. If we go at it again, I might end up another slutty husky bitch.' She tries to stay calm, but she's clearly upset that she's going to be stuck like this. Though her tail wags happily at the mention of becoming a bitch, so it seems her body's interested even if her mind's not accepted it yet.";
				now ColleenSpray is 100;
			else:
				say "     'Sorry, but lovely delicious bestial fucking seems to be how you lose yourself,' Colleen says, even as she pants slightly at the very idea, 'And I don't think I am ready to just give up and give in to infection, becoming just another happily fucked beast spreading her legs for any male that wants her, and being their happy little pet,' she says with a moan as she rubs herself, obviously extremely turned on by the very idea. 'No,' she says in a soft low voice, her eyes locked on Sarah, 'I don't think I am ready for that... Yet...' she pants out, her voice trailing off as she rubs her new fur in consideration.";
		else if SarahSlut is 1 or SarahSlut is 2:
			if ColleenSpray is 99:
				say "     'Sorry, I know we had lots of fun before, but I don't think that'd be a very good idea anymore. I've tried to use my spray to change back, but it doesn't seem to last anymore. I... I used it all up trying to clear up this husky thing I've picked up from Sarah, but it just reappears after a little while. If we go at it again, I might end up another slutty husky bitch.' She tries to stay calm, but she's clearly upset that she's going to be stuck like this. Though her tail wags happily at the mention of becoming a bitch, so it seems her body's interested even if her mind's not accepted it yet.";
				now ColleenSpray is 100;
			else:
				say "     'Sorry, but unlike her,' Colleen says with a nod at the naked Sarah, 'I am still trying to keep myself nice and human, and if we ended up fucking, I think it would only make it harder for me to remember that I am not a slutty little bitch,' she says as she watches Sarah cautiously, although you notice her tail seems to be wagging invitingly, so her body is interested at least regardless of what her mind is saying.";
		else if SarahCured is 1 or SarahSlut is 0:
			if ColleenSpray is 0:
				say "[FirstColleenSpraySex]";
			else if ColleenSpray is 99:
				say "[ColleenSpraySex]";
			else:
				say "     'Sorry, but I'm trying to hold on to my humanity as best as I can,' Colleen says with a nod at the barely clothed Sarah, 'Sex seems to the main vector of infection spread and it advances the infection's hold on someone's mind. That's exactly what we don't need right now.";
		else if SarahCured > 1:
			if ColleenSpray is 0:
				say "[FirstColleenSpraySex]";
			else if ColleenSpray is 99:
				say "[ColleenSpraySex]";
			else:
				say "     'Sorry, but I'm trying to hold on to my humanity as best as I can,' Colleen says with a nod at Sarah, 'I've seen what she went through just to regain her regular self and... it was a close thing. By a hair's breath. That's something I don't want to risk for myself.'";
	else if ColleenSpray is 0:
		say "[FirstColleenSpraySex]";
	else if ColleenSpray is 99:
		say "[ColleenSpraySex]";
	else:
		say "'Sorry, but that seems to be how the infection spreads the fastest. While I know I probably won't get out of this place without some changes, I think I'd like to try to keep them to a minimum,' Colleen says with a wry shrug.";

to say FirstColleenSpraySex:
	say "     'Sorry, but that seems to be how the infection spreads the fastest. And while I know I probably won't get out of this place without some changes, I think I'd like to try to keep them to a minimum,' Colleen says with a wry shrug.";
	say "     Shall you suggest she use her spray to allow her to have sex instead of saving it for an emergency?";
	if player consents:
		now ColleenSpray is 99;
		say "     Not wanting to give up so easily, you tell her that you don't usually cause people to change, especially when they're not already changing on their own. She seems skeptical of your claims, so you play your final card, reminding her of the restorative spray. You suggest that if she used a bit of it each time after sex, she'd be able to stop any changes before they start to show up. You even add that she'll certainly be safe from getting infected by creatures in here, so there's no need to save it for that when it could be put to much better use.";
		say "     Clearly tempted by the prospect of sex, the idea gives her pause. Moving in closer, you run your hands lightly along her sides and back, caressing her tantalizingly while continuing to reassure her. Before she realizes it, you're slipping off her jacket and moving a hand under her shirt to caress her bare back. Her unchanged skin is soft and smooth, a pleasant change from the scales and fur of many of the beasts of the city. Guiding her forward, you pull her into a kiss with one hand and start to remove her pants with the other. Soon you have her quite nude and laying upon her cot, ready to be made love to. Caught up in the excitement and with the spray to allay any concerns, she welcomes you into her arms.";
		WaitLineBreak;
		if player is male:
			say "[Colleen_pretfsex01]";
		else:
			say "[Colleen_pretfsex02]";
		now lastfuck of Colleen is turns;

to say ColleenSpraySex:
	say "     Wanting another go at the human soldier, you approach her with an offer for sex. She seems a little cautious as first, so you remind her that she can use the anything unwanted should start to come up. What little reluctance she has fades as you run a hand along her side and whisper that it'll all turn out fine as you nibble her ear. Soon you've got her naked again and on her cot in preparation of some fun.";
	if player is male:
		say "[Colleen_pretfsex01]";
	else:
		say "[Colleen_pretfsex02]";
	if player is purehuman:
		if ( cocks of player + cunts of player > 1 ) or breasts of player > 2 or breast size of player > 6 or cock length of player > 9 or cock width of player > 9 or cunt length of player > 11 or cunt width of player > 9:
			say "     'I know you still look human, but you've clearly been sexually altered. [one of]Best not to take any chances[or]Better safe than sorry[or]Can't be too careful[at random],' she adds.";
		else:
			say "     'I know you still look human, but [one of]it's best not to take any chances[or]better safe than sorry[or]one can't be too careful[at random],' she says.";
	now lastfuck of Colleen is turns;

to say Colleen_pretfsex01:
	say "     Atop her now, you guide your [cock size desc of player] cock into position. Lining up your [cock of player] meat with her pussy, you [if cock length of player < 10]thrust into her, inciting a moan of delight from the soldier[else if cock length of player < 20]push into her, inciting a whimpering moan of pleasure from the soldier[else]push into her slowly, inciting a gasp as your oversized manhood stretches the soldier unnaturally open[end if][if cock length of player >= 10]. Despite the increased size of your shaft, her cunt is made to stretch around it, showing she's not wholly unaffected despite still being purely human[end if][if player is purehuman]. Her hands run across your still-human body, clearly pleased to have found a lover who still seems fairly normal[else]. Her human hands run across your [bodydesc of player] body, intrigued by your altered features and doesn't shy away from touching them now that she's allowing herself to indulge herself[end if].";
	say "     You keep your pace steady as you fuck you human lover, enjoying the soft cries of pleasure she gives. But Colleen is no passive lover, soon ending up with her legs wrapped around your waist, her arms around your shoulders and her lips locked to yours. The sex is raw, straightforward and strong, much like the soldier you're fucking. With such a passionate lover, it is no surprise when it comes to an end with mutual cries of orgasmic release. You blast your [cum load size of player] load into her pussy, flooding her womb with your semen[if cock width of player > 30] to the point the woman's belly is stretched and bloated[else if cock width of player > 20] to the point the woman's belly has a visible bulge from it[end if]. Sated, the female soldier releases you and flops back onto her bunk with a loud sigh of satisfaction. She reaches over to her nearby pack, slips out her spray and uses a bit on herself as a preventative measure.";

to say Colleen_pretfsex02:
	say "     Atop her now, you move a hand between her thighs to caress across her mons and then to delve into her pussy. This incites a moan of pleasure from the soldier and she grabs your ass firmly with one hand and places the other on your [if breast size of player > 0][breast size desc of player] tit[else]side[end if][if player is purehuman]. Her hands run across your still-human body, clearly pleased to have found a lover who still seems fairly normal[else]. Her human hands run across your [bodydesc of player] body, intrigued by your altered features and doesn't shy away from touching them now that she's allowing herself to indulge herself[end if].";
	say "     In time, her hand slips to your cunny and she starts caressing your pussy and clit in return. For a while, you both play with one another's pussies and alternate between kissing one another and [if breast size of player > 0]sucking on each other's nipples[else]you sucking on her nipples while she moans for more[end if]. The soldier's touch is surprisingly soft and delicate, working to bring pleasure to your sensitive, needy pussy and aching clit. Your hips quiver and your juices flow freely as she excites you more and more with her sensual fingering.";
	say "     After several minutes of this, Colleen gets a hungry look in her eye and rolls you over onto her back with a grin. Turning around atop you, she buries her face between your legs and presses her juicy, dripping cunt to your lips. She dives right in to licking your cunny. She shows considerable skill at this, using her tongue artfully and eagerly to eat you out, the soldier clearly having done this before. You lick her in return, working a finger into her cunt while you suck at her clit. With all your earlier foreplay, it's not long before you're both crying out in orgasm even as you try to lap up the other's feminine juices. You lap up the human woman's juices, loving the taste of them across your tongue. Eventually, when both sated, Colleen releases you by rolling over onto her back once again with a loud sigh of satisfaction. She reaches over to her nearby pack, slips out her spray and uses a bit on herself as a preventative measure.";

Section 6 - Endings

when play ends:
	if bodyname of player is "Female Husky":
		if ColleenAlpha > 2:
			project the Figure of Colleen_face_icon;
			if humanity of player < 10:
				if player is male:
					say "     Finally surrendering to the infection, and the joy of being a husky, you swiftly return to the bunker to join your pet bitch in celebrating your new found freedom as a husky stud. You are surprised to find that a small pack of huskies is waiting for you on your return instead of just your pet, and you almost immediately recognize the alpha leader of the pack as the changed Colleen, now fully embracing her role as head bitch. Spotting you the pack immediately surrounds you, and Colleen pads up to you with a smile on her husky face, 'I can see that the bitch treatment didn't work properly on you,' she says with a sad shake of her canine head, 'Lucky for you though, we have a lot of other horny bitches here that it did work on... I'd like to introduce you to my military squad-mates,' she says as she gestures with her paw at the husky bitches surrounding you.";
					say "     'They took a bit of work to find scattered out in the city, and a bit more work to make sure they ended up as proper husky bitches like me, but it was worth it,' the alpha bitch says as she smiles at her new pack-members, before looking back at you. 'I look forward to letting you get to know them all properly,' she says as she reaches down with her paw and strokes your cock a few times, making you whine in need. 'But alphas first, after all,' Colleen says as she turns and presents her damp sex to you, the smell of her heat filling your nose. You find yourself mounting your alpha instinctively, eager to give her the pups she obviously wants from you, your mind filling with a sea of pleasure and a sense of belonging as you take the first steps in joining the pack as its slutty male husky stud. Out of the corner of your eye you notice your slutty husky pet has joined the pack as well, and is now just as much the pack's pet as you are...";
				else:
					say "     Finally surrendering to the infection, and the joy of being a husky, you swiftly return to the bunker to join your pet bitch in celebrating your new found freedom as a husky bitch. You are surprised to find that a small pack of huskies is waiting for you on your return instead of just your pet, and you almost immediately recognize the alpha leader of the pack as the changed Colleen, now fully embracing her role as head bitch. Spotting you the pack immediately surrounds you, and Colleen pads up to you with a smile on her husky face, 'I can see that the bitch look finally suits you inside and out,' she says in amusement as you lower your head instinctively to the rightful alpha.";
					say "     'You aren't the only one who learned to embrace being a husky bitch either,' she says as she gestures with her paw at the husky bitches surrounding you, 'They took a bit of work to find scattered as they were throughout in the city, and a bit more work to make sure they ended up as slutty little husky bitches like us, but it was worth it. My whole military squad back together at last,' the alpha bitch says as she smiles happily at her new pack-members, before looking back at you. 'I look forward to letting you get to know them all of them properly, but first we need to deal with your proper addition to the pack,' Colleen says with a gleam in her eye that makes your body clench as need surges through it. 'We have something special in mind for you actually,' she says as she gestures to your well trained husky pet, who is now panting subserviently as she joins the pack.";
					say "     'Since you went to such effort to train such a nice pretty pet for the pack, I figure what you must really have wanted was to be trained like a good little bitch yourself,' she says with a husky grin as she turns back to you, pulling out the collar you decided not to put on her such a short time ago, its silver tag declaring the wearer to be 'Bitch' flashes in the light as you stare at it eagerly. 'I can smell how much the idea turns you on already,' the alpha bitch says as she sniffs the air, and you realize that the very idea of being trained as a proper bitch is making your body hot with need as your sex dampens even as she steps forward and slips the collar around your neck. 'Don't worry, we won't waste any time in finding beasts around the city to help us train you properly, and before you know it you will be just as much of a slutty pet to the pack as you could have ever wanted!' the alpha says lustily as images of being fucked by beasts of all kinds run through your head, imagining their seed filling your needy, heat-filled womb. You realize that you don't even care what kind of beasts your alpha finds for you, happy to fuck any cock your alpha brings you so you can prove to the pack what a good little submissive fuckpet you are. Who knows, you think as the pack closes in around you, maybe your alpha will eventually decide to breed you so you can bear more little sexy slutpets for the pack!";
			else:
				if player is male:
					say "     Rescued by the military, they take Colleen, Sarah and you back to civilization, without ever realizing that the powerful naked husky with you was once one of their own soldiers. Knowing the system the way she does, Colleen is soon able to arrange it so you are all released back into society with only minimal examination, and as you go about setting up your new life she quickly moves in with you and your slutty pet even without you asking. You find yourself unable to argue with her strong dominant tendencies, and soon find yourself and your pet obeying most of her commands without question, as she proceeds to arrange your lives and schedules for you. Soon enough the two of you are functioning like a pair of properly trained dogs as you snap to obey your lovely alpha's commands, happy to be rewarded by soft pets and touches when you do a good job. The best reward of all though is when your needy alpha takes you to her bed in the evenings to satisfy her lovely husky body, though other nights she likes to just sit and watch as you fill her other pet up with your husky seed. Soon both of their bellies are swelling large with pups, and you can't help but feel proud of yourself as you see them grow large with your offspring. You may not be the alpha in the pack, but you can look forward to lots of happy little puppies of your own soon enough.";
				else:
					say "     Rescued by the military, they take you and Colleen and Sarah with you back to civilization, the military not even realizing that the powerful naked husky with you was once one of their own soldiers. Knowing the system the way she does, Colleen is soon able to arrange it so you are all released back into society with only minimal examination, and as you go about setting up your new life she quickly moves in with you and your slutty pet even without you asking. You find yourself unable to argue with her strong dominant tendencies, and soon find yourself and your pet obeying most of her commands without question, as she proceeds to arrange your lives and schedules for you. Soon enough the two of you are functioning like a pair of properly trained dogs as you snap to obey your lovely alphas commands, happy to be rewarded by soft pets and touches when you do a good job. Sometimes your new alpha takes her small pack of huskies out on the town to see what fun you can all find together as you hit the bars and nightclubs, you find yourself happy and content with your new life, although your alpha has had a gleam in her eye lately as she mentions the possibility of finding a nice stud to have the two of you bred with...";
		else if Alphahuskypet > 3:
			project the Figure of Colleen_face_icon;
			if player is female:
				if humanity of player < 10:
					say "     Succumbing to your powerful submissive urges, you run off into the city to find your alpha, needing his masterful touch to be complete and finish changing you into a proper bitch. Soon you find yourself following his scent to where several other husky bitches have gathered, and you join them in panting eagerly as the alpha looks you over before leading you off to hunt through the city with him. The exhilarating feeling of being part of something larger and more powerful than yourself fills you as you lope through the empty city streets, chasing off the competition and enjoying the time to play and bond as a pack, your body shifting to match theirs fully as the night goes on and you become just another full husky bitch. Eventually your new pack leads you back to their den, where several of the more pregnant huskies are resting, and your body shudders as your handsome alpha stalks up behind you as you look at the pregnant bitches.";
					say "     He nibbles at your ear teasingly as his paws roam over your body, and you shudder as he whispers that he caught you eying the breeding huskies, and noting how happy they seemed, and he thought he would show you what it's like to be nice and round and full of his pups. You groan eagerly, your body unable to resist his sensual touch as he begins to mount you like a proper bitch, several other members of the pack watching and cheering you on enthusiastically as they begin to play with each other. Looking around you find yourself panting happily as your lovely alpha fills you up with his seed again and again, and starts you on your way to being just another happy little breeding husky in his pack, and you realize you have finally found the perfect place to belong... as just another submissive husky slut, breeding more and more pups for your handsome alpha...";
				else:
					say "     While you come to eventually enjoy life outside the city and eventually do encounter another nice canine mate, you find your thoughts drifting back with increasing regularity to the powerful male husky from the city, and wondering what your life would be like if you had stayed and found your place in a pack full of slutty huskies just like yourself...";
			else:
				say "     You wonder sometimes about the other husky male you ran into at one point, and find yourself strangely disappointed at how unsuited your new body is for joining their pack, neither strong and alpha like, nor nice and female for them to fuck, you somehow can't help but feel like something of a failure...";

When play ends:
	if bodyname of player is "Alpha Husky" and ( Colleen is bunkered or Sarah is bunkered ):	[***This is an imperfect solution]
		if ColleenSlut is 1:
			project the Figure of Colleen_face_icon;
			if humanity of player < 10:
				say "     When you finally surrender to the infection, Colleen happily joins you and Sarah as you roam the city as a pack seeking your destiny, and while she may not be as close to you as your first and most important pet, she tries so hard to be a good little pet for you as well. Eventually the needy little husky bitch manages to persuade you to take her in and make her yours on a more permanent basis, joining your small pack as just another husky bitch ready and eager to serve your every whim, as you wander the city looking for more humans to make into nice little husky sluts just like your other pets...";
			else:
				say "     When the military comes, and Colleen realizes rescue is here, she panics and runs off into the city, unable to abandon her new sluttish life as a roaming husky slut. And while you go with the rescue squad you still wonder about the fate of the lusty little husky stray you had such fun reducing the former military woman into. You hear back occasionally from several of the people who go into the city to try to look for friends, family, or just thrills, about how many of them have been approached by a strange lonely husky woman with a collar in her mouth and a begging look. And find yourself hoping that someday the little stray will find herself a proper husky pack to use and take care of her like the one you have made out here with your slutty little Sarah and several other people you have helped to embrace their inner husky slut. Eventually you decide to help the little husky slut out, and you grin as you begin to train several new pets to take on a specific job for you, sending your newly made huskies into the city to find the obviously lonely Colleen, and bring her back to you, where you can find her a proper home and owner. Or maybe even a nice place by your fire with all your other husky pets if she still wants...";
		else if ColleenCollared is 1:
			project the Figure of Colleen_face_icon;
			if humanity of player < 10:
				say "     Colleen eagerly joins you and Sarah as you form your new pack and head out into the city to find even more pack members, her military experience standing you in good stead as she helps you track down the rest of her former squad mates. Soon she is enthusiastically welcoming several of her former military friends into the pack, the three of you easily able to overcome whatever other changes they have gained from their time in the city, and you smile as your pack of huskies grows larger and more powerful with each addition. Your pets help you to train your new pack mates as proper little slutty huskies just like them, and before long you are leading one of the most powerful packs of dogs in the city, all of them properly subservient to their alpha.";
				say "     Soon you find your eyes drifting to the military encampment and their roving patrols, your arousal spiking at the thought of all the people outside the blockade who would be happier as lusty little sluts with you to do their thinking for them. Picking your moment, you wait with your pack until they spot someone they vaguely recognize from their military careers, and using that you have them call out to them and convince them of who they are... at which point when they approach they are easy to lure off and convert. Repeating this process several times, finally gets you a new husky who knows a way through the camp and to the outside world, and as you lead your pack through the path and see the road open up ahead of you as you leave the city behind, you can't help but pant and grin happily as you look forward to showing more and more people the joys of being a husky...";
			else:
				say "     When rescued by the military, having Colleen as a pet stood you in good stead, as she knew just the best way to make sure they let you all go easily. She seems slightly sad when you leave the military base and the remnants of her old life, but is very happy to be a nice pet for you just like Sarah is. And you enjoy having her as a member of your small but satisfying pack of huskies, having two lusty little husky sluts around the house making you even happier than you thought you could be, even though it is a bit much to keep up with sometimes. Soon Colleen helps you come up with a great idea to make sure everyone is properly happy and taken care of, and after a bit of time to train her properly and prepare her, you call up one of the more important military men that Colleen used to know, and he seems curious enough to come over for dinner one night. You make sure to make it a night to remember, as you offer your guest every courtesy in a house full of huskies, including the use of your teasing little husky pet, which after several hours of her heat-filled scent teasing him, he decides to accept.";
				say "     The general is surprised to discover after a very long night filled with amazing sex, that the husky pet you lent him actually used to be the soldier he knew as Colleen, and moreover that she was happy and excited to be a little husky slut pet. You spend some time explaining to him how much happier she is like this and how she wanted to share that feeling with him, especially if that means she can help you in any way. He is very surprised at the situation and even more surprised when you offer to have him and as many of his other 'select' friends over as often as they want to visit, to enjoy your slutty little pack-mates. And while slightly reluctant at first, he soon agrees when you invite him or his friends to bring their own ladies over, and they can watch while you teach them to be just as happy and proper pets for them mates as your little pets are for you.";
				say "     You aren't surprised when he visits again soon, becoming a rather regular guest at your house, often with several other important people in tow, and while most of them are more than happy to be persuaded by your dominant attitude and the lusty scent of sex your pets always exude. On occasion you find one protesting enough that you need to train them personally and show them just how wonderful it is to be a slutty little husky spreading her legs for her alpha or anyone else the alpha wants. On the whole, you soon build up a rather large group of people who owe you favors, and enjoy their new pets as well as their visits to your own well trained pack immensely, these contacts enabling you and your fellow huskies to live nice and comfortable new lives, and even prepare for all the pups that are sure to follow any day now...";
		else if ColleenAlpha > 2:
			project the Figure of Colleen_face_icon;
			if humanity of player < 10:
				if player is male:
					say "     Your mind fills with joy as you finally fully embrace the changes in your body and mind, and rush back to the bunker where you can show your fellow huskies just what a good alpha you can be for them. You are surprised to find a small pack of huskies has already formed outside the bunker where they are obviously waiting for you, you growl instinctively as you see that this strange pack has already found your pet Sarah, and she wags her tail at you happily from where she sits surrounded by unfamiliar husky bitches. Before you can protest, the head bitch of this pack strides forward, and with some surprise, you recognize the other alpha as Colleen, the military woman you helped to embrace her inner bitch. 'Welcome back,' Colleen says teasingly, as her pack closes around her, 'My you make a much more dominant husky than I would have thought,' she says with obvious approval as she stalks forward, and you find yourself grinning as you look her over as well, something about her dominant stance and her teasing walk intriguing you as you look over her own slightly more powerful alpha-like body.";
					say "     'Do you like my new pack? I was going to try to add you to them as a slutty little bitch, but I think I kind of like the look you have going for you right now,' Colleen says with amusement as she gestures at the pack of huskies slowly circling the two of you, their noses twitching and their bodies growing warm with arousal as they catch hints of your dominant male husky scent. 'I think I could grow to really like the new you,' she says as she moves closer, rubbing her own strong body against your side teasingly and grinning as your cock grows hard in response. 'You make a pretty hot looking alpha male, and I could use a bit of help keeping everyone in line and well bred. It took some doing to find my squad scattered around the city... but they will make a good submissive pack for us I think... and then we can all be together...' Colleen pants out eagerly, obviously excited by the thought, and as your cock goes stiff, you realize you find the thought nice and exciting as well, a ready made pack with a hot and sexy alpha bitch just waiting for you to fuck her and make her your mate.";
					say "     Looking around at all the other former soldiers, you feel a grin cross your muzzle at the thought of training them to be as properly needy and slutty as your pet Sarah is, a pack full of submissive bitches willing to do anything to please their alpha. You find your gaze drawn back to where Colleen is eyeing you teasingly, and realize you couldn't ask for more, as you look at the teasing alpha bitch who is obviously eager to play, and put up a bit of a fight before finally letting you mount her and fill her up with your pups, a lovely bit of challenge and fun to go with all the sexual pleasure that will fill your life as alpha. You grin at your new partner, and she shudders eagerly at your bodies nonverbal answer, as you begin to circle and tease her, beginning the dance of an alpha dog claiming his mate, as the rest of the pack watches on eagerly...";
				else:
					say "     Your mind fills with joy as you finally fully embrace the changes in your body and mind, and rush back to the bunker where you can show your fellow huskies just what a good alpha you can be for them. You are surprised to find a small pack of huskies has already formed outside the bunker where they are obviously waiting for you, you growl instinctively as you see that this strange pack has already found your pet Sarah, and she wags her tail at you happily from where she sits surrounded by unfamiliar husky bitches. Before you can protest, the head bitch of this pack strides forward, and with some surprise, you recognize the other alpha as Colleen, the military woman you helped to embrace her inner bitch. 'Welcome back,' Colleen says teasingly, as her pack closes around her, 'I see your outside matches your inside perfectly now, you look like a real bitch,' she says with some amusement as she stalks forward, and you dance back on your canine paws as you watch her pack spread out to the sides.";
					say "     'Like my new pack? I made it myself,' she says with amusement as she gestures with her paw at the husky bitches surrounding you. 'They took a bit of work to find scattered as they were throughout in the city, and a bit more work to make sure they ended up as slutty little husky bitches like us, but it was worth it,' Colleen says with a husky grin as she continues to move forward, driving you back step by step as you try to keep an eye on all the huskies arrayed against you as well as their equally intimidating alpha. 'I'd love you to meet the rest of my airborne assault squad, each and every one of them much happier now as slutty little huskies like your pet here, and like you were supposed to be...' she says with an upset sigh as she glares at your dominant form, and you glare back, your hackles rising as she tries to intimidate you into submission. 'I had plans for a submissive little pet like you in the pack, nice fun plans I was sure you would enjoy... but now there is a problem, there can only be one alpha bitch in a pack after all...' she says with a canine chuckle as she glares at you, the tension in the air rising as you glare back, unable to bring yourself to submit to her dominance as you glance around the pack looking for any signs of weakness.";
					say "     'That's enough,' Colleen says with a sigh, waving her paw and breaking the staring contest as she calls her pack back to her side. 'Since I suppose I do owe you a little something for showing me how good life can be like this...' the husky bitch says with a canine grin as she strokes her paw down the soft fur of her side. 'I'll let you go this time, I'll even let you take your other little pet with you, since you went to all the work to train her properly... But if we run into each other again and you don't have a pack to back you up...' Colleen grins as she snaps her muzzle at you teasingly. 'I suppose we will find out who the real alpha is once and for all...' With those last teasing words, Colleen gathers up her pack and lopes off into the city, leaving you feeling slightly relieved as your pet presses up against your side lovingly. Petting Sarah on the head absently, you gather up your sexy pet and head out into the city yourself, already looking forward to finding some soldiers of your own, and building a pack to rival Colleen's as soon as possible... you are already looking forward to training them to be nice and proper pets like Sarah even as you approach the edges of the city and the two of you begin to work on enlarging your pack of sexy slutty huskies...";
			else:			[***]
				say "     When the rescue comes, you lead the military back to the bunker where Colleen and Sarah were staying, only to be surprised to find it empty, your sensitive canine nose telling you that you just missed another pack of huskies visiting the area, and it looks like Colleen was leading them! You sigh as you realize the somewhat alpha-like military husky led them off to some other location in the city she must have found while she was exploring and obviously putting a pack together. The military aren't able to search, considering how pressed they are by all the other infected trying to capture and convert them, and you are forced to abandon your pet and return to their camp with them. In camp your canine looks stand you in good stead, and they ask few questions about your infectiousness at all before releasing you back into normal society.";
				say "     [one of]You wander aimlessly for a while, unable to settle for a subservient position now that you have embraced your dominant instincts, and soon your sexual appetite leads you to interact with some rather shady people. Interestingly enough, this leads you to discover your new calling, as you help your new friends to train several people from the city, and even some perfectly normal women, to be lusty little sexpets for them and their clients. You even change several of them into slutty little huskies, happy to serve any clients needs at any time. While the pay is nice, you take more pleasure in the training, enjoying reducing the formerly independent women to slutty little pets, and you even keep a few of your favorites as the start of your new pack, and you wonder idly sometimes if Colleen is having just as much fun back in the city...[or]You wander aimlessly for a while, eventually settling in to a series of different jobs at several different bars and stores in the area. One thing that stands you in good stead in your new life however, is your sexual prowess and attractive husky body, making it easy enough to convince people to 'follow you home,' and 'play with the husky'. In a nice intimate manner, of course once they are nice and worked up, it is easy enough for you to train them to be proper slutty little huskies for your pleasure. Their bodies and minds easily molded into proper pets for your amusement and sexual enjoyment, soon you have quite a pack built up around you, and have to move to a new area with your pack to start again once some of the locals get suspicious of your increasing numbers. As time goes on and your pack grows more numerous and powerful, you are able to focus more and more on the important things, like ensuring they are all nice and well bred, with their bellies round and full of your puppies at all times. And while none of them are ever quite as much fun as your first pet Sarah was, they are more than happy to serve your every whim, and soon once a few more litters are born, you can begin to spread through your new city until everyone can understand the joy of being a lusty submissive husky slut... just like all your other pets.[at random]";
		else:
			if humanity of player < 10:
				say "     Once you have gathered Sarah up from the bunker where you left her, you head out in the city with your little husky pet to find more people to add to your small pack. Soon your pack is growing greatly as you pick off individual soldiers together, tempting them into following you or Sarah away from their companions, where you can train them to be properly responsive husky bitches, your experience in helping Sarah embrace her husky instincts serving you well as you train soldier after soldier to be proper pack members... And soon you have plans for spreading out and finding other cities once you have slipped past the military cordon... where your pack can slip in and show them just how much fun it is to play with mans best friend... before they become huskies themselves...";
			else:
				say "     After getting you and Sarah out of the city, you enjoy being the alpha of your small pack, especially once you add the normal husky dog to your group. And while at it can be hard to make ends meet and support your pack properly at first, your dominant attitude soon has you landing better and better jobs, until eventually you are well situated to support the entire pack. Once that happens you find yourself eyeing your co workers speculatively, wondering just how much better they would look as properly trained husky sluts themselves, after all, now seems like it might be a good time to start expanding the pack again...";
	else if ColleenSlut is 1:
		project the Figure of Colleen_face_icon;
		if humanity of player < 10:
			say "     When you finally surrender to the infection, Colleen happily joins you and Sarah as you roam the city seeking your destiny, while she may not be as close to you as your first and most important pet, she tries hard to be a good little pet for you as well for a time. Eventually the needy little husky bitch manages to persuade you to take her in and make her yours on a more permanent basis, as she happily becomes just another submissive pet for your pleasures...";
		else:
			say "     When the military comes, and Colleen realizes rescue is here, she panics and runs off into the city, unable to abandon her new sluttish life as a roaming husky slut. And while you go with the rescue squad you still wonder about the fate of the lusty little husky stray you had such fun reducing the former military woman into. You hear back occasionally from several of the people who go into the city to try to look for friends, family, or just thrills, about how many of them have been approached by a strange lonely husky woman with a collar in her mouth and a begging look. And find yourself hoping that someday the little stray will find herself a proper owner to use and take care of her like you take care of your little pet Sarah... Maybe you should go back yourself to check on her sometime and see if she still wants to be your pet now that you have a new life out here...";
	else if ColleenCollared is 1:
		project the Figure of Colleen_face_icon;
		if humanity of player < 10:
			say "     Colleen eagerly joins you and Sarah as you head out into the city to find your way in the world, her body shifting and changing even faster than your other pets did to match your new form, the influence of the both of you playing with your third pet encouraging her to fully accept her new shape as eagerly as she accepted her life as a husky. Soon she is following along with the two of you happily, eager to be part of whatever life has in store for the three of you.";
		else:
			say "     When rescued by the military, having Colleen as a pet stood you in good stead, as she knew just the best way to make sure they let you all go easily. She seems slightly sad when you leave the military base and the remnants of her old life, but is very happy to be a nice pet for you just like Sarah is. You enjoy having her with her, although two lusty little husky sluts around the house can be a bit much to keep up with sometimes, and eventually come up with a great idea to make sure everyone is properly happy. After a bit of time to train her properly and prepare her, you call up one of the more important military men that Colleen used to know, and he seems curious enough to come over for dinner one night. You make sure to make it a night to remember, as you offer your guest every courtesy, including the use of your teasing little husky pet, which after several hours of her heat-filled scent teasing him, he decides to accept.";
			say "     The general is surprised to discover after a very long night filled with amazing sex, that the husky pet you lent him actually used to be the soldier he knew as Colleen, and moreover that she was happy and excited to be a little husky slutpet. You spend some time explaining to him how she thought of him when she realized that it was kind of hard on you to maintain a house with so many needy pets, and that she was wondering if he would like to be her new owner. While surprised at the situation and the offer, he soon agrees to take her in as his pet, persuaded by her expertly trained tongue and needy slit, the situation making you smile even as he leads his new pet off with a leash. You just know he will be back to visit again soon, and if you ever need anything from him, his pet will certainly help you convince him to agree, and she will certainly enjoy her time back underneath a military man, you think with amusement as you turn back to enjoy your own husky pet.";
	else if bodyname of player is "Alpha Husky":
		if humanity of player < 10:
			say "     Having lost yourself to the infection, your canine instincts take over and you head into the city to form a new pack of your own. You dominate several of the canines around, turning them into a pack of loyal huskies and eke out a small territory for yourselves. Your pack captures wandering travelers from time to time, gaining a few members this way. You lose others from time to time as your weaker pack-mates at lost in fights. It is a tough existence at times, but one fueled by an eagerness and a canine lust that keeps you going.";
		else:
			say "     Somehow having endured your time in the city, you are rescued by the military's forces. You only receive a cursory examination and testing, your canine body mistaken for that of the much more common husky girls. While your alpha pride is hurt, you choose not to correct them of this misconception";
			if player is male:
				say ". You instead take this opportunity to get to know many of the others huskies in the compound. They recognize your alpha nature quickly and gain an obedient respect for you. Despite not having succumbed, their new instincts still affect them and you are easily able to gain their loyalty and affection.";
				say "     Once you and the others are treated and released, you set up a new home for yourselves as the new pack the military was kind enough to gather for you. With your stronger alpha infection in the presence of so many other huskies, your infection soon overpowers the treatment to make you non-infectious. Having already gathered a large pack of your own, you set to breeding them. You do occasionally enjoy adding a new female from time to time, but are largely content with the big pack you have, helping to hide the hidden cell of canine infection. It is with the second and third generation that there's a surge of huskies, your numerous offspring spreading out and forming lesser packs of their own by infecting others.";
			else:
				say ". You instead take this opportunity to get to know many of the other huskies in the compound. They recognize your alpha nature quickly and gain an obedient respect for you. Despite not having succumbed, their new instincts still affect them and you are easily able to gain their loyalty and affection, making yourself the alpha female among them.";
				say "     Once you and the others are treated and released, you set up a new home for yourselves as the new pack the military was kind enough to gather for you. With your stronger alpha infection in the presence of so many other huskies, your infection soon overpowers the treatment to make you non-infectious. Having already gathered a large pack of your own, you set to work on the lone male you found. While at the military base, you made certain to ensnare this very rare male husky as part of your group. You mate with him numerous times and train him to take charge and dominate the other submissive husky girls, working him to gradually become an alpha male for the pack. But you make certain he knows his place and maintain enough of his submissive nature to keep yourself as his mistress as well. With so many females already gathered for him to breed, your pack only occasionally enjoys adding a new female from time to time, helping to hide the hidden cell of canine infection. It is with the second and third generation that there's a surge of huskies, your pack's numerous offspring spreading out and forming lesser packs of their own by infecting others.";

When play ends:
	if ColleenFound is 1: [brought into the library, not transformed]
		if humanity of player < 10:
			say "     Finally overcome with your strong bestial instincts to breed, fuck, and spread the infection, you recall where a perfect new pet is waiting for you, nice and safe, and above all unsuspecting, in your bunker. Swiftly returning to the library, you manage to behave long enough to convince Colleen to let you in, where you immediately pounce on her and fuck her like the beast you are. The former soldier moans and pants underneath you, her body shifting and changing as you spread your infection to your new friend. You ravish her body until her form is as twisted and changed as yours, a perfect match for the wonderful new beast you have become, and then over the course of the next day or so, you keep the new Colleen trapped in the bunker with you while you mate her even more thoroughly, enjoying the way her mind changes more and more with each sexual encounter, as she loses her humanity bit by bit, the infection conquering her mind as easily as it conquered yours, making her little more than a beast just like you. Finally satisfied, you head out into the city to seek out even more new conquests to spread your glorious new form to, sure in the knowledge that your most recent convert will be doing the same elsewhere in the city as well...";
		else:
			if ColleenSpray is 99: [player and her had 'safe' sex]
				say "     Colleen is extremely happy when the rescue arrives, and while she has picked up a few minor traits from her time spent with you in the bunker, she is still recognizable and mostly human. She manages to talk to several of the military troops that rescue you and puts in several good words for you based on how you helped her survive. This means the military is more than happy to let you out of the city while they deal with the more important and dangerous beasts still left inside. Colleen keeps in touch with you as you begin to make a life for yourself afterwards, which includes semi-regular visits on weekends to let off some steam. As you lay in bed together after some sweaty sex with the trained woman, she usually talks a little about the ongoing containment mission of the city.";
				say "     Having an on and off again lover in the military does have its scary moments too though, as Colleen's scouting missions usually put her in the thick of making sure no infective beasts manage to make it out of the city. Sometimes it takes days before you hear back from her, but in the end you always do, with Colleen having some new and exciting stories to tell. And not only that, as the continued exposure to new active nanites does change little things about her, despite all that the army scientists can do about it. Nothing big though, and the brave soldier doesn't have to worry about losing her humanity - but you have to admit that it is quite interesting to find out just what the color of her eyes - or the shape and size of her pussy - is when she returns to you the next time.";
			else: [no sex between Colleen and the player]
				say "     Colleen is extremely happy when the rescue arrives, and while she has picked up a few minor traits from her time spent with you in the bunker, she is still recognizable and mostly human. She manages to talk to several of the military troops that rescue you and puts in several good words for you based on how you helped her survive. This means the military is more than happy to let you out of the city while they deal with the more important and dangerous beasts still left inside. Colleen keeps in touch with you as you begin to make a life for yourself afterwards, until finally you lose contact with her after she goes on a scouting mission in the area around the city to make sure none of the beasts managed to escape. You find yourself alternatively hoping she turns up ok and unchanged, or wondering if she would be happy to welcome you and change you into whatever she became if you hunted her down...";

Colleen ends here.
