Version 2 of Leopardman by Sarokcat begins here.
[ Version 2 - Special variations added for Art Collector event ]

"Adds a Leopardman to Flexible Survival's Wandering Monsters table"

Section 1 - Monster Responses

to say leopardman desc:
	setmongender 3;  [creature is male]
	if artleopardfight is 3:	[Description for Art Collector event]
		say "     As the leopardman growls again and stalks towards you, you get a good look at the powerful feline male. His strong body is covered with leopard-like fur, and as he rises up to two feet and flexes his claw-tipped hands, you get a very good look at his rather erect feline cock. Looking around quickly, you realize the leopardman has moved to block your exit. As you prepare to fight you can see a playful grin cross the muzzle of the obviously aroused feline. '[one of]You'll pay for this interruption,[or]I don't have time, you wretched thief,[or]Let's get this over with quick. I have more important matters to deal with,[or]I'm going to turn you in a scratching post,[in random order]' he says as he leaps forward after his prey. Already weakened from your long climb, you hope you're still up for a fight.";
	else if inasituation is true:
		say ""; [dealt with at the event source]
	else:
		say "     As you wander the deserted streets of the city, all of a sudden a large form jumps down into the street in front of you. As it stalks towards you, you get a good look at the powerful feline man. His strong body is covered with leopard-like fur, and as he rises up to two feet and flexes his claw-tipped hands, you get a very good look at his rather erect feline cock. Looking around quickly, you realize the leopardman waited until it was far too late for you to run before he leaped down from his hiding spot, as you prepare to fight you can see a playful grin cross the muzzle of the obviously aroused feline. '[one of]This should be fun.[no line break][or]Let's play Leopard and mouse shall we?[no line break][or]I like it when they struggle a bit.[no line break][or]You look like you will make a fine Leopardess...[no line break][or]Let's see how long you can resist me, little prey...[no line break][at random]' he says as he leaps forward after his prey.";

to say Leopardman attack:
	if artleopardfight is 3:
		now artleopardfight is 2;
		if HP of player > 0:
			say "     You surrender yourself to the powerful feline, begging for his mercy but finding none in his cold, steely eyes.";
		else:
			say "     You are beaten by the powerful feline, knocked to the ground and pushed away from the prize you sought.";
	else if inasituation is true:
		say ""; [dealt with at the event source]
	else if player is female:
		say "     'That's it, I knew you couldn't resist a sexy cat like me for much longer, and now we can have some real fun with that lusty little pussy of yours...' the leopardman says with amusement as you abandon any further attempt at resistance and lie there helplessly sprawled out in front of the male beast. You find your heart beating faster as he stalks closer to you, his powerful male scent filling your mind with lust even as he moves his spotted feline form over you. You gasp as one of his clawed hands trails up the inside of your thighs teasingly, the feel of his soft hands tracing up your [bodydesc of player] body making you moan with arousal, and causes the leopard to grin as he reaches your already damp female mound and rubs it teasingly.";
		say "     'Already nice and ready for me I see, this is going to be fun,' he says with a smirk as he positions himself above you, your legs parting automatically for him as he lowers himself down onto you, your body reacting to his touch without any hesitation, your mouth open and panting with need as he guides the tip of his barbed feline cock up against your increasingly heat-filled sex. The leopardman seems increasingly amused as he thrusts himself slowly inside you, the feel of his warm thick feline member spearing into you makes you groan with delight as you begin to forget why you would want to resist something so pleasurable.";
		WaitLineBreak;
		say "     His soft thick spotted fur tickles pleasurably as it rubs up against your [skin of player] skin, as he begins to rock his hips forward against yours, his barbs massaging your inner walls with small bursts of pleasure, as he slides his feline cock in and out of your increasingly lust-filled form. You feel his sharp feline teeth brush your neck and you moan as he licks across your neck several times with his raspy feline tongue, the sensation seeming strangely erotic as he rubs his muzzle against your unprotected neck teasingly. The pleasure only seems to build within you as he speeds up his thrusts, all thoughts of anything except sex driven out of your mind as your senses are overwhelmed by his masculine musk, and the feel of his silken soft fur stroking over your [bodytype of player] body as he continues to thrust that amazingly pleasurable feline cock into your needy passage.";
		say "     After what seems almost like an eternity of pleasure, the leopardman buries his head against your shoulders, his teeth scraping lightly against your skin as he holds you in place to receive his seed. You find yourself yowling helplessly like a cat as you feel his cock tense and fill your body with his warm thick seed, your own orgasm smashing through you and making you feel increasingly bestial as he fills your body with his predatory seed. Eventually you can do no more than shudder limply underneath him as he pulls out of you with a look of satisfaction on his feline face, 'What a good little sexy slut you make,' he murmurs with amusement as he traces one of his clawed tips along the side of your face teasingly, 'Now that you know how good it can be, I look forward to seeing you again, my little soon to be Leopardess. In the meantime, though, I am sure there are still others out there for me to find and breed...' the leopardman says with a wicked grin as he begins to stalk off down the street, already looking for his next sexual conquest as he leaves you lying there trying to recover from the amazingly sexual experience.[impregchance]";
		infect "Leopardman";
	else if ( HP of player > 0 and a random chance of 1 in 3 succeeds ) or ( player is submissive and a random chance of 2 in 3 succeeds ) or ( player is mpreg_ok and a random chance of 1 in 3 succeeds ):
		say "     'Well, I was certainly hoping for some more fun than this,' he rumbles as he looks over your body as you [if HP of player > 0]give up the fight and submit to[else]collapse helplessly in front of[end if] the powerful and masculine feline. 'Without a proper breeding hole, what good are you?' the leopardman asks teasingly as he looks down at you, the evil grin spreading across his muzzle making you shudder slightly. 'Though you certainly act like a weak and needy female, now don't you?' he purrs in your ear as he pins you down suddenly. 'Maybe you just need a little more... encouragement.'";
		say "     What he means by this becomes clear as he grinds his hard erection against your backside and gets it lined up with your asshole. You find your heart beating faster as his powerful male scent fills your mind with lust even as one of his clawed hands trails up the inside of your thighs teasingly. The feel of his soft hands tracing up your [bodydesc of player] body making you moan with arousal and causes the leopard to grin even as he slips a paw [if player is male]to your [cock size desc of player] [cock of player] manhood. 'Already hard, I see,' he rumbles. 'I knew there was a needy fucktoy somewhere inside you looking to get fucked and bred[else]across your bare groin. 'Nothing at all, eh?' he says in surprise. 'Well, let's see if we can't get you a proper pussy so you can get bred like you so clearly want next time[end if].' And with that said, he pushes his hips forward, sinking his pointed, barbed, feline rod into you.";
		WaitLineBreak;
		say "     You can't help but respond to his rough lovemaking, aroused at having such a strong and virile male atop you and stuffing your needy body. Your mouth hangs open as you pant with need as he thrusts into you rhythmically. The feel of his warm thick feline member spearing into you makes you groan with delight as you begin to forget why you would want to resist something so pleasurable[if player is male]. Your cock twitches and dribbles precum with each delightful push against your prostate[end if].";
		say "     His soft thick spotted fur tickles pleasurably as it rubs up against your [bodytype of player] form. As he rocks his hips forward against yours, his barbs massage your inner walls with small bursts of pleasure while his feline cock in and out of your increasingly lust-filled form. You feel his sharp feline teeth brush your neck and you moan as he licks across your neck several times with his raspy feline tongue, the sensation seeming strangely erotic as he rubs his muzzle against your unprotected neck teasingly. The pleasure only seems to build within you as he speeds up his thrusts, all thoughts of anything except sex driven out of your mind as your senses are overwhelmed by his masculine musk. The feel of his silken soft fur stroking over your [bodytype of player] body as he continues to thrust that amazingly pleasurable feline cock into your needy passage gets you to moaning and mewling beneath him. The push of his thick rod inside you feels so wonderful, especially in how it feels against your sensitive prostate.";
		WaitLineBreak;
		say "     After what seems almost like an eternity of pleasure, the leopardman buries his head against your shoulders, his teeth scraping lightly against your skin as he holds you in place to receive his seed. You find yourself yowling helplessly like a cat as you feel his cock tense and fill your rectum with his warm thick seed, claiming your body as he would a female's[if player is male]. Your own orgasm smashes through you and makes you feel increasingly bestial as he fills your body with his predatory seed. You empty your load across the ground as his strong paw strokes you off while he rumbles for you to pump out all that unneeded semen[end if].";
		say "     Eventually you can do no more than shudder limply underneath him as he pulls out of you with a look of satisfaction on his feline face. He wipes his cock on your rear. 'You make for a pretty good fuck, you sexy slut. Now that you know how good it can be, I look forward to seeing you as a proper female and eager to be a sexy leopardess getting bred under me soon,' the leopardman says with a wicked grin as he begins to stalk off down the street, already looking for his next sexual conquest as he leaves you lying there. It takes you some time to recover from the amazingly sexual experience and be able to move on.[mimpregchance]";
	else:
		say "     'Well this doesn't look like much fun...' the leopardman says as he looks your body over as you collapse helplessly in front of the powerful and masculine feline. 'Without a proper breeding hole what good are you?' The leopardman asks teasingly as he looks down at you, the evil grin spreading across his muzzle making you shudder slightly. 'Though maybe all you need is a little bit of kitty cream to help you along... and another leopard is always a good thing... even if it is male... for now,' he says with amusement as he begins to stroke his thick feline cock teasingly, the sight of his furred hand stroking that pointed and barbed member seeming strangely erotic as he draws closer to you. Lost in the increasingly sexual sight of his powerful feline body, and with the scent of his erotic musk filling your head, you can only pant helplessly as he positions his thick cock in front of your mouth teasingly. Before you can think about what you are doing, you find your tongue licking the tip of his thick cock, the salty taste of his delicious meat filling your mouth as his hands grip the top of your head as he slowly guides himself into your mouth.";
		say "     'That's good, open wide for your cream little kitty,' you can hear the leopardman say from above you, his words filling your mind even as his meaty feline cock fills your mouth, your eyes drifting closed as your lips close around the leopardman's wonderful member, as strange increasingly sexual thoughts fill your mind. You can hear the pleasurable growl of the leopardman above you as he begins to thrust in and out of your mouth, his barbs rubbing against your tongue pleasingly even as the pointed tip of his feline cock rubs against the back of your mouth. Your own cock stiffens with arousal as you begin to lick and suck eagerly on the proud feline meat in your mouth, the strange salty flavor of his leopard cock is surprisingly addicting, and you find yourself growing ever more eager to taste the 'cream' the leopardman promised you as you begin to worship his cock enthusiastically.";
		WaitLineBreak;
		say "     Soon the Leopard is moaning and yowling with pleasure above you, every sexy sound you wring out of him as you work on his cock seems like a pleasant reward to your lust-addled mind, as you run your tongue over his amazing feline rod and your own rod twitches with desire. Before much longer, your efforts are rewarded, and his cock twitches as it fills your mouth with his wonderful cream, the salty and sweet taste of the leopardman's seed filling your mouth as you eagerly try to gulp down every last amazing drop. You hardly realize that your own cock is busy coating your chest with your own seed as you continue to lick and suck at the leopardman's member, while he yowls his orgasm and triumph out for all to hear.";
		say "     Eventually the leopardman pulls his spent cock out of your mouth, and you collapse back helplessly as he stands over you with amusement, 'I can see you liked your dose of cream little one,' he says with a chuckle of amusement. 'And while I am sure you can hardly wait for your next dose, there are still plenty of people out there that need to become sexy little leopards like me, and there are plenty of females out there that need a little belly full of leopard cubs as well. And maybe next time you will have a proper little pussy as well for me to fill full of cubs,' he says with an amused flick of his tail as he stalks off into the city, already on the hunt for his next playmate as you lie there and try to recover from the intense sexual experience.";
		infect "Leopardman";


To say Leopardman loss:
	if artleopardfight is 3:
		now artleopardfight is 1;
		say "     The leopardman staggers back, his feline muzzle scrunched up in pain as he clutches at his wounds and glares at you for a minute. As you step forward to continue the fight, the feline glances to the side and dashes off into the office on the opposite side of the room, slamming the door and locking it.";
	else if inasituation is true:
		say ""; [dealt with at the event source]
	else:
		say "     The leopardman staggers back, his feline muzzle scrunched up in pain as he clutches at his wounds and glares at you for a minute. As you step forward to continue the fight, the feline glances to the side, and leaps for one of the buildings instead of leaping at you, and you watch with frustration as the injured feline climbs quickly out of reach before disappearing over the roof. Sighing you continue on your way through the city.";


Section 2 - Monster Insertion

Table of random critters (continued)
name	enemy title	enemy name	enemy type	attack	defeated	victory	desc	face	body	skin	tail	cock	face change	body change	skin change	ass change	cock change	str	dex	sta	per	int	cha	sex	HP	lev	wdam	area	cocks	cock length	cock width	breasts	breast size	male breast size	cunts	cunt length	cunt width	libido	loot	lootchance	scale (number)	body descriptor (text)	type (text)	magic (truth state)	resbypass (truth state)	non-infectious (truth state)	nocturnal (truth state)	altcombat (text)
--	--	--	--	--	--	--	--	--	--	--	--	--	--	--	--	--	--	--	--	--	--	--	--	--	--	--	--	--	--	--	--	--	--	--	--	--	--	--	--	--	--	--	--	--	--	--	--	--;

When Play begins:
	Choose a blank row from Table of random critters;
	add "Leopardman" to infections of furry;
	add "Leopardman" to infections of guy;
	now name entry is "Leopardman";
	now enemy title entry is "";
	now enemy name entry is "";
	now enemy type entry is 0; [non-unique enemy]
	now attack entry is "[one of]The leopardman swipes at you with his sharp claws![or]The leopardman pounces you playfully![or]He darts forward quickly and lashes out with a closed fist![or]The leopardman pauses for a second to watch you carefully, before darting forward and swiping at your legs, knocking you down![or]The leopardman grabs your arms with his hands, and leans forward to give you a teasing kiss before releasing you.[or]He charges forward and knocks you into a wall, pinning you for a second while he rubs his soft fur against you.[at random]";
	now defeated entry is "[Leopardman loss]";
	now victory entry is "[Leopardman attack]";
	now desc entry is "[leopardman desc]";
	now face entry is "broad sexy feline muzzle, with golden slit pupiled eyes and rounded feline ears sitting atop your new leopard-like face"; [ Face description, format as "Your face is (your text)."]
	now body entry is "powerful and lean, your well muscled form is carried easily on your powerful legs, their muscles designed for leaping and climbing, which rest easily on your rather paw-like feet. Your hands are tipped with sharp claws, easily suited for both combat and climbing"; [ Body Description, format as "Your Body is (your text)"]
	now skin entry is "[one of]leopard spotted[or]leopard furred[or]Black and yellow spotted[or]soft furred[or]short fur covered[at random]"; [ skin Description, format as "You have (your text) skin"]
	now tail entry is "You have a long, thin feline tail lashing teasingly behind you, its eager movements showing off your well-rounded ass, even as it twitches eagerly as if begging someone to pin it down and fuck you."; [ Tail description, write a whole Sentence or leave blank. ]
	now cock entry is "[one of]feline[or]leopard[or]barbed[or]pointed[at random]"; [ Cock Description, format as you have a 'size' (your text) cock]
	now face change entry is "it stretches forward, your nose flattening and your mouth spreading out as they merge together and begin to form a proper feline muzzle. Your eyes seem to blur for a second, and then the world sharpens around you as they become the slit pupils of a hunting cat, and as your changes finish with your new leopardlike ears coming to rest on the top of your head, you can feel your new feline muzzle stretching in a lewd grin as lustful thoughts fill your mind"; [ face change text. format as "Your face feels funny as (your text)." ]
	now body change entry is "your muscles shift under the skin, your feet shifting and the bones cracking as they become powerful feline paws and your legs shift to allow you to balance easily on your new, pawlike feet. Your hands feel strange as they shift and powerful leopardlike climbing claws push out of the tips of your slightly thicker and more powerful fingers"; [ body change text. format as "Your body feels funny as (your text)." ]
	now skin change entry is "a soft wave of short leopard spotted fur begins to cover your body, the fur rubbing against your skin softly as it grows in, making you shudder with pleasure as a proper coat of fur covers your body completely"; [ skin change text. format as "Your skin feels funny as (your text)." ]
	now ass change entry is "a thick feline tail begins to stretch out behind you, the increasingly sexy looking new appendage lashing back and forth teasingly with every step, as if inviting some sexy beast to come play with it"; [ ass/tail change text. format as "Your ass feels funny as (your text)." ]
	now cock change entry is "it is drawn up closer to your body by a feline sheath forming around it, your cock itself continues to stretch and change as well, becoming pointed and small barbs growing out of it, both for your feline mates pleasure and your own"; [ cock change text. format as "Your cock feels funny as (your text)." ]
	now str entry is 18;
	now dex entry is 26;
	now sta entry is 16;
	now per entry is 18;
	now int entry is 12;
	now cha entry is 18;
	now sex entry is "Female";  [ Defines which sex the infection will try and make you. current options are 'Male' 'Female' 'Both']
	now HP entry is 80;
	now lev entry is 9;  [ Level of the Monster, you get this much HP if you win, or this much HP halved if you loose ]
	now wdam entry is 11;  [ Amount of Damage monster Does when attacking. ]
	now area entry is "High";  [ Current options are 'Outside' and 'Mall'. Case sensitive]
	now cocks entry is 0;  [ How many cocks will the infection try and cause if sex is 'Male' or 'Both']
	now cock length entry is 0;  [ Length infection will make cock grow to if cocks]
	now cock width entry is 0;  [ Size of balls ]
	now breasts entry is 4;  [ Number of Breasts infection will give you. ]
	now breast size entry is 4;  [ Size of breasts infection will try to attain ]
	now male breast size entry is 0;  [ Breast size for if Sex="Male", usually zero. ]
	now cunts entry is 1;  [ if sex = "Female or both", indicates the number of female sexes infection will grant you.]
	now cunt length entry is 10;
	now cunt width entry is 4;
	now libido entry is 50;  [ Amount player Libido will go up if defeated ]
	now loot entry is "Spotted fur";  [ Loot monster drops, ]
	now lootchance entry is 50;  [ Chance of loot dropping 0-100 ]
	now scale entry is 3;  [ Number 1-5, approx size/height of infected PC body: 1=tiny, 3=avg, 5=huge ]
	now body descriptor entry is "[one of]sleek[or]powerful[at random]";
	now type entry is "[one of]feline[or]leopard-like[or]pardine[as decreasingly likely outcomes]";
	now magic entry is false;
	now resbypass entry is false;  [ Bypasses Researcher bonus? true/false (almost invariably false) ]
	now non-infectious entry is false;
	blank out the nocturnal entry;  [ True=Nocturnal (night encounters only), False=Diurnal (day encounters only), blank for both. ]
	now altcombat entry is "default";  [ Row used to designate any special combat features, "default" for standard combat. ]


Table of Game Objects (continued)
name	desc	weight	object
"Spotted fur"	"A small tuft of black and yellow fur, it is very soft and seems like it would feel nice against your skin."	1	  Spotted fur

Spotted fur is a grab object. It is part of the player. Understand "fur" as Spotted fur. Spotted fur is infectious. The strain of Spotted fur is "Leopardman".

instead of sniffing Spotted fur:
	say "The tuft of fur smells faintly of the powerful feline it came from.";

The usedesc of Spotted fur is "You take out the strangely attractive small tuft of fur you acquired earlier, rolling the soft fur between your fingers, you find the feel of the fur to be strongly sensual. Enjoying the pleasant feel of the fur, you begin to slowly rub the small bundle of fur over your skin, the silken soft fur tuft tickling your cheeks and chest as you trail it lightly over them several times, making you smile happily. After several passes however you go to trail it along your cheek again, only to realize the fur tuft is no longer there, looking down, you see where bits of the leopardlike fur have anchored themselves into your skin, giving you a small patch of sensual fur of your own to stroke, and you can almost feel the leopardlike changes moving throughout the rest of your body...[line break]";

when play ends:
	if bodyname of player is "Leopardman":
		if humanity of player < 10:
			if player is male:
				if player is female:
					say "     With your new powerful sexual instincts overwhelming you, you finally give in to your body's changes, your amazingly sexy new predatory body feels amazingly wonderful as you stalk the streets looking for anything to sate your increasingly powerful lust. Your lithe new body and climbing ability makes catching several of the sexy beasts wandering around the city, using their slutty little bodies for your pleasure before hauling their exhausted forms back to your newly found den. Before long you have a lovely little stable of men and women to play with whenever the mood strikes you, enjoying their moans of pleasure as your own sexy leopardlike infection slowly begins to overpower their bodies and their bodies begin to become more and more feline under your sexual assault.";
					say "     When the military arrives however, things change for a bit as you capture several soldiers to feed your nearly insatiable lust, and while their squad mates eventually manage to track down your den and their former teammates, your group of leopardlike beasts makes short work of converting the soldiers that find you. You are still forced to abandon your den now that it's location is known though, but you find yourself looking forward to building a nice sexy new den, where you can give birth to lots of little leopards, and drag your prey off to transform them and fill their slutty empty bellies with lots of little leopard cubs as well... You and your fellow leopardlike recruits just know that you are going to have so much fun with all these lovely little military personnel, and afterwards, who knows where you will find some new sexy prey to play with?";
				else:
					say "     You find your new predatory instincts growing increasingly more powerful as you give in to the pleasures of your new form, and before long you are enjoying prowling the streets of the deserted city looking for prey to chase, and people to transform. And while you are certainly one of the most powerful, and definitely one of the sexiest predators stalking the streets, the lack of unchanged people to stalk and play with is rather frustrating for a while, though you do find plenty of females of other species to sate your lusts on. This all changes when the military begins its campaign to free the city, and you find yourself overwhelmed with new prey to stalk, and while the soldiers are rather dangerous prey, you find that only adds spice to your hunt. While you have several close calls, you manage to catch several of the soldiers alone for more than long enough to have some fun and spread your infection to them, before letting them rejoin their squads trying to hide their new feline changes.";
					say "     You begin to truly enjoy the challenge as you find more and more creative ways to infect the soldiers, and as those you already began to infect with your powerful leopard seed return to the city, it becomes easier and easier to tempt them to come off alone for their next dose... though they often start bringing an unsuspecting new recruit or two to share in the transformation. Eventually you have a number of slutty leopardwomen who are too changed to returned to their base camp settling in throughout the city, and a few even manage to become sexy leopardmen like yourself, much to your feline amusement. And as the military tries to recover from its various defeats in the city, you find yourself grinning a feral grin as you wait for the soldiers still in camp to finish their transformations so you can continue to spread your wonderful new species far and wide once the blockade begins to crumble...";
			else:
				say "     Giving in to your new powerful instincts you find yourself enjoying your new predatory form as you stalk the city most nights looking for fun. You encounter several of those sexy leopardmen as you wander around the city, and enjoy every memorable encounter immensely, as you tease and taunt them and lead them a merry chase before allowing them to catch you and sate their lusts on your all too willing body. Few of the other creatures in the city pose much threat to your new predatory leopardlike form, and those that do are far too slow and clumsy to catch you. At least until the military arrive and combat begins to break out all over the city, you soon find the annoyance of all these untransformed soldiers running around to be extremely annoying as they stir up all kinds of trouble throughout the city. Feeling rather upset at the disturbance, you soon find yourself seeking more peaceful territory, your sleek leopardlike form making it rather easy to sneak through the military blockade and make your way out into the wilderness beyond the city.";
				say "     Your instincts keep you moving as you travel farther and farther from the city, looking for a new safe territory to set up in, and it isn't long after you find a nice spot of forest to set up in that you realize just what your instincts were telling you. You find yourself grinning ferally as you stake out your new home and set up a proper den in the area, finding yourself enjoying the sensation of your belly swelling with new life. Before long you know that you won't be the only leopard in this area, and you will have some lovely little cubs to hunt and play with, and you are already enjoying picking out which of the unsuspecting males from the nearby towns will help give you your next litter and help you spread your wonderful feline species even further...";
		else:
			if player is male:
				if player is female:
					say "     When the military rescue teams find you, you are barely holding on to your sanity due to the extremely powerful sexual instincts of your new predatory body, and you are extremely grateful to them as they take you back to their camp so you can get some help. At the military camp, you find it harder than ever to resist spreading your infection amongst all the sexy soldiers and scientists, the sight of all the unsuspecting people wandering around sparking your new predatory instincts. You are careful to downplay this to the scientists that talk to you, but you are also eager for some manner of help, and so you bring it up several times while talking to them. They seem rather surprised by your honesty, and with your new sensitive senses you can tell they are definitely more than a little bit aroused by your new leopardlike body as well.";
					say "     Unable to let you go in good conscience given your admission, they keep you there on the base while they look into finding a possible cure for your overwhelming lust, or at least a way for you to function in normal society again. And while there is some talk of transferring you to a more secure isolation facility where some of the other more feral captives have been sent, you are more than able to use your sexy new body and their own response to your predatory scent to avoid that fate. It isn't much longer before several of the scientists and lab assistants give in to temptation, and convince you to sate your ever increasing lust with them. Your new sexual body finds their attention to be increasingly flattering as well, as the people you play with seem to become increasingly addicted to the powerful pleasure you share together.";
					WaitLineBreak;
					say "     Before long many of your so called captors are starting to sport several feline features as well, much to your increasing amusement, and mild dismay, as they begin to enjoy their changes more and more. It is soon obvious that most of the scientists you have infected are no longer bothering to look for a cure, and instead are more interested in enjoying their new sexual instincts, and ensuring that their changes aren't discovered. Of course, they ensure you have plenty of uninfected visitors as well, though after being locked in with you for a while, none of them remain uninfected for very long. Eventually you find yourself enjoying the situation just as much as they seem to be, your new predatory instincts enjoying the pleasure and the sex more than you ever thought was possible, and while you still retain some measure of restraint compared to the beasts inside the city, you find the spread of your leopardlike infection to be amazingly arousing as well.";
					say "Unfortunately, the fun can't last forever, and when some of the scientists changes become impossible to hide any longer, they arrange your release while the military tries to deal with the sudden explosion of leopards in their midst, and their soldiers eager submission to the powerful predators. Leaving the camp behind you find a smile tugging at your feline muzzle as you and a decent-sized group of people in varying stages of becoming leopards head out into the world. As you look for a new place for you and your fellow leopards to settle and begin to hunt for new converts, you realize they finally did find a way to help you deal with your new sexual instincts, and as you rub your feline belly with anticipation of all the little sexy leopard cubs you can look forward to in the future, you find yourself looking forward to sating those new instincts of yours as often as possible...";
				else:
					say "     When the military finally arrives to rescue the survivors, they are somewhat surprised by your leopardlike appearance, but end up taking you back to their camp with them anyways. You find your new predatory instincts aroused by all the sexy women wandering around the military camp, though you manage to restrain yourself from acting on them while their scientists try to discover if you are a threat or not. Not wanting to spend the rest of your life in some sort of confinement, you act nice and polite, and even ask about joining the military yourself at some point. Once their suspicions about you are put to rest however, they release you so they can deal with more dangerous matters within the city, just as you expected they would. Soon you are prowling down the streets of another city, your dangerous and sexy form attracting you plenty of attention as you try to figure out what to do with your life now that you are free.";
					say "     Prowling the bars and clubs is surprisingly amusing, and you find you enjoy the hunt and the chase as you seduce woman after woman at the clubs, spreading your leopard seed far and wide as you find a new partner to play with most every night. Eventually you manage to get a job at one of the clubs, as you prove to be such a big draw yourself, and you settle in for a while to enjoy yourself for a while. Before long many of the regulars at the club have also started to acquire some feline features much to your amusement, and you enjoy staying there for a while as you ensure that there are plenty of well-bred leopardesses in the area that won't be forgetting you anytime soon. After a while, when the hunting in the area begins to get to easy you begin to hunt for fresher hunting grounds and new clubs to prowl, eager to continue to enjoy your new more predatory lifestyle for many years to come.";
			else:
				say "     When the military finally arrives to rescue the survivors, they are somewhat surprised by your leopardlike appearance, but end up taking you back to their camp with them anyways. You find your new predatory instincts aroused by all the sexy men wandering around the military camp, though you manage to restrain yourself from acting on them while their scientists try to discover if you are a threat or not. You are careful to make sure that the scientists think you nice and tame, despite your predatory looks, once their suspicions about you are put to rest however, they release you so they can deal with the much more dangerous matters within the city, just as you expected they would. Soon you are prowling down the streets of another city, your dangerous and sexy form attracting you plenty of attention as you try to figure out what to do with your life now that you are free.";
				say "     Prowling the bars and clubs soon gets you all kinds of attention from those who find your predatory form to be strangely attractive, and before long you find yourself becoming increasingly popular among a certain crowd, and you rarely go home alone at night. Your popularity doesn't go unnoticed for long, and you eventually receive several offers to work as a model for several different companies, the modeling only increases your popularity, and soon you are enjoying a life of mild luxury as a feline model. You find your bodies appetites for sex are as large as ever however, and you often play with many different sexy models whenever the opportunity presents itself, even transforming the best of them into sexy leopardmen themselves. The spread of leopardlike models and your ever growing popularity only makes you grin with amusement as more and more time passes and eventually people begin clamoring to grow a lovely spotted feline coat of their own... spots are definitely going to be the 'in' thing this season.";

Leopardman ends here.
