Version 1 of Mareslut by Sarokcat begins here.
[ Version 1.3.1 - Stables-equine player victory (M/F) - now w/Stallionboi ]

"Adds a Mareslut to Flexible Survival's Wandering Monsters table"


Section 1 - Creature Responses

when play begins:
	add { "Mareslut" } to infections of girl;
	add { "Mareslut" } to infections of furry;


to say Mareslut attack:
	if Player is male:
		if a random chance of 2 in 3 succeeds:
			say "     Unable to resist her sensual onslaught, you find yourself panting with arousal as you lower your hands, unable to fight any longer. Seeing your surrender, the mare gives you a large equine grin, before pulling you forward and planting a deep equine kiss on your mouth, her thick tongue exploring your mouth teasingly, even as her aroused, heat-filled scent washes over you. Finally breaking the deep kiss, the sexy mareslut smiles at you as you pant with arousal, her lusty hand wrapping around stiff [cock of Player] cock and stroking it several times, making you moan helplessly with pleasure. 'Oh we are going to have so much fun together my little stud. I certainly hope you plan on staying around for a while...' she says with a soft chuckle as she strokes your cock again before leading you into one of the side rooms by your cock. The sight her soft sultry curves distract you from your surroundings as she guides you over to a large bed and pushes you down onto its silken sheets. You moan with pleasure as the obviously experienced mare climbs on top of you, her hands tracing over your body teasingly as she rubs her already damp pussy against your erect member.";
			say "     After teasing you for a minute, the sexy mare shifts position slightly, her hand tracing along the base of your cock as she slowly guides it into her dark and delicious maresex. You groan with pleasure as she rests her soft muzzle against your neck as she slowly lowers herself onto you. The feel of her warm moist passage devouring your stiff rod inch by inch is absolutely exquisite, and you find yourself burying your hands in her soft hide as you pull her warm sensual body close. The mare lets out a low neigh of pleasure, her lust-filled moans mingling with your own as you thrust eagerly into her, all thoughts of restraint and consequences abandoned in the incredible passion of the moment. The intense sensations of her slick passage gripping and massaging your cock is absolutely amazing. The pleasure building until you completely lose yourself in the feel of your bodies coming together again and again; until finally your mind explodes with ecstasy as you shoot your seed into her lusty body. Your eyes roll back in their sockets as the lusty mare orgasms with you and your mouth hanging open as you gasp and pant for air. 'That was a nice start, but surely you don't think we are done yet handsome?' the mare whispers into your ear teasingly, before covering your open mouth with her own as she begins to move up against you again.";
			say "     Later on, after she has wrung several more screaming orgasms out of you, you begin to drift off to sleep completely exhausted. As you do, you think you hear her mutter 'that was fun, I almost hope you stay male, though I think you would make a lovely mare too... I can't wait to see how you turn out...' Though you are too tired to think about it right now. Eventually you wake up, and blink as you feel a large warm body pressed up against you, looking over carefully you see the mare from before sleeping next to you on the bed, obviously as worn out from your playtime as you still are. Realizing you can't have been out that long, you slowly begin to slip out of the bed, careful not to disturb the lusty mare as you gather your stuff together. You pause for a minute as the lingering sexual scents from the room fill your head with the desire to go back to the bed and wake the mareslut up for another round, but somehow you know that if you do that you would probably never get up the willpower to leave, and you sigh with regret as you slip out of the room and cautiously make your way back to the entrance.";
			infect "Mareslut";
		else:
			say "     [if HP of Player > 0]Unwilling to resist the mare's sensual onslaught any longer, you allow her to pin you against a wall[else]Unable to resist the mare's sensual onslaught any longer, you find yourself panting with arousal as she presses you against a wall[end if]. She presses her equine muzzle to your lips, kissing you deeply and passionately. The sexy mareslut smiles at you as she pants with arousal, her hoof-like hands roaming over your body before making their way to your [cock of Player] cock.";
			say "     '[one of]Mmm... I've got a client waiting, but I couldn't resist having a little quick fun with you first[or]Mmm... my next client loves it when I come in all messy[or]I'm a little sore after a gangbang with some of the stallions, but you'll make for a tasty treat to wash it all down[or]One of the stallions has been promised my next foal, but that doesn't mean we can't have a little fun[in random order],' she says with a playful grin. Grabbing you by the arm, she drags you into one of the many rooms and pushes out down onto the bed. Wrapping a strong hand around your cock, she strokes your [cock size desc of Player] penis to full erection before nestling her plush breasts around it. With those fuzzy melons squeezing around your shaft, she slides them along your meat. You can't help but moan and pant as she titty fucks you to what becomes a sticky orgasm in short order. You spray your cum between her tits and across her equine muzzle. She takes several licks of it, but leaves much of it splattered across her large bosom when she gets up and leaves now that she's had her fun. It takes you a few minutes to recover enough to leave before someone or something else happens upon you in your dazed state.";
	else:
		say "     Unable to resist her sensual onslaught, you find yourself panting with arousal as you lower your hands, unable to fight any longer. Seeing your surrender, the mare gives you a large equine grin, before pulling you forward and planting a deep equine kiss on your mouth, her thick tongue exploring your mouth teasingly, even as her aroused, heat-filled scent washes over you. Finally breaking the deep kiss, the lusty mareslut smiles at you as you pant with arousal. 'Oh yes, you look like you would love being a sexy slutty mare like me... Why don't I show you just how much fun we can have together?' she says as she drags you into one of the side rooms. Barely giving you any time to take in the sights of the sparse, outdated décor before dragging you over to the large bed, she wastes no time in guiding your unresisting body down onto the bed. She climbs on top of you, her warm sexy body pressing you down into the surprisingly soft mattress as she rubs herself up against you. You find yourself moaning as she strokes you with her hoof-like hands, her soft muzzle rubbing up against you teasingly as she licks and nibbles your erect nipples, the arousing sensations overwhelming your lust fogged mind with pleasure.";
		say "     You lose track of time as she plays with your all too eager body, your mind awash with sexual pleasure as she brings you to the edge of orgasm and keeps you there teasingly. She whispers soft words of encouragement into your ears as you beg for release, telling you all about how wonderful it is to be a well-fucked mare slut, and how much fun the two of you will have together with the handsome male stallions. Finally, when your mind is overwhelmed with the sexual images the mare is filling your head with, she moans with pleasure and moves her fingers up into you, swirling them around inside your sopping wet pussy teasingly and causing your mind to explode with pleasure as your long-awaited orgasm rocks your body. The mare only chuckles and whispers 'That's a good slut' into your ear teasingly as she renews her assault on your body. She wrings orgasm after screaming orgasm out of you again and again until you lose all track of anything but the pleasure the talented mare is giving you, her own squeals of orgasm mixing with your own as you rub up against each other on the bed.";
		say "     Finally after a near eternity of sexual bliss, you can't take any more, and you hear the mare chuckling softly and feel her hoof-like hand stroking your cheek tenderly as you begin to pass out from exhaustion. You think you hear her mutter something about what a good little mare you will make, before you fall asleep. Eventually you wake up, and blink as you feel a large warm body pressed up against you, looking over carefully you see the mare from before sleeping next to you on the bed, obviously as worn out from your playtime as you still are. Realizing you can't have been out that long, you slowly begin to slip out of the bed, careful not to disturb the lusty mare as you gather your stuff together. You pause for a minute as the lingering sexual scents from the room fill your head with the desire to go back to the bed and wake the mareslut up for another round, but somehow you know that if you do that you would probably never get up the willpower to leave, and you sigh with regret as you slip out of the room and cautiously make your way back to the entrance.";
		infect "Mareslut";
		decrease humanity of Player by 2;


To say Mareslut loss:
	if Player is not male or ( bodyname of Player is not "Mareslut" and bodyname of Player is not "Horseman" and bodyname of Player is not "Nightmare" and bodyname of Player is not "Stallionboi" ):
		say "     Driven back by your powerful assault, the slutty mare groans with pain as she staggers backwards and shoots you a rather dirty and sexy look as she says '[one of]Well you didn't have to be so rude!' [or]Maybe you will be more fun next time, sexy,' [or]Why don't you want to fuck me?' [or]Damn sweetie, that's a little rough for me. Maybe you should try one of the donkeys?' [at random]before staggering off down the corridor, shooting you a last teasing glance over her shoulder as she does so.";
	else:
		say "     Driven back by your continued resistance, the slutty mare groans and staggers backwards. She leans back against a wall with a tired sigh. '[one of]Alright, I give[or]Fine then, you win[or]You're too headstrong[at random],' she says, running her eyes over your horse form with continued longing even as she gives up her fight to molest you. '[one of]Fuck me if you wish[or]I'm yours to claim[or]You can claim my body, stud[at random].' She spreads her legs and offers up her body to you, submitting herself to you in a final plea to sate her lusts. Your equine nature feels a fresh twinge of arousal and the thought of having your way with her makes you excited. Shall you claim your prize now that this slutty mare's given in to you?";
		if Player consents:
			say "     Striding up to her, you place your hands firmly on her shoulder and hip, confident now that she knows you're in charge. She smiles and nickers softly with need, moving her hands behind her head as she continues to pose sexily for you as you get your [cock size desc of Player] cock lined up. Feeling little need to tease her at this point, you thrust into her wanton hole. This draws a large neigh of delight from her as your cock [if Cock Length of Player > 30]stretches and stuffs her[else if Cock Length of Player > 20]fills her[else if Cock Length of Player > 10]pushes into[else]slips into[end if] her hot and needy cunt.";
			say "     Now that you're fucking the slutty horse-woman, you move your other hand up from her hip to her bosom. Groping and fondling those large tits of hers gets the mare moaning more. She moves her hands down to your hips, tugging on them for you to fuck her harder. Rather than waste too much time on this whorish mare, you quicken the pace and drive your [cock of Player] cock into her in firm thrusts. You[if facename of Player is listed in infections of equinelist] nip at the mare's neck as you[end if] drive your pulsing rod as deep as it'll go, unloading your hot seed into her quivering snatch. After dumping a [Cum Load Size of Player] load of your semen into her womb, you pull out. She slumps to the floor with a sighing moan, lightly fingering her creamy snatch and groping a tit. You leave the slut lost in her post-orgasmic haze and get back to other matters.";
		else:
			say "     Having managed to fight off her advances thus far, you resist the temptation of your own infected body as well. With a final aggressive motion, you send the wanton female running off down the halls. She can throw herself upon the lustful desires of some other stud, for all you care.";


Section 2 - Creature Insertion

Table of Random Critters (continued)
NewTypeInfection (truth state)	Name	Enemy Title	Enemy Name	Enemy Type	Attack	Defeated	Victory	Desc	Face	Body	Skin	Tail	Cock	Face Change	Body Change	Skin Change	Ass Change	Cock Change	str	dex	sta	per	int	cha	sex	HP	lev	wdam	area	Cock Count	Cock Length	Ball Size	Nipple Count	Breast Size	Male Breast Size	Cunt Count	Cunt Length	Cunt Tightness	Libido	Loot	Lootchance	Scale (number)	Body Descriptor (text)	Type (text)	Magic (truth state)	Resbypass (truth state)	non-infectious (truth state)	Cross-Infection (text)	DayCycle	Altcombat (text)	BannedStatus (truth state)
--	--	--	--	--	--	--	--	--	--	--	--	--	--	--	--	--	--	--	--	--	--	--	--	--	--	--	--	--	--	--	--	--	--	--	--	--	--	--	--	--	--	--	--	--	--	--	--	--	--	--;

When Play begins:
	Choose a blank row from Table of Random Critters;
	now NewTypeInfection entry is false;
	now Name entry is "Mareslut";
	now enemy title entry is "";
	now enemy Name entry is "";
	now enemy type entry is 0; [non-unique enemy]
	now attack entry is "[one of]She rubs her large sexy breasts teasingly as she slides up against you.[or]The mare reaches out and strokes her hands over your body teasingly[or]The powerful mare moves surprisingly fast as she slams one of her hoof-like fists into your body![or]The sexy mare charges forward, running right into you![or]She gives you an equine grin for a minute, confusing you slightly, as she slowly stretches and poses teasingly in front of you, your body growing hot and aroused from the sexy show.[or]The mare reaches out with her powerful arms, and tries to pin you up against her sexy body, rubbing her soft fur all over your skin as she moans with excitement![or]She charges forward, and her hoof-like hands reach around your head, and pull you forward until your face is buried in her ample cleavage while she moans with excitement as she rubs her soft breasts up against your face.[at random]";
	now defeated entry is "[Mareslut loss]";
	now victory entry is "[Mareslut attack]";
	now desc entry is "[mongendernum 4]     Traveling through the strangely empty halls of the building, you nearly run into a large equine female coming out of one of the side rooms. 'Well what do we have here?' the sexy looking mare asks, as she looks you up and down. You find yourself examining her in return, your eyes trailing over the ample equine curves and large bosom of the [one of]sleek black[or]sexy gray[or]slutty roan[or]suede brown[or]beautiful white[at random] mare as she balances easily on her silvery hooves, her long equine tail flicking behind her in excitement as the naked and sexy mare looks you over. '[one of]I have time for a little fun,[or]You look like you need a bit of fun,[or]What a sexy looking customer. Why don't I show you around my body?[no line break][or]Why don't you stop and stay a while sexy?[no line break][or]I think you would make a very sexy looking mare, nice and sexy and slutty just like me![no line break][or]Oooh you look like you want to play! C'mon then![no line break][or]Hey sexy, care to mount up and go for a ride?[no line break][or]I just knew that [if daytimer is day]today was going to be a good day[else]tonight was going to be a good night[end if]![no line break][at random]' the mare says, before reaching out towards you eagerly.";
	now face entry is "rather equine like, with a large kissable muzzle, and beautiful brown eyes staring out of your expressive equine "; [ Face description, format as "Your face is (your text)."]
	now body entry is "curved and full-bodied, with sensuous and sleek curves begging to be stroked and touched, you balance easily on your new equine legs even as your slightly hoof-like hands stroke your sensitive sides absently"; [ Body Description, format as "Your Body is (your text)"]
	now skin entry is "[one of]softly furred[or]chestnut furred[or]tan colored horsehide[or]short fur covered[at random]"; [ skin Description, format as "You have (your text) skin"]
	now tail entry is "You have a sleek and beautiful equine tail stretching out over your well-rounded rear. Its silken-soft strands feel amazing on your sensitive [skin of Player] skin as they trail over your rear, the sensations of your tail trailing along behind you with every step making you shudder with ever-increasing arousal as it sways behind you in a sexy invitation to anyone who might be watching."; [ Tail description, write a whole Sentence or leave blank. ]
	now cock entry is "[one of]equine[or]horse like[or]blunt[at random]"; [ Cock Description, format as you have a 'size' (your text) cock]
	now face change entry is "it stretches forward, your mouth broadening as it fills with equine teeth and your nose flattening out into your new forming muzzle. New powerful scents fill your equine like nose as your eyes blur and shift position, and your ears reposition themselves on top of your changed head"; [ face change text. format as "Your face feels funny as (your text)." ]
	now body change entry is "it grows sleeker and sexier, your hips broadening and your legs and arms seeming to shift, the strange sensations causing you to moan with pleasure as you collapse to the ground. You feel increasingly aroused as your legs shift, and your feet melt into proper shiny silver hooves, and your hands seem to shift and your fingers shorten and your fingernails stretch out to cover the tips with surprisingly sensitive hoof-like tips. Your changes finally completely, you find yourself standing up easily on your new equine legs, your highly aroused body burning with desire as you look around, half hoping for a sexy horseman to show up to play with"; [ body change text. format as "Your body feels funny as (your text)." ]
	now skin change entry is "it seems to soften slightly and change in texture, the sensations causing you to shudder with pleasure as it feels like soft hands stroking all over your body as sleek new chestnut colored horsehair covers your body"; [ skin change text. format as "Your skin feels funny as (your text)." ]
	now ass change entry is "it rounds out into a properly plump shape, and your spine seems to tickle as long strands of hair begin to extend outwards from it. Their soft silken strands tickling your ass and inner thighs teasingly as a sexy equine tail forms behind you, hanging down to the back of your knees, its soft silken texture feeling surprisingly pleasurable as you swish it around experimentally a few times"; [ ass/tail change text. format as "Your ass feels funny as (your text)." ]
	now cock change entry is "it grows erect and aroused, before beginning to shift and change. The point of your cock broadening and flattening slightly into a rather blunt equine shape, while a proper sheath forms around the base of your cock, and a ribbed ring forms about halfway up your surprisingly slender new equine member"; [ cock change text. format as "Your cock feels funny as (your text)." ]
	now str entry is 18;
	now dex entry is 18;
	now sta entry is 26;
	now per entry is 14;
	now int entry is 10;
	now cha entry is 18;
	now sex entry is "Female";  [ Defines which sex the infection will try and make you. current options are 'Male' 'Female' 'Both']
	now HP entry is 80;
	now lev entry is 8;  [ Level of the Monster, you get this much HP if you win, or this much HP halved if you loose ]
	now wdam entry is 10;  [ Amount of Damage monster Does when attacking. ]
	now area entry is "Stable";  [ Current options are 'Outside' and 'Mall'. Case sensitive]
	now Cock Count entry is 0;  [ How many cocks will the infection try and cause if sex is 'Male' or 'Both']
	now Cock Length entry is 0;  [ Length infection will make cock grow to if cocks]
	now Ball Size entry is 0;  [ Size of balls ]
	now Nipple Count entry is 2;  [ Number of nipples infection will give you (males have nipples too) ]
	now Breast Size entry is 12;  [ Size of breasts infection will try to attain ]
	now Male Breast Size entry is 0;  [ Breast size for if Sex="Male", usually zero. ]
	now Cunt Count entry is 1;  [ if sex = "Female or both", indicates the number of female sexes infection will grant you.]
	now Cunt Length entry is 20;
	now Cunt Tightness entry is 6;
	now libido entry is 50;  [ Amount player Libido will go up if defeated ]
	now loot entry is "";  [ Loot monster drops, usually infective with the monster's _own_ strain (for example if there is a Cross-Infection from sex)]
	now lootchance entry is 0;  [ Chance of loot dropping 0-100 ]
	now scale entry is 3;  [ Number 1-5, approx size/height of infected PC body: 1=tiny, 3=avg, 5=huge ]
	now body descriptor entry is "[one of]sultry[or]sensual[or]curvaceous[at random]";
	now type entry is "equine";  [ one-word creature type. Ex: feline, canine, lupine, robotic, human... Use [one of] to vary ]
	now magic entry is false;
	now resbypass entry is false;  [ Bypasses Researcher bonus? true/false (almost invariably false) ]
	now non-infectious entry is false;
	now Cross-Infection entry is ""; [infection that this infection will give the player when they lose; can be left empty if they infect with the monster's own]
	now DayCycle entry is 0;  [ 0 = Up at all times; 1 = Diurnal (day encounters only); 2 = Nocturnal (night encounters only);]
	now altcombat entry is "default";
	now BannedStatus entry is false;

Table of New Infection Parts (continued)
Name	Body Weight	Body Definition	Androginity	Head Change	Head Description	Head Adjective	Head Skin Adjective	Head Adornments	Hair Length	Hair Shape	Hair Color	Hair Style	Eye Color	Eye Adjective	Mouth Length	Mouth Circumference	Tongue Adjective	Tongue Color	Tongue Length	Torso Change	Torso Description	Torso Adjective	Torso Skin Adjective	Torso Adornments	Torso Color	Torso Pattern	Breast Adjective	Breast Size	Male Breast Size	Nipple Count	Nipple Color	Nipple Shape	Back Change	Back Adornments	Back Skin Adjective	Arms Change	Arms Description	Arms Skin Adjective	Locomotion	Legs Change	Legs Description	Legs Skin Adjective	Ass Change	Ass Description	Ass Skin Adjective	Ass Width	Tail Change	Tail Description	tail skin adjective	Asshole Depth	Asshole Tightness	Asshole Color	Cock Change	Cock Description	Cock Adjective	Cock Color	Cock Count	Cock Girth	Cock Length	Ball Description	Ball Count	Ball Size	Cunt Change	Cunt Description	Cunt Adjective	Cunt Color	Cunt Count	Cunt Length	Cunt Tightness	Clit Size
--	--	--	--	--	--	--	--	--	--	--	--	--	--	--	--	--	--	--	--	--	--	--	--	--	--	--	--	--	--	--	--	--	--	--	--	--	--	--	--	--	--	--	--	--	--	--	--	--	--	--	--	--	--	--	--	--	--	--	--	--	--	--	--	--	--	--	--	--	--;

When Play begins:
	Choose a blank row from Table of New Infection Parts;
	now Name entry is ""; [matching infection name to Table of Random Critters]
	now Body Weight entry is 5; [scale of 1-9 for body weight, grouped into low weight (1-3), mid weight (4-6) and high weight (7-9)]
	now Body Definition entry is 5; [scale of 1-9 for body definition, grouped into low muscle (1-3), mid muscle (4-6), high muscle (7-9)]
	[Body Adjective is generated out of the body weight and body definition and can be used in scenes - one word descriptive adjective depending on weight and definition groups: low weight group: skinny/slender/lithe; mid weight group: average/fit/muscled; high weight group: pudgy/husky/jacked]
	now Androginity entry is 5; [1-9 scale of hypermasculine to hyperfeminine]
	[Gender Adjective is generated out of androginity 1-9: hypermasculine/masculine/effeminate/somewhat effeminate/androgynous/feminine butch/tomboyish/feminine/hyperfeminine]
	now Head Change entry is ""; [partial sentence that fits in: "Your head and face [one of]tingle[or]go flush[or]vibrate with odd pleasure[or]go cold[or]feel oily[at random] as [head change entry]."]
	now Head Description entry is ""; [partial sentence that fits in "Your face and head resemble that of [head description of Player] with [eye color of Player], [eye type of Player] eyes and an overall [gender appearance of Player] appearance."]
	now Head Adjective entry is ""; [one word descriptive adjective (avian/canine/...)]
	now Head Skin Adjective entry is ""; [one word descriptive adjective]
	now Head Adornments entry is ""; [partial sentence that fits in "Before moving on from your head, you give your [head adornments of Player] a proud glance followed by a light caress."]
	now Hair Length entry is 2; [hair length in inches]
	now Hair Shape entry is ""; [one word shape descriptor (curly/straight/...)]
	now Hair Color entry is ""; [one word color descriptor]
	now Hair Style entry is ""; [one word style descriptor (ponytail/mohawk/buzzcut/...)]
	now Eye Color entry is ""; [one word color descriptor]
	now Eye Adjective entry is ""; [one word descriptive adjective (slitted/round/...)]
	now Mouth Length entry is 3; [inches deep for face fucking; maximum possible will be double this number (when deep throating)]
	[Mouth Length Adjective  is generated by a function and can be used in scenes too - "petite, shallow, average, deep, bottomless"]
	now Mouth Circumference entry is 3;
	[Mouth Circumference Adjective is generated by a function and can be used in scenes too - "tiny, small, normal, wide, gaping"]
	now Tongue Adjective entry is ""; [one word descriptive adjective (wide/slobbery/...)]
	now Tongue Color entry is ""; [one word color descriptor]
	now Tongue Length entry is 3; [length in inches]
	now Torso Change entry is ""; [partial sentence that fits in: "Your torso [one of]tingles[or]goes flush[or]vibrates with odd pleasure[or]goes cold[or]feels oily[at random] as [Torso Change entry]."]
	now Torso Description entry is ""; [partial sentence, fitting in "Looking down at yourself, you appear [Body Adjective of Player], [Gender Adjective of Player] and your torso is [torso description of Player]."]
	now Torso Adjective entry is ""; [one word descriptive adjective (avian/canine/...)]
	now Torso Adornments entry is ""; [(pouch/udders/...); partial sentence to fit: "You take a moment to feel your [torso adornments of Player]."]
	now Torso Skin Adjective entry is ""; [one word descriptive adjective (furry/scaled/...)]
	now Torso Color entry is ""; [single word color adjective for the dominant color of the skin/fur/feathers/scales]
	now Torso Pattern entry is ""; [single word color adjective for the dominant pattern of the skin/fur/feathers/scales]
	now Breast Adjective entry is ""; [adjective(s) example: round, pointy, perky, saggy, bouncy. This would serve as either a general appearance of a infections breasts or possibly something that may be effected by a item or NPC.]
	now Breast Size entry is 0; [cup size as number, counting Flat Pecs = 0, A = 1, B = 2, ...]
	now Male Breast Size entry is 0; [cup size as number, counting Flat Pecs = 0, A = 1, B = 2, ...]
	now Nipple Count entry is 2; [count of nipples]
	now Nipple Color entry is ""; [one word color descriptor]
	now Nipple Shape entry is ""; [shape example: any shape will do as long as it has a baseline with a current infection or item]
	now Back Change entry is ""; [partial sentence that fits in: "Your back [one of]tingles[or]goes flush[or]vibrates with odd pleasure[or]goes cold[or]feels oily[at random] as [Back Change entry]."]
	now Back Adornments entry is ""; [partial sentence to fit: "Your back tickles with the feeling of movement caused by [back adornments of Player]."]
	now Back Skin Adjective entry is ""; [one word adjective (feathered/furred/scaly/...)]
	[Limbs Adjective is generated by a function and can be used in scenes too - "rail-thin, slender, sinewy, average, firm, muscular, flabby, meaty, rippling"]
	now Arms Change entry is ""; [partial sentence that fits in: "Your arms [one of]tingle[or]go flush[or]vibrate with odd pleasure[or]go cold[or]feel oily[at random] as [Arms Change entry]."]
	now Arms Description entry is ""; [partial sentence to fit: "Your [Limbs Adjective of Player] arms are [Arms Description of Player]."]
	now Arms Skin Adjective entry is ""; [one word adjective (feathered/furred/scaly/...)]
	now Locomotion entry is ""; [one word adjective: (bipedal/quadrupedal/serpentine/sliding)]
	now Legs Change entry is ""; [partial sentence that fits in: "Your legs [one of]tingle[or]go flush[or]vibrate with odd pleasure[or]go cold[or]feel oily[at random] as [Legs Change entry]."]
	now Legs Description entry is ""; [partial sentence to fit: "As your inspection goes even lower, you come to the two [Body Adjective of Player] legs supporting you. They are [legs description of Player]."]
	now Legs Skin Adjective entry is ""; [one word adjective (feathered/furred/scaly/...)]
	now Ass Change entry is ""; [partial sentence that fits in: "Your ass [one of]tingles[or]goes flush[or]vibrates with odd pleasure[or]goes cold[or]feels oily[at random] as [Ass Change entry]."]
	now Ass Description entry is ""; [partial sentence to fit: "Using your hands you feel your behind enjoying the sensation of your [Ass Width Adjective of Player], [ass description of Player]."]
	now Ass Skin Adjective entry is "";  [one word adjective (feathered/furred/scaly/...)]
	now Ass Width entry is 3; [ass width from 1-5]
	[Ass Width Adjective generated by function out of ass width: dainty/small/round/huge/enormous]
	[Ass Adjective generated by function out of body definition and ass width]
	now Tail Change entry is ""; [partial sentence that fits in: "Your rear [one of]tingles[or]goes flush[or]vibrates with odd pleasure[or]goes cold[or]feels oily[at random] as [Tail Change entry]."]
	now Tail Description entry is ""; [partial sentence to fit: "Just below your lower back sprouts a [tail description of Player], which you move back and forth with glee."]
	now Tail Skin Adjective entry is ""; [one word adjective (feathered/furred/scaly/...)]
	now Asshole Depth entry is 7; [inches deep for anal fucking;]
	[Asshole Depth Adjective is generated by a function and can be used in scenes too - "petite, shallow, average, deep, bottomless"]
	now Asshole Tightness entry is 3;
	[Asshole Tightness Adjective is generated by a function and can be used in scenes too - "tiny, small, tight, wide, gaping"]
	now Asshole Color entry is ""; [one word color descriptor]
	now Cock Count entry is 0;
	now Cock Girth entry is 0; [thickness 1-5, generates the Cock Girth Adjective]
	[Cock Girth Adjective is generated by a function and can be used in scenes too: thin/slender/average/thick/monstrous]
	now Cock Length entry is 0; [length in inches]
	now Cock Adjective entry is ""; [one word adjective: avian/canine/...]
	now Cock Change entry is ""; [partial sentence that fits in: "Your cock [one of]tingles[or]goes flush[or]vibrates with odd pleasure[or]goes cold[or]feels oily[at random] as [Cock Change entry]."]
	now Cock Description entry is ""; [partial sentence to fit: "You have a [Cock Girth Adjective of Player], [Cock Length of Player]-inch-long [cock adjective of Player] [one of]cock[or]penis[or]shaft[or]maleness[at random] that [cock description of Player]."]
	now Cock Color entry is ""; [one word color descriptor]
	now Ball Count entry is 0; [allowed numbers: 1 (uniball), 2 or 4]
	now Ball Size entry is 0; [size of balls 1-7: "acorn-sized", "dove egg-sized", "chicken egg-sized" "goose-egg sized", "ostrich-egg sized", "basketball-sized", "beachball-sized"]
	[Ball Size Adjective is generated by a function and can be used in scenes too]
	now Ball Description entry is ""; [partial sentence to fit: "Underneath it hangs a pair of [Ball Size Adjective of Player] [ball description of Player]."]
	now Cunt Count entry is 0;
	now Cunt Length entry is 0; [penetratable length in inches; some minor stretching allowed, or more with Twisted Capacity]
	now Cunt Tightness entry is 0; [size 1-5, generates adjectives of extremely tight/tight/well-used/open/gaping]
	[Cunt Tightness Adjective is generated by a function and can be used in scenes too: extremely tight/tight/well-used/open/gaping]
	now Cunt Adjective entry is ""; [one word adjective: avian/canine/...]
	now Cunt Change entry is ""; [partial sentence that fits in: "Your pussy [one of]tingles[or]goes flush[or]vibrates with odd pleasure[or]goes cold[or]feels oily[at random] as [Cunt change entry]."]
	now Cunt Description entry is ""; [partial sentence to fit: "You have a [Cunt Tightness Adjective of Player] [one of]cunt[or]pussy[or]vagina[or]cleft[at random] that is [cunt description of Player]."]
	now Cunt Color entry is ""; [one word color descriptor]
	now Clit Size entry is 0; [size 1-5, see Clit Size Adjective]
	[Clit Size Adjective is generated by a function and can be used in scenes: very small/small/average/large/very large]


when play ends:
	if bodyname of Player is "Mareslut":
		if humanity of Player < 10:
			if Player is female:
				say "     Finally unable to fight your new instincts any longer, you find yourself returning eagerly to the Stables, where you are sure you will find someone who will understand your bodies new instincts and needs. The guards at the door seem completely unsurprised at your return, and you wonder absently if they realized you were going to end up like this from the moment they let you bribe your way in. Grinning happily, you decide to 'thank' the guards properly later, just in case, and you give them an extra wiggle of your sexy hips as you saunter inside. Once inside the stables again, the scents of equine sex and leather fill your nose, and you find yourself whickering happily like a good little mare as you begin to feel like you have finally found your way home, enticing you to follow the scents deeper into the building. As you follow the scents of sex and musk further in, it isn't long before you encounter several of your fellow mares, who happily greet you and admire your fine new equine pelt as they lead you down the halls to a new room of your own, where several of them help you settle in with a nice and playful 'massage', their own hoof-like hands and equine tongues tracing over your body teasingly, even as you eagerly return your new herd mates attentions.";
				say "     Soon they have you nice and ready for your first set of 'Customers', and you find yourself whinnying with eager delight as you see the two guards you bribed on your first visit here come in with their large and proud equine erections obviously ready for use on your slutty mare-like body. Feeling happier and more aroused than you ever have been before, you eagerly go about presenting yourself for your first clients as a slutty mare whore, and as they fill your body with their large equine rods and you moan with the exquisite pleasure of being used like a proper slut. You find yourself knowing that they certainly are only the first of many clients you can look forward to servicing for the herd, and a silly grin crosses your now completely equine muzzle as you begin to look forward to all the many different beasts and creatures you will service, and especially all the handsome male equines! And who knows? Maybe eventually you will eventually become a slutty little brood mare for the herd, and have lots of little colts to play with! As these increasingly sexy scenarios wash over your mind, you give in completely to the pleasure, and surrender yourself completely to the powerful horses fucking your body, becoming just another happy, slutty mare whore for the clients to play with... and you love it!";
			else:
				say "     Finally unable to fight your new instincts any longer, you find yourself returning eagerly to the Stables, where you are sure you will find someone who will understand your bodies new instincts and needs. The guards at the door seem completely unsurprised at your return, though they do seem somewhat surprised at the cock dangling between your rather feminine mares legs. Their reactions causing you to grin with amusement as they usher you inside, one of them coming inside with you before heading off to get someone to come meet you. You are however too busy basking in the scents of equine musk and sex to think much of his actions, as the scents filling your head make you feel both welcome and aroused. You bask in the sensations for a minute, your cock growing nice and hard, and you are about to wander deeper into the stables again, when the guard returns with a powerfully built stallion, the close proximity of the far more powerful male making you shudder slightly as a wave of submissiveness washes over you. The Herd leader examines your mare like body and erect cock for a minute, before grinning with amusement, 'Yes I think we can find you a place here, plenty of our clients have, rather, 'interesting' tastes in their mares after all. And you should be able to help the rest of the mares learn how to please a stallion as well.' The powerful male says, his words making you smile hopefully, even as your body responds to his powerful dominant attitude.";
				say "     Soon at the herd leaders command, you find yourself led deeper into the complex, until finally several other mares come out to greet you and welcome you to your new home. Many of them eye your cock with a mixture of envy and interest as they explain to you that this floor is for those who service some of the more 'special' clients, often those with unusual or strange anatomy. Some of your fellow mares descriptions of their encounters are almost as strange as they are arousing, and soon you can't wait to meet your own first set of clients! Your first clients don't take long to arrive happily enough, and soon you find yourself enjoying all sorts of lovely sex games with a wide variety of creatures both equine and non, in all sorts of lovely positions! It isn't long before you become one of the more popular mares on your floor, though whenever you have a break from your clients, the other mares are more than happy to play with your rod for you as well! You find your lust-filled mind growing happier with your newfound status every day, and when there is a large influx of new soldiers to the stables, you are more than happy to make some into lovely little male mare sluts just like yourself! You just know they will come to love the changes just like you have... and it will be nice to have some more company to play with as well...";
		else:
			say "     When the rescue comes, you are more than eager to follow the handsome young soldiers to safety, though you find yourself idly wondering what several of them would look like as nice sexy mares instead. Still you are more than able to restrain yourself and play nice for the military scientist who take a quick look at you, the silly men obviously more interested in your sexy body and arousing scent than in their work, it is easy enough for you to change a few of their test results while they are distracted. This results in the military pronouncing you safe, and releasing you so they could focus their attention on more important matters like their stalled attempts to reclaim the city from the changed and infectious creatures now living there. Wandering through several cities you try your hands at several different jobs, growing increasingly frustrated and aroused as you do, before you end up transforming a cute girl you managed to talk into coming home with you one night into a lovely little mare as well. You find her looks even more arousing now, though she panics a bit at first, and you have to keep her with you in your apartment for several days of lusty sex before her first heat cycle kicks in.";
			say "     Watching as the formerly reluctant girl surrenders to her new equine instincts and moans with heat is surprisingly arousing. And as she moans and begs to be used like a little slutty mare and have her new large equine sex filled by an equally large cock, you begin to realize just how much potential this situation has. It isn't long before your first new mare is joined by several others, as you begin to build yourself a stable of lusty little mare sluts all your own, your new mares eager to serve you whenever you want, and spread their slutty little mares legs for anyone you want them to. Soon you have a thriving little business set up, and you troll the college bars most every night looking for just the right new 'recruits' to introduce to a life of equine sex and pleasure. Though the part you love most of all is watching as their lovely little tight pussies shift and change into large dark and wet mare pussies, their minds slowly warping and twisting under the pressure of their building equine heat, until they become perfect little maresluts for your herd...";

Mareslut ends here.
