Sarah by Sarokcat begins here.
[- Originally Authored By: Sarokcat&Hellerhound -]

Section 1 - Sarah and the Husky pack

Husky Pack is a situation.  The level of Husky Pack is 8.
the sarea of Husky Pack is "Outside".
when play begins:
	add Husky Pack to badspots of girl;
	add Husky Pack to badspots of furry;

instead of resolving a husky pack:
	say "Rounding the corner, you run right into the leader of a small husky pack, the fur cushioning the impact. You jump back as he snarls in your face, white and sharp teeth bared around a red tongue. You catch a glimpse of a thin human female on a reddish leash with a bone collar, probably from the neighborhood pet store, being dragged behind the alpha male.";
	say "Apologize and leave?";
	if the player consents:
		say "You bow low, and apologize for your insolence, saying that you will avoid their territory from now on. You turn and walk away, listening hard to see if they follow. Instead, you hear the moaning of the alpha and turn, surprised. He had climbed onto the human and was performing the classic husky victory dance. You watch as the human starts to change, and wonder if you should free her?";
		if the player consents:
			say "[sarahrescue]";
		otherwise:
			say "You watch as the woman transforms into another husky for the pack, hands becoming paws, head becoming canine, and her cunt becoming that of a desperate bitch. The alpha gets off and growls at you, spraying a small amount of saliva your way. You take the hint and leave quickly, trying not to break into a run.";
	otherwise:
		say "You ask who the captured human is. The alpha is rude, demanding who you think you are. 'Of course she is our new slut. What did you think? That she's gonna be the new President?'";
		say "Do you rescue her?";
		if the player consents:
			say "[sarahrescue]";
		otherwise:
			say "You leave her to her fate.";
	now husky pack is resolved;


to say sarahrescue:
	say "You jump forward, slamming the alpha out of the way and pick the woman off the ground, using her arm and not the leash. She smiles in gratitude for a second and you read her collar: 'Sarah'. But her expression quickly turns to one of fear and you turn, only managing to get halfway around before a particularly hard swat from the alpha husky sends you flying.";
	say "You struggle for breath, gasping as you stand, and the husky pays you no notice, dragging his sharp claws along Sarah's side. Blood wells up from the fearsome wound, and you are terrified that the husky just sentenced her death.";
	increase morale of the player by 10;
	say "You jump forwards and challenge the husky, and the pack closes in behind you.";
	challenge "Female Husky";
	if lost is 1:
		say "You fall to the huskies, and the alpha snorts at you, amazed that you would dare challenge him. He drags Sarah off, and the pack follows.[line break]It is a while before you manage to get up and walk away.";
		continue the action;
	challenge "Female Husky";
	if lost is 1:
		say "You fall to the huskies, and the alpha snorts at you, amazed that you would dare challenge him. He drags Sarah off, and the pack follows.[line break]It is a while before you manage to get up and walk away.";
		continue the action;
	challenge "Female Husky";
	if lost is 1:
		say "You fall to the huskies, and the alpha snorts at you, amazed that you would dare challenge him. He drags Sarah off, and the pack follows.[line break]It is a while before you manage to get up and walk away.";
		continue the action;
	if guy is not banned:
		challenge "Alpha Husky";
	otherwise:
		challenge "Female Husky";
	if lost is 0:
		say "Standing victorious, you grab Sarah, and carry her back to the bunker, and proceed to treat her wound. She changes under you, but with the medkit and a bit of skill manage to save her life.";
		if waiterhater is 0, wait for any key; [skips waiting if it's not wanted]
		say "You don't feel sorry for the huskies you left lying in the street. You think getting caught by some of the more dangerous beasts out there would be a fit punishment for what they tried to do.";
		now Sarah is in the bunker;
	otherwise:
		say "You fall to the huskies, and the alpha snorts at you, amazed that you would dare challenge him. He drags Sarah off, and the pack follows.[line break]It is a while before you manage to get up and walk away.";




Medkit Parts is a situation.
hasparts is a number that varies.

instead of resolving Medkit Parts:
	say "You find some parts for a medkit in the rubble of a nearby building. Maybe someone could put them together?";
	increase hasparts by 1;



Pet Shop is a situation.

instead of resolving a pet shop:
	if sarahslut is 2 and hp of Sven is 6:
		say "You manage to find your way back to the pet shop near where you rescued Sarah.  Reminded of your budding pets, you decide to have a look inside for something for them.  Unfortunately, the place is rather thoroughly looted, with the animal infected probably taking everything to placate their animal hungers or urges.  You do manage to find a few scattered collars lying around in the rubble.  You pick a grey, leather one with what smells like some husky cum on it.  Rinsing it off in a water dish in a busted cage, you get it clean, though it still smells a little of huskies, perfect for your little pet.  You find a second one, a baby blue one made of woven fabric with silver stars on it that fell in some spilled catnip.  Gauging it to be roughly his size, you decide it's perfect for your pretty kittyboi.  Taking a pair of the blank, heart-shaped tags, you use the press to punch the word [']SLUT['] onto Sarah's and [']FUCKTOY['] onto Sven's.  As you're operating the press, you spot an oversized toy mouse about the size of your fist lying beside it.  Tossing it and the water dish into the plastic bag, you put the new collars into in and head off, looking forward seeing how your pets will respond to their new roles.";
		now sarahslut is 3;
		now hp of Sven is 7;
	otherwise if sarahslut is 2:
		say "You manage to find your way back to the pet shop near where you rescued Sarah.  Reminded of your husky pet, you decide to have a look inside for something for her.  The place is rather thoroughly looted, with the animal infected probably taking everything to placate their animal hungers or urges.  You do manage to find a few scattered collars lying around in the rubble.  You pick a grey, leather one with what smells like some husky cum on it.  Rinsing it off in a water dish in a busted cage, you get it clean, though it still smells a little of huskies, perfect for your little pet.  Taking one of the blank, heart-shaped tags, you use the press to punch the word [']SLUT['] onto it.  Along with the water dish, you toss it into a plastic bag and head out, eagerly looking forward to what she'll play like with it on.";
		now sarahslut is 3;
	otherwise if hp of Sven is 6:
		say "You come across a small pet shop and are reminded of your new, feline pet.  Deciding to have a look inside for something for him, you cautiously take a look around.  It has been rather thoroughly looked by the infected hordes.  You can imagine many of those infected by pets desiring the shop's contents to satisfy their animal urges.  You do manage to find a few scattered collars lying around in the rubble.  You pick up a baby blue one made of woven fabric with silver stars on it that fell in some spilled catnip.  Gauging it to be roughly his size, you decide it's perfect for your pretty kittyboi.  Taking one of the blank, heart-shaped tags, you use the press to punch the word [']FUCKTOY['] onto it.  Beside the press, you spot an oversized toy mouse about the size of your fist and toss it along with the collar into a plastic bag to bring as gifts for your playful pet.";
		now hp of Sven is 7;
	otherwise:
		say "You spot a small pet shop, but a quick glance inside the smashed windows shows that pretty much everything of value has been looted from the place already.  Glancing across the street, you see a [one of]bank branch[or]electronics store[or]cell phone store[or]computer store[or]jewelry store[at random] that has been left untouched.  Chuckling a little at the strange priorities of the looters, you continue on your way.";
	if hp of Sven > 6 and sarahslut > 2, now Pet Shop is resolved;




Sarah is a woman.
sarahtalk is a number that varies.
sarahslut is a number that varies.
shortonparts is a truth state that varies.  shortonparts is normally false.
The description of Sarah is "A thin woman, with husky fur, a lolling tongue, and paws. There are white scar lines down her side where the huskies slashed her, and she has the slit of one of the feral bitches, just waiting to be filled. Her red collar stands out, with its leash ring on the back and the nameplate on front. [sarahslutstate][sarahpupstate]".
The conversation of Sarah is { "Woof!" }.

instead of sniffing Sarah:
	say "She smells like a [if sarahpregnant is not 0]pregnant, [end if]horny husky[if sarahslut > 2].  The scent of her arousal is quite strong from your lustful pet bitch[end if].";

to say sarahslutstate:
	if sarahslut is 0:
		say "She is having trouble with the husky instincts, but looks dominant for now, even wearing a red shirt and a pair of jeans.";
	otherwise if sarahslut is 1 or sarahslut is 2:
		say "She has submitted to most of her bestial needs, wearing nothing and dripping onto the floor, making the puddle larger, but some human side of her is still struggling for control.";
	otherwise if sarahslut is 3:
		say "She keeps sliding her collar back and forth, and lubricating it from the slime that has formed on the floor where her dripping cunt has been. Looks like all she needs now to complete the look is the leash.";
	otherwise if sarahslut is greater than 3:
		say "She whines at you, spreading her legs to show her aching slit, and pulls against the leash you pegged her to the wall with, desperate for satisfaction.";
	if sarahslut is greater than 2:
		if sarahpregnant is greater than 0:
			say "She smiles faintly, all dreams of humanity gone from her mind, rubbing her bloated belly. Her fur is matted from many sex acts without cleaning, and her collar, reading 'slut' on either side, is a testament to her state.";
		otherwise:
			say "She smiles faintly, all pretensions of humanity gone from her mind, as she rubs her needy slit and large breasts. Her fur is matted from the many sex acts without cleaning, and her leash, reading 'slut' on either side, is a testament to her state of mind.";


instead of conversing the Sarah:
	increase sarahtalk by 1;
	if sarahtalk is 1:
		say "'Hello. My name is Sarah, and thanks for rescuing me form those darn huskies back there. I used to be a medic, [bold type]so if you happen to find any medkit parts I could put them together for you[roman type]. I really do appreciate the help, and I hope I can provide you with a lot of help in the meantime, until the rescue comes. Please fill my cunt!' She moans, then regains control of herself. 'Damn those huskies.' Regaining her train of thought, she looks up at you and smiles. 'I used to work at the hospital, in the ER general ward, where they treated those who hadn't hurt themselves so badly they needed a specialist,' she says as she runs her new paw-like hands down her body, 'so I'm sure I can be of great help to you as well.'";
	otherwise:
		if sarahslut < 4:
			if hasparts is 0 or ( hasparts is 1 and shortonparts is true) :
				if sarahslut < 3:
					say "[one of]'Please fuck me, I need Oh sorry. Lost control of myself there.'[or]'Mmmm huskies.'[or]'I guess you are the alpha here.'[or]'I can make some medkits if you had parts.'[or]'Have you seen any spare medkit parts out there?'[or]'This place is wonderful. Why didn't I come here?'[or]'Thanks for saving me!'[or]Sarah moans, rubbing her dripping slit.[at random]";	[todo]
				otherwise:
					say "[one of]'Fuck me again master!'[or]'Please take me now!'[or]Sarah moans, rubbing her slit and dripping everywhere.[or]'Fill me!'[or]'Use me like the bitch I am.'[or]'Master, please use your slut!'[or]'I just love being your bitch.'[at random]";
			otherwise if hasparts is 1:
				say "Sarah hmms as she looks over the medkit parts you've found, running her white paws over them.  'You've got some parts here, but not quite enough to make a full medkit.  See if you can find some more around.'";
				now shortonparts is true;
			otherwise:
				if hasparts is 2 or hasparts is 3:
					say "Sarah coos in delight, running her white paws over some of the more unusual parts you found. 'This will make a great medkit,' she exclaims, managing to fit them back together. She hands you a medkit in return.";
				otherwise if hasparts < 8:
					say "Sarah looks at the parts with longing, and grabs them before you can hand them over. In short order you are handed back a few medkits, the most she could make.";
				otherwise:
					say "Sarah's eyes goggle out and her face turns pale at the size of your stockpile. She dives right in and begins to sort them, arranging them by type, and builds many medkits out of what you found.";
				let madekits be hasparts / 2;
				increase carried of medkit by madekits;
				decrease hasparts by madekits * 2;
				now shortonparts is false;
		otherwise:
			if hasparts is not 0:
				say "The sight of medkit parts does little to free her submitted mind, and she ignores them to keep rubbing her dripping slit.";
				now hasparts is 0;
			otherwise:
				say "[one of]'Fuck me again master!'[or]'Please take me now!'[or]Sarah moans, rubbing her slit and dripping everywhere.[or]'Fill me!'[or]'Use me like the bitch I am.'[or]'Master, please use your slut!'[or]'I just love being your bitch.'[at random]";



lastsarahfucked is a number that varies. lastsarahfucked is usually 250.

instead of fucking Sarah:
	say "[sarahfucking]";

to say sarahfucking:
	if lastsarahfucked - turns is less than 4:
		say "'Sorry master,' Sarah moans as she looks at you with her lust-filled eyes, the husky bitch moaning as she slowly rubs herself. 'But even I can't manage to recover this fast, I wouldn't be able to do our time together justice.' She pants out even as she rubs herself. 'I should be ready for you soon though, so please don't leave me here alone for long.' Your new bitch says as she tries to relax some so she can be ready to please you sooner.";
		stop the action;
	if sarahslut is 0:
		say "You approach Sarah, her needy husky scent filling the bunker and ensuring you have sex on the mind. She seems rather reluctant as you approach, her pawlike hands fingering her new found clothing. It's as if aware that once she has taken them off this time, she won't have any desire to put them back on again. Her slight reluctance makes you pause for a minute as you realize just how close the intelligent woman is to giving in to the desires of the needy husky bitch she has become. While she is reluctant right now, you know from watching her that with only a few soft touches, you could have her writhing underneath you willingly, her needy bodies new instincts overriding her brain and reducing her to little more then your pet as you play with her sexy body. Still, she might be better off if you left her to try to manage her new instincts alone, but the thought of her submitting to you is extremely arousing to your already sex-filled mind.  Do you decide to fuck her needy body anyways?";
		if player consents:
			say "Deciding that the opportunity she presents is just too tempting to not take advantage of, you stalk towards the tempting little husky, enjoying the lust-filled look in her eyes even as she tries to resist the strong urges of her newly-changed body. She puts up little resistance as you slowly tug her shirt up and off her body, your hands running through her fur and teasing her soft breasts even as she pants in increasing need. You find the entire situation increasingly erotic as you continue to tease the increasingly horny bitch, her hands starting to stroke your strong body in return.  Capturing one of her hands, you guide it down to the latch of her jeans, letting it go there and leaving her to take that final irrevocable step of baring herself purposefully to you.  Sarah whines in need as you tease her body, before finally giving in to the need that her body is telling her is so right, and unlatching her jeans for you. You grin in triumph as you reach down and slowly tug them all the way off of her body, enjoying the sight of her wet, needy husky pussy revealed for you to play with.[line break]";
			increase sarahslut by 1;
			now lastsarahfucked is turns;
			if cocks of player is greater than 0:
				say "Deciding to take proper advantage of this situation, you slowly push her down onto her back, stroking your cock several times so she can watch. You enjoy the way her eyes stay fixed on your [cock of player] member even as you slowly move over her prone form. Your hands and tongue trace over her body as you tease her until she begs for you to fill her up with your wonderful rod.  Taking your time to enjoy the situation to the fullest, you continue to tease her with your hands and mouth for several seconds. Your cock rubs up against the inside of her softly furred thighs and only lightly touches her crotch as you play with your hot little bitch.  Soon, she is panting and whining like an animal in heat, unable to even form proper words anymore, and you find that somehow this excites you even more as you reduce her to little more then a submissive slut underneath you.  Finally, you decide to give her the lovely dog treat she has been begging for, and groan in pleasure as you sink your cock into her damp folds. She moans and yips in pleasure as your cock fills her, and you grip her tightly as you begin to thrust into her roughly, unable to hold out much longer after the long foreplay.  Your mind is fogged with need and lust as you pump your cock into her, finally crying out as you spill your seed into her all-too-willing womb, leaving your mark of ownership deep inside her body.  Panting you slowly gather your wits about you and you grin to realize that Sarah is practically delirious underneath you, her tongue lolling out of her open mouth as her eyes stare up dreamily at the ceiling. You feel somewhat smug as you pull yourself off the well fucked husky bitch, somehow sure this will change her outlook on being a lovely little husky dog for good.";
			otherwise:
				say "Enjoying the look of her soft pussy, you decide to give her new husky passage the proper attention it deserves. You slowly push her down so she is lying on her back on the ground, looking up at you apprehensively.  You grin at the new bitch's uncertain look and decide to teach her how to properly enjoy her pussy, since she has obviously been neglecting her needs since her change. Grinning, you lower your head down between her legs, rubbing your cheeks along the soft fur of her thighs and making her pant as you tease her even further. Your tongue darts out and you slowly trace it along the outside of her lips, making her shudder as her delicious needy flavor fills your mouth.  You enjoy her reactions as you slowly begin to lick her soft pussy, your tongue probing further and further inside her with every slow sensual stroke. Sarah begins to moan and whine in need, obviously unable to form proper speech anymore as you tease and excite her body.  The thought of reducing her to the role of a proper animal excites you almost as much as her lusty scent and delicious taste, and you find yourself licking even faster, occasionally teasing her clit with your teeth as she shudders in pleasure.  Soon enough, the new bitch gives in as you help her embrace the slutty animal she has become, and she cries out in orgasm, her fluids rushing across your tongue in a burst of pleasure as she spasms underneath you.  Sarah then collapses limply on the ground, her tongue lolling out of her open mouth as her eyes stare up dreamily at the ceiling. You feel somewhat smug as you pull yourself away from the exhausted husky bitch, somehow sure this will change her outlook on being a lovely little husky dog, and glad you were able to help her get in touch with the slutty little bitch she really is now.";
		otherwise:
			say "Deciding it might be better to have a companion instead of just a slutty husky to keep you company, you decide to leave it at just friends, backing off and letting her regain her composure.  The fine-looking husky bitch can definitely be your best friend at least, and who knows, you might change your mind and give her a little 'training' later on anyways...";
	otherwise if sarahslut is 1:
		say "Taking a look at the fine husky bitch you brought back from the city, you notice she has stopped any pretense of wearing clothing. And she seems to be spending more and more time masturbating, filling the air with her needy scent and probably thinking of the wonderful time you gave her recently. You suddenly find yourself realizing what a fine pet she would make with a little 'training'. With her natural tendencies and her needy, new body, you could probably shape her into a wonderfully submissive little sexpet.  The thought of an eager little husky bitch, happily submitting to your every whim and need, makes your body even more excited as you stare at her with a new interest.  Do you go ahead with your plan to tame yourself a bitch?";
		if player consents:
			say "Sarah looks up at you in surprise as you approach her, your intent clear in your eyes. The husky shudders, knowing what is coming, but doesn't protest in the least.  Her body shudders in need as you move up next to her. Her new form makes her crave your touch even as her mind tries to hold on to some last remnants of its former self. You quickly settle any possible resistance she might offer by running your hands along her soft sides, causing her to pant in need as your hand slowly reaches her crotch and traces along the outside of her damp passage. Grinning, you bring your mouth up close to her ear and whisper into it in a soft sensual voice. 'You want this don't you?' you say in a coaxing tone, making her moan as you tease her heat-flushed folds with your hand. 'You want to give in to what your body wants and let me fuck you like you deserve don't you?' you tease as she moans in need, her head nodding almost automatically. 'More than that though, you want to me to take you and make you my pet, don't you? To be a slutty little pet for me to fuck as often as I want. Isn't that right?' you ask in a low voice even as your hands continue to tease her body, keeping her highly aroused.  'Yes, please! Make me your pet! Just please fuck me!' Sarah cries out, her eyes crossed with lust as she pants under your hands. Her admission pleases you as you begin to get to the matter at hand.[line break]";
			now lastsarahfucked is turns;
			increase sarahslut by 1;
			if cocks of player is greater than 0:
				say "You grin as you move behind her, enjoying her moans of submission as your hands continue to roam across her body. You decide to rub her new position in even more as you slowly push her down onto all fours.  Sarah moans as she realizes your intent, looking back at you over her shoulder as you stroke your cock several times before running its tip over her soaked entry, grinning at how wet your new pet is for you already.  Deciding not to waste any time enforcing the new status quo, you grip her thighs with your hands, lifting her up slightly until she is perfectly positioned. Pressing your cocktip to the lips of her vagina, you swiftly bury yourself inside her with one sure thrust, your throbbing meat filling her up to the brim and causing her to cry out in pleasure. Her depths are warm and welcoming, and you can't help but enjoy the glorious sensation of being buried to the hilt in her soft body.  Gripping her hips, you begin to thrust forward into the lovely bitch. Your every stroke makes her yip and pant in pleasure, her body rocking forward in time to your thrusts. You can feel your peak growing ever closer as you thrust into her eager form, but you still need to do one more thing before you fill her body with your seed, one last bit of icing on top of the cake. Leaning down, you nibble softly on her ear. 'Moan for me,' you whisper, knowing she will hear you easily. 'Beg me to fill you up and make you my pet. You know you want it. Just say yes and I'll make sure you get what you need.' you tease, slowing down your thrusts leaving her right at the peak of orgasm.  You aren't disappointed and with almost no hesitation Sarah is crying out and begging for your seed, begging and whining for you to take her like the animal she now admits she is.  Unable to hold back any longer, you thrust into her forcefully a few more times, before crying out as you spill your load into her eager body, making her shudder in orgasm underneath you.  Completely spent, you pull yourself out of her exhausted body, letting her slump to the floor as she moans out your name over and over again like a good little pet, you know you still have a ways to go to make her a proper pet, but you definitely feel like this was a good start.";
			otherwise:
				say "You grin as you move behind her, enjoying her moans of submission as your hands  continue to roam across her body. You decide to rub her new position in even more as you slowly push her down onto all fours, moving her tail aside to expose her dripping wet cunt.  She glances back at you over her shoulder, unsure of your intent, and you find yourself smiling at the fun to come.  You slowly run your fingers over her cunt a few more times, making her shudder, before slowly pushing one of your fingers inside her body. Sarah shudders and lowers her head down as her tight passage grips your finger like a glove. You push more of your finger into her, then slowly draw it back out.  You continue to explore her damp passage, first with one finger and then with two, as you move up along side her body. Her wet juices coat your hand completely as you stroke her soft insides.  She gasps and whines in pleasure as you use your free hand to slowly begin stroking the fur along her back, teasing and stroking her just like you would a dog, even as you bring her body ever closer to orgasm.[line break]";
				say "Deciding to make this moment even more complete, you lower your head down close to her ears, and whisper into them in a low sexy voice, 'Look at you on all fours like this, just like a proper bitch. You enjoy getting petted, don't you bitch? You want to be just a lovely little pet for your master don't you?' You moan into her ear, the situation getting you almost as worked up as she is. To prolong the moment, you slow down your teasing of her pussy, and increase your stroking of her back, occasionally pausing to give her a soft scratch in several sensitive locations while she tries to pant out an answer.  'Yes, please!' she finally manages to respond, panting incoherently, 'I want to be your pet. Please, Master, make me yours!' she cries out, finally beginning to accept her role as the animal she now is.  You shudder in pleasure at her eager response, and reward your new bitch by gripping the scruff of her neck with the hand you had stroking her, even as you plunge your fingers in and out of her even more vigorously.  She stiffens under your renewed assault on her body, before howling out in pleasure as a powerful orgasm shakes her body to the core.  You groan in pleasure as well, nearly orgasming yourself from the intense sexual situation.  When done, you slowly release her body, letting her slump bonelessly to the floor. You smile at her as she lies there on the floor of the bunker, moaning out her new name for you over and over again like a good little pet. Her soft cries of 'Master... my Master,' filling your heart with joy.  While you know you still have a ways to go to make her a proper pet, you definitely feel like this was a good start, and you almost can't wait for the next step.";
		otherwise:
			say "You grin at her new attitude and decide to let her stew in her own juices for a while longer, and maybe enjoy her once she has managed to calm down and regain a bit of her humanity... if she ever does.";
	otherwise if sarahslut is 2:
		say "Deciding to see if your new bitch is ready for another session, you look at her speculatively and note with amusement that some small human part of her is still fighting for control, even as she rubs herself in need.  You decide it is time to teach Sarah another lesson about the proper role of a pet, and begin to stalk towards her slowly, making your intent obvious. Her eyes quickly go large as they latch on to you, but she no longer puts up any pretense of not wanting or needing what you plan to give her, indeed her body begins to quiver eagerly as she anticipates the fun to come.  Grinning at how easily her mind begins to slip back into the proper submissive role of a slutty pet, you slowly stroke her soft fur as you move right in front of her, before pulling her muzzle close for a deep kiss, her tongue twining with yours as you enjoy the feel of her body pressing up against your own.  Breaking the kiss, you slowly place your hands on her shoulders and begin to push her down slightly, Sarah looks at you in puzzlement as you slowly guide her down on her knees in front of you, only to have her eyes go wide as she realizes she is now staring right up into your crotch.[line break]";
		now lastsarahfucked is turns;
		if cocks of player is greater than 0:
			if cunts of player is greater than 0:
				say "You grin as you reach down to stroke your erect member a few times, her eyes locked on your stiff rod only inches from her face.  Deciding to tease her even further, you lean forward slightly and slowly rub the tip of your cock over her nose, filling her husky senses with the scent of a strong erect male.  Sarah moans, her eyes half closing as your musky scent works its way through her body, and you grin as the sight of her on her knees before you in such a submissive manner makes your own pussy clench eagerly in response. You continue to slowly stroke your member, teasing her with it's nearness even as you enjoy her response, her bodies desires quickly overcoming any possible mental objections as she slowly moves forward and stretches her tongue out to taste your shaft. Her wonderfully soft tongue makes you groan as it licks over the tip of your member several times, before she leans forward to take your member into her eager muzzle. The feel of her mouth wrapping around your member is heavenly, made all the sweeter by having your pet submit and worship your cock with hardly any encouragement from you at all.[line break]";
				say "You reward your pet by beginning to stroke her soft headfur with your hands, rubbing and scratching at her head in encouragement even as she focuses on licking and sucking at your cock.  You groan in pleasure as she brings her front paws up, one of her husky like paws slowly fondling your full sac, teasing your balls with her soft touches.  You find yourself throwing your head back, your eyes rolling up in pleasure as her other paw finds its way to your own wet needy slit underneath your balls. You pant and grip her head tightly as she begins to tease your female passage with her paw, even as she suckles wantonly on your thick cock.  The combined pleasure is too much for you to stand for long, and before you know it, your body is shuddering as you flood her eager mouth with your seed, your pussy clenching around her paw as your juices coat it thoroughly as well.  You pant in the aftershock of the powerful orgasm, even as the talented bitch tries to lick up and swallow as much of your glorious seed as possible. Coming down from the intense pleasure, you realize that even though that experience was absolutely amazing, it still shows a bit of defiance in your new pet that you might need to deal with properly. You realize that something is missing to complete this next step of her training, a more visible show of your ownership might be needed, a collar perhaps?";
			otherwise:
				say "You grin as you reach down to stroke your erect member a few times, her eyes locked on your stiff rod only inches from her face.  Deciding to tease her even further, you lean forward slightly and slowly rub the tip of your cock over her nose, filling her husky senses with the scent of a strong erect male.  Sarah moans, her eyes half closing as your musky scent works its way through her body, and you take advantage of her half open mouth to slowly rub your cock alongside her muzzle.  Her body needs no further prompting to get the hint, even if her mind is still a few steps behind, and before you know it she has wrapped her eager muzzle around your thick shaft, making you moan in pleasure as she begins to suck and lick on your strong maleness.  You find yourself groaning as the husky quickly gives herself over to pleasuring you, your hands reaching down to stroke and pet her furry head even as she focuses her attentions on your shaft. You can feel her need building as she gets more and more of a taste of your [cock of player] cock. She groans and brings her hands up even as she leans forward, bracing herself on your hip with one hand, as her other hand comes up to work and tease your balls, rubbing her soft paws over your thick sac as if begging you to shoot all that seed into her waiting mouth.  Feeling the pressure rising, you know you won't be able to hold back much longer under the assault of her talented mouth, and use your hands to pull her off of you at the last minute, the husky almost begging to have your cock in her mouth again.  Groaning you lower one of your hands down to your cock again, the other still holding your new pet in place, pumping your cock a couple of time, you cry out as you orgasm, shooting your thick seed all over your pets face, pumping strand after strand of your white gold all over her body, marking her as your pet.  Sarah seems to get the message, panting eagerly and acting like a good little pet even as she tries to lick up every drop of your wonderful seed that she can reach.  Still you see a spark of defiance left in her eyes, you think you might need something more tangible to prove your dominance over your new pet now and forever, perhaps she needs a nice new collar to show her new status?";
		otherwise:
			say "You find a smile crossing your face as you reach down to stroke your damp pussy a few times, her fascinated gaze following your every movement as you slowly rub your fingers into your wet pussy.  Drawing them out slowly so she can see your needy juices coating your fingers, you slowly bring your fingers forward and rub them across her muzzle and nose. Almost automatically Sarah licks her lips, tasting your juices even as your aroused scent explodes through her heightened senses. The look on her husky face makes you grin as she pants in need, her muzzle drawing ever closer to your crotch as she begins to lean even closer.  Deciding to help speed up this lesson in how to properly please her master, you reach down and push softly on the back of her furred head, guiding her muzzle right up to your damp pussy. 'Now pleasure your mistress little bitch,' You whisper down to your needy pet, 'It's time for you to learn how to put that longer tongue of yours to work properly,' You continue, your words seeming to excite the husky even further, as she begins to lick at your wet snatch eagerly.";
			say "You groan in pleasure as she laps at your female sex, her tongue pressing into you again and again as she begins to truly give in to her desires to serve her mistress.  You find yourself burying your hands in her soft headfur, pressing her muzzle up against your crotch as she licks and nibbles at you, causing you to begin to buck and moan softly in pleasure. Your bitch truly is getting into the act, as she brings her paws up to stroke and tease your sensitive thighs and clit even as she applies herself to your pussy. Soon you can't restrain your pleasure any longer, and you cry out as you orgasm under the touch of her eager tongue and paws, your juices exploding over the husky's muzzle even as she gasps out in orgasm underneath you, spilling her own juices onto her thighs and the floor.  'Good little pet, did you enjoy your treat?' you ask her even as you come down from your own amazing orgasm, Sarah nods eagerly, even as she licks her muzzle to capture every last drop of your wonderful flavor.  Still it seems something is missing to you as you look down at your eager pet where she rests before you on her knees, you need something more to make her complete, to insure that she is your pet totally and completely... perhaps a nice collar to proclaim her new status as your slut and pet?";
	otherwise if sarahslut is 3:
		say "Sarah's eyes brighten in anticipation of another 'training' session as she sees you coming towards her, and you can tell her body is already beginning to grow hot with need. You grin as you slowly move up to her, reaching back and pulling the collar you found at the pet store out slowly, making sure it catches her eyes. Sarah's gaze latches onto the collar almost immediately, her body stilling as she watches the silver clip flashing and glinting in the light, and realizes that this time things will be different. 'What do you say?' You ask her as you hold the collar up for her inspection, the word 'slut' glinting off the side of the collar as you hold it up in front of her.  'Will you let me put this collar on you? Mark you as a proper pet and husky like you know you want me to?' You say as you dangle the collar in front of her fascinated gaze. 'If you put this collar on, you show everyone what a good little husky slut you are, now and forever, you give up your old life for a new one full of fun and fucking, doesn't that sound wonderful?' you say in a low tone, grinning as she nods slightly, her mouth open and panting, while her paws drop to her leaking pussy in need.  'What do you say? Should I put it on you?' you ask her teasingly as you bring the collar up close to her neck.  You grin in triumph as the husky bitch nods eagerly, lowering her neck down so you can slip the collar  around it with ease, you latch your pets new fashion accessory around her neck tightly, ensuring that it won't ever come off, and then arranging it so the word slut is prominently displayed for all to see. 'There now,' You say proudly as you rub her headfur lightly, 'That's a good little pet, and now I think you have earned a little reward...' You say with a grin, making her eyes light up at the praise and the promise of a treat.";
		increase sarahslut by 1;
		now lastsarahfucked is turns;
		if cocks of player is greater than 0:
			if cunts of player is greater than 0:
				say "Deciding to make sure your pets complete surrender is a memorable occasion, you slowly push her down to the ground, her eyes flashing eagerly as she moves to obey her new master.  You grin as you move your body around, her head positioned directly underneath you as she stares up at you curiously. Your pet quickly gets the idea as you begin to lower yourself down towards her muzzle. She moans and licks at your pussy and cock eagerly as they come down within range of her muzzle, making you shudder in pleasure for a minute, before slowly lowering yourself down over her own female husky form. You and your new pet both moan in pleasure as your [skin of player] skin brushes up against her soft chest fur, your breasts rubbing up against her stomach softly even as you lower your mouth down to her swollen pussy.  Your nose filled with her strong heat filled scent, you slowly trace your tongue over her sensitive lips, making her cry out underneath you.  The newly collared slut swiftly reapplies herself to your own sensitive parts, alternatively licking your damp pussy, and sucking and licking your stiff member. The feel of both your sexes being pleasured makes you moan in joy, experiencing the pleasure only a truly dominant herm can feel as you begin to lick and nibble on your pets own female sex. You both moan in pleasure as your bodies writhe together in pleasure, each of you attempting to make the other one orgasm, your pet has the slight advantage in that she has twice as many sensitive regions to play with, but you prove your dominance and experience as you wring a powerful orgasm out of your new pet.  The feel of her body spasming underneath you as proof of her complete submission to your dominance sets off your own orgasm as well, your cock and your pussy both spilling their liquid all over your new pets face.  Spent and still shuddering from the aftershocks of your orgasm, you pull yourself off your new slut and take a look down at her prone form, she just lies there happily spent on the bunker floor, her face and chest covered in your sticky fluids, and her eyes nearly vacant from pleasure. Looking her over you feel a bit of pride to see that she seems to have finally completely accepted her role as a pet and your own private slut.";
			otherwise:
				say "Deciding to make sure your pets complete surrender is a memorable occasion, you slowly push her down onto her back, eager to introduce her to her new position as a proper pet by filling her womb with your strong fertile seed. You grin as she spreads herself before you, her new collar shining brightly around her neck as she finally gives into her animalistic need to be owned and used by a strong alpha. Your new pet eagerly spreads her legs for you without any prompting, seeming to fully embrace her new role instead of fighting it now that she is properly collared. You spare a moment to admire her fine husky body, soft and sweet and so very heat filled, before you move up between her legs, your stiff [cock of player] cock rubbing up against her heat filled passage and making her whine softly with need. Not one to leave a horny bitch unattended, you pull her hips towards you even as you push yourself into her soft body.[line break]";
				say "Your new pet gasps and clutches you tightly, as you fill her up in one sure stroke, lowering your head to her shoulder you begin to rock your hips against hers, your cock moving within her soft body, and making her pant and gasp with every rough movement. Her soft fur rubbing up against you is sheer pleasure, even as her every soft pleading noise begs for you to fill her body up with your fertile cum. Her arms wrap around your shoulders as she holds onto you tightly, completely giving herself up to the carnal pleasure of the act of mating, your orgasm drawing ever closer as you prepare to give her body the life giving cream it so desires.  Finally unable to hold back any longer, you shout out your pleasure to the stone walls of the bunker as you fill your new pets needy womb up with your sperm, triggering her own powerful orgasm, and sealing her fate forever as just a happily fucked little husky pet, her only purpose in her new life to bring you pleasure and bear your pups...";
				increase sarahpregnant by 24;
		otherwise:
			say "Deciding to make sure your pets complete surrender is a memorable occasion, you slowly push her down to the ground, her eyes flashing eagerly as she moves to obey her new master. Grinning you slowly move between her legs, your hand rubbing across her damp pussy for a minute to ensure she is well and truly excited. You slowly crawl over her body, giving your new pet a good look at your female attributes, as you slowly position your damp pussy above her face. Your new bitch licks her lips even as you adjust your position so you are looking back down her body, 'Good little bitches get to taste their mistresses,' You say to the excited husky underneath you, as you slowly lower your pussy down to her muzzle, moaning as she begins to lick eagerly at your already damp lips. 'Very good little pets get to have their mistresses lick them as well,' You murmur as you carefully lie down across her soft furred form, your face coming to rest just above her pussy as you brace yourself on your arms above her.[line break]";
			say "Your pets body tenses in anticipation and joy as she realizes what a lovely reward she is about to get for her submission, then she shudders as you slowly run your tongue over her heat swollen mound.  You tease her clit with your teeth lightly, nibbling at the edges and making her gasp in pleasure, her soft cries muffled by your own pussy, as she dives back into her licking of your own soft walls.  Groaning at the touch of your pets talented tongue, you begin to lap and suck at her own passage, teasing her inner walls with your tongue even as your bodies begin to rub together in pleasure.  You lose track of time as you play with and tease your pet, the mutual pleasure washing away all other petty concerns as you celebrate your pets new permanent status together.  Finally though your body explodes in pleasure, as your pets tongue finally brings you to the orgasm you have been building up towards, your juices washing over her muzzle and face even as she continue to lap happily at you.  You reward your pet with several strong licks, bringing her an orgasm of her own and making her shudder and gasp happily underneath you as you enjoy her own unique flavor.  Eventually spent, you pull yourself off your new pet, who just lies there happily spent on the bunker floor, looking her over you feel a bit of pride to see that she seems to have finally completely accepted her role as a pet and your own private slut.";
	otherwise if sarahslut is greater than 3:
		now lastsarahfucked is turns;
		if sarahpregnant is greater than 0:
			if cocks of player is greater than 0:
				if cunts of player is greater than 0:
					say "Approaching your pet, you smile as you see her rubbing her belly, its visibly swelling bulge proof of your earlier prowess and mastery of her body.  Your pet seems happy and eager to please leaning back as she props herself up on her elbows, presenting her rather full body for your inspection.  Your eyes resting on her soft belly full of your pups, you smile and stroke her soft belly fur for a minute, making her moan, before switching your attentions to her nice breasts, even larger now as they fill with milk for the pups.  Deciding you like what you see, you slowly move yourself over her soft body, until you are situated just above the swell of her belly, your erect [cock of player] cock nestled perfectly between the swell of her breasts, and your pussy rubbing up deliciously against the soft fur of your pets chest. You moan in pleasure and anticipation as you begin to slowly rub your [cock of player] member up against the soft fur between the husky's breasts. The feel of her chest fur against your pussy as well as your cock is amazing, and your pets eager movements underneath you as she rubs herself up against you and tries to lick the tip of your cock fills you with pride at what a good little pet she is becoming. Sarah moans as you press her breasts together around your cock, lying back and enjoying the feel of your hands massaging her breasts as you thrust up against her. Like a good pet though, before long one of her hands finds its way to your own pussy where it rubs up against her body, your juices leaving a damp trail through her fur as you continue to hump her tits.  You groan in pleasure as her fingers brush over your ass, finding your pussy every couple thrusts as they rub your rear, the extra sensations all you need to tip you over the edge as you cry out in a massive orgasm, your own breasts bouncing on your chest as you spill your cum all over your pets face and breasts.  You pant helplessly for several minutes, as your cock continues to send soft spurts of seed onto her body, and your pussy continues to drip its juices onto her chest.  Finally you roll off your pet, propping yourself up off to the side as you recover from your exertions, and you find your mouth pulling back into a grin as you take in the sight of your pregnant pet. With  her face and breasts covered in your seed, and her chest drenched in the juices from your pussy, even as her belly swells with proof of your fertility. You slowly pull yourself up to your feet, the image of your well used pet staying with you as you prepare to explore the city some more.";
				otherwise:
					say "Approaching your pet, you smile as you see her rubbing her belly, its visibly swelling bulge proof of your earlier prowess and mastery of her body.  Your pet seems happy and eager to please leaning back as she props herself up on her elbows, presenting her rather full body for your inspection.  Your eyes resting on her soft belly full of your pups, you smile and stroke her soft belly fur for a minute, making her moan, before switching your attentions to her nice breasts, even larger now as they fill with milk for the pups.  Deciding you like what you see, you slowly move yourself over her soft body, until you are situated just above the swell of her belly, your erect [cock of player] cock nestled perfectly between the swell of her breasts.  Her muzzle drops open in anticipation as you begin to thrust your cock forward slightly, the soft feel of her furred breasts as your cock rubs up against them is amazing, and your well-trained and eager pet only makes matters better by lowering her muzzle down as far as she can, and stretching her tongue out to lick lightly at the tip of your stiff penis as it comes in range. She moans as you press her breasts closer together, making a better sheath for your cock out of her soft fur, and you begin to press forward in earnest. Your pet moans underneath you as you massage her breasts with every stroke, your breaths coming out as harsh pants as your pleasure increases with every thrust.  Finally you reach your peak, and you groan in delight as your cock shoots its seed all over your husky's breasts and face, coating her fur with your sticky treasure and making you pant in victory at having coated your fine slut in your seed both inside and out.  Tired you carefully rise off of your pet, even as she devours your seed happily, as you leave her lying there on the floor of the bunker enjoying the taste of her favorite treat.";
			otherwise:
				say "Approaching your pet, you smile as you see her rubbing her belly, its visibly swelling bulge proof of your earlier prowess and mastery of her body.  Your pet seems happy and eager to please as she lies back on the floor, though she does seem somewhat disappointed at the disappearance of your lovely life giving cock, like any good pet she is always willing to please her mistress.  Smiling you decide to take some time out to play with your pregnant pet, making her groan as you rub your hands over her softly furred belly, before bringing them up to play with her soft breasts.  Sarah moans as you rub and tease her breasts, already swelling larger with milk for her puppies. 'Does my little pet want her mistress to get her off?' You whisper to her teasingly, grinning as the husky nods desperately even as she melts into your soft touches. Deciding your little breeding bitch has probably earned a reward or two, you lower one of your hands down to her sopping slit, even as the other continues to massage her breasts.  She pants in pleasure at your touch, her well-trained body shuddering slightly as you run your hands over her pregnant form.  Deciding to take advantage of her open mouth, you lower your mouth to her muzzle, licking and teasing it until your pet is eagerly twining her tongue with yours in a deep passionate kiss. You find yourself growing excited as you play with your pet, happy at the thought of your seed growing deep in her body, and wondering if you will end up siring any more pups on her after this batch, or if maybe you will end up carrying someone else's pups in your own womb instead.  The erotic thought makes you moan into her muzzle as she shudders underneath you in orgasm, your own orgasm not far behind as you rub yourself up against her soft fur.  Panting you carefully lift yourself off your pet, her thighs soaked with her juices even as she lies there on the floor, the very picture of a happily bred husky slut.";
		otherwise:
			if cocks of player is greater than 0:
				if cunts of player is greater than 0:
					say "Your pet looks up in anticipation as you approach, her pussy leaking wetly onto the floor even as she lies back to give you a better view of her eager body. The sight of this once intelligent young woman now reduced to such an eager slut causes your cock to stiffen even as your own pussy grows damp as well. Deciding to enjoy this time with your eager little pet to its fullest, you slowly begin stroking and petting her as you work your way up her body, starting out with soft stroking of her feet, and moving up as your hands massage and stroke the soft fur of her inner thighs.  Sarah throws her head back and lets lose a desperate moan as you ever so slowly work your way up to her needy pussy, she groans as you tease her pussy with your hands for a minute, before continuing to stroke and tease your way up her chest and sides.  She is quickly so excited and lost in pleasure, that she bucks in orgasm underneath you almost as soon as you begin to massage her soft breasts.[line break]";
					say "Her antics make you chuckle slightly, as she pants and shudders underneath your touch, even as you continue to rub and caress her breasts.  Once her orgasm has faded somewhat, you slowly allow the tip of your cock to begin to trace the edges of her swollen lips, making the husky bitch gasp and look up at you, her eyes widening as she realizes you haven't even begun to truly play with her body yet. You feel a smile tugging on your face as you slowly sink yourself into her well lubricated passage, groaning at the feel of her vaginal muscles quivering around your [cock of player] rod as you sheath yourself in her body. Sarah moans and throws her head back as she cries out in pleasure at finally being filled by your warm member, writhing helplessly underneath you as you continue to rub yourself up against her soft furred body, your hips slowly beginning to move purposefully up against her.[line break]";
					say "You grin as she curls her legs up against your body, her hindpaws rubbing up against the backs of your legs, even as her thighs grip you to her tightly, encouraging you to go faster, her hips rocking in tandem with your own as your pussy leaks its own juice out over the area where your cock joins the two of you together. You moan in pleasure as you lower your chest down against your pets, your breasts rubbing together erotically as you run your hands through her soft fur.  Soon you can feel your balls churning and your rod stiffening even more in her as you prepare to fill her body with your fertile treasure. You groan as you feel your cock pressing up against the entrance to her fertile womb, and your body shakes with a powerful orgasm as you pump your seed into her eager and receptive body, each pump of your cum ensuring her belly will soon be swelling with your pups.  The feel of her womb being invaded by your strong blasts of sperm triggers another orgasm in your fine husky bitch, causing her to shudder and gasp underneath you, her eyes rolling back in her head as you bring her to her second earth shattering orgasm in mere minutes. Slowly pulling out of her semi conscious form, you find yourself grinning in amusement at how much fun your lovely little pet is. Standing up to prepare to head back out into the city, you spare a minute to pat your little husky's soft belly, now nice and full of your seed, you just can't wait to see it when you return, all nice and rounded and full of your little husky pups instead.";
					increase sarahpregnant by 24;
				otherwise:
					increase sarahpregnant by 24;
					say "Your pet grins as you approach, quickly positioning herself on all fours before you like a good little pet bitch. Her rear pointed towards you even as she lifts her tail up in an unspoken invitation, her swollen sex and thighs damp with evidence of her excitement and need. 'Well aren't you the eager little slut,' You tease your pet with a smug little grin as you slowly trace your hand along her back, making her shudder in anticipation. In response to your teasing taunt, your pet only moans slightly as she lifts her tail up even higher, raising her hips up even as she lowers her the front part of her body down closer to the ground. Her collar seeming to gleam around her soft throat as she does her best to live up to her new title of slut, prostrating herself before you and whining softly in need. Her tail brushes up against your chest eagerly, as you position yourself behind your well-trained bitch, her body eagerly responding to your touch as you position yourself at her needy entrance.[line break]";
					say " You waste no time with foreplay, your pet obviously being already ready and eager to be used like the submissive animal you have trained her to be, you grip her fur tightly as you slide your rod deep into her wet cunt. The feel of her well-trained walls gripping your cock is indescribable as you groan in pleasure, stroking her back as you tell her what a good pet she is to you. Her walls massage your member as you begin to thrust into her, your hands clenching in her fur as you stroke her, massaging your pet even as she moans and rubs her cheek against the floor. Brushing her facial fur up against the damp spots and puddles where here juices have already stained the floor without any concern for anything more than the moments pleasure.  You thrust into her even faster, panting as everything about this bestial mating with your bitch seems to encourage you to enjoy your new dominant position, and spill your seed into her eager and willing body.  Her vagina clutches at your rod as you increase your pace, her walls teasing your cock and trying to hold you within her body, even as the pleasure builds up to a fevered pitch inside you.  Unable to contain yourself any longer, you find yourself growling instinctively as you shoot your seed into the soft folds of the bitch underneath you, clutching her tightly to you as she shudders in pleasure at the feel of your hot sperm finding their way into her heat filled womb. As your orgasm fades, you find yourself panting in victory as your submissive little bitch moans underneath you, filled with pleasure as you pet her slightly several times, before pulling yourself out of the eager little slut, and letting her collapse into a puddle of her own juices.  You grin at the dreamy look on Sarah's face, as she revels in the joy of being just another pet and animal for you to use, a slave to her own needs and your desires. You leave her there in the bunker like that, rubbing her pussy and stroking her now full womb with her soft husky paws, well fucked and well seeded with your fertile sperm, you can't wait to see how the puppies turn out...";
			otherwise:
				say "Approaching your pet, you smile as she eagerly lies back on the floor at your approach, spreading her legs eagerly even as she massages her breasts with her soft paws.  Seeing her spread eagerly before you like that, you decide to take advantage of her position, and slowly move so you are kneeling between her thighs, one of your hands going down to tease her pussy for a minute, making her moan as your other hand guides her to lie back on the floor of the bunker.  Realizing what is about to happen she eagerly lies back and lifts ass off the ground slightly as you position yourself between her legs, lifting your leg over hers as you stretch out on the floor as well.  Sarah gasps and whines in need and pleasure as your pussy rubs up against hers, and you moan in pleasure as well at the feel of her damp passage rubbing up against your own.  Enjoying the sensations you begin to rub and grind against her crotch, your eyes closing in pleasure as your little husky eagerly begins to return the favor, the feel of your pussies rubbing against each other, as your juices mingle together on your crotches is amazing. You find yourself stroking and petting her legs, as you move your bodies together, your hands occasionally reaching down to stroke the area where your clits are rubbing against each other, even as your pet does the same.  Soon you are both grinding into each others crotches desperately, the scent of your feminine need filling the room and mingling with the scent of a husky in heat as you both move ever closer to the mind blowing orgasm you know is coming.  When the orgasm hits you cry out, your cry mingling with that of your bitch as you both writhe helplessly against each other on the floor. You manage to recover from your exertions before your pet does, and as you untangle yourself from her slutty body, you find yourself grinning at the happily fucked look on your pets face.";



sarahpregnant is a number that varies.
Sarahpups is a number that varies.

To say sarahpupstate:
	let otherhuskies be 0;
	if Carl is booked:
		increase otherhuskies by 1;
	if Amy is booked:
		increase otherhuskies by 1;
	if Coleen is bunkered:
		increase otherhuskies by 1;
	if sarahpups is greater than 11:
		say "Sarah is surrounded by her large brood of [sarahpups] puppies, several of them vying for her attention at any one second in time. Fortunately this seems to make your little husky breeder happier than ever as she smiles at your and her puppies and rubs her belly in anticipation of many more litters to come.";
	otherwise if sarahpups is greater than 0:
		say "Sarah is happily playing with your [sarahpups] husky puppies, keeping them happy and occupied while you explore the city, although from the looks the slutty husky is giving you even as she plays with the pups, she is already anticipating the next litter to come...";
	otherwise:
		say "She seems slightly lonely [if otherhuskies is 0]as the only husky around[otherwise if otherhuskies is 1]when her other husky friend isn't around[otherwise]when her other husky friends aren't around[end if], making you want to comfort her.";

An everyturn rule:
	if sarahpregnant is 1:
		say "You have a strange feeling in your body, as if you somehow just know that more of your offspring have entered this world, maybe you should go back and check on Sarah in the bunker... and make sure she is filled with your fertile seed again.";
		increase sarahpups by a random number between 1 and 4;
		increase score by a random number between 5 and 10;
		if "Proud Parent" is listed in feats of player:
			increase sarahpups by a random number between 0 and 1;
			increase score by a random number between 0 and 2;
		otherwise if sarahpups is greater than 11:
			say "Having sired so many puppies, you feel buoyed with happiness and a greater urge to get through this ordeal to protect them.";
			say "You and Sarah have earned the [']Proud Parent['] feat, making her more fertile and you more eager to protect your growing kennel.";
			add "Proud Parent" to feats of player;
			increase morale of the player by 5;
			increase score by 12;
		now sarahpregnant is 0;
	if sarahpregnant is greater than 1:
		decrease sarahpregnant by 1;
		if "Proud Parent" is listed in feats of player and a random chance of 1 in 3 succeeds and sarahpregnant > 1:
			decrease sarahpregnant by 1;


when play ends:
	if sarah is in the bunker:
		if sarahslut is less than 4:
			if humanity of player is less than 10:
				say "     Returning to the bunker, you waste no time in pouncing on the little husky you left there earlier, her moans as she fully succumbs to the infection are music to your ears. Before long she has been properly tamed, and all her pretense of clinging to her sanity and morals has vanished, helplessly stolen away under your powerful sexual assault. Enjoying your conquest, but still feeling as if it isn't enough, you soon head out into the city, knowing that some new destiny awaits you out there, you and your faithful pet husky following behind you...";
			otherwise if coonstatus is 0 or coonstatus > 100:			[incomplete conversion and no Candy]
				say "     Sarah comes with you after the rescue, glad to finally see the military arrive and eager to get back to her normal life. Acclimating to civilized life is particularly hard for her and her hyperbolic libido, resulting in a few embarrassing breakdowns in public.";
				say "     Ultimately, though, she manages to get by with your help, cobbling together a reasonably dignified way of living. Against the advice of similarly infected, she seems very adamant about not receiving 'relief' for her lingering lust, which puts her in a precarious position of avoiding her kin while also being alienated by the uninfected. At the very least, she seems glad to have you for company.";
				[Original ending. Removed.]
				[say "     Sarah comes with you after the rescue, glad to finally see the military arrive and eager to get back to her normal life. Unfortunately, she soon finds the world outside is too much for her new hypersexualized body, and she is unable to cope with all the sights and sounds of males around her without growing unbearably horny. It isn't long before someone notices and takes advantage of this fact.";
				say "     You find out just a little too late that several unscrupulous people managed to catch her alone one night and kept teasing and rubbing her body until she finally submitted to her needs.  Sarah is soon living the life of a unpaid stripper and slut in what is fast becoming one of the hotter underground nightclubs, where they cater to all tastes.  It is a seedy and unsavory place, a dead end for many sex-addicted victims [']working['] there.";
				say "     Sighing at her almost predictable fate, you make several attempts to recover the changed husky.  You even go so far as to offer buying her off them, only to find that they are not willing to sell.  It is even strongly hinted that further attempts to [']take their property['] may find you joining her in virtual slavery.  Unable to help her that way, you resign yourself to following her new career with interest, as she becomes a better and more proficient slut under the direction of her new owners, making them considerable money.  You find yourself realizing one thing with sorrow as you watch her turned from a smart young woman into an enslaved stripper... You really should have made sure she was your properly trained pet when you had the chance, instead of letting her go...";]
[				if cunts of player is greater than 0:		[player enslavement removed due to conflicts]
					say "     Feeling somewhat responsible for her well being, having rescued her before, you visit the club a couple times to try to speak to her, finally slipping her a note to have her meet you out back. You wait for her for a while, before she finally shows up, naked as can be with her fur still stained with her most recent lay's seed. You attempt to talk to her about her old life, and coming with you to get some help, and she keeps putting you off as she tries to think about it. You realize too late though that she was stalling on the orders of her new owner, as several men appear around you, you move to flee but something strikes you on the back of your head before you can do so.  When you wake up you find several amused people looking down at you, their naked bodies and erect cocks causing you to panic and try to get away, only to realize you are tied in place. Seeing you are awake one of them pours a little bit of some sort of juice down your throat, and you can almost immediately feel the need in your body increase greatly, making you pant as they laugh and chuckle around you.";
					say "     You gather from their talk as they poke and tease your body that your inquiries were causing trouble for them, and when you came down here alone, they couldn't resist the chance to add another pet to their 'stable'. Of course at about this point you lose track of what they are saying, as one of them finally inserts himself into your needy pussy, your mind going blank with pleasure and whatever drug they gave you as you find yourself reacting as if you were a slut just like Sarah. The handsome men use you over and over again throughout the night, your mind never knowing a minutes peace from the overwhelming pleasure, as they work your body you realize that you really ARE just a little slut like Sarah, and that you would do just about anything for this pleasure to continue.  Eventually your body can't take anymore and you end up passing out, only to be woken up by soft kisses, opening your eyes you see Sarah is lying next to you on the bed, 'I just knew you would feel better as a slutty little pet like me,' The vacant eyed husky says lustfully as she strokes your hypersensitive body making you moan. 'Just imagine, feeling like this all day and night, and all the wonderful cock we can share together...' She says with a moan as she begins to rub herself up against you, and your last coherent thought before the pleasure overtakes your body for good, is how much fun you and your slutty friend will be having together from now on, and how nice it will be to let your new well hung masters make all your decisions from now on!";
				otherwise:
					say "     Sighing at her almost predictable fate, you make several attempts to recover the changed husky, only to find that they are not willing to sell and that further attempts may find you joining her in virtual slavery. Unable to help her that way, you resign yourself to following her new career with interest, as she becomes a better and more proficient slut under the direction of her new owners, making them considerable money. You find yourself realizing one thing with sorrow as you watch her turned from a smart young woman into an enslaved stripper... You really should have made sure she was your properly trained pet when you had the chance, instead of letting her go...";		]
		if sarahslut is 4:
			if humanity of player is less than 10:
				say "     Returning to the bunker, you waste no time in pouncing on the your little slut husky, her happy moans and begging are music to your ears, as you indulge yourself with your slut. You find yourself grinning as you enjoy some private time with her, instinctively knowing how best to dominate and control the submissive bitch. Soon though, she becomes less and less a husky bitch, perhaps due to your dominance as she begins to take on a form more like your own. The changes are small at first, though they grow more and more prominent as your strong dominant infection overwhelms her own, making her into a more suitable breeder for your needs.";
				If cocks of player is greater than 0:
					say "     You grin as her body becomes an even better match for your own. Its form better able to take your powerful [cock of player] cock again and again, so she can breed you lots of little babies.  And you waste no time testing this as you sink yourself into her warm wetness over and over, enjoying your dominance over the your little pet. Eventually though, it is time to leave the small little bunker, a whole city waiting for you out there for you and your little slut, and you lead your newly changed submissive mate out into the world, you to find your destiny, and her to service your every whim and bear your offspring...";
					if sarahpups is greater than 0:
						say "     Her pups succumb to the changes even faster than their mother, her newly changed milk running through their vulnerable bodies and altering them as well. Soon her offspring are properly representative of your new forms, and looking at them you are proud to see them as proof of your own virility and the start of the many many young you plan to sire on your lovely little breeding slut.";
				otherwise:
					say "     You find yourself smiling as her body becomes a proper match for your own, her female form soon matching yours as you both lick and tease each other in a pleasurable orgy of sex.  You find yourself feeling even more needy and slutty as your pet demonstrates her submission to you over and over again, until soon you are panting with almost as much need as she has.  Realizing that you are not going to find the mate you both so desperately need while remaining here in the bunker, you turn to the city outside, leading your new slutty sister along with you as you head out into the city to find your destiny, and if possible, find you both a nice strong mate to share...";
					if sarahpups is greater than 0:
						say "     Her pups succumb to the changes even faster than their mother, her newly changed milk running through their vulnerable bodies and altering them as well. Soon her offspring are properly representative of your new forms, and looking at them you are proud to see them as proof of your own virility and as an example of the offspring you soon hope to be bearing from your own fertile body as well. You are soon helping her feed and care for the young, even as you both prowl the streets together looking for a proper male to fill both of your needy wombs up with their virile seed, so you can bear them even more little kits...";
			otherwise:
				say "     Finally rescued by the military with your mind intact, you bring Sarah along with you, and while some of the military are worried about her obvious feral tendencies, you manage to reassure them that she is properly in hand.  It doesn't hurt that they have bigger concerns than a personal pet of a survivor, and so you make your way out  into the world with your new slutty pet at your side. You soon find having your own personal husky slut is an even better thing now that you are in the outside world again, as she welcomes you home eagerly every night, and takes care of all the chores. Being a good little pet as you make new friends and meet new people, she is happy to help you out whenever you bring them over to 'meet' her. Eventually you feel like rewarding her with a companion, and pick up a normal husky dog to keep her company, a nice strong male one both for her pleasure and your own, as you find yourself enjoying watching the formerly bright paramedic eagerly going down on all fours for a purebred husky stud, moaning and yipping underneath the dog like a proper bitch.  She seems even happier as her belly grows round with husky puppies again and again, and while you sell some of them to breeders, you enjoy keeping several of them around the house, looking forward to when they grow up and you can have a full pack of slutty huskies at your disposal.";
				if sarahpups is greater than 0:
					say "     You were able to smuggle your pups with Sarah out of the city under the military's nose, and while they grow they can become somewhat of a strain to keep fed, you enjoy watching them grow into strong little huskies.  You make sure to train them all properly when they are young, the males and females both, to insure they know their proper roles as well-trained husky sluts for anyone who wants them.  And soon you have a number of good homes lined up for them to go live in, where they can serve their own masters and owners just as loyally as your own husky bitch serves you.  Your slutty 'kennel service' does well and helps cover the expenses of your busy household.";


Sarah ends here.
