Version 1 of Timothy by Sarokcat begins here.
[ Version 1.3 - Garrett Endings and add-ons ]

"Adds a herm gryphon breeder with room for company in her nest to Flexible Survival."

[NOTE: Timothy is based on the character of the same name in "Flexible Infection: A Wing in the Night" by Nuku Valente.]

Include Gryphon Companion by Sarokcat.


Section 1 - Gryphon Nest

Gryphon nest is a room.

The description of Gryphon nest is "This small room is tucked between several of the other tents filling the area, its soft canvas surrounding a small private enclosure filled with a large variety of different cushions and cloths, the soft light from the glowing floor and tent cloth illuminating the area. You can see several small items and trinkets, scattered amongst the cushions, but your eyes are drawn most to the heavily pregnant herm gryphon lying sprawled out on the cushions, a small collar with a tag hanging from around her neck.".
Timothy is in Gryphon nest.
Gryphon nest is west of Qytat Plaza.

instead of sniffing the Gryphon nest:
	say "The nest area smells strongly of gryphon arousal, sex and egg-laying.";


Section 2 - Timothy

LastTimothymilked is a number that varies. LastTimothymilked is usually 250.
Timothyfucked is a number that varies. Timothyfucked is usually 0.

Timothy is a man.
The description of Timothy is "Lying on a rather large pile of stolen cushions, is a rather striking blue furred gryphon, her attractive blue feathered wings half spread out behind her as she reclines back. The creatures talon like hands are absently rubbing its large white furred belly, obviously quite pregnant and unable to move quickly, its large breasts are slowly dribbling milk as it shifts its body slightly, giving you a good look at both its thick black cock resting up against the gryphon's distended belly, and the rather large and obviously well used passage resting between the gryphon's leonine thighs. Its leonine tail twitches where it is lying between her slightly spread legs, as the hemaphrodite gryphon cocks her avian head to look at you, her tongue hanging out the side of her beak slightly as she pants and rubs herself a bit more. You notice a small collar with a tag hanging around her neck, the tag just reads 'Pet'".
the conversation of Timothy is { "EggsEggsEggs!" }.

instead of linkactioning Timothy when HP of timothy > 0:
	say "Possible Actions: [link]talk[as]talk Timothy[end link], [link]smell[as]smell Timothy[end link], [link]fuck[as]fuck Timothy[end link], [link]milk[as]milk Timothy[end link][line break]";

instead of sniffing timothy:
	say "She smells like a hermaphrodite gryphon. The scent of pregnancy, egg-laying and sex hang thick around her.";

instead of conversing the timothy:
	if HP of timothy is 0:
		say "'Oh wow!' the gryphon says as you approach to talk to her. 'I didn't expect to see someone like you here,' she says as she looks you over, moaning slightly in pleasure as she shifts her large egg-filled weight to look at you better. 'Welcome to the flying city, I think they are calling it Qytat or something, to be honest I wasn't paying too much attention to things like that when my mistress led me here.' Seeing your confusion, she begins to explain. 'My mistress is the one who changed me into this lovely new body,' she says as she gestures at her long leonine form, and her avian wings, and finally rubs her pregnant belly. 'And my mistress is the one who keeps me nice and full of her gryphonic offspring as well. I was once a human called Timothy, living down there in the city, before I met her while I was out camping one night. That was the best night of my life,' she says, as her flexible beak pulls back in a happy smile. 'She changed me and filled me right up with her wonderful cock, and then led me here where I could be a good little breeding pet for her, bearing her eggs again and again, and letting her drink my tasty milk and fuck me whenever she wants,' the gryphon says, obviously growing somewhat excited at the memory, and small trickles of milk begin to dampen the soft fur on her large breasts. 'She still calls me by my old name sometimes, but I love it best when she calls me her pet, or even mate or breeder, it just seems so right,' the gryphon says with a shudder as she licks her lips. 'And sometimes she even lets other gryphons come in and breed me too, to make sure that I am always nice and full of little baby gryphons. It's the best life ever, you should really try it! I bet my mistress would love to make you into a happy slutty breeding gryphon too!' Timothy says as she rubs herself erotically, 'And you could stay here and talk with me and we could bear eggs for the handsome gryphon studs all day long... mmm,' she moans as she orgasms just from the thought, lying back on the cushions and panting slightly as you try to decide just what to say to that.";
		increase HP of timothy by 1;
	else if HP of timothy is 1:
		if player is pure and bodyname of player is "Hermaphrodite Gryphon" and cunts of player > 0 and ( gestation of child < 1 or child is born ):
			say "Timothy looks up at you and sniffs at the air before she smiles, beak creased with intense interest. 'You are ready for the next step,' she says, bouncing to her feet and stepping over towards you. Your eyes wander towards her jiggling assets as she reaches for your hips. Her claws softly scratch through the fur there, leaning closer, 'I can let you join me now. Would you like that? You could be a breeder griffon just like me.'";
			say "The thought of it is tempting, and you can feel your body stirring in reply to it, but what about trying to regain a normal life? What about your other friends? Could you give it all up?";
			if the player consents:
				say "'Fantastic!' she cries, rubbing her beak against your own before licking your cheek, 'First, we breed. I'm sure I don't need to give you too many pointers about that.' She begins to rub her heavy chest against your [breast size desc of player] furry breasts, the milk leaking from hers commingling with yours. Her hand wanders down between your legs, talons lightly brushing through the fur in search of more sensitive things.";
				if cocks of player > 0:
					say "Her hands close around a black gryphon cock and squeezes firmly at the base before working slowly towards the tip, running in slow motions as she purrs her delight. Claw flicks over the fat tip of the [cock size desc of player] organ before she raises herself up and [run paragraph on]";
					if cock length of player > 12:
						say "she angles back, trying to get it into herself, but discovers you have over a foot of throbbing maleness. She pulls it down and steps away from you before guiding it towards her snatch. She sinks the mighty head of it between her thighs and begins to work in back towards you, slowly shuffling ahead with a low moan of fulfilled bliss as she is brought to capacity and then stretched deliciously by your big black cock. She takes it all, the lump pressing up through her belly, running along her body until she has it all wedged within her fertile, greedy snatch.";
					else:
						say "the cock easily slips into her wet lips and she drives down against you, impaling herself on the shaft with a loud cry of bliss. Her hands grab at your hips and pull you forward into the motion as she gyrates against you, working until you are in her to the hilt.";
					say "Properly united with you, she begins to rock against you, her own shaft grinding into the fur of your belly as she arches her back, changing the angle that you drive into that tight slickness of her oven. 'Fill me!' she cries, 'I want to be so heavy with your eggs that I can't even move!' Her sex squeezes tightly around your throbbing pole as you rock with her, taking her faster and faster with her loud assent.";
					if cock width of player > 12:
						say "Your great balls contract and the world swims a moment as intense euphoria surges up through your tense shaft and blasts into the willing female, making her already lightly swollen belly surge forward with the egg batter. A taloned hand dips between your legs, gently milking at your furry balls as they spill their contents into her, milking you for every last drop of your fertility.";
					else:
						say "Your body tenses and you push her back just to push into her in a swift, final, thrust. With your shaft twitching, filling her willing cunt with your grey jizz, you cry out with her, grinding with her as you give up your offering. Her hands settle on your ass, squeezing and pulling at you, keeping your cock buried to the hilt even as the orgasm fades.";
					say "Timothy lets out a soft sigh, then smiles, 'That was fantastic. Now, your turn.' She works herself free of your shaft, leaving it glistening with her fluids and standing up to stretch. Her own shaft bobs in the air, hungry looking, 'But there's one thing we have to do first.'";
				say "'Before you can become a breeder, we have to do a little work on you,' she advises as she reaches for your belly, rubbing slowly for a moment. 'Don't worry, it will be fun.' She hops a step away, then hurries off to a small box, digging about in it with soft rustling and tossing a few odds and ends aside before she settles on a long slender object that looks like a smooth pink vibrator of some sort.";
				say "She returns to your side, waving the toy around at you as if it was a weapon. When she gets in front of you, she runs it across your belly and up towards your chest, 'Lay down.'";
				say "Complying, you lean back slowly to the ground and she settles beside you. The pink toy is pressed against your furry lips, and clicked on. It shakes as you expected, sending soft spikes of delight through your furry lips as she runs it up and down your vulva, 'Say you want it.'";
				say "You nod your head quickly. She pouts and gently presses it in half an inch, 'Say it out loud, beg for it.' As it presses into you, the sensations suddenly triple and you cry out in a sharp cry. This seems to satisfy her, if her grin is any measure, and she starts to ease it deeper into your trembling tunnel. Every inch that it penetrates ratches the sensations another magnitude, until it feels like the entire word has been reduced to nothing but your honey gushing cunt.";
				say "Lost in the rapture, you aren't even sure when she got on top of you, but as some small shred of coherency returns, you realize she is riding you with intense thumps, rutting her black cock into your cunt, her hands on your shoulders and the rest of her weight pinning you down. Above her, her thin tail thrashes about with every hard drive into your form, and you just can't seem to do a damn thing about it but to be lost in a world of constant release.";
				wait for any key;
				now humanity of player is 0;
				if "Fertile" is listed in feats of player:
					end the story saying "Your life becomes set in its way at just that point. Timothy breeds with you whenever another griffon isn't around, and you, in turn, service her needs to the best of your ability. You are well regarded by the griffons, as breeders go. Your astounding fertility earns you special praise as you produce child after child with seeming ease, creating a great demand to lay you in bed and experience it for themselves. You are well treated and cared for, but your days of adventuring are quite over. You serve well as a breeding griffon.";
				else:
					let a be 0;
					end the story saying "Your life becomes set in its way at just that point. Timothy breeds with you whenever another griffon isn't around, and you, in turn, service her needs to the best of your ability. You are well regarded by the griffons, as breeders go. You are well treated and cared for, but your days of adventuring are quite over. You serve well as a breeding griffon.";
			else:
				say "Timothy looks disappointed when you decline the proposition. She reaches up to rub over your chest lightly, 'Well, that's ok. I will be here when you change your mind, and we can have fun until then, right?' Despite her words, it seems clear that she would have rather you had joined her.";
		else:
			say "'[one of]Gryphon cock is amazing, you should try it.[or]Mmm I can't wait for my next breeding.[or]Are you sure you wouldn't be happier as a breeding gryphon?[or]I'm so glad to leave all that being human stuff behind me.[or]It feels good being stuffed nice and full of eggs, you should try it[or]Not long now,' she says as she pats her belly, 'And then I can get filled up again![or]Isn't it nice up here?[or]My mistress doesn't use my cock much, but being filled with hers is just amazing so I don't mind.[or]Would you like a little bit of milk?[or]If you keep hanging around here to talk to me, one of the other gryphons might find you in here and make you a happy little breeding toy too... Wouldn't that be wonderful?[or]Have you ever given any thought to having a tail? I love mine![or]Oh my, my breasts are going to need milking soon.[or]This infection or whatever it is the best thing that ever happened to me.[or]I can't decide which I like more,' the gryphon says speculatively. 'My wonderful new talons,' she says as she flexes her talon-like hands, then gestures down at her digitigrade lion feet and paws. 'Or my handsome new paws.' She coos in happy contemplation before looking at you. 'What do you think?[or]Whew, I'm still me, I had a nightmare the other day where I was a human again,' she says with a shudder 'Wouldn't that be horrible?[or]God I love being pregnant with lots of little gryphons![or]Who knew being an egg filled breeder could be so satisfying?[or]I bet you would look amazing pregnant with gryphons.[or]I just can't wait for my mistress to return and fill me with more of her lovely seed!'[or]Oh please won't you take some time out and try some of my milk?[at random]'";


Section 3 - Milking Timothy

Timothymilking is an action applying to nothing.

Understand "Milk Timothy" as Timothymilking.
Understand "Milk Tim" as Timothymilking.
Understand "Milk gryphon" as Timothymilking.

Check Timothymilking:
	If Timothy is not visible, say "Who?" instead;

carry out Timothymilking:
	if HP of Timothy is 0:
		say "     She may be one of those lustful gryphon herms, but it's always nice to at least introduce yourself before groping someone's breasts.";
	else if lastTimothymilked - turns < 6:
		say "'Mmm sorry, that sounds like a wonderful way to pass the time,' Timothy says as she rubs her large breasts slightly, before sighing, 'But I have to make sure to keep some for my mistress when she comes back, or in case the little ones come. Maybe a little bit later when I have a bit more stocked up,' she says, looking at you hopefully, 'You'll come back then won't you?'";
		stop the action;
	else:
		say "'Oh that sounds wonderful!' Timothy murrs as she rubs her obviously full breasts, several small drops of milk already leaking from her nipples as you move forward to take her breasts in your hands. Looking around somewhat you find an oddly shaped bowl near the cushions, a small curved depression built into its lip, as you bring it up to her breasts you find the depression matches the curve of her breast, the bowl obviously made for situations like this. The pregnant gryphoness moans as she holds the bowl in place while you softly massage her breasts, soft gryphon milk beginning to flow under your hands as you tease her nipples. The air fills with the strangely arousing scent of the strange hybrids milk, as the bowl slowly beings to fill, making you lick your lips slightly as you think about what the potent milk must taste like. You soon lose yourself in the feel of her soft furred breasts underneath your hands, running your hands over and through her fur rhythmically as you coax her milk into the swiftly filling bowl. Soon the bowl is completely full, and you are forced to set it aside, though Timothy's breasts are still leaking milk onto her fur as she pants, her head thrown back in obvious pleasure at being milked. Unable to help yourself, you find yourself lowering your head down to her damp breasts, and stretching your tongue out to take a taste of the milk straight from the source. You and Timothy both moan as your tongue licks over her nipple, the taste of her lovely body on your tongue is just amazing, and you quickly find yourself licking and sucking slightly on her nipples, soft trickles of milk filling your mouth with its wonderful taste, before you finally sit back panting almost as much as the gryphoness is from the lovely experience. Looking down at the full bowl, you decide not to let any of that wonderful milk go to waste, and gather some of it up to take with you.";
		infect "Hermaphrodite Gryphon";
		increase carried of gryphon milk by 1;
		now lastTimothymilked is turns;


Section 4 - Milking Timothy

Instead of fucking the timothy:
	if HP of Timothy is 0:
		say "     She may be one of those lustful gryphon herms, but it's always nice to at least introduce yourself before fucking someone.";
	else if lastfuck of Timothy - turns < 6:
		say "'Sorry, I know you want to play with me again,' Timothy says as she lies back on her cushions with a satisfied look on her beak. 'But I still need some time to recover before we have some fun again, maybe you could go find another gryphon to have fun with for a bit and come back later?'";
	else if cocks of player is 0 and cunts of player is 0:
		say "Lacking a gender of your own, you're not really equipped for playing with Timothy like that. Though those milk-filled breasts of her certainly look enticing. Perhaps you could start off by milking her instead?";
	else if bodyname of player is "Feral Gryphon" and player is pure:
		if cocks of player > 0:
			say "     'Mmm... you're quite the sexy beast, aren't you?' she purrs as she runs your eyes over your feral gryphon form. Her eyes linger especially long when she notices your sheath and cock. She runs her tongue along her beak, clearly tempted by your manhood. Grinning, you rear up to better put it on display, asking her if she sees something she likes.";
			say "     'Oh, I really shouldn't,' she says softly. 'Alright, but you can't tell my mistress. Take me[if level of timothy > 0] again[end if], you beastly stud.' Trained to be a breeding slut for gryphons, she gives in rather easily to you advances, spreading her leonine legs and offering up her juicy cunny. You mount the egg-filled herm, sinking your feral manhood into her.";
			say "     Having a hot, willing and fecund hen beneath you excites your feral instincts and you fuck Timothy vigorously. Her milk-filled breasts and egg-filled tummy rock beneath you as you pound into her quivering hole. Your thrusts are strong and cause her inner walls to squeeze and tremble around your beastly manhood. She pants and moans, loving every moment of the wild fucking you're providing her.";
			say "     'I'm a bad pet for letting you fuck me, but oh god does it feel good. You're such a sexy beast.' She plays with her milk-laden breasts and strokes her own cock as you pound away at her. She moans louder as her excitement builds higher and higher still. 'Mmm... do it, you stud-beast. Fuck that cunt and cum in me. Give me your big, feral eggs.' The last words are cried out as her cunt clamps down around your knot. She climaxes messily, spraying milk and semen across herself as her vagina milks at your rod. You release a wild cry and bite firmly on her shoulder as you cum hard, blasting your [cum load size of player] load into her egg-filled womb, your sex-fuelled mind eager to add to her growing clutch.";
			say "     Once you're done and your knot goes down enough to pull out, the sticky gryphoness rolls onto her side with a contented sigh. She rubs her rounded belly, smearing around the sticky mess of fluids. 'I hope my mistress won't be too upset that there are some feral gryphon eggs in there with the blue gryphon ones,' she says to herself. She seems quite happy though with the prospect of having your beastly eggs growing inside her.";
		else:
			say "     'Oh my, aren't you a lovely beast? she purrs as she runs her eyes over your feral gryphon form. Her eyes linger especially long under your tail as looks longingly at your leonine muff. She runs her tongue along her beak, clearly tempted by your pussy. Grinning, you turn around and raise your tail to give her a better view of it, asking her if she sees something she likes.";
			say "     'Oh, that looks so nice,' she says softly. 'Alright, but you'll have to climb up over me. I'm a little too full to get up and mount you properly.' Her knotted cock is stiff and ready for you and you grow wildly eager to have it in you. You scramble up onto the nest and move atop the anthro gryphon so you can sink your dripping cunny down over that hard rod of hers.";
			say "     Timothy runs her taloned hands through your feathers and fur, rubbing your body as you ride her cock. 'Mmm... you're so hot and needy,' she pants as your cunt squeezes and tugs at her cock. 'I think the wild beast needs a few eggs in her to tame her,' she moans playfully. 'That's just what a feral gryphon like you needs, isn't it? A nice, big clutch of eggs will feel so good - trust me, I know.'";
			say "     You release a moaning cry and ride that gryphon cock all the harder, your body's instincts taking over. Thoughts of gryphon studs, both feral and anthro, male and herm, mounting and filling you, siring clutch after clutch of eggs in you overrun your mind. The series of images this conjures to your mind eventually becomes too much for you and you climax loudly. Your cunt clamps down around Timothy's rod, quivering around it until she cums hard, pumping her hot load into you in an attempt to give you that clutch your feral instincts desires.";
			say "     'You need this so badly, don't you?' Timothy pants out as she continues to thrust into your all too willing body. 'If even the cock of a little breeding slut like myself feels this good to you, just imagine what the cock of a real stud gryphon or a feral beast is like,' Timothy moans into your ears, as she continues to move within you. Her knot tugs at your passage with every small motion, sending waves of pleasure throughout your body. 'Just imagine their strong talons holding you down as they fill you up, mounting you again and again until your belly swells large with their seed.' Her talons stroke the back of your head as you lean down closer, your body clenching in need as her soft words fill your mind. 'You would make such a perfect tamed gryphon, wouldn't you? As a tamed breeder, you could have those studs and beasts mounting you with their wonderful cocks, day after day, fucking you until your belly is heavy with clutches of eggs. Don't you want that? Want to be a lovely gryphon mount breeding enough mounts for everyone to enjoy?' Timothy whispers as she runs her talons along your body, her cock moving slowly within you as she keeps you panting at the edge of orgasm, her words washing over your lust fogged mind as she teases your body. Before you can realize what you are doing, you find yourself imagining this new life of yours, almost begging for some strong gryphon to come claim you and stable you as a mount breeder. The sheer dirtiness of these images make you even more excited, the longing you feel for it excites your needy body to an amazingly pleasurable orgasm. You cry out, begging for it, moaning that you want to be mounted and bred.";
			say "     'I knew you wanted to be happy and full of eggs just like me,' Timothy moans in victory, as her body stiffens underneath you, her cock twitching inside your hot folds as it finally shoots its thick gryphon seed into your waiting womb. The thick knot ties you together, ensuring that not a drop of that oh-so-fertile cum is wasted, while the spines tickle your passage to ensure your body is receptive. You find yourself panting as you lie on Timothy's stomach lightly, the knot keeping you together as she whispers more dirty words into your ears about the pleasures of becoming a mount breeder. You find yourself nodding almost automatically at her lewd descriptions of gryphons, both mounts and riders, atop you. Her talk of the constant sex makes you almost want to give in and see what life as a mount breeder is like. Eventually though, her knot softens, and the exhausted gryphoness relaxes back on the cushions to rest as you pull your tired body off of her, the spines tingling pleasantly as they pull out of you. You stagger back out of the nest. You half-heartedly gather up your equipment to wander out in the city again, though you find one of your forepaws keeps wandering back to rub your belly. You know that with the thick knot locking you together and the lovely spines stimulating your body, the chances of a pregnancy if such a thing is at all possible, is extremely high. Somehow this thought just seems to make you feel even better, and you find yourself smiling as you get ready to leave.[impregchance][impregchance]";
		increase level of Timothy by 1;
		now lastfuck of Timothy is turns;
	else if cocks of player > 0 and cunts of player > 0:
		if bodyname of player is "Hermaphrodite Gryphon":
			say "'Mmm... a lovely little gryphon just like me!' Timothy says happily as she runs her eyes over your gryphon body, lingering for a moment at your cock before taking in your damp pussy. 'You must want to see what it's like to be a happy slut gryphon like me!' she says with a grin on her beak as she gestures for you to come closer, the thick scent of gryphon musk filling your head with lust as she pulls you up close to her large egg filled belly, rubbing your bodies together pleasantly. 'Feel that lovely full belly? Nice and round with gryphon eggs? Isn't it wonderful? I bet you want to feel nice and round and full of life too don't you?' the gryphon moans, not waiting for an answer before positioning her thick barbed and knotted cock at your entrance. 'I may not be one of those handsome gryphon studs, but I can still give you a little taste of that lovely feeling,' she says as she pulls you down onto her thick cock, making you gasp as her soft barbs rub against your sensitive walls.[line break]";
			say "'Doesn't that gryphon cock feel good?' The gryphon gasps, as she thrusts into your slick tight passage. Her knot bumping up against you as she pulls you down onto her shaft. 'Nice and right as it fills you up?' she whispers, the feel of her soft barbs moving within you at every thrust causing you to gasp and groan in pleasure as she runs her talons over your body, her furred lion hindpaws rubbing against your own leonine legs as she moves within you. 'And feel that wonderful knot?' she pants out as her knot spreads you open more with each soft pleasurable thrust, seeking entrance into your eager body. 'Once it enters you it will lock your body to mine just like a good breeding slut should be, sealing your passage tight while my cock fills your body up with its wonderful gryphon seed. Every pump of my cock ensuring your belly will grow nice and round with the gryphon eggs growing inside you.' Timothy moans, as with one final push her knot enters your body, causing you to gasp helplessly as your pussy clenches it tight, holding it within you tightly like she said. Timothy immediately begins to speed up her thrusting, making you melt helplessly in her hands, your stiff cock rubbing up against her round belly with every thrust, her soft fur massaging it almost as well as your soft folds are massaging her own cock inside you.[line break]";
			say "Finally she clutches you tight as her body stiffens underneath you, her cock shuddering and twitching inside you as she shoots her gryphonic seed deep into your willing body. The feel of her fertile seed coating your insides, every drop of it trapped in your womb by her knot while her barbs massage your passage is too much for you, and you find yourself crying out as your own powerful orgasm washes over you, your passage shuddering around her cock as your own cock stiffens and shoots its seed, your thick cum coating her soft belly fur even as her own seed fills your body. You pant as she holds you tight, her knot tying you together as she whispers into your ears about the many more pleasures of being a breeding gryphon, nice and broody and well sexed. Eventually her knot softens enough that you can pull yourself off of her, your wings splaying out behind you as you rest back on your leonine paws. 'That was so nice,' Timothy murmurs as you slowly begin to gather your wits about you, 'And just think, that was only a short sample, of what being a gryphon breeder is like, though with any luck you can enjoy the feeling of my seed growing within you, and feel the joy of bearing gryphon eggs just like me.' She groans in pleasure while she rubs her own large egg filled belly, as she lies back on the cushions her eyes closing in exhaustion. You find your hand straying to your own belly as her words sink in, finding yourself half hoping that her seed has indeed caught and you will soon be joining her in her large gravid state...[impregchance][impregchance]";
			infect "Hermaphrodite Gryphon";
			increase XP of timothy by 1;
			now lastfuck of Timothy is turns;
		else:
			say "'Sorry, but I really don't think my mistress would like it if I let a non-gryphon like you have its way with me. It just wouldn't be right for a happy little breeding gryphon like me to get pregnant with anything but gryphon seed you understand,' Timothy says with a sad look at your body. 'But if you really want to have a little fun we could try to play around a little ourselves?' she says as she pats her thick black cock where It rests up against her pregnant belly.";
			if player consents:
				say "'Ah I knew you wanted to play around a bit with a big slutty gryphon, and maybe eventually you can become one yourself!' Timothy says happily as she gestures for you to crawl up onto the cushions with her. Her excited scent and the scent of gryphonic rut filling your nose as you find yourself moving closer automatically, you feel your cock stiffening as your pussy clenches with need. 'Mmm I can see that idea turns you on doesn't it?' she says as she pulls you up until you are lying next to her on the soft cushions. 'Wouldn't it be great to have nice big breasts like mine?' she says as she moves her large milk filled breasts closer to you, her taloned hand reaching behind your head as she slowly guides your mouth down to one of her nipples, while her other hand guides your hand to her other breast, making her gasp in pleasure. 'Lovely big milk filled breasts, for little gryphlets and playful mates to suck on and tease...' she moans, as you find yourself doing just that, her wonderful flavor making you nibble and lick at her breast playfully, while her hand holds your head in place, and your other hand slowly roams over her other breast, running through the soft fur and teasing her nipple. Soon your effort is rewarded by the pleasant flavor of her gryphon milk starting to trickle into your mouth, its flavor seeming to explode across your tongue as a new rush of arousal surges through your body.[line break]";
				say "'Mmm oh that feels so good,' she moans as you lick and suck on her wonderful milk giving breasts, her taloned hand stroking the back of your head, before roaming down your body further. 'Of course, there's also the joy of having a nice thick gryphon cock,' Timothy says in a teasing tone, as her soft talons trace over your [cock of player] cock, making you gasp against her soft breast as she wraps her hand around your excited cock and pumps it a few times. 'A nice knotted gryphon cock to play with whenever you want is just amazing, but the most fun part of being a big slutty gryphon isn't the cock,' she says as her taloned hand roams even lower, making you gasp as her clawed talon traces along the outside of your damp pussy. 'No the best part is the wonderful lion pussy of a gryphon slut,' the gryphoness moans, as her talon slowly pushes into your own pussy, causing you to moan in pleasure as your mouth fills with even more of her wonderful milk, your lust fogged head filling with the wonderful images her words are painting for you. 'Just imagine having a lovely gryphon body, like mine, with a hot needy pussy for all the lovely gryphon studs to fill full of their delicious thick cocks. Wouldn't it be nice to be fucked again and again, their wonderful seed filling your body with delicious eggs.' She moans, as her talon thrusts into you teasingly, bringing you to the cusp of orgasm. 'And the best part is feeling your belly grow large with their nice thick eggs, and the orgasmic pleasure of laying them and growing round all over again.' Timothy moans, her body shuddering as she orgasms at the thought, your mouth filling with her delicious milk as her hand tightens within you, causing you to explode in orgasm as well. Your seed mingling with hers as it coats the cushions underneath you, and your slick juices coating her taloned hand as she pulls it out of your tired body. 'Doesn't that sound like so much fun?' she asks as she lies back on the cushions next to you, clearly happy and tired from the playtime, 'you should really come stay and be a nice big breeding slut of a gryphon like me, I just know you would love it...' she says with a sigh as you slowly slide down off the cushions, and you have to admit, her offer does sound so very tempting...";
				infect "Hermaphrodite Gryphon";
				now lastfuck of Timothy is turns;
			else:
				say "'Aw that's too bad, I was looking forward to putting it to use again. It's been a little neglected lately in favor of filling me full of wonderful little gryphon eggs,' she says, giving you a sad look out of her avian eyes. 'But I guess there isn't much more to say then is there? Maybe you should try my milk or find another gryphon out there to help fill you full of eggs.'";
	else if cocks of player > 0:
		if bodyname of player is "Hermaphrodite Gryphon" and "MPreg" is listed in feats of player and "Submissive" is listed in feats of player and a random chance of anallevel in 5 succeeds:
			say "'Oh wow! A handsome stud gryphon all to myself!' Timothy says with a happy smile as you approach her, smiling as she takes in your male gryphon's form. 'A very handsome looking male too! Just looking at you is making me feel so very horny,' the gryphoness moans, as she shifts her large body, rubbing her talons over her large belly, as she spreads her leonine legs even further apart to give you a good view of just how wet she is. 'Why don't you come up here and put that wonderful rod of yo-ohhhh,' she starts to say before descending into a moan as you wrap your taloned hand around her cock and start stroking it. All of her talk about how wonderful being a breeder gryphon and being full of eggs feels has gotten you all worked up and made you eager to be the one getting bred. She gives such a delighted moan as you move your ass over her cock and grind down atop it, rubbing your body against her pregnant belly.";
			say "I'd been hoping to have you inside me, but my sexy cock has been a little neglected lately in favor of filling me full of wonderful little gryphon eggs. If that's what you want, I'm certainly game. Maybe we can even help you become a proper breeding gryphon,' she moans as you push your anus down around the pregnant herm's cock. The feel of the thick gryphon cock slowly splitting you open as you lower down onto it is amazing, your needy back passage spreading wide eagerly to grip the ebon rod. 'You're definitely eager enough for it,' she adds as you start riding her spined cock. Those soft spines rubbing along your inner walls as her shaft pushes against your prostate sends shivers up and down your spine.";
			say "'Just think of it, being a lovely breeder like me, your belly full of eggs, nothing to do all day but get fucked. You love getting fucked like this, don't you?' Not waiting for an answer, she quickens her pace, grinning as you moan and ride her harder. 'If even the cock of a little breeding slut like myself feels this good to you, just imagine what the cock of a real stud gryphon is like. So why not just give in to what your body wants and let me help you become a sexy, egg-filled hen?' she purrs to you while fucking you, pulling you roughly down onto her rod. The movement causes you to groan in pleasure as she bounces you up and down on her cock, your body rubbing up against her large belly with every thrust. Her knot rubs up against the your anal ring, its thick bulge knocking at your back door with every thrust. Your [if player is twistcapped]well-conditioned anus spreads readily for the thick knot of gryphon meat[else]tight anus is coaxed open by the thick knot of gryphon meat[end if], popping inside you and tying you onto that wonderful bulge inside.";
			say "Timothy pants as she continues to thrust into your all too willing body. 'Imagine their strong hands holding you down as they fill you, mounting you again and again until your belly swells large with their seed.' Her talons stroke the back of your head as you lean down closer, your body clenching in need as her soft words fill your mind. 'You're just so eager for it. I know you'd be much happier being a breeding slut rather than trying to be a male stud. Your body would get all the cock you'd want and more, fucking you so wonderfully until your belly is as large as mine and you bear their big, strong gryphon offspring. Wouldn't you prefer that? Want to be a just another happy breeding slut for them to use?' Timothy whispers as she runs her talons along your body, her cock moving slowly within you as she keep you panting at the edge of orgasm, her words washing over your lust fogged mind as she teases your body. And while she may not quite realize how ready your body already is for breeding, her words sound wonderfully appealing to your submissive instincts as well. Before you can realize what you are doing, you find yourself nodding and begging as you agree with her, moaning for some strong gryphon to come claim you and make you its pet, desperately wanting them to fill your body up with fertile gryphon seed, and turn you into a breeding whore just like the pregnant gryphon underneath you. The sheer dirtiness of what you are saying seems to make you even more excited as you beg, the truth of your words filling you with pleasure as you realize that at this moment in time that is exactly what your needy body wants, and an amazingly pleasurable orgasm explodes through you at that realization. Your [cock size desc of player] penis pulses and throbs, spreading your sticky load across the pregnant breeder's rounded belly.";
			say "'I knew you wanted to be happy and full of eggs just like me. Mmmm... and now let's see if we can't get you that hot, wet breeding hole,' Timothy moans in victory, as her body stiffens underneath you, her cock twitching inside your clenching anus as it finally shoots its thick gryphon seed into your back passage. With the thick knot tying you together, there is nothing to prevent it all from being be funneled off into your hidden womb, your altered anatomy not needing any further changes to make you breedable. You'd explain your readiness to Timothy, but you're too overcome by the afterglow of your orgasm. You instead happily remain tied to her, listening to her softly whisper to you the many pleasures of becoming a breeding gryphon like her. You find yourself nodding almost automatically at her lewd suggestions of herm gryphons and constant sex, almost wanting to give in and see what life as a breeder is like. Eventually though, her knot softens, and the exhausted gryphoness relaxes back on the cushions to rest as you pull your tired body off of her, the spines tingling pleasantly as they pull out of you. You stagger back to your feet and begin to gather your equipment to wander out in the city again, although you find one of your hands keeps wandering back to rub your belly, and you know that with the thick knot locking you together and the lovely spines stimulating your body, the chances of a pregnancy if such a thing is at all possible, is extremely high. Somehow this thought just seems to make you feel even better, and you find yourself smiling as you get ready to leave.[mimpregchance][mimpregchance]";
			infect "Hermaphrodite Gryphon";
			increase XP of timothy by 1;
			now lastfuck of Timothy is turns;
		else if bodyname of player is "Hermaphrodite Gryphon":
			say "'Oh wow! A handsome stud gryphon all to myself!' Timothy says with a happy smile as you approach her, smiling as she takes in your male gryphon's form. 'A very handsome looking male too! Just looking at you is making me feel so very horny,' the gryphoness moans, as she shifts her large body, rubbing her talons over her large belly, as she spreads her leonine legs even further apart to give you a good view of just how wet she is. 'Why don't you come up here and put that wonderful rod of yours to good use?' she pants out, her enticing aroma filling your nose as you climb onto the cushions with her. 'I just can't wait to feel you inside me,' she moans, her ample chest heaving with excitement as you guide yourself to her waiting passage. You can't help but feel yourself growing more excited than ever as the tip of your [cock of player] cock probes at her damp lips, her taloned hands running along your sides as she begs for you to fill her up.";
			say "Giving in to your own needs as well as her begging encouragement you groan as you sink yourself into her warm confines. Timothy cries out in pleasure as your cock enters her fully, her lion-like legs stroking along your sides as she tries to press you into her even further. The feel of your thick rod inside her warm damp folds is nothing short of amazing, and you find yourself groaning in pleasure as you lean forward, your chest resting on her swollen belly as your hands grip her soft furred thighs. Timothy begins to moan desperately underneath you as you start to thrust into her extremely willing body, her head thrown back on the cushions and her eyes closed in pleasure as you take the little slut gryphoness for your own.";
			say "'Oh god it feels so good, so big and so masculine, I just love the feeling of it buried so deep in me.' Timothy moans underneath you, 'Please take me harder, rut me and fill me with your hot seed! Please use me like a good little pet and fill me up with your eggs!' The gryphoness begs in gasping moans of pleasure, making you grin as she is reduced to little more than a needy beast under you, the pleasure of her well trained body mixing with the pleasure of seeing her become your willing slut, begging for the seed you are sure to give her soon. 'It feels so good to be nice and swollen with eggs, please cum in me, I want to feel your eggs growing in me with all the others, give you handsome little gryphon babies, and you can keep me as happily full as my mistress does...' she coos at you, her lust-filled words filling your mind with pleasure, as her well trained pussy strokes your cock for all its worth. Her ministrations soon have you shuddering in pleasure as your orgasm rocks your body with pleasure, your cock shooting its seed deep inside her body while her soft furred legs clutch you tightly to her. You lie there for several minutes as she pants and strokes your body, your cock emptying itself fully into her body, before slowly softening, the amazing experience leaving you shaking with pleasure even as you pull yourself out of the wanton gryphoness and try to gather your wits about you. 'That was wonderful,' Timothy moans, rubbing her leonine thighs together as her taloned hands stroke her belly. 'I hope I will have some new eggs growing in here soon, though maybe you should come back and visit me again once we both have recovered just to make sure... Don't worry though, I won't tell my mistress about this visit so you can keep coming back and having fun with me...' she says with a satisfied smile on her beak, as she relaxes back on the cushions.";
			infect "Hermaphrodite Gryphon";
			increase XP of timothy by 1;
			now lastfuck of Timothy is turns;
		else:
			say "'Sorry, but I really don't think my mistress would like it if I let a non-gryphon like you have its way with me. It just wouldn't be right for a happy little breeding gryphon like me to get pregnant with anything but gryphon seed you understand,' Timothy says with a sad look at your body. 'Maybe you should try drinking some of my milk or going out to find a nice handsome gryphon to give you a big wet cunt of your own that he could fill with little baby gryphons...'";
	else:
		if bodyname of player is "Hermaphrodite Gryphon":
			say "'Oh my, you look splendid!' Timothy says as she runs her eyes over your female gryphon's form. 'With none of those annoying male bits to get in the way either, I bet you will make a wonderful little breeding gryphon don't you agree?' she says, as she gestures for you to come closer so she can see you better. You find yourself flushing slightly as you obey, your body tightening with need as the heady scent of gryphon sex fills your nostrils, your pussy dampening with need as you crawl up to the pregnant gryphon's form. As soon as you draw close enough, Timothy begins to run her talons along your body, guiding you gently with her hands until you are sitting upright between her legs, and you find yourself staring at her thick black spined cock resting up against her belly, right in front of your gaping pussy. 'So hot and needy already,' Timothy says with a slight chuckle as she reaches down to stroke along your clit, making you moan, 'You really need a nice thick gryphon cock in you don't you? Why not just give in to what your body wants and let me fill you up with mine,' the gryphon says, as she guides you forward, your body responding to her words and touches as she positions you over her thick cock, before lowering you down onto it.[line break]";
			say "The feel of the thick gryphon cock slowly splitting you open as you lower down onto it is amazing, your needy gryphon sex spreading wide eagerly to grip the thick cock like a glove, making you shudder in delight as you find yourself taking Timothy's stiff rod in as far as you can, its soft spines rubbing against you pleasantly as they push into your body until you are resting up against his thick knot. You gasp as the pregnant gryphon pulls you forward so your stomach rubs up against her pregnant belly, making you both moan at the wonderful sensations as she begins to lift her hips up and thrust her cock into you. The movement causes you to groan in pleasure as she bounces you up and down on her cock, your body rubbing up against her large belly with every thrust, while her knot rubs up against the outside of your body, its thick bulge spreading you wider with each thrust as you feel your pussy stretching out to allow that wonderful bulge inside. You find yourself crying out lustily as your body finally relents and you can feel your pussy gripping his knot tight as it finally presses into your body fully, your pussy closing tightly around it as it expands and locks you together.[line break]";
			say "'You need this so badly don't you?' Timothy pants out as she continues to thrust into your all too willing body, 'If even the cock of a little breeding slut like myself feels this good to you, just imagine what the cock of a real stud gryphon is like,' Timothy moans into your ears, as she continues to move within you, her knot tugging at your passage with every small motion, sending waves of pleasure throughout your body. 'Just imagine their strong hands holding you down as they fill you up, mounting you again and again until your belly swells large with their seed.' Her talons stroke the back of your head as you lean down closer, your body clenching in need as her soft words fill your mind. 'You would make such a perfect little breeding slut wouldn't you, with no distracting little cock to get in the way, all you would have to think about is their wonderful cocks locking into your wet pussy, day after day, fucking you until your belly is as large as mine and you bear their big strong gryphon offspring. Don't you want that? Want to be just another happy breeding slut for them to use?' Timothy whispers as she runs her talons along your body, her cock moving slowly within you as she keeps you panting at the edge of orgasm, her words washing over your lust fogged mind as she teases your body. Before you can realize what you are doing, you find yourself nodding and begging as you agree with her, you find yourself begging for some strong gryphon to come claim you and make you its pet, desperately wanting them to fill your body up with fertile gryphon seed, and turn you into a breeding whore just like the pregnant gryphon underneath you. The sheer dirtiness of what you are saying seems to make you even more excited as you beg, the truth of your words filling you with pleasure as you realize that at this moment in time that is exactly what your needy body wants, and an amazingly pleasurable orgasm explodes through you at that realization.[line break]";
			say "'I knew you wanted to be happy and full of eggs just like me,' Timothy moans in victory, as her body stiffens underneath you, her cock twitching inside your hot folds as it finally shoots its thick gryphon seed into your waiting womb, the thick knot tying you together ensuring that not a drop of that oh so fertile cum is wasted, while the spines tickle your passage to ensure your body is receptive. You find yourself panting as you lie on Timothy's stomach lightly, the knot keeping you together as she whispers more dirty words into your ears about the pleasures of becoming a breeding gryphon like her. You find yourself nodding almost automatically at her lewd suggestions of herm gryphons and constant sex, almost wanting to give in and see what life as a breeder is like, eventually though, her knot softens, and the exhausted gryphoness relaxes back on the cushions to rest as you pull your tired body off of her, the spines tingling pleasantly as they pull out of you. You stagger back to your feet and begin to gather your equipment to wander out in the city again, although you find one of your hands keeps wandering back to rub your belly, and you know that with the thick knot locking you together and the lovely spines stimulating your body, the chances of a pregnancy if such a thing is at all possible, is extremely high, somehow this thought just seems to make you feel even better, and you find yourself smiling as you get ready to leave.[impregchance][impregchance]";
			infect "Hermaphrodite Gryphon";
			increase XP of timothy by 1;
			now lastfuck of Timothy is turns;
		else:
			say "'Mmm you want to be filled with wonderful little gryphon eggs too?' Timothy says as she eyes your female form, 'You aren't quite ready to be a proper breeder though yet, while the female parts are in the right place, the rest of your body just doesn't quite match,' the pregnant gryphoness says with a sigh. 'Fortunately I think I have a bit of a drink here that can fix that,' she says as she gestures you closer to her. With her excited scent filling your nostrils you find yourself complying eagerly, your pussy clenching hopefully as you draw closer, slowly crawling up onto the cushions near her leonine feet as you move up to her. She looks down at you over her pregnant belly as you move closer, a strange grin on her beak as she reaches down with one taloned hand and begins stroking her thick black gryphon cock in a teasing manner. As your head draws closer to her nether regions, her musky gryphon scent grows even stronger, and you find your gaze fixing on her cock, her talons moving teasingly along its black length as you draw closer. Drawing up level to her belly, your eyes still fixed on her cock, you are slightly startled to feel her other taloned hand stroke along the side of your head, before softly pushing it downwards towards that enticing black cock.[line break][line break]";
			say "You find your lips parting almost automatically as she guides you down towards her cock, your tongue tracing over its pointed tip as you draw close to it, the taste only intensifying your desire as your mouth waters and your pussy leaks its juices out onto your thighs. 'Oh yes,' Timothy moans, as she guides her shaft into your mouth, her talons gripping your head lightly as she feels your lips enveloping her member. 'Take all of my cock into that wonderful mouth of yours and suck on it please!' She cries out, as she pushes your head downwards. Needing no further encouragement with that delightful taste in your mouth, you find yourself eagerly sucking and teasing on her stiff black rod, your head bumping and rubbing softly against her large belly as it bobs up and down on her lovely shaft. Your mouth grips Timothy's shaft in its loving embrace as she grips the back of your head with her talons, her moans and groans music to your ears as you take more and more of her maleness into your mouth, licking and teasing at the soft black knot at the base of her cock as you suck happily on the rest of her shaft.[line break]";
			say "Unable to help herself, the gryphoness begins thrusting slightly into your mouth, moaning in need as she draws closer and closer to orgasm, the sounds encouraging you lavish even more attention upon her gryphon cock. 'God yes!' She cries out as her body shudders above you, and her cock stiffens as it fills your mouth with its fertile seed, the taste seeming incredible as you do your best to gulp it down. 'Suck it all down,' she moans as she continues to fill your mouth up to the brim, some dribbling down your chin slightly even as you continue working her rod. 'Drink down every little drop of gryphon sperm like a good little breeding slut, and let it make you into just another happy little gryphon whore just like me, ready and willing for all the horny gryphon males to come fill your gaping pussy with their seed. And then you can stay here with me and have your belly nice and full with their eggs too, and we can do this all the time...' she moans out in pleasure, the words seeming to sink into your mind, bringing forth images of your body changing to be more like the gryphons, and how wonderful it would be to be nice and full of new life all the time as you do your part to expand the gryphon population. You pull yourself off her spent cock, licking your lips as your body shudders in its own orgasm, her fertile seed filling your stomach and making your body tingle, and you find yourself wondering if being a happily fucked gryphon pet might not be a good idea after all.";
			infect "Hermaphrodite Gryphon";


Section 5 - Endings

when play ends:
	if bodyname of player is "Hermaphrodite Gryphon":
		if player is pure and HP of Garrett >= 7 and cocks of player > 0 and cunts of player is 0:
			if humanity of player < 10:
				say "     Unable to maintain control against the infection, you are drawn back to Qytat and join Garrett's operation. Following a plan the two of you worked out, the two of your approach the military with an offer to provide reconnaissance on the city. As you both seem calm and sane, you're able to work out the arrangement. By having your staff provide information to the soldiers passing through their routes, they themselves are left unharassed by the military forces. This leaves them free to continue to spread the male milk to others, further bolstering your numbers. To the soldiers just trying to get out of the city, one gryphon in a milk company hat is the same as another, so the swelling numbers go unremarked. And if the occasional stray squaddie gets snatched up for the milking facility - well, who's going to miss one here or there?";
				say "     You take a more active role, focusing on active recruitment of more gryphons. Your experience in the city helps you confront several of the wild gryphons[if level of player >= 10 and Museum Foyer is known], both herm and feral,[end if] and get them to drink some he-gryphon milk. This helps to bolster the hidden production side of the organization with more recruits. And with the milking facilities safely in the invisible floating city, the growing operation is safe from discovery during the military's rescue mission.";
				say "     And while most of the other herm gryphons who return to Qytat have little interest in the male gryphon milking factory, as they have collected some mates and breeding pets of their own, they don't object to it either. Some are even recruited to join up once they get a taste of your product. Mostly though, the operation is left on its own to grow and build up a starting stockpile.";
				say "     Once things settle down, arrangements are made for the special gryphon milk to be sold to clients interested in the exotic and masculine drink. Of course, the commercial product has to be rendered non-infectious first with a quick microwaving. These clients are mostly gryphons who've found places for themselves in the changing world as well as like-minded males looking for an erotic boost to their sex drive. From these starting clients, more are found (or recruited by eager and horny drinkers) and given a taste of the he-gryphon milk for themselves.";
				say "     While you never have a huge number of clients, those you have are more than enough to make your business prosper. And the work is always loads of fun, especially when you and Garrett are personally invited to the special milk parties some of your clients enjoy throwing. These are often spiced up by the inclusion of contraband bottles of unmicrowaved milk - still active with nanites and thus infectious. It's always a highlight to see a half-hearted guest turn into a lustful gay gryphon eager to be showered with attention at these private parties.";
				if gryphoness is tamed and XP of Timothy > 2:
					say "     As your interest is largely focused on gay sex with the other male gryphons, you neglect Denise somewhat, leaving her free to be enticed by Timothy's mistress. Having lost touch with her lingering humanity as well, she's not able to resist her advances for too long before she becomes another egg-laying breeder for the confident herm stud. You don't begrudge her her choice and even become casual friends with her new mistress. And while you do tempt her with an offer of milk from time to time, she's more than happy to stay a lustful herm breeding her sexy pets - pets whom you're freely given the opportunity to breed yourself when you're in the rare mood for a change from studly males.";
				else if gryphoness is tamed:
					say "     As your interest is largely focused on gay sex with the other male gryphons, Denise receives less attention from you. Having lost touch with her lingering humanity as well, she's become a playful recruiter for your company. While she doesn't partake in the drink herself, she's quite adept at convincing others to take a sample. She comes to enjoy watching hot males make out together, often filming for later reviewing or to share with you. She'll also pass along the occasional bottle of untreated milk, making the drinker into another hot gryphon stud. And while the milk does promote homosexual desires, she's found that if she gets to their cock soon enough, they'll end up bi- and more than willing to provide the hearty banging she desires. Once she's done, you're left with another recruit for the milking facility or another eager client.";
				else if XP of Timothy > 2:
					say "     As you remain friends with Timothy, you become acquainted with her mistress. The two of you become passing friends as well. As you're both kept occupied with your own affairs, your interactions are infrequent. You've offered her a sample of your product and she's offered to make you into another egg-breeder pet, but neither of you have pressed the matter. It's more a playful, teasing game you play. Being a friend though, you are freely given the opportunity to breed Timothy yourself when you're in the rare mood for a change from studly males.";
			else:
				say "     Managing to hold out against the infection, you keep yourself [if humanity of player > 33]mostly[else]somewhat[end if]sane and are rescued by the military forces. They've dealt with many others blue gryphons like yourself, though you being male is a bit of a surprise to the soldiers. As such, you take the opportunity to tell them that there are indeed some other male gryphons around, and that they're quite friendly. Some of the men chuckle and joke a bit about what [']friendly['] in this city can mean, but their squad leader does mention that he'll pass it along. You make sure he's got Garrett's name and a place and time that the military can meet up with him.";
				say "     Back at the camp, infection classification and processing for you is straightforward, so you're not detained overly long. As you've seen, the herm gryphons are quite common, so it's to be expected that many of the survivors carry that strain. And while your interests are more for male gryphons now, you do end up making some friends among them.";
				say "     After your release from the processing camp, you go about making a new life for yourself. You get yourself a boring little job with a shipping firm, enough to pay the bills and keep you fairly content. You also keep contact, though only sporadically when possible during the early days, with Garrett and his growing operation. Thanks to your assistance early on, he was able to get it ready enough for the second phase the two of you planned. By the time you're ready to go ahead, he's built up his staffing as well as a stockpile of he-gryphon cream.";
				say "     Once you get word that Garrett's prepared to go into full-scale production, you approach your boss with a lead on a lucrative shipping deal. Of course, the commercial product has to be rendered non-infectious first with a quick microwaving, but giving him some is more than enough to stir homosexual urges in the man and let you have a wild romp with him. This all earns you a sweet promotion and Garrett's special he-gryphon milk gets a distribution network outside of the city.";
				say "     Of course, it's not long before you slip your boss some of the raw product and you promote yourself to the new gryphon in charge, the rest of the staff soon to follow in kind. With Garrett running the production side and you running the distribution side, the two of you have soon secured a thriving business. And while your commercial product isn't infectious, it does make for a fine erotic stimulant, fuelling male-on-male lusts, ensuring you'll always have a steady pool of clients in this new, sex-centric world. You can always count on new clients coming when an existing one convinces, tempts or tricks a friend into sampling some for a hot gay romp.";
				if gryphoness is tamed:
					say "     Denise, surprisingly, becomes quite eager at spreading your product around as well. Being busy with the company (and its many hot gryphon studs), you can't always provide her with the attention she desires. While never taking it herself, she provides an untreated sample to many a would-be suitor. And while the milk does promote homosexual desires, she's found that if she gets to their cock soon enough, they'll end up bi- and more than willing to provide the hearty banging she desires. Often you get a new client and Denise gets a new playmate to keep her company.";
				say "     Also, since the distribution staff are all gryphons as well, they can act as delivery men, promoters and call boys all in one. You have many a client who'll request specific delivery gryphons to come when they're planning a special milk party and such deliveries are always lucrative. They're also quite fun, as you get personally invited to many of them. These are often spiced up by the inclusion of contraband bottles of unmicrowaved milk - still active with nanites and thus infectious. It's always a highlight to see a half-hearted guest turn into a lustful gay gryphon eager to be showered with attention at these private parties.";
		else if XP of timothy > 2:
			if Gryphoness is tamed:
				if humanity of player < 10:
					if cocks of player > 0 and cunts of player > 0:
						say "     Giving in to the infection, and embracing your new gryphonic instincts, you and your lovely companion take off into the sky together, her soft song lifting your spirits as you soar together through the skies. Recalling that breeding gryphon you had the chance to meet earlier, you lead Denise through the skies until you arrive at the lovely nest in the clouds. Timothy's mistress has returned however, and seems more than happy to see the both of you, inviting you in before pouncing on your horny bodies eagerly, you moan as she plays with your eager body, before it is her turn to moan as your mate begins to play with hers. Soon the three of you sprawl out on the bed, where her breeding pet can join in, and before you know it everyone is groping everyone else, and fur and wings are rubbing together pleasantly as soft cries of pleasure fill the room. You aren't sure how many times the other gryphoness takes you, and you aren't sure how many times you end up taking her as you all roll around together in a haze of carnal bliss. Eventually you are all lying there spent and exhausted, with no real clue as to who actually came out on top, and hardly caring at all as you rub your well fucked belly happily, your cock beginning to stir again as you can see the other gryphons doing the same. You can feel a grin starting to tug at your beak, as you begin to prepare yourself for another fun round of playing, and realize that while none of you seem to be able to, or even willing to come out on top at this point. The four of you certainly make a lovely breeding circle together. Eventually as your bellies grow large together with the results of your many couplings, you actually grow to be something of an odd family as well, a family that is very soon going to be growing much. Much larger...";
					else if cocks of player > 0 and "MPreg" is listed in feats of player and "Submissive" is listed in feats of player:
						say "     Surrendering to the infection and your new strong gryphon instincts, you and your lovely companion take off into the sky together on your strong new gryphon wings, enjoying the freedom of flight as you dance through the air together. Soon your instinctive needs lead you back to where you found and enjoyed the other lovely breeding gryphon in the sky. A shiver of excitement runs through your loins as your male womb feels a heated need building. Wanting to wait no longer, you hurry in with Denise in tow to greet Timothy properly. You are pleased to find that her mistress has returned and is there with her.";
						say "     At first, she's cold and cautious with you, upset to find a male seeking to play with her pet breeder. It doesn't take you long to convince her that you'd much rather be on the receiving end; bending over the edge of the nest and shaking your ass for her certainly catches her attention. She's on you like a shot, not wanting to lose this opportunity to conquer a potential usurper. She's rough and wild with you, getting you moaning and panting beneath her. As the dominant herm fucks you, you make out with Denise and Timothy, sharing kisses and sucking their cocks. Timothy's mistress seeds you and Denise multiple times until you're both bloated and bred by her virile semen.";
						say "     She's somewhat disappointed when you remain male even after her multiple breeding attempts, growing more emphatic about pounding you every time she has a go at you. With such a zealous fuck session over the next few days, it is no surprise to you when you grow gravid with eggs. Your new mistress is quite surprised by this and seems quite pleased with the outcome. You are a unique prize among the gryphons, no other dominant gryphon having such a special fucktoy. She happily keeps you and Denise, giving you collars and adding you both to her nest of breeders. Wearing her collar makes you smile, and makes you feel even hornier than ever, as you turn the tag up to read your new name. You feel yourself smiling happily as you see you are now called [']Egg Boi['], a name you look forward to living up to for your mistress, rubbing your stomach happily as you lie back next to your mistress's other pets. As your ass gets pounded again with your mistress's throbbing cock, Denise and Timothy are happy to suck your cock. Seeing Denise's new collar with its tag of [']Kitten['] makes you smile, knowing both you and her will soon be as bloated and rounded with eggs as Timothy, both entering a happy and well-fucked life as breeder gryphons.";
					else if cocks of player > 0:
						say "     Surrendering to the infection and your new strong gryphon instincts, you and your lovely companion take off into the sky together on your strong gryphon wings, enjoying the freedom of flight as you dance through the air together. Soon your instinctive needs lead you back to where you found and enjoyed the other lovely breeding gryphon in the sky, landing outside, you find that sadly Timothy's mistress has returned to stop you from playing with her happy little breeder. She tries to drive you back with several blows from her strong wings, but with the help of your companion you are soon able to overpower the other gryphon as well. Timothy looks on eagerly as you pin her former mistress down on the pillows next to her, your own breeding pet cooing encouragement as she holds the formerly dominant gryphon down for you.";
						say "You can feel a grin stretching across your beak as you push your gryphon cock into the new gryphoness, your knot locking the two of you together as you thrust into her all too eager body. Soon she is moaning underneath you as eagerly as your other breeding pets, and you grin as Timothy and Denise pant in excitement as they watch you mount the formerly powerful gryphon, each thrust of your barbed cock in her body making her more and more submissive to your touch. Finally you shoot your seed into her body, marking her as yours, and relax for a little with her underneath you, before you begin again, much to her dismay. You enjoy mating your new pet again and again, only stopping to take turns with your other breeding pets, before returning to sink yourself into her body again. You are finally satisfied when her belly begins to show signs of growing large with your seed, and her newly enhanced submissive streak has her begging to bear your gryphon young just as eagerly as your other two pets. Grinning as you look over your three egg filled mates, you realize that the happy life of a gryphon stud is definitely the life for you, and you set out into the city to see if you can find any other people who would make good breeders for a handsome gryphon stud such as yourself, returning often to make sure that your current stable of breeding pets never lack your seed or your eggs in their bellies... ";
					else if cunts of player > 0:
						say "     Surrendering to the infection and your new strong gryphon instincts, you and your lovely companion take off into the sky together on your strong new gryphon wings, enjoying the freedom of flight as you dance through the air together. Soon your instinctive needs lead you back to where you found and enjoyed the other lovely breeding gryphon in the sky, landing outside the area, you smile happily as your mate leads you inside to greet Timothy properly. You are somewhat happy to see that her mistress has returned, and she certainly seems happy to see the two of you, her pet having told her all about you and how she told you all about the lovely life of a breeding gryphon. The handsome dominant gryphon soon has both you and your mate panting needfully, as you sprawl out on the cushions near Timothy, you find yourself moaning happily as you watch while she dominates and mates Denise properly while you and her pet play together on the cushions. Soon she leaves your mate moaning happily as she rubs her well bred body, and comes over to where her pet has you hot and ready for her already.";
						say "     You can feel a grin tugging at your beak even as you spread your legs for the wonderful gryphon stud you now realize is going to be your mistress from now on. The feeling of your mistress's thick knot locking her inside your body, and ensuring that you will bear her lots of wonderful gryphon eggs is just amazing, and you pant eagerly and beg for more even as she shoots her fertile seed into your body. As you begin to come down from your wonderful orgasm, you feel her settling something around your neck, and look down to find that your thoughtful new mistress got you a collar to mark you as hers. Wearing her collar makes you smile, and makes you feel even hornier than ever, as you turn the tag up to read your new name. You feel yourself smiling happily as you see you are now called [']Breeder['] you moan eagerly as you look forward to living up to your new name for your mistress, rubbing your stomach happily as you lie back next to mistress's pet, your mistress's cock still sending soft pulses of her wonderful seed into your heat filled body. Looking over to where Timothy is lying there happily, you can't wait until your belly is as nice and round with your mistress's eggs as hers is. Glancing over to where Denise is lying, you see your mistress got her a collar too, and coo happily as you realize that the formerly shy and musical gryphon can look forward to a wonderful new life as her mistress's [']Kitten['], and are sure she will be just as happy and well-fucked a breeder gryphon as you are looking forward to being...";
					else:
						say "[bracket]***Sorry, no neuter ending at present.[close bracket]";
					if HP of Garrett >= 7 and cocks of player > 0 and cunts of player is 0:
						say "[garrett_ending_add-on_1]";
				else:
					say "     When the military finally arrive to evacuate people, you find yourself unwilling to leave, as thoughts of Timothy and Denise fill your head, and you find yourself returning to the floating city with Denise at your side. The other gryphons welcome the two of you to the city eagerly, and while several of them try to trick you or Denise into a submissive position, or convince you to be a breeder for them, you both manage to resist by holding on to each other instead. At some point, as the cloud city drifts away from the city below to seek safer lands, you look up Timothy and finally meet the happy breeding gryphon's mistress. She seems somewhat reluctant to invite the two of you in at first, but with her pet's encouragement she lets you in, and proves to be a nice enough gryphon, if a rather dominant one. Eventually she offers to let the two of you stay there with her and Timothy for a while until you can both find your own place, and even knowing that she certainly intends to add you both to her stable of breeders if she can, the two of you happily accept.";
					if cocks of player > 0 and cunts of player > 0:
						if a random chance of 1 in 2 succeeds:
							say "     [one of]Denise is soon the first to succumb, and you find her lying there happily bred next to Timothy one day, moaning wantonly and rubbing her belly as if eager for it to swell with new life just like Timothy's. You are somewhat careful of the other gryphon after that, and even think of leaving while you still can, but Denise manages to convince you to wait a while and think about it instead. Later that night though, you are woken up to find Denise and Timothy holding you down, while their mistress begins to push herself into your new gryphon cunt. You moan as she takes you again and again, your dominant urges replaced by increasingly submissive and maternal urges as her seed fills your body. Eventually you find yourself lying on the cushions yourself and rubbing your own full belly happily, and when Denise explains that she didn't want to stay here without you, you forgive her easily... after all, how else would you have learned how wonderful it is to be a lovely gryphon breeder?[or]Denise is soon the first to succumb, and you find her lying there happily bred next to Timothy one day, moaning wantonly and rubbing her belly as if eager for it to swell with new life just like Timothy's. Angry, you confront the other gryphon, and a fight soon ensues, with the more powerful gryphon easily driving you back, and pinning you down, and you moan as you feel her cock pushing into your new gryphonic pussy. You are unable to resist as she pins you down and fills you with her seed, and you eventually begin to moan and respond to your new mistress like a good breeder should. She makes sure to breed any trace of resistance out of you, and you happily find yourself serving as not only your mistress's pet, but as a pet for her other two breeding gryphons as well, your belly always nice and full with their eggs... aren't you lucky![or]You are the first to succumb to the crafty gryphon's blandishments, as she teases you incessantly, hinting at her willingness to be a breeding mare for you, only to turn the tables on you at the last minute, when your body is too heat filled and aroused to resist. Afterwards, with her seed filling your happy body, you just know you have to share this wonderful feeling with Denise, and soon manage to convince her to join you in your new life as a lusty egg slut for your new mistress...[at random]";
						else:
							say "     Watching the other gryphon closely, you decide you can't afford to wait and let her have the opportunity to take advantage of you. You manage to convince Timothy to entice her mistress to play with her for a while, the happy breeding slut more than eager to go along with any plan that involves her mistress filling her body with seed. When the gryphon is distracted, you and Denise pounce while she is still tied to Timothy, mating her in pairs while she can't resist, and holding her down afterwards and continuing to mate her eager body until she is begging to be filled with your eggs. Grinning at Denise, the two of you make sure that both she and Timothy are nice and full of your eggs, as the two of you settle in together as the new masters of your strange household.";
					else if cunts of player > 0:
						if a random chance of 1 in 2 succeeds:
							say "     Denise is soon the first to succumb, and you find her lying there happily bred next to Timothy one day, moaning wantonly. She rubs her belly as if eager for it to swell with new life just like Timothy's. You cannot blame her for it; she was never a very dominant partner in your couple, despite having the cock. You walk over to her and give her a kiss, then kiss Timothy as well, moving your paws to their cocks and stroking them. They moan happily at your touch.";
							if a random chance of 1 in 2 succeeds:
								say "     You slide down to your knees beside the nest and set to licking and sucking on their cocks. You please the pair orally, stroking, fingering, sucking and licking them until they each cum down your throat. You tell them repeatedly how beautiful they look and how lovely their egg-filled bellies are. When Timothy's mistress returns, you are quite excited and dripping for her. She mounts you without delay, claiming you as another breeding pet for her harem. You moan in delight as she thrusts into you while the others watch and stroke themselves off, spraying their seed onto your gryphoness body while she pumps her seed into you, breeding you with a clutch of eggs of your own - the first of many in your new life.";
							else if a random chance of 2 in 3 succeeds:
								say "     The sight of their well-bred bodies gets to be too much for you and you climb atop your mate's cock, moaning happily as it sinks into you. You start to ride Denise's hard rod as she bucks her hips and thrusts into you. Timothy smiles happily, stroking your hip and pulling your face down to her bosom. You lick and suckle from her nipples, drinking down her milk. Denise's cock blasts her hot seed into you, filling you with her eggs and breeding you like your body calls out for. When Timothy's mistress returns, she finds you all snuggled together and nicely bred full of growing eggs, quite pleased with her little harem. She mounts you all in turn, starting with you. She is mistress to you all now and will claim all your subsequent clutches, but you are quietly happy to have given your first to Denise.";
							else:
								say "     The sight of their well-bred bodies gets to be too much for you and you climb atop Timothy's cock, moaning happily as it sinks into you. Even as she starts reflexively thrusting into you, she moans something about waiting for her mistress, but you won't listen. You want the subby gryphon pet to claim your first clutch, wanting to give in entirely and be beneath them all. The breeder's objections stop when Denise moves over stuffs her breasts over her face, getting the pet to drink her milk. When Timothy's knot ties with you and her hot seed blasts into your womb, you moan in delight with the knowledge that her eggs will grow in you. You are now such a lowly slut that you'll give yourself to even pets and breeders like Timothy. When Timothy's mistress returns, she finds you all snuggled together and nicely bred full of growing eggs, quite pleased with her little harem. She mounts you all in turn, starting with you. She is mistress to you all now and will breed you all often. When she gives you a collar, its tag says [']Fucktoy['], for that's all you are now. She breeds you often, but you are a troublesome slut at times. Behind her back, you sneak away often to have Denise, Timothy, other dominant gryphons or even the slutty breeders of other gryphons fuck you full of eggs. You are the lowest of the low, the sluttiest of the sluts, the fucktoy and breeding slut of the entire colony, and you love it.";
						else:
							say "     You are the first to succumb to the dominant gryphon's advances, as she teases you incessantly. She is much stronger and more dominant than Denise and knows it. She whispers in your ear about how she'd give you far more eggs and much stronger gryphlets if you let her take you. Even her cock is bigger, though she lets her size speak for itself. It all becomes too much for you in time and you spread your legs for the sexy herm. She drives her cock into you and mates you repeatedly, ensuring you get the big clutch she promised. When Denise comes back to find you fucked and bred, she is claimed as well while you and Timothy hold her down. Not that she resists, per se, but having a horny, egg-filled gryphon on either breast silences all objections or questions. With her womb is filled as well, your mistress's harem is complete with you tagged as [']Breeder['] and the musical Denise as [']Kitten[']. The trio of you make a lovely nest of egg-sluts for your strong mistress.";
					else if cocks of player > 0 and "MPreg" is listed in feats of player and "Submissive" is listed in feats of player:
						if a random chance of 1 in 2 succeeds:
							say "     Being in the presence of such an assertive, dominant gryphon wears down your resistance fairly quickly. As much as you love Denise, she's simply not dominant enough to truly satisfy you. Coming to your decision, you have Denise go have fun with Timothy for a while while you and her mistress go off together, ostensibly to talk. The gryphon, expecting a confrontation, is surprised when you submit to her quite willingly, begging for her to pound your ass. She does so many times, somewhat frustrated that you won't produce a pussy for her to breed. By the time she's done, you're left you bloated and leaking her cum from your anus. Returning with her to the nest, Denise is quite excited by Timothy's enticing descriptions of the breeder slut life and is bred several times while you watch.";
							say "     Your submissive instincts have you begging to be fucked repeatedly over the course of the next several days. With so much virile gryphon cum being pumped into your fecund ass, it is no surprise to you when you grow gravid with eggs. Your new mistress is quite surprised by this and seems quite pleased with the outcome. You are a unique prize among the gryphons, no other dominant gryphon having such a special fucktoy. She happily keeps you and Denise, giving you collars and adding you both to her nest of breeders. Wearing her collar makes you smile, and makes you feel even hornier than ever, as you turn the tag up to read your new name. You feel yourself smiling happily as you see you are now called [']Egg Boi['], a name you look forward to living up to for your mistress, rubbing your stomach happily as you lie back next to your mistress's other pets. As your ass gets pounded again with your mistress's throbbing cock, Denise and Timothy are happy to suck your cock. Seeing Denise's new collar with its tag of [']Kitten['] makes you smile, knowing both you and her will soon be as bloated and rounded with eggs as Timothy, both entering a happy and well-fucked life as breeder gryphons.";
						else:
							say "     Denise is soon the first to succumb, seduced by Timothy's enticing descriptions of the breeder slut life and by her mistress's advances. You find her in the nest, messy with the dominant gryphon's seed as another breeding session is coming to an end. Denise moans and rubs her belly, eagerly imagining the eggs which will soon swell within it. As you advance upon the nest, Timothy's mistress grins, but readies to fight you for her newly claimed prize. She's quite surprised when you bend yourself over the nest, raising your ass to her even as you take your one-time companion's cock into your mouth and suck her off. Not one to waste such an opportunity, your ass is mounted and fucked right then and there. You end up getting filled multiple times by the randy gryphon more and more emphatically in her attempts to give you a pussy. This enthusiastic, rough fucking is just what your submissive instincts need from the virile, dominant herm, turning you on greatly and driving you to many a climax of your own.";
							say "     Over the course of the next several days, you and Denise are fucked multiple times. And while your new mistress is only thinking of you as a rival male she's made into her fucktoy, you know there is a much more pleasurable purpose to your moaning demands to be pounded. After so much zealous breeding, it is no surprise to you when you grow gravid with eggs. Your new mistress is quite surprised by this and seems quite pleased with the outcome. You are a unique prize among the gryphons, no other dominant gryphon having such a special fucktoy. She happily keeps you and Denise, giving you collars and adding you both to her nest of breeders. Wearing her collar makes you smile, and makes you feel even hornier than ever, as you turn the tag up to read your new name. You feel yourself smiling happily as you see you are now called [']Egg Boi['], a name you look forward to living up to for your mistress, rubbing your stomach happily as you lie back next to your mistress's other pets. As your ass gets pounded again with your mistress's throbbing cock, Denise and Timothy are happy to suck your cock. Seeing Denise's new collar with its tag of [']Kitten['] makes you smile, knowing both you and her will soon be as bloated and rounded with eggs as Timothy, both entering a happy and well-fucked life as breeder gryphons.";
					else if cocks of player > 0:
						if a random chance of 1 in 2 succeeds:
							say "     Noticing how the dominant mistress is turning Denise's head at times, attracting her with her herm body, you decide you can't risk waiting much longer before she tries to steal your mate away. You decide to turn the tables on her and sneak into Timothy's nest one evening. Being a purely male gryphon, the slutty gryphoness has been eyeing you lustfully in her own rights and is easily swayed into letting you fuck her. As you mate the slutty herm, you whisper to her over how you intend to breed her and that it takes a big male like you to breed a slut properly, that full males are the best studs. After you've finished filling her pussy and womb with your seed, you leave her, hopeful that you'll be able to steal her away in a few nights' time.";
							say "     But you are then shocked to find Timothy's mistress dismounting from Denise after filling her, clearly having started on the same plan. You stare at each other, with her running to check on her [']Pet['] and finding her in the same state as yours. You both stare at one another before finally breaking down and laughing at one another and yourselves. From that point on, you are fast friends instead of rivals. You are a pair, master and mistress, to both the subby gryphonesses. The title of [']Songbird['] is bestowed upon Denise as you each take turns fucking her and Timothy. You occasionally teasingly try to coax the mistress into letting you mount her, but she only chuckles that she will after you let her mount you first. It is all a playful game though, for she happily lets you finger or eat her out and you never try to steal the chance to fuck her while she's knotted in one of your mutual pets. You have a very happy nest and wouldn't change it for any other arrangement.";
						else:
							say "     Noticing how the dominant mistress is turning Denise's head at times, attracting her with her herm body, you decide you can't risk waiting much longer before she tries to steal your mate away. You decide to turn the tables on her and whisper your plan to Denise. At first, she's a little reluctant, but obediently gives in to her male's request when she offers a small change to your plan. Seemingly behind your back, she plays up her attraction to the gryphoness and allows herself to be taken off in secret to be mated by the mistress. But you are there, ready and waiting. With Denise on her knees and sucking the gryphoness's cock before the mating can commence, you sneak up behind the herm and drive your shaft into her. She struggles briefly, but between the cock in her pussy and the hot beak around her shaft, she has trouble resisting and soon gives in entirely. You fuck her beneath the night sky for hours, taking turns with Denise until she's been filled so many times that she stops resisting and gives in to you both. You drag her back to Timothy's nest and toss her onto it, shocking Timothy. The gryphoness is even more shocked as you force your new slut to mount her one-time pet's cock and ride it for another dose of gryphon cum in her slutty pussy. When the morning comes, you have a lovely harem of your own, with Denise as your [']Songbird['], Timothy now as your [']Pet['] and the former mistress reduced to [']Fucktoy[']. You have your fucktoy used by all, even Timothy and the other pets and breeders of the colony. She always moans and squirms any time you let a breeder take her, but she always cums the hardest for them as well, so you know she loves it. All her eggs grow into the best subby pets and breeders of the colony. After their mother, that is.";
					else:
						say "[bracket]***Sorry, no neuter ending at present.[close bracket]";
					if HP of Garrett >= 7 and cocks of player > 0 and cunts of player is 0:
						say "[garrett_ending_add-on_1]";
			else:
				if humanity of player < 10:
					if cocks of player > 0 and cunts of player > 0:
						say "     Giving into the instinctive urges deep within your needy mind, stiff cock, and hot pussy, you find yourself taking off on your new wings as you head back to the place where you found and enjoyed the wonderful breeding gryphon. Much to your delight, you find that Timothy's mistress has returned, the handsome herm gryphon welcoming you with open arms as she sees how needy and ready your body is for her. Before long she has your body pressed up against Timothy's needy form, your cock pressing at the needy wetness between Timothy's legs even as she fills your pussy up with her own wonderfully strong gryphon cock. You find yourself overwhelmed with pleasure as she guides your cock into Timothy's silken passage, the pregnant gryphon moaning underneath you as you are sandwiched between her and the strong and powerful gryphon behind you. Your lust fogged mind quickly succumbs to the intense pleasure of both fucking and being fucked at the same time, your body pressing into the gryphon underneath you in time to the stronger gryphon mistress's thrusts. Soon she cries out as she fills your needy body with her fertile seed, the feel of all the lovely baby batter coating your insides triggering your own orgasm as your body shoots its own seed into your fellow breeding slut. You stay there panting, your bodies locked together in pleasure by your thick gryphon knots as her seed sinks into your body, working to fill your womb with her eggs. You find yourself smiling as you can feel your mistress slipping her collar around your neck, marking you as her property just as much as the smiling gryphon underneath you.[line break]";
						say "     You look down and tilt the tag up to read your new name, and you can feel your beak pulling back in a smile as you can see the tag that proudly proclaims you to be [']Toy['] hanging from your collar. You can't help but feel joy at the rightness of the name, and moan in pleasure as your mistress's cock begins to stiffen and move within you again. Your mind is overwhelmed with lust as she begins to use you like a good toy, filling your needy belly up again and again with her seed, even as her pet writhes underneath you. Soon you know you will look just like her pet, your belly round and large with her eggs, and your form so well bred it will be hard to even move, lying here together waiting for your mistress to return and fill you with even more eggs so you can birth the next generation of her wonderful offspring. Just the thought of your eventual fate seems so wonderful to your instinct driven mind now, as you rub your leonine legs against hers, that you find yourself begging and pleading for her to fill you up with her seed again and again until your body is as round and full with life as her pets. Your mistress is happy to comply, and soon you find yourself living a wonderful new life, as your mistress's happily pregnant new toy, and though you and her pet often keep each other company while she is out, putting your flexible beaks and talons to work, you are both happy to know that only her seed fills your wombs with her wonderful eggs, which you birth for her time and time again. You are so happy you discovered the pleasures of being just a lovely gryphon's breeding toy...";
					else if cocks of player > 0 and "MPreg" is listed in feats of player and "Submissive" is listed in feats of player:
						say "     Giving into the instinctive urges deep within your needy mind and needy body, you find yourself taking off on your new wings. You are drawn back to that floating city where you found that wonderful breeding gryphon. Not quite fully understanding your desires, you follow the urge to return to her nest. Upon arrival, you find that Timothy's mistress has returned, the handsome herm gryphon watching this male intruder guardedly. But rather than confront her for control of her [']Pet['], you instead offer up your ass to her, telling her you'd much rather be another gryphon breeder right beside Timothy. Suspicious, but not wanting to let such an opportunity slip away, she drives her thick, knotted cock into you. She pounds you repeatedly, each time with increasing zeal as your body resists gaining a pussy for her to breed. The rough fucking and all the hot cum she pumps is just what your subby breeder instincts have been demanding and you beg for more over the course of the next several days.";
						say "     Having been fucked and filled so much over the next few days, it comes as no surprise to you when your belly starts to swell with growing eggs as well as all the cum stuffed inside you. Your new mistress is quite delighted by this unusual turn of events. You are so very happy when she bestows a collar upon you, tagging you as her [']Egg Boi['] from now on, a name you look forward to living up to for your mistress. You are considered quite the prize among the gryphons, no other dominant gryphon having such a special fucktoy and you are loaned out to many of them for their amusement and to add their eggs to your growing clutch.";
						say "     Timothy particularly enjoys watching you lay your eggs, finding it strangely captivating and arousing. If your mistress is not around when you lay a clutch, Timothy will eagerly mount and fuck you herself, driving her cock into your recently vacated ass to have first claim on a few of your new eggs. It's only at this time that she'll sneak a fuck behind her mistress's back and it's a something you both keep secret from her. The thought of being such a subby egg slut that you'll even let your mistress's pet breed you always brings a smile to your beak.";
					else if cocks of player > 0:
						say "     Giving in to the instinctive urges deep within your needy mind and stiff, you find yourself taking off on your new wings as you head back to the place where you found and enjoyed the wonderful breeding gryphon. Unfortunately you find that Timothy's gryphon mistress has returned, and upon seeing you she does not appear amused. Spreading her wings out she drives you back with several harsh blows, keeping her pet to herself as she drives your male form off to find another breeder to fill with your seed. Your body's new needs only enhanced by the touches of a breeding slut, you prowl the streets looking for a unclaimed pet of your own. Having surrendered to the infection rather late, you find the city practically empty of good stock, until the military arrives.[line break]";
						say "     You carefully stalk several of the soldiers until you can manage to lure one of the females away from the rest long enough for you to swoop in and carry her off. She is stunned as you carry her to your prepared nest, where you then proceed to quickly strip her bare and master her body with your strong gryphon cock. You love the feel of her body changing underneath you as you rut her again and again for hours on end, driving all her old and unnecessary human thoughts from her new gryphon brain as you make her into a fitting receptacle for your eggs. You are happy to see that when she is finished she is perfectly matched to you, a proper breeder with just a lovely well fucked cunt instead of the dual equipment so many of the other gryphons sport. Soon she is your happy mate, her belly swelling with your eggs, and her body eager for your seed every time you return from your hunting, she bears you many healthy gryphon eggs as time passes, and eventually you manage to find more pets to share your nest and keep her company while you hunt, though she always remains your favorite. Your many, many offspring will eventually spread across the land, converting more and more people into happy little breeding gryphons... but not for some time to come.";
					else if cunts of player > 0:
						say "     Giving in to the instinctive urges deep within your needy mind and hot pussy, you find yourself taking off on your new wings as you head back to the place where you found and enjoyed the wonderful breeding gryphon. Much to your delight, you find that Timothy's mistress has returned, the handsome herm gryphon welcoming you with open arms as she sees how needy and ready your body is for her. Before long she has you sprawled out face down on the cushions, your head between Timothy's legs as she fills your pussy up with her wonderfully strong gryphon cock. The pleasure of her barbed cock pressing into you making you moan as you lick and suck eagerly at Timothy's cock even as the gryphon stud fucks you roughly. Soon you find yourself orgasming uncontrollably underneath her as she fills your belly up with her fertile seed, your body shuddering as it prepares itself for the eggs that are sure to come.";
						say "     As you lie there trying to recover your mouth still licking and nuzzling at Timothy's sex, you feel something settling around your throat, and look down to find that your mistress has just fitted you with your own collar, marking you as just another one of her happily fucked pets. You raise one of your talons up to tilt the tag up so you can read what it says, and find your beak pulling back in a smile as you see it reads [']Egg-Slut['] and you realize just how true the tag is, and find yourself enjoying how it declares your purpose to any handsome stud gryphon who draws near. You find yourself cooing happily as your mistress strokes your feathered head with her strong talons, happy to finally be free to be nothing more than your mistress's little egg slut. You find yourself smiling as she guides you back down onto the cushions next to your fellow breeding slut, her cock already thick again and ready to fill your needy body will all the eggs your slutty heart could desire... and you find yourself glad as you feel her thick gryphon seed shooting within you again, that you have finally found where you belong, serving your mistress and bearing her many, many young...";
					else:
						say "[bracket]***Sorry, no neuter ending at present.[close bracket]";
					if HP of Garrett >= 7 and cocks of player > 0 and cunts of player is 0:
						say "[garrett_ending_add-on_1]";
				else:
					say "     When the military arrive and you are finally able to leave the city, you find yourself constantly wondering about the strange breeding gryphon you left behind in that strange floating city. And you find yourself wondering if they are still there even after the military has long since evacuated those on the ground, the happy breeder and her mistress and gryphon studs who keep her filled with eggs again and again. Eventually curiosity gets the better of you, and you pack up and head back to the city to look, you tell yourself that it is just to let them know they should return to normal society, as you follow the trail they left to their city where it hides among the mountains, you feel your body responding to the scent, and realize that it is you that has finally come home, as they greet you with open arms. While you are never heard from again, there are persistent rumors of an ever growing number of gryphons in those isolated mountains...";
		else if Gryphoness is tamed:
			if humanity of player < 10:
				if cocks of player > 0 and cunts of player > 0:
					say "     Giving into the infection and embracing your new gryphonic instincts, you and your lovely companion take off into the sky together, your new wings lifting you aloft easily. Your companion's song fills the air with its lovely tunes as you soar through the skies above the city together. Soon the two of you find a nice secluded spot away from the city and the press of the military and other infected, and you settle down to enjoy your new lives together, your days filled with the joys of flight, song, and lots and lots of sex. You both take turns mating each other lustily, often several times a day, and after a while you can't help but smile at the sight her belly growing large and round with the fruits of your labors... but then again, your belly is also beginning to show the fruits of her labors as well, and you smile as you realize your little family is about to get a lot larger...";
				else if cocks of player > 0 and "MPreg" is listed in feats of player and "Submissive" is listed in feats of player:
					say "     Giving into the infection and embracing your new gryphonic instincts, you and your lovely companion take off into the sky together, your new wings lifting you aloft easily. Your companion's song fills the air with its lovely tunes as you soar through the skies above the city together. Soon the two of you find a nice secluded spot away from the city and the press of the military and other infected, and you settle down to enjoy your new lives together. Your days are filled with the joys of flight, song, and lots and lots of sex. While you both take turns mating each other lustily, often several times a day, neither of you is quite satisfied with the dominant role in your relationship. For a time, your relationship goes on with you both taking a turn on top to satisfy your lover's desire to be fucked. As enjoyable as cumming in your lover is, you both find it far more fulfilling when on the bottom.";
					say "     Thankfully good fortune comes your way in the form of a young soldier scouting the area around your love nest. Using your accumulated skills, you're able capture him and bring him back to the nest. At first he's a little resistant, but some sexy enticement from Denise soon has him giving in. After he's fucked her a few times and is well on his way to becoming a herm gryphon, you offer up your ass and are soon pounced and pounded until you're leaking gryphoncum from your creamy asshole. Whether it's some trace of his old personality or due to your wanton begging to be dominated, your new lover is a strong, confident and virile stud of a gryphon, eagerly taking the role of top and breeding you both thoroughly. You and Denise are still permitted to fuck one another and do so happily now that you have your dominant stud to fuck the top of your pairing so you're both left satisfied. And when she's feeling her own heat, she's more than willing to pin you down and ride your cocks until she's got a growing clutch of eggs to match both of her sexpets['] bloated bellies.";
				else if cocks of player > 0:
					say "     Giving into the infection and embracing your new gryphonic instincts, you and your lovely companion take off into the sky together, your new wings lifting you aloft easily. Your companion's song fills the air with its lovely tunes as you soar through the skies above the city together. You find yourself enjoying how eagerly your partner displays herself for you, and how much she enjoys you filling her belly with your seed, obviously happy and eager to finally embrace the life of a gryphon breeder. Happily leading her out of the city, you soon manage to find yourself a nice den near a small town, where you can both be safe while she grows large with your eggs. You return to the city occasionally to watch the skirmishes between the military and the other infected, occasionally joining other gryphons as they swoop down to intervene sometimes, or to play tricks with the military's milk supply like the one the gryphons played at your mate's apartment. You find you enjoy flying off and leaving the transforming military behind to deal with their strong new urges, and even manage to bring a couple of them home to join your mate as happy breeders once they have realized their true calling. Soon your den is full of your offspring as well as several happily gravid breeding gryphons, and you can't help but feel a smile tugging at your beak as you hear the soft tones of Denise's song as she sings the little ones to sleep, happy to have finally found a nice home together with your mates.";
				else if cunts of player > 0:
					say "     Giving in to the infection, and embracing your new gryphonic instincts, you and your lovely companion take off into the sky together, your new wings lifting you aloft easily. Your companion's song fills the air with its lovely tunes as you soar through the skies above the city together. Eventually your handsome mate guides you out of the city, and you find yourself giving in to the more masculine gryphons urgings almost instinctively. Following your mate you travel for several days before you end up settling on a cliff near a rather large city, the closeness of the nearby populace has you nervous, but Denise calms you down easily as she rubs up against your female form, her hands stroking and exciting you, until you forget all your objections as you bend over to let her mount you again and again. You find yourself falling easily into the role of a submissive breeder for your handsome mate, as you set up your new den eagerly for them during the day, and present yourself eagerly to be bred whenever she wants. Soon you can feel your belly growing round with new life, the feeling of your mates children growing inside you making you happier than you ever thought possible. Eventually as you grow even larger from your continued matings, you are unable to even leave the den any longer, letting your mate do all the scouting around the city while you rest and relax like a good little gryphon breeder. After a while you find out why your mate picked this particular city to settle down in, as another gryphoness joins you in the den, and you are happy to have the company, as well as another lovely breeder to help you bear your mates children. The new breeder tells you this city is famous for it's musical talent, and that several people have been lured out into the dark by your mates beautiful song, where the ones who can sing best she tries to transform. You smile happily as you realize your mate is finally able to live up to her dream of singing for other musicians, and look forward to her adding several more of her conquests to the den soon as well... after all, surely they will all be as drawn in by her lovely lonely song as you were once upon a time...";
				else:
					say "[bracket]***Sorry, no neuter ending at present.[close bracket]";
			else:
				say "     When the military comes, Denise is scared, but you manage to convince her to come with you, and the two of you go with the military to be cleared for life outside the city. The military are slightly worried about just how infectious your particular strain of infection has proven, but between the two of you, you manage to sweet talk them into letting you go, your obvious intelligence and control convincing them to focus on the problems still inside the city instead. Afterwards you both wander around together aimlessly for a time, and Denise begins to grow slightly depressed again before you spring your surprise on her. Your fellow gryphon is shocked when she realizes you have been learning to play a guitar you had specially modified for your talons, and is equally surprised when you introduce her to several other infected outside the city with some musical talent. She grows increasingly excited as together you put together your own band, and her joy is infectious, soon you and your new band are laughing and having a great time together, as she puts her lovely new voice to use. With your enhanced reflexes and perfect gryphon hearing, you make an excellent guitarist as well, being sure to always give her the perfect backdrop to allow her voice to shine. Soon your band is drawing larger and larger crowds, at first because it is a novelty band made up entirely of those changed in the outbreak, but quite soon more and more people are actually being attracted because of your unique sound and musical talents. The two of you are soon happier than ever as you travel around with the band, enjoying your new [if charisma of player > 17]superstar[else if charisma of player > 14]major[else]minor[end if] success status. Though remembering your time together in the city, neither of you let the fame go to your head too much, and you continue to enjoy your time together away from the stage most of all... although sometimes you end up enjoying your time together with some of the bands groupies as well... but that's another story...";
				if HP of Garrett >= 7 and cocks of player > 0 and cunts of player is 0:
					say "[garrett_ending_add-on_2]";
		else:		[Gryphon body w/neither Timothy nor Denise goes here]
			say "     During your rescue from the infected city and the subsequent processing, you have a fairly easy time of it thanks to your infection. As the gryphon form you have picked up is a fairly common one, the testing period you undergo is pretty brief. You make a few friends among the other gryphons there before getting released.";
			say "     Looking to make a new life for yourself, you manage to get yourself a courier job once you get the hang of flying on your new wings. While it doesn't pay that well, it lets you fly around and get paid for it. And having kept in touch with the other gryphons and part-gryphons you'd gotten to know, you can usual get a flying companion or a bed companion whenever you like.";
			if HP of Garrett >= 7:
				say "     Some time after you settle into your new life, you notice a new product on the market - he-gryphon milk. The musky, milky fluid (now microwaved to be non-infectious) is marketed as an exotic drink that temporarily stimulates and enhances male-on-male pleasure in the consumer. It pleases you to see that Garrett's product has become somewhat of a success, especially among the gay community and with guys looking for that little boost to help them try how things are on the fabulous side of the fence.";
				if cocks of player > 0 and cunts of player is 0:
					say "     You become a fairly frequent client of the special milk drink. Aside from fuelling you up for a wild gay romp from time to time, you always make sure to have a bottle or two available while making your deliveries. It's a great thing to have available when you find yourself dropping off a package to a hot guy at the end of your day, especially if they just need that extra little bit to get them up for some fun with another male.";
	else if Gryphoness is tamed:
		if humanity of player < 10:
			if bodyname of player is "Feral Gryphon":
				now timothyfucked is timothyfucked;  [do-nothing - See Feral Gryphon endings]
			if cocks of player > 0:
				say "     When you surrender to the lusty instincts inside you, Denise tries to stay away for a while, but is unable to take the loneliness of life in the city without anyone to talk to, especially after having had a friend even for a short time. Soon you hear her soft song through the city, and almost instinctively you follow it to where she is waiting for you. She smiles as she welcomes you with open arms, and lets you change her and make her yours, so she can follow you wherever you go in your new life in the city...";
			else:
				say "     Taking your surrender to your feral instincts as a sign, Denise stops fighting her own instincts, and while she stays with you for a short while, soon she flies off in search of other gryphons to mount her and make her a proper breeder just like you...";
		else if bodyname of player is not "Siren":
			say "     Rescued from the city, you manage to convince Denise to come with you as you make your way out into the new world, her shy demeanor makes it somewhat easy for you to keep her with you as you try to settle in to your new life. Eventually she becomes happy settling in wherever you are, though she does manage to accumulate a large variety of music, which she often listens to wistfully.";


to say garrett_ending_add-on_1:
	say "     You also spend some time assisting Garrett with his operations. And while you are kept pretty busy with the activities of your own nest, you do help him out from time to time. It does expand over time and you're glad for your friend that it's become quite the success. You also get the opportunity from time to time to enjoy some time together for old times['] sake.";

to say garrett_ending_add-on_2:
	say "     Keeping contact with Garrett, you are always happy to hear that his milking operation has continued to grow. You become a client of his, though only an occasional one as his product always fuels a lust for males in you, leaving Denise rather neglected. You're more prone to pass the product along to some of your male fans to get them excited for a romp with you. Your band also anonymously writes an advertising jingle for the he-gryphon drink, helping to boost his sales. In thanks for this, he makes sure to ship you a few contraband bottles of unmicrowaved milk - still active with nanites and thus infectious. These are even more fun to slip to lustful fans, as transforming them into new horny gay gryphons to join Garrett's staff is quite the treat.";

[ HP of Timothy ]
[ 0 = not met   ]
[ 1 = talked to ]

[ XP of Timothy ]
[ # of fucks    ]
[ 3+ = connection w/Timothy ]

[ level of Timothy ]
[ # of fucks as Feral Gryphon ]
[ 3+ = connection w/Timothy ]


Timothy ends here.
