Version 3 of Zoo People by SarokCat begins here.
[ Version 3.1 - Typo fixes and book enhancement]

"Adds a large group of scattered npcs to Flexible Survival with a variety of responses and goals..."

Include Gryphon Companion by Sarokcat.

Section 1- Brian

Briantalk is a number that varies.
LastBrianfucked is a number that varies. LastBrianfucked is usually 250.
Brianfucked is a number that varies. Brianfucked is usually 0.

Brian is a man.
The description of Brian is "You see an exceptionally large and well built Rhino man, obviously heavily infected, over by a series of cracks in the border wall. Easily eight feet tall or more, his body is covered in thick rough looking grey skin, he balances rather uneasily on his large hooflike feet, a large thick cock hangs rather limply between his legs, swaying slightly as he moves. His face is a cross between a humans and a rhinos, though it seems to lean more towards that of a beasts, especially with the large thick bony horn that protrudes from the top of his rhino-like muzzle.  He doesn[apostrophe]t seem to be the brightest of the infected, whatever he might have been before, this is emphasized by him lowering his his head so his horn is facing the wall... and charging forward at the thick concrete wall. There is a resounding impact as he staggers backwards slightly, holding his head, although you do think there are a few new cracks in the wall where he hit...";
The conversation of Brian is { "Ouch!" }.
Brian is in Border Wall.

instead of sniffing Brian:
	say "Brian smells like a male rhino, covered in sweat.";

Instead of conversing the Brian:
	if Briantalk is 0:
		say "'Huh?' The large rhino-like man stops staring at the wall for a minute, his eyes darting around until they finally focus on you. 'Oh hey, sorry I didn[apostrophe]t notice you there.' he says, shrugging his large shoulders before glancing back at the cracked area of the wall. 'The name is Brian, and well, as you can see I kind of ran into a Rhino just a little way out of the zoo... I well I really don[apostrophe]t want to talk about what happened with the rhino,' Brian says, his grey skin seeming to flush slightly in embarrassment for a second as he thinks about the encounter. 'You can see the end result plainly enough though,' He says as he gestures at his large rhino like form, his horn bobbing slightly as he shakes his head sadly. 'Kinda a big change, I mean I wasn[apostrophe]t a small guy to begin with, but now. Well damn right?' Brian says with amusement.  'Kinda a bit harder to think clearly though, if ya know what I mean... but hey, at least it made me lots stronger, I should be able to get us out of here in no time now!'  The excited rhino man says, 'I mean ya know the military is watchin all the regular ways out of the city, but way I figures it, they won[apostrophe]t be watchin this part with the wall, so once I bust my way through, it[apostrophe]s clear sailering from there!' Brian says, getting even more excited by the idea, as he turns back to the wall, lowers his head, and charges it again. The impact sending him reeling back from the wall shaking his head, as he adds a couple more cracks to the already damaged area.";
		increase Briantalk by 1;
		stop the action;
	if Briantalk is 1:
		say "[one of]'One more should do it!' He says as he charges the wall[or]'I[apostrophe]ll have us out of here in no time!'[or]Brian is too busy holding his head from his last run at the wall to talk to you right now[or]'Watch this one!' He says as he charges.[or]'Woah' Brian mutters as he reels back from the wall, 'I can hear magenta..' he mutters, and you decide it might be best trying to talk to him later...[or]'Chaaaaarge!'[or]'Hey, haven[apostrophe]t I seen you somewhere before?' Brian asks blearily, his large eyes unfocused as he tries to think.[or]'For the Horde!' Brian shouts, as he leads a particularly vigorous charge at the wall. Sadly the wall seems unimpressed at this passioned cry, as it remains standing, although Brian doesn't as he lands hard on his ass.[or]'If ya are just gonna stand there and watch, ya could like do some cheering or something' Brian says as he eyes the wall again.[or]' Eat this wallface!'[or]'Dude, you don[apostrophe]t think all this headbanging is gonna hurt my brain any do yas?'[or]'Die concrete!'[or]'Woah, I can still hear my brain ringing from that last hit...'[at random]";



Instead of fucking the Brian:
	if cunts of the player is greater than 0:
		say "'[one of]Once we get out of here, I[apostrophe]ll be happy to fuck you up on that...[or]'Yeah sure,' he says absently, 'Just as soon as I finish up here.[or]Maybe when my head stops spinning...[or]That sounds nice dear.[or]Fucking you up against the wall?' He says in a puzzled tone, 'That doesn[apostrophe]t sound like it would do much damage to the wall...[or]huh?[or]Fucking? Yeah I think I like fucking..[or]Are you kidding? Have you SEEN how fucking large my cock is now? I mean I could use it as a battering ram!  Hey wait, that[apostrophe]s an idea...[or]I dunno, maybe later?[at random]' Brian says as he looks at you for a minute, before refocusing his attention on the wall.";
	otherwise:
		say "'Sorry dude, but I only like the ladies, I think anyways, it can be hard to remember sometimes' Brian says in an absentminded manner as he stares at the wall."; 





Section 2- Diego


Diegotalk is a number that varies.
Coyotetricks is a number that varies.
Diegochanged is a number that varies.
Diegobitched is a number that varies.
LastDiegotricked is a number that varies. LastDiegotricked is usually 250.
Diegotricked is a number that varies. Diegotricked is usually 0.
LastDiegofucked is a number that varies. LastDiegofucked is usually 250.
Diegofucked is a number that varies. Diegofucked is usually 0.

Diego is a man.
The description of Diego is "[Diegodescribed]";
The conversation of Diego is { "Fooled you!" }.
Diego is in Park Entrance.

instead of linkactioning Diego when diegotalk > 0:
	say "Possible Actions: [link]talk[as]talk Diego[end link], [link]smell[as]smell Diego[end link], [link]fuck[as]fuck Diego[end link], [link]trick[as]trick Diego[end link][line break]";

instead of sniffing Diego:
	say "Diego smells like a [if diegochanged is 0]male[otherwise if diegochanged is 1]herm[otherwise]female[end if] coyote.";

To say diegodescribed:
	if diegochanged is 2:
		say "The former coyote man is now a pretty tan furred coyote bitch instead, and is eyeing you eagerly as she leans up against the wall dividing the park from the rest of the city. You can see one of her paws slowly straying down to her furred pussy as you approach, a smile playing across her muzzle as she rubs herself teasingly.";
	if diegochanged is 1:
		say "The tan furred coyote herm is still here leaning up against the wall dividing the park from the rest of the city, and seems to be amused as you approach, one of her hands straying down to fondle both sets of her equipment as a smile tugs at her coyote muzzle.";
	if diegochanged is 0:
		say "A tan furred coyote like man is leaning up against the wall dividing the park from the rest of the city, he eyes you curiously as you approach the park, one of his ears flicking in amusement as a small smile plays across his muzzle.";

Instead of conversing the Diego:
	if Diegotalk is 0:
		say "'Hey there,' the coyote like man says with a grin.  'The name is Diego friend, and I have to say this is an unexpected surprise.  Haven[apostrophe]t seen too many people in these parts that haven[apostrophe]t completely given into the pleasure.' Diego says as he readjusts his position against the wall to get a better look at you.  'Can[apostrophe]t say how long that will last, of course.  You look like you like to enjoy yourself as much as anyone else around here.  And well, I[apostrophe]d be lying if I said this wasn[apostrophe]t the most fun I[apostrophe]ve had in my life,' he says with a grin playing across his muzzle.  'Never been so glad to have a coyote nip me in my backyard.  Course, everything seems much more amusing to me now also.  Must be that whole trickster thing, eh?' The coyote man chuckles as he leans back against the wall happily.  'Guess we will see how long you last here.  Course, if ya need any advice about the creatures in the park feel, free to talk to me as much as you want.  Of course I can[apostrophe]t garuntee it will be GOOD advice - that whole trickster thing and all, ya ken?' he adds with a sly wink.  'Course, ya could always just wait here until the military finally gets itself together and comes to visit.  Course, if I felt like it, I could always pull out a few more coyote tricks on them.  That would be sure to slow them down a bit, if ya know what I mean.  I[apostrophe]d only do something like that as a favor to a fellow trickster,' Diego snickers at the thought of the poor, tricked military fools.";
		increase Diegotalk by 1;
		stop the action;
	if Diegochanged is 2:
		say "[one of]'I think I[apostrophe]m in heat!'[or]'God what I wouldn[apostrophe]t give for a nice, thick, coyote cock right about now... to fill my empty pussy...'[or]'Hell I[apostrophe]m almost too horny to think about tricking anyone... almost.'[or]'This was the best trick I ever had played on me!' Diego says with a happy grin on her muzzle as she rubs her new body.[or]'You know, I hear there is an alpha wolf out there in the city looking for bitches... maybe we should go check it out together?' She asks with a twinkle in her eye.[or]'Where did you get that wonderful milk from anyways? Not that I won[apostrophe]t be making some milk of my own as soon as I can find a nice stud to knock me up...' Diego says with a smile as she rubs her breasts eagerly.[or]'I wonder if there is any nice canine studs around who want to play hide the knot?'[or]'If you play with the felinoids in the park, you could end up a slutty little pussy for their amusement, doesn[apostrophe]t that sound fun?'[or]'The skunk girls are all pets of the larger skunkbeasts.  Nice little submissive pets for the strong skunks to fill up with their fertile seed... mmm' Diego moans and rubs herself, obviously aroused by the thought of being a beasts pet.[or]The coyote bitch pants and yips softly, obviously too busy masturbating to bother talking to a boring person like yourself.[or]'I saw a woman riding a horse go by here a while back, I[apostrophe]m pretty sure though the horse would be the one doing the riding eventually though, if you know what I mean.'[or]'God I never knew being a bitch was so much fun, I[apostrophe]m so glad this happened!'[or]'I wonder if any of those nice German Shepherds in town would like to play with a coyote.' she says with a speculative look on her face.[or]'I heard there was a woman caught by some huskies recently to be turned into a nice little submissive husky bitch.  I can kind of envy her now,' she says with a smile.[at random]";
		stop the action;
	if Diegochanged is 1:
		if "dog milk" is listed in invent of player:
			say "'Hey you have more of that wonderful milk.' Diego says with a grin on her new muzzle as she sniffs the air, her coyote tail wagging behind the herm coyote eagerly. 'Well the damage is already done right, and that stuff tasted amazing so one more drink couldn[apostrophe]t hurt right?' Diego says as she looks at you hopefully, eyeing the bottle of milk you are holding out teasingly. Do you give Diego some more of the milk?";
			if player consents:
				say "You grin as you hand the eager coyote herm another container of the thick transformative canine milk, enjoying the eager look on her muzzle as she quickly gulps down another dose of the milk. 'Ah thats still so damn good...' Diego says with a smile as she finishes drinking the liquid, handing the empty container back to you as she strokes herself absently. 'Hey wait,' the coyote herm says as she moans again, staggering a bit as her body obviously begins to heat up from within as she begins to change. 'I[apostrophe]m already a herm, what now? Oh shit no...' The coyote pants out as her hands go down to her thick canine cock, rubbing at it and stroking it as it seems to shrink into her body. [line break]";
				say "'Noooo..' Diego pants out as she strokes her vanishing cock with her increasingly paw like hands, the rest of her body seeming to change into a slightly more beastial form as well. 'Oh god,' She moans as she ceases to be a male completely, her rod vanishing into her body even as her breasts swell larger, 'Feels so good...' Diego moans as the new females hands begin to rub and stroke herself erotically. The newly formed bitch begins to yip in pleasure as she moves her paw-like hand over her new mound, finally letting out a long coyote howl as she brings herself to orgasm before leaning up against the wall panting.  Eventually Diego looks back at you with a satisfied grin on her face, 'Guess fool me twice, shame on me eh?' She says, seeming not at all displeased as her paws begin to roam her new body again. 'I[apostrophe]d probably be annoyed, if this wasn[apostrophe]t the best feeling ever...' The coyote bitch says with a smile on her muzzle as she looks at you happily. 'I feel so damn horny and sexy like this, its amazing. Hell I think I might even be in heat!' She says eagerly, panting happily at the prospect while her paws begin to rub over her soft fur again, the trickster obviously forgetting you are there watching as she begins to pleasure herself yet again."; 
				delete dog milk;
				now Diegochanged is 2;
				stop the action;
			otherwise:
				say "'Aw, still your probably right, best not to push my luck.' The coyote herm says as she shoots your backpack a longing look as you put the milk away, before settling back up against the wall with a sigh.";
				stop the action;
		otherwise:
			say "[one of]'Damn fine trick you pulled there!'[or]'Thank God I still have my nice thick coyote cock' Diego says with a grin as he rubs said cock suggestively.[or]'Hell I can[apostrophe]t decide whether I should pull a trick on you, or thank you for this.' She says as she gestures at her changed body.[or]'You know, I hear there is an alpha wolf out there in the city looking for packmembers, maybe you should go see if he has room for you?' She suggests with a twinkle in her eye.[or]'Where did you get that wonderful milk from anyways?' Diego says with a grin as she licks her lips.[or]'I saw a woman riding a horse go by here a while back, I[apostrophe]m pretty sure though the horse was the one doing the riding eventually though if you know what I mean.'[or]'There was a deer around here recently at some point, she looked kinda lonely if you know what I mean...'[or]'I wonder what's bigger..' Diego muses with a thoughtful expression on her muzzle, 'The horse cocks here in the park, or the zebra cocks in the zoo...'[or]'Careful around the cute chinchilla in the park, they are almost as tricky sometimes as I am.'[or]'I wonder how much those strange cock plants are going to keep spreading.'[or]'Cock and pussy, best of both worlds!'[or]'I heard there was a woman caught by some huskies recently to be turned into a nice little submissive husky bitch' She says with a smile.[at random]";
			stop the action;
	if Diegochanged is 0:
		if coyotetricks is greater than 4:
			if "dog milk" is listed in invent of player:
				say "Noticing the strange coyote mans thirst, you wonder if you should perhaps play a bit of another trick on Diego, and decide to play just a bit by rummaging around in your backpack until you find the milk from the canine you fought earlier. 'Hey something smells good there,' The tricky coyote says as you shift through your backpack, making sure to flash the small bottle of milk several times where the coyote can see it. 'Damn,' Diego says with a sad smile as he looks at you with large coyote eyes, 'Its just so much work tricking the man, very very thirsty work if you know what I mean.' The trickster says with a smile on his muzzle, 'Why not help a fellow out, If you know what I mean?' He says hopefully as he eyes the bottle of milk you just pulled out.  Do you decide to continue and give him the changing milk?";
				if player consents:
					say "Handing the transformative drink to the unsuspecting coyote, you watch eagerly as Diego quickly gulps the thick milk down. 'Damn that hit the spot, thanks bud,' Diego says as he hands the empty container back to you, before pausing with a strange look on his muzzle. 'Oh shit,' The coyote man says as he doubles over for a second, his hands going to his groin and chest as he moans slightly, 'What kind of milk was that?' The changing coyote says as he begins to pant with need as he rubs himself, 'God it feels so good.' Diego moans, as you can see his chest swelling out with a new pair of soft breasts. The changing coyote moans, as he straightens up and leans back against the wall, eyes half closed in pleasure as his hands reach down to stroke at his crotch. One of his hands rubbing along his stiff rod eagerly, while the other reaches underneath his cock to rub and stroke at her brand new female opening. The sight makes you grin as the lust filled new coyote herm moans wantonly as she plays with herself, your own body growing excited as she brings herself to orgasm, her seed coating one hand, even as her wet juices spill out over the other as she shudders in ecstasy. Panting from pleasure and exertion, Diego lowers her head and looks at you with a wry grin on her muzzle. 'Well damn, that was a nice trick there,' The coyote herm admits as her hands begin to wander over her changed body again. 'I guess you got me that time then, maybe I should give you a little reward for being such a good trickster?' The new herm says with a lewd wink as she eyes your body eagerly."; 
					delete dog milk;
					now diegochanged is 1;
					stop the action;
				otherwise:
					say "'Damn, what a tease.' Diego says sadly as you slip the milk back into your pack, 'I taught you too damn well it seems.' The coyote says with a sigh as he watches the milk vanish back into your pouch.";	
					stop the action; 
			otherwise:
				say "'Damn, all this tricking the man is making a dishonest coyote mighty thirsty, you wouldn[apostrophe]t happen to have anything to help a fellow out now would you?' The strange coyote man says hopefully, only to sigh sadly when you shake your head.";
				stop the action;		
		if Diegotalk is 1:
			say "'[one of]Hmm, advice eh? How's this, always remember to brush your teeth after giving a blowjob, good hygiene is still important!'[or]Have you tried looking in some of the small lairs in the park? You might find something worthwhile, just be careful to wait until no ones home before you take a peek.'[or]Don[apostrophe]t mess with badgers, seriously even I wouldn't kid you about those dangerous buggers.'[or]I hear there was a doe hanging around here at some point, if ya want her to go with ya just make sure to grab her right away.'[or]Have you seen those handsome felinoids out there? Maybe you should try petting one a few times, I'm sure you will find it educational.'[or]I hear if you play with the small felines enough, a big strong alpha lion will show up.'[or]If you see some wyverns fighting in the park, you should probably just watch and not interfere, not your business right?'[or]There's some weird skunks out there, but I hear the bigger beasts are lots of fun to play with.'[or]Happy with your current look? Then this is definitely not the place to be.'[or]Don't worry about any of the plants you see moving around the park, just go give them a pet they are pretty much harmless.'[or]Have you seen any little yellow rodents in the park? Seems to me like something you might be interested in.'[or]Don't hit the chinchillas! Hurting something that cute has to be against some kinda law, you wouldn[apostrophe]t want to get in trouble now would you?'[or]The bitches love the nice thick coyote cock.'[or]Feel like a real trickster today? Why not try tricking me and see what happens?'[or]I bet you can't trick old Diego here, just give it a try!'[at random]";


Diegotricking is an action applying to nothing

Understand "Trick Diego" as Diegotricking.
Understand "Trick military" as Diegotricking.
Understand "Trick coyote" as Diegotricking.
Understand "delay military" as Diegotricking.

Check Diegotricking:
	If Diego is not visible, say "Who?" instead;

carry out Diegotricking:
	if lastDiegotricked - turns is less than 6:
		say "'Sorry bud, only so much time for tricking people in the day,' Diego says as [if diegochanged is 0]he shakes his[otherwise]she shakes her[end if] head sadly, 'Trick people too much and it just gets stale, so come back and try again later.'";
		stop the action;
	now lastDiegotricked is turns;
	say "Oh so you think a new little trickster like you can pull one over on me? Lets see what you got!";
	let bonus be (( the Intelligence of the player minus 10 ) divided by 2);
	if 2 is listed in bookcollection, increase bonus by 2;
	let diceroll be a random number from 1 to 20;
	say "You roll 1d20([diceroll])+[bonus]: [diceroll + bonus], ";
	increase diceroll by bonus;
	if diceroll is greater than 18:
		say "'Woah amazing!' Diego exclaims happily, 'Are you sure you aren[apostrophe]t part coyote? I mean, Damn that was an impressive trick!' The coyote says as [if diegochanged is 0]he shakes his[otherwise]she shakes her[end if] head in admiration. 'That kinda trick will get some extra effort on my part.  Should take those silly military types ages to get it all sorted out!'";
		increase Coyotetricks by 2;
		extend game by 18; 
		if Coyotetricks > 3 and prankevent is 0:
			now Prank Aftermath is not resolved;
			now prankevent is 1;
	otherwise if diceroll is greater than 12:
		say "'Dang that was a good one! Not quite up to my usual standards of course, but pretty damn good!' Diego says with a happy grin on [if diegochanged is 0]his[otherwise]her[end if] face, 'I think I might be willing to try that one out on some of their scouts, might earn ya a bit of time ya see.";
		extend game by 6;
		increase Coyotetricks by 1;
		if Coyotetricks > 3 and prankevent is 0:
			now Prank Aftermath is not resolved;
			now prankevent is 1;
	otherwise:
		say "'You call that a trick?' Diego says derisively, snickering at your pathetic attempt, 'Now this is a trick!' [if diegochanged is 0]he says as he[otherwise]she says as she[end if] swiftly whips out a trick that makes you stagger back in shock and makes you feel slightly less human.";
		decrease humanity of player by 10;


Instead of fucking the Diego:
	if lastDiegofucked - turns is less than 6:
		if diegochanged is 2:
			say "'Sorry there stud,' Your little coyote bitch pants as she looks up at you with a happy expression on her muzzle, 'I still haven[apostrophe]t recovered from last time yet, maybe you should try coming back just a little later?' Diego asks somewhat pleadingly.";
			stop the action; 
		otherwise:
			say "'Sorry there, the little coyote can only come out to play every so often,' Diego says with a smirk on [if diegochanged is 1]her[otherwise]his[end if] muzzle.";
			stop the action;
	if Diegochanged is 2:
		if cocks of player is greater than 0:
			if a random chance of 1 in 2 succeeds:
				say "'I thought you would never ask!' The newly changed coyote female says with a grin on her muzzle,  'After all, the best trickster definitely won,' She says in a teasing tone of voice as she runs her paws up and down her changed body, 'And to the winner goes the prize...' Diego pants out eagerly, obviously becoming more and more excited by the second. 'Don[apostrophe]t you think I would make a fine prize for such a good trickster?' She says teasingly as you approach, spreading her legs slightly as she leans back up against the wall behind her, 'Why don[apostrophe]t you claim your prize then handsome?' She says as she reaches out one of her paws to stroke your [skin of player] side. Grinning at her eager invitation, you waste no time in moving your body up against hers, pinning her to the wall as she moans eagerly in need. 'God yes, please fuck me, fuck me like a bitch in heat...' Diego moans, panting in lust as her arms wrap around you eagerly and her body rubs against yours.[line break]";
				say "Already highly aroused by the feel of her new sensual body pressing up against yours, and the strong scent of a bitch in heat, you need no further encouragement as you rub your [cock of player] rod up against her crotch. Diego pants eagerly as your tip begins to probe her soft new folds, her body eagerly spreading itself open before you as you shift your hips forward and sheath yourself inside her.  'Oh god yes,' the coyote bitch moans eagerly, shuddering at the feel of your rod inside her body as she clutches you tighter, her needy words making you grin with amusement as you begin to slowly thrust into her.  The feel of your cock moving within her is obviously too much for the former male, as she groans and yips instinctively in pleasure, her furred legs reaching up to wrap around your body and hold you close. [line break]";
				say "Her body feels wonderful around your cock as you press her up against the wall, moving in swift sharp thrusts within her warm passage as she clings to your body eagerly. 'Yesss, fuck me, make me a proper bitch..' You can hear Diego whispering softly over and over again as she rests her head on your shoulder, her needy words only encouraging you to pump into her amazing body even harder. Soon the feel of her body moving up against yours, and he amazing feeling of your cock buried deep inside her, is too much for you, and you cry out as your [cock of player] begins to spill its life giving seed into your bitches eager womb.  Your cries mingle with her own bestial howl of ecstasy as the feel of being filled like a proper bitch triggers her own orgasm, her new instincts obviously victorious over any lingering traces of her old male personality.  Coming down from the pleasure of the intense mating, the two of you collapse against the wall in a tangle of limbs, her body still wrapped around yours as she moans happily at being bred. 'Thank you so much,' Diego whispers into your ear, as her paw-like hands hold you close, 'Thank you for fucking me properly, and thank you for tricking me into becoming a bitch.' She says as she licks your cheek and rubs her muzzle against your neck. 'I never realized how much I would love being a bitch, being your bitch,' The coyote female says with a grin, as the two of you begin to untangle yourselves from each other. Standing up, you help your newly bred coyote bitch up as well, leaving her leaning up against the wall as she recovers, and somehow you know she will be right there waiting eagerly for you whenever you choose to return, willing and eager for you to take her like the prize bitch she now is...";
				now  lastDiegofucked is turns;
				now diegobitched is 2;
				stop the action;
			otherwise:
				say "'I thought you would never ask!' The newly changed coyote female says with a grin on her muzzle,  'After all, the best trickster definitely won,' She says in a teasing tone of voice as she runs her paws up and down her changed body, 'And to the winner goes the prize...' Diego pants out eagerly, as she drops down to all fours on the ground before you, her newly changed body making the stance seem both more natural on her, and very sexy. 'Don[apostrophe]t you think I would make a fine prize for such a good trickster?' She says teasingly as you approach, turning her rear towards you and lifting her tail eagerly to give you a perfect view of her heat swollen filled pussy. 'Why don[apostrophe]t you claim your little coyote like a proper bitch?' She pants out as she glances at you over her shoulder, waving her ass slightly as her tail wags eagerly in anticipation.[line break]";
				say "The sight of the formerly dominant coyote on all fours before you as she gives in to her new female instincts makes you smile, and your cock is already hard and ready as you reach out and begin to stroke her soft fur.  Diego moans as she shifts her stance slightly, rubbing her body up against your touch as you position yourself behind her, rubbing your cock tip lightly over her silken folds teasingly as you watch her moan in need. 'Please, please I need it so badly...' The coyote bitch begs, lustily, your male presence overwhelming her new female instincts with the need to be bred. Her heat filled scent filling your nose tells you just how ready she is for you, and you groan in pleasure as you push yourself into her warm body. The feel of her silken body welcoming you eagerly is amazing, and you begin panting yourself as you begin to rock your hips forward into the eager bitch beneath you, your hands gripping her fur tightly with each thrust.[line break]"; 
				say "'God yes,' Diego pants out underneath you, rocking back into each of your thrusts eagerly, 'Claim me please, fill me up and make me your bitch,' She moans, as she surrenders herself fully to her new bodies need to be mated and claimed. The sound of her eager voice, as she begs to be bred and claimed, makes you feel strong and dominant as you thrust into her body even faster, your orgasm building quickly as she yips and begs underneath you.  Finally your body tenses and you cry out in pleasure as your cock explodes within the new bitch, spilling its seed into her new pussy as she lets out a coyote howl of victory at fulfilling her new role in life as a bitch. Gasping from the intense orgasm, you hold Diego close for a few minutes, feeling your cock slowly soften inside her, before eventually pulling out of her eager body and staggering to your feet. [line break]";
				say "Without you inside her, Diego collapses to the ground, lying on the soft grass for a minute, before rolling over and sitting up still panting from the recent exertion. 'Thanks, god I needed that,' your new bitch says with a smile on her muzzle as she rubs her stomach with her paws. 'I never imagined anything could feel this good before...' She says with a dreamy look on her muzzle, before blinking and looking at you. 'I think I[apostrophe]m your bitch now, it just feels... right somehow,' Diego says with a smile on her muzzle as she hauls herself up on her still shaky legs, before reaching out to stroke your cheek with one of her paws lightly. 'Thank you, for claiming me properly,' She says as she leans forward and gives you a soft lick on the cheek, 'It feels good to be claimed by such a crafty trickster.' The coyote bitch says with a soft grin, before staggering back over to the wall and leaning up against it for support. 'Anytime you want to play with your bitch again, you know where I am.' She says with a wink, as you gather your stuff together to set out into the city again, grinning at the change a few little tricks managed to bring about in your bitch.";
				now lastDiegofucked is turns;
				now diegobitched is 2;
				stop the action;
		otherwise:
			say "'Sorry about this hun,' The coyote female says sadly as she reaches down to stroke her increasingly paw like hand across your crotch. 'While I would have appreciated your form just a little while ago, now it just doesn[apostrophe]t do it for me anymore.' She says as she shakes her muzzle at you sadly, 'Not even sure now what I saw in women anymore, but I just can[apostrophe]t stop thinking about a nice thick cock  filling me up now...' Diego says as she leans back against the wall, her paws stroking her soft fur eagerly. 'Nice thick knot filling me up, knocking me up like a good little bitch... mmm.' She moans as she rubs herself, before lowering her lust glazed eyes and looking at you for a second. 'Sorry, I just can[apostrophe]t think straight right now, I just need to be bred properly so very badly... maybe you should see if you can go find a nice thick canine cock to fill me up with?' She says with a smile on her muzzle as she goes back to playing with herself."; 	
			stop the action;	
	if Diegochanged is 1:
		if cocks of player is greater than 0:
			say "'Well you know, that is an interesting offer...' Diego says as the new herm eyes your proudly erect cock thoughtfully. You can easily tell though, that while she is trying to hide her excitement, your offer has immediately caused her new opening to grow damp, even as her tail gives her away by lifting up eagerly behind her, making you grin as you press closer to her new changed body, reaching out to stroke her soft fur teasingly. 'I guess, I might as well, I mean, you did trick me fair and square now didn[apostrophe]t you...' Diego says in a slightly nervous tone, her tongue starting to hang out of her muzzle as the scent of an aroused male speaks to her new instincts. The new coyote herm slowly turns her back to you, her tail lifting up in a soft invitation as she leans forward and braces herself on the wall, her legs spreading out instinctively as she positions herself for you. Her upturned tail gives you a clear view of her new wet swollen coyote pussy, and her cock dangling down underneath her body as you approach to give her new female parts a proper introduction to your [cock of player] cock.[line break]";
			say "Diego moans as your hands stroke through the soft coyote fur of her inner thighs, rubbing and teasing her until she raises her ass up into the air even higher, her coyote head resting up against the wall as you begin to rub the tip of your cock against her new entrance, enjoying how easily the once tricky coyote is overcome by the needs of her new body. Her soft passage grips your rod like a velvet glove, the coyote underneath you gasping in pleasure as you push yourself into her body, her passage massaging your cock needily even as you draw back and begin to thrust into her again. Diego moans and begins to yip as her new small breasts begin to bounce underneath her body in time to your thrusts, her tongue lolling out of her muzzle as she gasps in time with your thrusting. The sensations of having a strong male pumping his rod into her, washing over the coyote herms lust fogged mind, making her react instinctively as she thrusts her hips back to meet you. [line break]";
			say "You can[apostrophe]t help but grin at the sight of the eager coyote underneath you, as you reach one of your hands up to stroke along her soft furred back, before gripping the scruff of her neck. Diego cries out, her knees locking as her body shudders in orgasm, her orgasm triggering your own, as you eagerly spill your seed into her waiting body. You relax your grip on her neck, slowly drawing your rod out of her dripping pussy, even as her body trembles with the aftershocks of her intense submissive experience. You can feel a grin tugging at your face, as without your support, Diego slowly drops to her knees, leaning heavily against the wall for support, you have a feeling that the lovely little coyote won[apostrophe]t be forgetting this particular trick anytime soon...";
			now Diegobitched is 1;
			now  lastDiegofucked is turns;
			stop the action;
		otherwise:
			say "'Hey glad you still want to come play with Diego even after that trick you pulled on me,' The coyote herm says with a grin as she looks at your female body lustily, 'Well I have to admit that was a pretty good trick of yours,' The coyote says as she rubs her new breasts with one hand, before lowering it down to stroke her half erect cock. 'Now I think I should pay you back with a nice little trick of my own,' she says teasingly as she draws closer to you, one of her furred hands reaching out to stroke along your own breasts as she lowers her muzzle to whisper in your ear. 'A nice, thick, knotted, coyote trick, to put right in your eager body...' She whispers teasingly, her words making you gasp even as she wraps her arms around you and drags you both down onto the soft grass.[line break]"; 
			say "The coyote herm laughs at the surprised look on your face, and when you open your mouth to protest she locks her soft muzzle over your mouth, silencing you as her tongue darts around in your mouth teasingly. Thoughts of protest are soon the last thing on your mind as her soft hands roam your body, the coyote on top of you still knowing just how to tease and arouse a woman. Giving in to the pleasure, you are soon rubbing your breasts up against her own soft furred breasts, as her cock rubs up against your damp needy feminine opening. The teasing of the tricky coyote soon has you lifting your body up to meet her cock, as you try to get the tricky herm to fill you up properly, panting eagerly as each teasing pass brings you closer to the wonderful pleasure you know is coming.[line break]";
			say "Finally you lift yourself up, and her cock slips right inside you, making you gasp as the burning emptiness inside you is filled with Diego's coyote rod. She wastes no time with any more teasing once she has her cock in your slick pussy, and Diego begins thrusting eagerly into your body, her eyes closed tight in pleasure as she lets out short yipping noises with every thrust.  The feel of her knot pressing up into your body, spreading you wider with each thrust at it seeks to lock the two of you together, is simply amazing, and you can tell as you stare up at Diego with lust clouded eyes, that the coyote above you is panting with just as much lust as you are. Soon her knot is inside you fully, making you groan as it swells up pleasantly, tying the two of you together as her thrusts speed up, your hands clenching her fur tightly even as she begins to shoot her seed into your needy body.  The feel of that wonderful canine cock spurting into you is more then you can stand, and you find yourself crying out as well as your body spasms around Diego[apostrophe]s thick meat. The two of you collapse together on the grass, her cock still buried deep in your body as you both pant and try to recover from the intense experience. Eventually her knot goes down enough that she can pull it out of you with a soft popping noise, leaving you feeling strangely empty, even though you are still nice and full of her wonderful coyote seed...  The  coyote herm slowly crawls back over to the wall, leaning her back against it as she pants in exhaustion and pleasure, a teasing grin on her muzzle as she winks at you teasingly. Without another word, you slowly haul yourself back up to your feet, and begin to retrieve your equipment, keeping a careful eye on the tricky coyote just in case.[impregchance]"; 
			now  lastDiegofucked is turns;
			now diegobitched is 1;
			stop the action;
	otherwise:
		if coyotetricks is greater than 4:
			if cocks of player is greater than 0:
				if cunts of player is greater than 0:
					say "'Hmm you look pretty good there,' Diego says with some interest,  'Sadly though, as a coyote I can already tell you have a trick hidden away next to your lovely treat.' The coyote says as he gestures to your cock.  'Nice try there. But better luck next time eh?'";
				otherwise:
					say "'Heh you want to play with a hot coyote stud like me?' Diego says with amusement, 'Hard to blame you for that I know, but I think I[apostrophe]ll pass. You may be a good trickster, but figuring out the 2 guys arrangement isn[apostrophe]t a trick I happen to be interested in.'";
			otherwise:
				say "'Well after all that tricking and flirting, how could I say no?' Diego says with an amused grin, his paw-like hand reaching out and pulling you closer to him. 'What say we have a go right here then?' The coyote trickster says with a grin, as he moves around you until he is pressing your body up against the wall he was leaning on. 'Hmm I like what I see,' Diego says with a grin as his hands roam down your body, you open your mouth to say something, only for the tricky coyote to take advantage of this fact. His furred muzzle presses up against your face as he takes advantage of your open mouth to let his tongue dart inside your mouth, tangling with your own pleasantly as his hands settle on your ass, rubbing it softly. 'Now now,' Diego pants out as he breaks the deep kiss, 'No more tricks for today, now its time for you to get your treat.' the male coyote says as his stiff cock rubs up against your crotch.[line break]";
				say "You can[apostrophe]t manage to respond to the male coyotes comments as he wastes no time in lifting your ass up slightly, giving himself a better angle as his cocktip probes at your hot passage. You find yourself moaning as your back is pressed up against the cool wall, your legs automatically wrapping around the hot coyote stud as he sinks his thick rod into your needy body.  'God you feel so good' Diego moans as he begins to thrust into you in short powerful thrusts, each one pressing you into the wall as you find your hands gripping his shoulders tightly, encouraging the strong coyote to fuck you even harder. Soon you feel the base of his cock swelling up inside you, making you moan as he continues to fuck you up against the park wall, the rough feeling of the wall and the soft feel of his fur rubbing against your [skin of player] skin erotically. Diego[apostrophe]s breath comes out in harsh panting as his thrusts speed up, his knot locking the two of you together fully as with a grunt he finally shoots his thick seed into your body. The feel of his cock exploding within you triggers your own powerful orgasm, and you find yourself throwing your head back and panting as your body shakes with pleasure. 'Oh yeah, now that was a sweet treat,' Diego mutters as the two of you stay there your bodies still locked together against the wall by his knot.  You find yourself enjoying the time in silence as his knot slowly deflates, before with a soft pop he is able to pull out of you and set you back down on your own feet.   'Come back again anytime,' The coyote stud says as he leans up against the wall again, seeming to need its support to keep himself stable after all the exertion.[impregchance]";
				stop the action;
		otherwise:
			if cocks of player is greater than 0:
				say "'Sorry bud, I don[apostrophe]t care to play with guys, maybe you should come back a little bit later.'";
			otherwise:
				 say "'Hmm Maybe, I[apostrophe]ll really have to think about your offer for a while,' the coyote says, as he looks you up and down, 'Since you aren[apostrophe]t much of a trickster now are you...'.";

when play ends:
	if Diegobitched is 2:
		if humanity of player is less than 10:
			if cocks of the player is greater than 0:
				say "Not long after you surrender to your new instincts, Diego begins to hunt you down, worried that you haven[apostrophe]t come by to claim your bitch in a while. Seeing the coyote bitch looking for you, you remember some of the tricks the two of you played before, and your instinct driven mind comes up with a cunning plan.  With a bit of work, you manage to trap yourself an unsuspecting coyote, and are more then happy to show her just how happy you are to 'play' with her still malleable body.  Soon the tricky coyote is changing again into a more suitable form to be your mate, as you coat her with your seed, coaxing her into begging and moaning for the changes you work on her body. Eventually you let your new pet loose, properly trained, and with her belly already swelling with your offspring, the two of you head out into the city and to embrace your new life together"; 
			otherwise:
				say "Not long after you surrender to your new instincts, Diego does as well, unable to resist the strong needs of a coyote bitch in heat as she hunts you down. The bitch seems happy to see you too have given in to the pleasures of a purely female form, and eagerly joins you in your new life, even though her form is slightly different then your own, she seems strongly attached to you. Eventually the results of your mating with her begin to show though, and she retreats into the city to bear your coyote pups, you only see her occasionally after that, the needs of your pups distracting her, as well as her driving instincts to find a new coyote mate keeping her busy, even as your new life keeps you busy...";
		otherwise:
			if cocks of the player is greater than 0:
				say "Rescued from the city with your mind intact, you meet Diego again in the military camp, the coyote bitch being picked on by several of the soldiers for all the tricks she pulled on them.  Unable to just let it happen, you stand up for your bitch, and shame the soldiers into leaving her alone.  Diego is extremely relieved to see you, and is glad to let you know that she has been the model of a good coyote bitch while she waited for you to return and claim her. The military is more then eager to release the two of you together, practically shoving you out of the camp in an attempt to get the tricky coyote as far away from them as possible.  The situation makes you grin as you head out with Diego to try to figure out how to fit into the world after your experiences in the city. Though soon it is obvious that some of your playing around in the city bore fruit, as Diego is soon beginning to show evidence of the fruits of your labors with the heat filled coyote. She eagerly moves in with you when you eventually find a place to stay, and quickly begins devoting that crafty mind of hers to find way to better increase your standing in your new life.  Soon though, your strange little family is enlarged by a new litter of coyote pups,  and Diego[apostrophe]s attention is diverted to her new role as a happy mother,  although she does start dropping hints about wanting to be 'claimed' again sometime soon...";
			otherwise:
				say "[one of]Rescued from the city with your mind intact, you meet Diego again in the military camp, The coyote bitch happy and eager to see you there, if somewhat disappointed in the fact that you are lacking your glorious cock. Still she is more then happy to point out that your claiming of her body has borne fruit, as evidenced by her softly swelling belly. When the military finally let you go, the tricky coyote bitch manages to get herself released as well, following you out into the world and staying as near you as possible as you both try to fit back in with society.  You come to enjoy her amusing company enough that you hardly protest when she moves in with you, taking care of most of the chores even as her belly grows larger.  Soon your strange little family is enlarged by the addition of several cute little coyote pups around the place, getting into things and making you both smile. You settle into your life outside the city even easier with a new companion like Diego to keep you company and amused, although you start to worry when the coyote starts talking about finding a nice stud to claim you both...[or]Rescued from the city with your mind intact, you meet Diego again in the military camp. The coyote bitch is happy and eager to see you there, she seems amused at the fact that you too have ended up changed into a proper female, and is more then happy to rub and tease your new body even as she tells you how happy she is with her own change. When the military finally release the two of you, Diego stays in close contact with you, often sending you teasing letters about how happily her belly is swelling from your mating in the city, and how much more fun she is having as a proper bitch. Her happy acceptance of her new female status perks you up as you try to settle into your new life, and the pictures she sends you of your little coyote pups can[apostrophe]t help but make you smile. Although her latest teasing letter about finally finding a lovely coyote stud to play with, and the invitation to come join her sometime so her new stud can return the favor you did for her in the city and give you some pups in your own belly, is strangely attractive...[at random]";  
	if Diegobitched is 1:
		if humanity of player is less than 10:
			say "Not long after you give in to your new instincts, Diego gives into hers as well, the powerful instincts of both a male and female coyote finally overcoming the tricksters resistance. Soon the new coyote herm is prowling the streets as well, setting traps and tricks for both infected and military alike, and eagerly enjoying the bodies of anyone she can manage to trap.  Her very presence on the streets makes things more dangerous for many of it[apostrophe]s inhabitants, but somewhere in your new more instinct driven mind, you know that if you ever were to encounter the coyote again, you could have such fun turning the tricks on her again...";
		otherwise:
			say "When the rescue comes, the coyote you tricked is still waiting at the park for the military to arrive, several of whom are less then pleased to see the trickster that was plaguing their advance waiting their casually. Diego soon found her new body put to great use by the military men, as they took their frustrations out on her, unfortunately in the heat of the moment and distracted by her taunting commentary on how easy they were to trick, none of them thought that the coyote herm might still be infectious, bringing her right back into the military barracks for a long night of payback.  The next morning a lovely new group of coyotes spread out throughout the military camp, reveling in their new bodies as they trick the rest of the soldiers into surrendering, as well as sabotaging most of the machines and weaponry.  The advance into the city grinds into a halt not long after you are released back out into the world, and from what you hear, it is unlikely to start again anytime soon with such devious tricksters loose in the military bases...";




Section 3- Timothy


Timothytalk is a number that varies.
Timothymated is a number that varies.
LastTimothymilked is a number that varies. LastTimothymilked is usually 250.
Timothymilked is a number that varies. Timothymilked is usually 0.
LastTimothyfucked is a number that varies. LastTimothyfucked is usually 250.
Timothyfucked is a number that varies. Timothyfucked is usually 0.

Timothy is a man.
The description of Timothy is "Lying on a rather large pile of stolen cushions, is a rather striking blue furred gryphon, her attractive blue feathered wings half spread out behind her as she reclines back. The creatures talon like hands are absently rubbing its large white furred belly, obviously quite pregnant and unable to move quickly, its large breasts are slowly dribbling milk as it shifts its body slightly, giving you a good look at both its thick black cock resting up against the gryphons distended belly, and the rather large and obviously well used passage resting between the gryphons leonine thighs.  Its leonine tail twitches where it is lying between her slightly spread legs, as the Hemaphrodite gryphon cocks her avian head to look at you, her tongue hanging out the side of her beak slightly as she pants and rubs herself a bit more. You notice a small collar with a tag hanging around her neck, the tag just reads 'Pet'";
the conversation of Timothy is { "EggsEggsEggs!" }.

instead of linkactioning Timothy when Timothytalk > 0:
	say "Possible Actions: [link]talk[as]talk Timothy[end link], [link]smell[as]smell Timothy[end link], [link]fuck[as]fuck Timothy[end link], [link]milk[as]milk Timothy[end link][line break]";

instead of sniffing timothy:
	say "She smells like a hermaphrodite gryphon.  The scent of pregnancy, egg-laying and sex hang thick around her.";

instead of conversing the timothy:
	if Timothytalk is 0:
		say "'Oh wow!' The gryphon says as you approach to talk to her, 'I didn[apostrophe]t expect to see someone like you here,' She says as she looks you over, moaning slightly in pleasure as she shifts her large egg filled weight to look at you better. 'Welcome to the flying city, I think they are calling it Qytat or something, to be honest I wasn[apostrophe]t paying too much attention to things like that when my mistress led me here.' Seeing your confusion she  begins to explain. 'My mistress is the one who changed me into this lovely new body,' She says as she gestures at her long leonine form, and her avian wings, and finally rubs her pregnant belly. 'And my mistress is the one who keeps me nice and full of her gryphonic offspring as well. I was once a human called Timothy, living down there in the city, before I met her while I was out camping one night. That was the best night of my life.' She says, as her flexible beak pulls back in a happy smile. 'She changed me and filled me right up with her wonderful cock, and than led me here where I could be a good little breeding pet for her, bearing her eggs again and again, and letting her drink my tasty milk and fuck me whenever she wants.' The gryphon says, obviously growing somewhat excited at the memory, and small trickles of milk begin to dampen the soft fur on her large breasts.  'She still calls me by my old name sometimes, But I love it best when she calls me her pet, or even mate or breeder, it just seems so right.' The gryphon says with a shudder as she licks her lips.  'And sometimes she even lets other gryphons come in and breed me too, to make sure that I am always nice and full of little baby gryphons. It[apostrophe]s the best life ever, you should really try it! I bet my mistress would love to make you into a happy slutty breeding gryphon too!' Timothy says as she rubs herself erotically,  'And you could stay here and talk with me and we could bear eggs for the handsome gryphon studs all day long... mmm' she moans as she orgasms just from the thought, lying back on the cushions and panting slightly as you try to decide just what to say to that.";
		increase Timothytalk by 1;
		stop the action;
	if Timothytalk is 1:
		say "'[one of]Gryphon cock is amazing, you should try it.[or]Mmm I can[apostrophe]t wait for my next breeding.[or]Are you sure you wouldn[apostrophe]t be happier as a breeding gryphon?[or]I[apostrophe]m so glad to leave all that being human stuff behind me.[or]It feels good being stuffed nice and full of eggs, you should try it[or]Not long now' she says as she pats her belly, 'And than I can get filled up again![or]Isn[apostrophe]t it nice up here?[or]My mistress doesn[apostrophe]t use my cock much, but being filled with hers is just amazing so I don't mind.[or]Would you like a little bit of milk?[or]If you keep hanging around here to talk to me, one of the other gryphons might find you in here and make you a happy little breeding toy too... Wouldn[apostrophe]t that be wonderful?[or]Have you ever given any thought to having a tail? I love mine![or]Oh my, my breasts are going to need milking soon.[or]This infection or whatever it is is the best thing that ever happened to me.[or]I can[apostrophe]t decide which I like more,' The gryphon says speculatively, 'My wonderful new talons.' She says as she flexes her talon-like hands, than gestures down at her digigrade lion feet and paws. 'Or my handsome new paws.' She coos in happy contemplation before looking at you. 'What do you think?[or]Whew, I[apostrophe]m still me, I had a nightmare the other day where I was a human again.' She says with a shudder 'Wouldn[apostrophe]t that be horrible?[or]God I love being pregnant with lots of little gryphons![or]Who knew being an egg filled breeder could be so satisfying?[or]I bet you would look amazing pregnant with gryphons[or]I just can[apostrophe]t wait for my mistress to return and fill me with more of her lovely seed!'[or]Oh please won[apostrophe]t you take some time out and try some of my milk?[at random]'";



Timothymilking is an action applying to nothing.

Understand "Milk Timothy" as Timothymilking.
Understand "Milk Tim" as Timothymilking.
Understand "Milk gryphon" as Timothymilking.

Check Timothymilking:
	If Timothy is not visible, say "Who?" instead;

carry out Timothymilking:
	if lastTimothymilked - turns is less than 6:
		say "'Mmm sorry, that sounds like a wonderful way to pass the time' Timothy says as she rubs her large breasts slightly, before sighing, 'But I have to make sure to keep some for my mistress when she comes back, or in case the little ones come. Maybe a little bit later when I have a bit more stocked up' She says looking at you hopefully, 'You[apostrophe]ll come back than won[apostrophe]t you?'";
		stop the action;
	otherwise:
		say "'Oh that sounds wonderful!' Timothy murrs as she rubs her obviously full breasts, several small drops of milk already leaking from her nipples as you move forward to take her breasts in your hands.  Looking around somewhat you find an oddly shaped bowl near the cushions, a small curved depression built into its lip, as you bring it up to her breasts you find the depression matches the curve of her breast, the bowl obviously made for situations like this. The pregnant gryphoness moans as she holds the bowl in place while you softly massage her breasts, soft gryphon milk beginning to flow under your hands as you tease her nipples.  The air fills with the strangely arousing scent of the strange hybrids milk, as the bowl slowly beings to fill, making you lick your lips slightly as you think about what the potent milk must taste like.   You soon lose yourself in the feel of her soft furred breasts underneath your hands, running your hands over and through her fur rhythmically as you coax her milk into the swiftly filling bowl.  Soon the bowl is completely full, and you are forced to set it aside, though Timothy's breasts are still leaking milk onto her fur as she pants, her head thrown back in obvious pleasure at being milked.  Unable to help yourself, you find yourself lowering your head down to her damp breasts, and stretching your tongue out to take a taste of the milk straight from the source.   You and Timothy both moan as your tongue licks over her nipple, the taste of her lovely body on your tongue is just amazing, and you quickly find yourself licking and sucking slightly on her nipples, soft trickles of milk filling your mouth with its wonderful taste, before you finally sit back panting almost as much as the gryphoness is from the lovely experience. Looking down at the full bowl, you decide not to let any of that wonderful milk go to waste, and gather some of it up to take with you.";
		infect "Hermaphrodite Gryphon";
		add "gryphon milk" to invent of player;
		now lastTimothymilked is turns;



Instead of fucking the timothy:
	if lastTimothyfucked - turns is less than 6:
		say "'Sorry, I know you want to play with me again,' Timothy says as she lies back on her cushions with a satisfied look on her beak. 'But I still need some time to recover before we have some fun again, maybe you could go find another gryphon to have fun with for a bit and come back later?'";
		stop the action;
	if cocks of player is greater than 0:
		if cunts of player is greater than 0:
			if bodyname of player is "Hermaphrodite Gryphon":
				say "'Mmm a lovely little gryphon just like me!' Timothy says happily as she runs her eyes over your gryphon body, lingering for a moment at your cock before taking in your damp pussy. 'You must want to see what its like to be a happy slut gryphon like me!' She says with a grin on her beak as she gestures for you to come closer, the thick scent of gryphon musk filling your head with lust as she pulls you up close to her large egg filled belly, rubbing your bodies together pleasantly. 'Feel that lovely full belly? Nice and round with gryphon eggs? Isn[apostrophe]t it wonderful? I bet you want to feel nice and round and full of life too don[apostrophe]t you?' The gryphon moans, not waiting for an answer before positioning her thick barbed and knotted cock at your entrance. 'I may not be one of those handsome gryphon studs, but I can still give you a little taste of that lovely feeling' She says as she pulls you down onto her thick cock, making you gasp as her soft barbs rub against your sensitive walls.[line break]";
				say "'Doesn't that gryphon cock feel good?' The gryphon gasps, as she thrusts into your slick tight passage. Her knot bumping up against you as she pulls you down onto her shaft.  'Nice and right as it fills you up?' She whispers, the feel of her soft barbs moving within you at every thrust causing you to gasp and groan in pleasure as she runs her talons over your body, her furred lion hindpaws rubbing against your own leonine legs as she moves within you. 'And feel that wonderful knot?' She pants out as her knot spreads you open more with each soft pleasurable thrust, seeking entrance into your eager body. 'Once it enters you it will lock your body to mine just like a good breeding slut should be, sealing your passage tight while my cock fills your body up with its wonderful gryphon seed.  Every pump of my cock ensuring your belly will grow nice and round with the gryphon eggs growing inside you.' Timothy moans, as with one final push her knot enters your body, causing you to gasp helplessly as your pussy clenches it tight, holding it within you tightly like she said.  Timothy immediately begins to speed up her thrusting, making you melt helplessly in her hands, your stiff cock rubbing up against her round belly with every thrust, her soft fur massaging it almost as well as your soft folds are massaging her own cock inside you.[line break]";
				say "Finally she clutches you tight as her body stiffens underneath you, her cock shuddering and twitching inside you as she shoots her gryphonic seed deep into your willing body. The feel of her fertile seed coating your insides, every drop of it trapped in your womb by her knot while her barbs massage your passage is too much for you, and you find yourself crying out as your own powerful orgasm washes over you, your passage shuddering around her cock as your own cock stiffens and shoots its seed, your thick cum coating her soft belly fur even as her own seed fills your body. You pant as she holds you tight, her knot tying you together as she whispers into your ears about the many more pleasures of being a breeding gryphon, nice and broody and well sexed.  Eventually her knot softens enough that you can pull yourself off of her, your wings splaying out behind you as you rest back on your leonine paws.  'That was so nice,' Timothy murmurs as you slowly begin to gather your wits about you, 'And just think, that was only a short sample, of what being a gryphon breeder is like, though with any luck you can enjoy the feeling of my seed growing within you, and feel the joy of bearing gryphon eggs just like me.' She groans in pleasure while she rubs her own large egg filled belly, as she lies back on the cushions her eyes closing in exhaustion. You find your hand straying to your own belly as her words sink in, finding yourself half hoping that her seed has indeed caught and you will soon be joining her in her large gravid state...[impregchance][impregchance]";
				infect "Hermaphrodite Gryphon";
				increase Timothymated by 1;
				now lastTimothyfucked is turns;
			otherwise:
				say "'Sorry, but I really don[apostrophe]t think my mistress would like it if I let a non gryphon like you have its way with me. It just wouldn[apostrophe]t be right for a happy little breeding gryphon like me to get pregnant with anything but gryphon seed you understand.' Timothy says with a sad look at your body. 'But if you really want to have a little fun we could try to play around a little ourselves?' She says as she pats her thick black cock where It rests up against her pregnant belly.";
				if player consents:
					say "'Ah I knew you wanted to play around a bit with a big slutty gryphon, and maybe eventually you can become one yourself!' Timothy says happily as she gestures for you to crawl up onto the cushions with her.  Her excited scent and the scent of gryphonic rut filling your nose as you find yourself moving closer automatically, you feel your cock stiffening as your pussy clenches with need. 'Mmm I can see that idea turns you on doesn[apostrophe]t it?' she says as she pulls you up until you are lying next to her on the soft cushions, 'Wouldn[apostrophe]t it be great to have nice big breasts like mine?' She says as she moves her large milk filled breasts closer to you, her taloned hand reaching behind your head as she slowly guides your mouth down to one of her nipples, while her other hand guides your hand to her other breast, making her gasp in pleasure. 'Lovely big milk filled breasts, for little gryphlets and playful mates to suck on and tease...' She moans, as you find yourself doing just that, her wonderful flavor making you nibble and lick at her breast playfully, while her hand holds your head in place, and your other hand slowly roams over her other breast, running through the soft fur and teasing her nipple.  Soon your effort is rewarded by the pleasant flavor of her gryphon milk starting to trickle into your mouth, its flavor seeming to explode across your tongue as a new rush of arousal surges through your body.[line break]";
					say "'Mmm oh that feels so good,' She moans as you lick and suck on her wonderful milk giving breasts, her taloned hand stroking the back of your head, before roaming down your body further.  'Of course there's also the joy of having a nice thick gryphon cock,' Timothy says in a teasing tone, as her soft talons trace over your [cock of player] cock, making you gasp against her soft breast as she wraps her hand around your excited cock and pumps it a few times. 'A nice knotted gryphon cock to play with whenever you want is just amazing, but the most fun part of being a big slutty gryphon isn[apostrophe]t the cock,' She says as her taloned hand roams even lower, making you gasp as her clawed talon traces along the outside of your damp pussy.  'No the best part is the wonderful lion pussy of a gryphon slut,' the gryphoness moans, as her talon slowly pushes into your own pussy, causing you to moan in pleasure as your mouth fills with even more of her wonderful milk, your lust fogged head filling with the wonderful images her words are painting for you.  'Just imagine having a lovely gryphon body, like mine, with a hot needy pussy for all the lovely gryphon studs to fill full of their delicious thick cocks. Wouldn[apostrophe]t it be nice to be fucked again and again, their wonderful seed filling your body with delicious eggs.' She moans, as her talon thrusts into you teasingly, bringing you to the cusp of orgasm. 'And the best part is feeling your belly grow large with their nice thick eggs, and the orgasmic pleasure of laying them and growing round all over again.' Timothy moans, her body shuddering as she orgasms at the thought, your mouth filling with her delicious milk as her hand tightens within you, causing you to explode in orgasm as well. Your seed mingling with hers as it coats the cushions underneath you, and your slick juices coating her taloned hand as she pulls it out of your tired body. 'Doesn[apostrophe]t that sound like so much fun?' She asks as she lies back on the cushions next to you, clearly happy and tired from the playtime, 'you should really come stay and be a nice big breeding slut of a gryphon like me, I just know you would love it..' She says with a sigh as you slowly slide down off the cushions, and you have to admit, her offer does sound so very tempting...";  
					infect "Hermaphrodite Gryphon";
					now lastTimothyfucked is turns;
				otherwise:
					say "'Aw thats too bad, I was looking forward to putting it to use again, It[apostrophe]s been a little neglected lately in favor of filling me full of wonderful little gryphon eggs.' She says giving you a sad look out of her avian eyes. 'But I guess there isn[apostrophe]t much more to say than is there, maybe you
 should try my milk or find another gryphon out there to help fill you full of eggs'";
		otherwise:
			if bodyname of player is "Hermaphrodite Gryphon":
				say "'Oh wow! A handsome stud gryphon all to myself!' Timothy says with a happy smile as you approach her, smiling as she takes in your male gryphons form, 'A very handsome looking male too! Just looking at you is making me feel so very horny,' the gryphoness moans, as she shifts her large body, rubbing her talons over her large belly, as she spreads her lion like legs even further apart to give you a good view of just how wet she is. 'Why don[apostrophe]t you come up here and put that wonderful rod of yours to good use?' She pants out, her enticing aroma filling your nose as you climb onto the cushions with her. 'I just can[apostrophe]t wait to feel you inside me,' She moans, her ample chest heaving with excitement as you guide yourself to her waiting passage. You can[apostrophe]t help but feel yourself growing more excited than ever as the tip of your [cock of player] cock probes at her damp lips, her taloned hands running along your sides as she begs for you to fill her up.[line break]";
				say "Giving in to your own needs as well as her begging encouragement you groan as you sink yourself into her warm confines. Timothy cries out in pleasure as your cock enters her fully, her lion like legs stroking along your sides as she tries to press you into her even further. The feel of your thick rod inside her warm damp folds is nothing short of amazing, and you find yourself groaning in pleasure as you lean forward, your chest resting on her swollen belly as your hands grip her soft furred thighs. Timothy begins to moan desperately underneath you as you start to thrust into her extremely willing body, her head thrown back on the cushions and her eyes closed in pleasure as you take the little slut gryphoness for your own.[line break]";
				say "'Oh god it feels so good, so big and so masculine, I just love the feeling of it buried so deep in me.' Timothy moans underneath you, 'Please take me harder, rut me and fill me with your hot seed! Please use me like a good little pet and fill me up with your eggs!' The gryphoness begs in gasping moans of pleasure, making you grin as she is reduced  to little more than a needy beast under you, the pleasure of her well trained body mixing with the pleasure of seeing her become your willing slut, begging for the seed you are sure to give her soon. 'It feels so good to be nice and swollen with eggs, please cum in me, I want to feel your eggs growing in me with all the others, give you handsome little gryphon babies, and you can keep me as happily full as my mistress does...' She coos at you, her lust filled words filling your mind with pleasure, as her well trained pussy strokes your cock for all its worth.  Her ministrations soon have you shuddering in pleasure as your orgasm rocks your body with pleasure, your cock shooting its seed deep inside her body while her soft furred legs clutch you tightly to her.  You lie there for several minutes as she pants and strokes your body, your cock emptying itself fully into her body, before slowly softening, the amazing experience leaving you shaking with pleasure even as you pull yourself out of the wanton gryphoness and try to gather your wits about you.  'That was wonderful,' Timothy moans, rubbing her leonine thighs together as her taloned hands stroke her belly. 'I hope I will have some new eggs growing in here soon, Though maybe you should come back and visit me again once we both have recovered just to make sure... Don[apostrophe]t worry though, I won[apostrophe]t tell my mistress about this visit so you can keep coming back and having fun with me...' She says with a satisfied smile on her beak, as she relaxes back on the cushions.'";
				infect "Hermaphrodite Gryphon";
				increase Timothymated by 1;
				now lastTimothyfucked is turns;
			otherwise:
				say "'Sorry, but I really don[apostrophe]t think my mistress would like it if I let a non gryphon like you have its way with me. It just wouldn[apostrophe]t be right for a happy little breeding gryphon like me to get pregnant with anything but gryphon seed you understand.' Timothy says with a sad look at your body. 'Maybe you should try drinking some of my milk or going out to find a nice handsome gryphon to give you a big wet cunt of your own that he could fill with little baby gryphons...'" ;
	otherwise:
		if bodyname of player is "Hermaphrodite Gryphon":
			say "'Oh my, you look splendid!' Timothy says as she runs her eyes over your female gryphons form. 'With none of those annoying male bits to get in the way either, I bet you will make a wonderful little breeding gryphon don[apostrophe]t you agree?' She says, as she gestures for you to come closer so she can see you better. You find yourself flushing slightly as you obey, your body tightening with need as the heady scent of gryphon sex fills your nostrils, your pussy dampening with need as you crawl up to the pregnant gryphons form.  As soon as you draw close enough, Timothy begins to run her talons along your body, guiding you gently with her hands until you are sitting upright between her legs, and you find yourself staring at her thick black spined cock resting up against her belly, right in front of your gaping pussy. 'So hot and needy already,' Timothy says with a slight chuckle as she reaches down to stroke along your clit, making you moan, 'You really need a nice thick gryphon cock in you don[apostrophe]t you? Why not just give in to what your body wants and let me fill you up with mine.' The gryphon says, as she guides you forward, your body responding to her words and touches as she positions you over her thick cock, before lowering you down onto it.[line break]";
			say "The feel of the thick gryphon cock slowly splitting you open as you lower down onto it is amazing, your needy gryphon sex spreading wide eagerly to grip the thick cock like a glove, making you shudder in delight as you find yourself taking Timothy's stiff rod in as far as you can, its soft spines rubbing against you pleasantly as they push into your body until you are resting up against his thick knot. You gasp as the pregnant gryphon pulls you forward so your stomach rubs up against her pregnant belly, making you both moan at the wonderful sensations as she begins to lift her hips up and thrust her cock into you.  The movement causes you to groan in pleasure as she bounces you up and down on her cock, your body rubbing up against her large belly with every thrust, while her knot rubs up against the outside of your body, its thick bulge spreading you wider with each thrust as you feel your pussy stretching out to allow that wonderful bulge inside.  You find yourself crying out lustily as your body finally relents and you can feel your pussy gripping his knot tight as it finally presses into your body fully, your pussy closing tightly around it as it expands and locks you together.[line break]";
			say "'You need this so badly don[apostrophe]t you?' Timothy pants out as she continues to thrust into your all too willing body, 'If even the cock of a little breeding slut like myself feels this good to you, just imagine what the cock of a real stud gryphon is like,' Timothy moans into your ears, as she continues to move within you, her knot tugging at your passage with every small motion, sending waves of pleasure throughout your body. 'Just imagine their strong male hands holding you down as they fill you up, mounting you again and again until your belly swells large with their seed.' her talons stroke your the back of your head as you lean down closer, your body clenching in need as her soft words fill your mind. 'You would make such a perfect little breeding slut wouldn[apostrophe]t you, with no distracting little cock to get in the way, all you would have to think about is their wonderful cocks locking into your wet pussy, day after day, fucking you until your belly is as large as mine and you bear their big strong gryphon offspring. Don[apostrophe]t you want that? Want to be just another happy breeding slut for them to use?' Timothy whispers as she runs her talons along your body, her cock moving slowly within you as she keeps you panting at the edge of orgasm, her words washing over your lust fogged mind as she teases your body.  Before you can realize what you are doing, you find yourself nodding and begging as you agree with her, you find yourself begging for some strong gryphon to come claim you and make you its pet, desperately wanting them to fill your body up with fertile gryphon seed, and turn you into a breeding whore just like the pregnant gryphon underneath you.  The sheer dirtyness of what you are saying seems to make you even more excited as you beg, the truth of your words filling you with pleasure as you realize that at this moment in time that is exactly what your needy body wants, and an amazingly pleasurable orgasm explodes through you at that realization.[line break]"; 
			say "'I knew you wanted to be happy and full of eggs just like me,' Timothy moans in victory, as her body stiffens underneath you, her cock twitching inside your hot folds as it finally shoots its thick gryphon seed into your waiting womb, the thick knot tying you together ensuring that not a drop of that oh so fertile cum is wasted, while the spines tickle your passage to ensure your body is receptive. You find yourself panting as you lie on Timothy's stomach lightly, the knot keeping you together as she whispers more dirty words into your ears about the pleasures of becoming a breeding gryphon like her. You find yourself nodding almost automatically at her lewd suggestions of male gryphons and constant sex, almost wanting to give in and see what life as a breeder is like, eventually though, her knot softens,
 and the exhausted gryphoness relaxes back on the cushions to rest as you pull your tired body off of her, the spines tingling pleasantly as they pull out of you.  You stagger back to your feet and begin to gather your equipment to wander out in the city again, although you find one of your hands keeps wandering back to rub your belly, and you know that with the thick knot locking you together and the lovely spines stimulating your body, the chances of a pregnancy if such a thing is at all possible, is extremely high, somehow this thought just seems to make you feel even better, and you find yourself smiling as you get ready to leave.[impregchance][impregchance]";
			infect "Hermaphrodite Gryphon";
			increase Timothymated by 1;
			now lastTimothyfucked is turns;
		otherwise:
			say "'Mmm you want to be filled with wonderful little gryphon eggs too?' Timothy says as she eyes your female form, 'You aren[apostrophe]t quite ready to be a proper breeder though yet, while the female parts are in the right place, the rest of your body just doesn[apostrophe]t quite match.' the pregnant gryphoness says with a sigh, 'Fortunately I think I have a bit of a drink here that can fix that,' She says as she gestures you closer to her. With her excited scent filling your nostrils you find yourself complying eagerly, your pussy clenching hopefully as you draw closer, slowly crawling up onto the cushions near her leonine feet as you move up to her. She looks down at you over her pregnant belly as you move closer, a strange grin on her beak as she reaches down with one taloned hand and begins stroking her thick black gryphon cock in a teasing manner.  As your head draws closer to her nether regions, her musky gryphon scent grows even stronger, and you find your gaze fixing on her cock, her talons moving teasingly along its black length as you draw closer.  Drawing up level to her belly, your eyes still fixed on her cock, you are slightly startled to feel her other taloned hand stroke along the side of your head, before softly pushing it downwards towards that enticing black cock.[line break][line break]";
			say "You find your lips parting almost automatically as she guides you down towards her cock, your tongue tracing over its pointed tip as you draw close to it, the taste only intensifying your desire as your mouth waters and your pussy leaks its juices out onto your thighs. 'Oh yes,' Timothy moans, as she guides her shaft into your mouth, her talons gripping your head lightly as she feels your lips enveloping her member. 'Take all of my cock into that wonderful mouth of yours and suck  on it please!' She cries out, as she pushes your head downwards.  Needing no further encouragement with that delightful taste in your mouth, you find yourself eagerly sucking and teasing on her stiff black rod, your head bumping and rubbing softly against her large belly as it bobs up and down on her lovely shaft. Your mouth grips Timothy's shaft in its loving embrace as she grips the back of your head with her talons, her moans and groans music to your ears as you take more and more of her maleness into your mouth, licking and teasing at the soft black knot at the base of her cock as you suck happily on the rest of her shaft.[line break]";
			say "Unable to help herself, the gryphoness begins thrusting slightly into your mouth, moaning in need as she draws closer and closer to orgasm, the sounds encouraging you lavish even more attention upon her gryphon cock.  'God yes!' She cries out as her body shudders above you, and her cock stiffens as it fills your mouth with its fertile seed, the taste seeming incredible as you do your best to gulp it down. 'Suck it all down,' She moans as she continues to fill your mouth up to the brim, some dribbling down your chin slightly even as you continue working her rod. 'Drink down every little drop of gryphon sperm like a good little breeding slut, and let it make you into just another happy little gryphon whore just like me, ready and willing for all the horny gryphon males to come fill your gaping pussy with their seed.  And than you can stay here with me and have your belly nice and full with their eggs too, and we can do this all the time...' She moans out in pleasure, the words seeming to sink into your mind, bringing forth images of your body changing to be more like the gryphons, and how wonderful it would be to be nice and full of new life all the time as you do your part to expand the gryphon population.  You pull yourself off her spent cock, licking your lips as your body shudders in its own orgasm, her fertile seed filling your stomach and making your body tingle, and you find yourself wondering if being a happily fucked gryphon pet might not be a good idea after all.";
			infect "Hermaphrodite Gryphon";


when play ends:
	if bodyname of player is "Hermaphrodite Gryphon":
		if Timothymated is greater than 2:
			if Gryphoness is tamed:
				if humanity of player is less than 10:
					if cocks of player is greater than 0:
						if cunts of player is greater than 0:
							say "Giving in to the infection, and embracing your new gryphonic instincts, you and your lovely companion take off into the sky together, her soft song lifting your spirits as you soar together through the skies. Recalling that breeding gryphon you had the chance to meet earlier, you lead Denise through the skies until you arrive at the lovely nest in the clouds. Timothy[apostrophe]s mistress has returned however, and seems more then happy to see the both of you, inviting you in before pouncing on your horny bodies eagerly, you moan as she plays with your eager body, before it is her turn to moan as your mate begins to play with hers.  Soon the three of you sprawl out on the bed, where her breeding pet can join in, and before you know it everyone is groping everyone else, and fur and wings are rubbing together pleasantly as soft cries of pleasure fill the room.  You aren[apostrophe]t sure how many times the other gryphoness takes you, and you aren[apostrophe]t sure how many times you end up taking her as you all roll around together in a haze of carnal bliss.  Eventually you are all lying there spent and exhausted, with no real clue as to who actually came out on top, and hardly caring at all as you rub your well fucked belly happily, your cock beginning to stir again as you can see the other gryphons doing the same.  You can feel a grin starting to tug at your beak, as you begin to prepare yourself for another fun round of playing, and realize that while none of you seem to be able to, or even willing to come out on top at this point. The four of you certainly make a lovely breeding circle together.  Eventually as your bellies grow large together with the results of your many couplings, you actually grow to be something of an odd family as well, a family that is very soon going to be growing much. Much larger..."; 
						otherwise:
							say "Surrendering to the infection and your new strong gryphon instincts, you and your lovely companion take off into the sky together on your strong gryphon wings, enjoying the freedom of flight as you dance through the air together. Soon your instinctive needs lead you back to where you found and enjoyed the other lovely breeding gryphon in the sky, landing outside, you find that sadly Timothy[apostrophe]s mistress has returned to stop you from playing with her happy little breeder. She tries to drive you back with several blows from her strong wings, but with the help of your companion you are soon able to overpower the other gryphon as well. Timothy looks on eagerly as you pin her former mistress down on the pillows next to her, your own breeding pet cooing encouragement as she holds the formerly dominant gryphon down for you.  [line break]";
							say "You can feel a grin stretching across your beak as you push your gryphon cock into the new gryphoness, your knot locking the two of you together as you thrust into her all too eager body. Soon she is moaning underneath you as eagerly as your other breeding pets, and you grin as Timothy and Denise pant in excitement as they watch you mount the formerly powerful gryphon, each thrust of your barbed cock in her body making her more and more submissive to your touch. Finally you shoot your seed into her body, marking her as yours, and relax for a little with her underneath you, before you begin again, much to her dismay.  You enjoy mating your new pet again and again, only stopping to take turns with your other breeding pets, before returning to sink yourself into her body again.  You are finally satisfied when her belly begins to show signs of growing large with your seed, and her newly enhanced submissive streak has her begging to bear your gryphon young just as eagerly as your other two pets. Grinning as you look over your three egg filled mates, you realize that the happy life of a gryphon stud is definitely the life for you, and you set out into the city to see if you can find any other people who would make good breeders for a handsome gryphon stud such as yourself, returning often to make sure that your current stable of breeding pets never lack your seed or your eggs in their bellies... ";
					otherwise:
						say "Surrendering to the infection and your new strong gryphon instincts, you and your lovely companion take off into the sky together on your strong new gryphon wings, enjoying the freedom of flight as you dance through the air together. Soon your instinctive needs lead you back to where you found and enjoyed the other lovely breeding gryphon in the sky, landing outside the area, you smile happily as your mate leads you inside to greet Timothy properly.  You are somewhat happy to see that her mistresses has returned, and she certainly seems happy to see the two of you, her pet having told her all about you and how she told you all about the lovely life of a breeding gryphon.  The handsome dominant gryphon soon has both you and your mate panting needfully, as you sprawl out on the cushions near Timothy, you find yourself moaning happily as you watch while she dominates and mates Denise properly while you and her pet play together on the cushions. Soon she leaves your mate moaning happily as she rubs her well bred body, and comes over to where her pet has you hot and ready for her already.";
						say "You can feel a grin tugging at your beak even as you spread your legs for the wonderful gryphon stud you now realize is going to be your mistress from now on.  The feeling of your mistresses thick knot locking her inside your body, and ensuring that you will bear her lots of wonderful gryphon eggs is just amazing, and you pant eagerly and beg for more even as she shoots her fertile seed into your body. As you begin to come down from your wonderful orgasm, you feel her settling something around your neck, and look down to find that your thoughtful new mistress got you a collar to mark you as hers. Wearing her collar makes you smile, and makes you feel even hornier then ever, as you turn the tag up to read your new name. You feel yourself smiling happily as you see you are now called 'Breeder' you moan eagerly as you look forward to living up to your new name for your mistress, rubbing your stomach happily as you lie back next to mistresses pet, your mistresses cock still sending soft pulses of her her wonderful seed into your heat filled body. Looking over to where Timothy is lying there happily, you can[apostrophe]t wait until your belly is as nice and round with your mistresses eggs as hers is. Glancing over to where Denise is lying, you see your mistress got her a collar too, and coo happily as you realize that the formerly shy and musical gryphon can look forward to a wonderful new life as her mistress[']s 'Kitten', and are sure she will be just as happy and well-fucked a breeder gryphon as you are looking forward to being...";
				otherwise:
					say "When the military finally arrive to evacuate people, you find yourself unwilling to leave, as thoughts of Timothy and Denise fill your head, and you find yourself returning to the floating city with Denise at your side. The other gryphons welcome the two of you to the city eagerly, and while several of them try to trick you or Denise into a submissive position, or convince you to be a breeder for them, you both manage to resist by holding on to each other instead. At some point, as the cloud city drifts away from the city below to seek safer lands, you look up Timothy and finally meet the happy breeding gryphon[']s mistress.  She seems somewhat reluctant to invite the two of you in at first, but with her pet[']s encouragement she lets you in, and proves to be a nice enough gryphon, if a rather dominant one.  Eventually she offers to let the two of you stay there with her and Timothy for a while until you can both find your own place, and even knowing that she certainly intends to add you both to her stable of breeders if she can, the two of you happily accept.";
					if cocks of player > 0 and cunts of player > 0:
						if a random chance of 1 in 2 succeeds:
							say "[one of]Denise is soon the first to succumb, and you find her lying there happily bred next to Timothy one day, moaning wantonly and rubbing her belly as if eager for it to swell with new life just like Timothy's. You are somewhat careful of the other gryphon after that, and even think of leaving while you still can, but Denise manages to convince you to wait a while and think about it instead. Later that night though, you are woken up to find Denise and Timothy holding you down, while their mistress begins to push herself into your new gryphon cunt. You moan as she takes you again and again, your dominant urges replaced by increasingly submissive and maternal urges as her seed fills your body. Eventually you find yourself lying on the cushions yourself and rubbing your own full belly happily, and when Denise explains that she didn[apostrophe]t want to stay here without you, you forgive her easily... after all, how else would you have learned how wonderful it is to be a lovely gryphon breeder?[or]Denise is soon the first to succumb, and you find her lying there happily bred next to Timothy one day, moaning wantonly and rubbing her belly as if eager for it to swell with new life just like Timothy's. Angry, you confront the other gryphon, and a fight soon ensues, with the more powerful gryphon easily driving you back, and pinning you down, and you moan as you feel her cock pushing into your new gryphonic pussy. You are unable to resist as she pins you down and fills you with her seed, and you eventually begin to moan and respond to your new mistress like a good breeder should. She makes sure to breed any trace of resistance out of you, and you happily find yourself serving as not only your mistress's pet, but as a pet for her other two breeding gryphons as well, your belly always nice and full with their eggs... aren[apostrophe]t you lucky![or]You are the first to succumb to the crafty gryphon's blandishments, as she teases you incessantly, hinting at her willingness to be a breeding mare for you, only to turn the tables on you at the last minute, when your body is too heat filled and aroused to resist. Afterwards, with her seed filling your happy body, you just know you have to share this wonderful feeling with Denise, and soon manage to convince her to join you in your new life as a lusty egg slut for your new mistress...[at random]";
						otherwise:
							say "Watching the other gryphon closely, you decide you can[apostrophe]t afford to wait and let her have the opportunity to take advantage of you. You manage to convince Timothy to entice her mistress to play with her for a while, the happy breeding slut more then eager to go along with any plan that involves her mistress filling her body with seed. When the gryphon is distracted, you and Denise pounce while she is still tied to Timothy, mating her in pairs while she can[apostrophe]t resist, and holding her down afterwards and continuing to mate her eager body until she is begging to be filled with your eggs. Grinning at Denise, the two of you make sure that both she and Timothy are nice and full of your eggs, as the two of you settle in together as the new masters of your strange household.";
					otherwise if cunts of player > 0:
						if a random chance of 1 in 2 succeeds:
							say "Denise is soon the first to succumb, and you find her lying there happily bred next to Timothy one day, moaning wantonly.  She rubs her belly as if eager for it to swell with new life just like Timothy's.  You cannot blame her for it; she was never a very dominant partner in your couple, despite having the cock.  You walk over to her and give her a kiss, then kiss Timothy as well, moving your paws to their cocks and stroking them.  They moan happily at your touch.";
							if a random chance of 1 in 2 succeeds:
								say "You slide down to your knees beside the nest and set to licking and sucking on their cocks.  You please the pair orally, stroking, fingering, sucking and licking them until they each cum down your throat.  You tell them repeatedly how beautiful they look and how lovely their egg-filled bellies are.  When Timothy's mistress returns, you are quite excited and dripping for her.  She mounts you without delay, claiming you as another breeding pet for her harem.  You moan in delight as she thrusts into you while the others watch and stroke themselves off, spraying their seed onto your gryphoness body while she pumps her seed into you, breeding you with a clutch of eggs of your own - the first of many in your new life.";
							otherwise if a random chance of 2 in 3 succeeds:
								say "The sight of their well-bred bodies gets to be too much for you and you climb atop your mate's cock, moaning happily as it sinks into you.  You start to ride Denise's hard rod as she bucks her hips and thrusts into you.  Timothy smiles happily, stroking your hip and pulling your face down to her bosom.  You lick and suckle from her nipples, drinking down her milk.  Denise's cock blasts her hot seed into you, filling you with her eggs and breeding you like your body calls out for.  When Timothy's mistress returns, she finds you all snuggled together and nicely bred full of growing eggs, quite pleased with her little harem.  She mounts you all in turn, starting with you.  She is mistress to you all now and will claim all your subsequent clutches, but you are quietly happy to have given your first to Denise.";
							otherwise:
								say "The sight of their well-bred bodies gets to be too much for you and you climb atop Timothy's cock, moaning happily as it sinks into you.  Even as she starts reflexively thrusting into you, she moans something about waiting for her mistress, but you won't listen.  You want the subby gryphon pet to claim your first clutch, wanting to give in entirely and be beneath them all.  The breeder's objections stop when Denise moves over stuffs her breasts over her face, getting the pet to drink her milk.  When Timothy's knot ties with you and her hot seed blasts into your womb, you moan in delight with the knowledge that her eggs will grow in you.  You are now such a lowly slut that you'll give yourself to even pets and breeders like Timothy.  When Timothy's mistress returns, she finds you all snuggled together and nicely bred full of growing eggs, quite pleased with her little harem.  She mounts you all in turn, starting with you.  She is mistress to you all now and will breed you all often.  When she gives you a collar, its tag says 'Fucktoy', for that's all you are now.  She breeds you often, but you are a troublesome slut at times.  Behind her back, you sneak away often to have Denise, Timothy, other dominant gryphons or even the slutty breeders of other gryphons fuck you full of eggs.  You are the lowest of the low, the sluttiest of the sluts, the fucktoy and breeding slut of the entire colony, and you love it.";
						otherwise:
							say "You are the first to succumb to the dominant gryphon's advances, as she teases you incessantly.  She is much stronger and more dominant than Denise and knows it.  She whispers in your ear about how she'd give you far more eggs and much stronger gryphlets if you let her take you.  Even her cock is bigger, though she lets her size speak for itself.  It all becomes too much for you in time and you spread your legs for the sexy herm.  She drives her cock into you and mates you repeatedly, ensuring you get the big clutch she promised.  When Denise comes back to find you fucked and bred, she is claimed as well while you and Timothy hold her down.  Not that she resists, per se, but having a horny, egg-filled gryphon on either breast silences all objections or questions.  With her womb is filled as well, your mistress's harem is complete with you tagged as 'Breeder' and the musical Denise as 'Kitten.'  The trio of you make a lovely nest of egg-sluts for your strong mistress.";
					otherwise:
						if a random chance of 1 in 2 succeeds:
							say "Noticing how the dominant mistress is turning Denise's head at times, attracting her with her herm body, you decide you can't risk waiting much longer before she tries to steal your mate away.  You decide to turn the tables on her and sneak into Timothy's nest one evening.  Being a purely male gryphon, the slutty gryphoness has been eying you lustfully in her own rights and is easily swayed into letting you fuck her.  As you mate the slutty herm, you whisper to her over how you intend to breed her and that it takes a big male like you to breed a slut properly, that full males are the best studs.  After you've finished filling her pussy and womb with your seed, you leave her, hopeful that you'll be able to steal her away in a few nights' time.";
							say "But you are then shocked to find Timothy's mistress dismounting from Denise after filling her, clearly having started on the same plan.  You stare at each other, with her running to check on her 'Pet' and finding her in the same state as yours.  You both stare at one another before finally breaking down and laughing at one another and yourselves.  From that point on, you are fast friends instead of rivals.  You are a pair, master and mistress, to both the subby gryphonesses.  The title of 'Songbird' is bestowed upon Denise as you each take turns fucking her and Timothy.  You occasionally teasingly try to coax the mistress into letting you mount her, but she only chuckles that she will after you let her mount you first.  It is all a playful game though, for she happily lets you finger or eat her out and you never try to steal the chance to fuck her while she's knotted in one of your pets.  You have a very happy nest and wouldn't change it for any other arrangement.";
						otherwise:
							say "Noticing how the dominant mistress is turning Denise's head at times, attracting her with her herm body, you decide you can't risk waiting much longer before she tries to steal your mate away.  You decide to turn the tables on her and whisper your plan to Denise.  At first, she's a little reluctant, but obediently gives in to her male's request when she offers a small change to your plan.  Seemingly behind your back, she plays up her attraction to the gryphoness and allows herself to be taken off in secret to be mated by the mistress.  But you are there, ready and waiting.  With Denise on her knees and sucking the gryphoness's cock before the mating can commence, you sneak up behind the herm and drive your shaft into her.  She struggles briefly, but between the cock in her pussy and the hot beak around her shaft, she has trouble resisting and soon gives in entirely.  You fuck her beneath the night sky for hours, taking turns with Denise until she's been filled so many times that she stops resisting and gives in to you both.  You drag her back to Timothy's nest and toss her onto it, shocking Timothy.  The gryphoness is even more shocked as you force your new slut to mount her one-time pet's cock and ride it for another dose of gryphon cum in her slutty pussy.  When the morning comes, you have a lovely harem of your own, with Denise as your 'Songbird', Timothy now as your 'Pet' and the former mistress reduced to 'Fucktoy'.  You have your fucktoy used by all, even Timothy and the other pets and breeders of the colony.  She always moans and squirms any time you let a breeder take her, but she always cums the hardest for them as well, so you know she loves it.  All her eggs grow into best subby pets and breeders of the colony.  After their mother, that is.";
			otherwise:	
				if humanity of player is less than 10:
					if cocks of player is greater than 0:
						if cunts of player is greater than 0:
							say "Giving in to the instinctive urges deep within your needy mind, stiff cock, and hot pussy, you find yourself taking off on your new wings as you head back to the place where you found and enjoyed the wonderful breeding gryphon. Much to your delight, you find that Timothy[apostrophe]s mistress has returned, the handsome herm gryphon welcoming you with open arms as she sees how needy and ready your body is for her. Before long she has your body pressed up against Timothy's needy form, your cock pressing at the needy wetness between Timothy's legs even as she fills your pussy up with her own wonderfully strong gryphon cock.  You find yourself overwhelmed with pleasure as she guides your cock into Timothy's silken passage, the pregnant gryphon moaning underneath you as you are sandwiched between her and the strong and powerful gryphon behind you. Your lust fogged mind quickly succumbs to the intense pleasure of both fucking and being fucked at the same time, your body pressing into the gryphon underneath you in time to the stronger gryphon mistresses thrusts. Soon she cries out as she fills your needy body with her fertile seed, the feel of all the lovely baby batter coating your insides triggering your own orgasm as your body shoots its own seed into your fellow breeding slut.  You stay there panting, your bodies locked together in pleasure by your thick gryphon knots as her seed sinks into your body, working to fill your womb with her eggs. You find yourself smiling as you can feel your mistress slipping her collar around your neck, marking you as her property just as much as the smiling gryphon underneath you. [line break]";
							say " You look down and tilt the tag up to read your new name, and you can feel your beak pulling back in a smile as you can see the tag that proudly proclaims you to be 'Toy' hanging from your collar. You can[apostrophe]t help but feel joy at the rightness of the name, and moan in pleasure as your mistress[apostrophe]s cock begins to stiffen and move within you again. Your mind is overwhelmed with lust as she begins to use you like a good toy, filling your needy belly up again and again with her seed, even as her pet writhes underneath you. Soon you know you will look just like her pet, your belly round and large with her eggs, and your form so well bred it will be hard to even move, lying here together waiting for your mistress to return and fill you with even more eggs so you can birth the next generation of her wonderful offspring. Just the thought of your eventual fate seems so wonderful to your instinct driven mind now, as you rub your leonine legs against hers, that you find yourself begging and pleading for her to fill you up with her seed again and again until your body is as round and full with life as her pets. Your mistress is happy to comply, and soon you find yourself living a wonderful new life, as your mistresses happily pregnant new toy, and though you and her pet often keep each other company while she is out, putting your flexible beaks and talons to work, you are both happy to know that only her seed fills your wombs with her wonderful eggs, which you birth for her time and time again.  You are so happy you discovered the pleasures of being just a lovely gryphons breeding toy...";
						otherwise:
							say "Giving in to the instinctive urges deep within your needy mind and stiff, you find yourself taking off on your new wings as you head back to the place where you found and enjoyed the wonderful breeding gryphon. Unfortunately you find that Timothy[apostrophe]s gryphon mistress has returned, and upon seeing you she does not appear amused. Spreading her wings out she drives you back with several harsh blows, keeping her pet to herself as she drives your male form off to find another breeder to fill with your seed. Your body's new needs only enhanced by the touches of a breeding slut, you prowl the streets looking for a unclaimed pet of your own. Having surrendered to the infection rather late, you find the city practically empty of good stock, until the military arrives.[line break] ";
							say "You carefully stalk several of the soldiers until you can manage to lure one of the females away from the rest long enough for you to swoop in and carry her off. She is stunned as you carry her to your prepared nest, where you than proceed to quickly strip her bare and master her body with your strong gryphon cock. You love the feel of her body changing underneath you as you rut her again and again for hours on end, driving all her old and unnecessary human thoughts from her new gryphon brain as you make her into a fitting receptacle for your eggs.  You are happy to see that when she is finished she is perfectly matched to you, a proper breeder with just a lovely well fucked cunt instead of the dual equipment so many of the other gryphons sport.  Soon she is your happy mate, her belly swelling with your eggs, and her body eager for your seed every time you return from your hunting, she bears you many healthy gryphon eggs as time passes, and eventually you manage to find more pets to share your nest and keep her company while you hunt, though she always remains your favorite.  Your many, many offspring will eventually spread across the land, converting more and more people into happy little breeding gryphons... but not for some time to come.";
					otherwise:
						say "Giving in to the instinctive urges deep within your needy mind and hot pussy, you find yourself taking off on your new wings as you head back to the place where you found and enjoyed the wonderful breeding gryphon. Much to your delight, you find that Timothy[apostrophe]s mistress has returned, the handsome herm gryphon welcoming you with open arms as she sees how needy and ready your body is for her. Before long she has you sprawled out face down on the cushions, your head between Timothy's legs as she fills your pussy up with her wonderfully strong gryphon cock.  The pleasure of her barbed cock pressing into you making you moan as you lick and suck eagerly at Timothy's cock even as the gryphon stud fucks you roughly. Soon you find yourself orgasming uncontrollably underneath him as he fills your belly up with his fertile seed, your body shuddering as it prepares itself for the eggs that are sure to come. [line break]";
						say " As you lie there trying to recover your mouth still licking and nuzzling at Timothy's sex, you feel something settling around your throat, and look down to find that your mistress has just fitted you with your own collar, marking you as just another one of her happily fucked pets. You raise one of your talons up to tilt the tag up so you can read what it says, and find your beak pulling back in a smile as you see it reads [']Egg-Slut['] and you realize just how true the tag is, and find yourself enjoying how it declares your purpose to any handsome stud gryphon who draws near.  You find yourself cooing happily as your mistress strokes your feathered head with her strong talons, happy to finally be free to be nothing more than your mistresses little egg slut.  You find yourself smiling as she guides you back down onto the cushions next to your fellow breeding slut, her cock already thick again and ready to fill your needy body will all the eggs your slutty heart could desire... and you find yourself glad as you feel her thick gryphon seed shooting within you again, that you have finally found where you belong, serving your mistress and bearing her many, many young...";
				otherwise:
					say "When the military arrive and you are finally able to leave the city, you find yourself constantly wondering about the strange breeding gryphon you left behind in that strange floating city. And you find yourself wondering if they are still there even after the military has long since evacuated those on the ground, the happy breeder and her mistress and gryphon studs who keep her filled with eggs again and again. Eventually curiosity gets the better of you, and you pack up and head back to the city to look, you tell yourself that it is just to let them know they should return to normal society, as you follow the trail they left to their city where it hides among the mountains, you feel your body responding to the scent, and realize that it is you that has finally come home, as they greet you with open arms. While you are never heard from again, there are persistent rumors of an ever growing number of gryphons in those isolated mountains...";
		otherwise:
			if Gryphoness is tamed:
				if humanity of player is less than 10:
					if cocks of player is greater than 0:
						if cunts of player is greater than 0:
							say "Giving in to the infection, and embracing your new gryphonic instincts, you and your lovely companion take off into the sky together, your new wings lifting you aloft easily. Your companion[apostrophe]s song fills the air with its lovely tunes as you soar through the skies above the city together. Soon the two of you find a nice secluded spot away from the city and the press of the military and other infected, and you settle down to enjoy your new lives together, your days filled with the joys of flight, song, and lots and lots of sex. You both take turns mating each other lustily, often several times a day, and after a while you can[apostrophe]t help but smile at the sight her belly growing large and round with the fruits of your labors... but then again, your belly is also beginning to show the fruits of her labors as well, and you smile as you realize your little family is about to get a lot larger...";
						otherwise:
							say "Giving in to the infection, and embracing your new gryphonic instincts, you and your lovely companion take off into the sky together, your new wings lifting you aloft easily. Your companion[apostrophe]s song fills the air with its lovely tunes as you soar through the skies above the city together. You find yourself enjoying how eagerly your partner displays herself for you, and how much she enjoys you filling her belly with your seed, obviously happy and eager to finally embrace the life of a gryphon breeder.  Happily leading her out of the city, you soon manage to find yourself a nice den near a small town, where you can both be safe while she grows large with your eggs.  You return to the city occasionally to watch the skirmishes between the military and the other infected, occasionally joining other gryphons as they swoop down to intervene sometimes, or to play tricks with the military[apostrophe]s milk supply like the one the gryphons played at your mates apartment.  You find you enjoy flying off and leaving the transforming military behind to deal with their strong new urges, and even manage to bring a couple of them home to join your mate as happy breeders once they have realized their true calling.  Soon your den is full of your offspring as well as several happily gravid breeding gryphons, and you can[apostrophe]t help but feel a smile tugging at your beak as you hear the soft tones of Denise[apostrophe]s song as she sings the little ones to sleep, happy to have finally found a nice  home together with your mates.";
					otherwise:
						say "Giving in to the infection, and embracing your new gryphonic instincts, you and your lovely companion take off into the sky together, your new wings lifting you aloft easily. Your companion[apostrophe]s song fills the air with its lovely tunes as you soar through the skies above the city together. Eventually your handsome mate guides you out of the city, and you find yourself giving in to the more masculine gryphons urgings almost instinctively.  Following your mate you travel for several days before you end up settling on a cliff near a rather large city, the closeness of the nearby populace has you nervous, but Denise calms you down easily as she rubs up against your female form, her hands stroking and exciting you, until you forget all your objections as you bend over to let her mount you again and again. You find yourself falling easily into the role of a submissive breeder for your handsome mate, as you set up your new den eagerly for them during the day, and present yourself eagerly to be bred whenever she wants. Soon you can feel your belly growing round with new life, the feeling of your mates children growing inside you making you happier then you ever thought possible.  Eventually as you grow even larger from your continued matings, you are unable to even leave the den any longer, letting your mate do all the scouting around the city while you rest and relax like a good little gryphon breeder.  After a while you find out why your mate picked this particular city to settle down in, as another gryphoness joins you in the den, and you are happy to have the company, as well as another lovely breeder to help you bear your mates children. The new breeder tells you this city is famous for it[apostrophe]s musical talent, and that several people have been lured out into the dark by your mates beautiful song, where the ones who can sing best she tries to transform.  You smile happily as you realize your mate is finally able to live up to her dream of singing for other musicians, and look forward to her adding several more of her conquests to the den soon as well... after all, surely they will all be as drawn in by her lovely lonely song as you were once upon a time... ";
				otherwise:
					say "When the military comes, Denise is scared, but you manage to convince her to come with you, and the two of you go with the military to be cleared for life outside the city.  The military are slightly worried about just how infectious your particular strain of infection has proven,  but between the two of you you manage to sweet talk them into letting you go, your obvious intelligence and control convincing them to focus on the problems still inside the city instead.  Afterwards you both wander around together aimlessly for a time, and Denise begins to grow slightly depressed again before you spring your surprise on her. Your fellow gryphon is shocked when she realizes you have been learning to play a guitar you had specially modified for your talons, and is equally surprised when you introduce her to several other infected outside the city with some musical talent.  She grows increasingly excited as together you put together your own band, and her joy is infectious, soon you and your new band are laughing and having a great time together, as she puts her lovely new voice to use. With your enhanced reflexes and perfect gryphon hearing, you make an excellent guitarist as well, being sure to always give her the perfect backdrop to allow her voice to shine.  Soon your band is drawing larger and larger crowds, at first because it is a novelty band made up entirely of those changed in the outbreak, but quite soon more and more people are actually being attracted because of your unique sound and musical talents.  The two of you are soon happier then ever as you travel around with the band, enjoying your new [if charisma of player > 17]superstar[otherwise if charisma of player > 14]major[otherwise]minor[end if] success status. Though remembering your time together in the city, neither of you let the fame go to your head to much, and you continue to enjoy your time together away from the stage most of all... although sometimes you end up enjoying your time together with some of the bands groupies as well... but that's another story...";
[		otherwise:		[Gryphon body w/neither Timothy nor Denise goes here]	]	
	otherwise:
		if Gryphoness is tamed:
			if humanity of player is less than 10:
				if cocks of player is greater than 0:
					say "When you surrender to the lusty instincts inside you, Denise tries to stay away for a while, but is unable to take the loneliness of life in the city without anyone to talk to, especially after having had a friend even for a short time.  Soon you hear her soft song through the city, and almost instinctively you follow it to where she is waiting for you. She smiles as she welcomes you with open arms, and lets you change her and make her yours, so she can follow you wherever you go in your new life in the city...";
				otherwise:
					say "Taking your surrender to your feral instincts as a sign, Denise stops fighting her own instincts, and while she stays with you for a short while, soon she flies off in search of other gryphons to mount her and make her a proper breeder just like you...";
			otherwise if bodyname of player is not "Siren":
				say "Rescued from the city, you manage to convince Denise to come with you as you make your way out into the new world, her shy demeanor makes it somewhat easy for you to keep her with you as you try to settle in to your new life.  Eventually she becomes happy settling in wherever you are, though she does manage to accumulate a large variety of music, which she often listens to wistfully.";

Section 4- Gryphon Nest

Gryphon nest is a room.

The description of Gryphon nest is "This small room is tucked between several of the other tents filling the area, its soft canvas surrounding a small private enclosure filled with a large variety of different cushions and cloths, the soft light from the glowing floor and tent cloth illuminating the area. You can see several small items and trinkets, scattered amongst the cushions, but your eyes are drawn most to the heavily pregnant herm gryphon lying sprawled out on the cushions, a small collar with a tag hanging from around her neck.";
Timothy is in Gryphon nest.
Gryphon nest is west of City Plaza.

instead of sniffing the Gryphon nest:
	say "The nest area smells strongly of gryphon arousal, sex and egg-laying.";














Zoo People ends here.	 


