Arlene by Sundered Dragon begins here.
[version .01 ground work]

"Adds a pirate shark named Arlene turned dragon priestess to the Flexible Survival game."

[   HP of Arlene                         ]
[ 0 = Event not started                  ]
[ 1 = Met not talked yet                 ]
[ 2 = Talked given initial quests given  ]
[ 3 = First turn in                      ]
[ 4 = second Quest offered               ]
[ 5 = second turn in                     ]
[ 6 = third quest                        ]
[ 7 = third turn in                      ]

[       level of Arlene gained via breeding hir and improving the temple         ]
[ 0 = no blessings                                                               ]
[ 1 = Gift of fertility gives the priestess four balls.                          ]
[ 2 = Blessing of fortitude, make the priestess size five and dummy thicc.       ]
[ 3 = Abyssal embrace, causes the priestess to grow tentacles.                   ]
[ 4 = Infernal abundance, makes them milky and able to have multi preg.          ]
[ 5 = Breath of Tiamat, Arlene gains draconic traits.                            ]
[ 6 = Boundless Adipose, vore cult only tf to make Arlene into whale dragon shark]
[ 99 = blessings rejected                                                        ]


[  Hunger of Arlene used to track kids and changes to hir chambers     ]
[ 0-10 = novice breeder/ not bred                                      ]
[ 11-20 = Broodmother in training                                      ]
[ 21-30 = Proud broodmare                                              ]
[ 31-40 = Fertility idol                                               ]
[ 41- 50 = Pampered milk cow                                           ]
[ 51 and up = indolent dragon breeder                                  ]

[  Thirst of Arlene                               ]
[ 0 = PC not learned of Arlene's embezzlement     ]
[ 1 = PC turns a blind eye to hir heresy          ]
[ 2 = PC is skimming off the top as well          ]
[ 3 = PC puts a stop the thieving                 ]
[ 4 = PC is blackmailing Arlene               ]

[   Morale of Arlene tracks the grandure of the cult which is increased via recruiting humans and questing ]
[ 0-10 base level austere cult                                                                             ]
[ 11-20 furnished halls and rough stone                                                                    ]
[ 21-30 = the temple grows and supplicants abound                                                          ]
[ 31-40 = A crowded but comfy the temple walls have been smoothed but many comforts are lacking            ]
[ 41-50 = New passages are craved and comforts abound as the cult expands                                  ]
[ 51-60 = the temple groans with the weight of its plunder and the happy sighs of it gravid thralls        ]

[ Libido of Arlene                                  ]
[ 0 = not pregnant                                  ]
[ 1-12 = first signs of pregnancy                   ]
[ 13-28 = About to pop                              ]
[ 29 = Ding dergs are done                          ]


[loyality of Arlene                       ]
[ 0 = can't get H-preg                    ]
[ 1 = could have gotten H-preg            ]
[ 2 = is H-preg                           ]


[Strength of Arlene used to buff rebellion chance]

[Dexterity of Arlene rolls against humanity during rebellion]

Table of GameCharacterIDs (continued)
object	name
Arlene	"Arlene"

Arlene is a woman.
Arlene is in The Priestess's Chamber.
ScaleValue of Arlene is 3. [human sized]
Body Weight of Arlene is 5. [scale of 1-9 for body weight, grouped into low weight (1-3), mid weight (4-6) and high weight (7-9)]
Body Definition of Arlene is 5. [scale of 1-9 for body definition, grouped into low muscle (1-3), mid muscle (4-6), high muscle (7-9)]
[Body Adjective is generated out of the body weight and body definition and can be used in scenes - one word descriptive adjective depending on weight and definition groups: low weight group: skinny/slender/lithe; mid weight group: average/fit/muscled; high weight group: pudgy/husky/jacked]
Androginity of Arlene is 6. [Gender Adjective is generated out of androginity 1-9: hypermasculine/masculine/somewhat effeminate/effeminate/androgynous/feminine butch/tomboyish/feminine/hyperfeminine]
Mouth Length of Arlene is 10. [inches deep for face fucking; maximum possible will be double this number (when deep throating)]
Mouth Circumference of Arlene is 3. [mouth circumference 1-5, "tiny, small, normal, wide, gaping"]
Tongue Length of Arlene is 7. [length in inches]
Breast Size of Arlene is 5. [cup size as number, counting Flat Pecs = 0, A = 1, B = 2, ...]
Nipple Count of Arlene is 2. [count of nipples]
Asshole Depth of Arlene is 6. [inches deep for anal fucking]
Asshole Tightness of Arlene is 1. [asshole tightness 1-5, "extremely tight, tight, receptive, open, gaping"]
Cock Count of Arlene is 2. [number of cocks]
Cock Girth of Arlene is 3. [thickness 1-5, thin/slender/average/thick/monstrous]
Cock Length of Arlene is 10. [10 Inches]
Ball Count of Arlene is 2. [allowed numbers: 1 (uniball), 2 or 4]
Ball Size of Arlene is 3. [size of balls 1-7: "acorn-sized", "dove egg-sized", "chicken egg-sized" "goose-egg sized", "ostrich-egg sized", "basketball-sized", "beachball-sized"] [Increase by 1 for Alpha, decrease by 1 for Omega]
Cunt Count of Arlene is 1. [number of cunts]
Cunt Depth of Arlene is 6. [penetrable length in inches; some minor stretching allowed, or more with Twisted Capacity]
Cunt Tightness of Arlene is 3. [size 1-5, generates adjectives of extremely tight/tight/receptive/open/gaping]
Clit Size of Arlene is 1. [size 1-5, very small/small/average/large/very large]
[Basic Interaction states as of game start]
PlayerMet of Arlene is true.
PlayerRomanced of Arlene is false.
PlayerFriended of Arlene is false.
PlayerControlled of Arlene is false.
PlayerFucked of Arlene is true.
OralVirgin of Arlene is false.
Virgin of Arlene is false.
AnalVirgin of Arlene is true.
PenileVirgin of Arlene is false.
SexuallyExperienced of Arlene is true.
TwistedCapacity of Arlene is false. [Twisted Characters can take any penetration, no matter the size]
Sterile of Arlene is false. [steriles can't knock people up]
MainInfection of Arlene is "Dragon Breeder".
Description of Arlene is "[priestessdesc]".
Conversation of Arlene is { "Yo-ho and a bottle of cum!"}.

the scent of Arlene is "Casually sniffing the air coiling about Arlene's quarters, you draconic senses are greeted by the potent scents of hybrid need laced with crisp oceanic tangs."

to say priestessdesc:
	if level of Arlene is 0 or level of Arlene is 99:
		say "     Though new to hir role as priestess, the self proclaimed former captain nevertheless carries hirself with an air of authority and confidence befitting hir station as herald of your burgeoning Dragon Cult. Still, hir meager [']robes of office['] as shi calls them leave much to be desired and little to the imagination. Not that you're complaining, as the thin black bikini top and primitive leather necklace festooned with wave polished blue moonstone alongside aquatic fangs circumscribing hir lush E-cups imparts a certain primal beauty to hir sleek curvaceous form and gentle clacker to hir steps. While a simple set of large gold hooped earrings worn smooth and pitted by hir time amidst the waves adorns hir sharp pointed fins. Hopefully, as the cult's numbers grow, you'll be able to adorn your herald with proper regalia, for now, the simple charm of her primitive attire serves its purpose and provides you with a generous view of your priestesses hybrid beauty.";
		if Libido of Arlene is 0:
			say "     You ruminate, while your gaze drifts down along the athletic contours of her midriff as you bask in the cute, subtle blush of hir cock cave and gentle inviting sway of hir plush sack nestled against hir tone thighs. Perhaps sensing your libidinous stare, the cheeky monster girl fixes you with a knowing grin as shi leans provocatively into your stare, while the subtle impression of hir plush dick slit parts ever-so-slightly as the glistening tips of hir twin tools peek out from their warm inviting housing. Smirking at the sight and lovely scent of hybrid desire wafting off of hir proud swimmers body, you allow yourself a moment of idle self indulgence as you watch thin breads of pearly pre leaking from hir lurid endowments. Then down as the gleaming droplets flow along chiseled contours of hir well-lubed digitigrade legs and hir large, powerful webbed padded paws.";
			project figure of Priestess_clothed_icon;
		else if Libido of Arlene >= 1 and Libido of Arlene <= 12:
			say "     You think to yourself as your inquisitive orbs casually meander along the adorable swell of hir taut spherical tummy while you admire the sensuous impressions of heavenly E-cups lazily resting upon and gentle motherly glow of hir alabaster middle. Despite hir normally dominant commanding public presences, the new mother at times struggles to maintain the image of dignity and grace as shi waddles through halls. Even now shi looks a tad flustered by your inspection of hir growing bounty as a sweet girly blush blossoms on hir angular muzzle as the competitively small monster mommy fidgets beneath your lustrous imperial stare. While hir webbed paws casually drift to the supple swell of your latest clutch as she, somewhat thoughtlessly, brushes hir clawed mitts about the subtle outline of your eggs peeking along the edges of hir fingers. Chuckling at hir sheepish display, you offer your lovely mate a reassuring smile and a few token loving words of praise that puts the novice mother at ease as shi proudly arches hir back as the golden light of your eyes washes over hir growing bounty.";
			say "     Good girl, this looks suits you, now doesn't it? You purr affectionately, flaring your chromatophores in molten ballet of lustrous hypnotic hues as you reach out and gently stroke hir coarse cheeks. Nodding dreamily as the pleasant swirl of many colors and none simmer across hir selachian eyes, the former captain turned breeder straightens hir posture, as notes of hir earlier public confidence flicker along the edges of hir angular muzzle. Your languid gazes explore the generous swell of hir hips, and the pronounced crimson blush of hir dick slit as the horny herm thrum delectably within their juicy housing while the glistening trick of girly dew shamelessly filters along the ripped hills and valleys of hir bestial legs. Bathing hir coarse hide in a needy sheen of balmy delight as shi casually pampers your brood with renewed delight.";
		else if Libido of Arlene > 12:
			say "     You muse, while your abyssal eyes shameless wallow at the delectable sight of your priestess's maternal majesty, hir ponderous drum tight tumby hangs well past hir knees while an adorable pair of arms swallowing love handles gracing hir voluptuous grace hir voluptuous feminine flanks. While the vibrant tapestry of rich ruby red stretch marks spirals around hir prominent outie is slowly becoming the unofficial symbol of your cult's purpose as some have even begun adoring their bodies with crude simulacrums. Much to Arlene's delight as despite hir hints of reticence towards hir bountiful curves, as hir body swells with draconic life, so do hir powers along with connection to Tiamat, and prestige within the cult's ranks. Already hushed whispers of hir [']communions['] with the goddess's favored angels echo through the temple halls as shi spends more and more of waking hours pampering hir brood as shi encourages them to grow larger. Even now, hir paws rarely leave hir bountiful bump for long, as hir glittering spherical middle provides the perfect rest not just for hir arms, but hir decadently engorged breasts lovingly atop its gravid beauty.";
			say "     Wondrously flushed with untold liters of fresh cream, the novice brood mother's comparatively small body can barely support the lush weight of sloshing G-cups, much less hir potent womb. To hir credit though, the little biped carries hir new found (if temporary assets) with lovely grace befitting hir title are your priestess, but not without cost. As the lovely brew of motherly hormones and the heady pressure of your spawn massaging hir lovely hybrid anatomy wreaks the most delectable havoc with hir oversexed senses. Even now, you can smell the twin scent of salty pre and balmy fem honey coiling about hir as shi basks in hir god-to-be's presence eager to receive your commands, or slake your body's boundless draconic lust upon them. Rumbling happily, a part of you wonders if perhaps you should indulge these urges, or maybe show some loving compassion towards the needy herm as your eyes drift the lurid ruby glint of hir cocks peeking out from under the toasty swell of hir heavy belly. After all, it won't be long till shi's due, you muse, mouth watering at the thought of rewarding your favored follower's devotion.";
	[else if level of Arlene is 1:
		say "      In the days since your cults inception, your priestess has started to grow into hir role as guide and mentor to the humans sheltering among your imperial kind. Already resources and fresh blood have slowly begun to pour into the temple, and as is hir right as priestess. Arlene has taken a small tithe of materials and commissioned a beautiful set of silk robes to better reflect her status. Another time, you might have taken some small measure of ire at such misuse of [bold type]your[roman type] treasure, yet even your coldblooded side recognizes the utility of bejeweling your priestess in such finery. After all, it wouldn't do if the voice of your will continued to clothe hirself in rough stones and cast off fang like some common backwater shaman tending to an insipid flock of inbred fools. You muse, many eyes lovingly drifting along the open black and gold laced silk robe neatly resting upon hir toned hourglass curves as the torches plays along the glossy fabric. Though a simple sash made of tanned black leather emblazoned with expertly cut blue moonstone and carved white enamel adorns hir waist, your priestess rarely ties or makes any effort to conceal the wondrous blessing bestowed by Tiamat.";
		say "     You opine, letting your gaze roaming the growing softness of hir core as once tight six pac has given way to thin a supple layer of maternal padding. By no means fat, the added motherly padding swaddling hir well-bred middle not only enhances the potent chiseled muscles decorating arms and sturdy digitigrade legs, but provides a bit of grip for your talons during your ever-more-frequent moments of passion. Hir breasts too have grown to a commendable F-cups that provides pleasant eye catching bounce to hir step as shi makes rounds about the temple extolling the virtue dragons and coming of the goddess. Where shi goes, Arlene's zeal spreads through the masses spurring them to work harder to prepare the temple for its debut on the eve of your ascension. Ever eager to please, the humans happily drink in hir words like ambrosia and make a point of lending their own tummies to the cause as a great number of humans have begun keeping tall marks on their blossoming bodies to advertise their devotion to your flight. Though shi wisely cautions restraint for the moment as the cult's numbers are too low to allow your flock to lay about and brood.";
		WaitLineBreak;
		if Libido of Arlene is 0:
			say "     Yet such efforts are often in vein, as your flock's devotion to growing your and the enhancements to hir own potent package, has led to more then a few of your followers and Seradovah thralls succumbing to your quad-balled servant's charms. Even now, more than a few of their ilk have become regular fixtures in the subsurface nursery. Not that you could ever truly fault them, as even you are not wholly immune from hir enhanced potency as your couplings have become all the more fruitful, nor you can say that you aren't enjoy the sight of hir four plush balls bouncing in tune with hir every step. Or, you muse as a cute hungry rumble passes through your middle, the refined taste of hir creamy seed titillating your taste buds, and the heavenly warmth of cum rounding out your [bodydesc of player] core.";
		if Libido of Arlene is >= 1 and Libido or Arlene is <= 12:
			say "     Though as your eyes meander about the gentle growing curve of hir eggy tummy, you can't but notice the lovely maternal glow radiating off hir, and the soaring comfort Arlene takes in hir gravidity. Where once stood a clumsy novice breeder, unsure how to carry hir blessed eggs, now stands a confident broodmother in training. Though hir motions are still at times awkward as shi struggles with the weight of your eggs, your guileful priestess has learned how to turn such moments of weakness into to hir advantage as with but a sigh, or a single huff. Your flock comes rushing to hir side eager to care for the vessel of your will and favored mother of you spawn. Hir breasts too are already showing the lovely signs of engorgement as hir plump grey and white rack has gained more than a little added heft and firmness to them. You muse, proudly taking in the beatific sight of ripening sweater puppy gently resting atop hir expectant middle.";
			say "     Though nowhere near full, hir lush mounds creaks and sloshes delectably with hir every motion, serving as a constantly lovely little reminder of hir of condition. Not that shi appears to mind, as the shameless herm seems to enjoy the extra attention paid to hir as playfully adjusts hir robe, or leans just a hair forwards into your gaze to better highlight hir row. Hir gait too has shifted over the last few days to long purposeful predatory stride which imparts the most delectable of ripples through hir taut motherly figure with hir every step. Even a far traveled soul such as yourself is wholly hardened against the maternal charm of hir voluptuous curves as your many eyes often follow the heavenly bounce of hir plush tit and hefty balls peeking out from under the hem of tight spherical tum. Perhaps, you muse, as the coiling scent of hir hybrid need waft about you, you should relieve your chosen of some of hir burden as the poor herm's left hand casually dips below the glistening hem of hir tummy as shi casually fondles basketball size package.";
		else if Libido of Arlene > 12:
			say "     Besides, your eager priestess is quite adept at whelping new members of your prolific flight all on hir own. You think to yourself, as your loving gaze drinks in the heavenly sight of your chosen hopelessly swollen womb. Hir lush motherly tummy dominates much of hir view as the sensual alabaster dome ringed by smokey grey lazes well past hir knees. While a glorious tapestry of thickening ruby stretch marks centered around hir plush outie as hir overtaxed body swells all the rounder with the cute not-so-little outlines of your spawn. Despite this, your mate wears hir change with pride as you often spy hir idly strokes some of the deepening tigerstrips circumscribing hir tumby, or resting hir arms upon the vast curve of hir love handles. Seemingly inspired by hir changes, many more of your follower have begun tattooing their own bodies with simple simulacrums of hir lovely tigerstripes to honor their priestesses.";
			say "     Meanwhile, hir robes can barely contain Arlene's impressive bust as hir tight perky F-cups have almost bloomed into heavenly H-cups. Wondrously flushed with delectable cream, hir tits practically shimmer in the torch light as hir course pebbled hide groans with the weight of hir cream while they lusciously sway a top hir impossibly swollen tummy with the slightest provocation. All to Arlene's, and the cult's evergrowing delight as many of your more brood focused followers have come to enjoy the potent taste of hir divine milk. Hir power and connection to your patron has become all the closer too as hir communion with the goddess and Kai Monah, once an open secret. Are now the talk of the cult as shi has begun openly encouraging others to observe hir as shi [']communes['] with your brood. The fact such rites often involve your flock pampering or massaging hir brood swollen body and quad basketballs sized cum tanks is not lost on you. Yet, the effects of hir bound more than outweigh any meager concerns you many have over gradually change in demeanor as hir growing closeness to the Ocean Mother has aided the Naxokaazthur tireless hunts for fresh fodder to feed the masses.";
	else if level of Arlene is 2;
		say "     As the temples expands so to has it priestess, fortified by Tiamat's unending love, Arlene has grown to commendable height of roughly ";
		if "Touched by Madness" is listed in feats of Player:
			say "two and half meters."; 
		else:
 			say "eight and half feet tall.";
		say "Still slightly shorter than your imperial draconic majesty, your priestess now towers over your flocks, forcing the tiny humans to crane their necks just to catch a glimpse of hir androgynous angular muzzle or meet hir selachian gaze much less see the burnished sea gold amulet inlaid ruby fashioned in the image of a Sea Tyrant's eye. Hir attire too has been modified to better accommodate hir stature, though its core design remains unchanged, the silky fabric neatly complements hir motherly curves. Though a few allowances have been made to accommodate hir voluptuous G-cups, the simple, yet elegant robes are just as fetching as the day you first laid eyes on them. You muse, as your many abyssal eyes drift along the softening curves of the former pirate taking in the adorable sight of hir well-padded ass that would look more at home on a sedentary broodmother than a cunning corsair. Still, the heavenly sight of hir plush heart shaped tush swaddled in hir latest fineries is rather fetching and altogether fitting addition to your chosen priestess's burgeoning form. All hir time tending to the needs of your flock have caused hir lovely thighs to lose much of their definition, though you would by no means view hir as out of shape. Hir curvacious, bestial, digitgrade legs seem perfectly at home on hir enhanced body and only add to hir growing splendor.";
		say "     You muse, as your molten gaze drifts back up along the heady out of hir meaty basketball size spunk tanks as you drink in the sight of impressive virility on full display. Then back to the tender spectacle of hir girthy tail swaying behind hir, though as your many eyes roam the sleek contours of hir finned appendages, you can't help but notice a number of small magenta streaks eerily reminiscent of your own chromatophores lining the border of hir grey and white tail. Perhaps, you muse, as hir affinity with your spawn and patron deepens, hir body is becoming more draconic in nature, or your own potent nanites are having an effect on Arlene. Regardless, they are a rather fetching addition to your chosen mouthpiece not to mention a suitable reminder of your growing ownership of the buxom beauty.";
		if Libido of Arlene is 0:
			say "      You think to yourself, observing the unsubtle blush of Arlene's cock slit as they doting herm seem to bask the molten glow of your many eyes bathing hir form in your radiance. While hir web fingers shamelessly drift to plush not-so-little bulge of hir juicy dick slits as shi playfully [']pinches['] hir flush sex between hir the silky webbing of hir left paw and give hir package a purposeful squeeze. Eliciting a light trickle of salty selachian pre from hir lush sex as shi cheekily snakes hir naturally lubed tail under the toasty folds of hir heavy quad-balls, as shi gently jostles hir ponderous package as if in offering. Smirking at the sight and lush memories of hir delectable flavor, you can't say you don't appreciate the show, or enthusiasm perhaps you should take the kinky priestess on hir offer....";
		else if Libdo of Arlene  >= 1 and Libido of Arlene <= 12:
			say "     You ruminate, allowing your gaze to lovingly glide over hir tight, compact baby bump as take in the sensual sight of your latest clutch. Thanks hir impressive stature, your priestess looks all the more at ease with hir condition, gone is the adorable awkwardness of the brood mother in training you once knew. Now, your proud broodmare carries hirself with an air of grace and dignity more than befitting a herm of hir fertile status. To your far traveled eyes, hir every step highlights hir wondrous condition as hir fierce predatory stride sends delectable wobbles through hir taut eye catching blushing tum and flush milk laden breasts. Even in the early stages of latest pregnancy, hir bust has grown all the more perkier as hir cushy orbs lovingly laze atop hir maternal mound and dominate much of hir vision. Not that your chosen minds, as the added padding enhances hir motherly splendor while serving as a potent reminder to your flock of the enjoys gravidity.";
			say "    Even now, your enhanced ears can hear the subtle slosh and tender groan of hir swelling sweater puppies with Arlene's every breath. Perhaps feeling your approving abyssal gaze passing over hir plush assets, the bawdy herm fixes you with knowing grin as shi hugs hir chiseled arms about the edges of hir bust and hugs them into a cute faux-heart shape while easing hirself into your lustful stare. Shi casually gropes vast paws full of plush maternal flesh, eyes alight with maternal pride as hir cream flush tits slips through the cracks in hir paws. While you watch with a mirthful grin as a light trickle of cream leaks for Alrene's lush ducts then down hir arms as the pearly bead of creamy delight glides down the toned hills and valleys of muscle limbs while coyly jostles hir ponderous mounds before you. All the while, your stomach rumbles at the thought of sampling such delectable fare, or indulging yourself on the lewd herms supple body.";
		else if Libido of Arlene > 12;
			say "   Though such splendid additions pale to the lurid beauty of hir burgeoning baby bump, you muse as you bask in the gravid majesty of heft herm's maternal figure. As even with hir impressive stature, hir soft adipose laden tummy easily obscures hir thunderous thighs and pendulous balls behind a ripe glistening dome of motherly opulence. Despite the constant care and attention of hir chosen handmaiden's generous attention, hir alabaster tummy is replete with thick rosy stretchmarks and plush hem line decorating hir pronounced outie. Though hir supple love handles no longer decadently hang over the side of hir breedable flanks, the deep groove encircling hir doughy middle remain undiminished while providing your favored broodmare a lovely arm rest. Hir tits too have put on more than a little extra weight as they edge closer to resplendent H-cups that lovingly wallow atop hir turgid tum. Beyond engorged, hir pink nips and areola are pulled tight across hir milk flushed glands as appear to ripen by the second, and at times you can almost hear hir hide creak mid breath as hir glowing body readies itself to feed your ravenous flight."; 
			say "     Much to the growing elation of Arlene, and the cult's, for as hir belly swells with regal tallow and countless eggs, so too does hir connection to the goddess's power, and your control over hir. Hir communion too have become massive events encompassing much of the cult's time as they fawn over hir gravid figure or hand feed hir delectable morsel of exotic sea food and rare juices. While many the mothers-to-be dote upon hir verdant curves or taut tummy in the constant hope that some of the goddess's blessing will be imparted upon their own brood. Another time, you might have chaffed at the praise heaped upon Arlene, yet you can't deny the usefulness of hir potent connection to the goddess and Kai Monah as with but a thought you priestess can alter the current bring untold resource to the island's shores from the ocean's depths.";
	else if level of Arlene is 3;
		say "     Following hir latest evolution, your abyssal priestess's regal body now supports a wriggling set cephalopoda tendrils, dripping in natural lubricants growing for hir back. Markedly larger then shi is tall, hir new limbs are an impressive sight and potent symbol of hir office as speaker of the Ocean Mother's cult. Naturally, hir silken ebony robe laced with lustrous gold accents have undergone a few clever modifications to accommodate not just hir new limbs, but hir ever more voluptuous figure. Gazing upon hir soft curvaceous hips, thicc doughy thighs, alongside hir pillowy forearms decorate hir fertile frame, you soon spy a number of thin magenta stripes evocative of your own chromatophores coil about the edges of hir leg and neck. A part of you can hardly believe the living fertility idol standing before you was once the tiny captain you found upon that supply ship all the many days ago. Nor would Arlene, you imagine, as hir time spent in communion with the goddess and the constant pampering of the cult has worn away much of hir bellicose demeanor, though hir greed remains intact. As shi has taken to adorn hir fingers and paws in all manner of glitter golden rings inlaid with priceless pearls or rare stone. Hir girthy tail finned even host a expansive of array of lacy gems bound by a thin band of supple black leather that shimmers in the torchlight.";
		if Libido of Arlene is 0:
			say "    Meanwhile, hir once respectable chest has blossomed to a set of generous G-cups while hir perky teats have been pierced with a tasteful set of platinum nipple chains inlaid with meteoric emeralds. Though large by [']normal['] standards, hir heavenly tits look at home on your towering chosen's lush body. Nestled neatly between the ripe glistening hills of hir sweater puppies, is a brilliant golden ruby amulet inlaid with polished onyx fashioned in the shape of Cruel Sea Tyrant's eye. Letting your gaze drift further south, your imperial eyes are greeted by the adorable swell of plush muffin top, though sadly vacant at the moment, hir tummy has put on more than a little padding in recent days. As hir once tone midriff is graced with a rich layer of spherical motherly adipose that marks hir status as a proud broodmother, but also serves as delectable little grips for your paws when claiming hir. Even hir hybrid sex has put on more than a few fingers of fertile flesh as hir puffy slits bugles with soft welcoming tallow ringing hir cunt and cocks cave. Hir quad balls have gained more than a touch of lurid heft, you muse observing the tender impressions of lewd hir orbs as they laze comfortably against hir digitigrade legs.";
		else if Libdo of Arlene  >= 1 and Libido of Arlene <= 12:
			say "      Similarly, hir milky GG-cup chest is graced with an artful set of  pierced with a tasteful set of platinum nipple chain inlaid with meteoric emeralds while a brilliant golden ruby amulet fashioned in the shape of Cruel Sea Tyrant's eye shelters between the verdant hill of hir motherly mounds. Flush with untold liters of fresh cream, hir stately tits almost creak and slosh with hir every breath as they ripen in preparation for the arrival of your lasted clutch while they rest atop the growing swell of hir plump alabaster tumby. Heavy and low, hir doughy womb looks well at home on hir burgeoning glowing body as a sensual hem of midriff rifles along the lips of cock cave. Despite the respectable size of your clutch, your experienced brood mother wears hir weight well and even seems to exalt in your spawn's presence. As hir every motion and gesture naturally draws the eye to hir assets, even the most reluctant of novices are often spellbound by hir gravid grace as shi sashays through the hall extolling the wonders of motherhood to the masses.";  
			say "     Sensing your eyes upon hir gloriously padded womb, your proud broodmare lovingly coils hir tendrils about the supple silky hem of hir tummy and ponderous cum tanks. Worshipfully pampering hir divine tummy and plush heavy balls in coils as shi leans forward and offers hirself for inspection. Flashing the naughty breeder a toothy dragonic grin, you reach out and gently rub your dominant palm along the glossy, toasty swell of hir tumby. Delighting your sense upon the heady contrast of hir motherly pudge playing across your pad as your paws sink ever-so-slightly into hir welcoming adipose and the exotic coarseness of hide gracing your pads. While the buxom, eager to please broodmare pants and whinse with unvarnished need as your claws glide along hir well-lubed curves of hir supple body.";
			else if Libido of Arlene > 12;
			say "    Of course, such petty baubles pale in comparison to hir (almost) peerless H-cups, you muse as your many molten eyes are drawn to prodigious milk tanks. Laden with a boundless ocean of rich cream along hir adorable baby fat, hir breasts dominate much of hir field of view. Leaving you to doubt if shi can even see anything beyond the platinum nipple chain inlaid with meteoric emeralds affixed to hir drum taut nips, much less the brilliant golden ruby amulet fashioned in the shape of Cruel Sea Tyrant's eye balanced atop shimmering sweater puppies. For all their size, to your well-traveled eyes, hir profound glands look well at home preached atop the divine swell of hir bouncy baby belly. Swaddled in toasty tallow, and rounded by the imperial shape of your eggs, hir tumby easily obscures your plaything's lower half behind a wall of glowing maternal excess while elbow deep love handles wobble enticingly about hir hips. Despite the tireless efforts of hir doting thrall's affectionate care, Arlene's gleaming pearly white tummy is coated in sordid tapestry of ruby tiger stripes sprawling out from hir prominent outie like the arms of some distant spiral arm galaxy.";
			say "     Not that shi seems to mind, as the brood focused priestess wears these with pride and seems to openly revel in hir growing softness and beautiful changes. As hir blissful condition progresses, shi's is often carried by several Seradovah through the hall upon a lavish palanquine so all may bask at in the glory of your coming spawn, or offer their thanks to your future saviors. Arlene's communions too have taken on a more hedonistic overtone as shi's begun to abandon all sense of decorum in favor of raw carnal passion. A change your followers have gleefully embraced as they playful jockey amongst themselves for the opportunity to pamper your brood or dote upon hir lavish curves while the Seradovah attend them their more... carnal needs. The results though are more than worthwhile as your fertile cultist's frames continue to swell with coldblooded life and indubitable purpose. Meanwhile stories of the cult's grandeur are being leaked into city, luring evermore humans out hiding as they risk all for a chance to partake of these salubrious pleasures, or behold the riches of the deep brought by hir new found connection with goddess and her archangel.";
	else if level of Arlene is 4;
		say "     Though subtle, Arlene's latest blessing is a welcome one, not just for the cult, even if shi hasn't changed much outwardly. Even now, you know hir new wombs and perpetually milky tits will serve the cult not just breeding new members of your flight but feeding the hungry masses. In recognition, your cultist's have crafted for her a primal yet elegant staff to aid hir in those rare moments shi chooses to waddle among rather than be born aloft upon hir palanquin. Forged from reclaimed awesome tree wood dyed a deep slate black, the staff smooth cylindrical base stands roughly as tall as Arlene hirself. A simple tan leather grip emblazoned with a simple geometric pattern evocative of the moon and waves is affixed to its core. While its head is capped with raw sea polish aquamarine worn into a rough crescent, and the odd amethyst hued inclusions can be seen coiling about the gemstones edges. A number of pieces polished sun bleach bone, Sea Tyrant scales, and talons donated by your flight dangle from it upon braided lengths of black silk.";
		if Libido of Arlene is 0:
			say "     As for your Priestess hirself, hir bountiful H-cup bust has entered a state of perpetual engorgement that no amount of milking, or suckling could ever hope to alleviate. Not that you, or your beloved milk shark would have it any other way, kept perpetually perky and taut by the boundless gallons of fatty cream, hir opulent alabaster breast flesh gleams in the torch light as thick beads of pearly perfection stream down from hir puffy nips and the soft swell of hir vacant tummy. Utterly shameless, your loyal mate takes great pride at the sight of hir excess and openly invites all to partake of hir when shi makes hir rounds extolling others to join hir in the path of broodmotherdom. Those who heed hir noble words are reward with boundless renewed vigor and lurid milky perfection. Though you, yourself reap the greatest benefits as hir but a sip of beatific cream is enough to reinforce your draconic nature and restore much of your vitality. Of course, you muse allowing your abyssal gaze to leisurely trace the voluptuous curve of hir tender doughy tum, then down to the pleasantly puffy swell of hir cock cave and plush padded balls that oh-so elegantly conceals hir dual cunt behind their warm, perpetually lubed majesty. Some part of you can't wait to taste hir motherly milk and experience the epicurial bliss of hir offering to your own growing divinity. ";
			say "     A sentiment, your mate no doubt shares, as a bright ruby blush flicker around the edges of hir dick slit as shi openly rub hir plush maternal thighs against one another. While shi fans hir girthy jewel encrusted finned tail behind hir, filling the room with the sweet coiling scents of hir hybrid heat wafting from welcoming plump cunts. All the while, each potent bat of hir tail and needy flex of hir doughy, receptive body, sending cute little ripple through hir adorable Rubenesque figure. Arlene casually arches hir back with a needy whimper as shi leans into your inquisitive look while shi awaits your latest commend, or latest clutch of eggs. Perhaps, you could take hir up on this lovely offer, though nothing says you can't enjoy the view of lush fertile body for a just a moment longer.";
		else if Libdo of Arlene >= 1 and Libido of Arlene <= 12:
			say "     As your milky priestesses, reclines before upon a bed of crimson pillows, hir succulent H-cup tits have begun to reach new heights of not just production, but capacity from which no amount of tender milking, or reverent breastfeeding could ever relieve. From the blissful look of your hedonistic cow's face alongside hir chosen handmaiden and hungry supplicant demeanor as they fawn over gravid splendor, none would wish this to change. Blessedly engorged with motherly milk and bejeweled with a set of platinum nipple chain inlaid with meteoric emeralds while a brilliant golden ruby amulet fashioned in the shape of Cruel Sea Tyrant's eye shelters between the verdant hills of hir taut sweater puppies. Hir H-cup breast looks well at home balanced atop hir ";
			if loyalty of Arlene is 2:
			say "thoroughly seeded wombs. Even now in the early stage of pregnancy, hir soft plush tummy spills past hir voluptuous upper thighs, putting many of hir previous litters to shame as the sheer weight of your beastly spawn hir almost left the happy herm bedridden. Not that your brood focused priestess or hir loving coterie of handmaidens and supplicant would dare allow hir to sully hirself with any manner of manual labor.";
			say "    Totally devoted to your brood and their host's care, their every moment waking is spent pampering the voluptuous breeder curves as whole teams of equally gravid and portly humans attend to their every want or need. As they worshipfully massage hir thick paw pads, manicure hir talons, or diligently collect the endless stream of divine cream flowing from hir nips. While others bathe hir the deep growing folds decorating hir tummy in generous sheen of sweet smelling oils so hir coarse, pebbly white and grey hide shines with a mirror-like finish. Meanwhile teams of Seradovah lead by trusted handlers, their arms laden with all manner of delectable food and juices, mill around hir opulent body ready at moments notice to slake whatever craving your ravenous spawn communicates to your flush mate. Which often proves to be no easy task, are your insatiable priestess and hir progeny's appetite are as bottomless as hir lust, as the bountiful weight of hir brood putting pressure on the right places and the constant attention of hir attendants has left hir in a state of faux-heat.";
			say "     One no amount of idly masterbasion could ever hope to quench, you muse, as the brood mad priestess's infectious needy scent wafts about the room with ever increasing intensity as shi bask in the golden radiance of your molten. You watch as the lewd herm spreads hir thunderous thighs, allowing hir basketball sized package to loudly plop between hir legs. While she lovingly wrap hir arms about hir swollen tum, purring happily to hirself as hir webbed fingers sink into the padding decorating hir glowing bump as she gently hefts hir lush tummy out of the way of hir blushing vents. Then motions you forward with an inviting come hither bat of selachian tail while shi needily clench hir supple, glossy paw pads before you as hir soft adipose laden body ripples delectably with the effort.";
			else if loyalty of Arlene is 1:
				say "hir partially seed wombs. Though hir burgeoning bump is nowhere near its true resplendent majesty, your followers and your priestess's devoted care to your little ones is still commendable. As, plush teams of diligent gravid feeders and their Seradovah helpers worshipful tend to your Arlene's even need as massage hir paws or hand feed hir any manner of vittles your brood demands.";
				say "     Much to the joy of your proud broodmother, as shi seems to take no small amount of pride in dual roles of priestess and mother of your spawn, you muse watching hir order hir loving humans about while shi wallows in hir blissful condition. Beyond diligent, hir chosen are eager to serve hir gluttonous will as they tirelessly take down hir latest order, or lavish fresh praise upon the slumbering form of your brood growing within hir. All of which shi drinks in with manic glees as hir paws the tightening curves of supple lap filling belly and plush thighs almost if in open inviting to hir virile master to indulge themselves upon hir. Smirking at thought, you watch as hir webbed fingers sink into the generous fold of hir growing tumby as shi pampers well-lubed curves. You find it hard to resist the simmering need building along your flanks as your golden eyes wander hir soft voluptuous figure drinking in the adorable sight of hir pillowly love handles coiling about hir waist. Then down the length of hir dough digitigrade legs, coddled in a thick layer of supple tallow, you can just barely about out the flush folds of hir toasty cock cave,. As the pendulous swell of hirbasketball sized cum dominate much of hir lap, you muse as your grazes drifts to hir cute manicured talons and meaty paws, as the gravid shark fixes with a smoldering look and beckons you forward with a wave of hir bejeweled selachian tail.";
		else if Libido of Arlene >=12:
			say "     As your bed bound milk shark happily lazes atop of hir expansive crimson pillow nest, hir humongous perpetual productive K-cups are constantly attended by an endless swarm of doting human supplicant as they dutifully collect the boundless streaks of creamy perfection streaming from hir perky milk tank in thick brown ceramic urns. Beyond nutritious, Arlene's mother's milk has become a staple of not just of the cult's diet, but a potent source of healing and revitalization for the masses. All to your priestess's delight as the pampered broodmare, takes no small amount of pride in providing for your flock, and lewd joy at the attention paid to hir taut alabaster melons as the little human lovingly knead or massage hir potent glands. Offhandedly, you notice a few temporary links have been added to hir platinum nipple chain to better accommodate the heavenly swell of massive mounds and widening part of hir puffy pink nips. Meanwhile, hir necklace has almost been completely engulfed in the pillow folds of hir bust as the thin golden chain slinking around Arlene's gilled neck giving any hint shi might still be wearing it.";
			if loyalty of Arlene is 2:
				say "     Hir tummy too continues to ripen by the hour as the lustrous swell of hir alabaster bump framed by muted grey, is laden with vibrant spiraling galaxy of thicc ruby stretch marks engulfs much of hir toasty lush lap devouring belly. Blessedly swollen with your eggs, Hir heaving tumby not only serves as the perfect rest for swollen tits, you muse, delight at the lewd impression of breast wallowing atop hir pudgy womb, but a constant reminder of the hir glorious fertile purpose. One the cultist take great pride in assisting hir in as whole teams of buxom gravid human, bearing golden vessels filled the brim with clear sweet smelling fawn over hir groans curves as massage and pamper hir ponderously rows of man swallowing love handles and lush outie navel. All the while, whispering loving words, or earnest praise to the priestess and your ravenous slumbering spawn as they encourage the growth of both. Other affectionate cultist minster to your chosen's doughy digitigrade legs and tender paws, diligently rubbing the beautiful chubby contours of hir bestial once muscular legs in open admiration of fertile proportions. Which proves to be no minor feat as tender folds hir Rubenesque thighs could easily dwarf some of your shorter supplicants, you muse with small amounts of satisfaction as Arlene's servants palm sink into the inch deep tallow swaddling hir pleasing plump thighs, or briefly vanish beneath the mountainous fold of glowing tum.";
				say "     Though the voluptuous herm rarely walks anymore, scores  of your followers still attend to Arlene's paws and gleaming toe talons, as they massage hir adorable gleaming or work to maintain the peerless shine of hir manicured nails. At times, a few of the overeager pawsluts, occasionally pause in their task to plant a few sneaky worshipful kisses upon hir glossy ebony toe beans. Meanwhile on the outskirts of hir chambers, crew of well-train gravid human handlers and their Seradovah assistants, their arm laden with platter of exotic meats and jugs of vibrant juice parade about Arlene's gravid majesty as they cater to the mercurial craving of their mistress and your brood as hand feed hir any delectable treat shi demands. Ever eager to provide for your young and your cult's eternal craving for hir cream, your mate devours these proffered vittles with a lewd, proud grin while hir plush pillowy arms roam the supple curve of rumbling midriff as if to encourage hir hardworking body to keep pace with the demands placed upon it.";
				WaitLineBreak;
				say  "    Or more likely, to wallow in hir the blissful state of hir latest pregnancy, you muse, observing the manic glint in hir eyes as shi proudly gropes lush pawfuls of titanic tit and tum in hir mitts. At times hir paws drift further south as shi sensuously caresses the countless beautiful of your eggs peeking through the vast ring tender tallow swaddling hir silky body in a protective blanket of maternal excess. For all hir gluttonous antics, your dear priestess's power has never been stronger as hir connection to Tiamat Kai Monah is nearing it zenith, through them (and your eggs) all the mysteries of the waves and secrets of the shore are slowly being revealed to hir. Even now word of golden treasures once thought lost to the depths and the locations of new followers resound through the which each of hir communion. The cultists too have noticed their draconic pregnancy quicken or busts swell during these tawdry events as if Arlene's condition has become infectious. Another time, you might have such developments worrying, yet such blessing only serve to deepen the resolve of the faith in their holy to build your army in time for the goddesses coming."; 
				WaitLineBreak;
				say "     Besides, you can't say you're not enjoying the sight of so many bouncy buxom breeders strutting through the temple's halls while they parade their ripening bodies before you, you think to yourself, as your tauric sex thrum with excitement as a moist trick of balmy dew snakes it way down your [bodydesc of player] hindlegs. You notice Arlene's lust fogged eyes turn toward you, hir angular muzzle twitching with a raw delight as shi shameless huffs your draconic scent coiling through the room. As shi casually beckons you forward with an inviting wave of hir gem encrusted tail, fixing hir with a lewd grin, you find it hard to say no to hir enticing offer especially now that shi's in such a wondrously needy state. Besides, a part of you is already looking forward to sinking your talons into hir voluptuous figure once more.";
			else if Loyalty of Arlene is 1:
				say "     Arlene's sumptuous tummy continues to ripen with the lovely weight of your latest litter, albeit at only a fraction of hir enchanting body's true potential. Nevertheless the sight of glowing alabaster tallow tum, covered in a cute rosy sheen of thicc stretch marks spire outwards from hir prominent outie lazing upon hir pillow nest rarely fails to inspire the faithful. Far wider than most humans are tall, hir supple belly and temporary home of your massive eggs is swaddled in decadent inches of motherly adipose alongside a deep set of hand swallowing love handles curling over hir massive hips and shrouding padded ball bag behind a supple wall of fertile flesh. While the heavenly sight of hir rich I-cups wobbling atop pudgy tumby always brings a smile to your muzzle, you muse, observing the succulent impress of hir milk tank cast upon hir resplendent hide and the click of platinum nipple chain accompanying hir every breath. A sentiment shared by your cultist as the impossibly rich cream trickling from the gravid milk shark's swollen sweater puppies has become a staple of your follower's diet. Whole teams of eager milk maids bearing large ceramic jug swarm about hir flush fecund tit flesh as they worshipfully knead hir perky pierced nips as they offer loving thanks to the two of you for providing them with such priceless bounty.";
				say "    Others bearing silver vessel laden with sweet smelling oils attend to hir doughy arms, or lacquer hir nails, watching them go though, a part of finds it hard to believe this fluffy limbs once belonged to a trim bellicose corsair. Yet more of your gravid followers fawn equally ponderous legs as they massage the deepening folds of hir thunderous thighs with earnest zeal, or polish hir glossy toe bead and talons. All the while purring doting praise to the partially seed mother of your divine flight and your slumbering wrymlings. Amidst all this loving activity, Arlene confers with hir chosen handmaidens while shi manages the day-to-day affairs of the cult with surprising efficiency, though hir tendrils still roam the tender curves of hir affectionate follower as they pamper hir glowing body. For all hir apparent softness, your priestess's power over the waves continues to grow as Tiamat and Kai Monah gifts steadily reveal more of the world's hidden wealth and location of possible supplicants to hir. The majesty of Arlene's communion too has only increased as your flock often finds their draconic pregnancies quicken and tits ripening as each ritual molds your followers one step closer into the perfect vessels for your spawn.";
				WaitLineBreak;
				say "     A reality you've come to enjoy as halls are now packed with curvy seasoned broodmares, their tummy packed with eggs and tits groaning with cream. Alongside doe-eyed novices desperate to experience the fathomless joy only you and your spawn can provide them. And one day soon, you'll finally be able to share this gift with the world, but numbers must and priestess's must continue to grow in preparation for the goddess's coming, and your ascension. Yet for the moment, you should continue to aid your priestess in hir holy duties by bequeathing hir with another clutch of your spawn, or indulge yourself upon hir many wondrous assets. You muse as your tauric body tenses with lewd anticipation of feeling hir supple body beneath you once more, or sampling a delectable helping of hir fatty milk and salty seed.";
		else if level of Arlene is 5;
			say "     Thanks in no small part to efforts, and Arlene's devotion to the cause, the fecund hybrid has achieved a form truly fitting of a priestess and consummate broodmother to your dragon flight. Little of the athletic pirate captain's former muscular physique remains, the lingering fragments that do are lost behind feet of succulent tallow befitting a pampered broodqueen like hirself. Not that shi regrets hir changes in the slightest as the voluptuous and impossibly greedy demi-dragoness often openly revels in hir hard earned beauty as shi wallows a top pile of gold and priceless gemstones dredged from the deep. Hir angular selachian muzzles host a proud pair of pointed ivory swept back horns, capped by bands of burnish sea gold inlaid with cyan moonstone. Arlene's robes have further expanded to accommodate hir portly curves and massive set of octopus tentacles. While hir necklace alongside hir platinum nipple chain too have had a few links and loops add to them account for hir frequent pregnancies.";
			if Libido of Arlene is 0:
				say "     Though you have to admit the puny piece of jewelry has begun to look a touch too small on the horny half-dragon's rubenesque figure, they nevertheless serve as potent reminders of hir growth in their own way. As hir turgid perpetually milk I-cup almost seem to swallow the minuscule chain and amulet in their lurid perky weight. More than pleased with hir fantastic assets, the dutiful cow and hir hordes of attendants can hardly keep their paws off hir enhanced bust as tey pamper and stimulate hir body with constant massage or playful gropes plush tit flesh as hir divine cream is always in high demand. Bereft of eggs, Arlene's milk lacks much of its heavenly properties, yet this doesn't stop your priestess from enjoying the attention paid hir pillowy tits, or diminish your cultist's appetite. Hir arms have grown all the larger too, coated in abyssal adipose, they giggle enticingly with but the slightest movement. No longer suited for manual labor of any kind, hir plush forearms are still perfect for holding your young as they drink in Tiamat's wisdom with their first meals. ";
				WaitLineBreak;
				say "    Letting your eye's waltz about Arlene's doughy alabaster pot belly and deep sexy navel, its hard not to notice the adorable overhang and subtle bounce of lush oceanic middle that accominies hir every motion. To the untrained eye, shi might appear in the early stages of another glorious pregnancy, yet as shi lovingly fondles the grey and white borders of hir belly, it's hard not to notice the way hir webbed fingers sink into the pillowy swell of hir verdant as shi absentmindedly pampers the source of power and symbol of hir office as shi await your lasted brood. Meanwhile, the chromatophoric markings once confined to extremities to hir cushy love handles have finally spread to hir flanks and the rims of limbs, with but a thought shi can alter their color or morph their pattern, though shi often prefer to keep the stunning shade of royal metallic magenta. Hir digitigrade legs have regained measure of their shapely quality with hir latest transformation as the barest hint toned powerful muscle can be seen peeking through the divine adipose swaddling hir.";
				say "     Though shi often employs hir staff to aid hir in those rare moment shi chooses to waddle the halls, though you still suspect this is larger for show as hir large webbed draconic paws capped with five scintillating ivory claws bear Arlene's weight with ease. Meanwhile, Arlene's balls have swollen to plush quad medicine balls that even strain against their lush grey house with the slightest provocation. Strangely, hir dual crimson rod remains largely unchanged despite Tiamat blessing, sneaking a quick peek at hir supple vent, you'd wager hir cocks grown to a delectable foot of raw juicy prehensile excess with mouth watering salty flavor to match.";
			else if Libdo of Arlene >= 1 and Libido of Arlene <= 12:
				say "      Still the tiny in comparison pieces of jewelry serves as lovely reminders of Arlene's changes as hir glossy hulking I-cup milk tanks have subsumed in the heavenly curves of pillowy breasts. Swollen with untold gallons of warm fatty cream, hir have blossomed into peerless perky orbs swaddled in welcoming adipose that stretches areola into wide saucers. Hir nips too have more than little pleasing puffiness to them as well, an effect further enhanced by hir current clutch, as hir productive glands constantly drip with rich pearly waterfalls of hir divine mother's milk. Much to the everlasting glee of the cultist as teams of well-organized doting humans joyously fawn over hir fecundity as massage hir potent mound with sweet smelling to aid hir body ceaseless production. While others bearing golden urns kneel beside hir sordid orbs and do their best to collect as much of hir glorious cream as they can before ferry it off to the cult's larders for storage and processing.";
				say "     Some of the braver, or perhaps gluttonous mortals still try to sneak a few cheeky laps of errant milk from the supple borders of hir breasts, lest hir cream go to waste. Judging from the contented sigh of your well-bred mate, as the eager milkslut lap at hir tits or girthy tum, shi more than appreciates the service. As the formerly lithe and muscular herm's pregnancy advances, Arlene's arms have continued to swell with supple motherly padding as your many spawn's ravenous demands exact their lovely toll on once trim form. For all hir gains though, the motherly shark-dragon voluptuous build still makes for perfect [']bedding['] for the newest members of your flight as they drink their first meals. ";
				if Loyalty of Arlene is 2:
					say "Hir belly too has grown to truly divine proportions as even in these early stages of hir dual pregnancies, hir lovely tallow laden tummy serves as a magnificent altar for hir sumptuous tits. As hir blessedly ripe bump is almost as large as shi is, aided by your countless eggs bottomless appetite and the worshipful care of hir feeders it won't long till the gluttonous breeder is more tummy than mummy. Though going from the occasionally blissful smile on Arlene's muzzle as shi proudly pampers hir the taut hem of belly, or gleefully fondles hir deep blushing navel with hir the tendrils, shi is more than looking forward to it. Nor can you say you aren't enticed by thought of delighting yourself once more upon the supple, sensual softness of your mate gravid beauty or groping hir tender folds with your talons.";
					say "    As even hir portly legs and inviting, glistening paws are lovingly wrapped in deep silky pudge that ripples enthralling the torch light with but the slightly, barely even able to waddling in hir preferred state without the aid of hir staff ornate. Arlene's legs somehow impossibly possess the barest modicum of their athletic shape as despite the thunderous state of thighs which is further highlighted by hir large webbed draconic paws. Though shi rarely makes use of them, preferring instead to be born on hir palanquin while she makes rounds extolling the glory of brood motherdom to the masses. Hidden behind the sweltering dome of Arlene's bouncy baby bump and prominent digitigrade legs, hir plush quad ball bad can, at times, be seen peeking out from hir toasty fold, while the dual scent of hir needy hybrid sex mingle the rich floral oils coating hir coarse pebbled. As the constant pressure of your brood lazing atop of hir prostate alongside the endless bliss of hir warm Rubenesque folds rubbing against Arlene's gushing cock cave and double cunts has left hir state of simmering arousal.";
				else if Loyalty of Arlene is 1:
					say "Though nowhere near the imperial height of what hir body can achieve, the sight of your pampered playing supple, silk tummy swelling with your latest clutch never to bring a smile to you muzzle or serves a further motivation for your cultists to follow in hir footsteps. Generously rounded with the lovely impression of eggs and coated in a lovely layer of motherly adipose, hir burgeoning bump would look well at home on some macro well into the later stages of their pregnancy. As hir turgid glowing alabaster tum framed muted grey has gained more than a little bit of pleasing roundness and the constant care of hir diligent feeders along the voracious influence of your slumping spawn, hir blushing cross shaped navel considerably. Rather of proud hir lewd curves, the lustful demi-dragon's tendrils routinely wander the toast swell of hir belly as if to encourage hir growth or to bask in majesty of your youngs presence.";
					WaitLineBreak;
					say "     Despite hir soaring weight and seemingly sedentary build, hir thick draconic paws bear Arlene's flush figure with preternatural ease, though employs hir staff at such times. Though the fecund demi-derg stride has never been more graceful as the days, if not weeks of practice ferrying your spawn has honed balance and poise to a razor's edge. As hir every step and gesture naturally draws the eye to the gentle sway of milk bust or enticing wobble of hir tumby as shi makes hir rounds through the temple, preaching the virtue of brood motherhood and spreading the word of your flight's ascension. Not even you are immune from hir voluptuous charms, as the enthralling sight of hir perpetually lubed hide shimmering in the torch light and hypnotic jiggle of hir plush legs is beyond breathtaking at times. While the sumptuous spectacle of hir doughy quad medicine ball sized cum tanks shamelessly jostling along hir meaty thighs evokes a certain lewd hunger within you. As you find yourself yearning to nurse hir delectable prehensile cocks hidden beneath the cute overhang of hir tummy, or once more hilt yourself in hir plush puffy cunt.";
					say "     No doubt sensing your molten gaze roaming hir expansive resplendent being, the well-fed, and bred hybrid invitingly snake hir bejeweled finned tail out from under hir growing hoard then leisurely fans hir toasty body, filling the room with hir needy scent as if to invent your to partake of bountiful body. Not that you need much encouragement, as wondrous fantasies of hir plush body entwining with your own draconic splendor already play across your mental landscape. Besides, the poor brood hungry herm's body could do with an extra clutch to keep hir company and its such for a noble cause too...";
			else if Libido of Arlene > 12:
				say "     You can't help but be impressed with the workmanship of hir platinum emerald laden nipple chain and ruby dragon's eye necklace as Arlene's prodigious J-cup mounds, swollen with hir untold bounty strains against them delectable with hir every breath. Shimmer with a rich sheen of natural lubricant, hir bountifully engorged with hir sumptuous mother's milk and puffy nips constantly drip with a heavenly sheen of pearly cream. Profoundly priceless, an endless conga line of your followers bearing large golden urns mill about the temple grounds while they wait their chance both to fill them and to pay homage to your chosen. The buxom humans worshipfully crowd about hir perky mammoth tits as they knead and massage your priestesses plush groaning orb with loving alacrity. Their supple fingers shamelessly sink into hir productive fatty while they coax thick streams of cream from hir puffy ducts. Some of your more adventurous followers still pause in their task to sup directly from Arlene's pieced pink nips, or gently lap at any errant that dare defile your gravid mate's tender body.";
				if Loyalty of Arlene is 2:
					say "     Lost in hir own personal paradise, your gluttonous breeder pays them any mind or even seems all that aware of their presence, as hir paws roam the awe inspiring curves of hir ponderous tumby. Far larger than shi is, the horny herm can barely even wrap hir portly arm around the sweltering mass of spawn laden bump as it decadently lazes over hir beastly digitigrade leg like a quivering mountain of fertile excess. Though that doesn't stop the titanic broodmare from gleefully groping vast pawfulls of lube and oil slicked skin as if to bask in hir heavenly proportions. Hir alabaster tumby is almost completely covered in thick sensual ruby red stretches that seem to deepen by the second as hir body struggles to keep pace with not just rapid growth of your spawn, but Arlene's own ravenous appetite. As the glowing grey love handles swaddling hir heaving tum alone could easily swallow a man whole in their plush toasty folds, while hir sensitive robust outie has blossomed to truly ostentatious proportions is not a rather catching eye center piece to hir splendor, but has become a potent symbol of hir boundless affinity for gravidity."; 
					say "     Spurred on by hir example and the hopes that some of Arlene's blessing may rub off on them, your cultist now openly vie for the chance to lay hands upon hir fecund majesty or offer their prayers for salvation to your slumbering brood. Though the most committed breeders are allowed the honor of pampering hir beautiful bump as such, a renewed wave of baby fever is has swept the cult. The rest content themselves with feeding the priestess's boundless appetite or pampering pleasing plump body, as even in hir opulent state, the craving of exotic fare and delicious drink imposed upon hir by your innumerable eggs are more than a little taxing. To their credit, your eager follower and chosen Seradovah servants perform their tasks admirably despite Arlene's voracious appetite as teams of dutiful feeders clamber about hir nest as they try to tempt the insatiable herm with some fine dish or precious juices."; 
					say "    All of which only serves to fuel hir splendid growth as hir upper arms are swaddled in untold inches of supple tallow leading down to a cute taper near hir wrists.  Nevertheless, hir Rubenesque arms are well at home resting against hir pudgy frame, or being pampered by your doting followers as they lovingly massaged the folds decorating hir plush body. Still, they serve a comfortable pillow for your brood as they nurse or Arlene's handmaidens during the rare moments shi sleeps. Despite profoundly hir portly nature, Arlene's connection to the goddess, Kia Monah, and by extension you has never been greater, nor have hir communion been more popular as any silly pretense of decorum or scripture has been thrown to the wayside in favor of raw carnal pleasure and gluttonous satisfaction. Under your priestesses tutelage, alongside the constant influx of the sea nanite laced bounty, your cultists have fully surrendered to their bodies desire for food and sex while they parade their plush gravid bellies, and heaving milky breasts before you in the hopes they might earn your approval. In time, they will all become little more than happy, bubbly incubators swaddled in succulent adipose with no thought beyond their next meal, fling, or servicing your flight's needs.";
				else if Loyalty of Arlene is 1:
					say "     Utterly enthralled by the attention paid to hir own brood flush body, shi lovingly encourages your follower's playful antics as the doting humans gleefully pamper hir toasty middle. Even eager to please, the affectionate mortals are more than happy to oblige hir as they diligently caress and massage the glowing folds of hir mountainous tum ringed by glistening handles. Almost as large shi is, your puny by comparison cultists are dwarfed by the doughy swell of alabaster tummy. Even at half hir body's capacity, the ponderous mass of supple midriff easily obscures much of hir well-padded quad medicine ball size cum tanks and juicy cock slit are visible behind the voluptuous blanket of hand swallowing adipose. Almost drunk with motherly hormones and the blissful presence of your eggs putting pressure on the right places, hir puffy dick slit leaks a light stream of salty pre, while the crimson tip of hir foot long prehensile tool occasionally slips free of its lovely housing. "; 
					say "     Arlene's thick meaty broodmare-esque waist and digitigrade legs capped by hir power draconic paws and five ivory toe talons still retain some of their shapely qualities, though it's impossible to deny the supple beauty of lush material padding coating hir leg in layer of jiggly tallow. Meanwhile, hir plush outie ringed with dense spire of ruby stretch mark too has grown all the more prominent and sensitive a the merest brush of your followers fingers in enough to evoke a cute little pant from the lustful demi-dragon. Totally devoted to their mistress's growth, scores zealous of worshipers fawn over the jiggly home of your titanic spawn as they slather hir tigerstrip kissed womb in a fresh sheen of sweet smelling oils. While other dutifully followers accompanied by teams of handpicked Seradovah feeders, their arms packed with plates of succulent treats alongside massive crystal of exotic juices mill about hir chambers as tirelessly work to satisfy both your mate's craving and your spawn's ravenous appetites."; 
					WaitLineBreak;
					say "     Not that shi needs much encouragement, as Arlene's rising obsession with hir preferred state along with all the power and wealth it brings hir is more than apparent in ways shi proudly gropes hir plush eggy middle with hir chubby paws. Hir draconic eyes alight with manic glee as shi basks in the tender softness protectively swaddling hir bulky body and the heady weight of your spawn as they mold hir into the perfect vessel. Occasionally though, the greedy half-half will scoops vast pawfull of coins and precious gems from hir nest with hir tendrils then drizzles them over fecund curves delighting at the pleasant click of hir hoard cascading over over hir while the rich hues of hir horde reflect in the ambient torch light as they plink off fecund middle. Another time, you might have chastised members of your flock for such displays, yet the crown jewel of your cult's grandeur has earned the right to wallow in riches shi has brought in as the power and connection to you and the goddess only deepening with hir girth and gravidity.";
					say "     Hir communions too have become all the more ostentatious as shi's thrown all senses of dogma or decency to the winds in favor of carnal pursuits and hedonism, not that you can complain about the results. Spurred on by their priestess's example and sheer bounty shi coaxes from the deep with but a word, your cultist have fully embraced their desires and true purpose as incubators for your spawn. Their bodies now swell with rich supple adipose, plush milky tits, and bellies bulge with the weight of your spawn as proudly parade themselves about the halls in an effort to your earn favor and revel in glory of your coming ascension.";]

Instead of conversing the Arlene:
	if HP of Arlene is 0:
		say "     [bold type]BAD PLAYER! You shouldn't be seeing this![roman type]";
	else if HP of Arlene is 1 and cunt count of Player >= 1 and bodyname of Player is "Dragon Breeder" and Player is pure:
		say "     [italic type]Author's note: sections of Arlene's dialogue have been omitted till the next stage of the Cult's development is unlocked to avoid spoilers and confusion.[roman type]";
		Project Figure of Priestess_clothed_icon;
		say "     What do you wish to discuss with your priestess?";
		LineBreak;
		let Scalie_stuff_Choices be a list of text;
		add "Hirself?" to Scalie_stuff_Choices;
		add "Status of Pirate island?" to Scalie_stuff_Choices;
		add "Where is the rest of hir crew?" to Scalie_stuff_Choices;
		add "Just chat?" to Scalie_stuff_Choices;
		let Scalie_stuff_Choice be what the player chooses from Scalie_stuff_Choices;
		if Scalie_stuff_Choice is:
			-- "Hirself?":
				say "     Rightly curious about your hir past, you tactfully inquire how hir life was prior the outbreak, and your meeting on the stricken supply ship. 'Well yar worshipfullness,' shi hums, eyes drifting skywards as shi fidgets beneath your molten gaze, 'dat be a right tough question ta answer. Ya see me memories [']O me self before da troubles be right,' shi pauses, hir tail a twitch with nervous energy,' hazy at times.' No stranger to the mind altering effects of the nanites, you motion for hir to elaborate. '*Cough* so ya see me dragon I'z not sure what'z me, or da crew were in da a old days, or even if we'z was even from dis here berg ta begin with,' shi says, idly gesturing to the city with a soft flick of hir wrist. Really? You ask somewhat perplexed as shi doesn't strike you as either a feral, or some manner of extra dimensional visitor. 'Aya me heart, doe we'z had'z a few [']O dem dare nutter on da account, I'z don't thinks I'z be as far gone as some [']O does loons, but with da Lady's as me witness, I'z not too sure whether I be [']dis place, tar an other, or some pig skin what got changed like da rest,' Arlene says, briefly throwing hir hands up in defeat. But surely shi must remember something of hir past?";
				say "     'Da, I'z getz wee flashes from moon-ta-moon but I'z not sure what be real, or what be a product of dem nanity blighter mess'in wit me mind,' shi sighs dejectedly through a brisk click of hir gleaming fangs. Intrigued, you ask about these flashes of hirs. 'Well,' shi begins eyes drifting towards her desk, 'sometimes I dream [']O me self, or it is me former self,' shi adds, wistfully tapping hir chin, 'sitting at some plain [']ol desk with a screen in front [']O me, and some tiny white keyboard at me finger tips. Try as I'z may, I'z cun never make out what's on it or around me'z, tis like da whole world be made [']O white walls, with a white ceiling, un bathed in white light.' Sounds like a cubical, you rumble offhandly. 'Da mayhaps, doe fir da life of me it could've been an oubliette, fir my thoughts at da time always be of escaping, adventuring, un making me mark. Some-tin be stopping dis [']ere version of me, from leaving dat dare white hell.' Arlene huffs, lips curling into a harsh toothy grimace as shi roughly slams hir tail against the floor with an audible thud.";
				WaitLineBreak;
				say "     'Beyond dat, I'z can'ts tells ya's much whether I'z was a man, woman, short, tall, or any such nonsense, doe I still do be a knowing how the machines [']O dis place works and un some of its history. Ta utter me felt trapped doe, doing the same-tin over un over like some kind [']O right proper nutter. Den,' shi beams, hir expression lightening as shi wistfully peers down at hir [if libido of Arlene is 0]sleek selachian figure [else if libido of Arlene >= 1 and Libido of Arlene < 12]cute curvy bump[else]glorious maternal figure[end if]. 'Dare be time I see me self as I'z am now, da captain [']O some grand crew trawling da deep black [']O some vast zunless sea, pillaging ta waters for all manner of trinkets un baubles for patrons too vast un unknowable to describe. Un doe we was free to live as we chose, we'z was hunted, un hated by all manner a strange folk what called dem starless skies home, un only by da grace [']O da nameless gods of da neath did we survive fir as long as we did.' shi preens, eyes alight with covetous bliss. 'But,' shi adds as hir fins slump ever-so-slighty, 'fir da life of me me heart, I'z can't remember da name [']O any of me crew, nor a single face from da roster, or even da name of our ship.'";
				say "     That must be frustrating, you rumble. 'Aya, un ya know what be da worst be, me dragon?' Arlene asks, with an almost pitiable quiver in voice. What? 'I'z don't know how I'z, or me crew came ta be on da island, un no one on the books remembers joining, tis like,' shi hesitates, fists clenched into tight balls till hir knuckles go a pale ivory, 'we was always on dis [']ere rock. Some of us be thinking dat perhaps we might uv even been born here, or conjured by da dem wee automations what be causing all da trouble. But,' shi whispers, while casting a conspiratorial glance towards the main hall, 'I let ya in on a wee secret me heart. I'z don't rightly care what I was in da [']ol days, cause ya see in all does memories da other me was never happy, un dreamed [']O starting over, or letting go un beginning again.' shi hums, as subtle wisps of many colors and none dance along the edges of hir appreciative gaze. 'So instead [']O whining like some green horn on dare first tour, I'z gonna take dis [']second chance['] to make something of meself. Un with yers un da Lady's blissing maybe dis time I make a right proper life here fir me self, and our wee ones.' Arlene simpers, sweeping hir arm about the temple grounds.";
			-- "Status of Pirate island?":
				say "     'Arg I'z was hoping ya wouldn't ask about dat me heart,' Arlene grumbles, nervously rocking on the balls of hir paws. Cocking a scalie set of eyebrows at hir, you ask why. 'Well,' shi mumbles, nervously eyeing the walls to escape your abyssal gaze, 'ya see yer worshipfulness, doe we'z cleared out most [']O da caves me un me [italic type]former crew[roman type] what'z holed up in, dare still be a right many bolt holes the treacherous blighter can scurry too.' Perturbed, you demand to know why this was allowed, and if they pose a threat to you, or the cult. 'Da it weren't fir a lack [']O trying me dragon, but the lava tubes [']ere be stretching on fir miles un dem dragon boyos un scalie hulks be a might be too big ta swim in after dem.' shi grumbles, through a tired little huff. 'Un even if da could me heart, ta tubes be a maze like no other. Doe,' shi grins with a far-too-toothy smirk, 'we did block off most of da old hollows un sealed the blackguards in. Still, a good many more [']O me kind managed to slip away, and scores more feral folk be trawling the shores even now, so it won't be long till someone starts popping out fresh names fir da books.'";
				say "     Huffing, you rightly ask what's to stop them from coming back then, or assaulting your holdings in the future. 'Mayhaps the blighters might entertain da notion me heart, yet day taint got no one ta rally behind, much less da stomach ta take on our wee ones, AND the Lady's servants yar-har-har!' Arlene crows through a heavy belly laugh. 'Doe,' shi rumbles, 'if in I was you yar worshipfulness, I'd stay out [']O da old lair fir now, as dare be more den a few stragglers and squatters milling about in da depths. Mayhaps one day da lads, tikes, un I will head down dare un clean the place out ounce un for all, but fir now the blackguards presence be keeping ta utter beasties away.' Nodding along, you suppose that will have to do, for now. In the future though, you will not be so forgiving if you priestess withholds information from you, no matter how minor it may seem, you growl, flaring your chromatophores a piercing red. 'Aya your regalness, it won't happen again.' Arlene says, giving you a modest bow.";
			-- "Where is the rest of hir crew?":
				say "     'Ah Teuta and Jacquotte? Does two be handling the nitty gritty of getting us supplies un fresh blood, doubt you'll be seeing dem much fir da Seradovah un our wee pig skins got quite da appetite. Course,' shi shrugs, sending a light wobble through hir pillow chest, 'ya can't blame dem, it be hard work mining away down [']ere, un dat is ta say no'thun of carting all da rubble out da moon pool be keeping [']ol Teuta right busy. Un top [']O bring in fresh tools and materials fir da cause.' Fair, you rumble, but what of your other priestess. 'Jacquotte?' Arlene asks, with soft click of hir talons along hir slate floor. You nod. 'Ah, she be handling the recruitment drives on da mainland, not too many pig skins left D's days so sniffing dem be almost as hard as convincing them do ta come. Doe as fortune be having it, da lassy be having a way with word, un da wee ones presence can be a right good help too,' your head priestess smirks.";
				say "     How so? 'Well even dem cantankerous wyverns be giving our lovely sea devils a wide berth, doe,' shi chuffs, 'every couple of moons one [']O da simpler ones takes umbrage at dem, doe day taint nothing compared to our spawn me heart!' Arlene preens, puffing out hir chest as hir paws drift to [if libido of Arlene is 0]the toned hills and hale vallies of hir athletic core[else if libido of Arlene >= 1 and Libido of Arlene < 12]gentle swell of hir hir burgeoning baby bump as hir thoughtlessly pats hir glistening belly[else]tender curves of hir supple eggy tumby as shi traces hir plush navel with obvious delight[end if]. 'As ye can guess, da sight [']O da wee ones flogging da louts be a most...' shi pauses to idly inspect hir attire, 'compelling argument ta join up with us.' Chuckling, you tell hir that you imagine so, though you can't help but express some measure of disappointment in their absence. 'Da, I who knows how ya feel me heart, I miss me loyal mates, doe mayhaps in da moons ta come you might catch dem between trips.' Arlene sighs, as hir head fin seem to sag just a hair.";
				WaitLineBreak;
				say "     Rapping your talon along the floor, you propose that you could simply order them to return for a while instead. 'Aya, ya could me dragon and da lasses would most certainly obliged but with things being as tight as day are around here welll.  ,' your priestess sighs with a pleading look on hir face. Right, belay that for the moment then, in the future though, you hope to hear from them in person, after all, much as you'd like to trust your priestess's word. You rumble, fanning your wings in mild aggravation. You still would prefer to hear from your followers directly when time and circumstances allow. 'Aya me lovely, I'z pass the word along to da girls when'z next day comes ashore,' Arlene says flashing you the two dragon symbol used by your flock.";
			-- "Just chat?":
				say "     '[one of]Oh what do ya do with a Drunken Feral? What do ya do with Drunken Feral early in da the morning? Feed dem to da Slut rats for dinner. Feed dem to da Sluts rats for dinner. Oh way, hey, and up shi rises early in da morning. Shove em up yar cock then cum them over! Shove em up yar cock then cum them over! Oh way, hey, and up shi rises early in da morning,' Arlene hums to hirself[or]Ya know me dragon a few [']O da lasses was thinking of gathering fir whiskey and cigars later, perhaps yar worshipfulness would ta join?' your priestess asks, hopefully[or]Ah ha da cum runs cold, we take our poon and never grow old. Ah ha da lady's code, un hail da mighty rising from da deep! With an incredible tail born from da endless seas!' Arlene sings quietly hir under breath[or]Yar I tell ye now, I tell ya now da Dragon Breeder cums,' your plaything chirps[at random].";
	else:
		say "     [bold type]Warning: this area is built around your character having a full Dragon Breeder body and a pussy, no content will ever be available or accessible without it.[roman type]";

[Arlene milking is an action applying to nothing.

Understand "Milk Arlene" as Arlenemilking.

Check Arlenemilking:
	if Arlene is not visible, say "Who?" instead;

carry out Arlenemilking:
	if Level of Arlene < 4:
		say "     Error, you should not be seeing this!";
	else if lastArlenemilked - turns < 6:
		say "     WIP.";
		stop the action;
	else if HP of Arlene >= 4:
		say "     WIP.";
		ItemGain Dragon Breeder milk by 3;
		now lastArlenemilked is turns;]

an everyturn rule:
	if Libido of Arlene >= 1 and Libido of Arlene < 29:
		increase Libido of Arlene by 1;
	else if Libido of Arlene is 29:
		increase Hunger of Arlene by a random number from 2 to 5;
		now Libido of Arlene is 0;

the fuckscene of Arlene is "[sexwithArlene]".

to say sexwithArlene:
	if bodyname of Player is "Dragon Breeder" and Player is pure:
		say "     In the mood for another round of fun with your lovely priestess, you decide to...";
		LineBreak;
		let Draconic_Delights_Choices be a list of text;
		if cock count of Player is 0 and player is impreg_now and Libido of Arlene >= 12 and "Flat Chested" is not listed in feats of Player:
			add "Have some hyper preg sex?" to Draconic_Delights_Choices; [note to Prome: I really need a better name for this]
		if Cunt Count of Player >= 1:
			add "Blow hir?" to Draconic_Delights_Choices;
		if Cunt Count of Player >= 1:
			add "Sit on hir face?" to Draconic_Delights_Choices;
		if Cunt Count of Player >= 1:
			add "Get Bred?" to Draconic_Delights_Choices;
		let Draconic_Delights_Choice be what the player chooses from Draconic_Delights_Choices;
		if Draconic_Delights_Choice is:
			-- "Have some hyper preg sex?":
				say "     You idly rub your powerful draconic paws over the lush swell of your brood-laden middle in raw delight at the sensual smoothness of your taut oily scales gliding across your pads as you absentmindedly pamper the growing outlines of your spawn slumbering. While you eye up the plush ponderous tumby of your equally eggy priestess, and decide to have a little [']mommy time['] with the buxom herm. After all, you both deserve a chance to blow off some steam in your current state, you muse, as the wondrous cocktail of maternal hormones bubbling through your [bodydesc of Player] core has left you more than a little on edge lately. A sentiment that seems to be shared by Arlene, as your sharp draconic senses can easily smell the exotic scent of hir hybrid arousal coiling through the room as the increasingly heavy set breeder labors under the lush weight of your titanic spawn. The poor herm is barely able to stand, much less waddle in hir current state as hir overstretched tummy dominates every aspect of hir life as your goliath clutch nearly dwarfs your favored plaything. Though from the proud little glint in hir eyes as shi lovingly traces a single pointer claw along the vibrant crimson spiderweb of tiger stripes gracing hir heaving bump, you know shi wouldn't have it any other way.";
				say "     'Da, admiring yar handy work, me dragon?' shi hums, draping hir arms over the lush groaning curves of her gorgeous G-cups. Swollen with purpose and rich cream, hir decadent mounds maintain a certain shapely quality that few mothers hir size could match, as they comfortably wobble atop hir heavenly tum with hir every laborious breath. Rumbling contentedly, you tell hir that it's hard not to, besides, the new look suits hir. 'Yar, ye be too kind to dis [']ere old sea dog, me heart,' shi purrs, as hir webbed palms drift along the tender swell of hir rack in open admiration. 'Nots dat I'z don'ts be appreciating da attention, evens if yer wee ones can be a right ravenous bunch,' she titters, giving hir perky nips an affectionate squeeze. 'Still, ta gifts dem un her worshipfulness be sharing with me be more den worth da hassle,' shi preens, watching twin glittering beads of pearly perfection seep between the gaps in hir fingers. Chuffing in reply, you express more than a touch of satisfaction in knowing that their blessings are being put to good use. 'Indeed day are me heart, course, I'z see I'z not ta only one what's enjoying ta lady's gifts,' Arlene simpers, eyeing up your own fecund middles.";
				WaitLineBreak;
				say "     Naturally, you preen, as you advance upon hir with a proud predatory sashay, reveling in the subtle bounce of your assets and gentle click of your talons upon the floor. Though boons such as yours deserve to be shared with a like-minded soul, wouldn't shi agree? You tease, pressing your verdant bump against hirs, exalting in the dissonant kiss of your glossy scales gliding along hir coarse well-lubed skin. 'Ay me lovely, I'z couldn't uv asked for a better mate, or partner,' your priestess coos, cheekily wrapping hir mitts about the lush swell of your gleaming middle. Gnarring happily at hir tender touch and light kiss of hir claws gracing your scales, you proffer that perhaps the two of you should take a moment to enjoy the spoils of your continued alliance and, you pause, working your dominant forepaws about hir waist, groping a supple pawful of hir shapely selachian ass, your growing bounty. 'Da ya took da words right out [']O me mouth boyo,' Arlene chuckles, motioning to an unoccupied stretch of the plush furry carpeting gracing hir humble quarters with a theatrical flick of hir finned tail.";
				say "     Smirking at hir suggestion, you strut over to the convenient patch of open space and leisurely drape yourself across the cushy hides with a grateful sigh at the satin caress of the wondrous fur gracing your paws, and oh-so-sensitive scales as you roll onto your back. Mh, feels good to get off your feet, you chuckle, beckoning your doting priestess over with a come hither wave of your augmented tail. 'Da, un da view be something to admire too, me sultry sea devil. Why I'z dares ta reckon thar be no finer sight in da neath den yar abyssal beauty, me dragon,' the eager shark herm purrs, selachian eyes drifting along the opalescent curves of your eggy core. Almost blushing at hir praise, your draconic mind can't help but agree, as your many golden glowing orbs waltz along the hills of your supple scalie middles. The growing swell of your assets as you take in the heavenly sight of your brood laden body. Oh-so-ripe and devilishly powerful, the spectacle of your imposing fertile frame rarely fails to bring a toothy smile to your scaley lips. You muse, drinking in the beatific radiance of your molten gaze refracting off the regal lamina lining your draconic limbs.";
				WaitLineBreak;
				say "     The sense of raw bestial might and unearthly potential builds in your taut not-so-little bumps by the second as your slumbering spawn grow all the larger. Soon, some proud facet of your cold-blooded maternal mind crows as you playfully paw at your lush feral core, you'll be able to hold these wondrous wyrms in your arm and share with them all gifts the goddess has bestowed upon you. 'Course,' Arlene coos, wrapping hir hand beneath the plush curves of hir monumental tummy as shi makes a show of hefting hir taut middle out of the way of hir cute dick slit as shi nestles hir profoundly gravid body behind you. 'I'z like ta think I'z be coming a close second tea ye,' shi crows, carefully lower hir plush baby bump atop yours as shi tucks hir athletic hips between your splayed draconic legs. Perhaps, you tease, wrapping your forepaws about hir lush figure, and gently grazing your scything reflective talons along the resplendent swell of hir rosy tiger-striped midriff, relishing the supple weight of Arlene's brood pressing down upon you. Shi certainly shows potential, who knows, in time shi might even give your regal form a run for its money.";
				say "     'Mayhaps, me dragon, but only so long as ye keep treat'n me so,' your priestess pants as your pillowy pads sink into the deepening folds of hir lush middle, while you coil your tail about hir hips and draw hir all the closer with a gentle tug of your augmented limb. Rumbling in a lewd draconic cadence, you promise your lovely priestess that you will. After all, shi looks so precious like this, and you wouldn't want to deny Arlene hir purpose. You swoon, as hir coarse pregnancy-plushed vent brushes the glossy alabaster petals of your peerless scalie flower. 'Da, course me lovely wyrm, few things in the neath bring a smile ta dis old sea devils face better than seeing yar worshipfulness buoyed by such bountiful tides,' your priestess preens, gliding hir clawed mitts down along the verdant swell of your mammoth middle, till hir coarse well-lubed digits brush the tender curves of your toasty tum. 'Sides, your regalness makes fir a right fine pillow for our wee zea beasties,' shi chuckles, giving your gleaming scales an endearing rub.";
				WaitLineBreak;
				say "     Chuffing at hir boldness, you lavish her toned hips with a commanding squeeze of your tail while asking hir if perhaps shi'd like to make another lovely [']contribution['] to your blossoming majesty then. 'By yar will, me dragon,' Arlene hums, supple palms drift outward to your potent haunches as shi takes hold of your hindlegs, provoking a needy gnar from your lips as hir nails dig ever-so-slighty into your inner thighs. While the silky tips of hir glossy dual dicks, lightly traipse about the lush borders of your [cunt size desc of Player] folds as your priestess fixes you with a smoldering, yet pleading, look. Go on, you hum with a gentle matronly trill in reply to hir show of proper decorum. 'Aya-aya me heart!' the gravid herm roars with a forceful buck of hir hips, as shi hilts hir slithering spiral spires in a single sensual stroke. Frictionless bliss surges through your puddling passage as your devilishly sensitive body roils at the gossamer kiss of hir dexterous twin rods caressesing your petals as the heavyset herm lavishes your [cunt size desc of Player] muff with powerful, bestial pistons of hir hard working hips.";
				say "     You find yourself panting in a deep brassy draconic trill, at the wondrous kiss of hir wondrous tools stretching your plush pussy all the wider as hir flexible rods coil and twist in on themselves in a chaotic whirl of sensations. Hir unbound cock heads seem drawn to your tenderest folds like erotic magnets as their ophidian forms writhe like tumultuous storms about your flushed walls. Your liminal mind struggles to parse their every flickering touch and worshipful motions as they simmer along your tauric cunt. Ah-ah, yes good girl, you swoon, at the inquisitive kiss of hir dicks roiling along the imperial edges of your sensitive joybuzzer. A part of you can't help but marvel at hir control over hir silky spires. As Arlene's graceful throbbing rods cinch about your plush hood, casting lewd furrows in your tender cunny scales, lavishing your elated clit with the vibrant echos of hir thrusts. Never once through does hir pace slow though as the heady flex of hir satin cocks moiling your swelting depths and eager dandle of your button simmers along your lust-addled senses as if the sordid ebb and flow of the tides were coursing about your [bodydesc of Player] form.";
				WaitlineBreak;
				say "     All the while, hir groaning body wobbles atop your tight tum in a heavenly squall of gravid delights as vast, meaty quakes ripple through hir bountiful bump and milky mounds with each hearty piston of hir hips. Your chosen's chambers resound with the lewd slosh of hir full creamy breasts as hir perky melons bounce in tandem with each intoxicating thrust, filling the air with a fecund sonnet of hybrid excess. Enthused by the sight and buoyed with tainted pride at the size of your slumbering wyrms pushing the fecund herms body to limits as your brood reshapes hir into the perfect vessel, you tenderly run your paws about the adorable blush of hir tiger-stripe laden middle. Reveling at the sensation of hir coarse heaving paunch simmering along your silky lamina, and the scrumptious weight of hir latest clutch coddling your pads. Mh shi's coming along so wonderfully, you purr exalting at the welcoming doughy softness of hir motherly middle as your pads sink into the rough, rubbery folds of hir balmy love handles, pampering hir resplendent body with soft endearing strokes. Your well-bred priestess chirps in selachian bliss as you lightly rake your claws along hir tight hide, leaving bright crimson lover's marks in their wakes while hir twin gossamer rods ripple along your elated passage in vivacious rhythm.";
				say "     How cute, shi loves being your cuddly little breeder, doesn't shi? You tease, savoring the growing rosy blush filter across hir creamy core as you coil your tail about hir lightly swaying package, giving it a cheeky squeeze. Evoking a desperate sigh from hir lips, as the silky curves of your nodding plaything's twin cum veins thrum in tune with hir pounding pulse along your abyssal walls and perky scalie clit while your abyssal draconic voice slithers through the room like a tempting serpent. Good, and how could shi not? After all, shi gets to watch hir curvy body grow round and taut with your young, you intone flaring your chromatophores in an enchanting waltz of lush pinks and worshipful golds, bathing hir room in your hypnotic parade of otherworldly lights. To feel the supple weight of your eggs bearing down upon hir as hir body swells with countless immaculate wyrms eager to further your shared ambitions, and bejeweling these holy grounds with treasure. While your doting worshipers wait upon hir every word. You tempt, drawing your wings about hir shoulders as you glide their glossy points down the small of Arlene's back.";
				WaitLineBreak;
				say "     'Ah, aya *pant* aya, so big, so soft, feels so... right,' your delectable mate murmurs, eyes glazing over in lustful fog as shi nuzzles hir chin along the vibrant swell of hir plush G-cups perched atop hir resplendent middle while scintillating beads of alabaster cream trickle from her lush mounds. That's right pet, virile herms like hir were made for this, you preen, drawing your talons along hir quivering sides, rollicking at the needy quiver passing through hir fecund figure. 'Yes zu'u aam Kai Monah, zu'u aam hen kove,' Arlene rumbles in an dissociated tone, while a far off look creeps across hir muzzle, as you hook a delectable droplet of hir cream on the glimmering reflective edges of your dominant pointer claw. Then bring the scrumptious treat to your lips and lightly lap at the pearly orb perched on your talon, purring. Mh, delicious, as expected from your priestess, while your bifurcated tongue coils about your natural blades while Arlene looks on in muted awe."; [I serve the ocean mother, I serve the five heads.]
				say "     But there is always room for improvement too, you coo, languidly gliding your oral muscle along the scything contours of your reflective talon. You fold your hindlegs about hir hips, supportively sinking your supple paws into the tight athletic mass of hir ass, encouraging the decadent herm to go faster as your needy tauric cunt spasms delectably in tandem with the spine-tingling pistons of hir glossy rod. Shi still has so much more growing to do, doesn't shi? You tempt, blissfully cupping your forepaws about the groaning equator of hir plush middle, then trace your talon up along the tender curves of hir puffy navel. 'Aya da wee ones do be needing lots [']O space,' Arlene hums dreamily, as hir left hand joins yours in the loving exaltation of hir fertile figure as shi reverently gropes vast handfuls of hir ripening tum. 'Un succour,' shi mews, paws drifting upwards to the perky peaks of hir glorious nips as shi lustfully tweaks hir claws long the cute pink borders of hir plush teats.";
				WaitLineBreak;
				say "     That's right little mouse, your voracious spawn will need all the ambrosial delights shi can produce, you coo, watching the smitten shark worshipfully knead hir flush mounds as thick streams of rich milk beads between hir fingers. 'Aya, more cream fir da crew, more names fir da account, more plunder fir me holds,' the former captain cackles with manic glee as shi grips your hindlegs once more as shi ravenously pounds your eager passage with hard bestial pistons of hir hips. Sending roiling waves of bubbling bliss through your sopping passage as hir twin cocks corkscrew along your spasming walls, lavishing your regal muff in an unbound torrent of decadent delights. All the while, the pulsing caress of hir thrumming cum veins flickers about your joybuzzer as the heady tension and passionate coddling of the bawdy herm's dexterous dicks cascade through your sensitive muff with zealous alacrity. Gnarring in coldblooded rapture at the eclectic kiss of hir spires and sweltering weight of hir bountiful brood-bound bump pampering your tauric frame, you coyly coil the tip of your enhanced tail between hir chiseled athletic legs.";
				say "     A the verdant lustful heat pours off hir plush cunt and petite package flickering across the exotic muscles decorating your tail like the tender kiss of some otherworldly sun as you playfully massage hir juicy petals with soft, endearing strokes of your gossamer scales about the shapely contours of Arlene's inner thighs. ";
				if intelligence of Galaxite is 2: [tail maw version]
					say "You find your mouth watering with unbidden delight at the blissful memory of hir sultry flavor waltzing across your unusual palate. You unfurl the hidden borders of your exotic mouth, relishing the heady sensation of the bracing temple air flickering along the veiny borders of your aberrant maw while your glossy feelers slip free of their unusual housing. You can't resist teasing your bawdy mate's petals and sumptuous sack with a few playful little strokes of your silky tendrils, provoking a slutty whimper from the sensuous shark's lips as the malleable mass of your tentacles roam hir hybrid splendor.";
					WaitLineBreak;
					say "     How adorable, you purr, in a slithering cadence, idly flickering your forked tongue at your needy priestess as your yearning maw drinks in the intoxicating sapor of your native oils dribbling along its supple form. You lovingly slip your tentacles about the lightly swaying curves of hir tight little cum tanks and plush nether lips, reveling in the exotic texture of hir coarse selachian hide and potent pounding of hir pulse roiling along their impressive lengths as you vivaciously engulf hir wondrous sex in the thrumming folds of your voracious tail. The swooning herm can only pant in broken, lustful gasps as thick gray wisps of hir passionate breath billow about hir angular muzzle while shi struggles to keep hir pace as hir eyes drift lazily towards the ceiling. 'By da nameless god [']O da neath,' shi stammers through hir wild bestial ruts as the lustful thrum of hir glossy tools caresses your spasming walls and your tauric cunny muscles ravenously milk hir prehensile rods in their molten embrace.";
					say "     Flashing the well-seeded shark an appreciative too-toothy grin, you slip a pair of inquisitive feelers betwixt the exotic folds of hir ripe puffy flower, exalting at the oh-so-sweet tang of hir futa juices tracing the ecstatic borders of your tendrils as Arlene's flush muff bulges with their weight. The sensually salty sapor of hir compact package trickles about your feelers like an abyssal eel as the strumming veiny petals of your tentacular maw playfully pampers hir tight little cum tanks in their voracious hold. Your tendrils arc about hir balmy devilishly-tight passage in a wriggling sonnet of draconic affection as you spiral and bend their glossy form about Arlene's needy little cunt, swooning internally at the lewd kiss of the spellbound shark's elastic passage cinching about your tendrils as hir fuck-hungry walls eagerly milk their satin mass. 'Goddess, so good...' your priestess pants, hir voice trialing off into a reverent simper as shi roughly raking hir claws along your inner thighs. As thin bands of pearly cream stream down the sides of hir bountiful body at the artful caress of your tendrils as hir supple body wobbles and sways in tune with the titillating whirl of your feelers.";
					WaitLineBreak;
					say "     You can't help but smirk at the near hypnotic bounce of hir tender assets as hir vast pillowy tummy writhes in your grasp like an overloaded washing machine with each energetic thrust of hir twin spires caressing your lush [cunt size desc of player] cunt. Savoring the spectacle of hir rosy middle squirming in your paws, and the subtle meaty patter of hir milky teats serenading your ear, you lean your profoundly bendy body forward, till the tight supple flesh of your adorable navels kiss. You drape your arms about hir resplendant gravid body and draw your forked tongue about the sensual curves of hir gushing nips. Mh how wonderous, you purr affectionately at the rich, thick, fatty piquancy of Arlene's cream dribbling down the length of your tongue while a hungry rumble simmers across your expectant middle. You cup your massive mitts about hir expansive orbs, lightly pressing them together, and ravenously bury your proud draconic snout between the swell of hir verdant pink areolas as you engulf hir diamond hard nips into the silky embrace of your thin draconic lips.";
					say "     Evoking a cheek-filling rush of ambrosial nectar from hir overflowing milk tanks that gush at the merest suckle as hir petite nips baste your taste buds in a soothing tide of maternal delights. 'Cribens me dragon ye got a way with dat thing!' your priestess gasps, as you voraciously suckle with a potent draconic gnar, letting the inquisitive tips of your bifurcated tongue encouragingly coil about hir teats. All the while, hir ripening mound lazes against your paws, creating scrumptious furrows in hir heavenly G-cups as your fingers sink ever-so-slightly into their welcoming bight. Teasing and pampering hir productive mounds with loving, purposeful strokes of your silky mitts, you revel in the blessed sparks of change coursing through you as your scalie form drinks in Arlene's potent cream. A sweltering ecstatic heat, pulsing through your cute middles and ripening chests as the first hints of the goddess's gifts stir within you. Enthralling chains of eldritch lightning dance along your imperial chest as your matriarchal mounds groan with fresh ";
					if "Touched by Madness" is listed in feats of Player:
						say "pints ";
					else:
						say "quarts ";
					say "of decadent cream as your peerless body is molded all the closer to the perfect image of divine fecundity.";
					WaitLineBreak;
					say "     Goddess this feels amazing, your liminal mind swoons in raw unvarnished elysium at the erotic energy dancing down your sides that leaves you panting for more as your oh-so-sensitive nerves reel with the entwining bliss flickering about your well-fucked passage. Arlene's writhing rods seem to drink this chaotic static as a lewd pin prick of desire flares about your [cunt size desc of player] muff in a vibrant aurora of rapturous sensations that seems to be drawn along your neediest folds like lightning seeking a ground. The coiling caress of hir pulsing cum veins and the ambient kiss of the goddess's love pour across your pampered clit with each intoxicating thrust, fanning the simmering flames of the draconic lust surging through your joy buzzer and pregnancy-flushed hood. A sensuous trickle of balmy dew beads from your bejeweled cunt in a glittering trail of honey, tracing its way down the sleek borders of your scales like the gentle kiss of a reverent lover.";
					say "     You wallow at the stormy kiss of the goddess's affection arcing along the tough, glittering, oily contours of your augmented tail while your dexterous tendrils flicker across your plaything's quivering cunt, both vying for your attention. Your senses are drowned in a vibrant whirlpool of draconic desire at the sensual flavor of hybrid juices and native oceanic tangs playing across your tail maws eager palate as your glossy feelers spill along the tactile borders of hir tight little cum tanks. Kneading and jostling the respectable orbs in their lush embrace like a set of immaculate gems as hir ripening baby batter banks seem to drink in the aberrant energies simmering across your entwining bodies. You almost swear you can sense the verdant potential of hir lush spunk banks drawing in Tiamat's blessing as their twitching mass squirms delectably with the regal echoes of hir thrusts.";
					WaitLineBreak;
					say "     The throbbing, veiny petals of your succulent maw creep all the tighter about Arlene's swaying sex as you press your voracious O-ring to the tender lips of hir selachian flower. A preyish shiver passes through hir fecund figure, while the toasty contours of your maw conforms itself to hir cute little aquatic button as your exotic muscles reverently suckle on hir perky aquatic clitty. Hir eyes seems to glaze over in a lustful fog of bestial bliss while hir tongue shamelessly lolls from the side of hir mouth as your inquisitive tendrils gleefully glide about hir satin folds. Affectionately attending to hir inviting muff with an artful symphony of gentle pistons, shifting coiling slithering caresses, and tender worshipful strokes as you levy your growing control over your augmented form upon hir. The lascivious ballet of tentacular reveries drift all the closer to hir tremulous prostate, as your profoundly flexible feelers dotingly massage the poor herm's overstimulate G-spots. Driving the bliss-wracked breeder wild as reverent words and lustful pants pour from Arlene's lips as hir hybrid mind is set awash in an impossible torrent of unbound ardor.";
					say "     Such a needy mommy, you titter between sips, bathing hir two-toned hide in your golden incandescent stare, as you drink in not just hir adorable expression, but the heavenly motes of transformative bliss bubbling in your breasts and eggy tum. The sensuous opalescent scales gracing your motherly mounds groan with maternal purpose as your regal breasts flow outwards in a slow, yet by no means undesired ";
					if "Touched by Madness" is listed in feats of Player:
						say "centimeters ";
					else:
						say "inches ";
					say "of bountiful flesh as your tits swell to accommodate the needs of your young. Your lovely tummy blushes a picturesque crimson with the soothing weight of your hungry brood and latest meal, stitching your lamina all the tighter by the second while the ripening borders of your belly libidinously grinds against your priestess's fertile form.";
					WaitLineBreak;
					say "     Eliciting a well-pleased reptilian purr from your insatiable body pressing against Arlene's, eldritch lightning crackles along your resplendent curves as they gently glide against one another in a euphoric medley of sensation as the rapturous echoes of your glossy lamina and the well-seeded shark's rough skin wash over your fecund forms. An endearing tightness builds in your core while your ravenous tail maw convulses with fertile purpose as something begins to shift within you as the exotic muscles decorating your tail convulse with a familiar alluring energy. Unwilling to finish first though, you imploringly dig your hindpaws into the rich athletic contours of your lush priestess's fertile figure while fixing hir with a sultry, smoldering draconic stare as you urge hir onward. You can feel a brisk tension ripple through hir dense thighs as shi strains hir hard duly-taxed muscles to the limit, till sweat pours from hir brow in a simmering sheen as you commandingly rock hir fertile hips all the quicker.";
					say "     Hir slithering spires thrum along your wall with the ecstatic pounding of hir pulse, hir serviceable rods roiling about your quivering satin sex in a wild bestial tattoo, bereft of form or technique. Yet replete with the raw, primeval passion that your tauric half craves as Arlene roughly digs hir claws into your inner thighs like a proper beastess claiming hir mate as hir lush body quivers in your arms with the resplendent reverberations of hir pistons. Till with one toe-clenching thrust, shi roughly hilts hir turgid tools within your puddling depths, loosing twin molten deluges of salty seed upon your folds. While blissful heat and the reverent wobbles of hir brood-blessed body cascade over you, your passage simmers with fecund rapture as your [cunt size desc of player] cinches about hir respectable rod, worshipfully milking hir wriggling cocks in your ravenous embrace. The hidden concentric sinewy rings decorating your enhanced tail bulge with the lurid mix of exotic feminine fluids and the soft goopy forms of your eggs straining along your tapered limb as they coil along Arlene's supple being.";
					WaitLineBreak;
					say "     You can't help but rumble ecstatically between eager sips of the gravid herm's cream at the hallowed tightness roiling through your sensitive form, alongside the endearing caress of hir curvy body while your spawn-to-be trace the chiseled contours of hir hips and amazonian thighs as tendrils lovingly push them onward. You almost gasp in draconic delight at the first gelatinous kiss of your exotic ovum, your plush O-ring is stretched devilishly taut by the succulent caress of their malleable forms. As the first of many eggs surges forth amid a heady gush of girly juice in a vibrant tattoo of back-to-back climaxes cascades over you, though not a drop of your exotic juices slip free of your maw's embrace as the lewd squelch of your petals cinches about Arlene's folds while your dexterous tendrils guide your silky eggs. A fervent rumble issues from the bawdy shark's lips as hir plush passage roils with the rubbery mass of your spawn and silky tendrils, hir belly creaks and groans with the heavenly weight of your unearthly load. Your feelers corkscrew and gesticulate in an effervescent spiral as they deposit your eggs with in the spellbound herm.";
					say "     You take no small sense of pride at the sight of fresh stretch marks blossoming across hir blushing creamy hide in an ever deepening spiral of thick, throbbing tiger stripes as hir body struggles to contain your offering. All to your priestess's soaring bliss, as shi enthusiastically traces hir tight rosy tigerstripes, kneading vasty handfuls of maternal padding as the lingering sparks of the goddess's love coalesce about hir heaving form as the potent essence of your offering is absorbed by your slumbering young. Another time, you might have felt some small pang of regret at denying your eggs the chance to mature into proper wyrms, yet gazing at the proud manic glint in Arlene's eyes as hir tummy creeps over your [bodydesc of player] form stills such petty thoughts. 'Yar-har dats right me beasties keep growing!' your priestess pants, nuzzling hir chin about the regal bight of hir oceanic breasts as the once rich flow of hir cream peters off to a slow trickle. 'Yer going to be a proper sea devils in no time, now taint that right me dragon!?' Arlene preens, as hir slippery spires gently go flaccid as shi leisurely slips them free with a spine tingling pop.";
					WaitLineBreak;
					say "     Shivering at the fleeting caress of hir tools and ambient warmth of hir seed wallowing within your well-used cunt, you can't help but nod in agreement as you loose your loving hold on hir flush nips, then levy a tender series of gentle kisses along hir coarse maternal curves. Earning you a duly-pleased chuff from your priestess as the last vestige of the luminance static entwining your gravid form winks out of existence, as you lavish the eager broodmother-in-training with genuine praise for hir continued zeal and service to the goddess while you carefully withdraw tendrils. 'Da,' Alrene purrs, though an adorable little smile as hir ripe muff reverently caresses the last few ";
					if "Touched by Madness" is listed in feats of Player:
						say "centimeters ";
					else:
						say "inches ";
					say "of hir aquatic folds, 'ya be spoiling me with such honeyed words me heart,' as shi eases hirself onto the ground with a content sigh before laying on the soft cushy fur carpet, letting the weight of hir body wash over hir. Tittering, you tell hir its hard not to, after all shi looks so cute like this. Self-gratification aside though, your time together will hasten the goddess's arrival and the rich rewards that await you both. 'Ya-ha-ha, spoken like a true sea dog, me lovely!' Arlene preens through a roiling belly laugh while hearty ripples simmer across hir swollen body as shi reverently massages hir plush form with vivacious strokes of hir girthy finned tail.";
					say "     'Ta think with de help [']O de wee ones here un our most worshipful ladyship, we'll be sitting pretty fir da rest [']O are days as right proper queen uh dis [']ere berg,' she gushes, giving hir tummy a lewd slap with hir tail. Tutting as your run your paws over the outlines of your own slumbering brood, you playfully chide the herm's lack of ambition, why settle for one puny sphere when there is a whole ocean of possibilities for the two of you to plunder and despoil, together. 'Ha-ha, I'z do love the cut [']O your gib me dragon, if nothing else, ya be keeping things interest, *yawn*, but fir now, da little uns un I be needing a touch [']O tuck,' Arlene coos, in a dreamy trill as shi stretches out on the well-padded furry carpet while idly flexing hir toes. Of course, you hum in a soft, reptilian cadance as you gently roll onto your paws and pad over to hir bed, then pluck the topmost sheet alongside a pillow from its mundane frame. Tucking the pillow under your arm, you quietly stride over to hir side, drape the now too-small blanket over hir tight brood swollen body, and slip the serviceable pillow behind hir head. 'Daw, ya can be a right kind one when ta mood strikes ya, me dragon,' your priestess mews as shi drifts off to sleep. Not wanting to wake hir, you stealthily amble back to the main hall to allow the lush breeder a chance to rest.";
					Move Player to Dragon's Causeway;
					NPCSexAftermath Player receives "PussyFuck" from Arlene;
					NPCSexAftermath Arlene receives "PussyDildoFuck" from Player;
					if Libido of Arlene < 25:
						increase Libido of Arlene by 1;
					if breast size of player <= 5:
						now breast size of Player is 5;
					else if breast size of Player >= 6:
						increase breast size of player by 2;
				else if intelligence of Galaxite is 1:
					say "While a well-pleased rumble issues from your thin draconic lips as the supple borders of your exotic ovi slit waltz along hir coarse hide, you devilishly trace your tail about hir dripping aquatic snatch. Reveling at the blissful tension coiling through their toned muscles as you lovingly angle your tail along the toasty folds of your priestess's eager passage, you affectionately draw your prehensile limb about Arlene's lust-flushed muff in a sensuous circuit. You tenderly trib hir neglected box in tune with the verdant pistons of hir hips, relishing the plush caress of hir puffy gravid kitty playing across your tail mounted slit as hir supple, yet pleasingly rough, hide seems to mold itself about your egg-laying limb, bathing the alien muscles decorating your tail in a lustful balm of hermaphroditic heat and sensual juices.";
					WaitLineBreak;
					say "     'Mh, by da goddess, me dragon, yar certainly got ta way with dat thing,' your priestess mews, hungrily pressing more of hir bountiful weight against your inquisitive limb and supportive paws as shi ravenously grinds hir needy folds about the sordid appendage with alacrity. Your senses revel in the heady dissonance of your co-mingling hides as the unsubtle catch of hir rough pebbled selachian skin moils your ovi slit while the abyssal kiss of your glossy lamina serenades hirs in a heavenly sonnet of exotic delights. All the while, rich rivulets of hir girly honey, laced with the well-seeded sharks native oils, and your own draconic lubrication trickle down the tiny gaps in your tough, opalescent scales in a velvety sheen of hybrid excess as the succulent caress of hir puddling sex washes over your ovi slit soon leaving you panting for more. Molten droplets of feminine need soon trace their way along the [bodydesc of Player] edges of your flanks while you artfully curve your tail at an instinctual angle and spear the sultry herm's sodden muff with a single, masterful stroke.";
					say "     Earning you a desperate, but delighted gasp from the brood-laden shark's lips as hir elastic cunt bulges with the graceful tapered weight of your tail, stretching hir aquatic passage wondrously taut. A lovely series of fecund quakes passes through hir too-tight tum as you pound hir welcoming folds, while hir heaving rosy tum and plush alabaster tits wobble before your eyes enthrallingly with the pistons of your beatific tail. Wallowing at the decadent sight of hir leaking creamy mounds, shuddering at each hearty motion of your tail and generous thrusts as hir gushing tits seed the air with rich pearly spray as tender droplets of thick fatty milky cascades over your flush body and down the verdant curves of hir plush tummy. Your senses are awash in an intoxicating squall of lush radiant bliss while you drink in the divine spectacle of hir fecund form jostling atop your own as hir selachian sex succulently cinches about the elated contours of your tail cunt.";
					WaitLineBreak;
					say "     You lavish the burgeoning breeder's box with loving, spiraling thrusts of your prehensile appendage in a decadent mirror of hir hedonistic strokes, as you twist and corkscrew your dexterous tail about Arlene's welcoming stain box. Exalting at the balmy heat and gentle spasms of hir selachian cunt rippling about the exotic muscles of your ovi limb as your tail is lovingly swaddled in hir satin folds of hir elastic sex, you coyly massage the sensual spade decorating your wondrous tail about the thrumming impression of hir masculine g-spot as you tenderly pamper your precious breeder's prostate with gentlest of brushes of your expansive glossy appendage. All the while, slipping ever more of your girthy tapered tail betwixt hir well-used folds till the malleable velvety edges of your spinal fin brush the needy borders of hir joybuzzer. Eliciting evermore cute lust-addled pants from the curvy shark's lips as light gray wisps of steam stream along the angular edges of hir lips as the libidinous caress of hybrid erogenous zones sends hir fuck-numbed mind reeling.";
					say "     Hir lust-fogged eyes slowly drift skyward as hir tongue shamelessly lolls between the sharp borders of hir gleaming fangs at the vivacious treatment of hir intersexed body. Oh poor thing, you had no idea shi was so, you pause playfully raking your hind claws along the sensual maternal curves of hir athletic ass, pent up, you hum, in a playful ophidian trill, playfully flicking the crimson tips of your bifurcated tongue at hir, and reveling at the subtle oceanic tangs of the temple air simmering across your palate and Arlene's adorable expression. 'A-ay-aya, s-s-so full, feels so go-good,' the brood-laden shark stammers as shi struggles to keep hir lascivious pace. You detect certain laxity in hir limbs as hir once fervent strokes grow evermore languid as you rail hir hybrid g-spots in a resplendent torrent of abyssal delight. Hir hands thoughtlessly drift back down along hir flush contours of hir ample tum as shi takes holds of your hindlegs again to steady hirself, yet not once does the unearthly tenor of hir serviceable prehensile spires slacken as hir dexterous rods glide along your elastic tauric passage like erotic magnets drawn that seem drawn to your neediest nerves.";
					WaitLineBreak;
					say "     Worshipfully fondling and attending your needy muff in a beatific symphony of abyssal delights while hir throbbing cum vein simmers about your scalie clit in a turgid duet of unbound rapture. The potent pounding of hir desperate pulse pampers your ecstatic button and silky walls in their sleek, fervent embrace while the poor over-bred herm caresses your proud form. Chuffing at hir antics, and the heady pounding of your [cunt size desc of Player] sex, you fondly work your hindpaws into a more supportive position. Lending more of your draconic strength to hir, earning a well-pleased, if distant, simper from the duly seeded selachian as the tasteful curves of maternal ass sinks ever-so-slightly into the inviting padding of your [bodydesc of Player] paws. Meanwhile your forelimbs roam up along the bountiful folds of hir heaving [one of]tumby[or]tummy[or]belly[or]paunch[at random] in raw admiration of hir growing splendor, and the pleasant of hir weight brood-laden body massaging your imperial curves.";
					say "     Your increasingly maternal mind swoons at the intoxicating interplay of hir rough pebbled hide gracing your pads and the decadent give of hir soft maternal padding and hidden tautness of hir ripe womb greeting your paws as you trace your talons along the thicc ruby tiger-stripes decorating hir alabaster core. A little preyish quiver ripples through hir body as your plaything's overstretched middle wobbles hypnotically in your grasp while the rich streams of pearly cream trickle along the malleable webbing of your paws. Chuffing at the sight and welcome scent of hir ambrosial milk, a boisterous rumble soon cascades about the regal curves of your eggy tum at the thought of savoring such wondrous fare. While the supple swell of hir maternal majesty lovingly gliding about your own motherly form wars with the salubrious pules of hir dual spires gracing your petals and the fervent caress of hir satin walls roiling about your ovi tail jockey for prominence in your liminal mind.";
					WaitLineBreak;
					say "     Though the ravenous hunger bubbling in your brood-kissed body soon wins out as you gently lean forward, ever mindful not to interrupt the labored pistons of your feisty fishy friend as you lovingly press your upper half against hirs. Exalting in the heavenly sensation of hir ripe plush middle rifling against the tough lamina gracing your lush tum, you drape your arms about the pillowy swell of hir flush expansive sweater puppies as your elated digits sink ever-so-slighty into their taut milky mass. Wallowing at their hearty heft, while lewdly complimenting the lust-drunk herm on hir divine proportions, you indulgently tweak hir gushing nips between your thumb and fore fingers, evoking a fresh gush of alabaster delight from hir supple tits and another voracious gurgle from your ripe core. Mh such a productive mommy, you tease, edging your head all the nearer to the plentiful hills of hir resplendent rack, letting the steamy beads of your lustful breath play across hir maternal form as you fix hir with a smoldering draconic stare.";
					say "     Of course, we can't let such, you pause to cheekily lick your lips, bounty go to waste now, can we little mouse? You purr, tenderly flicking your lengthy ophidian tongue about the bright pink borders of Arlene's areola, provoking a lewd, needy mewl from hir as the sensuous tips of your oral muscle traipse about hir hide. 'No,' your priestess stammers, in a far off candace as motes of many colors and none dance across hir eyes in a kaleidoscopic ballet. Rumbling appreciatively, you lovingly grope your paws tightly across the immaculate bight of hir oceanic G-cups, drawing them into a cute little faux-heart as you level your muzzle to hir cute pink perky nips, as your greedily wrap your lips about hir leaky teats. Humming contentedly, your far-traveled palate is gleefully greeted by a rich sheen of fatty cream as hir plush mounds, perhaps sensing the effervescent desire welling within you, loose twin jets of pearly perfection upon your eager maw.";
					WaitLineBreak;
					say "     Nearly caught off guard, you can barely keep up with hir decadent stream of warm delectable cream gracing your muzzle, as your cheeks soon bulge ever-so-slighty with the scrumptious fare. Yet your pride and billowing hunger of your spawn refuses to yield, as you loudly, and greedily swallow each exquisite mouthful of your priestess's lovely offering. Your liminal revels at hir rich flavor cascading about elated palate with each fervent suckle, along the intoxicating echoes of silky spire coiling about your sex, and verdant caress of hir cunt lovingly gripping your ovi tail as you feed. Unsubtle waves of transformative bliss building in your tight core while Arlene's milk seeps though you, your [breast size desc of Player] chest grows almost hot to the touch as the tender glands seem to drink in the verdant waves of change billowing through you. Swooning between suckles, you can already feel a beautiful tightness creeping across your scales as your productive mounds thrum with renewed purpose as they swell with fresh ";
					if "Touched by Madness" is listed in feats of Player:
						say "pints ";
					else:
						say "liters ";
					say "of maternal cream.";
					say "     Wondrous, you hum under your breath at the succulent sensation of your groaning sweater puppies slowly spill over the sensuous mass of your eggy middle with each reverent suckle. All to your increasing delight as your swelling tits lovingly laze along the plush curves of your priestess's own, your mind is set alight with smoldering draconic pride and purpose as the thought of sharing such heavenly bounty with your spawn wars with the blissful image of your growing imperial majesty filling your mind. As heady fantasies of your future fecund splendor utterly overflowing with coldblooded life perched atop oceans of gold and priceless treasure play out before you. Briefly closing your eyes, you can almost hear the adoring cries of countless worshipers praising your name, and the loving touch of your doting attendants catering to your every want or whim. While creatures both great and terrible jockey for the chance to breed you so that their lines may share in your endless glory, or bring honor to the goddess's name.";
					WaitLineBreak;
					say "     All the while, your fertile form drinks in each delectable drop of Arlene's morphic cream, pleasant pin pricks of thrumming static begin roiling across your curves like a verdant storm cloud as your scales creak with the weight of your priestess's cream and tender kicks of your spawn. Good babies, you purr with a proud draconic trill at the hearty echoes of your little wyrms movements rippling through your ecstatic body while the heady caress of the goddess's blessing cascades over you like living thunderheads. You watch, in coldblooded awe, as the lurid spectacle of the many colored tendrils of divine radiance pours over you and your chosen priestess's entwined form, titillating your sensitive scales like the worshipful kiss of countless doting lovers. The erotic energies slowly dance along the minute borders of your scales, then down the sordid length of your augmented appendage, fueling the supple pistons of your tapered tail as unearthly strength floods your limbs, till the air soon resonates with the lush, meaty patter of your thrusts.";
					say "     Your priestess's body seems to drink in the ambient energies, as hir once chaotic rhythm takes on a certain steely quality as shi almost digs hir nails into your inner thighs as shi bucks hir hips with verdant abandon. Your liminal mind can't help but bask in the wondrous sensation roiling your well-bred cunt as Arlene's coiling spires quiver and writhe about your walls, while the exhilarating pulses of the goddess's love cascades over your tender button. Gushing at their abyssal caress and heavenly tang of your priestess's cream serenading your eager palate, an all too familiar tightness begins welling in your breast as the little death creeps over you. Unwilling to finish before your adorable plaything, you coyly arc the glossy ridges of your malleable tail fins along the supple borders of Arlene's joybuzzer, lavishing hir adorable button with the impossibly smooth and erringly malleable ridges of your sail.";
					WaitLineBreak;
					say "     The regal echoes of the goddess's love surge about hir clitty and spasming passage as you affectionately coil the tactile forks of your ophidian tongue along the gravid selachian's tender nips in a sensuous helicoid while you suckle. The spellbound shark can only murmur vague grunts of animalistic appreciation as hir luscious body jostles in your loving many-limbed embrace with the hearty strum of hir thrusts. Your eager mitts gleefully roam hir ponderous middle and plush ass, relishing the lovely heft of your brood as you grope scrumptious pawfulls of lush maternal padding. The vivacious pounding of hir pulse and roiling arcs of static delight ripples about your cunt, evoking ever more desperate throbs from your priestess's cum veins as hir twin rods simmer across your needy folds like wild metronomes. A look of mindless bliss soon creeps across Arlene's face as hir bestial pistons reach a feverous pitch, till with one paw-clenching thrust, shi roughly hilts hirself almost to the base of hir coarse pebbly vent as shi cums.";
					say "     Loosing twin torrents of molten delight upon your [cunt size desc of Player] cunt, you almost gasp in decadent rapture at the salubrious caress of each potent pulse of hir cum veins as hir glossy spire strums about your scalie button as Arlene bastes your eager box in welcome sheen of futa seed. Swooning, you can feel your already overstretched lamina crack delectably at the heady weight of hir offering, and the unbidden spasm of your ravenous cunt as your hungry aquatic muscles cinch about hir dual tools in a beatific tattoo, slowly pushing you over the edge. You sense something shift within your lower half, as your alien tail muscles roil like an overloaded switchboard amid a squall of the lascivious tightness and you cum with a muffled well-pleased coo, a libidinous torrent of exotic juices laced with supple goopy eggs roil along the concentric rings decorating your egg-laying appendage. Each heady contraction flickers along your bliss-wracked nerves like a steady thrum of micro climaxes as your tender tail bulges with the sheer fertile weight of your load.";
					WaitLineBreak;
					say "     Your tail visibly bulges with every hedonistic ripple passing through your ovi passage like the loving caress of innumerable pleasure beads as they stretch your already gaping mate's cunt all the wider with their lurid mass as your alien limb deposits egg after blissful egg within hir eager walls. 'Cribens, so good,' Arlene pants, hir lush tummy swelling in your caring grasp as the velvety conga line of exotic ovum effortlessly slips past hir voracious cervix. You can only watch in elated awe as hir lush womb wars for space with your own well-egged tum as hir pearly hide is pulled decadently taut while glistening tigerstripes blush an ever deeper wine red as hir body struggles to accommodate your offering. Your tainted mind is set awash with a surge of motherly draconic pride, as the warm coarse edges of hir belly leisurely slip over the fruitful curves of your form while the lingering spiderweb of otherworldly static seems to sink into hir maternal majesty. 'Ah-ah, that's right me lovelies, drink up hir worshipfulness's blessing, fir yar all gonna be right proper sea devils in nay time at all!' your priestess swoons as you affectionately pamper hir quivering middle with your forepaws, rollicking at the blissful sight of the heavyset priestess's gravid form ripening before your eyes.";
					say "     Hr once boundless flow slowly begins to ebbs to a light trickle as you relieve hir supple mounds of their decadent cargo, till the plush orbs gradually begin to sag ever-so-slightly in your dominant hold. Though their beauty is by no means diminished, you muse, greedily suckling the last tender drops of morphic cream from hir puffy ducts as your many eyes take in the enthralling sight of hir pillowy G's gentle lazing atop the meaty curve of hir expansive middle. You can't help but lavish hir fecund tummy with an appreciative little nuzzle as you, almost regretfully, loose your hold on hir heavenly milk tanks, before turning your attention to your enhanced sweater puppies. Full and flushed with motherly purpose, your liminal mind proudly exalts at their lush heft as you fondly trace your inquisitive mitts along your new curves, before thoughtlessly whispering a short thankful prayer to the goddess for bestowing you with such bounty. After all, some growing facet of your draconic psyche notes, the little ones will need all the nourishment they can get.";
					WaitLineBreak;
					say "     Besides, this proud section of your tainted mind notes, the added heft is a rather fitting addition to your fecund figure too, as you work your webbed mitts about your plush breast, relishing the light little sloshing noise serenading your ears as the succulent flesh spills between the tiny cracks between your fingers. A sentiment shared by your priestess as shi gazes at the regal mounds with obvious delight, preening, 'Dah taint that a sight to warm da soul,' as shi languidly un-hilts hir slowly shrinking rods while shi eases hirself onto the floor behind you. Chuffing at the sordid parting kiss of hir tools gracing your clit, you can't help but echo hir words as you drink in the sight of your enhanced mounds while cheekily slipping your tail free of hir silky folds with a low, almost inaudible, *pop*. As your golden eyes drink in the succulent little quivers passing through your priestess as you tenderly trace your spaded limb across the gleaming two-toned borders of hir flush body, you remark that hir fecund splendor isn't all that hard on the eyes either.";
					say "     'Yar, ya be spoiling me rotten with dem honeyed words [']O yers,' Arlene blushes, slowly reclining backwards, letting the weight of hir brood wash over hir as shi basks in the blissful afterglow. Tittering, you remark that it's difficult not to, especially when your fruitful coupling has such, you pause to playfully nuzzle the tight curves of your expansive chest with your chin, wondrous benefits for your own divine form. Yet, base pleasures aside, your tawdry liaison only serve to hasten the goddess's arrival and bring you both that much closer to your ultimate reward. 'Har-har-har, spoken like a true sea dog, me dragon! Why, I'z sometimes think ya missed yer calling as right proper scallwag. But still,' shi hums in doting maternal tone as shi gives hir flush middle a gentle shake, 'ta think da wee help we'll both be sitting pretty fir the rest [']O our days a right proper queens o['] dis [']ere burg. Why jus tinking [']O all da possibilities, me lovely, a whole world dancin['] on our strings, uz gotz me head a spinning!' Arlene crows, as shi reverently draws hir tail about the toasty swell of hir tender tum.";
					WaitLineBreak;
					say "     Snickering in reply, you ask your priestess why stop there, with the goddess at your backs, and your flight at your side there's no reason you can't spread your dominion far and wide. Why just think of all the impossible riches and unearthly delights that await you both on the countless spheres of the eternal ocean. 'Aya me heart, un that's one [']O da things I'z loves about ya, ye think big, un know how to keep things interesting,' Arlene purrs, idly flexing hir toe claws while shi lets out a tired yawn. 'But fir now, da wee ones un I be needing a bit of rest, least until dez eggs get settled.' Of course, you rumble  you hum in soft, reptilian cadance as you gently roll on your paws and pad over to hir bed, then pluck the top most sheet alongside a pillow from its mundane frame. Tucking the pillow under your arm, you quietly stride over to hir side, drape the now too small blanket over tight brood swollen body. 'Daw ya can be a right kind one when the mood strikes ya me heart,' your priestess mews as you slips the serviceable pillow behind hir head before shi drifts off to sleep. Not wanting to wake hir, you stealthy amble back to the main hall to allow your favored breeder a chance to rest.";
					Move Player to Dragon's Causeway;
					NPCSexAftermath Player receives "PussyDildoFuck" from Arlene;
					if Libido of Arlene < 25:
						increase Libido of Arlene by 1;
					if breast size of player <= 5:
						now breast size of Player is 5;
					else if breast size of Player >= 6:
						increase breast size of player by 2;
			-- "Blow hir?":
				say "     [italic type]Author's note: more variants will be added as development continues.[roman type]";
				Project Figure of Priestess_hard_icon;
				LineBreak;
				say "     Eyeing up the subtle impression of your selachian siren's juicy cock cave straining against the glossy confines of hir form-fitting black bikini bottom, a muted hungry rumble flickers across your tough tummy scales at the heavenly memory of hir exotic flavor. You decide to show your bawdy priestess a measure of... oral affection as you confidently stride up to the amazonian creature, and commandingly hook your dominant pointer claw under hir chin. Delighting at the soft velcro-esque creak of your talon's scything reflective edges gliding across hir rough pebbled hide as you crane hir head upwards. 'Y-yes me heart, how may I'z be [']O service to ye?' shi gulps, tiny beads of sweat pouring down the side of hir muzzle as your ravenous golden gaze washes over hir lithe body. Smirking at the sight, alongside the enthralling scents of fear and arousal radiating from hir quivering body as you pull hir hale, yet pleasantly curvy body close. Relishing the succulent dissonance of your sleek lamina playing across hir coarse hide as your palms explore hir thin hourglass waist and toned muscular ass as you give voice to your desire, while motioning towards Arlene's bed with an imperial nod of your draconic head.";
				say "     'Aya, of course me dragon,' your priestess pants as you trace the honed edges of your nails about the pencil-thin borders of hir bikini bottom. Good girl, you rumble in a deep ophidian cadence as you withdraw your non-dominant hand from hir hips, and lead hir by the crook of your claw to the foot of hir bed. Swooning with a wordless sultry trill, shi seats hirself upon the soft, white, velvety sheets while she eagerly spreads hir legs to you in an open invitation as shi teasingly fans hir girthy finned tail in playful come hither gesture. Flashing the adorable creature a too-toothy grin, you kneel you before hir, and tuck your proud draconic muzzle between hir two-toned thighs, shamelessly indulging in the scent of hir hybrid arousal and tender little wave of goosebumps simmering across hir hide as the steamy wisps of your breath waltz across hir [one of]sleek[or]aquadynamic[at random] form.";
				WaitLineBreak;
				say "     You domineeringly slide the flat of your left pointer claw under the glossy black straps of hir cute little bottom and pull the thin lycra loop devilishly taut, eliciting a needy mewl from your cute little priestess's lips as the minute band digs into hir coarse flesh, creating cute little furrows in hir blushing curves of hir shapely hips. Till with one resounding [italic type]*twang*[roman type] hir suit tears along the seams, and the thin bit of nylon slips free of hir hybrid bounty. Tossing it aside with a quick flick of your wrist, you can't help but revel at the scrumptious sight of hir plush dick slit glistening in the ambient light while the twin tips of hir crimson spires peek out of their supple housing. Mh... delicious, you preen, letting your eyes briefly wander down the compact swell of hir petite ball bag as you affectionately tuck your muzzle to hir sex, gently lapping at the tactile borders of hir aquatic cock cave with the sleek little forks of your bifurcated tongue. Exalting in the exotic sapor of hir salty pre gracing your palate and the abyssal caress of your mates coarse hide playing across your dexterous tongue as you lovingly slip the tender peaks of your oral muscle betwixt hir lush dick slit.";
				say "     'Ah Tiamat's teats ya regal beastie, what manner [']O sea devil taught ya that trick?' Arlene coos, as your ophidian muscles cheekily coil about hir supple crimson spires with loving alacrity. You voraciously engulf hir receptive vent in the silky caress of your regal maw, rollicking at the preyish shudder passing though hir hale body as your gleaming fangs caress hir vulnerable flesh. You lovingly draw the forks of your prehensile tongue along the supple taper of hir cocks, delighting at the subtle thrumming of hir twin spires straining against your eager embrace and the generous trickle of hir futa pre seeping from their gossamer tips as you gleefully pamper hir tools with a loving deliberate slowness. All the while, your precious [if Intelligence is 2]morsel[else]priestess[end if] squirms beneath you as you hungrily alternate your attentions between the satin contours of hir respectable rods and your mate's exotic walls. Each vivacious pass evokes a sympathetic gasp or preyish shudder from the spellbound shark and an adorable little flex of hir toe-mounted talons as you slowly coax hir ";
				if "Touched by Madness" is listed in Feats of Player:
					say "twenty centimeter ";
				else:
					say "eight inch ";
				say "spire to full mast.";
				WaitLineBreak;
				say "     Your draconic mind can't help but bask at the heady echoes of hir pulse playing along the serpentine contours of your tongue as Arlene's delectable rods lasciviously rifle against the tight plush entrance of hir dick slit while you affectionately stoke their turgid forms, relishing every subtle gush if salty pre washing over your greedy maw. Until eventually their glossy crimson tips reverently brush the titillated edges of your expansive muzzle, basting your gustatory senses in a blissful sheen of hir hybrid juices. Smacking your lips, you lustfully press the succulently stiff, yet pleasingly malleable, taper of hir twin spires along the ridged roof of your maw as you endearingly bob your imposing draconic head about the silky length of hir rods. Internally rollicking at the gentle patter of hir heartbeat fluttering along your soft palate, as a duly pleased rumble of coldblooded satisfaction reverberates through your [bodydesc of Player] snoot as you drink in the mouthwateringly rich flavor pouring off hir twin rods. 'G-go-gods [']O da neath,' Arlene stammers, eyes roving skywards as hir prehensile pricks squirm ever-so-slightly in your oral embrace while shi writhes beneath you like a fish on a line.";
				say "     The coldblooded predatory side of your liminal mind revels at hir every needy little quiver and lustful pant as you lovingly massage your profoundly flexible tongue about the satin borders of hir delectable pricks in tandem with the lurid motion of your head. You roughly wrap your hands about hir waist, exalting at the exotic texture of hir coarse pebbled hide and the pleasingly shapely curves of hir athletic hips as you sink your silky pads into hir chiseled abdomen while fixing the enchanting siren with a smoldering look. Relishing every supple wobble of hir flush E-cups as they bob scant ";
				if "Touched by Madness" is listed in Feats of Player:
					say "centimeters ";
				else:
					say "inches ";
				say "from your animalistic muzzle with every deep lustful breath shi takes, as hir left hand drifts to the verdant swell of hir pillowy sweater puppies. Shi coyly works hir clawed mitts about their glistening curves, groping tender pawfulls of sensuous breast flesh with hir left hand, reveling at their plush weight and the ambient glint of your many eyes reflecting off hir perpetually lubed hide in a vast pinwheel of molten gold.";
				WaitLineBreak;
				say "     All the while, her free hand edges ever closer to your proud rack of sleek umbral horns, though never once do hir webbed mitts leave hir sheets. Impressed by hir restraint as shi eyes your lovely handlebars with obvious interest, you decide to allow your doting priestess the honor of laying hands upon your imperial horns. Go on, you gnar, letting the verdant vibrations of your voice and bestial ridges of your carnal maw wash over hir delectable tools while motioning to your swept-back onyx horns with a theatrical flick of your augmented tail. Nodding dreamily, your plaything hesitantly leans over you, letting hir shapely breasts cascade over your proud snout as shi takes hold of your head-mounted horns for support. The twisting hollows of your liminal mind can't help but feel some odd notes of draconic delight at your priestess's strangely commanding hold, as shi urges you on with unsubtle pistons of hir wrist along their glossy curves. The gentle caress of hir plush tits wallowing atop your proud scalie visage spurs you onward as you ravenously gyrate your regal muzzle about hir supple rods.";
				say "     A loving rumble escapes from the well-pleased selachian as shi works hir palm about your gleaming horns, as if urging you to take more of hir succulent spires. Another time, you might have felt a certain pang of indignation at being used in such a base fashion, yet the enchanting kiss of hir cocks throbbing and caressing your gluttonous maw, and the delectable sapor of hir pre stills such thoughts. A lustful fog creeps over your fracturing psyche as the lewd, voracious facets of your mind surge to the forefront as the roiling desire to taste Arlene's virile seed and wallow in the decadent warmth of hir load simmer across your elated palate. Your dominant hand languidly creeps about the toned hills of hir athletic thigh, rollicking at the exotic caress of hir toned muscles playing across your pads and the low aphonic creak of your talons catching upon the light grain of selachian skin as you trace your mitts along the verdant curves of hir loins, in a soft sensuous circut.";
				WaitLineBreak;
				say "     Savoring the cute little shivers passing through hir, and the heady sympathetic twitches of hir cocks roiling across your far-traveled palate, you masterfully draw the wondrous coils of your tongue about hir glossy rods all the tighter. All the while, your inquisitive digits gently brush the welcoming padding of hir compact ball bag, relishing the tender, needy, little pants of the lust-addled herm as she strokes your horns. You lovingly cup your silky paws about hir respectable package, admiring the gentle heft lazing in your palms while you lovingly jostle hir petite baby batter banks in your dominant hand like precious gems. Your sharp draconic senses are greeted by the coiling scent of feminine arousal tickling the edges of your senses, as a muted trickle of girly juices drips from hir hidden vent, then down upon hir carpet in a hushed tattoo, as the sultry selachian's neglected sex cries out for your attention. Chuffing under your breath, you slip your free hand beneath hir plush sack as you affectionately run your experienced digits about the balmy borders of hir supple muff while hir cushy cum tanks lightly caress your oily scales, reveling in the toasty kiss of hir fem honey cascading over your scales as you affectionately tweak hir eager aquatic button with your thumb and forefinger.";
				say "     Coyly working your dexterous digits about hir tender hood, you lavish the coarse tactile edges of hir joybuzzer with the gentlest of storkes, before carefully slipping a pair of glossy fingers between hir folds, exalting at the welcoming quiver of hir lust-flush petals cascading about your fingers as you gently jill hir aquatic muff with slow purposeful pistons. 'M-mh, more,' your plaything stammers, lightly squeezing hir chiseled thighs about the sides of your head in a shameless, animalistic display of base need. Chuffing in reply, you obligingly dip one then another of your free fingers betwixt hir succulent nether lips, delighting at the verdant kiss of hir plush flower gracing your immaculate scales as hir ravenous muff captures your inquisitive digits in their aquatic embrace. Hir cunt quivers ever-so-slightly with the loving dissonant motions of your and dextrous tongue as you alternate between the affectionate bobs of your regal muzzle and the tender jilling of your digits. Letting your every sensuous motion feed into itself in a heady whirlpool of carnal bliss, your amerous priestess's hybrid mind struggles to parse as shi wraps hir legs about your neck, and crudely rakes hir clawed [one of]peets[or]paws[or]pawbs[at random] across your back as shi urges you on.";
				WaitLineBreak;
				say "     Hir toned thighs sensually rifle about your imperial visage as shi roughly pulls your imposing maw all the closer to her dripping cock cave, filling your elated senses with the heady scents of hybird arousal as lustrous beads of hir exotic dew stream down the two-toned borders of hir slit. Dimly, you watch out the corner of your expansive vision as they leisurely stream about the coarse borders of hir pebbled hide as they lace hir compact sack then flow down to hir sweltering pussy lips, as hir fem-honey drips across the length of your inquisitive digits like a tropical tide. All the while, the worshipful throb of hir pulse roiling through hir twin spires plays about your eager ridged muzzle, you cheekily slip the tender edges of your ophidian tongue about the turgid contours of hir squirming cum veins in a serpentine spiral till their bifurcated tips glide about the balmy borders of hir dick slit. Enticing a lewd little needy selachian mew from your priestess's lips, as your prehensile tongue ravishes the tight dewy folds of hir delectable vent with sensous slithering laps.";
				say "     Thin rivulets of drool pools from the edges of your maw at the heady sapor of hir hybrid juices serenading your senses as the needy herm mews broken words of delight encourgment to you. Your experienced digits masterfully lavish hir elastic muff with quick enthralling strokes as you nearly hilt your massive paw to the wrist in hir writhing passage, all the while your thumb and pointer finger reverently minister to hir stiffening button with gentle, eclectic tweaks. Stammering in a lust-addled tenor at your caring caress, you can sense a rigid, yet not wholly unbidden tension flowing through your priestess's aquatic form as hir toes dig ever-so-slightly into your tough opalescent scales. Hir plush compact cum tanks churn in the velvety embrace of your supple palms as shi roughly presses your snoot flush with her cock vent before loosing a bestial cry of release as shi cums, basting your receptive palate in twin jets of salty delight. Though nowhere as impressive as the loads of some of the larger creatures, the mouthwateringly rich sapor of seed laced with the intoxicating tang of hir aquatic juice evokes an affectionate little purr from your majestic lips as you lovingly suckle the tender little droplets of hir pearly offering.";
				WaitLineBreak;
				say "     The vibrant echoes of hir climax and your own resplendent touch wash over hir puddling snatch as Arlene's aquatic muscles spasm like a loose line in a squall as hir well-loved muff gushes a subtle trickle of molten honey as shi finishes. Then collapses onto hir bed with a sated huff, muttering, 'Yar, by da lady, I'z needed dat!' as shi looses hir hold on your neck and lets hir legs crash against the foot of hir bed with a light *thud*. Rumbling happily in reply, you withdraw your skillful digits with a theatrical toe clenching flourish, and leisurely tilt your gaze upward as you watch your lovely plaything idly massaging hir blushing middle. Before rising to your full imperial height with a contented gnar at this adorable spectacle of your lover in languid repose, and the soft warmth of hir load wallowing in the pit of your stomach. 'Course it do be looking like ye be enjoying yer self too, me heart,' Arlene titters, lightly brushing hir tail against your sleek flanks.";
				say "     Perhaps, you quip while making a show of licking your cum-slicked chops clean. Its not like you didn't get something out of this too, you add, flexing your dew-dripped arm before yourself while you vivaciously lick a few of the errant droplets off your wrist. 'Da un I'z be happy to be providing yer loveliness, doe I'z think I could be doing with a wee nap now. If in dat be alright with ye, me dragon,' Arlene hums as stretches out on hir bed. Nodding with an earnest toothy smile, you bid hir rest then as you turn on your heels and quietly trot back out to the Main Hall.";
				NPCSexAftermath Arlene receives "CockOral" from Player;
				NPCSexAftermath Arlene receives "Stroking" from Player;
				Move Player to Dragon's Causeway;
			-- "Sit on hir face?":
				if Libido of Arlene >= 1 and Libido of Arlene < 12:
					say "     Enjoying the sight of your priestess's budding maternal glow, and the scrumptious swell of hir cute little tumby gently lazing just below hir waistline, ";
				else if Libido of Arlene >= 12:
					say "     Indulging yourself on the heady spectacle of your plaything's glimmering motherly radiance, and the vast pillowy curves of hir plush lap-filling middle wallowing well past hir knees, ";
				else:
					Project Figure of Priestess_hard_icon;
					say "     Letting your many eyes waltz about the toned curves of Arlene's athletic swimmer's physique, ";
				say "you feel a sudden urge to enjoy some oral appreciation with your sultry siren as you paw up towards hir. Quietly delighting at the soft click of your talons upon the cold stone resonating through the air, and spiraling reflections of your molten gaze refracting across hir selachian form like motes of frozen golden starlight cast upon the slate walls. You hook the crook of your dominant pointer claw about the thin center string of hir bikini top, giving the wafer thick band a casually tug as you pull hir close, purring your lustful desires to the bawdy herm in a soft ophidian trill. 'Mh, course me heart,' Arlene hums, as hir [if Libido of Arlene < 12]tender E-cups[else if Libido of Arlene >= 12]flush and ripe G-cups[end if] are drawn into an adorable heart by the glossy ebony fabric cinching about hir flush breasts. While the light velcro knell of your talons gliding across hir coarse hide echoes throughout hir quarters. Good girl, now, you pause, idly flicking your blades skywards, severing the delicate cord, and letting hir supple sweater puppies slip free of their crude housing with a pronounced, carnal wobble.";
				say "     As its remains fall to the floor beside hir, you angle the flat of your claw against hir chin and tilt hir head towards an open patch of carpeted ground, gnarring, sit. 'Aya-Aya me dragon,' Arlene hums enthusiastically, hir finned tail wagging behind hir like an eager puppy as ";
				if Libido of Arlene >= 1 and Libido of Arlene < 12:
					say "shi cutely rests hir hands upon the adorable blushing hem of hir tight eggy belly, then sashays over to the center of hir room and languidly drapes hir resplendent form across the silky smooth carpet with a playful flourish. 'Ah, feels good ta get off me feet,' your gravid playmate coos, stretching out before you while playfully flexing hir paws in a show of base contentment. Smirking at your bawdy lover's wondrous full repose, you can't but tell how cute shi looks like this, with a velvety chirp as you paw up beside hir. You reverently reach out with your dominant forepaw as you lightly rub your silky mitt about the supple hem of hir blushing bump while complimenting your priestess on hir progress thus far. Why, you hum in simple admiration of the coarse firm curves of hir ample tummy. It won't be long till shi's ready to pop at this rate, you tease lovingly circling a talon along the adorable little, puffy navel. 'Da your worshipfulness be too kind, doe I'z can'ts say I'z not gonna miss this,' shi swoons, clutching hir paws to hir flush flanks as shi dreamily strokes the faint little outlines of your spawn, peaking through hir maternal padding.";
					WaitLineBreak;
					say "     Chuffing approvingly, you reassure your budding breeder that you won't let hir suffer too long without another clutch to keep hir company. 'Daw, ye be spoiling me, ya regal sea devil,' Arlene simpers, leaning into your touch as the once subtle blush simmering across hir developing middle spreads up hir cheeks as shi takes hold of your paws and lovingly caresses your supple pads with hirs. Almost beaming at hir antics, you tell hir that it's hard not to, not when shi looks so beautiful like this, and the rewards waiting for you both are so close, you almost can taste it. 'Yar-har, now dats da spirit me dragon, I'z news from ta moment I'z laid eyez on ya you un I'z were destined fir great un terrible things! Now come on, un get ya wondrous muff over [']ere!' Arlene crows, roughly slapping hir tail against the carpet in a bawdy display as shi lightly tugs on your leg.";
				else if Libido of Arlene >= 12:
					say "shi tenderly wraps hir paws about the ripening curves of hir ponderous middle with an elated coo as hir fingers sink into the generous layer of tigerstripe-laden padding gracing hir fecund form. Already, you can smell the coiling scent of hir hybrid arousal filling the air at the sight of the succulent furrow cast by hir webbed mitts and adorable little ripples in hir blushing core. The once rosy red hues of hir pleasantly plump tumby gives way to soft off-white outline of hir webbed digits as shi hefts hir tummy off of hir lap while shi waddles to the vacant section of carpet. Though somewhat laborious given the regal size of your spawn in comparison to their compact mother, you can't deny that there isn't a certain hypnotic grace to hir movements as hir plush mounds and curvy love handles wobble enticingly with every step. Alongside the proud vivacious grin blossoming on hir tapered snout as shi drinks in the sight of hir titanic brood while shi cautiously eases hir self to the floor.";
					WaitLineBreak;
					say "     'Oh by da gods of da neath, I'z really needed this,' shi groans, draping hir curvaceous form across the supple carpet with a tired sigh. 'Still,' shi murmurs, watching a tender not-so-little ripple pass through hir well-padded womb as shi lays back with a soft relaxed sigh, resting hir head upon the soft fuzzy hides decorating hir room. 'I'z be lying if in I'z didn't saying da sight [']O your wee ones don't be bring a smile to me face,' Arlene coos, leisurely drumming hir tail along the gleaming curves of hir evermore motherly figure. Chuffing in coldblooded amusement, you stride over to hir side and lovingly brush your dominant forepaw about hir lustrous middle as you voice similar sentiment. After all, few could blame your priestess for enjoying the fruits of hir labor, especially when the rewards are so vast. 'Da, spoken like a true sea devil, doe a part [']O dis ol['] blackguards hearts hopes ta stay like dis just a wee bit longer,' shi purrs with a contented little coo, as you trace your talons about the burgeoning swell of hir cute, puffy outie.";
				else:
					say "shi sashays past you with a purposeful seductive waggle of hir hips, that brings a lustful rumble from deep within your draconic breast as you shamelessly admiring the subtle ripples of hir powerful muscular thighs, and tight, toned athletic ass. While the sensual shimmer of the lantern light streaks across the sleek contours of hir hide as shi struts towards the center of the room. You watch in mild amusement as Arlene leisurely drops hirself down to all fours, flashing you a deep ravenous grin as shi arches hir back to better highlight the sordid outline of hir well-used cunt and compact package staining against the confines of hir bikini bottom while shi traces the tips up hir tail fins about the edges of hir hybrid camel toe. Before rolling onto hir back, and motioning your forward with a come hither wave clawed mitts, rumbling in a proud bawdy tone, 'Come on then matey don't keep me waiting.'"; [merge here] [Note to future Sunder: Fix the WaitLineBreaks;] [To past and later future Sunder: Done?]
				say "     Delighting at hir enthusiasm, you carefully paw over hir prone figure as you line up your lustrous [cunt size desc of Player] passage with hir bestial muzzle. Briefly letting the soft balmy echoes of hir lustful breath gently caress the proud muscular contours of your hindlegs and perpetually-lubed borders of your tauric snatch. You dexterously lower yourself into a bestial sitting position while the adorable little pants of your plaything seranade your ears. You find it hard not to enjoy the welcome kiss of hir snout brushes your tough, yet unerringly sleek opalescent scales, and the coarse edges of hir muzzle brush your cunny scales as the supple borders of your muff bristles at hir touch. Now, lick, you gnarr in a pleased coldblooded brassy trill, pressing the lust-flushed lips of your draconic flower against hir snoot in primal glee as your mate's sensual pebbled hide teases your fertile lips. Humming in turn in a soft sultry cadence, your plaything eagerly leans into the warm welcoming embrace of your supple box. Sending a heady shiver up your spine at the exotic of hir hide lavishing your glossy lamina, and the tender laps of hir inhuman tongue as draws hir oral muscle about your folds in a slow enthralling circuit.";
				WaitLineBreak;
				say "     Almost swooning at the dissonant caress of hir selachian affection, you rock your powerful haunches in tandem with each doting flick of hir beastly tongue while your fuck-hungry walls hug the near-bestial taper of hir oral muscle. Your aquatic muff, gushes a soft trickle of girly draconic juice down the side of Arlene's hydrodynamic visage as hir tongue lovingly waltzes about your scales. 'Mmh delicious,' shi purrs, pressing hir snoot all the deeper against your elastic flower as shi slips the warm silky tip of hir tongue along the edges of your clitty hood with reverent aplomb. Eliciting a duly-pleased rumble from your draconic lips as hir nearly prehensile tongue coddles your oh-so-sensitive joybuzzer in a blissful sonnet of saturnalian sensations. While Arlene shuffls beneath you, coyly tilts hir head to one side, and leisurely engulfs your throbbing button in the tropical embrace of hir predatory maw, setting your senses at coiling silky softness of hir oral muscles pampering your clit with abyssal celerity.";
				say "     Slithering motes of static bliss flicker about your folds as hir cunning tongue dances across your lustful passage like bolts of unbound lighting arcing about a ship's hull. While the razor edges of hir gleaming fangs decadently brush your dainty petals as shi nurses your scalie button like it were hir own sweet treat. Ah, such a needy pet, you pant, feeling your expansive sail ripples at hir touch, as your sultry siren playfully nibbles your impregnable scales, sending fresh sparks of predatory pleasures roiling through your supple sex. Though your insatiable tauric form soon cries out for more, unwilling, or unable to resist your liminal body's needs, you greedily press more of your imperial weight upon hir snout. Purring in lewd delight at the muted gasps emanating from hir muzzle as your ravenous cunt devilishly glides over hir yearning maw like a living muzzle. Perhaps sensing your intent, Arlene almost mournfully withdraws hir satin tongue from your tender button, while working hir snout into a more convenient angle. Your sopping walls spasm delectably at the lurid kiss of hir salacious hide innervating your verdant cunt as your sordid sex engulfs hir sleek visage.";
				WaitLineBreak;
				say "     Your tender flesh is pulled fiendishly tight by the salacious kiss of hir snoot straining against the abyssal hold of your [cunt size desc of Player] cunt as you roughly piston your hips like a dragoness possessed. The air echoes with the cute submissive whimpers from your spellbound morsel's lips, though you pay them little mind, as your elated senses are too focused on the fervent attention paid to your divinely taut petals. As Arlene lavishes your spasming passage with the tenderest strokes in an intoxicating whirlpool of desire. Hir skillful laps flawlessly flow between your neediest nerves as if shi has a road map of your tauric passage. Meanwhile, you twerk your feral flanks along the pleasingly coarse contours of hir sleek, perpetually-lubed muzzle, delectating at the exotic interplay of succulent sensation rippling through your [bodydesc of Player] core. Hopelessly enraptured by the bubbling bliss coiling through you, and the ravenous, nearly unquenchable need roiling about your tainted mind. You instinctively flare your glorious wings outward to aid your balance as you piston your flanks all the quicker.";
				say "     Wallowing in the heady rush of dominant delights simmering through your liminal being, your paws are soon drawn to the ";
				if Breast Size of Player is 0:
					say "pure glimmering contours of your washboard chest. Unencumbered by the oft times disgusting trappings of your former mammalian self, your smooth, immaculate core masterfully suits your draconic sensibilities, and coldblooded abyssal splendor than any foul udders ever could. You muse, indulgently running your clawed mitts about the stately toned borders of your reptilian torso in unvarnished elysium at the sensation of raw, primeval power rippling through your imperial physique as you lovingly trace your scything talons across the divinely articulate muscles decorating your illustrious form. To think many of the lesser [one of]scalies[or]false-wyrms[or]lizardkin[or]endotherms[at random] slumming it in your future dominion would dare deny themselves this heavenly pleasure by cultivating such grotesque monkey mounds, you preen internally."; [My dudes, I'll be real here. I have no idea fucking how to write flat content, or even what the appeal of no/small breasts is. Hence, I'm defaulting to the PC thinking tits on a lizard are gross *shrugs*. Any suggestions on how I can make this better?]
				else if Breast Size of Player >= 1 and Breast Size of Player <= 4:
					say "tasteful curves of your [breast size desc of player] breasts gracing your two-toned tauric torso. Both pleasantly ripe and sensible sized, your shapely sweater puppies match not only your motherly disposition, but the regal athletic profile of your tauric form. You ruminate, playfully cupping your scalie mitts about their lustrous swell, delighting at the gentle airy weight of your assets resting in your palms and faint bounce of your imperial mounds accompanying your every potent piston gracing your tactile senses. You lovingly tweak your stiff, perky pearly nips between your thumb and forefinger as you lovingly pamper your resplendent tits with reverent and selfindulgent motions. All the while, the low, nearly imperceptible, sloshing of your cream serenades your ears as you playful caress the petite mounds in your caring paws.";
				else if Breast Size of Player >= 5 and Breast Size of Player <= 12:
					say "heavenly hills of your resplendent rack adorning your proud tauric form. Flushed with delectable cream and soft, welcoming padding, most humans could barely even fit the hands about the glorious swell of your [breast size desc of Player] chest. Yet, as you run your glossy paws across their glossy well-lubed curves you can't say you wouldn't enjoy watching them struggle. Besides, your form-fitting tits are the perfect accent to your growing maternal splendor, and a priceless gift to your flight. You muse, playfully fluffing the silky curves of your milky mounds, while the audible churn of your divine cream regales your ears as your webbed digits eagerly grope vast pawfulls of regal breast flesh. You find it hard not to smirk at the sight of your pillowy sweater puppies spilling through the tiny gaps in your fingers, and the all too pleasant sensation of your imperial mounds lazing in your grasp. Alongside the succulent caress of your stiff teats greeting your pads as you reverently massage your oh-so-productive teats with slow endearing strokes.";
				else if Breast Size of Player >= 13 and Breast Size of Player <= 19:
					say "ponderous swell of your prodigious milk tanks, bouncing before your elated eyes at the slightest provocation. Even though your titanic mitts could never hope to contain their fecund majesty, you nevertheless enjoy the attempt as you cup your paws about their heavenly equators. Exalting at the supple indentions cast by your webbed mitts as your fingers effortlessly sink into their malleable mass, a part of you can't but smile at their size and the thought of their priceless bounty straining them all the tauter. As you tenderly heft their plush mass into the air, before letting them fall, and watching this sensual ripple passing through your ripening cream fountains as the decadently jostle before your eyes. Marvelous, you preen at the thunderous sloshing of your divine milk reverberates through your priestess's chambers.";
				else if Breast Size of Player >= 19:
					say "mountainous mass of the massive mammoth mammeries, bejeweling the lustrous idol of draconic fertility you've become. Every ripple and decadent ";
					If "Touched by Madness" is listed in feats of Player:
						say "centimeter ";
					else:
						say "inch ";
					say "of your maternal milk tanks is a priceless reminder of your commitment to providing for you spawn and your budding divinity. Yet as heavenly as your [breast size desc of Player] breasts are, some section of your motherly mind still isn't satisfied with these wondrous proportions. Not when you could achieve so much more, you think to yourself as you reverently grasp plush pawfuls of ever-ripe flesh at the thought of sharing this rich fare with your young. Mmh, the babies will love this, you whisper under your breath, relish the silky padding caressing your palms as your mitts sink into the downy swell of your plush rack, creating the most delectable of furrows in your opulent breasts.";
				WaitLineBreak;
				if Cock Count of Player >= 1:
					say "     Dimly though, you can feel the sublime kiss of Arlene's dexterous tongue coursing through your [bodydesc of player] form while the tender pulse of abyssal rapture washes about your core like ripples on a still pond as your needy neglected cock rifles against the supple walls of your draconic slit. With every worshipful simmering lap of hir cunning lingua ravishing your spasming walls and the loving dangle of hir muzzle gracing your sopping box, your [cock size desc of Player] ribbed spire swells within its velvety housing. As your proud tool slowly surges to life, drawing a plaintive, yet needy, rumble from your lips as your rod languidly slips free of your opulent slit, amid a salty spurt of reptilian pre. You can only swoon at the abyssal kiss of your satin vent hugging the beastly ridges of your tool with every virile throb of your hybrid sex, and the cool temple air waffling along its tapered splendor.";
					say "     Unable to resist the clarion call of your turgid tool, you carefully shift your weight to one side before reaching back with your dominant forepaw, yet your caring plaything simply brushes your paw aside, tutting, 'Da no need fir dat me lovely, I'z got ya,' between affectionate laps of your spasming muff. Chuffing at hir boldness and loving zeal, you reorient yourself and almost swoon while your well-mannered priestess eagerly takes hold of your throbbing tool with hir left hand, humming, 'Goddess yar a right proper beast me heart,' worshipfully running hir palm along the graceful curves of your ridged tool. Earning hir a vivacious rumble as the satin webbing of hir mitts caresses the oh-so-sensitive fleshly plates of your draconic spire as shi pampers your royal rod with a decadent dandle. One set of your molten golden eyes slowly tilting skywards as hir supple pads caress the tender tiers of your titillating tool as shi massages your throbbing cum vein between laps of your puddling flower.";
					WaitLineBreak;
					say "     Hir unoccupied mitts glide about the lust-flushed lips of your moist vent, endearingly tracing hir claws along the tiny borders of your scales before slipping hir fingers between the elastic folds of your dick slit as shi teases your plump aquatic knot. 'Goddess, me dragon, how do ya keep yer hands off dis monster?' Arlene crows, gleefully running hir fingers about the lascivious indentations cast by your regal gland, slyly slipping one then another of hir dexterous digits between the elastic lips of your cock cave. Enchantingly lavishing your devilishly sensitive folds and stiff bulbous knot with languid strokes that sends your already oversexed mind reeling with carnal ecstasy as the doting attention paid to your hybrid sex nearly pushes you over the edge. Yet you rail against the all-too-familiar tension welling in your core, desperate to eke out just a few more moments of heavenly satisfaction with your mate.";
					say "     All the while, the expert touch of Arlene's nimble tongue fellating your joybuzzer, and the succulent caress of hir pleasingly textured hide serenading your petals, alongside the skillful caress of hir eager mitts pampering your spire and juicy vent jockey for prominence in your tainted mind. Almost gushing like a blushing maiden, your puddling mind struggles to parse each lurid motion of your plaything's paws lavishing your spire, and succulent pulses of hir tongue flickering across your muff as the hybrid sonnet of bestial bliss soon bleeds together in a abyssal squall of hybrid rapture. The roiling tension budding in your breasts grows too compelling to ignore as fleeting motes of many colors and none drift across your expansive field of view. Your once metered pistons become all the more wild and untamed as the bestial side of your increasingly insatiable psyche surges to the forefront. You loudly thump your haunches upon Arlene's angular snoot reveling in the saturnalian sparks of static delight coursing through your expansive muff as she lavishes your innermost depths like a herm possessed. Despite your rough treatment, your mate never once shirks from hir zealous ministrations. If anything, your lewd priestess seems to be enjoying your shameless animalistic antics.";
					WaitLineBreak;
					say "     As the worshipful tattoo of skillful paws surges to meet your body ravenous demands, you nearly cry out in draconic rhapsody at the feeling of your glossy cock ridges caressing hir palms while shi pampers your throbbing knot in an enchanting circuit. Till the effervescent symphony of delights pushes you over the edge as you throw back your head, loosing a proud earth shaking roar as you cum. ";
					if Ball size of Player >= 4:
						say "Your ponderous balls audibly churns with excess as [cock size desc of Player] cock erupts in a pearly torrent of draconic seed. Your elastic cum vein and imperial spire strain against your priestess's caring grasp while you baste hir adorable body in a vibrant deluge of toasty spunk. Arlene coos in pleasant lustful trill at the beautiful caress of your load washing over hir prone form, you watch out of the corner of your eyes at the heady spectacle of the shimmering sheen of alabaster cum seeps across the carpet, then down the floor towards the main hall like a creamy tide. The elated voice of your followers soon ring in a mix of alarm and arousal at sight of your offering surging down the hall main, then southward toward the Moon Pool, dripping into the sea with a titillating ivory patter.";
					else:
						say "A modest, yet relieving quiver flickers across your fins as the heady forces of your petite load roils through your majestic form as you lightly drench your plaything in a subdued spurt of alabaster seed. Arlene chuffs in playful amusement as shi lovingly strokes out the last few droplets of your sensibly sized offering.";
					say "     The enthralling erotic reverberations of your resounding climax washes over you in a mind numbing cascade of futa bliss, as your [cunt size desc of player] cinches about your doting priestess's angular snout, your duly-loved muff ripples with rapturous satisfaction. Sparks of sinfully sweet sensation roil through your tauric tunnel as your hungry muscles glide along hir muzzle in a slow tapering metronome, while a sordid trickle of your girly juices peter across hir pebbled hide as resplendent chorus of your feminine release entwines itself with heady afterglow of your masculine climax. Spent and sated, you can feel your tauric legs wobble ever-so-slightly as your tenderly rise to your full majestic height, yet your pride compels to keep your composure even as the vivacious caress of your priestess's tactile hide pampers your ecstatic folds. While you languidly unentangle yourself from Arlene, relish the parting kiss of hir pleasantly bumpy and well-lubed hide as you carefully sashay past hir.";
					WaitLineBreak;
					if Ball size of Player >= 4 and Libido of Arlene >= 12:
						say "    Your many eyes are greeted by the hedonistic sight of your hopelessly gravid mate's seed soak body as shi shamelessly runs hir web paws about the glimmering folds of hir ponderous middle, humming. 'Mmh now dat feels good,' as shi playful massages the shimmering sheen of pearly perfection into the taut rosy curves of hir lovely tumby. 'Criben un just look at da way yer seed be sparkling ya regal beast, [']tis like I'z bathed in moonlight,' shi simpers appreciatively, leaning into the subtle rays of hir lanterns as the soft bone white glow dance upon hir well-seed form. Smirking at the sight, you kneel down beside hir and lovingly kiss hir fem cum stained lips, while telling hir how precious shi looks right now. 'Da ya be spoiling me with dem kind words me dragon, still it do me shame to let so fine a fair go ta waste. Side ya ones un I were getting might peckish,' shi rumble, casting hir eyes toward the alabaster river of cum flowing down the main hall as plaintive growl roils across hir flush tum.";
						say "     Loosing a soft chuckle, you tell hir to worry, you'll have the humans bring hir, and your slumbering spawn something to eat. And of course, you add, motioning to the soaked carpet with a regal bob of your head, clean up this mess. 'Oh bless ya me heart, much as I'z love our little sea devils [']ere,' shi pause to affectionately drum hir along the plush edges of hir ripe middle. 'They be a right ravenous lot of scallywags, still,' shi purrs carefully nuzzling hir tail about the slumbering forms of your brood. 'I'z wouldn't trade anything fir all da joy, and power they bring me,' shi crows as subtle motes of many colors and none dance across the edges of hir eyes. Good girl, you preen, giving hir an endearing pat on the head while you commend hir attitude. Besides what's a few hunger pangs compared to the gifts that await you both, for in time worlds may bow at your paws, the riches of untold realities will decorate your halls, and legions of mighty wyrms will stride forth yours, and the goddess's name.";
						WaitLineBreak;
						say "     'Yar, I'z loves it when ya talk like dat me dragon,' Arlene pants in covetous trill as shi greedily gropes vast pawfull of fecund futa flesh. 'Ta think me wee ones az such marvelous destiny a head [']O dem. Doe,' shi titters as hir webbed digits sink ever-so-slighty into the balmy folds of hir blushing middle, 'fir da moment I'z think I'z settle for a bars.' Arlene murmurs as deep voracious, yet angry growl echoes from the pits of stomach, 'er,' shi blushes, casting a guilty glance towards the larder, 'best be making dat a few dozen bars [']O dat white chocolate they'z got squirlled away. If in you'd be so kind me heart.' shi mews. Of course, you beam, good breeders like hir deserve the chance to indulge from time-to-time. 'Bless ye yer regalness,' your priestess coos, as you draw yourself to full height and prowl out the door. Then bellow your commands to the nearby gaggle of humans drifting through the halls to gawk at the steadily thinning stream of seed running through the foyer. 'Yes mistress!' they cry in union, flashing you the two-headed dragon symbol, before darting off and leaving you to your own devices.";
						NPCSexAftermath Player receives "OralPussy" from Arlene;
						NPCSexAftermath Player receives "Stroking" from Arlene;
						Move Player to Dragon's Causeway;
					else if Ball size of Player >= 4 and Libido of Arlene >= 1 and Libido of Arlene < 12:
						say "     Your molten gaze is met by the scrumptious sight of your blush priestess's well-glazed body lounging in a regal pool of your potent load as shi playfully traces hir clawed digit in languid spiral across the shapely surface of hir cute little eggy belly. 'Goddess me dragon ye should bottle this stuff,' shi swoons, basking in the gentle shimmer of the lantern light playing across hir two-toned hide. '[']Tis feels like the rays of holy zun warming the depth [']O me old black heart.' shi purrs, absentmindedly running hir paws down the athletic contours of hir tight swimmers legs, slathering hir tender form in your gracious offering. Chuffing, you amble up beside hir, and level a quick series of kiss down the nap of hir neck, delighting at the coiling scent of pussy lingering on hir lips, and the salty tanging of seed roiling about hir. While you voice your approval of performance and fervent appreciation of your offering. 'Da think nutt'en of it ya beautiful beastie, I'z be more den happy to serve as our lady commands.' Arlene mews, dreamily as mote of many colors and none briefly flicker across hir selachian eyes.";
						say "     Good girl, both you and the goddess are both very proud of hir work thus far, and in time hir devotion will lead to the sweetest of rewards. You preen, leaning down to kiss the tender curves of hir flush chest. For one day soon, this world, and countless others along with all their treasures will kneel at your paws and adorn your temples with their grandeur. 'Yar-har, ya really know how ta sweet talk me ya lovely sea devil,' Arlene crows, as shi leans into your loving touch. Snickering, as your lips brush the adorable swell of plush middle, you tell hir it's hard not to, not when shi looks so cute like this. 'Ya be too kind yar regalness, course not's that's I'z blames ya, a body like dis deserves a might touch of worship don't ye agree?' she hums, arching hir back to better highlight hir condition. Of course, you rumble, enjoying the sight of hir gleaming curves and scrumptious swell of your eggs rounding out hir lush profile. 'Da I'z glade ya think so me dragon, cause I'z think this look be growing on me,' shi chuckles, giving hir tummy an affectionate pat with hir tail.";
						WaitLineBreak;
						say "      Nodding, you can't help but voice your enthusiasm for hir attitude, though as your expansive gaze drifts toward the pearly lake of salty seed pooling about hir chambers. You wonder aloud if perhaps you should summon your followers to come and clean up. Enjoyable as it may be to see hir wallow in your draconic virility, a favored mother of your spawn deserves finer conditions. 'Aya me dragon, say would be a right-[']N-true mate un grab some [']O da pig skin den, I'z would me self but...' shi hums, voice petering out to a contented sigh as shi lewdly rubs another generous layer of alabaster cum over hir tight athletic form. Shrugging as the lingering afterglow of your climax simmers through you, you decide to indulge your pet's request and swiftly rise to your full imperial height. You strut out the door, then bellow your commands to the nearby gaggle of humans drifting through the halls to gawk at the steadily thinning stream of seed running through the causway. 'Yes mistress!' they cry in union, flashing you the two-headed dragon symbol, before darting off and leaving you to your own devices.";
						NPCSexAftermath Player receives "OralPussy" from Arlene;
						NPCSexAftermath Player receives "Stroking" from Arlene;
						Move Player to Dragon's Causeway;
					else if Ball size of Player >= 4 and Libido of Arlene is 0:
						say "     Your abyssal eyes are met by the lascivious spectacle of your cum drenched priestess, playfully bobbing on a near ankle deep lake of your pearly seed, humming. 'By Salt and Storm me dragon ya should be careful where ya point dat cannon of yers, why ya could put more den a few eyes out.' as shi idly floats upon the salty";
						if "Touched by Madness" is listed in Feats of Player:
							say "centimeters of toasty cum ";
						else:
							say "inches of toasty cum ";
						say "filling hir chamber. Chufffing, you tell hir you'll try to keep that in mind, as you lean down and offer hir your hand. 'Da no thanks me lovely, I'z kinds [']O like da why dis feels on me skin, [']tis baskin in [']ol Sargasso,' Arlene purrs, teasingly splashing a generous arm full of your toasty herm milk over hir curvaceous form. Shrugging and in no mood to question your toy, not when shi looks so content. You merely lean down and give your precious priestess a soft kiss on the snoot, while informing hir you'll go grab some of the help to come clean up. For much as you might like to allow your pet to enjoy hirself, the two of you still need to maintain some measure of decorum.";
						say "     'Da ya be right me dragon, can't have the place be looking all squalid like,' Arlene huffs, a tad dejected while childishly thumping hir tail against the soggy carpet, sending a sultry spray of frothy nacre white across hir chambers. 'Still no saying I'z can't be enjoying me self till da pig skins get to mopping.' shi giggles, indulgent fanning hir arms wides while shi drifts upon the mini pound of alabaster cum. Of course, you reply in a good-natured cadence buoyed by the lingering motes of your explosive climax fluttering through you. Before turning on your heels, you strut towards the main hulls and flag down several members of your cults gawking at the mini river flowing through the caverns with a potent blend of lewd desire and awe. Calling them to attention with a quick snap of your fingers, you bellow out your orders to the tiny warmbloods, then watch with reptilian delight as they hop to attention. 'Zu'u aam ol faal hen klovve uth!' they chant in union, flashing you the two headed dragon symbol before scurrying off, leaving to your own devices.";
						NPCSexAftermath Player receives "OralPussy" from Arlene;
						NPCSexAftermath Player receives "Stroking" from Arlene;
						Move Player to Dragon's Causeway;
					else if Ball size of Player < 4 and Libido of Arlene is 0:
						say "     Your draconic eyes are treated to the adorable sight of your amazonian priestess casually brushing aside a few errant drops of your pearly seed that dared to marr hir selachain midriff while shi lick hir chops in base contentment. 'Mh delicious as always me dragon,' shi purrs, stretching out before you. 'Doe yer aim could use some work,' shi adds in a loving, yet teasing tone, gesturing to the thin streaks of glimmering cum emblazoned upon hir chiseled yum gutter. Oh really, who says you weren't right on the mark? You rumble, buoyed by the lingering effervescent bliss of your coupling. You paw up beside hir athletic form, you kneel next to hir, and tenderly draw your snout along hir toned six pack. Though a worried look briefly flickers across hir muzzle at the sight of your barbed fangs, hovering so close to hir vulnerable yet invitingly creamy abs. Hir unease soon vanishes as you flash a ravenous, yet playful sidelong glance, while drawing your bifurcated tongue along the rough pebbled contours of hir lithe core as you lap up the lingering droplets of pearly dew from hir rosy tum.";
						say "     '*Ha-ha* oh cribens that tickle ya naughtly sea beastie!' Arlene giggles, in sweet surprised girly tune, as shi cutely wriggles beneath you. You glide your ophidian muscle up along hir tight core, as your prehensile tongue dances its way up and over the soft blue-grey hills of breast and gleaming pink peaks of nips, till your lips meet and kiss hir salty muzzle. 'Ah ya cheeky monster,' shi coos, cupping hir paws to the side of your head as shi fondly strokes your ear. 'Ye really know how ta spoil a 'girl' when da mood strikes ya,' shi adds, as hir claws lovingly traces the tiny borders of your gleaming scales. Perhaps, but obedient pets like hir deserve to be rewarded from time-to-time, you rumble, lightly nuzzling your proud visage against hir paws before drawing yourself up to your full majestic as your attention back to the more immediate concerns of your cult and coming ascension.";
						NPCSexAftermath Player receives "OralPussy" from Arlene;
						NPCSexAftermath Player receives "Stroking" from Arlene;
					else if Ball size of Player < 4 and Libido of Arlene > 12:
						say "     Your regal gaze is graced with the resplendent sight of your hopeless gravid mate pawing at the subdued little sheen of your draconic seed dripping down hir cute not-so-little outie. 'Mh now dis feels good me heart,' Arlene purrs, running hir cum slicked palms over the bountiful curves of hir well egged middle in a carefree circuit. 'Why,' shi adds, casually slipping a hir fingers between the toasty fold of hir deepening lovehandles, shi slathering hir rosy tum in a wafer thin sheen of your peerless seed. 'I'z uz half a mind to bottle dis [']ere tonic fir later. Goddess willing, dis might fetch a fine price on the mainland.' Chuckling at the notion and the parting echoes of your climax, you teasingly tell hir that might not be a bad idea, who knows you might even attract a few new cultists that way. 'Yar-har-har, mayhaps your worshipfullness, doe I doubt them poor boyos could afford to entreat so fine a boon from such a devilish beastie as yer self!' Arlene gaffas with hearty laugh, sending cute little ripple through hir plush middle as hir bawdy voice echoes through hir chambers.";
						WaitLineBreak;
						say "     'Still, I'z might be up fir un-utter pint of dis elixir, assuming that is dat, yer loveliness deems me worthy [']O such favor.' shi purrs, as shi stretches out before you, basking in the shimmering motes of light playing across hir lush body. Making a show of admiring hir blushing baby bump and ripe, milky tits, you inform the bawdy siren that you'll consider it, after all she makes such a good little cock polisher, it's only fair you treat hir from time-to-time. 'Da ye be spoiling me, me dragon,' your priestess hums, in a dreamy trill, tucking hir arms behind hir head, while hir tail lovely roams the beatific swell of plush rosy middle. Rumbling happily in reply, you tell its hard not, especially when shi looks so adorable like this. 'Aya, the sight [']O yer wee ones be growing on me by day,' shi mews, reverently hugging hir oceanic middle with proud glint in hir eye as webbed fingers sink ever-so-slighty in the soft padding of effulgent tum. Grinning at hir words, you spare hir supple form one last loving glance before excusing yourself and returning to the important matters of running your cult or exploring the city.";
						NPCSexAftermath Player receives "OralPussy" from Arlene;
						NPCSexAftermath Player receives "Stroking" from Arlene;
					else if Ball size of Player < 4 and Libido of Arlene >= 1 and Libido of Arlene < 12:
						say "     Your exalted eyes are treated to the succulent tableau of your plaything reverently actress hir burgeoning cum slicked bump, humming. 'Goddess ye poor beastie, ye must uz been right pent up,' in a cheeky trill as shi cups hir paws about the scintillating curves of plush middle, leisurely massaging your virile offering along the supple swell of hir growing bump. Loosing a well-meaning guffaw, you tell, hir perhaps, though it's hard to find mates as, you pause to idly run your ophidian tongue along the gleaning edges of your fangs, delectable as shi is rather difficult. 'Yar-har-har, aya ya be speaking da lady's truth me dragon! Course,' Arlene crows, enticingly drawing hir tail about hir motherly amazonian curves, 'da wee ones be bring out da best me.' Indulgently bobbing your head, you inform your scrumptious shi is becoming quite the [']catch['], especially in hir lovely condition.";
						WaitLineBreak;
						say "     'Aye me heart, doe I'z must be a saying, da new curves do be looking right at home me, wouldn't ya agree?' shi preens with haughty glint in hir eyes as arches hir back to better highlight the glossy swell of seed kissed middle. Of course, you rumble affectionately as you reach out with your dominant forepaws and doting massage the regal curves of hir bountiful tumby. 'Ah that feels right heavenly me dragon, ya know I'z could get used to dis kind of treatment.' shi simpers with a happy little hum. Good girl, you rumble, shi going to make an excellent pampered broodmare one day. 'I'z hope so...,' Arlene coos, sleepily as you gently rub hir coarse curves while hir eyes flutter shut and hir breathing slows to a calm relaxed pace as shi drifts off to sleep beneath you. In no mood to wake hir, you quietly paw over to Arlene's bed, pull off a few blankets, then lightly drape them over hir slumbering, before stealthy tiptoeing out hir of chambers.";
						NPCSexAftermath Player receives "OralPussy" from Arlene;
						NPCSexAftermath Player receives "Stroking" from Arlene;
						Move Player to Dragon's Causeway;
				else if Cock Count of Player is 0:
					say "     Your mind is set awash in a lurid squall of resplendent rapture at the worshipful echoes of your plaything's tender oral affections lavishing your joybuzz reaches its crescendo. Lustrous motes of enthralling delectation course through your ecstatic clit with every sensuous motion as your priestess probes the exalted folds of your aquatic snatch in a slithering sonnet. While the heady caress of hir well-lubed tactile pebbled hide stretches your ravished [Cunt Size desc of Player] cunt all the wider with each voracious piston of your hips. As shi thoughtlessly tries to hilting evermore ";
					If "Touched by Madness" is listed in feats of Player:
						say "centimeter ";
					else:
						say "inches ";
					say "of hir angular snoot within the elastic walls of your peerless muff. Panting in reptilian delight at the vibrant kiss of each delectable little bump of hir coarse oily skin roiling across your quivering cunt, and the soft, yet endearing caress of hir lustful breath playing across your toned inner thighs.";
					say "     An all-too-familiar tension budding in your core as the sensual static sensations bleed into one another, and push you closer to the edge. Unwilling to yield to the little death so easily, you push back against the simmering storm of salubrious bliss gripping you. As you ravenously twerk your flanks ever the faster, desperate to treat your lustful depths to just a few moments more of the roiling felicity surging through your tauric form. Dimly though, you can just barely hear the plaintive grunts of your toy as you pound your puddling pussy lips about hir snoot like shi were some cheap thrill. Lost in your own lascivious ardor, hir delectable mewls do little more then serenade your draconic ears, spurring your fuck-hungry body on. Undeterred by your beastly treatment, your bawdy priestess's never once slackens in hir zealous worship of your well-loved muff as the glimmering edges of hir fangs lightly braise the your scalie petals betwixt the succulent innervation of hir tongue's titillating your draconic button.";
					WaitLineBreak;
					say "     While you indulgently caress the stately contours of your [breast size desc of player] chest. Lavishing your opalescent scales and perky nips with lurid motions of your dexterous palms as they roam your divine form with decadent aplomb. Tiny motes of many colors and none twinkle just along edges of your expansive vision as the intoxicating tension arcing across your tauric flowers builds like the frothing waves, spellbound by the sensations bubbling through you. Your color changing cells soon blare a sympathetic simulacrum of goddess's favored hues upon the walls, filling the room with a prismatic ballet of impossible colors. Till with one toe clenching thrust, the roiling torrent of effervescent desire crashes over you in a welcome squall of coldblooded release. Your well-used muff cinches about Arlene's fem-honey slicked muzzle as you hilt yourself upon hir snoot, faring your nascent wings skywards in triumph. You tilt your proud head back, bellowing a deep brassy cry of delight as your plush cunt gushes a molten trickle of girly juices across your toys eager lips.";
					say "     Your subby morsel, affectionately hums beneath as shi laps at your draconic offering pouring down the sides of sleek visage and eager palate. Smirking at the thought and lingering ripples of hir tongue flickering across your folds as shi hungrily suckles upon the delectable drops of lustrous dew. You languidly withdraw your tender petals from hir duly-used muzzle, with deliberate slowness, delighting at parting echoes of hir selachian hides gracing your blushing alabaster muff. As the beatific tactile bumps of coarse, yet devilishly lubed flesh reverently glides across your tender sex as you hoist yourself back up to your full ";
					if "Touched by Madness" is listed in feats of Player:
						say "metric ";
					else:
						say "imperial ";
					say "height with seductive little as you carefully set over Arlene's prone form on shaky, sated legs.";
					WaitLineBreak;
					if Libido of Arlene is 0:
						say "     Your many eyes are greeted by the adorable sight of your equally spent priestess shamelessly licking hir fem-honey drenched cheeks clean with exaggerated smacks of hir selachian chops, murmuring. 'Mmh, now dat hit da spot me dragon,' paws drifting to hir tight creamy abs as shi theatrically gives hir stomach a hearty pat. Lips curling into a predatory grin, you rumble your satisfaction at your toy's performance and hir appreciation of your offering while you kneel down beside and treat their sultry siren to a quick little kiss. 'Arg thank ye your regalness fir spoiling me so,' Arlene purrs, lightly clasping hir paws to the side of your head as shi reverently strokes your draconic jowls and ears. Leaning into hir touch, you tell hir with skills like hir's its hard not spoil hir, after all, what kind of mistress would you be if you didn't show your, you pause as deep ophidian purr builds in your breast, pets some love from time-to-time.";
						say "     'Aye me dragon,' your priestess chuckles, 'serving under ya be more den might a bit interesting. Doe maybe next time you'll find it [']N your heart-O-hearts to let me be on top?' Perhaps, you simper, letting your eyes leisurely wander down the articulate curves of hir athletic core, and delicious impressions of hir moose knuckles straining against the wafer thin fabric of hir bikini bottoms as the lingering memories of hir rich salty flavor simmering across your mind's eye. Although, you add gently kissing your way down the nape of hir neck, relishing the adorable little shivers of passion through hir vulnerable body as your barbed fangs lightly brush hir aquatic hide. You do quite like the feeling hir underneath you, still you rumble, fixing hir with a smoldering abyssal glance. Shi has been a good girl recently, so you'll consider granting hir request right now. 'Mh a most tempting offer my heart, doe da spirit be willing, da flesh be a might weak, un spongy, so fir now I'z think I'z needz a moment a touch [']O tuck. Eh, if in dat's alright with you, me *yawns* dragon?' shi hums, stretching out before you. Nodding sagaciously, you decide to allow your priestess a moment of respite and turn your attention back to the more important matters of running your cult, and your other, lesser affairs in the city.";
						NPCSexAftermath Player receives "OralPussy" from Arlene;
					else if Libido of Arlene >= 1 and Libido of Arlene < 12:
						say "      Your golden abyssal gaze is treated to the stately spectacle of your motherly priestess ravenously licking hir selachian chops, purring. 'Yar no dat hit da spot,' shi as hir girthy finned tail leisurely about the burgeoning curves of hir adorable eggy middle. Rumbling affectionately, you carefully drape your towering form over hir's as you lovely nuzzle your cheeks against the cute swell of adorable eggy belly, telling hir now what kind of [']mother['] would you be if you didn't provide for your chosen and hir brood. 'Aya, ye be a right good mate me heart, one me un da wee ones be proper lucky to have,' Arlene simpers, as she reaches out and tenderly runs hir clawed fingers through your tentacular hair. Nearly blushing under hir praise, and the warm bubbly sense of parental pride roiling in your breast. You lightly kiss the subtle outlines of your eggs peeking though your mates rip cord core, telling hir you're glad to hear that. After all, you scarcely dreamed you'd ever have kids this way.";
						say "    'Da me mate, the tides be strange un wondrous but,' shi pauses as hir free hand drifts to the tight glimmering curves of hir creamy middle, 'I'z wouldn't [']ava it any utter way.' Nodding in agreement, listening to the cute little gurgles emanating from hir supple tummy, as you tell hir much the same, after all you can't wait to see how shi develops. As one day soon the pair of you will get to behold the sight of your titanic young fulfilling their destiny of heralding in the goddess's coming and bringing this chaotic world to heel. 'Mh dat will be quite da sight me lovely, un just think of the riches dat wait us once hir worshipful walks among us!' Arlene crows as muted streaks of many colors and none briefly swirl across hir pupils. Of course pet, you titter, in covetous trill, but for the now why not just enjoy the moment. 'Da,' Arlenen mews contentedly, as you wrap about hir vulnerable form and pamper hir growing bump with caring strokes of your forepaws. Till the familiar wanderlust and zealous desire to attend your cults needs complies you to reluctantly rise, still some part of you takes comfort in the knowledge that one day such minor concerns will be beneath and you be free to enjoy eternity with your chosen mates, free from all want and needs.";
						NPCSexAftermath Player receives "OralPussy" from Arlene;
					else if Libido of Arlene >= 12:
						say "     Your molten draconic eyes are treated to the resplendent spectacle of your blissfully gravid mate loudly smacking hir lips as shi unabashedly licks hir fem-cum drenched muzzle, mewling. 'Oh by da lady ya really know how to treat a girl ya wondrous beastie.' as shi rest hir arms across the bountiful swell of hir tigerstripe laden tum. 'Doe I'z think wee ones un I still be a might peckish,' shi titters, as soft ripple gurgle passes though hir heaving womb. Well we can't have that, you simper goodnaturedly, letting your eyes meander about hir flush creamy tits, and beautiful faint outlines of your massive spawn peaking out from beneath hir mammoth middle. After all, your brood has so much more growing to do, perhaps you should go grab some of the pig skins and have them prepare a meal for your hir? You titter as you reach out with your dominant forepaws and gently trace a talon along the cute edges of hir puffy outie. 'Mhhmmm, now dat do be sounding like a most entice offer my lovely, why ye be surprised how ravenous this lot can be. Not dat I'z don't minds treating dem,' shi coos giving hir flanks an endearing rub.";
						say "     Smirking, you let out a base gnar of contentment at hir words, and the sensual sight of hir palms sinking into the welcoming maternal padding gracing hir athletic form. You voice your joy both at the notion your brood and hir seem to be getting along so well, and hir budding affinity for gravidity. 'Aya the wee ones be growing on me day-by-day, but what's not to love me heart?' shi purrs affectionately running hir web fingers over the vast swell of hir heart G-cups tits. 'I'z got diz ripe un fat tits that would put even the most buxom on naiad's to shame, un a stately bump what's fit fir worship.' shi coos, hands drifting the verdant curves of stretch mark kissed tum as playfully gropes a tender pawful of generous maternal padding. 'Un all da wee while, hir ladyship and the tikes be whispering to me all manner of secrets both great and terrible, why I'z doubt ya could not have [']O found a better deal den dis me heart.' shi swoons as shi glances up at with a look of pure adoration.";
						WaitLineBreak;
						say "     Delighted by her words, you can't help but praise your priestess for dedication and attitude, though you add, as a cheeky smile flickers across your lips. You can think of one other thing that might brighten hir day. 'Un what's dat me heart?' Arlene questions with an eager simper. Why a nice little patter of chocolate from the larder and foot rub from the humans. 'Oh yer too kind to me yer grace,' shi purrs as your stride out the door and flag down two lowly humans, then bark out your commands. 'Yes mistress!' they cry in unison as they flash you the tow headed dragon symbol then sprint off to ladder, leaving you to your own devices.";
						NPCSexAftermath Player receives "OralPussy" from Arlene;
						Move Player to Dragon's Causeway;
			-- "Get Bred?":
				say "     Drinking in the [if Libido of Arlene is 0]sensuous sight of your priestess's chiseled midriff, and delightfully perky E-cup breasts as they strain ever-so-slightly against the glossy black bindings of hir wafer thin bikini top[else if Libido of Arlene >= 1 and Libido of Arlene < 12]scrumptious sight of hir cute little preggy belly gently lazing over hir lust flushed sex[else if Libido of Arlene >= 12]wondrous maternal glow of your mate's massive tiger-striped tummy as hir well-egg womb wobbles enticingly with hir every breath[end if], you decide to treat your toy to some classical fun. After all, you both deserve a chance to blow off some steam, you ruminate, advancing upon hir with a pronounced predatory[if player is impreg_now] sashay that adds a sensuous little bounce to your plush eggy tumby[else] strut that highlights the bestial grace of your [bodydesc of Player] draconic form[end if] as you coil your tauric half about hir, bathing the room in a viberant prismatic ballet of lustful pinks as you give voice to your vivacious desires.";
				if Libido of Arlene is 0:
					Project Figure of Priestess_soft_icon;
					say "     'Mmh, I'z was hoping you'd say some-tin like dat me dragon, why its been a might touch too long since I'z had the privilege [']O pillaging yar cove.' Arlene purrs, in a lewd velvety trill as shi leans your caress, while shi playfully brushes hir fingers across your glossy lamina decorating your feral half. Rumbling a similar sentiment, you hook your arm about hir waist, leisurely tracing your reflective talons along the supple hills and tight valleys of hir toned six pack then down to hir prominent moose knuckle peaking through hir oh-so-tight bikini. You loving work your webbed fingers about hir puffy cock cave, giving hir cute hybrid sex an endearing little squeeze, telling hir how much your looking forward to playing with your favored toy when ";
					if Player is impreg_now:
						say "there are few lovers who can satisfy you like shi can, especially in your current condition. You preen, lightly pressing the adorable swell of curvaceous tumby against the small of hir back. ";
					else:
						say "it's so hard to find mates that can truly treat your draconic majesty with the care it deserves. You swoon in an elated cadence, tenderly grinding your sadly vacant middle along the lithesome contours of hir back. ";
					say "'Yarg, ya be given me too much credit me heart, doe I'z be lying if wasn't enjoy the attention,' Arlene hums with a contented sigh as shi takes your hand, and leads over to a the middle of hir chambers.";
					WaitLineBreak;
					say "     Though some section of your proud, increasingly draconic mind chaffs at hir forward attitude, hir adorable smirk, and the memories of hir delectable cocks stills any simmering ire bubbling in your breast. As you proudly strut past hir with a hypnotic waggle of your hips, then present your gleaming alabaster cunt[if player is herm] and ample quad balls[end if] to hir with theatrical flourish of your augmented tail. You glance back over your shoulder at hir with a lewd smoldering expression, beckoning your mate forward with a commanding nod of your regal head and prehensile tendrils, purring, come here pet. 'Aya, me dragon,' Arlene coos adoringly, drinking in the scintillating sight of your gleaming sex as shi paws up behind you. Then tenderly wraps hir clawed mitts about your flanks, sending a blissful spark of primal anticipation through your proud form as hir talons dig ever-so-slightly into your toughed hide.";
					say "     Humming at the predatory kiss of hir claws, you find yourself huffing in loving anticipation as Arlene dexterously hooks the sleek borders of hir tail fins about the thin strap of bikini bottoms, and casually pulls them down with a deliberate slowness. As you drink in the cute spectavel of a soft rosy blush spreading across hir creamy hide as hir flatteringly tight suit glides across hir shapely hips. Its hard not to appreciate the way hir skimpy bottoms hug the adorable curves of hir swimmer thighs, casting cute little creases in your mate's two-toned skin. Highlighting the adorable crease of hir cock cave, and the twin tips of hir crimson spires peeking free of their delectable housing as they descend down hir legs. Only to be kicked aside seconds later as they fall to the ground while Arlene twin robs slowly surge to attention amid a trickle of hermy juices coiling along hir legs.";
					WaitLineBreak;
					say "     Flashing you a proud, yet naughty smirk, shi flexes hir tail and takes hold of hir dual tool in the ponderous pebbled coils, playfully stroking hir juicy tools to attenion with an air of bawdy pageantry. Grinning in kind, you drink in the sight of prehensile pricks slipping through the tiny bend in hir selachian limb, as the oceanic scent of hir pre soon fills the room. You can't help but gnar approvingly at hir showwomenship while shi coyly twerks hir hips in tune with each enchanting motion. As hir delectable rods slowly swell to their full serviceable and stain against the exotic confines of hir tail every carnal throb of hir glittering spires. Perhaps reading your expression, your toy levels you with a knowing look as Arlene lines up hir sleek form up with your now dripping snatch, humming. 'Ya ready me heart?' in a mischievous trill as shi gazes at you like needy pup desperate for it's masters approval. Of course little mouse, you happily simper at hir welcome show of proper decorum, you entwine your own enhanced limb about waist. Then give hir toned ass an encouraging squeeze as you hungrily press the pearly lips of your [cunt size desc of Player] snatch against the glistening pre slicked tips of hir cocks.";
				else if Libido of Arlene >= 1 and Libido of Arlene < 12:
					say "     'Oh praise da goddess me heart, I'z was hoping ye'd say dat, whyz I'z been more den a might bit pent up as [']O late,' Arlene hums, with an almost exasperated sigh as shi tenderly rests hir left hand upon the adorable swell of hir burgeoning belly, giving hir growing curves and your precious wrymling an affectionate well-desevered pat. Oh poor pet, we can't have that. You rumble with a playful flick of your ophidian tongue as you cup your dominant hand about their coarse hem of hir supple tumby. You find it difficult not to enjoy the billowing warmth greeting your palms, as you run your webbed mitts across the blissfully tight, yet abyssally coarse bight of hir blossoming bump. Good girls like her deserve to blow off some steam from time-to-time. You can only imagine how [italic type]HARD[roman type] it must be for hir to waddle around with such an adorable eggy belly, and... You titter, letting your paws drift down to the plush impression of hir petite package peaking through hir tight bikini bottom, these nice heavy balls. You tease, tenderly drawing the flat of your pointer talon along their tasteful countours.";
					say "     'Mmhh dat feels good,' Arlene shivers, leaning into your touch as the twin tips of cocks shamelessly strain against the glossy black lycra. Such a needy mommy herm, not that you can blame hir, ";
					if player is herm and player is impreg_now:
						say "you know first hand how randy a nice fat clutch can make you. You simper, leisurely pressing the burgeoning curves of your ripe womb against the fecund swell of your priestess's equally blessed belly. Why just the feeling of all these big sexy eggs putting pressure on all the right places alone is enough to drive you, you pause letting your words hang in the air like a potent lure as you tuck your snout to the tips of hir ears. Wild, you tempt with a sultry snake-like hiss, lightly flicking your bifurcated tongue along the hidden edges of selachian ears. Provoking an adorable little shiver from your lush mate as hir wordlessly coos in agreement.";
					else if player is herm and player is impreg_able:
						say "you've felt similar urges during some of your prior litters. You rumble in a lustful, yet sagacious trill as your paw drifts to the sadly vacant contours of your [bodydesc of Player] middle. Why the slightly little breeze caressing your scales was enough to leave you panting, while that rich bubbling cocktail of mommy hormones could sometimes keep you hard for hours on end. Not to mention feeling all those cute kicks whenever the little ones got antsy was such a treat. You add with a pleasant snicker as you gently massage the exotic folds of hir lust flushed cock cave with devilishly slow motions of your inquisitive mitts. Eliciting a sympathetic twitch from the gravid selachian's twin rods as shi murmurs dreamily in agreement.";
					else if Player is female and Player is impreg_now:
						say "you full well how hot under the collar a good litter can make you. You swoon, lovingly running a hand along the regal curves of your motherly middle. Why just the thought of having someone massage your nice big eggy belly, or rubbing your hard working paws for you was enough to get you excited. Much less getting to watch your body's change as your precious spawn develops is such a precious feeling you could hardly live without. You tease, as you lean down to lightly nibble on hir sleek head fin. Earning you a worshipful hum of agreement from your chosen plaything as shi melts into your arms.";
					else if Player is female and Player is impreg_able:
						say "in fact, you're almost jealous of hir lustrous condition. You tease, flaring your wings about hir verdant form as you caringly wrap hir expectant body in your draconic embrace. Why, you rumble with a longing trill, absentmindedly pawing at the growing pit in your poor empty tumby. You can't wait to experience again that feeling of matriarchal purpose filling your regal personage, or getting to watch as your body ripens all the closer into the image of a proper ";
						if "Touched by Madness" is listed in feats of Player:
							say "mommy derg. ";
						else:
							say "dragon mother. ";
						say "You preen, with a devilishly haughty trill as you give the lust-addled shark's package a tender squeeze. And you bet a big virile breeder like hir would love to help you relive that heavenly state again now isn't that right? You tempt, lightly brushing your silky wings along your curvaceous pet's well-loved middle while shi pants in base agreement."; [merge here]
					say "     Good girl, you titter with a proud ophidian hiss, motioning to the center of hir spacious chamber with an imperial nod of your draconic head. You paw over to the empty patch of furry carpet while leading hir on with a commanding tug of your augmented tail as you briefly flare your chromatophores in a hypnotic ballet of impossible hues. Arlene half stumbles behind you, seemingly spellbound by the hypnotic array of shapes and colors refracting off the walls and you own ample assets as you seductively glance over your shoulder and you present your oh-so-breedable flanks to hir with theatrical flourish. Chuckle under your breath at the far off look in hir eyes as they drift the gleaming folds of your [cunt size desc of Player] scalie alabaster ";
					if Player is herm and Ball size of Player >= 4:
						say "cunt and ponderous swell of your creamy quad package as your virility gently jostle between your powerful hindlegs with the slightest provocation. ";
					else if player is herm and Ball size of Player < 4:
						say "cunt and compact curves of your pearly cum tanks neatly nestled between your predatory haunches. ";
					else if player is female:
						say "cunt. ";
					say "Though, as you idly fan your argument tail about your exotic bestial sex, filling the air with the beguiling aroma of your draconic pharamons. You watch, with no small amount of mirth as hir nose twitches, and selachian orbs widen to vast umbral saucers as shi focuses upon your effulgent petals. Go on pet, you hum as your bawdy siren shakes off hir lewd fugue, bellowing. 'Aya-aye me dragon!' as shi hooks hir claws about the wafer thin strings of hir bikini, and severs their puny bonds with a single flick.";
					WaitLineBreak;
					say "     Observing them fall, you feel a hungry smirk tugging at the edges of your muzzle as your many molten eyes drink in the sensual spectacle of twin tools slipping free of their sordid housing amid a soft trickle of salty pre roiling down the athletic curves of hir well-muscled thighs. Your lustful mate prowls up behind you, fixing you with an approving look while shi takes hold of your proud haunches with surprising confidence as shi sinks hir talons ever-so-slightly into the toned contours of your inner thighs. You loose an unbidden, yet well-pleased hum as the bestial tauric section mind almost melts a the feeling of hir claws gracing your hide as if your liminal form were being claimed by a proper four legged mate. Perhaps sensing this, your eager mate levels you with a knowing cheeky smirk, running hir pleasantly coarse fingers along the decadently lubed contours of your inner thighs as shi lines hirself up with your [cunt size desc of Player] snatch.";
				else if Libido of Arlene >= 12:
					if Player is female:
						say "      'Aya yer regalness, I'z been praying ta da goddess's ye might be saying something like dat. Much az I be loving da wee ones,' shi coos, idly caressing taut, blushing hem of hir envyable bump, 'day been making me more den a right bit... frisky des past few moons,' Arlene pants in a lustful mix of relief and exacerbation as shi eases hir lovely plush body against yours. Oh you poor thing, we can't have that, you tut with a pleasant reassuring ophidian trill, tenderly coiling your tail about the lush pillowy swell of titanic tum as you softly massage the warm well-lubed folds of hir lap devouring middle. You know full well how [']hard['] it must be for hir to carry around such a big, sexy belly like hirs. You hum, lightly pressing your [if Player is impreg_now]taut tum against the soft doughy fold of hir paunch, reveling at the growing heft of your imperial young and the sublime maternal shimmer of your oily scales[else]vacent midriff along the supple, inviting bight of your silky, scalie tumby[end if]. Why, you simper, affectionately tracing your tail fins about the prominent curves of hir ripe outie, it must be so difficult for someone hir size to just keep your little angels fed, much less attend to hir own... needs. You add with a teasing flick of your bifurcated tongue as your oh-so-sensitive priestess's shameless huffs and whimper like a desperate beast as your glossy scales flicker across hir rosy tigerstipped bump.";
						WaitLineBreak;
						say "     'Zuni zul,' Arlene nods, eyes briefly glazing over with a scintillating fog of impossible hues as shi dreamily runs hir paws along the verdant swell of hir resplendent middle. 'Da wee devils be a right hand full, but day be more den worth da hassle, well,' shi pauses to glance at you with a look of simple admiration, 'so's long az I'z got ye me lovely. Sides,' shi purrs nuzzling hir predatory muzzle about the tender curves of hir groaning G-cups, 'it feels kind [']O... nice just to lay back un let da pig skins take oh me un mine. Why I'z being right honest with a me heart,' shi smile giving hir flush midriff an airy pat. 'I'z tink I'm starting to like da attention.' Smirking, you tell your blossoming breeder, how happy you are to hear that, after all shi looks so cute and snuggly like this, it would shame not to enjoy hirself or hir bounty, while you coil the oily length of your tail about the sweltering borders of hir hybrid sex. 'Mh I love da way you think me dragon, un dare be no other soul in da world I'z rather share dis with den you, ya virile beastie.' shi preens, leaning into the doting caress of your tail.";
					else if Player is herm:
						say "     Why you're almost jealous of hir, shi must feel so full and content with a wonderful litter to keep hir company, while your cultist and Seradovah thralls attend to hir every need. 'Yar, yer not wrong dare me lovely, doe do something wondrous about kicking up me heels un letting the pig skins take care [']O me un da wee ones,' Arlene swooning as the soft blush spreads across hir snoot. '[']Tis like all me care un worries just melt away, fact I'z don't even mind dat I'z can't see me toes no mer.' shi chuckles ruefully, arching hir back to better highlight hir ponderous condition. 'Fact be, tink I'z tis new view be a might bit better den da old one, would't ya agree me dragon?' Nodding, you rumble affectionately how hir new curves suit hir, perhaps you have to look into making this a more permanent addition to hir [']wardrobe[']."; 
						WaitLineBreak;
						say "     'Yar-har-har, now wouldn't dat be quite the sight me heart, doe if ye and the help keep treating me so, I'z might just take you up on that offer. Why jus a thinking about a life free [']O care er worries un a right powerful shiver of me zee beasties at me beck and call be sending me head a spinning,' shi titters in a near manic cadence as shi gleefully gropes hir plush meaty middle. Enthused by hir attitude, you lovely purr your agreement, after all you remind hir, once your business with Tiamat is concluded the two of you will be free to live and rule as you please. In time not only this sphere, but countless others may yet fall under the yokes of their great and terrible brood queens. You simper, jovially drawing your girthy tail about the supple impression of hir hybrid sex. 'Mh, I loves it when you talk like that me dragon, un ya know,' shi hums fluffing hir chest. 'I can't think of any other soul I'z wish to share such dis [']ere world with den you, ye wondrous wyrm.";
						say "     Beaming at hir words, you paw past your verdant mate, tenderly tracing your tail about hir ample curves as your strut towards the center of hir chamber, and present your gleaming [cunt size desc of Player] cunt to hir a fanciful flourish of your augmented tail. Glancing over your shoulder with a ravenous yet expectant glint in your many eyes, you watch as your priestess shamelessly drinks in the sight of your lush cunny scales ";
						if Ball size of Player >= 4:
							say "and ponderous quad balls lightly swaying between your legs ";
						else if Ball size of Player < 4: 
							say "and the compact curves of dense poly package ";
						say "as they glitter in the scintillating light cast by your chromophores and the electric candelabras. 'Cribens me heart, I'z don't I'z think ever gonna tire of dis sight,' shi murmurs, paws drifting the oceanic bight of hir sensual bump with deliberate slowness, openly relishing the supple kiss of hir motherly curves caressing hir webbed fingers."; 
						WaitLineBreak;
					say "     As they leisurely dip beneath the toasty hem of hir flush full belly while shi hastily severs the thin strands of black lycra binding hir bottom with a skillful flick of hir nails, humming. 'Goddess dat feels better, don'ts even know I'z bother with des thing t'any more,' casually tosses the remnants aside and strides up behind you with a proudly purposeful sturt, only to stop but a fluttering heartbeat later as hir turgid tum bumps into you with a soft little thump. Doing your best not to chuckle at the flustered, embarrassed look creeping across Arlene's selachian visage, you considered suggesting a different position, only to be cut off by a centering cough from your priestess. 'Right *ahem* might [']O gotten a wee bit carried away der boyo un forgot bout da little un's [']ere.' shi stammers, rubbing the back of her head in amusement. 'But don't ya worry I'z knowz what'z ta do,' shi grumbles while shi clear hir throat and shouts towards the Main Hall, "; 
					if "Touched by Madness" is listed in Feats of Player:
						say "'Oi Jul Lee do da thing!'"; [this is a ref to Legend of Korra https://youtu.be/mofRHlO1E_A?si=jEyjtRFU50QUXXVV]
					else:
						say "'Seradovah aam Kai Sunrack ahrk areh faal truk!'"; [Seradovah aam Kai Sunrack ahrk areh faal truk = Seradovah serve the ocean priestess and do the thing!]
					say "    While hir voices echoes throughout the temple grounds, you briefly hear the shuffling of coils, and a smattering of confused yelps resounding through the halls as a trio of burly Seradavah bearing large a silky white sheet and several black nylon ropes burst into hir chamber and hurriedly bow at their mistress's feet murmuring: 'Nu aam Arlene,' in a hissing near mechanical cadence. 'Took ya lot long enough, now gal win nilli!' your priestess growls with a haughty snap of hir fingers as the hunky naga spring to their feet as a pair of them hurriedly wrap your mates tender tum up in their blanket, and gently hoist hir fruitful middle out of the way of hir gleaming cock cave, while the odd serpent out takes a plank position behind you. 'Good boyos, [']tis wonderful to have such useful scallywags on da account,' Arlene preens, as strides atop the prone thrall, while the other two support hir precision cargo as shi takes hold of your proud flanks while twin spire surge to attention as lines hirself up with your yearning cunt."; [Gal win nilli = get to it] [also note to self merge here]
				say "     Though shi makes no move to claim your needy hole, and merely fixes you a cute desperate look as shi fondly caresses your inner thigh with endearing strokes of hir coarse, yet devilishly paws. Such manners, you snicker under your breath as you regally purr your consent. 'Aya-aya me dragon!' Arlene bellows, rears back hir shapely hips, and thrusts. Salubrious abyssal bliss simmers across your gleaming [Cunt Size desc of Player] folds as your far-traveled mate hilts twin sleek rods in a single practiced toe curling motion that leaves you hungrily gnarring for more. As your tender tauric tunnel ripples with the sensual kiss of hir sizable tools corkscrewing along your elastic walls while a [if libido of Arlene is 0]pleasant little bounce passes through hir exceptional tits[else if Libido of Arlene >= 1 and Libido of Arlene < 12]decadent jostle ripples through hir groaning milk tanks and tight tum[else if Libido of Arlene >= 12]heavenly jiggle flutters through hir flush G-cups as they strain against their glossy prison while the normally implacable Seradovah supporting hir royal womb struggle to keep their hold of hir ponderous middle[end if]. Your sleek scalie sex bulges with the impressive heft of hir serviceable rods as your malleable muff seems to mold itself to their sinuous forms. Milking hir dual tool in a blissful spasm of aquatic delights as hir dexterous dicks coil and unfurl within you like the petals of some exotic blossom.";
				WaitLineBreak;
				say "     Lavishing your cunt in a preternatural sonnet of static as hir writhing tools dance along your passage an impossible whorl of sensation your liminal mind struggles to pares. As each fluttering twist and eclectic bend in hir thrusts blends into the next with a seamless grace your far-traveled body craves. You preen, gnarring in primeval satisfaction, hungrily rocking your powerful lower body in tune with hir vivacious thrusts, desperately trying to take just a hair more of hir prehensile pricks. Your priestess's dexterous dicks seem glide on their erotic orbits as they surge along the desperate bestial bends of your tauric cunt, in a turgid sonnet of abyssal bliss. Your well-used walls spasms delectable with each regal motions as hir dual tools flare along your gushing box in a breath catching double helix, lavishing your sordid muff in a devilish dervish no normal fling ever could.";
				say "     All the while, the well-hung herm's throbbing cum veins serenad your lustful flower with reverent pulses of supple rapture as their lurid whirl cascades over senses like the lapping of some alien tide, hir paws soon drift to the ";
				if Player is impreg_now:
					say "imperial curves of your lush eggy tum, pampering your glossy scales with the tenderest of touches, humming. 'Ya know [']tis a shame some lucky ";
					if "Touched By Madness" is listed in feats of Player:
						say "[one of]git[or]glob[or]boyo[or]zog[at random] ";
					else:
						say "soul ";
					say "already dones puts a shiver in yar timbers me dragon,' talons lovingly trace the subtle outlines of your regal spawn as shi lightly pats your cute taut tummy scales. 'Doe, I'z guess dat just means I'z gets to enjoy da fruits of dare labor.' Arlene preens with a proud little chirp, eager palms exploring the growing curves of your eggy middle. Drawing a light pleasant rumble from your lips as the bubbling cocktail of tainted hormones coursing through you leaves you swoon at hir touch and gentle little kicks of your feisty wyrms. Ah that feels so good, you moan with a lustful ophidian trill while you thoughtlessly flick your tongue in air, at the attention paid to your lush bump as your playing pampers your sensitive tum with soft pleasing little rubs.";
					say "     'All bet me lovely, doe how do ya be keep your mitts off yourself be a right true wonder, why tis like your worshipfulness were cut from da finest [']O silks.' shi purrs indulgent drawing hir fingers along the minute borders of your glossy lamina. 'Un forged from da toughest steel,' Arlene adds, reverently brushing toned contours of your sleek draconic flanks while hir palms drift to the sensual borders of your gleaming belly. 'Cribins un just feel da heft [']O all dem beasties, I'z can hardly believe how easy ya make it look.' your priestess coos appreciably, as shi delicately jostles the adorable hem of your precious tum. Why thank you pet, though what can you say, you made of this, you rumbling happily in reply, gently pressing the imperial weight of your brood against hir palms, delectating in the primal rush of maternal bliss filling your core at the velvety kiss of hir paws gracing you middle. 'Aya mayhaps me wondrous sea devil, do I dare ta tink you dat even without our ladyship's blessing, ya still make a right proper monster mummy.' Arlene preens, between hir meaty thrusts as shi massaging the growing outlines of your eggs with reverant well-practiced strokes.";
					WaitLineBreak;
					say "      Mmhh, shi's not wrong, you proudly hum, as hir mitts gleefully rubs out the few stubborn knots blighting your growing majesty while the sordid echoes of hir lustrous pricks flicker through your needy passage in a heavenly tattoo. Yet your current form suits you far better than your old pathetic human body, or any lesser form you could have acquired out in the city. You crow, glancing down at the blossoming of curves of your gravid splendor, delighting at the subtle ripple passing though your imperial scales with your mate's every rutting thrust while tiny beads of molten yellow light reflecting off your native oils. A part of you can hardly wait to see what further lovely changes await you as your body continues to evolve, or what manner of regal dragons you might yet birth in service to the goddess. You muse with primeval satisfaction as you affectionately run your paws over the supple curves of your eggy middle. 'Yar-har, true my dearest, dare taint no treasure like ye in all da neath!' Arlene exclaims, with a bawdy belly laugh.";
				else if player is impreg_able:
					say "vacant contours of your trim tum, as shi expertly pampers the silky smooth contours of your well-lubed scales with pleasing strokes of pebbled palms, snickering. 'Mmhh, ya know I'z been looking forward to claiming ye again me dragon. Why,' shi pauses, snaking the finned edges of hir ponderous tail up your sculpted hindlegs, 'it should be a right crime ta deny a beasty breeder such as ye her purpose.' as the subtle patter of hir ravenous thrusts and low lustful pants reverberates throughout the halls. Your hands absentmindedly glide to tight empty edges of your fertile core, you playfully paw at chiseled midriff, as you rumble in agreement. After all, at times it feels so wrong to go without the comforting presences of your spawn, or the intoxicating rush of your motherly hormones coursing through your imperial form. Not to mention the heady sight of your glowing bump spreading out before you, you playfully quip, tenderly groping the [bodydesc of player] edges of your underloved tumby.";
					say "     'Daw, ya poor lassy, don't be a worrying [']bout that now, fir yer mates got ya covered,' Arlene chuffs in teasing, yet caring tone, hir twin rods roil about your satin folds with regal aplomb. As the throbbing borders of hir glossy cum veins writhe about your puddling pussy in a sensual metronome. Oh such a doting little mouse, why, whatever can you do to reward hir for such faithful service? You titter in playful seductive trill, delighting at the attention paid to your lurid folds. As your playful priestess's dual tools reverently cinch about your scalie button between hir throbbing cum viens, lavishing your quivering clitty with an abyssal rhythm all their own as the potent pounding pulse washes over you at the apex of hir thrusts. 'Yar, I'z be need be needing no more reward den seeing yer regalness growing ripe with me zea devils.' Arlene purrs, as subtle motes of many colors and none shimmer across hir selachain eyes.";
					WaitLineBreak; [merge here]
				if intelligence of Galaxite is 2:
					say "     Vibrant pulses of desire surge through your voracious tail, as you dimly taste the salty sapor of the temple air mixing with abyssal tangs of your priestess playing's needy scent waft across your concealed maw's exotic palate. The innumerable swarm of tentacular feelers nesting with your unearthly tail slowly begin to stir, as their glossy forms writhe about the supple contours of your tail. Yielding to their clarion call, you thoughtlessly arc the sinuous curves of prehensile limb into an instinctual [']U[']-shape while flaring the fleshy petals of your maw wide. Your tainted mind relishes the beautiful rush of sensations billowing through your draconic form as you lovingly tuck its salubrious length between your priestess's toned thighs and lightly swaying cum tanks. Eliciting a wordless mew of deep seeded bliss from your [if Libido of Arlene is 0]lustful toy[else if Libido of Arlene >= 1 and Libido of Arlene < 12]adorable budding breeder[else if Libido of Arlene >= 12]blossoming broodmother[end if] as the silky lips of your tentacular tail maw lovingly brush hir the decadently lubed curves of hir baby batter banks.";
					say "     'By da Lady's teats,' shi purrs eyes rolling skyward as the gossamer veiny curves of your maw's O-ring and sleek crimson petal conform to the sultry curves hir lust flushed cunt. An almost preyish quiver simmers through hir as the first of your inquisitive tendrils surge forth amid a little gush of your exotic juices as they reverently caress hir dewy folds in a wriggling tide of morphic delights. Your mouths water with predatory anticipation at the rich zest of hir honey playing across your feelers as they lasciviously swarm about hir girly button. You playfully tweak and knead the cute herm's aquatic joybuzzer with slow purposeful strokes of your tentacles impossibly smooth contours, relishing every cute quiver passing through your as the soft wisps of your 'breath' washes over hir perky clit. Drawing a needy pleading bestial whimper from your sultry shark as hir futa mind struggles to process the effervescent fonts of abyssal elysium course through hir liminal form. Chuffing at the needly look hir face [if Libido of Arlene is 0]pleasant little wobble of hir oh-so-palmable breasts as hir bucks hir hips with a wild, desperate energy[else if Libido of Arlene >= 1 and Libido of Arlene < 12]the hypnotic bounce of hir milk flushed breasts and cute little ripples flaring across hir rosy tum with each labored piston of hir hips[else if Libido of Arlene >= 12]oceanic ripples of lustfully bound belly and ripe cream-stuffed tits accompanying each fruitful piston of hir hips while the Seradovah struggle to support hir[end if].";
					WaitLineBreak;
					say "     You devilish slip a sensuous quintet of dexterous tendrils between hir eager petals, rollicking at the passionate caress of hir aquatic muff needily cinching about your tendrils as they eagerly swim along hir abyssal depths in a flood of impossible sensations. You tenderly furl and twist your tendrils in a licentious mirror of hir own lurid tools, drawing loving appreciative pants from your bawdy plaything as their sleeking forms roil hir cunt with aberrant delight. You can practically taste the exotic selachian tang of hir honey playing across your far-traveled palate as you lavish hir silky box with a practiced touch of feelers along the hidden edges of hir masculine G-spot while Arlene shudders with hybrid bliss. Chuffed by the fruitful pounding of hir pulse playing along your own regal passage as the chaotic echoes of hir writhing tool pamper your folds in a libidinous crescendo. You cheekily slip a number of your dexterous tendrils betwixt the tactile lips of your tail maw, leisurely drawing them along the coarse pebbled contours of hir hide as you magnanimously caress hir compact cum tanks like priceless gems.";
					say "     Gasping, the naughty herms, briefly gaze drift skyward as your ponderous prehensile tendrils gleefully explore the toasty borders of hir supple cock cave as your slip a pair into hir tight, dripping vent. Basking in the salacious blend of hybrid flavor simmering across your exotic palate, your feelers seem to drink in hir lovely dew while you diligently minster to hir aquatic dick slit with sublime strokes of your tendrils along the lurid base of hir twin spires. Your remaining tentacles entwine themselves about hir silky tools like tempting serpents. Earning you a confused, yet bawdy little rumble from your plaything as hir overstimulated mind buckles beneath the carnal assault on hir senses as shi struggles to keep hir pace. Yet the odd little putters in hir thrusts, and dreamy looking in hir eyes, only adds to the heavenly caress of hir cocks as the roiling mass of your fetching feelers washes over hir splendid rods.";
					WaitLineBreak;
					say "     Fuck how did you live without these? You pant in unvarnished delight as their satin coils brush your own dewy [cunt size desc of Player] folds while you their abysaal splendor along your mate's aquatic pleasure tools like living cock extenders as you tenderly slip them past your own dripping petals. Your eager muff stains delectably to accommodate their titillating passage as each vivacious little wriggle of your tendrils massaging Alrene's throbbing dicks, and the heavenly caress of your girthy feelers cascades over you in a velvety tide of draconic excess. The lingering fragments of your human mind shudder at the unearthly frenzy of lustful sensations washing over you, as the more primal facets of your psyche assert themselves as your mind is nearly drowned in an unending torrent of sensation. Each beatific thrust of your tendrils seems to flow into one another in a verdant choir of desire as your tendrils ravenously spiral about Arlene's dexterous dick and sopping [if Libido of Arlene is 0]passage[else]pregnancy flushed folds[end if], pushes you closer to the edge.";
				else if Intelligence of Galaxite is 1:
					say "     A delectable shiver of abyssal bliss ripples through your salacious tail as you coyly slip your exotic limb between your playthings your legs like a doting serpent as you wrap your ovi appendage about shapely thighs. 'Mh, dat be feeling kind [']O nice me dragon,' Arlene mewls dreamily, leaning ever-so-slightly into your touch. Rumbling appreciatively, you draw the graceful taper of your spaded tail along upwards, delighting at the tawdry kiss of hir coarse, yet devilishly lubed hide gracing your ovi slit as you gild the ponderous length of your immaculate limb about your hir inner thighs. Relishing each lewd echo of hir thrusts roiling your [cunt size desc of Player] sex, and the subtle flicker of hir toned muscles playing across your ovi tail. You lovingly trace the satin edges of your fins about hir dripping folds, eliciting a desperate little coo from your priestess at the touch of your glossy sail humbling hir neglected muff as shi thoughtlessly presses hir balmy petals against your inquisitive limb.";
					WaitLineBreak;
					say "     Such a needy toy, you jubilantly titter at the spreading warmth of hir molten cunt simmering across your tail and malleable fins, as you expertly pamper hir yearning cunt[if Libido of Arlene >= 1] and tender swell of hir eggy tummy[end if] with soft, sensual strokes of your prehensile limb. Reveling at the slutty quiver of hir neglected muff as a balmy trickle of hybrid dew waltzing about the tiny contours of your scales and subtle ovi slit. With each loving pass, your shameless selachian lustful petals eagerly hugs your inquisitive tail as you slyly draw your dexterous tail into an instinctual [']U['] bend. Your playful mate whimper and whine as a needy look of confusion dawns on hir face, before your ponderous limb surges forward, spearing hir elastic folds with a squelching flourish. 'Cribins!' your toy stammers, in a broken bawdy chuff. Hir salty juices stream down the side your tapered tail in effulgent veil while hir well-loved muff stretches decadently taut with the decedent impression of your spaded tail.";
					say "     The poor shark's walls seem to ripple with ever ravenously piston of your tail, sending enticing little wobbles through [if Libido of Arlene is 0]hir lush, supple breasts[else if Libido of Arlene >= 1 and Libido of Arlene < 12]hir blossoming milk tanks as tiny beads of pearly perfection bead from hir adorable pink nips, while they stream cute burgeoning curves of hir plush eggy middle[else if Libido of Arlene >= 12]hir poor groaning milk flushed tits as they audibly churn with untold liters of cream heavenly. Beyond ripe, the room resounds with the hearty patter of hir mammoth mounds jostling atop hir bound bump while hir nips gush a thick river of alabaster delight across pillowy bump[end if]. All to your chosen's building elysium, as hir tongue lolls from the edges of hir lips at the vibrant whirlpool of sensation flaring through hir hermy body. Purring in shared bliss, you artfully arc the glassy smooth ridges of your tail about the tender borders of joy buzzer, letting the glossy bumps and carnal valleys of your sail glide along hir clit in a exotic spiral. 'Oh goddess,' shi murmurs between riotous bucks of hir hips as her hybrid body shudders at your touch.";
					WaitLineBreak;
					say "    Almost drunk on hir aquatic cunt's delectable spasm gripping your drooling ovi slit, you can't resist twirling your spaded limb about hir borders of hir prostate in a salubrious spiral that soon leaves Arlene mewling like a lowly bitch. 'M-more, blessed Salt more,' shi pants, with a deep, pleading look in hir eye. Of course pet, you gnar magnanimously, corkscrewing your tail in a devilish mirror of hir own sordid tool's graceful waltz about your sleek [cunt size desc of Player] cunt while shi huffs in shallow ragged as shi struggle to keep hir pace with your virile piston. For all hir lack of finesse, the enthralling sputters in once methodical rhythm only entices your tainted mind further as the salacious thrum of hir ever quickening pulse and desperate caress of hir selachian muff pushes you closer to the edge."; [merge here into cock section or climax if PC is female]
				if Cock count of Player >= 1 and Libido of Arlene < 12: [cock section]
					say "     Your poor neglect [cock size desc of Player] cock slowly surges to life, as pleasant waves of static satisfaction course about the gossamer ridges of your draconic rod as its silky tapered tip slips free of its soft home. Mewling happily, as even the slightest caress of your balmy cock cave along the tactile tiers of your exotic tool threatens to overload your psyche as the smooth, opalsescent scale of aquatic vent your devilishly hug your plump knot with each pounding thrum of your mate's twin spire. Unable to resist the heady pulses of rollicking desire filtering through as your glorious prick grows mind numbingly turgid. You begin huffing under your breath as the supple plates lining your spire gleefully glide along the glossy lips of your slit in a sordid conga line of unrestrained desire as they slip. Fuck that feels so good, you murrmur, thoughtlessly shift your weight to one side as you reach out with your dominant forepaw in simple desperation to feel its decadent throb playing across your pads once more. Only to have your hand lightly pushed aside by Arlene's as shi stammers, 'Do-don't wo-worry a-ah gotz ya matey,' hir voice cracking with a mutual hunger.";
					say "     Nodding with a far-off look in your eyes, you rumble your consent as you relax into hir confident grasp. Ah thank you, you purr with draconic delight at the loving touch of hir well-lubed fingers tenderly wrap about the gleaming curves of your reptilian rod. 'Mh ya poor beastie why'z jus feel da tension in dis monster, how long az it been since ya drained da old girl?' shi titters playfully, as hir webbed mitts dotingly dandling in slow appreciative little rhythm about the sordid contours of your [cock size desc of Player] spire. Too long, you mew in a pleased, yet needy reptilian chirp at the gentle catch of hir oily pebbled paws dancing about the prominant ridges of your secculent cock. 'All say boyo, don't be fretting, I'z take good care of ya,' shi chuckles, skillfully pumping hir wrists all the quicker as the blood rushes your ripening knot. Oh fuck yes, you murmur, clicking your along the floor in needy tattoo, while your smooth bulbous gland grinds along the glossy edges of your scalie vent, stretching your sensitive flesh all the tauter by the second.";
					WaitLineBreak;
					say "     But you need more, you gnarr, shamelessly rocking your paws in tune with your reverent priestess's strokes, relishing each exotic flex of hir silky spire's and needy cluch of cunt grpping your tail. A swirling tension builds inside you as your senses buckle under the squall of vivacious desire roiling about your elated form while hypnotic motes of many colors and none dance along the edges of your sight. Spellbound by the sight, and imperial pulses of hybrid rapture coursing through your liminal body, you hardly notice as your tongue lols from lips like a wild beast lost in the deepest throws of hir heat. Simmering echoes of your hermy elysium roil over the edges of well-loved body like the poundings of the tides as the feverish kiss of Alrene's coiling pricks and your lurid tendrils flickers across your passage, heady caress of your [if Intelligence of Galaxite is 2]tentacular maw[else]ovi tail[end if], and loving strokes of your draconic spire overwhelm the last fraying hairs of your resistance. You rear back your head and bellow your proud release, as your ";
					if Ball size of Player >= 4:
						say "ponderous quad cum tanks audibly churning and turgid cum vein is pulled almost painfully tight as you loose untold gallons of pearly seed upon the carpet breath you.";
						say "     Though you can still hear a mild hiss of annoyance petering from your plaything's lips as a vast puddle of alabaster excess spreads across hir floor. Your bliss-wracked mind can hardly even register anything other than pride at the heady sight of your seed flowing across the deep black slate and lewd pungent scent of your virility wafting about the halls. Mixed gasps of surprise and swooning desire soon resound through the temple grounds as your cultists catch sight of your gleaming load cascades down towards the Moon Pool. Dimly, you can even spy a number of your more hedonistic followers rush out with weathered jugs or crumpled bottles to collect a few drops of divine seed for their own... personal use some section of your fraying psyche muses as the rollicking tension surging through your tauric begins petering down towards your tail.";
					else if Ball size of Player < 4:
						say "compact baby batter banks ripple with lurid elysium as your baste the carpet beneath you with thin sheen of salty cum. All the while, your priestess grumply clicks hir teeth in dismay as your load sinks into the dense fur beneath you. Too lost in your own personal bliss, your lust addle senses can barely register petty concerns as the sordid sense of fulfillment flickers across your spine like lightning dancing upon a ship's hull.";
					WaitLineBreak;
				else if Cock Count of Player >= 1 and Libido of Arlene >= 12:
					say "     Your unattended [cock size desc of Player] tool swells in the satin folds of your supple dick slit as enthralling waves of verdant delight course through you at the little kiss of your tools exotic ribbing brushes your scalie vent. Despite your grown familiarity with your dragonic form, you still find yourself panting all the harder as your regal spire rifles along the silky walls of your vent. While the sordid plates and graceful taper of your rod tender pampers the lust-flushed folds of its dripping housing with intoxicating throb. Distantly, you can just barely hear lewd droplets of pre laced with your reptilian juices plinking along the ophidian maw of the Seradovah beneath you in an enthralling little tattoo. Your rod swells to full mast as the riotous pounding of your pulse resounding through your well-fucked body. Unable to resist its siren song as the merest catch of your ribbed draconic cock serenading your vent alone almost brings you to climax.";
					say "     You begin shifting your weight to one side as you thoughtlessly reach for your turgid tool with your dominant forepaw. Only to have your paw be lightly brushed aside by one of the Seradovah beneath you it looms upward, its mouth a gape as the goddess's favored hues flicker across its normally glassy vacant eyes. Though neither you nor your priestess have spoken a single command to it, you're far too drunk on your own pleasure to care where this sudden surge of purpose came from, and watch from the corner of your expansive field of view with a mix of curiosity and confusion. As the neigh on mindless creature inquisitively flickers its ophidian tongue outwards as if tasting the air while rolls over into its and leans into the [if Player is impreg_now]adorable swell of your pregnancy plush dick slit[else]tight trim curves of your cock vent[end if] as it lovingly wraps its scalie muzzle about the bestial taper of your draconic prick.";
					WaitLineBreak;
					say "     A muted gasp peters from your lips as its gleaming fangs lightly brush the stiff borders of your spire as it almost gleefully engulfs the [cock size desc of Player] length of your dick within the warm furrows of its ophidian maw. Fuck muzzles are amazing, you blissfully murrmer, at the velvety kiss of its exotic muzzle coddling your cock and the lurid caress of natural channel lovingly massaging the tender curves of your draconic tool. Your coldblooded heart nearly skips a beast as the sensual scalie bobs the supple length of its blunt serpentine snout in a worshipful rhythm. While the silky forks of its tongue glide along the sordid fleshy ridges of your cock in a coiling spiral, kneading and caressing the immaculate contours of ripe cum vein. Swooning, you rumble your appreciation to the thrallish creature as the sleek edges of its oral muscle regally pamper about your knot in a carnal sonnet, while the lucid wisps of its breath wash over your glimmering vent and glossy thighs.";
					say "     Oh goddess yes, you stammer, as the doting naga's maw roils along your cock, caressesing your noble tool with purposeful strokes of its muzzle while the graceful channel and artful ridges of its predatory maw glide along the sensitive ribs of draconic dick. Sending impossible waves of raw tactile bliss simmer though your draconic spear at scrumptious kiss of silken flesh playing the sensitive tier of tool as the seemingly ravenous scalie hunk takes evermore delectable ";
					if "Touched by Madness" is listed in feats of Player:
						say "centimeters";
					else:
						say "inches ";
					say "of your proud rod with reverent alacrity. You can almost swear your feel the thing purr beneath you as it suckles upon the bestial contours of your tool and scalie pre like a dotting subby pet. Ah that's it good thrall take that knot, you growl as its thin emerald lips brush the taut swell of your exotic gland. While a nearly inaudible rumble slips from the servile creatures lips as you feel its glossy palm glide along the [if Player is impreg_now]growing curves of your resplendent middle[else]the sleek contours of your [bodydesc of Player] feral tum[end if] towards the lush borders of your vent as it tenderly strokes the velvety folds of your slit and turgid knot with lurid little motions of its glassy smooth scalie fingers.";
					WaitLineBreak;
					say "     Slowly slipping one, then another of its dexterous digits betwixt the throbbing borders of your vent while its tongue explores the succulent ridges of your spire with near mechanical strokes of its ophidian tongue. Evincing a coldblooded chirps of draconic delight from your regal muzzle as their silk forks devilishly massage the oh-so-sensitive tiers of your titillated spire in a mind-numbingly precise little rhythm. Your many eyes slowly drift skyward at the tender echoes of the thrallish naga's tongue playing across your thrumming cum vein as the enscrolling kiss of its bestial maw coddles your cock. The beatific forks of its ophidian tongue rove the tender curves of your spire lurid ridges in a purposeful spiral that steal the breath of any lesser being. All the while, their glossy their fingers attend your swollen knot and sensuous cock cave with methodic pistons, though passionless, your lust-addled mind still wallows in the lewd dissonance of your thrall's robotic ministrations and the wild thrusts of your priestess.";
					say "     Disparate fonts of carnal rapture cascades over you like a static storm, as a ripening tension begins fluttering through your core at the regal discordance wash over you, you lightly rock your feral half intune with the sordid motions of your playthings. Desperately trying to edge just a few more moments of salubrious rapture, you push against the bubbling tide of bliss sailing through you as your servile Seradovah seems to purr with near sapient delight. Another time, you would have sworn the soulless naga were enjoying itself as its serpentine maw waltz about your spire, reverently suckling your taper spire between oddly-loving gropes of your bitch-breaking knot. Yet such insipid thoughts are the furthest from your mind as motes of many colors and none dances drift across the edges of your expansive vision as the roiling tension within you nears a feverish pitch. Till at last, you cum with a tempestuous roar as throw back your head and flare your wings outward in bestial release.";
					WaitLineBreak;
					if Ball size of Player >= 4:
						say "     Your ponderous balls and well-loved g-spot churn with virile, coldblooded excess as your ridged your spire bulges along the silky coils of your thrall's serpentine tongue as you loose a molten torrent of pearly perfection upon your pliable toy's eager maw. Nearly humming in a broken, yet almost elated cadence, the mindbroken creature worshipfully presses its boxy snout to the scintillating folds of your alabaster vent, wrapping its pencil thin lips about your knot as it roughly hilts your [cock size desc of Player] rod in the gossamer embrace of its ophidian maw. Under different circumstances, you might have snapped at the thoughtless brute for such thoughtless antics, yet your swooning mind can only gush at the sordid caress of its tongue playing along the vivacious bulges in your regal rod as you baste its eager muzzle with untold gallons of draconic seed. The room resounds with low hungry echoes of its neigh on desperate gulps, too numbed by your own pleasure, you can hardly even register the sputtering gasps of its breath washing over [if Player is impreg_now]your plush eggy tumby and ripe vent[else]glimmering tummy scales and plush dick slit[end if] as the creature struggles to keep up with your virile output.";
						say "     Casting your far reaching gaze downward, your abyssal eyes are met by the succulent sight of your lovely subby slave's blushing emerald visage as twin streams of simmering seed drip down the sides of lips as it suckles. Almost tittering with unvarnished mirth, as you drink in heady sight of your seed trailing along its sculpted scalie core with deviant pride. Bereft of any gag reflex, the thoughtless brute seems to take your load in stride, though, you can't help but notice with no small sense of draconic satisfaction, its tummy scales creak and groan with the lush weight of your offering. Such a hungry thrall, you murmur under your breath, observing a deep rosy blush spreading over its poor abused middle. As its once sleek shapely scales are stretched delectably tight while a plaintive rosy glow flickers across the nearly imperceptible borders of its golden lamina.";
						WaitLineBreak;
						say "     Strangely though, the living automata practically seems to be enjoying the lascivious swell of toned middle as its lengthy tail roams the sweltering curves of its belly with a strangely familiar enthusiasm. As its lips curl into a pleasant grin with ever worshipful suckle as its sloshing tummy edger ever close to the floor while it sway beneath you. 'Goddess dat boyo be enjoying itself now taint it me dragon?' Arlene chuckles, sparing the hungry naga a well-pleased glance as the deepening curves of its swollen belly plop against the carpet with a meaty thump. All say, you giggle in kind, watching the ravenous thrall sups the last tender drops of your offering, and collapses with soft thud beneath you. Its citrin eyes seem to fog over with lustful fugue as it protectively fondles cushy middle like it were carrying a clutch of your precious young.";
					else:
						say "     Your compact cum tanks thrums with wondrous delight as decadent pinpricks of libidinous energy course across your twitching cock as your [cock size desc of Player] rod erupts with a gentle dollop of molten cum across the prone naga drone's receptive palate. Rumbling in garbled mix of the High Cant and base animalistic trills, your abnormally eager Seradovah roughly presses its snout to your silky slit as the strange scalie engulfs your knot in its ophidian hold. Reverently suckling each tiny droplet of precious seed and exotic juices in a near worshipful hunger while its oddly skillful mitts tenderly pamper the ardent lips of your tight cock caves with supple strokes of its dexterous digits. As the lingering arcs of static delight swirling about your elated body seem drawn towards your augmented tail."; [merge to climax below]
				say "      Something starts to shift within you as the exotic muscles decorating your tentacular tail spasms enthralling as regal girth of your exotic limb bulges ever-so-slightly with the sordid weight of your malleables egg and alien juices roil about your ovi limb. Gushing at the raw carnal rapture billowing through, you find yourself roughly digging your talon into the soft carpet beneath you as the first of many goopy ovum are pushed along by the loving touch of your[if intelligence of Galaxite is 2] tendrils and[end if] unearthly muscles. Each faux contraction sparks across your tail like a heady patter of mini climaxes as their gelatinous forms glide the supple borders of your [if intelligence of Galaxite is 2]O-ring as your tendrils[else]ovi-limb[end if] bulges with their sordid impressions of your eggs flickering across the impossibly sensitive walls of your exotic tail. As the euphoric parting kiss of your tight tail cunt deposits your precious into Arlene's sweltering passage in a vibrant conga line smothering your senses in a squall of delights. 'Oh goddess be praised,' your priestess pants, as hir blushing belly buldges with intoxicating touch of your eggs[if intelligence of Galaxite is 2] and ravenous tendrils[end if] while you relish every supple quiver of hir well-loved cunt lavishing your [if intelligence of Galaxite is 2]inquisitive tendrils[else]augmented petals[end if] as you instinctively pamper hir lurid passage with the tenderest of caresses.";
				WaitLineBreak;
				say "    The innervating touch of your goopy ovum and [if intelligence of Galaxite is 2]dexterous feelers[else]glossy spade[end if] put the most succulent of pressure on your elated priestess's hybrid g-spots while their malleable forms lightly brush hir yearning cervix as hir receptive body seems to drink in your offering. ";
				if Libido of Arlene >= 1 and Libido of Arlene < 12:
					say "Glancing over your shoulder, you can't but swoon at the sight of hir blushing core as hir once tight sculpted middle groans and creaks with the unsubtle impressions of your regal spawn. 'By da neath, so full,' shi growls with base delight, hir voice crackling in a near bestial draconic trill. As hir lush tummy presses against your flanks while hir body struggles to contain your virile offering. All to the blissed-out selachian's delight as hir pulse races and cocks twitch [if intelligence of Galaxite is 2]in your tentacular embrace in tune with each rapturous kiss of your exotic eggs. Scintillating sweat pours from hir brow like shimmering diamond as hir plush little baby batter banks thrum in sordid caress of your tendrils as your aquatic mate meekly pistons hir hips with last waning vestiges of hir strength [else]with lingering caress of your fins gracing hir supple walls[end if].";
					say "     Wallowing in the pleasant echoes of hir struggles, and the flagging corkscrew of hir throbbing cocks, you benevolently fix your lovely pet with an appreciable smirk humming. Go on pet, cum for your mistress, as you [if intelligence of Galaxite is 2]encouragingly stroke your glossy tendrils about hir sordid sack and sensuous tools with imploring motions[else]enticingly corkscrew the glimmering hills and malleable valleys of your ponderous limbs sail along the quivers hir button[end if]. Nodding with a far-off look in hir eyes, a titillating tension arcs through hir aquatic muff as hir tender walls eagerly cinch about the last of your divine eggs. While a decadent twitch simmers across the edges of hir oh-so-palmable package as with one muted mew, your plaything cums, drenching your elated passage[if intelligence of Galaxite is 2] and elastic tendrils[end if] in a balmy sheen of futa seed. Mh, poor pet, you had no idea shi was so pent up, you snicker, at the lascivious shiver sailing up your spine while your [cunt size desc of Player] cunt spasms with primeval bliss as the little death claims you.";
					WaitLineBreak;
					say "    Your needy walls clench about the sultry siren's writhing rods as your tauric body and tentacular feelers desperately milk each wondrous drop of your spellbound lover's precious seed with divine alacrity. While shi collapses against your proud flanks spent, tried, and devilishly full, murmuring, 'By [one of]Salt[or]Storm[or]Stone[at random] my dragon ya know how ta treat a lassy.' As you supportively coil your tail about hir hale waist, lest shi fall to the floor. Of course pet, dotting servants like hir deserve treats from time-to-time. Especially when they performed so... admirable, you gnarr, absentmindedly pawing at a growing patch of virile warmth spreading across your tauric tum with your dominant forepaw. 'Aw ya be too kind me, me lovely,' Arlene purrs, hir twin spires slowly deflate as shi nuzzle hir angular snout against you. You can't help but swoon appreciatively at the parting kiss of cocks caressing [if intelligence of Galaxite is 2]your tendrils and [end if]raw slit as they slip free with an endearing pop. You sashay past your panting plaything, proudly swaying of hips with each step and leaving a thin trail of salty seed in your wake as amble back to the main hall.";
				else if libido of Arlene is 0:
					say "Shuddering delightfully, you tenderly withdraw your own [if intelligence of Galaxite is 2]supple tendrils with deliberate slowness, relishing the heady sapor of hir exotic dew gracing your maw and the cute little subby moans for your favored mate. As your feelers slip of hir thrumming folds,[else]dew slick tail with purposeful languidness, exalting in the subtle parting catch of your fins gliding about hir elastic folds and jubilant shudder of your precious mate as[end if] you caringly ease to hir the floor with practiced, grace, while shi drapes hir lovely burgeoning body across the well-padded carpet. 'Oh cribins me heart, just look at the sight [']O da wee ones, goddess I'z hope day stick!' shi titters, arching hir back as shi admires the adorable swell of hir cute blushing middle. Drinking the spectacle of hir simmering curves and spreading crimson glow engulfing hir egg stuffed tum, you can't help but rumble in agreement.";
					if player is impreg_now:
						say "     As you drink in the spectacle of hir simmering curves and spreading crimson glow engulfing hir egg stuffed tum, while dottingly run your hands over your own gleaming bump. After all, you preen at the thought of sharing your preferred state with such a kindred soul, there are few pleasures greater than playing mother to such regal spawn. 'Aya me lovely,' Arlene crows, indulgently running hir paws along hir supple blushing middle, 'doubly so when the rewards are so rich!' Indeed little mouse, you'll make a fine broodmare out of hir yet. 'Yar-har-har, I look forward to it me dragon.' your priestess chuckles as shi stretches out upon the floor, basking in the heavenly afterglow of your coupling. Chriping in agreement, you lean down and give your delectable breeder a quick parting kiss before seeing yourself out.";
					else:
						say "     Drinking the spectacle of hir simmering curves and spreading crimson glow engulfing hir egg stuffed tum, as you enviously pamper the silky contours of your tight athletic middle. Besides, you simper, it's only fair you get to share in the fun too. 'Indeed me dragon, goddess willing we be adding a right many more names ta da books soone enough.' Arlene hums expectantly as hir hir traces the chiseled peaks and regal valleys of your divine form. Well spoken pet, it's been far too long since you've had another to clutch, why you were beginning to forget how it felt. You rumble, giving your tummy an appreciative pat. 'Aya un we can't be having dat me lovely, side I'z be lying if I'z didn't enjoy the sight of ya strutting through da halls with nice be clutch of me wee ones.' your priestess chuckles as shi stretches out upon the floor, basking in the heavenly afterglow of your coupling. Purring in loving contentment, you reach out and gentle stroke hir still glowing middle, while hir much the same. After all, its rare to find a fellow breeder who enjoys this as much as you do, you add as saunter past your spent pet with an invigorated waggle of your hips.";
				else if libido of Arlene >= 12:
					say "Tilting your proud draconic head backwards, abyssal lips peel back into a devilish smirk at the rapturous sight of your plaything's lush rosy tumby straining against the silky white sheet holding hir brood blessed bump aloft. As hir taut tum groans with each supple kiss of your malleable eggs, you watch, with no small amount of amusement as the fabric begins to fray and the rich wine purple tigerstripes gracing hir creamy hide throb and deepen by the second as hir body swells with draconic life. All the while, your priestess audibly pants in utter bliss as thin tears form along the alabaster fabric supporting hir as hir bump spills between the cracks, murmuring. 'Ah goddess yes, fill me ya wondrous beastie,' paws drifting to the shimmering curves of hir flush core as shi ruts your eager muff with labored pistons of hir blossoming hips.";
					say "      Hir twin spires thumb delectable at each sensual pass of your tendrils and aquatic walls pamper hir glossy spires in their vivacious embrace as you fix hir with a smoldering look as you hum. Go on pet, cum, while [if intelligence of Galaxite is 2]your feelers reverently massage the spasming borders of hir G-spots and compact cum tanks[else]you arc your spaded tail about the elated contours of hir g-spots[end if] in a sordid ballet of hybrid ecstasy. Your plaything can only whimper in reply as the Seradovah supporting hir coils their glittering tails about hir shaky legs for support as if to urge hir on. Leaning into their embrace, your plaything fervently bucks hir hips with the last waning ounces of hir strength[if intelligence of Galaxite is 2] while your tendrils squirm about your dripping passaging in a decadent spiral of rollicking sensation[end if] as shi cums with a relieved sigh. Hir ripe cum veins bulge ever-so-slightly with the toasty weight of hir load roiling about hir spires as shi loose a torrent of selachin seed upon your slutty folds.";
					WaitLineBreak;
					say "     Rumbing with bestial draconic satisfaction at the heavenly warmth seeping your core, you can feel your hungring walls cinch about about hir spent spires in a decadent dandle as your ravenous body seems to drink in hir lovely offering. Your raw cunny muscles soon spasm like an overloaded switch board as you cum once more with a contented rumble as your palms drift to ";
					if Player is impreg_now:
						say "the tender curves of your well-loved middle as the tumultuous echoes of static delight course across your scales. You can't help but urge your brood to drink in your priestess's blessed load while lovingly pampering their slumbering form with paws, relishing the thought that one day soon you'll be holding your precious spawn in your arms. And together share in the wondrous destiny that a waits you both in day to come.";
					else if Player is impreg_able:
						say "the yearning curves of your [bodydesc of Player] respective tum, rollicking at vibrant tendrils of coldblooded satisfaction simmering though your muff as you thoughtlessly whisper a prayer to the goddess urging her to let this load stick. As your body craves the priceless euphoric bliss only your brood can bring you, you muse while the heavenly memory of your maternal splendor fills your mind's eye. You can't help but purr at the thought of feeling your body ripen once more with divine life, and all the blissful changes your preferred state brings. As intoxicating images of your growing curves perched atop vast oceans of treasure and army of thralls attending your and your chosen's every need briefly wash over you.";
					say "     Your now spent priestess, sways ever-so-slightly on hir shuddering legs, barely even able to support hir burgeoning body as shi eases hirself into the waiting embrace of the Seradovah's coils with a contented sigh. 'Yarg feelz like I'z about ta pop,' shi hums, proudly pawing at hir heaving tum as the flush rosy hem of hir bloated belly spills out across hir while your mate's supple tools soften within your muff's aquatic embrace. Chuffing happily at the sight, you can't help but enjoy the spectacle of hir groaning curves and the parting caress of hir cocks as they leisurely glide along your silky passage and supple button as you playfully tell how hir how adorable shi looks like this. 'Daw, ya be too kind to dis [']ere old sea sow. Doe,' Arlene purrs, leaning into your gaze, 'I'z must admit dis I'z could be getting used to dis me heart,' while shi lovingly drapes hir arms over the deepening folds of hir turgid tum. 'Specially when I'z got des boyos to take care of me,' shi adds, bobbing hir head towards the Seradovah supporting hir lush form.";
					WaitLineBreak;
					say "     Of course, you chuff in agreement as you carefully withdraw your [if intelligence of Galaxite is 2]tentacular[else]ovi[end if] tail with a fanciful flourish, after all hir new curves and servants suit hir. 'Yar-har, all say me dragon, this accord of our be working out right fine, un doe I'z never thought meself cut fir do clothe, service to her ladyship be a might bit more [']fulfilling['] den me days prowling da deep blue.' Arlene preens, reclining out upon the Seradovah's ponderous coils as if to bask in hir glorious condition. 'Why, jus tink-[']N [']bout all da petty plots un schemes me un da [one of]ladz[or]boyz[or]grotz[at random] would weave all ta nick a few bobble er trinket when we'z couldz [']O been working fir her ladyship be boggling da mind,' shi rumbles, wistfully. Nodding, you express a similar sentiment as your meager struggles in the city and your old life seem like such a puny compared to the destiny that awaits you now. 'Aya me dragon, *yawn* un dare be no other soul I'd wish ta share dat with.' Arlene hums sleepily, sinking into your thralls coils as shi slowly drifts off to sleep in the naga's protective glossy coils. In no mood to disturb hir, or your spawn's peaceful slumber, you quietly paw over to hir bed, gather a few blankets and drape the over hir bountiful from before departing.";
				NPCSexAftermath Player receives "PussyFuck" from Arlene;
				NPCSexAftermath Arlene receives "PussyDildoFuck" from Player;
				if Libido of Arlene >= 1:
					increase Libido of Arlene by 3;
				if Libido of Arlene is 0:
					now Libido of Arlene is 1;
				if Cock Count of Player >= 1:
					NPCSexAftermath Player receives "Stroking" from Arlene;
				Move Player to Dragon's Causeway;
	else:
		say "     [italic type]Author's Note[roman type]: Arlene's scenes are not compatable with non-pureblooded Dragon Breeder.";

Table of GameEventIDs (continued)
Object	Name
Flight beckons	"Flight beckons"

Table of WalkInEvents (continued)
Priority	Name	EventObject	EventConditions	EventRoom	LastEncounterTurn	CoolDownTurns	EncounterPercentage
1	"Flight beckons"	Flight beckons	"[EventConditions_Flight_beckons]"	Grey Abbey Library	2500	2	100

to say EventConditions_Flight_beckons:
	if BodyName of player is "Dragon Breeder" and Player is pure and Cunt Count of Player >= 1 and Energy of Galaxite is 4 and Intelligence of Galaxite >= 1 and scalevalue of Player is 5:
		now CurrentWalkinEvent_ConditionsMet is true;

Flight beckons is a situation.
ResolveFunction of Flight beckons is "[ResolveEvent Flight_beckons]".
Sarea of Flight beckons is "Nowhere".

to say ResolveEvent Flight_beckons:
	say "     Peregrinating about your little bastion of calm amidst the sea of chaos battering the city in preparation of your next foray into the unknown, you feel an odd prickling sensation flickering about the edges of your tendrils as the unnatural sensory cells lining their sucker-laden lengths thrum with activity. Though initially peculiar, as you pour your liminal focus towards these sensory blips, your mind is met with a sudden eclectic mix of emotion flooding through the back of your draconic skull. As a profound feeling of being watched trickles through your awareness alongside notes of... you pause, allowing the sensation to wash over you... familiarity tickle at the back of your mind. You muse, as you continue to go about your day as if nothing were wrong while letting your abyssal senses flow outwards as your exotic tendrils [']ping['] the area around you. In seconds, crude images of the various buildings, ruined cars, omnipresent bits of moldering trash, and cast off clothing shimmer into being in the dark recesses of your minds as if some unseen hand were hurriedly etching away upon some archaic black and white scratch pad. Little stands out to you, beyond the unusually wavey quality of the mental imagery, yet as your otherworldly senses pierce the rooftops and begins to caress the firmament, new images fluttering into being as rough simulacrums of several winged tauric figures swirl about your mind's eye.";
	say "     Focusing upon them, your augmented awareness picks up a number of all-to-familiar features upon them as rough images of swept-back horned heads graced by girthy tendrils, and a sleek aquatic sail running down the length of their hydrodynamic bodies stir something within you. Your spawn, you whisper under your breath as a rush of motherly affection smolders in your breast at the thought of your wild oats returning to you. You hastily flap your wings and leap towards the nearest building with a subsonic crackle as you sink your taloning into the weak concrete surface of some nameless structure, relishing the sensation of their scything edges rending deep gouges into its pathetic surface as you barrel up its side sending a show of brick and mortar behind you as you ascend. Hand over paw, you surge up the many stories of this puny structure propelled forward by mighty flaps of your wings and the unerring bite of your talons till you pull yourself up the grey building's side. Landing with a muted swish, the impact of your paws scatters the ubiquitous grey and black speckled tar used to coat most roofs sending dust and ash flying through the air while bellowing a proud, yet welcoming draconic roar as you scan the clouds for signs of your wayward brood.";
	WaitLineBreak;
	say "     In reply, a trio of brassy bellicose cries reverberate through the area as your descendants swoop down from above like brilliant cobalt comets as they kick up a squall of dust impregnated with aggregate and old weather-worn cigarette butts as they drop to their knees in reverence, intoning as one, 'Nah se sturm slayrak Monah,' as they dip their angular heads to the blacktop in deference to their maker. Bidding them to rise with a loving reptilian chirp, you can't help but admire the sight of the lone female, flanked by a pair your hermaphroditic progeny arrayed before you. Equally as tall as you are, their proportions are closer to the bawdy pirate sharks you encountered some time ago, though their wings appear to be a touch more developed, not to mention larger, as your descendant's can barely tuck them to their sides. Peering along their sinuous [bodydesc of player] lower halves and thick predatory flanks, you're pleasantly surprised to note that your errant brood boast ";
	if Intelligence of Galaxite is 1:
		say "the same slender spaded tail as you.";
	else if Intelligence of Galaxite is 2:
		say "the same manner of subtle seams running along the borders of their tails as yours.";
	say "     Perhaps feeling your appreciative abyssal gaze upon their enhanced figures, the lips of your spawn curl into muted knowing smirks coiling on the edges of their royal blue muzzle as they rise to their full imperial as the middle dragoness and sole female among them says, 'Rosus for our sudden intrusion upon your,' in a respectful, if hesitant cadence as she tucks her paws to her sizable chest and her hitchhiker's thumbs together in effigy of a pair of draconic heads and fans her webbed fingers outwards like wings as she casts her gaze over the abbey and its various inhabitants. 'Ahem, humble territory monah. But we have been sent here with a message from our zast monah, Kai Sunrak.' Cocking a scalie eyebrow in mild confusion at the somewhat unfamiliar terms she quickly adds, 'Our other mother, the Ocean Priestess, Lady Arlene,' though you detect a note of awkwardness in her voice at this correction, why though, you can't be certain. Nevertheless, you nod and bid your dutiful spawn to rely your nascent priestess's message. 'Gah monah,' she says, letting her paws fall to her side. 'It is with great pride,' she beams as her and sister puff out their chest and tails twitch behind them.";
	WaitLineBreak;
	say "     'That we have come to inform you that the pacification of Pirate Island has completed and with aid of our goddess Tiamat, The Holy Empress of Chromatic Wyrms, Lady of Many Colors and None, Patron of the Lost and the Damned, The Corner Stone of Order, and soon to be saviour of the sphere we have finished laying the groundwork for your temple,' she rumbles reverently, her golden eyes alight with beautiful coldblooded fervor as her sisters to her right says, 'By her will as dedicated by our fruitful zast monah we too have begun scouring the city for worthy human supplicates to worship at your paws,' as shi gestures to the wider city with a sweeping wave of hir wings. 'And,' the left herm chuffs as hir right forepaw drifts to hir feral midriff, 'grow our flight in preparation of your ascension on the eve of the goddess's arrival.' Smirking at the thought of what wonders await you, you ask your brood to take you there then, so you may greet your flock and begin the great work. Though as soon as these words leave your lips, you notice children's luminance eyes dim while they shuffle demurely from side-to-side before the female speaks in a downcast tone. 'R-regrettably vaysun da Kai Monah, the winds of Kyre will not bear you as they do us,' she gulps with a shamefaced look on her regal muzzle. Perturbed, you ask her to elaborate. 'Rosus monah,' she peeps shaking her head, 'but your form, though mighty, is still shackled to the ways of mun and as such you can not fly as we do, for now, or so the hen klovve has said.'"; [Vaysun = vessel]
	say "     Why not just carry you to the island then, you counter. 'Would that we could monah,' the right herm mutters, as shi sheepishly traces hir foretalon along the blacktop, 'but the many beasts of this land and the constructs of the kin da mun vex us at every turn.' shi growls, casting a baneful eye towards the clouds. 'Much as it would please us to bring these insolent gnats to heel in the goddess's name, we are,' the left herm snarls as shi clicks hir barbed fangs, 'forbidden from aggravating the rabble.' Then why not simply escort you over land to the temple grounds, surely that would not draw too much attention? Besides, you can't say a part of you wouldn't mind spending a few minutes to get to know them. 'Zunni zul,' the female says with a sagacious bob of her head as her sucker-laced tendril hair cascades about her regal visage. 'Any other time we would relish the chance to bask in your presence and bring righteous battle to the churls of this sphere honored wyrm maker! Yet,' she pauses as her jaw clenches, 'our duties to the goddess can not be shirked, so for now we return to our nier and continue surveying this city for fresh followers, ol faal hen klovve uth. At least,' she smirks, as her paws briefly drift to her toned scalie middle, 'until our numbers have been expanded.'";
	WaitLineBreak;
	say "     Rumbling in a soft neutral tone, you decide to drop the matter, for the moment at least, as you can sense your progeny will not budge on this, and instead ask for proper directions. Knowledgeable as you may be of the city, along with its surrounding environs, your brood was a touch vague as many minor patches of dirt and rock could easily be called pirate island. After all, it's not like you could [bold type]just travel to The Beach and hunt for a message in a bottle to find out where this pirate island is[roman type] much less stumble onto the grounds, you muse. 'Gah Monah, zinii zul rosus un mey kirre,' the lone female says with a genuine air of contrition as she lowers her eyes and briefly tips her snout to her breast before continuing. 'Far to the southwest,' she rumbles, gesturing towards the beach with a gentle wave of her tail, 'and well past the forgotten shores of Vohr island is a vast cavernous islet that was once home to Kai Sunrak's treacherous crew. Along its [italic type]western[roman type] shore is a [italic type]Quiet Sandbar[roman type] flanked by a number of ancient tidal caverns that lead to a maze of long dead lava tubes and half sunken warrens. Amidst this chaotic web of switchbacks and dead ends, your temple rests snuggly in the warm womb of the earth, along with our many kin,' she preens."; [Of course mother, you speak the truth, please forgive your foolish children.]
	say "     Nodding, you ask how you're supposed to navigate the caverns then. 'Ah, dread not monah, the Seradovah regularly patrols the area, and will guide you to us once you have made landfall,' the right herm chirps, fanning hir wings beside hirself as if making ready to take off. Sounds simple enough, you reply, idly peering over the scattered roof tops towards the bay and wider ocean beyond. 'Indeed monah,' the right herm hums with a respectful bob of hir scalie head, 'may your journey be swift, would that we could accompany you, but,' she rumbles mournfully, 'duty requires us elsewhere,' as hir haunches tense and talons lightly rake the ground beneath hir paws. Sensing they're getting ready to leave, you decide to...";
	LineBreak;
	let Parting_words_Choices be a list of text;
	add "Let them go." to Parting_words_Choices;
	add "Praise them for their dedication to the goddess." to Parting_words_Choices;
	add "Give them a goodbye hug." to Parting_words_Choices;
	let Parting_words_Choice be what the player chooses from Parting_words_Choices;
	if Parting_words_Choice is:
	-- "Let them go.":
		say "     In no mood to dissuade your wild oats from their task, you bid them leave with a regal wave of your dominant arm before you step back and allow them space to take off. 'Our thanks Monah, it has been...' the lone female pauses, her lips curl into an almost smile as beautiful silver hues dance upon her chromatophores, 'good to see you even if only for the moment, mayhaps one day we will have more time speak as Zin kin. Till then Nah se sturm slayrak, mother,' she simpers as she gallops past and leaps into the air, while kicking up a dervish of dust devils behind herself as she soars into the available cloud cover, then vanishes from sight. While her hermaphroditic siblings share a quick yet oddly perplexed look at one another, before hastily bowing to you. 'May your travels lead you to warm sands and gentle tides, honored wyrm maker,' the left herm intones, before bolting into the air and sailing after hir sibling. 'And may the goddess protect you and,' shi glances towards the library, 'your pets who shelter in your grace vaysun da Kai Monah,' the right intersexed dragoness rumbles as shi too darts off the edge of the building and soars into the firmerment.";
		say "     Watching their shadows peter away into the cloud cover, you can't help but feel a note of pride welling in your breast after your all too brief encounter with your brood along with the knowledge that your distant wyrmlings are not only safe, but seem to be following in their sire's paw prints. Perhaps one day soon, you might even meet a few of your few grand wyrms, or great grand wyrmlings, you muse, utterly unable to hide the goofy grin pulling on the edges of your muzzle at thought. But, you ruminate, as you hop down from the roof top using your nascent wings to slow your descent, such fanciful notions will have to wait, for now you need to busy yourself with locating the Quiet Sandbar upon Pirate Island. Then once your tasks there are complete, you can focus on connecting with your expansive brood and make up for lost time.";
		now Flight beckons is resolved;
		now under sea is active;
		increase score by 69;
		increase XP of Player by 50;
		now Perception of Arlene is 1;
	-- "Praise them for their dedication to the goddess.":
		say "     Touched by their dedication to heralding in Tiamat's arrival and hastening your own ascension to mistress of this sphere, you offer your dutiful young the most heartfelt praise for putting the needs of the goddess needs above their own desires. After all, though it pains you to see them go, there is no telling how long this besieged sphere has left before greater monsters than those roaming the streets, or brooding in the dark forgotten place of this world will appear. Once this world is secure though, you look forward to making up for lost time and getting to know your flight properly, you proffer with a warm maternal smile that sets your children's many eyes alight. 'Th-thank you for understanding my wise monah,' the lone female stammers as she quickly kowtows before you as a single scintillating tear stream down the contours of her scalie visage. 'My siblings and I shall look forward to the day we may take our place at your side and revel in the glory of your ascension together!' Her siblings quickly drop to their knees beside her with their heads bowed. 'Indeed great monah, you speak with the wisdom of the goddess as befitting of the vaysun da Kai Monah,' the left herm reverently intones.";
		say "     'Zin sisters, monah's words honor the goddess and our flight, as is proper,' the right herm hums dutifully. 'Gah my clutch mates, but is such wisdom not expected from the vaysun da Kai Monah?' the female simpers proudly. 'Zin,' the others rumble in coldblooded agreement, as the trio of dragonesses return to their full height and fix you with an affectionate look as the female says, 'We shall remember your words, great wyrm maker, and ensure our many siblings hear them so they may draw strength from your example and devotion to the goddess.' Loosing a pleasant draconic chirp, you return a similar sentiment and bid them well on their hunt for more followers. 'Thank you monah, may your niers be fruitful, and foes quake at your passage!' the dragon sisters bellow, pressing their hands to their chest as they work their fingers into the odd two headed dragon symbol once more while flaring their wings out beside themselves. Beaming at their fervor, you casually step back and watch as they launch themselves once more into the cloud line in a loose chevron formation.";
		WaitLineBreak;
		say "     Watching their shadows vanish into the cloud cover, you can't help but feel a note of pride welling in your breast after your all too brief encounter with your brood along with the knowledge that your distant wyrmlings are not only safe, but seem to be following in their sire's paw prints. Perhaps one day soon, you might even meet a few of your few grand wyrms or great grand wyrmlings, you muse, utterly unable to hide the goofy grin pulling on the edges of your muzzle at thought. But, you ruminate, as you hop down from the roof top using your nascent wings to slow your descent, such fanciful notions will have to wait, for now you need to busy yourself with locating the Quiet Sandbar upon Pirate Island. Then once you're task there are complete, you can focus on connecting with your expansive brood and make up for lost time.";
		now Flight beckons is resolved;
		now under sea is active;
		increase score by 69;
		increase XP of Player by 50;
		Increase Dexterity of Arlene by 1;
		now Perception of Arlene is 1;
	-- "Give them a goodbye hug.":
		say "     Unwilling to let your kids leave without a proper goodbye, you hurriedly bid them to wait, if only for a moment. Cocking their heads in shared surprise, your daughters flex their tendril hair or bat their tails in confusion as the female begins, 'Of course monah, what is your-' only to have her words die on her thin cobalt lips as you leap forward then hurriedly wrap your arms about her as you pull her snout to her shoulder as you lovingly nuzzle your muzzle against her. 'M-mother what are you doing?' your daughter stammers as tension briefly flares through her toned draconic body. The warmth of your embrace and a low series of gentle reptilian chirps quickly melts away reticence she may have had as your regal daughter returns your gesture, cooing, 'So warm, what manner of magic is this?' Purring good-naturedly, you platonically run your finger along her beautiful sail, while telling her this is just a simple long overdue hug, nothing more. 'But it feels so... nice like the voice of the goddess singing to me in my dreams.' Tutting, you ask if her other mother has never hugged her before.";
		say "     'Once when shi first weaned us, but this feels different... better,' she rumbles dreamily, though hints of sorrow still flicker through her voice as her paws gingerly glide along your upper back while she melts into your arms. There-there, mommy's got you dear, you simper sweetly, delighting at the simple joy of holding your daughter. Powerful as you may have become, and alluring as Tiamat's promises may be, few things can compare to the sense of love and affection you feel towards young, or the bubbly upwelling of heavenly pride building in your breast at having gifted your children with such beautiful forms. As no matter what the future holds for you, you know on some deep instinctual level your draconic spawn will survive in this flexible world you've found yourself in. 'Th-thank you mon-... mom,' your daughter mews, burying her face all the deeper in your chest. Of course dear, you whisper tilting your snout to one side and planting a single light air kiss on their forehead, then beckon your hybrid progeny to join you with a welcoming maternal wave of your tail.";
		WaitLineBreak;
		say "     'Gah mona-,' the right herm rumbles, lightly shaking hir head, 'er yes mom,' as shi and hir sibling prance up beside you, draping their arms and wings over you, and their sister as they snuggle their angular muzzles along your shoulders. Their warm and effervescent affection cascades over you while you lightly pat their powerful lower halves with your forepaws in a mix of admiration for your imperial young's impressive physique and profound pride at siring such paragons of draconic perfection. 'Ah you're right sister, this feels so... good,' the left herm murmurs as shi platonically pats your flanks with hir forelimbs. 'Zin I have had no idea this feeling existed till now,' the right herm mewls dreamily. Perturbed, you rightly ask why not? Surely shi must have mates, if not clutches of hir own? 'Ga-, er yes mother, but our lot is to serve as the five heads commands!' shi rumbles with a deep feverous tenor, though you can hear a slight, almost resentful, crack in hir voice as shi continues. 'And time spent coddling the hatchlings is time that could have been spent searching for more followers, yet to deny my young this feels wrong. Ah, apologies mother, I do not mean to blaspheme against our patron and saviour,' shi adds with a shameful look in hir eyes.'";
		say "     Clicking your teeth, you plant a light peck on hir forehead and tell there is no shame or heresy to be found in wishing to spend time with hir clutches as the bonds between parent and child are almost as important as those between the goddess and them. 'I-I had not considered that, I will remember the next time I see my daughters,' the right herm says thoughtfully as hir paw drifts to hir hale midriff. 'And we shall pass on your words to our siblings and progeny as well, mother,' the left herm hums, fixing you with an attentive stare. Positively beaming with maternal glee, you reach out and ruffle your lovely hybrid child's tentacle hair, while telling hir, and hir sibling, how happy you are to hear that. You all have a hard road ahead of you, but together, the journey could be made easier. 'Zinii zul,' they murmur in union as your trio of lovely daughters give you one last group squeeze before disentangling themselves from you.";
		WaitLineBreak;
		say "     'But we dally here too long, still, thank you for your counsel, mother,' the lone female rumbles, nodding her head respectfully at you before trotting over to the edge of the roof, leaping into the air, then sailing towards the cloud banks. 'May we meet again soon upon the hallowed grounds of your temple,' the left herm intones, briefly clutching hir paws to hir breast, before taking wing after hir sibling. 'Indeed,' the right herm hums, nodding towards the shrinking images of hir siblings, 'I look forward to the day that I may introduce you to my own brood.' Smirking, you tell her you can't wait to meet them, and the rest of your flight. 'They will be happy to hear this mother, till then, farewell!' shi roars as shi sprints after hir clutch mates then hurls hirself off the ledge and hurriedly soars beside them as they sail towards the heavens in a loose chevron formation.";
		say "     Watching their shadows peter away into the cloud cover, you can't help but feel a note of pride welling in your breast after your all too brief encounter with your brood along with the knowledge that your distant wyrmlings are not only safe, but seem to be following in their sire's paw prints. Perhaps one day soon, you might even meet a few of your few grand wyrms, or great grand wyrmlings, you muse, utterly unable to hide the goofy grin pulling on the edges of your muzzle at thought. But, you ruminate, as you hop down from the roof top using your nascent wings to slow your descent, such fanciful notions will have to wait, for now you need to busy yourself with locating the Quiet Sandbar upon Pirate Island. Then once your tasks there are complete, you can focus on connecting with your expansive brood and make up for lost time.";
		now Flight beckons is resolved;
		now under sea is active;
		increase score by 69;
		increase XP of Player by 50;
		increase Strength of Arlene by 1;
		now Perception of Arlene is 1;


Table of GameEventIDs (continued)
Object	Name
under sea	"under sea"

Table of WalkInEvents (continued)
Priority	Name	EventObject	EventConditions	EventRoom	LastEncounterTurn	CoolDownTurns	EncounterPercentage
2	"under sea"	under sea	"[EventConditions_under_sea]"	Pirate Island	2500	2	100

to say EventConditions_under_sea:
	if BodyName of player is "Dragon Breeder" and Player is pure and Cunt Count of Player >= 1 and Perception of Arlene is 1:
		now CurrentWalkinEvent_ConditionsMet is true;

under sea is a situation.
ResolveFunction of under sea is "[ResolveEvent under_da_sea]".
Sarea of under sea is "Nowhere".

to say ResolveEvent under_da_sea:
	say "    Prowling along the soft pearly white and gold sands gracing this desolate, yet unerringly placid section of this alleged former pirate enclave, you can find neither scale nor fin of the Seradovah said to be patrolling this place. Then again, the rough surf battering this modest islet alongside the countless caverns lining the area's craggy interior offer quite a great deal of cover, even for beings as large and intimidating as the hunky nagas. You muse, passing by the various mouths of some of the more sizable cave entrances, worn by the constant ebb and flow of the tides and pitted with barnacle holes, both old and new. The local slate has taken on an almost lunar quality as strange channels accompanied by odd bellies in the rock running across the stone at chaotic angles that stretch deep into the gloomy briny depth. Flaring your chromatophores for effect, you bathe the area in a soft bone white as you peer all the further into the umbral pall, only to find this rocky tube ends in a rubble strewn puddle no larger than a kiddy pool full of brackish salt water laden with detritus and crushed sea shells.";
	say "     Shaking your proud scalie visage in mild irritation, you head back to the churning surf and momentarily consider submerging yourself in the waves once more to ping the Seradovah with your budding eldritch sonar, but swiftly abandon the idea. You have no interest in peering at the horrid wound festering in their breast again any time soon, or at least until you figure out some why to avoid being drawn in by it. Though it galls you to no end to be forced to wait upon your lessers thusly, you decide it best to simply stay near the water's edge. Besides, you ruminate, the trip here was not exactly the easiest, so why not take a few minutes to sit back and rest till the lowly puppet things reveal themselves. You muse, selecting a mostly clean patch of sand some distance from the crashing waves then gently lower yourself onto your back and tuck your arms behind your head as bask in the [if daytimer is day]warm rays of the sun as they play across your velvety scales[else if daytimer is night]brilliant starlight as the muted glow of the vibrant nightsky shimmers along your silky lamina[end if] while you wait.";
	WaitLineBreak;
	say "     [italic type]An indeterminate amount of time passes[roman type], and beyond the pleasant of hymns of the wave curling around you, or the faint songs of seabirds nesting in hidden rocky lees dotting the inner island delighting your ears, very little has happened since you first laid down. Grumbling in aggravation, you prop your upper half up to stare balefully at the coiling off-green waters and swirling alabaster white caps inching ever closer to you as the tide steadily rises. Though as your enhanced vision combs though at the assort flotsam and jetsam milling through the waves, you spy an odd ripple of lustrous gold and gossamer emerald fluttering through the surf. At first glance, you give it little notice, merely assuming the minor anomaly to be nothing more than brightly colored plastic, or perhaps a buoy shorn free of its mooring by the eldritch storm you helped herald in. Yet, as it slithers along the boundaries of the Quiet Sandbar, your augmented senses quickly spot a purposeful pattern in its movement as a spined sail soon peeks out of the frothing waters as it barrels towards you.";
	say "     Though momentary flickers of alarm ripple through your mind, the instant passes quicker than it came as the cold numbing balm of recognition washes over you as you whisper Seradovah under your breath as its statuesque hybrid's crocodilian muzzle breaches the surface and a pair of reflective yet oddly dull slitted eyes lock onto you while it slithers onto shore. Took them long enough, you huff, as you ready a well-deserved tirade for the indolent cur, then recall these soulless automatons have no hope of comprehending your ire, so any attempts at unbraiding one would be foolish waste of your time. You grumble with an aggravated shake of your head as pull yourself to your full height and watch as it slinks on to shore. Though for all its tardiness, you can't say that you aren't enjoying the light spectacle of the ribbons of sea water cascading down their burly shoulders and tough rippling pecs as the impressive demi-leviathan glides along the crisp blues waters. Or the lovely glint of its scales as the dense ripcord muscles lining its lengthy tail and shapely ass shimmer in available light as it silently slithers upon the pearly dunes to bow before, intoning, 'Nah se sturm slayrak Vaysun da Kai Monah,' pounding its bony fists into the sand, sending a brief rumble through the ground.";
	Project Figure of Seradodovah_soft_icon;
	WaitLineBreak;
	say "     Bidding it to rise, though you doubt it understands you much less has any true concept of the world around it beyond whatever its order were, you nevertheless watch as it jerks itself into an ophidian standing position rumbling. 'Fellow... temple... below,' in a dry mechanical mantra as it glides past you towards one of the smaller caverns nestled along the borders of the Quiet Sandbar. Never once though does it stop to look back to see if you're heeding its words, nor does it cease its senseless prattle as it edges its massive frame through the stony aperture. Rolling your many eyes, you begrudgingly hurry after it before the creature fully dips out of sight, propelled by your powerful lower half, you catch up to it in seconds and march in lockstep behind the enthralled scalie. Together you trudge through the gloomy twisting paths while the comforting sound of the ocean waves and ambient light peter away each second till only your draconic radiance and the monotone chant of the Seradovah are left to keep you company.";
	say "     Deeper in, the area grows all the colder as the rocky floor steadily gives way to silt-rich muck that clings to your webbed paws and the sickeningly sweet scents of ancient aquatic decay laced with earthy tangs whose origins you can't quite place with each step you take. Which only serves to fuel your growing ire, as the minutes drag on, you briefly asking your [']guide['] how much longer this will take, yet you doubt the mindbroken creature knows, or even has the ability to answer you even if it did. You ruminate, watching the hulking thrall pause at the edges of a vast impossibly still pond appearing out of the shadows. Chirping to itself in some broken tongue, the creature rears back and dives head first into the stagnant filth-laden liquid. You can feel tendrils of revulsion clawing at the back of your mind at the notion of defiling your draconic beauty by submerging yourself in such rot, yet you quickly bite back against the rising tide of bile surging in your breast and flare your chromatophores all the brighter then dive in after them.";
	WaitLineBreak;
	say "     All the while you try to suppress your resplendent body's natural instinct to invoke the power for your eldritch eyes as you swim down through the narrow passageway as the fetid soup of silt and decay sullies your senses like a blighted shroud. Blessedly, the water soon begins to brighten to a brilliant and clear blue as the caverns widen enough that even a Sea Tyrant could easily slip through as you descend, guided by the low hum of the Seradovah. Offhandedly though, your tendrils sense a mild change in the water as the slight almost imperceptible tug of a faint current washes over them as you glide through the passageway. Unbothered you continue on through the various switchbacks and sudden drops till the craggy disjointed heteromorphic rock gives way to a smooth section of gleaming slate formed into a partial u-bend. Here your companion at last ceases its muted mantra, and bolts straight up towards a low flicker of white synthetic light. With nowhere to go but up, you surge after them and burst free of the water's embrace with a mighty flap of your wings and you find yourself standing in the middle of vast underground moon pool illuminated by small cylindrical electric ";
	if "Touched by Madness" is listed in feats of Player:
		say "torches.";
	else:
		say "lanterns.";
	say "     Though you can't say that you're an expert in such things, to your layman's eye the area appears to have been recently excavated as the rough slate walls are covered in fresh claw marks alongside fragments of waste rock. Casting your abyssal gaze about the area, you watch as the Seradovah slithers northwards towards a rent in the bedraggled rock and soon vanishes from your abyssal sight. Shrugging, you prowl on after them without sparing the Moon Pool a second glance, and as you slip through the unfinished opening in the earth you are greeted by the grinning salachine face of the bawdy pirate shark captain flanked on either side by almost a score of nude caucasian women whose ages range from their mid twenties to late thirties with hair colors varying from platinum blonde to fiery ginger. Molded by the harshness of the nanite outbreak, their bodies are toned and athletic yet still retain a modest degree of their feminine curves as their hourglass waists and trim swimmers thighs impart a classical beauty to their unaltered bodies.";
	WaitLineBreak;
	Project Figure of Priestess_clothed_icon;
	say "     Going by the awestruck looks on their comely faces and gentle blush of their tight freshly-shaved cunts illuminated by your draconic splendor as you walk in, they were not only expecting you, but overjoyed by your arrival. Supple D-cups and dainty B-cups decorate their charming cores, by no means impressive with current state of the sex-crazed and ofttimes hyper inhabitants, the little humans wear them well enough, you muse watching the puff out their chests as your molten gaze washes over them. The captain hirself though seems to have picked up a modicum of [']clothing['] too as thin string bikini top now coddles hir impressive E-cups along with a primal necklace composed of woven hide laced with polished stone, shark's teeth, and lesser sea dragon fangs. Perhaps sensing your eyes drift over to hir, the buxom corsair clears hir throat and steps forward yelling, 'Alright ya sea nymphs look lively now, for ya stand before our most worshipful lady's champion and herald of our salvation, the vaysun da Kai Monah! The scourge of worlds, Nursemaid to dragons, and the most holy archangel of domination, submission, and servitude!'";
	say "     The assembled humans quickly press their mitts to their breasts and link their fingers to form the same draconic symbol that your spawn displayed as they drop to their knees, murmuring in awe of your abyssal glow and titanic frame. 'Goddess they're so beautiful,' one hums. 'Such regal scales,' another gushes. 'By Tiamat I can't believe they're here,' a third mews. 'Fuck I want them inside me,' a forth wimpers as they eagerly prostrate themselves before you. Chuffing at their proper display of deference to your majesty, you take a quick moment to look around the area and, much to your dismay, this alleged temple is little more than a hole bored into the ground. True, you ruminate, it's somewhat unreasonable to expect a handful of apes and Seradovah to build you a chapel worthy of your imperial presence so soon, even if they had sea tyrants to aid them. Perhaps in time, improvement can be made, still they did an admirable for lesser beings as they seem to have already started expanding your domain outwards from this central area.";
	WaitLinebreak;
	say "     You think to yourself as the captain struts besides you, flashing you a quick but knowing look as shi makes a poor attempt at a bottomless curtsy saying, 'Now I'z knows what yar thinking me most regal and benevolent dragon, these puny hall taint much to look at. Un da flock be mighty small tat da moment, but dar hearts be in it and with uz around to help [']bolster da ranks['],' shi chuckles, webbed mitts shamelessly drifting to hir tight cream tum as shi playfully traces hir talons along hir cute little belly button. 'We'z be able to pretty this place up right [']N proper like, of course,' shi adds, spinning on the balls of paws and motions to your supplicants. 'The girls could use a might pinch [']O guidance in how our great and terrible mistress wishes to run this place. Now taint that right me lovelies?' the captain asks, in a pleasant trill as shi motions for the humans to lift their heads with a commanding wave of hir tail. 'Yes Lady Arlene!' the humans rumble in unison as they fix you with a doting expectant stare.";
	LineBreak;
	say " [bold type]Author's note: your decision here will have drastic effects on your cult, the available sex scenes, and potentially your Dragon Breeder body. As these effects are permanent would you like some minor spoilers, or go in blind?[roman type]";
	LineBreak;
	let Spoiler_and_stuff_Choices be a list of text;
	add "Spoil me Dovah daddy!" to Spoiler_and_stuff_Choices; 
	add "No thanks." to Spoiler_and_stuff_Choices;	
	let Spoiler_and_stuff_Choice be what the player chooses from Spoiler_and_stuff_Choices;
	if Spoiler_and_stuff_Choice is:
		-- "Spoil me Dovah daddy!":
			say "     [bold type]YOUR WISH IS GRANTED![roman type]";
			LineBreak;
			say "     [italic type]Protective cult[roman type]: Embark on quests with Arlene's crewmates to rescue humans from bondage throughout the city's various slaver rings. Along the way you pick up a number of husky bitches for your cultists to train and play with. As a result, this path has the highest possible growth rate and features minor pet play, human X anthro, and milky yuri goodness. Further, rebelling against Tiamat is far easier as your brood and cultists will be more inclined to follow you should you ever choose to turn against the goddess. Unfortunately, this path will likely have a more kind-hearted tone that aspiring dragon overlords may find distasteful.";
			LineBreak;
			say "     [italic type]Hedonist cult[roman type]: Embrace your greedy inner predator while your priestess molds your followers into perfect broodmares, or delectable treats for yourself. The slowest growing cult by far as, for some reason, few people wish to become fodder for your growing splendor, though, with the right convincing, eager morsels can still be procured to sate your draconic urges. Beware though, as though the willing consumption and absorption of your followers will undoubtedly strengthen you, overindulgence may take its toll on your Dragon Breeder body. Yet such trifling concerns are nothing compared to the ravenous power and fertile glory that awaits committed preds and selfish gluttons who fully surrender to their draconic urges. Rebelling though will be rather difficult, if not impossible as precious few among your flock or flight will be willing, or even able to assist you should choose to walk this path. Fetishes include: body worship, absorption, weight gain among your followers, hyper pregnancy, Alt preg, optional multi boob, optional player weight gain, lactation, willing vore and willing UB with the PC as the pred. Note: this path is only open to preds with a tail maw.";
			WaitLinebreak;
			say "     [italic type]Ascension cult[roman type]: Spread the love to your adoring flock by assisting them in shedding their pitiable humanity so they may join your flight and further your ambitions, whatever they may be. This path is a firm middle ground in terms of growth as word of your gifts will surely attract fresh blood to the cult's ranks for few can resist the lure of power and immortality only you can offer. Rebellion is markedly easier compared to the hedonism path, yet some among your flock and spawn will still need some convincing to join you in open revolt against the goddess. Fetishes include: Gradually TFs, Taur X Taur, Taur X anthro, optional UB with the PC as pred, and the most depraved fetish of all... handholding.";
			say "[dovhadaddyout]";
		-- "No thanks.":
			say "     [bold type]Very well.[roman type]";
			say "[dovhadaddyout]";

to say dovhadaddyout:
	say "     How do you wish to run your cult?";
	LineBreak;
	let cultist_creed_Choices be a list of text;
	add "Protective cult dedicated to saving and preserving human life." to cultist_creed_Choices; 
	if Intelligence of Galaxite is 2:
		add "Pleasure cult made to service your needs and swell your brood." to cultist_creed_Choices;
	add "Transformative cult driven to uplift humanity from its grotesque condition." to cultist_creed_Choices;
	let cultist_creed_Choice be what the player chooses from cultist_creed_Choices;
	if cultist_creed_Choice is:
		-- "Protective cult dedicated to saving and preserving human life.":
			say "     Spreading your wings outward, you flare your chromatophores in a brilliant mix of hopeful platinum and faithful gold as you inform your modest flock of faithful humans of your intent to shelter and protect this world from harm. Too long have your former kin huddled in fear of the aberrant mutants and nameless horrors prowling the lands. Too long have they been shackled to the words of false prophets that offer not but empty words, and promises of salvation in the hereafter. Too long have they wallowed in ignorance of the goddess's power, love, and the many, you pause to languidly flexing powerful tauric body before your faithful, much to their delight as their eyes wander your chiseled core and opalescent hide. Gifts she would happily bestow upon them in the here and now, if only they would open their hearts and legs to her, and chosen angels, you simper, as you watch several of your follower eyes widen with unvarnished rapture. Together, they will save not only themselves, but all of humanity from being consumed by the nanites and foul creatures that dare to blight this world and seek to twist its people to their will. For unlike the imaginary deus of this sphere, the goddess accepts humanity for who they are and wishes no harm to come to this world, or its people.";
			say "     Yet salvation will not come easily as, though her eyes have turned upon this world, in order for her to manifest and bring order to chaos she will require their aid in bolstering your flight's numbers. But dread not, you beam, they will not be alone in this task as your flight shall endeavor to save as many of their ilk as possible, so together they can usher in an age of human supremacy under the protective talon of dragon kind. In the meantime, they should rejoice, for soon your flight shall take to the city to bring the goddess's wrath upon the mutant, the heretic, and the alien! Ol fala han klovve eth! You bellow, roughly slamming your tail upon the ground. 'Ol fala han klovve eth!' Your flock intones with a brassy fervor. Very good, you rumble affectionately, then inform them they are dismissed and free to return to their duties with your blessing. In the meantime, you will confer with your priestess so you begin the search for more souls in need of salvation. 'Yes mistress!' your followers cheer as they scurry to their feet and bolt in every direction.";
			WaitLineBreak;
			say "     As they flutter off into the various passage ways dotting the hall, the captain, er, Arlene you mentally correct yourself saunters up beside you with a cocksure grin on hir muzzle, saying, 'Yar quite dat lofty wee speech dare my dragon, or shoulds I'z be saying Vaysun da Kai Monah,' through a low chuckle as shi hooks hir arm about yours and playfully nuzzles hir coarse snoot against your silky perpetually-lubed core. 'Why,' shi whispers, 'I'z almost believe ya cared fir dis scurvy lot of willowy pig skins, still hope be a most tender balm, one we'z likely be needing un good supply to get this place ship shape any time soon. Now,' shi continues gesturing to a modest rent in the eastern section of this main hall with hir tail while lightly tugging on your arm as if beckoning you to follow. 'As fortune would have it, my lovely, me and mine might have a lead or two on some right nasty boyos what been capturing more than their fair share of pig skins dat ya might be interested in.'";
			say "     Duly curious, you allow Arlene to lead on as shi guides you into a spacious, passably lit room with a number of battery-powered prop lights fashioned into the shape of waist-high wrought iron candelabras illuminating a smoothed cavern furnished with a modest red metal four-poster bed hosting a ritzy creamy velvet sheets alongside several throw pillows. Its floors meanwhile have a number of thick furry hides thrown down upon while simple blue and gold cloth banners bearing your scalie visage have been hung on the slate walls. Likely sensing your eyes wandering hir abode, shi gently disentangles hirself from you and struts to the center of the room rumbling, 'Admiring me wee hidey-hole me dragon, tis nothing grand but pig skins respect these little displays, but back to the business at hand,' as shi seats hirself upon hir serviceable bed. 'Yar see,' shi says, playfully fanning hir before you, 'not too long before we'z met. Da crew un I caught wind of group [']O dem dogger boyos and puppy lasses rounding up the pig skins for sale upon the burgeoning flesh trade growing in dis [']ere city. Now while this place taint no Tortuga, dare still be a might lick of coin in peddling pure lasses to the masses,' shi hums, with a covetous glint flashes across hir selachian eyes.";
			WaitLineBreak;
			say "     Why's that, you rumble. 'Because me heart, it be easier to turn them into whatever manner [']O beastie yar soul could imagine. Sometime doe, ya find a rare un what's resistant to da change and fir whatever reason, lots [']O does pig skins seem to be able ta whelp a pureblooded copy of whatever boyo puts a bun in their bonnets,' Arlene cackles, hir paws briefly gliding along the graceful gray curves of hir tone midriff as shi traces the supple borders of two-toned hide. 'Why me crew un I once thought [']bout paying dem doggos a visit to see what manner of plunder they'd managed to acquire. But fir all their softness, there were a lot [']O of gitz in dat pack, so we let them be. Still,' shi adds with a predatory click of hir teeth, 'that was then me heart, now I'z got your sea devils and her most worshipfulness blessing it should be right milk run to shanghai use some fresh blood. I'z just need a wee while to send the little un's to see if dem bilge rats are still about. Course, if in your looking to pass a neck [']O time,' shi purrs with lustful trill, reclining ever-so-slightly onto hir bed while arching hir back at an inviting angle, 'the crew could always use new members to fill out our ranks...'";
			LineBreak;
			say "     [bold type] Author's note: cult content ends here for in the meantime feel free to play with your toy and build your numbers. If you're a backer though, please cast your vote on our patreon page to help decide which path gets developed next.[roman type]";
			now under sea is resolved;
			move player to Priestess's Chamber;
			now loyalty of Dragon Cultist is 1;
			increase XP of player by 50;
			increase score by 25;
			now HP of Arlene is 1;
		-- "Pleasure cult made to service your needs and swell your brood.":
			say "     Rumbling happily at the sight of the delectable treats arrayed before you, you prowl up to them, strobing your chromatophores a lurid pink. You commandingly cup your foretalon about the chin of your lowly followers, and inform them in an imposing, yet loving draconic trill of their glorious purpose as your favored harem and caretakers of your young. For only through their service to the goddess's draconic angels will this world be spared from the horror stalking it, but fear not, you rumble tracing your claws about the lush maiden's eve's orange. There is both bliss and glory to be found in submission as they will have the privilege of carrying the seeds of this world's rebirth into a paradise of coldblooded perfection under the goddess's benevolent thumb. No longer will they need suffer under this insipid leadership of short-sighted apes, or endure the depravations of false gods that would offer nothing but empty words and the hollow promise of rewards in the hereafter.";
			say "     Under you, you trill in abject delight as a preyish quiver passes through the puny warmblood as your words coil about her like tempting serpents on a vine. They will experience the boundless elysium of brood motherdom and revel in the heavenly changes your clutches will imbue upon them. In time, their broods and names could echo through the numberless spheres as their angelic young work to bring order and stability to the chaos of the eternal ocean. As their fame as broodmares grows, so too shall their esteem in the eyes of the goddess for her rewards are palpable things of the here and now. Tiamat rewards service with life everlasting and power equal to the mightiest wyrm to those with courage to bring will to power. In time, they may even earn ascension to the rank of priestess and gain greater gifts, or be granted worlds of their own to rule in the goddess's name.";
			WaitLineBreak;
			say "     And of course, you chirp invitingly as your proudly flaunt your [one of]alluring[or]athletic[or]predatory[or]powerful[or]curvaceous[or]tauric[or]dominant[or]reptilian[or]draconic[or]regal[at random] form before them, the transcendental rapture of servicing and, you pause to run your bifracted tongue along your fangs. Nourishing your majesty awaits them, for as great and terrible as you may be, you simper flexing your impressive wings before them as you bath the area in an enthralling ballet of pink and silver light. Your current form is but a fraction of what is required for the salvation of this sphere, and only through their devotion to you and the goddess's will shall you become strong enough to herald in her coming. Some among them may even earn the right to become a part of your nascent divinity, or perhaps even adopted into the ranks of your flight should they manage to distinguish themselves.";
			say "     This said, you tease, releasing your hold on the little human's chin, much work needs to be done before the goddess can be summoned into this world and deliver it from the creeping doom the unworthy leadership of this place have brought upon. To that end, you expect your delicious thralls to service your flight without question and blanket this city in cold-blooded perfection! Ol fala han klovve eth! You roar with a mighty thump of your tail upon the cavern floor. 'Ol fala han klovve eth!' the eager morsels bellow as they switch to a kneeling position, cup their hand to their breast then flash the same two-head dragon symbol your brood displayed to you. Rumbling in a pleased draconic cadence, you dismiss the puny manlets with a commanding flick of your tail telling them to return to their duties with your blessing, and watch as they quickly scurry away in every direction.";
			WaitLineBreak;
			say "     As they vanish into the gloomier sections of your hallowed temple, the captain, er, Arlene, you internally correct yourself, struts up to you with a vivacious grin on hir snoot, saying, 'Yar, now be da way ta light a fire in da pig skins['] muffs, me dragon, or should I'z be say'in, Vaysun da Kai Monah?' as shi jovially claps hir webbed mitts in approval. Shrugging, you tell hir you have no great preference as the title much like this cult is merely a tool to herald in the goddess and reap your just reward. '*Ha-ha* I loves it when ya talk like dat me heart, I'z knewz I had a right good feeling about ye. Now come along I'd like ta have a few wee words with ye in private before we'z get down to business all proper like,' Arlene chuckles, motioning for you to follow hir with a casually flick of hir finned tail towards a hole in eastern section of the hall. Rumbling in neutral tone, you gesture for hir to proceed and fall in step with the sultry corsair as shi leads you through the modest rent in the earth.";
			say "     Emerging on the other side, your abyssal gaze is greeted by the sight of a spacious, passably lit room with a number of battery-powered prop lights fashioned into the shape of waist-high wrought iron candelabras illuminating a smoothed cavern furnished with a modest red metal four-poster bed hosting a ritzy creamy velvet sheets alongside several throw pillows. Its floors meanwhile have a number of thick furry hides thrown down upon while simple blue and gold cloth banners bearing your scalie visage have been hung on the slate walls. Chuffing, you offhandedly compliment the bawdy herm on what shi's down with the place. 'Daw it nutting special just some old fur me an dem sea beasties found while we was cleaning out me old lair, but still,' shi crows as shi leisurely strides towards hir bed and proudly seats hirself upon while casually fanning paws before you. 'It serves its purpose and reminds the pig skins [']O da way of things. Un ye be happy to hear that our wee sea devils and dem big fishy boyos are already hard at work find us more plunder. [']N speaking [']O which, my and me mates put your share in the Treasury as da lasses have come to call it.'";
			WaitLineBreak;
			say "     'Course,' shi hums with covetous glint in her selachian eyes, 'we be needing more bodies on da books if in we want to really pull in the riches [']O da neath. Not ta mention, our wee piggies are going to need some more help ta get this place ship shape any time soon.' Naturally, you rumble, feeling your lips curl into a draconic smirk at the thought of your servants alongside your beatific brood have dredged from the depths, and what future wonders await you. 'Yar-har-har, I know that look well me lovely, un I couldn't be agreeing more! This [']ear deal [']O yours with her worshipfulness be fine one indeed! Never before have I'z dreamed of commanding sea beastie like them big boyos out in the depths. Un,' Arlene rumbles in deep brassy trills as shi playfully paws at hir tight creamy midriff, 'if in ya have the time perhaps ya wouldn't mind leave me with fresh shiver in me timbers...'";
			now under sea is resolved;
			move player to Priestess's Chamber;
			now loyalty of Dragon Cultist is 2;
			increase XP of player by 50;
			increase score by 25;
			now HP of Arlene is 1;
		-- "Transformative cult driven to uplift humanity from its grotesque condition.":
			say "     Gleefully admiring the [']fresh clay['] arrayed before you, you theatrically flare your wings and bathe the area in a soft ballet of mercurial silver light as you proudly declare you have come to free your faithful from the shackles of the human form and raise them to the lofty realm of draconic perfection. For humanity's time is nearing its end, and by embracing the path of ascension will they be able to not only survive, but thrive in this new new world. As unlike the weak surface level and ofttimes fleeting transformation the insipid ferals have tried to force upon them, you offer them a chance to truly become a mighty wyrms of legend. You rumble, proudly tracing a claw along the rich scales decorating your imperial core, much to the delight of your followers as their eyes lovingly glide along the sleek curves of your tauric form. Untouchable by time and entropy, their eternal bodies shall never know the weakness of old age, nor the limits of the mortal form. They shall wield powers dreamt of only in storybooks and the boundless joy of flight, should they prove worthy, they may even be granted powers equal to the false gods of this sphere.";
			say "     Never again will they know fear or doubt, for the mutant, heretic, and alien that dare trespass upon this sphere shall quake at their great and terrible passage! All you, and the goddess, ask in return is that they accept her place as the one true deus, and aid you in growing your flight so that your combined faith in Tiamat may at last call her to this world. Then she can put an end to the chaos ravaging these lands and usher forth an age of coldblooded perfection and flawless order! You roar, briefly rearing up onto your hindlegs and buffeting the crowd with a mighty flap of your wings, eliciting a low chorus of ooh's and aah's from the little humans as they shamelessly admire your imperial majesty. More than this, those who distinguish themselves may one day earn the right to conquer worlds of their own and spread their flight's names and dominion to the many corners of the eternal ocean in the goddess's name. But to do this, they must show their devotion to you, and your spawn as heavenly beings and embrace their holy roles as dragon mothers as well as heed the words of your priestess.";
			WaitLineBreak;
			say "     For only then, when they have fully given themselves to the cause will they earn the right to stand amongst the goddess's chosen angels and birth the salvation this world craves! Ol fala han klovve eth! 'Ol fala han klovve eth!' the little humans cry as many among their number lustfully paw at their toned tums in anticipation. Well spoken little mouses, you crow, now go attend to their future flights needs and revel in the changes that are to come! You commandingly thump your tail against the ground to dismiss your followers. In unison, the dragons-to-be move into a kneeling position and cup their hands to their breast and flash you the same two-headed dragon symbol your progeny displayed to you not all that long ago before hurriedly scattering about the temple with a joyous spring in their step. Watching them go, the captain, er, Arlene you mentally correct yourself saunters up to you with confused, yet oddly pleased look on hir muzzle. 'Quite the promise there me dragon or Vaysun da Kai Monah?' Shi chirps, idly flick hir tail behind hirself. 'I never took ye for the power sharing sort, but I'z suppose the pig skins will appreciate what yar doing for dem. Assuming this doesn't all go to their heads,' shi chuckles.";
			say "     Shrugging, you tell hir not to worry, besides, Tiamat requires a great many supplicants. What better draw is there then the promise of draconic ascension and the chance to wield her power? 'Da ya got me there me dragon, doe I'z hope ye can make good on yer word, fir I'z seen what yer kind can do when roused to anger.' Huffing, you brush aside such concerns with a wave of your scalie mitts and inform Arlene that is a problem for the future. Besides, the nanites dwelling within you and your spawn can be bent to service your needs in the interregnum. 'Ya-har, you might make a right good snake oil salesmen me lovely, now come along and let's discuss how to get this place shipshape,' shi chuckles mirthfully as shi gestures to a large hole nestled along the eastern wall with hir finned tail. Nodding, you fall in beside hir and stride forward together though the opening.";
			WaitLineBreak;
			say "     Slipping through the narrow, by your standards, threshold, your abyssal eyes are greeted by the sight of of a spacious, passably lit room with a number of battery-powered prop lights fashioned into the shape of waist-high wrought iron candelabras illuminating a smoothed cavern furnished with a modest red metal four-poster bed hosting a ritzy creamy velvet sheets alongside several throw pillows. Its floors meanwhile have a number of thick furry hides thrown down upon while simple blue and gold cloth banners bearing your scalie visage have been hung on the slate walls. Likely noting the molten glow of your many eyes waltzing about the area, Arlene coyly steps before with a mischievous gleam in hir eyes and says, 'Admiring my home away from home, me heart?' You nod, though you're not sure you'd use the term admire. 'Da tis simple set furnished with wee bits un bobs taken from me old lair, yet it serves its purpose well enough to remind the pig skins of their place. Still, der be much more to be desired if we're ever going to make this damp hole in the wall a temple worthy enough of her worshipfulness.' Arlene titters as shi seats hirself upon hir bed and playfully fans hir tail beside hirself.";
			say "     Rumbling in agreement, the great work is going to need more than its fair share of fresh blood and material if they are to comply with the goddess command to bejewel these halls in her name. 'Right ya are, me wonderous wyrm, thankfully fir us both dem boyos have been helping me un me mates plunder what we can from the loot stored in Pirate Island. Un our lovely sea devils have quite the boon too!' shi hums, leaning back onto hir bed and longingly gazes at the tight toned curves of hir hale creamy midriff. 'With them at our back, the girls un I have been able to suss out no small amount of plunder lurking in the city. Course,' Arlene purrs, idly tracing hir tail along the lush borders of hir two-toned tum, 'could always use a few more bodies to,' shi pauses as lips curl into a voracious grin, 'fill out the ranks...'";
			now under sea is resolved;
			move player to Priestess's Chamber;
			now loyalty of Dragon Cultist is 3;
			increase XP of player by 50;
			increase score by 25;
			now HP of Arlene is 1;


Arlene ends here.