Augustus_Drake by Sundered Dragon begins here.
[Version one testing phase]
[Version 1.1 MVP Build]
[Version 1.2 The fluffening]
"Adds a mostly human NPC survivor named Augustus Drake to the Flexible Survival game."

[   HP of Augustus Drake    ]
[ 0 = Event not started     ]
[ 1 = Met not talked yet    ]
[ 2 = Talked given quest    ]
[ 3 = First medkit Turn in  ]
[ 4 = Second medkit turn in ]
[ 5 = third medkit turn in  ]
[ 6 = Go Visit Medea        ]
[ 7 = Quest turn in         ]
[ 98 = Quest turned down    ]
[ 99 = Drake TFed           ]

[  Hunger of Augustus Drake              ]
[ 0 = PC does not know about Old One Eye ]
[ 1 = Old One Eye is at large            ]
[ 2 = Old One is attacking the Chance    ]
[ 3 = Old One is pacified                ]
[ 4 = Old One has been Unbirthed         ]
[ 5 = Old One Pacified by human Drake    ]
[ 6 = Old One Pacified by anthro Drake   ]

[  Thirst of Augustus Drake             ]
[ 0 = PC has not breed Ava              ]
[ 1 = Grandpa of War                    ]
[ 2 = is ok with showing his true age   ]
[ 3 = PC shotgun wedding                ]
[ 4 = Happy grandpa form                ]

[                Morale of Augustus Drake                                        ]
[ 0 = No knowledge of Jade                                                       ]
[ 1 = Heard of Jade                                                              ]
[ 2 = Found Fox Breeder's den                                                    ]
[ 3 = Slothful Player allowed Drake to carry out an Exterminatus on the Den alone]
[ 4 = Player and Drake have Defied Darkness and saved Jade                       ]
[ 4 = Saved Jade alone and brought hir to Drake                                  ]
[ 5 = Saved Jade alone but Player kept hir as a pet                              ]
[ 6 = Joined Jade as a Hyper Fox Breeder Herm                                    ]
[ 7 = Jade is turning into a Awesome tree                                        ]
[ 8 = Jade has fully devolved into a tree                                        ]
[ 9 = Turned Jade into a normal anthro fox to avoid becoming a tree              ]
[ 10 = Turned Jade into a Fennec taur to avoid becoming a tree                   ]
[ 11 = Revert all was used to cure Jade after she became a tree                  ]
[ 12 = Revert all was used before Jade became a tree                             ]
[ 13 = Jade has become a shine maiden at the Onsen on the Edge of the World      ]

[             Placeholder of Augustus Drake                            ]
[ 0 = Baseline                                                      ]
[ 1 = Player has dominated Drake once                               ]
[ 2 = Player topped Drake wearing proper wearing appropriate gear   ]
[ 3 = Player is considering muzzling and collaring Drake            ]
[ 4 = Drake is collared and muzzled                                 ]
[ 5 = Player rejected Lioness Taur TFs                              ]
[ 6 = Player has allowed themselves to become a Lioness Taur        ]
[ 7 = Player has let themselves turn into a Maned Lioness taur      ]

[                   Charisma of Augustus Drake                             ]
[ 0 = Baseline                                                             ]
[ 1 = Player has plundered Luanne's Fabrics                                ]
[ 2 = Player has merged with some the Latex Creatures at the fabric store  ]
[ 3 = Player has absorbed all Latex Creatures at the fabric store          ]
[ 99 = Player either bitched out or was beaten at Luanne's Fabrics         ]

[                       XP of Augustus Drake                                ]
[                         0 = Baseline                                      ]
[                         1 = The Call is awakening                         ]
[                         2 = The Call stirs                                ]
[                         3 = The Call desires you                          ]
[                         4 = The Call wishes to be heard                   ]
[                         5 = The Call shall be heard                       ]
[                         6 = The Call is nearly upon you                   ]
[                         7 = The Call beckons                              ]
[                         8 = The Call is heard                             ]


[ Level of Augustus Drake ]
[ 0 = first message       ]
[ 1 = second message      ]
[ 2 = third message       ]
[ 3 = Fourth message      ]
[ 5 = Fifth message       ]
[ 6 = sixth message       ]

[ Humanity of Augustus Drake ]
[ 0 = first message          ]
[ 1 = second message         ]
[ 2 = third message          ]
[ 3 = Fourth message         ]
[ 5 = Fifth message          ]
[ 6 = sixth message          ]

[ Depravity of Augustus Drake ]
[ 0 = first message           ]
[ 1 = second message          ]
[ 2 = third message           ]
[ 3 = Fourth message          ]
[ 5 = Fifth message           ]
[ 6 = sixth message           ]

[ Affection of Augustus Drake  ]
[ 0 = first message            ]
[ 1 = second message           ]
[ 2 = third message            ]
[ 3 = Fourth message           ]
[ 5 = Fifth message            ]
[ 6 = sixth message            ]

[   Loyalty of Augustus Drake  ]
[ 0 = Quest not completed/TF   ]
[ 1 = Quest completed/not TF'ed]




[             TODO List                 ]
[ Port skin diff and cunt diff          ]
[ Pet Candy walk in event               ]
[ Klaus X lion Drake dom fight no sex   ]
[ Black Equinoid walk in event          ]
[ Bonfire of dreams walk in event       ]
[ Human Drake X Fem Player?             ]


A postimport rule:
	if HP of Doctor Matt >= 5 and Only the Lonely is not resolved:
		now Only the Lonely is active;

A postimport rule:
	if HP of Augustus Drake is 7 and Loyalty of Augustus Drake is 0:
		now Loyalty of Augustus Drake is 1;


Section 1 - What is a man

Table of GameEventIDs (continued)
Object	Name
Only the Lonely	"Only the Lonely"

Only the Lonely is a situation.
ResolveFunction of Only the Lonely is "[ResolveEvent OnlytheLonely]". It is inactive.
Sarea of Only the Lonely is "Plains".
when play begins:
	add Only the Lonely to BadSpots of FurryList;
	add Only the Lonely to BadSpots of MaleList;
	add Only the Lonely to BadSpots of FemaleList;


to say ResolveEvent OnlytheLonely:
	say "     Aimlessly journeying through the wild nanite enhanced grasses of the dry plains, you locate an unbroken stretch of road heading away from the city. Normally, this minor aberration would be beneath your notice, were it not for the siren's call of a still-standing billboard advertising the Last Chance, a motel, camping, and auto shop less than a quarter-mile away. Enticed by the prospect of higher-end salvage, you head off without a second thought towards the potential treasure trove of supplies. The trek itself is unusually quiet, almost too quiet in your opinion. The pronounced absence of life, nanite-altered or otherwise, in the immediate area raises a few alarm bells in your head. Coming upon the outskirts of a large walled compound, you quickly find out why.";
	say "     The ground here is cracked and pitted with hundreds of thumb-sized holes, the edges encrusted with flakes of vermilion dust and sun-bleached bone. The traditionally all encompassing gold and green grasses which overrun much of the plains have been beaten back, not by hand, but by flame. Carbon scoring is rampant and the deadened soil is slowly being blown away revealing twisted gnarled roots eating the rusted remains of sewer lines like maggots feasting on the carcass of the world that was. The breeze itself is impregnated with a weak chemical tang that sticks to the back of your throat no matter how many times you try to clear it. Getting closer to the complex, you see its walls are covered in claw marks as if someone or something attempted to climb them.";
	WaitLineBreak;
	say "     A fool's errand you note, observing multiple types of razor wire have been installed along the perimeter. Standing on your toes, you spot what could at best be charitably described as a pill-box squats atop the roof of what you surmise is the hotel proper. Built from scavenged wood, reclaimed metal, and draped in a beat-up cargo net you doubt the thing could stand up to anything stronger than heavy breeze. Squinting, you spy the vague outline of a lone humanoid sniper. Their weapon already drawing a bead on your chest is set up therein. You wonder why they haven't taken a shot, perhaps they were waiting for you to enter earshot, or maybe they're sizing you up.";
	say "     Once your gazes meet, the marksman yells in a cold commanding masculine tone that seems used to giving orders and being obeyed. 'Drop to your knees and hands behind your head, mutant, unless you want me to paint the black top a fresh coat of brain matter gray.' As they flip on an attached laser sight that locks on to your nasal arch as if to drive home the point that they have you zeroed. Having no choice but to comply, you doubt you could survive a bullet in the head. Sure the nanites [italic type]might[roman type] pull you back together but you'd rather not play that game so, you do as the gunner instructs, for now. 'Smart choice, stranger, now what in the hell do you want!?' The rifleman demands. Feeling it would be better to be relatively honest with them. You inform them of the signage you spotted a ways back and how you thought you might do a bit of trading at the Last Chance. A technically true statement, as long as you replace the word trade with. Looting everything that isn't nailed down like you're taking part";
	WaitLineBreak;
	say "     in a post apocalyptic episode of super shopper, that is. Ruminating on your words for a moment, they lower their weapon saying. 'Hm, alright then, if that's the case maybe we can work something out. Come on, get up and head round front, I'll let you in. But try anything funny-,' the fellow taps their rifle. Assuring them you mean no harm and are merely here to do some trading, you proceed, under the watch to the entrance of the Last Chance. The aperture proper, a heavy steel bar gate, is pitted in claw marks and is wrapped in several dozen padlocks and chains and is fortified by a one-foot thick cement wall. On the other side, you see the gunner, their heavy black bolt-action rifle slung over their shoulder, sliding down a workman's ladder propped up against the side of their perch.";
	say "     Able to get a better look at the other, you note that they are about six foot six inches tall, an impressively-built humanoid dressed in a white T-shirt, jeans, and black sneakers. Their skin, a rich tan olive, is complemented by well-kept black hair that shines like it was dipped in oil. He, judging from the absence of breasts upon his carved chest, robust Adam's apple, and noticeable bulge in his pants, appears purely male. At first glance, the man looks completely human, but as he strides over in an almost mechanical fashion to unlock the gate, you note the fellow's sharp almond eyes are slitted much like a hunting cat's. Sliding the gate back he says, 'Sorry about the tough talk kid, but with things the way they are right now, I can't afford to be too careful,' nodding for you to enter. 'Oh, the name's Augustus Drake by the way. Most people call me Drake though,' he continues, shutting the gate.";
	WaitLineBreak;
	say "     While he works, you take the opportunity to look the burg over. Given what you can see, the Last Chance seems to consist of several buildings divided by a spacious parking lot. One, a 1950s style two-story-tall hotel, its walls painted a weather-worn mellow beige, is situated to the north. To the west is a wooden walkway framed by a garden of various California poppies with some kind of bronze maker at its core. In the eastern section is a small wilderness supply outlet joined with a mechanic shop. No doubt intended as a lure for ill-prepared vacationers who forgot to pack their hiking boots or unlucky truckers stuck out in the boonies. However, your sightseeing is brought to an abrupt end as Drake finishes sealing up the area saying, 'Come on kid let's talk in the lobby,' and walks off without listening for a reply. Deciding to follow along for the moment at least, you fall in step with Drake as he leads you to the motel.";
	AddNavPoint The Last Chance Parking Lot;
	move player to Last Chance Lobby;
	now Only the Lonely is resolved;
	now HP of Augustus Drake is 1;

Section 2 - What has he got

Table of GameCharacterIDs (continued)
object	name
Augustus Drake	"Augustus Drake"

Augustus Drake is a man.
Augustus Drake is in the Last Chance Lobby.
ScaleValue of Augustus Drake is 3. [human sized]
Body Weight of Augustus Drake  is 5. [scale of 1-9 for body weight, grouped into low weight (1-3), mid weight (4-6) and high weight (7-9)]
Body Definition of  Augustus Drake is 7. [scale of 1-9 for body definition, grouped into low muscle (1-3), mid muscle (4-6), high muscle (7-9)]
[Body Adjective is generated out of the body weight and body definition and can be used in scenes - one word descriptive adjective depending on weight and definition groups: low weight group: skinny/slender/lithe; mid weight group: average/fit/muscled; high weight group: pudgy/husky/jacked]
Androginity of Augustus Drake  is 2. [Gender Adjective is generated out of androginity 1-9: hypermasculine/masculine/somewhat effeminate/effeminate/androgynous/feminine butch/tomboyish/feminine/hyperfeminine]
Mouth Length of Augustus Drake is 2. [inches deep for face fucking; maximum possible will be double this number (when deep throating)]
Mouth Circumference of Augustus Drake  is 3. [mouth circumference 1-5, "tiny, small, normal, wide, gaping"]
Tongue Length of Augustus Drake is 3. [length in inches]
Breast Size of Augustus Drake  is 0. [cup size as number, counting Flat Pecs = 0, A = 1, B = 2, ...]
Nipple Count of Augustus Drake is 2. [count of nipples]
Asshole Depth of Augustus Drake is 6. [inches deep for anal fucking]
Asshole Tightness of Augustus Drake is 1. [asshole tightness 1-5, "extremely tight, tight, receptive, open, gaping"]
Cock Count of Augustus Drake is 1. [number of cocks]
Cock Girth of Augustus Drake is 3. [thickness 1-5, thin/slender/average/thick/monstrous]
Cock Length of Augustus Drake is 10. [10 Inches]
Ball Count of Augustus Drake is 2. [allowed numbers: 1 (uniball), 2 or 4]
Ball Size of Augustus Drake is 3. [size of balls 1-7: "acorn-sized", "dove egg-sized", "chicken egg-sized" "goose-egg sized", "ostrich-egg sized", "basketball-sized", "beachball-sized"] [Increase by 1 for Alpha, decrease by 1 for Omega]
Cunt Count of Augustus Drake is 0. [number of cunts]
Cunt Depth of Augustus Drake is 0. [penetrable length in inches; some minor stretching allowed, or more with Twisted Capacity]
Cunt Tightness of Augustus Drake is 0. [size 1-5, generates adjectives of extremely tight/tight/receptive/open/gaping]
Clit Size of Augustus Drake is 0. [size 1-5, very small/small/average/large/very large]
[Basic Interaction states as of game start]
PlayerMet of Augustus Drake is false.
PlayerRomanced of Augustus Drake is false.
PlayerFriended of Augustus Drake is false.
PlayerControlled of Augustus Drake is false.
PlayerFucked of Augustus Drake is false.
OralVirgin of Augustus Drake is true.
Virgin of Augustus Drake is true.
AnalVirgin of Augustus Drake is true.
PenileVirgin of Augustus Drake is false.
SexuallyExperienced of Augustus Drake is true.
TwistedCapacity of Augustus Drake is false. [Twisted Characters can take any penetration, no matter the size]
Sterile of Augustus Drake is true. [steriles can't knock people up]
MainInfection of Augustus Drake is "Human".
Description of Augustus Drake is "[augustusdrakedesc]".
Conversation of Augustus Drake is { "Your kindness will burn this world and char the frozen time."}.

the scent of Augustus Drake is "Drake smells of smoke and gunpowder with an underlying feline musk.";

to say augustusdrakedesc:
	if HP of Augustus Drake < 99:
		say "     A late thirty-something Caucasian male with [if Perception of Player > 20]glossy black hair that you suspect might be dyed, [else]well trimmed black hair, [end if]who you believe to be the owner of the Last Chance. Standing at roughly six foot six Drake is quite the tall fellow with a decent build. His masculine body is sculpted in tough compact muscles and his tight cut ass could teach diamonds a thing or two about hardness. He wears a sun-faded white T-shirt and blue jeans that look a little tight on him. Strapped to Drake's back is a giant sniper rifle almost as big as he is with a popular quote from the Bhagavad-Gita: [italic type]Now, I am become death, the destroyer of worlds,[roman type] etched in a spiral pattern on the barrel. You recognize it as an anti-material rifle. If you recall correctly, a single depleted Uranium round fired from that thing is purportedly able to pierce the engine block of an APC. Currently, he could almost pass for an unaltered human were it not for his vertical pupils that are eerily similar to those of a predatory cat's or his odd earthen musk.";
		project Figure of Augustus_Drake_icon;
	else if HP of Augustus Drake is 99:
		say "     Forcefully stripped of his humanity, due in large part to your meddling, Drake has transformed into a patriarchal lion. Initially a tall man, Augustus's infection has imbued him with an extra six inches putting the man at a towering seven feet. After being warped by the nanites you indirectly infected him with, Drake's impassive face has taken on the hardened boxy muzzle and dark blunted nose of a feral male lion. Adding to the effect is a mane of liquid bronze fur growing from around his neck. The ends of which appear to have a ring of flowing crimson highlights circumscribing his mane. His torso, humanoid in shape and covered in a pelt of burnished gold, has become a dense sea of finely hewed muscles you could lecture an anatomy class on. Altered by the infection, Drake's digits have become an efficient hybrid of leonine paws and sapiens hands. That allows him the benefit of his long retractable claws; while preserving his ability to operate sensitive equipment.";
		say "     Much in the order of his mane, Drake's fingers and toes are tipped with bright sanguine hairs. Sprouting from his chiseled ass is a long Felidae tail, which just like his digits ends in a tuft of rich blood red fur. Resting upon Drake's carved digitigrade legs is a plump pair of cantaloupe sized furry balls that hang close to his knees. In contrast, his meaty feline sheath appears to be around two inches thick and less than three inches long. As he's no longer able to fit into most pre-infection attire, Augustus has to walk about in the nude. The sole exception being a wrap-around holster he wears around his chest that at the moment is playing host to a large pocket knife. Hoisted over Drake's shoulder is his Anti-material rifle, the words: [italic type]Now, I am become death, the destroyer of worlds[roman type] coiling around the barrel.";
		project Figure of Augustus_Drake_lion_form_soft_icon;

instead of conversing the Augustus Drake:
	say "[Draketalk]";

to say Draketalk:
	if HP of Augustus Drake is 1:
		say "     'Grab a seat if you like,' Drake says walking behind the counter, not paying much attention to whether you do or don't. He opens a hidden drawer, pulling out a lighter along with a half smoked hand rolled joint and a plastic orange lighter. Tapping a bit of ash off the end he unabashedly sparks it up as he continues, saying. 'Now, you said you're looking to do a little trading right?' You reply in the affirmative. 'Good, here's the deal. I pretty much set here on food, water, and materials but I'm a bit short on medical supplies. Well, I got tons of painkillers, but no sterile equipment. Normally, I'd go scaving some myself but can't leave this place alone long enough to go searching right now. If in you're willing to part with any spare medkits you find on your travels, I'll give you two bottles of water and some food for your trouble. Sounds like a deal?' Drake asks, blowing a puff of fragrant gray smoke rings.";
		say "     Nodding, you tell the man you'll think about it. 'Good enough for me, oh one more thing I forgot to mention,' He takes a long drag burning the dubby down to a roach, 'while you're walking the grounds, you might pay a visit to Kathy, she's in room 020,' Drake points towards the ceiling, 'or little Ava out in the garage.' He gestures to the parking lot. 'We don't get much sane company out here, and I'm sure the two of them would love to hear what's going on in the city these days. Course, if you mess with either of the girls. The nanite infection will be the least of your worries.' He concludes calmly snuffing out a burning ember on his calloused palm, and flicking the ash off with his middle finger.";
		now HP of Augustus Drake is 2;
	else if HP of Augustus Drake is 2:
		if Medkit is owned:
			ItemLoss Medkit by 1;
			say "     'Thanks kid, this will help Ka-ahem me out a lot.' Drake says squirreling the medical equipment behind the counter. 'Here,' he opens some nondescript drawer just below your line of sight, 'your remunerations,' Augustus says, handing you two units of food and water in the form of generic launchables. Generic Brand lunchables: now with extra preservatives and fifty percent less sawdust than the next leading brand.";
			ItemGain water Bottle by 2;
			ItemGain food by 2;
			now HP of Augustus Drake is 3;
		else: [Cue Darth Kreia speech]
			say "     'Having trouble finding those medkits, kid?' Drake inquires in a somewhat indifferent tone as he gazes over your shoulder at a pair of dust devils swirling beyond the gate with a vaguely bored look on his face[if Perception of Player >= 25]. Despite his seemingly disinterested tenor, you notice a slight clench in his jawline. The man's feline eyes are sharp focused crescents reminiscent of a predator eyeing up its prey as he watches the motes of brown, gray, and black dust swirl behind you[end if]. Shrugging, you reply in the affirmative, the city isn't exactly swimming in supplies, and most survivors aren't exactly in a sharing mood either. '*Huff*, true, not a lot of folks willing to trade either. Can't say I blame them, it's a bit risky,' Drake grumbles through an odd, sharp, almost too-toothy scowl. Why does he say that, you ask. 'Well, sometimes the more stable muties will try to slip in an infectious item or two into whatever their trading. Seen it happen once in the field when an older woman named Jade I used to know who lived in old Victorian style house near the Red Light District.'";
			say "     'She was a short woman with beautiful rich raven black hair, soft violet eyes, skin the color of caramel cream, and smelled of exotic spices.' He says as his momentarily adopts a warm nostalgic tone, 'who bought a box of trash bags, tube of toothpaste, a hairbrush, and some rubber gloves from a Latex Vixen Herm from the RLD.' Drake nods his head in the general direction of the Red Light District. 'Don't know which one was infectious, but in hindsight, I suspect some, if not all of the plastic from those came from the vixen. Didn't take long for her to start changing, it was little things at first. Skin started looking a bit too smooth, hair became stiff and ridged, then she,' Drake winces as his left eye twitches almost imperceptibly at the memory. 'She started showing more than a bit of passing interest in mutants. At first, I thought it was just intellectual or medical curiosity. She was pretty damn smart, half the time I had no idea what she was talking about. But, I learned something new whenever we spoke, so I didn't think much of it.'";
			WaitLineBreak;
			say "     'You know, I'd like to imagine under other circumstances, we could learn a lot from some of the creatures out there. But,' Drake swallows hard as if taking a pull of some bitter medicine, 'once I caught her staring at some locals ";
			if "Touched by Madness" is listed in feats of Player:
				say "in flagrante delicto. ";
			else:
				say "going at it in some alley. ";
			say "I knew something was up. From there, she got very forward with people and started expressing more than a passing interest in others, which seemed strange to me at the time. I was pretty darn sure she was ace. Since my brother and I tried barking up that tree more than once in the past, and well,' he says, flashing a single far-too-sharp canine at you, 'nothing ever came of it. Eventually, during one of my visits, I ended up walking on her having some [']alone time[']. By then she... she was already transitioning into a full fledged Latex Vixen Herm, but the saddest part was, she seemed to enjoy playing with her new [']toy['] even as her mind started to slip away,' Drake continues in a tired almost ragged tone as his catty pupils shrink to the smallest of pin pricks. 'I can't shake what I saw that day.'";
			say "     'When I close my eyes, I can still hear that horrid squeaking sound the remaining skin on her hand made as she sat there beating off that creepy latex dick!' he barks through clenched teeth. 'With every stroke of her hand, I could see these growing tendrils of red and white seeping from her groin as if they were worms feasting on roadkill while globs of red and white plastic fell from her hair like blobs of rotten oil. Everywhere the stuff touched, her body started to writhe and contort into a parody of a fox. Then this smell hit me,' he winces, his nose twitching in revulsion, 'it was like holding your head over a cauldron of burning brakes, body soil, and ozone that made me want to gag. But the worst part was, she had this-this look on her face,' Drake shudders as he recalls the memory. 'It was like she knew what was happening to her, yet couldn't, or wouldn't stop, it just felt too good she said. Guess, that's how the nanites get us all in the end, they make you feel as if what you're doing is right, and numb you to what's going on around ya. Over time, you start making tiny compromises that all make sense to you at the moment.'";
			WaitLineBreak;
			say "     'Little by little, with every line crossed, the easier it gets to just [italic type]let go[roman type]. Sooner or later, you stop seeing the nanites as a threat, but a tool you can use for yourself to achieve some [']ideal self['], a means to live out your deepest fantasy, or a resource you can exploit. I still wonder though how much of that is a result of the nanites['] influence, or simply a quirk of human nature. Either way,' he continues as his voice regains a touch of its commanding presence. 'I tried helping her for a while, brought her books, pills, even a few toys, and offered her a room at The Chance. Anything to help her manage her urges and shelter that last waning spark of who she was, but I,' Drake inhales deeply and exhales with a solemn sigh. 'Had to... cut ties after they went into heat, rut, or whatever you want to call it and tried to jump me. Course,' he snarls, rage radiating out from his being like ill humors seeping from a blighted wound, 'that was just what that goddamn monster wanted! Once she was isolated, it just strolled on into her place like it owned it and took over.'";
			say "     'Found out later from the locals, this particular Vixen was, or at least claimed to be, the progenitor of a lot of the Latex Foxes in the city, and was using Jade and her house as hir own personal fox factory. The sick freak was really efficient about it too. From the looks of things, shi kept feeding Jade and a few others a diet of Estosterogen and fertility pills to produce a steady supply of monsters for hir to send out and pillage the city for hir own ends. Once I caught sight of what was left of her, saw with my own eyes what that-that thing was doing to her, I couldn't sit by any longer.' He says ruefully as he pulls a solid white vapor pen from his pocket, takes a long, and blows a billowing cloud of floral maple-scented fumes into the air above you. Sighing, he puts the pen back in his pocket then continues. 'Her and a couple others were locked in small filthy rooms with only small solar lanterns for illumination, full of vinyl vulpines fighting for a space on one of her four huge latex breasts. Poor thing, she looked so swollen, her tits could touch the ground even when she was standing.'";
			WaitLineBreak;
			say "     'On the rare occasion she tried to move, you could almost see the seams of her twisted rubbery hide start to fray around the edges, like the nanites were struggling just to keep her together. Next thing I knew, it felt like something in me just snapped in me, I rushed in. I can't say what exactly happened next, but the things I did to hir owner, I'm,' he pauses and looks down at his knuckles as if searching for a stain or wound that's long since vanished, 'not proud of.' Drake says as his voice trails off and his hand drifts a hair towards his knife holster then falls to his side defeatedly. 'When I finally got my choler under control, most of hir slaves had run off, but not Jade. She just sat there in her cold barren room playing with herself, and getting rutted by her kits like everything was perfectly fine. I tried everything I could to get her out of there, but she didn't want to leave! She even begged me [name of player], fucking begged me, to leave her and the freak who turned her alone.'";
			say "     'That thing said, ha-ha-ha,' Drake laughs, or at least makes an attempt at it. As the broken discordant notes coming from him are hard and jagged things that scratch at your ears like waves crashing upon pillars of rough black basaltic iron as he briefly burying his head in his hand to muffle the harsh unnatural tones. 'Said it was happy! Can you believe that [Name of Player]? Happy, ha-ha-ha! Happy, being little more than a mewling cum-dumb broodmare worshiping its mistress's rod without a care beyond when its next litter of plastic freaks was due. FUCK! [Name of Player] what did Jade, or anyone do to deserve that!?' he roars, his voice alight with self-righteous rage while veins on the side of his neck throb and bulge a painful red. [if Intelligence of Player >= 25]Though for all his visible anger flaring across his body like coiling tendrils of a wildfire searching for fuel, Drake's aberrant amber eyes are cold lifeless pools of sadness. Staring at their depths, you almost feel like you can see faint flickers of the memory dancing along their edges like a half forgotten nightmare.[end if]"; [Warning: CPTSD is a hell of a drug.]
			WaitLineBreak;
			say "     Then suddenly slams his fist against the counter with enough force to rattle the glass behind you. 'She was a good person with a bright future, and a great job working with the astrophysics department at Tenvale college. She could have done so much for the world if she just had the time. Now, all she'll be remembered for is filling the town with Latex Foxes!' Drake bellows in a sharp cutting knell. 'You know,' he says as he tries to rein himself in, 'she used to come here every year or so to go stargazing with her peers at the top of Mt. Shirley. Why,' he adds wistfully, 'I remember one year there was a meteor shower going on, and she hired me and Rufus to help carry their stuff. Course my brother, being the man he was, brought like half a kilo of shrooms with them. Don't know how he convinced us, but the whole group ended up eating them all and we tripped for hours on those peaks together.'";
			say "     'Man, we must have spent the evening talking about work, our hopes, our dreams while stars performed a ballet only we could see, and the gentle crackle of our campfire kept the nights chill at bay. And now,' Drake says, his cadence dropping to a low tired whisper as he rests his chin against his knuckles. 'I'll never get to sit and warm myself by that bonfire of dreams again,' Drake rumbles, shaking his head. 'All thanks to that fucking mutant, she's gone, because something wanted to use her against her will! So kid,' Drake says, fixing you with a cold hard stare, 'you can see why most folks don't want to trade, at least with a feral mutie?' Nodding, you tell him that does make a bit of sense, though not all the infected act that way. 'You're not wrong kid, but those of us who are still more or less human want to stay that way. It only takes one strand of hair, a drop of bodily fluids, or a tiny scratch to wipe away everything that makes you, well, you,' he says mournfully, while he shifts his gaze to his sculpted core as a shudder passes through him.";
			WaitLineBreak;
			say "     Regaining his composure, he locks his slitted eyes with you and continues. 'Still, I know there's at least one group of people at the [bold type]Abandoned Lot[roman type] near the junkyard who occasionally do some business with humans, or people they consider human enough.' Curious about what qualifies as [']human enough['], you ask Drake to elaborate. 'Well, they seem to be a bit more receptive to working with the more normal sized people-shaped infected like the Anime Babes, Hentai Fans, Spartans, Helots, Math Teachers, and the Naiads at college.' He gestures with his left thumb to the direction of the campus. 'Seen a few Harpies, Sirens, Cavemen, Vikings and Amazon types down there too. Oh,' he adds, tapping the counter top with left pointer and middle fingers, 'think the Knife Ears, Knights, and Squires down at the Urban Forest might pass.'";
			say "     'Then,' he pauses as right eye twitches in aggravation, 'there are the Pod Persons.' Drake growls at mere mention of the name. Pod Persons, you ask, who or what are those? 'No one knows much about them, but I hear if you eat the fruit of what people have taken to calling an Awesome Tree growing in the forest. You can turn back into a human, don't really believe it myself though.' He huffs dismissively. 'Some of the rumors coming out of that place say these Pod Persons eventually become Awesome trees themselves.' Darn, sounds like one hell of a Faustian bargain, your remark. 'Sure is kid, sure fucking is.' Drake huffs as he clicks his tongue.";
			[now Morale of Augustus Drake is 1;]
	else if HP of Augustus Drake is 3:
		if Medkit is owned:
			ItemLoss Medkit by 1;
			say "     'Huh little lighter than I expected,' Augustus rattles the kit next to his ear, 'but still good on ya kid.' Drake says vanishing the first aid kit. 'And there you go, honest pay for honest work.' he says, sliding a bit of food and water your way.";
			ItemGain water bottle by 2;
			ItemGain food by 2;
			now HP of Augustus Drake is 4;
		else:
			say "     'More slim pickings out there, eh kid?' Drake asks in an even, if downcast tone. More or less, you reply. 'Well, you could try some of the vets in the High Rise District or The Zoo. Tend to avoid those places myself after hearing a few horror stories from the start of the outbreak about people merging with their pets or the exhibits. Not sure if that's true, but a bunch of people in the area swear a number of more exotic infections in the High Rise started out at the specialist clinics. Luckily, most of those human animal hybrids weren't really interested in looting, so you might find supplies there. Just watch your step, some ferals like to taint resources, or use them as bait to draw people in.' Interesting, you reply, so he'd be fine with vet supplies as long as they aren't tampered with. 'Ya, well I can't afford to be too picky.' He shrugs. 'Besides, despite what some of the big pharma folks will tell you, most of the drugs and equipment they have work on people just as well as animals.'";
			say "     'Especially painkillers, most don't seem to get addicted to [']em as easily as people do, or they just don't show it, so they tend to be stronger too.' Huh, you'll have to keep that in mind the next you go scaving. 'Appreciate it kid,' Drake bobs his head in acknowledgment. 'Just be careful what you pick up, or use, don't want to accidentally pop some de-wormers and ruin your guts, or take some what you might think are high end pain meds only to find out they're actually animal hormones. Local rumor has it that a few desperate folk have used them as bootleg H.T.R drugs.' Really, would that even work, you ask. 'No idea, never tried it, or seen someone use it.' Drake says, throwing up his hands. 'But if my trading partners are to be believed, nanites are pretty sensitive to Oestrogen and Progestogen and can completely change a person's sex with only a single dose of the stuff.' Right, but does he have advice on ways you can identify the drugs you find.";
			WaitLineBreak;
			say "     'Well normally, I'd say you should check online, if the power weren't down.' he says drumming his finger along the countertop. 'Though, you might be able to find a pill catalog at the vets. A lot of places keep them on hand so folks can identify what meds their pet got into.' Drake pauses to rub his chin. 'Police and E.M.S services often have them as well for similar reasons. Occasionally, you might find a catalog at a library, doctor's office, or pharmacy, but I wouldn't hold out hope. I'd imagine those things would be pretty hot items to folks in the know, after all this time, doubt you'd find any left.' Giving him the thumbs up sign, you tell Drake you'll keep that in mind. 'Good on ya kid, if you do find one let me know, got a couple bags of trail mix in back I'd like to I.D.' He says, motioning to the door behind him with a bob of his head.";
	else if HP of Augustus Drake is 4:
		if Medkit is owned:
			ItemLoss Medkit by 1;
			say "     Shaking his head at your offer Drake says. 'Sorry kid, if that one's anything like the last I don't want it.' Wondering what's wrong with your medkits, you ask Drake if he could be more precise. '*Huff* guess I got no choice, look kid those kits were for Kathy,' Drake sighs. 'Since, I don't know if you've noticed but she might be due any time now. And to be perfectly frank, I am not sure she'll survive labor. I mean she has that-that huge litter,' Drake starts pacing around the lobby, 'and she's so small, how is Kathy going to, what if she? What if I can't, what I'll do if she... and little Ava,' Drakes says, his voice cracking like the walls of an old fort about to buckle as he buries his head in his hands.";
			say "     'Shit kid, I'm in over my head here. I mean braining a behemoth or garroting a Minotaur is one thing, but I don't know what to do if stuff goes south.' Drake looks at you through his fingers. 'That's why I've been sending you out for those medkits. I thought at the very least I could get stitches, antiseptic, or hell even a set of sterile gloves would be a god send.' Perturbed, you ask Drake why he hid this information from you. '*Sigh* kid we have a saying in my family: never let anyone have a hold over you. Sounds pessimistic I know, but I couldn't be sure how'd react or if you'd try and take advantage of the situation. But I am out of options now, so if you're still willing to help I sure as hell need it.'";
			LineBreak;
			say "     [bold type]What do you want to do?[roman type][line break]";
			let Drake_Quest_Choices be a list of text;
			add "Help him." to Drake_Quest_Choices;
			add "Don't help him." to Drake_Quest_Choices;
			let Drake_Quest_Choice be what the player chooses from Drake_Quest_Choices;
			if Drake_Quest_Choice is:
				-- "Help him.":
					say "     'Wait really?' You nod, asking Drake what his plan is though you do mention the nanites seem to handle issues normally associated with childbirth nowadays. 'I know but these are MY KIDS not some random Latex fox's shitting one out in a back alley. I want to make sure I can handle any accidents or complications. Besides, I'd rather not trust the nanites to fix my problems. As for my plan, well,' Drake sighs, 'I don't so much have a plan as a gamble. You see, I haven't checked over the local clinics, care centers, and police stations. Cause the way I figured it, those places along with the rest of our emergency services would be hit the hardest by the outbreak. But at this point, I can't see any way around it.'";
					say "     'So kid, if you're up to it, I'd like you to take a look around the city for a children's hospital or pediatrician's office. Not gonna lie, I'm a little afraid to see what the nanites would do there, but who knows maybe one of the nearby practices survived the infection.' Bobbing your head, you ask Drake if he could make a list of items he's looking for. 'Good idea,' Augustus takes out a pen and a pad of paper from somewhere behind the counter, 'let's see gloves, formula, drops, T-dap, those ear-nose-throat syringes mom used...,' Drake mumbles to himself. Five minutes and two sheets of paper later, Augustus puts down his pen. 'Here you go kid, sorry for the wait.' Drake says handing you the pages from the notepad. Taking it from him, you tell you'll keep your eyes open. 'Thanks [Name of Player].'";
					now HP of Augustus Drake is 5;
					now Doctor will see you now is active;
				-- "Don't help him.":
					say "     'Ya, I guess that was too much to expect from a stranger.'";
					now HP of Augustus Drake is 98;
		else:
			say "     'Still no luck with those medkits, kid?' Drake asks dryly. Shaking your [FaceName of player] head, you tell him you haven't found any more. 'Ah, have you tried the hospitals or police stations? They were hit pretty hard when the outbreak started, so folks have been avoiding them. Who knows, you might find some there, if you're feeling brave.' Nodding, you tell him you'll keep that in mind, but you're not sure you want to waltz into what may as well be nanite ground zero. 'Fair enough, hm,' Drake pauses and taps his chin thoughtfully. 'Now that I think about it, there were some rumors that a few of the surviving E.M.Ts got picked up by a [bold type]husky pack[roman type] a while back. After all this time though, I don't know if they're still human,' Drake shrugs. 'But if you found them or freed them, they could probably point you in the right direction, or make some D.I.Y medkits together themselves.' Interesting, you tell him you'll keep that in mind the next time you're out scaving for Drake's medkits. 'Thanks kid, I appreciate it, and good luck out there.'";
	else if HP of Augustus Drake is 5:
		say "     Still looking for those supplies kid?' Drake says in a forced hopeful tone infected with a low undercurrent of worry. Bobbing your head, you tell him you're keeping your eyes open. 'Good, thought of something that might help you out. Ya see there's an old [bold type]Hardware store[roman type] I picked over a while back out over yonder.' He motion towards the plains with a broad sweeping gesture. 'Didn't leave much behind, but there should be a few things lining around that you could use to fashion yourself an improvised weapon.' While that doesn't sound like much to go on, you nonetheless thank him for the heads up and ask if he has any other suggestions. 'Hm,' Drake rumbles, adopting thoughtful expressions as he raps his fingers along the lobby counter. 'You could try the junkyard. It usually has the odd [bold type]unused tool[roman type] laying around, you'd be surprised what you can do with a good crowbar or claw hammer. Be mindful of the locals though.'";
		say "     'Place is full of ogres, hydras, green skins, racoons, bunch of ornery junkyard dogs, something called a Tousky, Junkmen, and this one giant cat wearing some kind of, well I don't know what to call it. An exo-suit I guess? Made of old car parts, if you can believe it.' He says with a perplexed shrug. That's quite the menagerie, you remark. 'Ha, you said it kid, though the place doesn't hold a candle to the stuff living in the Urban Forest and then there's Mt. Shirley. Ugh, that place is really... touched,' Drake answers, casting a leery glance towards the crimson peaks. Really what's the mountain touched by, you ask. Fixing you with a serious look, the color drains from Drake's face as he utters a single word in a cold icy whisper, 'Madness,' then says no more.";
	else if the HP of Augustus Drake is 6:
		say "     'Any luck kid?' 'Drake mutters from behind the counter, his chin resting on his knuckles as he listlessly gazes out at the garden beyond the lobby. Shaking your head in the affirmative, you hand him Medea's parcel. 'Is this all you could find kid?' He asks, looking rather depressed at the sight of lackluster haul. Electing to put him at ease you regale Drake about your encounter with Medea. Telling him how many of the items he requested won't be necessary due to the nanite plague. 'Really,' he says, shifting through the package. 'Well I guess. I sort of suspected as much so I'll have to take this,' Drake pulls out Medea's card, 'Doctor Medea, huh. Guess someone's parents liked Jason and the Argonauts, at their word.' Drake getting up from behind the counter.";
		say "     '*Huff* still you did right by me and mine, so let me give something a little more valuable than food or water. Just need a second to get it out of the storage,' He says, extracting a five-inch-in-diameter keyring from his desk. Selecting one with red tape wrapped around it from the overflowing keyring, Drake unlocks the storeroom and heads on in, shutting the door behind himself before you can get a look inside. A minute or two passes before he returns carrying a battered medium sized black plastic suitcase not unlike those used by the military or a P.M.C. Placing the container on the counter, Drake undoes a number of hidden pressure latches. He flips the case open and slides it over to you. Looking inside of the case, you see a deconstructed short barrel rifle, known in parlance as a Bullpup carbine slotted into blue foam cut outs. These weapons might not always have the range or stopping power of conventional full sized rifles like the rugged Kalashnikov or modern M series.";
		WaitLineBreak;
		say "     They excel in close quarters or urban scenarios owing to their maneuverability and lightweight design. Given your situation where most combat happens at knife point, such a layout is probably among the ideal. Interestingly, as you examine the piece's innards a little more thoroughly, you notice a number of electronic components have been added in lieu of the normal firing mechanisms. Further, the weapon does not appear to accept magazines, belts, clips, or even individual rounds leading you to believe this gun may have a self contained source of ammunition. 'Beauty isn't it?' Drake says, pulling out the stock. A rather elegant yet ergonomic jet black thing engraved with a bald eagle posing atop the letters RSX. You nod in agreement asking where he got such a prize. 'Well I'm not sure if I told you this. But a couple of weeks ago a military convoy got fragged by the behemoths not too far from The Chance.'";
		say "     'There were no survivors but a lot of their gear was left mostly intact. This being among them,' Drake taps the stock. 'Now if you can give another minute or two I can put this together for ya.' Wondering why you'd need his help, you ask Drake if you could perhaps do it yourself. 'Do you have a good multi-tool, a pair of magnifying glasses, and read the manual; which by the way the table of contents is thicker than a feral sea dragon's thumb?' You tell him no. 'Then I think you'd best leave it to me. Now where are my work glasses,' Drake says rummaging through his desk. 'Dang,' Drake snaps his fingers, 'I must have left them upstairs. Come on,' he says, gesturing for you to follow him. Shrugging, you pick up the suitcase and fall instep with Augustus.";
		WaitLineBreak;
		say "     On the way up though, you notice a slight laxity in Drake's demeanor. No longer do his shoulders appear rigid in the order of a Potsdam giant on inspection day. His stride once boarding on mechanical now has a bit of joyful swagger to it. Even his stern expression is lost. Reaching Kathy's door, Drake smiles perhaps for the first time since you've met him as he knocks on her door. 'Sweetie, I'm coming in,' he says, letting himself in. 'Drakey!' Kathy her arms open wide and exclaims as you walk in after him. 'Hey honey,' Drake says, hugging his mate, and nuzzling the side of her head with his own. 'I am sorry to bother you about this, but have you seen my magnifying glasses?' 'Oh, that's right I forgot to tell you,' Kathy replies as she disentangles herself from Drake.";
		say "     'I was trying them on last night, don't worry though.' Kathy says rolling onto her tummy using her overripe womb as pillow and giving you a wonderful view of plush ebony snatch and thick padded ass as she reaches for the nearby nightstand. 'I put them in here when I was done.' Kathy says plopping down on her tush and sending a quick ripple through her lush figure, she pulls out a stubby pair of spectacles not all that dissimilar to those stereotypically worn by librarians. 'By the way, how do I look?' She asks, adoring the eye wear, which you have to say doesn't look all that bad on the portly lioness. Even if they do not rest on her head exactly as they were intended.";
		WaitLineBreak;
		say "     'Hm, you know, I didn't think it was possible but you may have actually found a way to look even cuter.' Drake says, rubbing his chin as if to make a show of his inspection. 'Course now I feel bad about asking for them back.' 'Flatterer,' Kathy teases, handing Drake his glasses. 'Thanks sweetie, you know when I am done we could-,' Augustus whispers to Kathy as he kisses the nape of her neck. 'Ooh, I'll have to get out the mini-skirt and the yardstick then,' Kathy cuffs, running her fingers through Drake's mane. 'But could you take care of them first, I don't do public shows anymore,' she says, gesturing to you. 'Oh right,' Augustus chuffs. 'Hey kid, you mind setting that thing down on the table while I get out my tool.' Drake says over his shoulder as he pokes through the nightstands. Grunting, you do as he requests then prop your back against the door frame.";
		say "     Locating his folded multi-tool, Drake takes a seat, removing what you guess is the trigger assembly and barrel from the suitcase. 'Alright-y, this shouldn't be more than a spell,' he says, putting on his glasses. 'Now let's see, according to the manual I have to connect these wires to this thing here,' he says expertly coiling the tips of several wires together around a threaded anode diode. 'Then trim the excess then adjust the screws a half turn, clear off any dust or shavings-,' Drake murmurs slowly assembling the carbine. A rather idiosyncratic task you realize watching him make hundreds of tiny adjustments, muttering at the same time about magnetic saturation, scram rail alignment, and heat dispersion. Perhaps curious as to what he's building, Kathy waddles over to Drake's side saying, 'What's this thing?'";
		WaitLineBreak;
		say "     'My guess, it's a gauss gun sort of like the ones my roommate in college was working on,' Drake says, rapping the handle with the nail of his left middle finger. 'What's gauze? Is that the stuff you used to clean my cuts?' Kathy inquires. 'Sorry it's a bit of a homonym-,'Drake replies. 'A what,' Kathy interrupts, cocking her head at an angle. 'It means two words that sound the same but have different meanings, I'll explain a bit more later when we go over your English packets later. But basically this thing,' Drake taps the barrel with a screwdriver, 'uses high powered magnets fueled by a Type III Vanometic powercell to sling sharp bits of metal really far, really fast. Kind of like the Brahmashira only without the need for black powder. Still, I wonder how they overcame the problem of rail degradation. If I recall correctly the things overheated once they went above neodymium strength magnets. I remember people were talking about using He-3 as a heatsink or thermal conduit, but that was before Texas had its helium shortage. Only other option was Deuterium or Tritium but production of those damn near stopped after a reactor meltdown in Japan tanked the market.' Drake says affixing the rifle's housing.";
		say "     'Oh. So why are you giving it to them?' Kathy says, nodding her head towards you. 'Well the kid did us a favor by finding those supplies you'll need-,' Drake replies only to be swiftly cut off. 'Wait, is this about the cubs again? I told you, they'll be fine.' Kathy giggles petting her belly fur. 'I know Kathy but,' Drake says, sounding a little solemn as he wraps an arm around her. 'If anything happened... I don't think I could live with myself. You were right though. I guess, I just need to hear it from a few people.' 'Oh Drake,' Kathy says, pulling herself next to him and giving him a playful nip in the nose. 'You get so cute when you're all angst-y.'";
		WaitLineBreak;
		say "     'Now who's the flatterer,' Augustus jokes, slapping the finishing touches on the carbine's casing. 'Still you,' Kathy says, rubbing her muzzle against his check as he completes the weapon. Getting up, Drake whispers something in Kathy's ear that makes her chuckle then saunter off to the other side of the room. 'Sorry for the wait kid, here let me give you a quick demo outside. I got a couple of makeshift targets in storage. I'll grab them, a few beers, some smokes, and we can plink at them for a bit,' he says, handing you the rifle. Accepting it, you allow Augustus to lead you out the door, only to hear Kathy say, 'Um, Drake I think I need a little help putting on this mini-skirt,' stopping him in his tracks.";
		say "     'Actually on second thought, maybe you should head out on your own to test your new gun. Ya, I think that'd be best. So uh good luck, you're an adult an['] all so don't shoot your foot off or anything, BYE!' Drake says pushing you all the way out onto the dry plains. Locking the gate behind you, he sprints back to room 020 like a desperate young man about to lose his V-card. Looks like you won't be getting back in for awhile, but oh well at least you got a new gun.";
		Move player to Dry Plains;
		ItemGain Driver carbine by 1;
		now HP of Augustus Drake is 7;
		now Loyalty of Augustus Drake is 1;
	else if HP of Augustus Drake >= 7:
		say "[AugustusDrakeTalkMenu]";

to say AugustusDrakeTalkMenu:
	say "     [bold type]What do you want to talk to Drake about?[roman type][line break]";
	LineBreak;
	now sextablerun is 0;
	blank out the whole of table of fucking options;
	[]
	if HP of Augustus Drake <= 98:
		choose a blank row in table of fucking options;
		now title entry is "How he survived out here so long";
		now sortorder entry is 1;
		now description entry is "The plains aren't the most forgiving of places, so what's his trick";
	[]
	if HP of Augustus Drake <= 98:
		choose a blank row in table of fucking options;
		now title entry is "His eyes";
		now sortorder entry is 2;
		now description entry is "They're a tad unusually, must be a story behind them";
	[]
	if HP of Augustus Drake <= 98:
		choose a blank row in table of fucking options;
		now title entry is "The current state of the Last Chance";
		now sortorder entry is 3;
		now description entry is "Why are most of the doors locked";
	[]
	choose a blank row in table of fucking options;
	now title entry is "Chat";
	now sortorder entry is 4;
	now description entry is "Engage in a little post-apocalyptic water cooler talk";
	[]
	sort the table of fucking options in sortorder order;
	repeat with y running from 1 to number of filled rows in table of fucking options:
		choose row y from the table of fucking options;
		say "[link][y] - [title entry][as][y][end link][line break]";
	say "[link]0 - Nevermind[as]0[end link][line break]";
	while sextablerun is 0:
		say "Pick the corresponding number> [run paragraph on]";
		get a number;
		if calcnumber > 0 and calcnumber <= the number of filled rows in table of fucking options:
			now current menu selection is calcnumber;
			choose row calcnumber in table of fucking options;
			say "[title entry]: [description entry]?";
			if Player consents:
				let nam be title entry;
				now sextablerun is 1;
				if (nam is "How he survived out here so long"):
					say "[LoreDumpOne]";
				else if (nam is "His eyes"):
					say "[OldOneEye]";
				else if (nam is "The current state of the Last Chance"):
					say "[LoreDumpTwo]";
				else if (nam is "Chat"):
					say "[ShootingTheShit]";
				wait for any key;
		else if calcnumber is 0:
			now sextablerun is 1;
			say "     Actually, you don't feel like talking to Drake at the moment.";
			wait for any key;
		else:
			say "Invalid Option. Pick between 1 and [the number of filled rows in the table of fucking options] or 0 to exit.";
	clear the screen and hyperlink list;

to say LoreDumpOne:
	say "     Briefly shooting the breeze with Drake, you bring up the subject of his continued survival. 'To be honest I got lucky, at the time of the outbreak I was already indoors along with most of the staff and clientele. We avoided the brunt of the infected by staying inside the walls and going dark. Unfortunately, people weren't too keen on staying put and decided to run the blockade even though I offered them free room and board.' Drake nods his head in the general direction of the quarantine line. 'They didn't get far before the ferals caught on. I'll spare you the sorted details on what happened next. But suffice to say the military didn't exactly take too kindly to a column of horny mutants so close to their position and shelled the lot of them to kingdom come.'";
	say "     'Not too long after the flames died down, a convoy was sent out from beyond the line, I am guessing to assess the situation in the city, since most drones aren't getting through. Too many fliers think they are toys, challenges or something I guess, but the bloody fools. They went out in light armor with almost no heavy weapons, chem suits, tank support, or explosives. Hell, I'm pretty sure they didn't even bring flash bangs. No wait,' Drake grumbles his face contorted into a foul grimace as if he just bit into a block of pure Denatonium. 'I take that back, they had one grenade, each. I have no idea why though. I mean what in the heck is one M67 grenade gonna do against say a wyvern other than piss it off?' So what happened to them, you ask.";
	WaitLineBreak;
	say "     'Bane of my existence, goddamn behemoths happened. Those fucks attacked the convoy not one hour in turning, eating, and what did Vix call it, unbirthing? The lot of them. When all was finally said and done, I went out looking for survivors, as you can guess there weren't any. On the plus side, I looted this beauty from an overturned A.P.C,' Drake says, baring his teeth like a beast stalking his prey as he hoists the Anti-material rifle. 'Can you believe those guys never took this thing out of its case? Ugh,' Drake rubs his forehead, 'my head hurts just thinking about it. Aside from the Brahmashira here,' Drake points to his rifle, 'I pulled out a few dozen boxes of ammo .50 Cal., sandbags, bits of gear. Pretty much everything I needed to start setting up a nice little no-man's-land. Since then,' Drake shrugs, 'I've just been waiting for the troops to get serious and roll on in.'";

to say OldOneEye:
	say "     Intrigued by Drake's Felidae pupils, you ask him how he obtained them. 'These,' Drake grumbles pointing to his eyes, 'are the result of me letting my guard down.' Not satisfied with that lackluster answer, you request Drake elaborate. 'Ok, the long and the short of it is that before I met Kathy and Ava, I let a group of people stay here for a while. In exchange, they gave me some supplies and watched over The Chance while I'd go carry out deep raids into the heart of the zone of alienation, er I mean city. And well on the way back from my last trip I was answering the old call of the wild, when this fucking Manticore flies into me from behind.' Drake holds his right hand at a ninety degree angle; then glides his left hand to the palm of his right hand. 'No joke, the shit actually tried to mount me,' Drake audibly gags at the thought.";
	say "     'Good thing for me I had my great grand pappy's old trench knife on hand. Ah now that was good Deutsch Stahl from the Kaiser Reich, not like this piece of junk pot metal from China I am using now.' Drake pulls his shirt collar away from his neck, displaying a black nylon knife holster playing host to a cheap pocket knife strapped around his chest. 'So, when the fucker was lining himself up I tore my left hand free from its grasp, pulled out my knife and slashed up the bastard's legs. Didn't do much but once I landed a solid jab on the critter's paw,' Drake pantomimes a quick stabbing motion, 'the blighter finally loosened its grip enough to give me the chance to struggle out from under it. Asshole was persistent and all, I will give him that. Even with a banged foot and a couple of broken ribs, he still tried to rape me. Almost succeeded when he got a few stings in with his tail,' Drake involuntarily winces and rubs his shoulder, 'until I gouged out his eye. ";
	WaitLineBreak;
	say "     That finally drove the Manticore off, but man I was a freaking wreck for the better part of a day. By the way, you run into an ornery scarred-up one-eyed Manticore with feathery wings. Tell him I want my family's knife back. I plan on giving it to my kids after all. *Huff* anyways, after I patched myself up, I headed on back to the Last Chance and something a hell of a lot worse.' You ask Drake what he means. 'Those people I mentioned earlier, turns out they were infected. But that is a story in and of itself.'";
	now Hunger of Augustus Drake is 1;
	now Old One Eye is active;

to say LoreDumpTwo:
	say "     Wondering why the majority of the Last Chance is sealed up, you ask Drake if something went down prior to your arrival. 'Ya, I guess it does look a little like the plot of one the B-movie horror flicks shot here, so I'll tell it to you straight. You see, not long after everyone with a working car, or the ability to steal one.' Drake grumbles rolling his eyes, 'tried to flee the outbreak, a group of teens from the local college showed up begging for shelter. I let them in, but I forgot to search them, or their stuff first. Stupid old fool,' Drake mutters, knuckling his brow. 'I guess one of them may have drunk tainted water or fiddled with an infectious doodad at some point, and kept their mutation secret.'";
	say "     'Looking back on it, it should have been obvious they were hiding something, but I was too willing to write off my suspicions by feeding myself these trite lines. Oh they're just scared kids, let them be, it's not your place to pry, who are you their father...fuck me I should of listened to my gut.' Drake says his voice dripping with self-loathing. 'Still, things worked out for a time at least. I got to run deep raids for a bit, gather up supplies, fortified the Chance with their help, meet other survivors, even ran with a sane mutie or two. Shit didn't last, never does,' Drake says, pulling a white vape pen with half gram cartridge of light yellow wax from his pocket and takes a long drag.";
	WaitLineBreak;
	say "     He holds it for a moment then exhales a cloud of floral smoke at the ceiling saying. 'On my last foray, I got well... mauled by a Manticore, during one of my more, *ahem*' Drake coughs into his hand, 'vulnerable moments. I survived thanks to the nanites piecing me back together. [']Bout time they did something useful right? Still I was out of commission for about a day. Course, when I limped back to the chance I found the teens had gone feral, tore up most of the rooms, and skipped town, uh metaphorically speaking. I'm pretty sure most of them are with the Impala herds judging from the hoof prints. Still cleanup was a goddamn bitch, I ended up burning most of the furniture, carpets, shower curtains, even tore out a section of wall. I am not one hundred percent sure I got everything though. So for now, I am keeping them locked down till the C.D.C, F.E.M.A, the E.P.A, or better yet all three give me the all clear. That answer your question kid?'";

to say ShootingTheShit:
	if HP of Augustus Drake <= 98:
		say "     [one of]'I wonder what the government will do with me and the girls.'[or]'Man, I could go for a cup of coffee, even decaf.'[or]'What is it, dragons?'[or]'Got any news?'[or]'Hard to believe I am going to be a dad.'[or]'Don't worry about us. Come hell or high water, I'll see my,' Drake pauses, a look of contentment growing on his otherwise stern visage, 'family through this.'[or]'Hey, you see a lighter anywhere around here,' Drake says, peering over the room. 'Up, never mind, it fell under the desk.'[or]'I don't know what I'd do without Kathy and Ava around to keep me company. Probably be talking to a beach ball with a face painted on it.'[or]'Used to joke that I preferred the company of animals over most people. I did not expect the universe to take me seriously.'[or]'What would my folks think of their grandkids?'[or]'I swear if that pedantic dragon shows up again, I'll turn it into a pair of boots and a pair of hand bags for the girls.'[at random]";
	else if HP of Augustus Drake is 99:
		say "     [one of]'Oh kid, there's something really important I need to-AH!!! D-damn n-nits I bits my-sh mooth agun,' Augustus says massaging his cheek, as a trickle of blood oozes from his lips.[or]'There's some reason you're still bothering me.'[or]'Get out of my face.'[or]'You mind fucking off? I promised Ava I'd read to her in a bit.'[or]'Go darken someone else's door, asshole.'[or]'Oh dear god, what is it now?'[at random]";


Section 3 - if not himself then he has naught

Part 1 - Basic Sex

the fuckscene of Augustus Drake is "[sexwithdrake]".

to say sexwithdrake:
	if HP of Augustus Drake is 99 and cunt count of Player >= 1:
		say "[DrakeSexMenu]";
	else if HP of Augustus Drake is 99 and cunt count of Player is 0:
		say "     Drake doesn't seem interested. Perhaps you're not his type.";
	else:
		if "Propositioned" is listed in Traits of Augustus Drake:
			say "     He doesn't seem interested.";
		else:
			if Cock Count of Player > 0: [Male and Herm]
				say "     'Look,' Drake blushes a deep crimson as he suddenly breaks eye contact with you and begins staring at the ceiling very intently. 'I'm flattered you find me uh, interesting an all, but I am straight.' Feeling a little embarrassed, you apologize for the misunderstanding. 'No harm done,' Drake says reassuringly.";
			else if Cunt Count of Player > 0: [Female]
				say "     'Hm, I'd be lying if I said I wasn't a little interested,' Drake says, emitting a rather lusty cat-like growl. 'Ahem, sorry about,' Drake coughs into his hand. 'But I am sort of in a relationship right now so... ya.'";
			else: [Neuter]
				say "     He doesn't seem interested.";
			TraitGain "Propositioned" for Augustus Drake;

to say DrakeSexMenu:
	say "     Eyeing up the patriarchal lion man, you wonder if you should.";
	project Figure of Augustus_Drake_lion_form_hard_icon;
	now sextablerun is 0;
	blank out the whole of table of fucking options;
	[]
	choose a blank row in table of fucking options;
	now title entry is "Against wall";
	now sortorder entry is 1;
	now description entry is "Have Drake pin you against a nearby and fuck you raw";
	[]
	choose a blank row in table of fucking options;
	now title entry is "Blow him";
	now sortorder entry is 2;
	now description entry is "Suck the big cat off";
	[]
	if BodyName of Player is listed in infections of TaurList:
		choose a blank row in table of fucking options;
		now title entry is "Taur breeding";
		now sortorder entry is 3;
		now description entry is "Have Drake breed your cute taur body";
	[]
	if BodyName of Player is listed in infections of TaurList and BodyName of Player is not listed in infections of EquineList and "Dominant" is listed in feats of Player:
		choose a blank row in table of fucking options;
		now title entry is "Taur Dom";
		now sortorder entry is 4;
		now description entry is "Dominate Drake with your powerful tauric body";
	[]
	sort the table of fucking options in sortorder order;
	repeat with y running from 1 to number of filled rows in table of fucking options:
		choose row y from the table of fucking options;
		say "[link][y] - [title entry][as][y][end link][line break]";
	say "[link]0 - Nevermind[as]0[end link][line break]";
	while sextablerun is 0:
		say "Pick the corresponding number> [run paragraph on]";
		get a number;
		if calcnumber > 0 and calcnumber <= the number of filled rows in table of fucking options:
			now current menu selection is calcnumber;
			choose row calcnumber in table of fucking options;
			say "[title entry]: [description entry]?";
			if Player consents:
				let nam be title entry;
				now sextablerun is 1;
				if nam is "Against wall":
					say "[DrakeSex1]";
				else if nam is "Blow him":
					say "[DrakeSex2]";
				else if nam is "Taur breeding":
					say "[DrakeSex3]";
				else if nam is "Taur Dom":
					say "[DrakeSex4]";
				wait for any key;
		else if calcnumber is 0:
			now sextablerun is 1;
			say "     Shaking your head slightly, you decide against fucking Drake.";
			wait for any key;
		else:
			say "Invalid Option. Pick between 1 and [the number of filled rows in the table of fucking options] or 0 to exit.";
	clear the screen and hyperlink list;

to say DrakeSex1: [Against wall]
	say "     '*Huff* You know you're really lucky Kathy can be very persuasive when she wants to be, and this stupid fleabag of a body needs to blow off steam pretty regularly. Otherwise, I honestly wouldn't be giving you the time of day,' Drake grumbles as he vaults over the counter top and lands in front of you without making a sound. Aw, he shouldn't pout you promise you'll make him feel real good. You tease, sizing up the lion man's stern regal physique with an appraising gaze as you reach out to stroke his toned golden abs and well defined yum gutter with your dominant hand. Besides, he should enjoy the new bod. You mean, fuck damn, look at him! He could grind meat on these things. You swoon tracing the hardened ridges of his sternum. '*Ggrr* don't touch me there,' Drake snaps batting away wandering hand.";
	say "     Mh-hm whatever he says, you jeer rolling your eyes, utterly undeterred by his demeanor. You press yourself against his velvety pelt continuing to stroke his chiseled pecs with your non-dominant hand. You delight in the savage dissonance of his carved ripcord core and his downy soft fur brushing your fingertips. While with the other, you brazenly stroke his groin, teasing his lush sheath and heavy knee-knocking balls. 'Damn horny mutant, you want the D don't you,' Drake chuffs bemusedly as you cup his sizable feline package. What can you say, you're a connoisseur of fine things. The new tool is quite the improvement over that old boring one, doesn't he think? Just look at this freaking monster, he could make an Alpha Husky look like a fennec fox! You purr as your fingers stroke the sensitive spines of his stiffening unit.";
	WaitLineBreak;
	say "     'Don't compare me to those things. I'm not some toy you can ogle and grope to your heart's content,' Drake rumbles. Ah, did you hit a nerve? Is the big kitty upset that he's got a rod big enough to hammer a nail through a bike frame? What is the big guy gonna do about it? You gibe, pressing your body against his goliath wang as it slowly peeks its way out of its fuzzy sheath, till it's sandwiched between your sternums. 'This!' Drake roars, grabbing hold of your [bodytype of Player] back. Digging his claws in your [SkinName of Player] hide, he lifts you off the ground and slams you a bit too roughly against a barren strip of wall. Acting on the instincts burned into what's left of your humanity over countless eons of evolution you struggle albeit meekly in his predatory look and grasp but the lion man's left paw shoots out seizing hold of your wrists.";
	say "     He gruffly pulls them above your head while wrapping his right arm about your hips for support as he lines your [cunt size desc of Player] cunny up with his leonine member. Smirking at his antics you taunt him telling him he's such a naughty boy, is he planning on taking charge now? Only to be cut off as Drake roars, stretching his jaw to his chest as he bites at your throat. Fear tinged with an odd excitement course though you like an unstable plasma globe as Drake's dagger-like fangs and steamy hot breath encircle your vital arteries. Shooting you a baneful sideways glare he rumbles in a slightly muffled tone, 'Enough! I'm getting sick of your damn voice. If you want this monster so damn bad, fine. Just don't come crying to me if you catch a litter of kittens from this. Got it?' Drake says, pressing his fangs against your neck hard enough that you swear you can almost feel your own pulse beating against his saber like teeth.";
	WaitLineBreak;
	say "     Not wanting to push Drake too far (at least for the moment), you lightly bob your head and whine submissively at him as your body breaks out in cold sweat. Well at least as much of a sweat as your [SkinName of player] skinned form will allow. 'Good, glad we understand each other.' Drake growls and loosens his feral grip on your throat. 'I'd prefer not to break beautiful things after all.' Drake remarks, eyeing up your [bodytype of player] body and the beautiful [breast size desc of Player] adoring your glistening chest. He licks his ebon lips at the sight, as if savoring the sight. Encouraged by the effect your assets have on the patriarchal lion, you arch your arch back to accentuate your figure with an inviting shake of your chest. 'Mh quite the set you've got there. You must be proud of them.'";
	say "     Drake chuffs, nuzzling his fuzzy chin against your chest as he kisses your bosom. Giggling, you tell him you can think of something that would make them even better. 'Now what would that be?' Drake replies coyly as his barbed tongue caresses your nips. Why a big belly full of kittens for them to rest on and maybe some sweet cream to round them out. Bigger is better after all, you tell him. 'You know. I hate to say it, but I like the way you think. Besides, it might give your naughty little ass something to do and out of my hair for a while,' Drake replies as he steadies his grip on your [bodytype of Player] hips. Maybe, there's only one way to find out, you trill, batting your eyes at him seductively.";
	WaitLineBreak;
	say "     'Guess so,' Drake snickers, thrusting you onto his waiting lap, expertly spearing your eager sex with his spiny tapered tool with audible wet squelch as your nether lips are splayed wide open. Entranced by the alien sensation of his animalistic tool, you purr with unvarnished delight as his soft fleshy barbs lavish your needy sex and sensitive button, your cunt devouring inch upon virile inch of his leonine cock. You can feel your stomach and fertile passage bulge to accommodate the sheer size of Drake's heavenly hefty rod. You hardly have a chance to enjoy the supple innovation of your feminine flower though. Your partner wastes no time pistoning his rugged waist as he bounces you on his turgid tool sending blissful waves of bestial bliss through your oh so sensitive nerves.";
	say "     Looking down past your heaving chest, you watch with perverse delight as your body ripples from the force of his thrusts. Equally entranced, your partner's lust fogged eye drift over your bouncing assets. The former human chuffing happily as he kisses your bulging midriff. A pleased simper passes your lips as his large whiskers and golden pelt tickles your already over stretched [SkinName of player] skin in such delightful ways. While his rough spiny tongue explores your chest and rock hard nips, unbothered by sensual sheen smearing your asset, or perhaps the big cat is enjoying the lingering flavor of fear and adrenaline. Bouncing in his grasp you cry in ecstasy at the feeling of the large feline's tapered tool brushing your cervix and filling your eager sex to the limit.";
	WaitLineBreak;
	say "     Enthralled by the sensation, you lock your legs around his dichotomous furry hips without thinking. You buck like a bitch in heat, relishing the interplay of his downy golden pelt alongside his dense musculature along your inner thighs. You're soon writhing in his grasp, and feel the virile feline's sizable tail wrap itself up your sides and around your neck like a warm fuzzy scarf. A part of you can't help but nuzzle your [FaceName of player] face against the whipcord limb whilst his masculine scent titillates your senses. A lewder section of your warped psyche taunts your mind with the sudden urge to fellate the crimson tip of his bobbing tail as if it were an unattended dick waiting to be serviced. A part of you wants to fight down this strange desire but the static pleasure pulsing through your well used cunny addles your mind well past the point of resistance or caring.";
	say "     Throwing inhibition to the wind, you cave to your building desire. Your body moves like it was on auto-pilot as you reach out with your [FaceName of player] tongue. Earning your pleased chuff from Drake he watches your antics and obliges your unspoken request. Guiding his prehensile limb to your lips, the big cat gently strokes your cheek, saturating the air around with his unique calming scent before allowing you access to the exotic limb. All the while, he never falters in his vigorous pace as he pounds your needy cunny with that animalistic rod of his even as rivets of your feminine fluids leak down his legs. Still your focus never leaves your perceived prizes as lips engulf the leonine limb and you bob your head in tandem with Drake's animalist paces.";
	WaitLineBreak;
	say "     'Heh, someone's enjoying themselves,' Drake quips between play bites to your chest with his razor-edged fangs teasing the sordid tissue in ways you've rarely dreamt of. You coo in affirmative as your tongue traces the hardened bone and shapely sinew hidden under his pelt of his tail. 'Well I hope you don't mind if I join in then,' Drake remarks though he doesn't wait for a reply as he rebinds the slack in his tail about your chest. He squeezes and fondles the [if breast size of Player < 1]flat chest[else]tender orbs into an adorable heart shape[end if] while he at last lets go of wrists allowing you free reign of his anthro body. A privilege you take swift advantage of as your hands roam the big cat's well hewed furry body, tracing lazy lines in his toned muscles and lurid pelt.";
	say "     Drake soon returns the gesture running his hand down your sides. He playfully gropes your curves and [TailName of player] ass with his soft feline paw pads. Drake teases you about how he's going to make you into a nice well-behaved little mutant once he's pumped a litter or two into you. As his words seep into you like a spell being cast, your nanite-laced mind swoons at the mental image of yourself growing ripe and round with the handsome feline's cubs. You place a hand over the outline of dick pressing against your insides you quip back between laps to his tail, proclaiming. What only one or two? Ha it's going to take a lot more than that to keep you from messing around in the city, as you bounce on his lap.";
	WaitLineBreak;
	say "     'Fine as many as it takes, to keep you out of peoples['] hair. Besides, if nothing else I think you'd look cute waddling around town with a belly full of kittens,' Drake chuffs somewhat excitedly as your lurid walls massage the individual fleshy barbs of his member. Well then, what's this big lion waiting, let's see what those swimmers of his can do. You tease, sneaking a cheeky hand between the big cat legs giving his balls a fondle while your other continues tracing his sizable tool.'*Mrow* well if you insist, I hope you can handle it!' Drake rumbles in a low catty tone as he picks up his pace jostling your body on his turgid spire like disposable flesh light as he rakes your [bodytype of player] sides with his claws.";
	say "     Not so hard as to be painful but that you feel a thrill from their presence, and you suspect the love marks will look cute too. At least that's what you tell yourself as you bounce in his grasp and lose your hold of his saliva-soaked tail. Not that you notice as you throw your head back, howling in delight like a woman possessed as your poor cunny is abused in the most delectable ways. Your frayed nerves struggle to transmit the sensations of Drake's sensuous spines lavishing your silken passage as your body clenches down on that wonderful kitty cock. You can dimly see the same bestial bliss on muzzle as his body reaches its limits and finishes with deep powerful roar that building and vibrates in your chest as a deluge of warm creamy floods your waiting petals. At once, you can feel the sheer weight and force of his eruption painting your insides with mutant seed. Your stomach stretches out in a firm sphere of cum bloated majesty, and your voice joins with his. You involuntarily bury your head in his chest golden floof to muffle your cry as you reach your own electric climax.";
	WaitLineBreak;
	say "     For a moment, the two merely pant and cuddle in each other's embrace as rub your face against his toned pecs and paw at your raw distended stomach. As you trace a finger along your treasure trail a part of you hopes his load will stick. You wouldn't mind being the mother of a handsome pride of lions. Soon though post nut clarity kicks in as Drake's demeanor hardens and his dick softens, you feel the tension in his body rises as his rational half reasserts itself alongside the memories of what you've done to him. As they say: A man forgets but he never forgives. A woman forgives but she never forgets. Best to quickly disentangle yourself despite the warm bubbly feeling in your breast crying out for you to linger just a second longer. You muse, swiftly make an excuse to leave before either of you can ruin the moment.";
	NPCSexAftermath Player receives "PussyFuck" from Augustus Drake;

to say DrakeSex2: [Blow him]
	say "     'Hungry a, *hm* well you're in luck.' Drake sneers with a predatory gleam in his eyes. 'I haven't drained the snake in a while and these things tend to get a bit sore when I put it off too long,' Drake says, jokingly jostling his package. 'By the way, don't expect me to be gentle when I'm using that [FaceName of player] mouth of yours. Once this body gets worked up, it's impossible to rein it in,' Drake scoffs hopping up on the lobby counter top, spreading his legs for you. Eyeing up his plump meaty sheath, golden knee-knocking nuts, and toned furry glutes you tell him you can live with that. As you ease yourself between his muscular thighs, your senses are at once assaulted by his heady feline musk. Your mouth waters and stomach rumbles while you shamelessly huff his virile scent. Drake pays your antics no mind though as you gently fondle his hefty sheath and sagging fluffy balls with your hands.";
	say "     A part of you delights in the wonderful girth and tacitly pleasing fuzz of his altered groin. You can't say why though but something about the soft downy nature of the pelt wrapping his sizable package excites you. As you gently stroke his sheathed furry tool with one hand gradually teasing his barbed rod out of hiding. With the other, you gently cup and caress Drake's heavy hand-filling baby-makers between your fingers like a sack of precious marbles. His hefty orbs practically groan in your palms from the sheer volume of his virile seed sloshing inside. Guess he wasn't lying about being pent up, the poor cat could probably fill a kiddie pool with things. 'Mh, you're pretty good with your hands, must be getting a lot of practice out there, eh?' Drake chuffs, leering down at you with a domineering smirk on his predatory mien.";
	WaitLineBreak;
	say "     You barely hear his verbal barbs though. Your nanite twisted mind is more focused on his fleshy ones on his regal tool as it grows and throbs at your touch like a living tube of lipstick. You find yourself marveling at his crimson not-so-little tool peeks its way out of its hiding place, stretching the skin of his golden sheath enough that you'd imagine it should be painful for him. Yet from the eager look on Drake's feral feline visage, you can tell it's quite the opposite. For all his continuing bluster about hating his new form, you can tell on some level he's still enjoying the new tool along with all its accessories. Who could blame him either, it probably feels out of this world to have those delectable barbs teasing his fluffy sheath, you muse. As your hands tease his exotic barbs and bloated sack, Drake chuffs, 'Heh, looks like someone's enjoying themselves,' rubbing his stern felinoid chin as he watches you coax his pre-drooling cock to full mast. Shooting him a sultry look, you purr in the affirmative telling him you're quite pleased with your handy work.";
	say "     You lick your lips hungrily as the scent of his fresh glistening pre-cum and male pheromones elates your altered senses further. You slurp a dollop of the clear treat, you heap vague praise on the patriarchal lion's package as your hands struggle to wrap around his twitching rod. 'Goddamn furry, I still can't believe you like this weird dick. This thing looks like the devil's pipe clear,' Drake grumbles half heartedly. His tone is a bit softer than before. Tutting at him, you teasingly tell him he should be proud of his new anatomy. Most men would kill for a meat tube this big after all whilst you lazily lap at the tips of his crimson spines. 'Fuck that feels way too good,' Drake pants. His body trembling with delight as your [FaceName of player] tongue explores his twitching tapered rod to the best of its ability. Ah should you stop, is this getting too much for the big kitty boi, you jeer, fixing him a dirty look as your oral muscle grazes the tight skin of his sheath.";
	WaitLineBreak;
	say "     'No, I didn't say stop,' Drake rumbles, grabbing hold of the back of your [FaceName of player] head, sinking his claws in for effect. Naughty boi, you thought as much, you reply, tutting at him in a lustful trill as your lips engulf the tapered tip of his feline member. You revel in the rich salty and tangy flavor of his naturally lubed tool as you go down his foot-plus long cock. You can feel your cheek bulge and throat widen as your nanite altered maw attempts to accommodate his barbed turgid meat spear. Not for first you're a little grateful for the nanites assistance when it comes to dealing with above average mutants as you sense Drake's exotic tool brushing past the base of your tonsils. Your body seems to loosen itself around your partner enough to just barely fit. 'Damn you're just the right kind of tight.'";
	say "     'I still can't get over how this feels. Like I'm wearing your cute little mug,' Drake remarks as you slowly pistons your [FaceName of player] head along the length of his pringles-can-sized tool as best your [FaceName of player] mouth can manage. You revel in the sensation of his delectable flavor and tender barbs massaging your nanite-twisted palate. Whilst your dominant hand cups and fondles Drake's silken package like a bag of prized gems, your non-dominant explores the virile mutant's muscular thighs and chiseled abs, exalting in the wonderful dissonance of his smooth voluminous golden pelt and hardened core. The big cat rumbles enthusiastically at this treatment. He sneakily coils his long fuzzy tail about your neck like a living collar. While the slack of his extra limb gropes your [breast size desc of Player] breasts, you moan delightedly as you glide your canines along the length of his spines.";
	WaitLineBreak;
	say "     You take great care in how much pressure you put on the delicate tissue. Never enough to hurt but enough to provide the large felinoid with a thrill as you practically brush your [FaceName of player] teeth with his fleshy spines. 'Ah, faster!' Drake roars, tightening his clawed grip on the back of your [FaceName of player] skull almost to the point of being painful as he presses down on you forcing his sizable dick down your throat. You almost choke and gag as his heft rod presses against your larynx, but you've gotten quite used to such treatment in recent days and take the abuse in a remarkable stride. Fixing him a needy look, you give Drake a happy throaty rumble vibrating the muscles of your well-used throat along the length of his shaft as you struggle to keep pace with your partner's desire. 'Fuck and I thought Kathy's muzzle felt amazing!' Drake chuffs as his barbed meaty throbs along your soft tissue.";
	say "     You can almost feel his heart pound a minute as his turgid spiny nob stretches your throat almost to capacity as he involuntarily flexes his hips slightly in tandem with the bobs of your head as if he could force just a few more centimeters down your eager maw. Still your malleable mandible struggles to accommodate Drake as his hilt brushes your nose and exciting your senses with the masculine scent of his abs, but there's only so much you can take. Yet, you remain undaunted, gliding your tongue along girth fellating his exotic cock while you dip a few fingers between your legs as your neglected nethers cry out for attention. You waste no time with meager foreplay you find yourself jilling your stiff bitch button between your thumb forefinger. While your remaining digits probe your desperate sex, lavishing your neglected muff with quick thrusts.";
	WaitLineBreak;
	say "     The effect is immediate as pulses of bliss echo about your core and mixes with the oral pleasure titillating your palate in a heady storm of ecstasy. The air echoes with the vigorous wet squelching sounds of your performance until neither of you can hold back any longer. With a feral roar that reverberates through your being, the big cat cums. He tightens his hold on you wrapping his claws feet around you while pressing your head to his furry groin, blasting torrents of hot thick seed down your eager throat as he climaxes. You feel your body swell with his load as your belly groans and sloshes with his offering as it struggles to contain his virile gift. A part wants to gag or pull away but Drake's grip is too firm, his claws too sharp and your hunger too great to resist as you're forced to swallow each drop, your stomach bulging in a warm firm dome. By the time he's done, Drake pushes you like a used toy throwing you off balance.";
	say "     The big cat seems to regard you as you play with yourself, his expression waxing between disgust and sympathy. Sympathy appears to win out though as he says, 'Here move your hand, let me help you with that,' and hops off the counter. Licking his lips, the patriarchal lion kneels beside and lowers his muzzle between your legs. You make no move to stop the man as his hot breath washes over your sex. If anything, a part of you is excited by the prospect of being eaten out by the big cat even if you can't see him past your swollen stomach at the moment. Not that it matters to Drake as his padded paw hand wraps about your thighs, you can feel him lifting your lower body off the ground and forcing you on your back. He kisses your eager lips, with his boxy feline muzzle. You don't even mind when his cold blunt nose bruises your cum stuffed tummy while his long flat spiny tongue lavishes your joy buzzer with long drawn out licks.";
	WaitLineBreak;
	say "     Each barb feels like it has life of its own as they seem drawn to your neediest nerve. As you find yourself moaning with elation and reach down to caress Drake's soft feline ears in a display of admiration. For his part, Drake doesn't seem to mind. In fact you swear you can almost hear him purr at your touch, though you know he would never admit to it. Still the unsubtle vibrations are almost perfectly tuned to make for the most welcome exotic massage to your steamy sex while he nurses your clit with his tongue. You can feel your body tense up in anticipation as Drake explores your button. As each lap of his tongue sends tingles up the base spine like erotic static that fogs your mind that seems to hold you in thrall. You try desperately to hold out as long though as you can but your pre-warmed motor is already humming. It's all you can do to simply ride each blissful wave roiling through your body like the churning waters of a storm-wracked sea. Until at last your body taps out and you cry out like a sated beast as you finish squirting a load of feminine fluids in Drake's predatory maw.";
	say "     A part of you wants to apologize for not warning him, but the words die on your lips as he withdraws his head from your loins happily licking his muzzle clean. You get the feeling he doesn't mind too much. The large feline even goes so far as to offer you his hand and pull you to your feet before hopping back behind the counter top with a pleased look on his face. You feel like you should say something to him, perhaps even thank him but think better of it. You can already see his stern demeanor creeping over him again as his more rational (and irritated) side reasserts itself. After all, you tell yourself, sometimes it's best to let sleeping cats lie.";
	PlayerEat 15;
	PlayerDrink 15;
	NPCSexAftermath Player receives "OralCock" from Augustus Drake;

to say DrakeSex3: [Taur Breeding]
	say "     'Really, after all you've done to me you still think I'd be interested in you in any way?' Drake snarls baring a single saber like fang. 'Actually wait,' he rumbles through a devious grin, 'you know what fine. This body needs to let off some steam and something tells me yours can handle a bit of abuse. Don't think it makes us [']even['] or that I'm going to forgive what you did to me anytime soon. Now get over there,' Drake gestures to the lobby window. 'I don't want you messing up the lobby like you did with my D.N.A.,' Drake commands. Yes daddy, you tease, sauntering up the glass, flaunting your [cunt size desc of Player] cunny for him as you assume the position. 'Don't call me that,' Drake growls in a deep throaty rumble that echoes in his chest as he angles himself behind your animalist hind end. 'Only Kathy and the kittens can call me that. Not YOU or anyone else.' He says, digging his claws into flanks for emphasis.";
	say "     Ep, yes Drake, you stammer, feeling his talon rake the skin of your [bodytype of player] body leaving thin red scratch marks in their wake. 'Better,' Drake snaps, withdrawing a hand to stroke his plump golden sheath as he eyes up your [cunt size desc of player] snatch. 'Now be a useful piece of meat and put on a good show in case the girl's walk by. They've been wanting to see what this beastly body can do to you, so don't disappoint. Oh,' Drake adds as his heft meat spear inches its way out of hiding, 'Just a reminder, if you get knocked up. The kids are your problem, not mine. I don't want any of your feral mutts to know it was me who sired them, we clear?' You nod, telling him your lips are sealed. 'Good, glad we understand one another for once.' Drake chuffs lining up his sizable package with your feral sex. The big cat bucks with all the force of a rutting beast.";
	WaitLineBreak;
	say "     Oh yes, you cry as you're pressed against the glass. You coo with elation at the feeling of his spiny tool splaying your cunny wide. His barbs teasing the eager nerves of your tauric button till he's practically hilted himself in your feral sex. 'Mh, roomy you must be popular with locals.' Drake comments drumming his clawed finger along the inner thigh of your rear legs. 'I bet taurs like you make great cum dumpsters. Must be why you gave up your humanity, to be the best cock sock in town. Can't say I blame you. It must be easy to be a slutty breeding bitch with a body like this.' Drake growls, pistoning his toned hips with enough force to press your upper half against the glass till all your breasts are mashing against the transparent surface. You can't say why but something about his rough treatment has you moaning happily over the sounds of your [SkinName of Player] hide squawking against the glass.";
	say "     The cool chill contrasts with the heat and fury of your leonine suiter as he has his way with your lower half and his fleshy barbs scrape your feral depths. 'Ha, not even going to speak up for yourself!' Drake scoffs as he fondles your [bodytype of player] rear. 'Well if that's the way you want to be treated, I don't mind playing my role. Besides, you can carry my scent out there as you waddle around the city. You can let everyone know who the biggest man on plains is! I bet you'd love that wouldn't you?' Drake simpers. Yes, you trill, delighting in the exotic interplay of Drake blade-like claws skimming your hide and his soft fleshy spines teasing your muff in ways no human ever could. Your display earns you a low chuff from Drake in amusement at your debasement as he tail wraps around your left hind leg. 'Ha, that's right, you're just a few steps away from being a feral yourself and you love it don't you? Not having a care in the world beyond where your next cock or meal is coming from.'";
	WaitLineBreak;
	say "     He rumbles over the lewd sounds of his heavy furry balls slapping against your [bodytype of player] body echo through the room. 'You know,' Drake purrs in a low teasing tone leaning in close to you upper half, 'I see you slutting around the plains. I wonder how many of the mutants you've whelped are out there right now causing chaos. I wonder if it's tens, dozens, hundreds. You've certainly got the capacity for it,' Drake jeer caressing you under belly with his soft paw pads. 'Hopefully this batch of little ones can help keep things stable and undo some of the damage you've caused. Who knows you might even make a few little lion taurs. Besides I bet Kathy and Ava would enjoy the sight of you waddling around with a belly full of kittens.'";
	say "     'Speaking of which, hey Kathy are you here to enjoy the show?' Drake jeers as the portly lioness waddles down the stairs perhaps drawn by the sound of her name being called. As she rounds the bend, a devious smile creeps across her muzzle as catches sight of you two mid coitus. No doubt amused by the spectacle of a tauress being pinned to the reinforced glass window like a cheap whore at a peep show. The lush lioness regards the pair of you with unabashed mirth as she says in a playfully sarcastic tone. 'Oh I didn't know a show was scheduled for today. Drake could you be a dear and hold that pose a moment. I seem to have forgotten my seat.' 'Oh course hun,' Drake chuffs in a loving trill. He then leans over to you and rumbles commandingly in a voice just barely below hearing. 'You heard her,' pressing his claws into your flanks and soft underbelly as Kathy runs upstairs. Nodding, you do as you're told and lock yourself in place despite any indignation you may feel as she vanishes.";
	WaitLineBreak;
	say "     In seconds, you can hear her rummaging around the floor above obviously looking for something. She then returns moments later with a green cloth folding chair wrapped under her arms and sets it up in front of the lobby. After smoothing a few creases, the gravid cat girl seats herself with her legs splayed open and with dramatic flourish of right hand says in a haughty tone. 'You may continue now.' 'Yes ma'am!' Drake snickers as resumes his rough treatment of your feral sex. The man holds nothing back, pounding your flank with all the force of a living gale. He slams your body against the tempered glass till the heat of your body mists the window in near perfect outline of your form. 'Mh, that's right honey fuck that cute piece of taur ass,' Kathy cheers watching your perky [breast size desc of Player] tits glide along window.";
	say "     The shameless lioness eases herself back into her chair, no doubt enjoying the show, and perhaps feeling a little left out. She curls her tail under her taut cub swollen tummy teasing her leonine muff till her tail glistens with fem honey. Though she's not merely content to simply jill herself raw, the portly mother-to-be arches her fifth limb to more ergonomic angle to better bring her dexterous appendage to bear. Kathy slams her sizable sordid limb home. You're almost impressed by how much her body can handle as her sex effortlessly devours over a foot of well lubed tail. You can hear Drake rumble approvingly at her as she bucks her fecund body along the lengths of her sodden limb while her hands drift to her chest as she tweaks her stiff ebony teats between her thumb and pointer finger, coaxing out thick streams of cream from her tits. She eventually brings one to her lips with a hungry look in her eyes as she laps at leaking milk spouts before plopping it into her mouth. ";
	WaitLineBreak;
	say "     She suckles away, purring happily between gulps as she rubs her cute catty paws along the beautifully tawny furry cushioning her tits provocatively as if to stimulate the glands. Not that she needs it, you note, watching her unattended teats leak a small stream down her chest. It's more likely that she's simply doing it for her mate you surmise, listening to the sound of Drake's lustful panting as he watches her go. Stealing a glance behind you, you note his gaze locked on the sight of his horny lover as he abuses your sex like his own personal fleshlight. You can't deny that you aren't enjoying yourself either, each brutal thrust of his spiny spire sends delightful ripples through your animalistic body. A part of you swears you can almost sense each exotic barb innervating your fertile passage and throbbing button. The wonderful feeling mixes well with sensation of Drake's powerful paw like hands massaging your hindlegs and inner thighs stimulating the bestial nerves of your lower half.";
	say "     To your altered mind, each brush of his claw evokes utter primal delight as you feel as if you're being properly bred by a fellow quadruped. Say what you will about his demeanor, but the man knows his way around a tauress. That is to say nothing of the show Kathy is putting on for the two of you. It's almost hypnotic watching her voluptuous body jiggle as she tail-fucks her lush cunny and plays with her hopelessly engorged tits. Her whole body is a sea of bouncing maternal majesty as she rocks her hips in her creaking seat. Rivers of white stream down her tawny chest, and pool at her paws in a slowly growing creamy puddle. The big kitten doesn't seem to mind this in the slightest. If anything, she seems to be enjoying the brief relief as she pinches her stiff ebony nips basting her fur natural bounty. She massages some of the pearlescent fluid into fur like she was taking her own personal milk bath.";
	WaitLineBreak;
	say "     She moans to herself between swallows, 'That's right Draky, take that little slut. The kittens could use some playmates.' Not that Drake hears her. Catching a glimpse of the dopy look on Drake's muzzle reflected in the window, you can tell he's barely even aware of anything beyond his immediate pleasure. You could be a lifeless breeding mount for all the man cares as he pounds your backside. His eyes are locked on his mate's bountiful body as his claws dig into your side. You know that you should feel indignant at being the semi-willing centerpiece of their little game, but a part of you can't deny a certain thrill either. Maybe it is the nanites' influence wreaking havoc on your inhibitions or perhaps it's simply the raw cunt-scrapping you're receiving. Regardless it doesn't diminish your enjoyment as your sex is ravaged by the big cat's onslaught. You feel your walls tighten and quake with each thrust as your satin depth milks your leonine partner's spiny member of all its worth.";
	say "     'Hot damn woman that feels amazing, what mutant taught you how to do that!' Drake rumbles, running a paw along the length of your undercarriage. Even though warning bells blare in your ears, cautioning you against having such a predatory creature touch your soft lower body, you still swoon at the sensation of the tips of his claws caressing your vulnerable area. You find yourself panting lustfully as his strong, clawed hands rake the outline of your tauric passage. His pace never slows even as dick seems to twitch within you like a vibrator on its last legs. He still tries to hold, gritting his teeth as digs his fingers into your sides as if it would somehow stall things. Simple biology wins out in the end though as Drake bellows. 'Fuck I think I'm gonna, gonna-,' his words lost in a primal roar as a potent tremors pass through him as he climaxes.";
	WaitLineBreak;
	say "     You can feel his tapered dick swell and throb with the force of his release, pushing you closer to the edge as he blasts your depths with his virile offering. He still tries to mate though his own orgasm as if he had another round in the chamber. His thrusts get progressively weaker with each passing moment, yet the unusual sensation of his flesh spines and the warm seed pushes you over edge as well. Howling like a tauress possessed into the lobby window, you cry out as sweet relief floods senses like the purest of highs as the big cat's fresh offering of rich cum wallows delightfully in your well-used cunny alongside Drake's gradually softening rod as if you two were tied. The big cat makes no move to extricate himself either, equally content to let his cock retract back into its sheath. Still there is something special about the way the barbs caress your raw sex as they glide across your cum soaked nerves of your tauric clit.";
	say "     Enthralled by the sensation, you paw at your warm, thoroughly distended stomach nestled neatly between your legs. Oddly though, despite your stomach swaying well past your knees, you don't feel that encumbered by the sudden cumflation. You opine it must be one of the perks of being a taur, it's only natural you handle load with a tad more grace than some silly biped. If anything, you take a bit of pride in what your body can handle. You muse as you grope the fecund dome. Maybe it's the gallons of natural antidepressants sloshing around inside you or nanites fiddling with your brain, but a part of you is hoping Drake's swimmers stick. You can only imagine the adorable kitty hybrids you're sure to birth. Plus, you're sure you'd look sexy as hell with taut taur tummies on this body.";
	WaitLineBreak;
	say "     'Hrump, not even knocked up and you're already thinking up baby names aren't you. Damn braindead broodmare,' Drake quips as his harsh voice snaps you back to reality. So what if you are, you counter resting your hands on your flat anthro stomach. You don't expect him to understand how you feel. 'Oh, leave her alone, Draky. Let my girl enjoy the afterglow, I know I am,' Kathy trills from outside as she packs up her now slightly damp chair. 'Yes dear,' Drake mumbles, looking a tad embarrassed as head outside to help her back up the stairs leaving alone to collect your things. By the time he comes back, you're all packed and the man hops back behind the counter waiting to see what you want next.";
	NPCSexAftermath Player receives "PussyFuck" from Augustus Drake;

to say DrakeSex4: [Taur Dom or Death by Snu-Snu!]
	say "     Gazing hungrily at Drake's statuesque physique, you find yourself wondering what it would be like to take such a virile specimen for a ride. Though a part of you knows the big guy won't consent to bottoming for you, not after what you've done to him. Still, strong as he may be, you feel your tauric body will give you an edge if you want to have your way with the hunky lion man. You ruminate as your [bodytype of player] body tenses up delightfully as if it were a bow being drawn at the thought. 'Uh [Name of Player], why in the hell are you looking at me like that? You're not going feral on me are you?' Drake huffs, his slitted eyes narrowing in aggravation as he notices the growing predatory tension in your lower half. Tutting at him, you reply that you were just thinking about something. 'Ugh, what?' Drake grumbles as he unsubtly fiddles with one of the hidden draws behind the counter. Oh nothing, you were just thinking how cute he'd look underneath you, you simper, drumming your toe claws on the floor in an eager tattoo.";
	say "     'Ya, that's not gonna happen, so why don't you-' Drake begins only to have his words die on his lips as you bound over the divide in a single leap. Pouncing upon him with a room shaking thud, you knock him to the floor with your tauric bulk. Before he can react, you pin his arms to the ground with your forelimb, relishing the sight and feeling of the big cat struggling in your grasp like some base prey. 'The fuck is wrong with you kid! Get off!' Drake howls as he thrashes in your grasp. Hm? What was that Draky boi, you tease in a sing-song tone as you press your talons into the vital areas along his wrists. 'I said, GET OFF!' Drake bellows, snapping at lower body with his teeth as if he were a wild beast caught in a trap. Oh, but Drakey boi, you are, and from the feel of it, so is he. You chuckle as you languidly grind your [cunt size desc of player] sex against his toned furry groin, delighting in the sensation of his pelt and plump sheath gracing you [skinname of player] hide.";
	WaitLineBreak;
	say "     'I-I am not,' Drake stammers half-heartedly. Aw, don't be shy, big boi, he likes having a big strong tauress on top, doesn't he? Why, you hear the view is, you pause to smirk at him, to die for, you coo, languidly running your dominant hand along ";
	if Breast size of Player is 0:
		say "the [bodytype of player] curves of your flat chest. ";
	if Breast Size of Player >= 1:
		say "the perky mass of your [breast size desc of player] breasts. ";
	say "While his gently-swelling barbed cock presses against the eager lips of your [cunt size desc of player] cunt. You click your tongue at him, then lean your bendy body over his and trace a few little swirls in the tawny fur of chiseled abs with your claws. Or at least his little friend seems to be enjoying the show, to which Drake only scoffs and glowers as he tries to look away from you. Don't pout kitty, you tease, as draw your talon up his sternum and hooking the tip under his boxy chin. By the time you're done with him, he's going to enjoy this, you taunt lining up your [cunt size desc of player] muff with his turgid prodigious rod.";
	say "     You slam your hips down on his girthy tool, though perhaps with a bit too much force as the big cat gasps like he took a hit to the diaphragm. Not that you care, as your lascivious tauric sex engulfs his throbbing fleshy barbed prick with blissful ease. You rumble with bestial delight at the sensation of each individual spine lavishing your cunt and feral button as you bounce on his lap. Even if the positioning is a little awkward, his exotic barbs almost seem drawn to your most sensitive spots like erotic magnets. Your hands gleefully roam his ripcord pecs, indulging in the tactile dissonance of his silky tawny pelt and hardened muscles as your fingers dance between the chiseled hills and valleys of his herculean core. Though you're careful not to lose your hold on wrists as you drink in the baneful look the supposedly proud lion shoots you as he delectably struggles beneath you, the sight only serving to spur you on as you piston your tauric flanks along his thick meaty member.";
	WaitLineBreak;
	say "     You're absolutely enthralled by the sordid innervation of his tapered throbbing cat cock and the touch of his malleable spines gracing your bestial nethers. The big cat isn't completely immune from this either as he gazes in a spellbound manner at your ";
	if Breast Size of Player is 0:
		say "[bodytype of player] chest dangling ";
	if Breast Size of Player >= 1:
		say "[breast size desc of player] chest wobbling ";
	say "so close to his muzzle. Leering over him, you playfully stroke the crimson highlights of his regal mane like he was your own personal toy. Does kitty want a feel, you tease him, arching your back to better accuntuate your natural assets while you paw at your [breast size desc of Player] chest. 'Y-yes,' Drake croaks in a low, almost defeated tone. What was that kitty? You couldn't hear him, you jeer, cocking your head to one side while tweaking one of your nips between your fingers for show. 'Gr,' he rumbles like a beast straining against the leash, 'yes... Kitty would... like a feel,' Drake says at last, doing his best to not look at you and hide the blushing look on his muzzle.";
	say "     Aw, that's what you thought, you taunt, losing your hold on his arms, though some section of your psyche suspects that he'll try something funny. The big cat impresses you though, as he chuffs in an almost pleased octave as he reaches up with his soft padded hands and lovingly caresses your anthro half's chest. You're nearly caught off guard by the tenderness of his touch as his velvety padded fingers explore your upper body ";
	if Breast Size of Player is 0:
		say "and the [bodytype of player] core of your washboard chest as you ravenously bounce your lower half along the length of on his hefty rod."; [Fucking flat fans, what in the nine sharting layer of ultra hell I'm supposed to do here!]
	if Breast Size of Player >= 1 and Breast Size of Player <= 4:
		say "and petite pillowy [breast size desc of player] chest. Your increasingly eager plaything happily paws at your respectable rack, merrily cupping and lightly fondling sensible-sized tits with his warm satin-furred mitts that fit oh-so-perfectly about your modest assets as you ravenously bounce your lower half along the length of on his hefty rod.";
	if Breast Size of Player >= 5 and Breast Size of Player <= 12:
		say "and lush perky [breast size desc of player] breasts. Your well-motivated Kitty can barely even wrap his hybrid hands around your generously endowed sweater puppies. Not that it stops him from trying, as he lovingly massages the delectable swell of your heaving chest as you ravenously bounce your lower half along the length of on his hefty rod.";
	if Breast Size of Player >= 13 and Breast Size of Player <= 19:
		say "and properly endowed [breast size desc of player] tits. Though your increasingly compliant little kitty fuck toy has no hope of ever getting his paws around your [breast size desc of player] melons, his big strong leonine-like hands still rove your oceanic chest, manically groping decadent paw-fulls of tender tit flesh. As he lavishes your heavenly teats with some much deserved affection, you ravenously bounce your lower half along the length of on his hefty rod.";
	if Breast Size of Player >= 19 and Breast Size of Player <= 25:
		say "and intimidating [breast size desc of player] rack. Your evermore submissive prey's paws explore the elysian expanse of your flawless bust and the poor thing can't resist sinking his eager digits into your soft supple mound, creating a cute set of furrows in the taut skin of your chest. You have to repress a gleeful trill as the tips of his talons tease your sensitive flesh as you ravenously bounce your lower half along the length of on his hefty rod.";
	if Breast Size of Player >= 26:
		say "and gravity defying bosom. Your enraptured morsel can't contain his boundless adoration for your impossibly huge rack as he kneads the blissful bounty of your peerless chest. The big cat barely even has to move as he leans in to worship your massive nips with a loving series of gentle kisses and eager laps of his spiny tongue. Almost purring with mirth, you press your heavy mounds against his toned core so that can he feel the full vibrant weight of your breasts as you ravenously bounce your lower half along the length of on his hefty rod.";
	WaitLineBreak;
	say "     His throbbing tapered tool stretches your tauric sex with its sinfully sweet shape as his beatific barbs roil within your tauric walls in a hedonistic waltz of verboten bliss. A twisted section of your mind can't resist the urge to grope the rapturous bulge his spiny cock makes in the [skinname of player] hide of your lower body with your forelimbs. 'Fuck that feels-,' Drake pants, his amber eyes almost glazing over with bliss as he eagerly bucks his waist in time with the bestial rhythm of your lower half as you toy with the lewd impression of the of his spiky cat cock with one of your forepaws. Good, doesn't it kitten, you titter, leaning over to pet his rugged muzzle and silken ears with the back of your hand. Admit it Kitty, he loves having a nice strong tauress stroke him off with these big soft paws, you coo, raking your dominant [bodyname of player] forelimb along the length of his golden yum gutter.";
	say "     'Yes,' the big cat mewls meekly like an embarrassed school boy while still trying to avoid eye contact. *Fufu* good Kitty, you knew he'd come around, you chuckle in a lewd haughty trill as you trace lazy swirls with the nails of one of your forelimbs in your toy's tawny gold pelt. You clench the powerful muscles of your exotic tauric sex, milking his towering member as a reward for your not-so-little fuck toy. Despite his prior protests, this purported king of beasts purrs like a grateful kitten, as you piston your lower half along the length of his spiny tool. Though a part of you feels like teasing him about his cute little purr, the rapturous sensation of his fleshy spines dandling you bestial button and feral muff like tiny lightening rods of pleasure, along with the tender affection he lavishes upon your [breast size desc of player] chest stills your tongue.";
	WaitLineBreak;
	say "     Besides, your poor little prey looks like it's about to die of embarrassment at any moment if you push it any harder, and you don't want to break your toy. Well, maybe not yet. One day he might earn the right to be collared by you, you think to yourself, sensing a sordid tightness swelling in your core as your body nears climax. And judging by the vacant, yet ever so blissful, expression of the big cat's once stern visage as his tongue lolls happily from his muzzle, he feels the same. Such a good boi, now go on Kitty, cum, and put a nice big litter of lion cubs in here, you titter, rearing up on your hind legs and languidly massaging the delectable bulge that his tapered feline cock makes in your tauric tummy with your forepaws. You revel in the sensation of his throbbing prick lavishing your welcoming passage with heady caress of his fleshy barbs, and the gentleness of his pelt brushing against hind limbs as you jackhammer your lower half against the man's surprisingly durable pelvis.";
	say "     With every delightful motion, you swear you can almost feel Drake's pulse quicken faster like a tooled engine as his sizeable cock exalts your bestial depths. The blissful pressure builds within you as you climax with an animalistic roar that reverberates throughout the room. You roughly slam your lower half on his bruised groin with enough force to elicit a cute pained whimper from your prey as your delightfully throbbing cunny muscle cinches about his meaty member like a tailor fit glove, eager to claim their creamy prize. The sensation proves all too much for your feline fuck toy as, with contented sigh, a heavy shudder passes though him and he cums, hard, unleashing a deluge of toasty tainted seed in your receptive cunny. Luxuriant warmth floods your hybrid being, and a part you can't resist massaging your ballooning belly and exalting in the beautiful sight of your sloshing dome-shaped bump-to-be swelling in your grasp. As litter upon litter of virile spunk packs your tauric middle, the supple curve of your heavily swollen tummy gradually comes to rest comfortably on the big cat's toned fuzzy chest.";
	WaitLineBreak;
	say "     Mh, this is quite the offering big boi, you swoon, giving your warm well-filled middle a loving pat with your forepaws. Say, would the kitty care to touch? You tease, pressing your swollen half against his muzzle and invitingly drum your forepaws along your feral hemline. Purring demurely, the hunky lion man nods, and glides his padded hands along the equator of your distended lower half. Your pacified pet diligently pampers your lower half, drawing delectable soothing circles in your creaking tummy. He leans to give your swollen animalistic middle a tender rub with his whiskered cheeks and a few loving laps of his spined tongue along your sensitive skin that sends heady waves bestial bliss through your core. Aw such a nice Kitty, you jeer, patting him lightly on the head with a forepaw while his lovely little purr echoes about your well-used body as if it were a cute subsonic massage.";
	say "     He really does know to put this body to use, doesn't he? You trill as his sizeable prick slowly slinks back into its plush wrapper with smooth rhythmic beats of his flustered heart. His exotic barbs levy one last hurrah on your sated cunny as they moil your slaked sex, lavishing the sordid tissue with each pulsing quiver. Unwilling to let such a rare sensation, or a drop of the big cat's creamy load pass you by, you constrict your hungry cunt about his tapered tool coaxing the last drops of post-coital bliss from your fuck-numbed plaything's shrinking tool. With a pleasant pop, his cock slips free, though not a single rivet of virile seed escapes your folds. Loosing an almost catty purr, you rear up on your hindleg to show off your gracefully swollen animalistic half and better expose it to your kitty's loving touch. You praise your spent toy for the ride while promising to take good care of your prize. You're sure that they'll ";
	if "Breeding True" is listed in feats of player:
		say "grow up to be some of the cutest lions around.";
	if "They Have Your Eyes" is listed in feats of player:
		say "turn out as a litter of the most beautiful [bodyname of player] baby taurs in town.";
	if "Breeding True" is not listed in feats of player and "They Have Your Eyes" is not listed in feats of player:
		say "come out as an absolutely adorable pack of hybrids.";
	WaitLineBreak;
	say "     Of course, if this load doesn't stick, you can always come back for round two, or three. Bet he'd like that wouldn't he? You taunt him, pressing Drake's head against your well-loved middle. 'Yes,' the big cat mewls with a dumb look on his once imposing visage as he looks up at you and nuzzles his fuzzy boxy chin along the sensuous curves of your cream-filled middle. Good, you inform your temporary toy as you give his regal mane a few playful pets with your forepaws, relishing the power that your exotic body has over him, before releasing your hold. You shove him to the floor like a used sex toy and disentangle yourself from him. Now clean yourself up, and maybe this lobby too, you command, gesturing to his fem-honey-soaked groin then the dirty carpet. You expect him, and this place to be presentable by the time your cubs are due, or you're feeling in the mood again. The big cat merely nods, muttering something about needing a [one of]minute[or]smoke[or]drink[or]ice pack[at random] though you barely pay attention to him as you collect yourself and get ready to leave, or ride him again.";
	NPCSexAftermath Player receives "PussyFuck" from Augustus Drake;
	[now Humanity of Drake is 1;]


Section 4 - Events

Table of GameEventIDs (continued)
Object	Name
World He Inhabits	"World He Inhabits"

Table of WalkInEvents (continued)
Priority	Name	EventObject	EventConditions	EventRoom	LastEncounterTurn	CoolDownTurns	EncounterPercentage
2	"World He Inhabits"	World He Inhabits	"[EventConditions_World_He_Inhabits]"	Sniper's Perch	2500	2	100

to say EventConditions_World_He_Inhabits:
	if HP of Augustus Drake < 99 and HP of Kathy >= 1 and HP of Ava >= 1:
		now CurrentWalkinEvent_ConditionsMet is true;

World He Inhabits is a situation.
ResolveFunction of World He Inhabits is "[ResolveEvent WorldHeInhabits]".
Sarea of World He Inhabits is "Nowhere".

to say ResolveEvent WorldHeInhabits:
	say "     Walking along the edges of Drake's perch, you pause to take a moment and admire the view. Despite all the chaos and destruction of the nanite apocalypse, the plains still possess a natural albeit dissonant beauty to it. The golden grass swaying in the breeze, like a sea of rippling metal growing over human artifice, reminds you of famous semi-abandoned spaces like Centralia or some of the superfund sites in the states. Perhaps, The Last Chance will join them one day, another abandoned ruin cloaked in a vibrant green that belies its hostility towards human life. You muse, tilting your head letting the wind wash over you as in soak the vista and blood red peaks of Mt. Shirley off in the distance. Lost in your simple reverie, you don't even notice Drake scaling the ladder. His muffled steps are so akin to a light breeze upon a still moonlit pond, you don't even realize he's there till he's standing right behind. 'Enjoying the sights?' he quips, giving you a start as you whip about to face him, your arms raised ready for a fight.";
	say "     Locking eyes with him, you almost scream at him not to creep up on people like that. Drake merely shrugs in response saying, 'Eh, sorry [']bout that, it's a bit of a habit I picked up. It's a lot easier to deal with mutants if they don't know you're there.' You agree that that's true enough, but he should be a little more careful about who he sneaks up on in future. 'Fair, still you see anything interesting out there though?' You tell him no, but also ask why you don't see him up here more? The weather is nice, and the view is a heck of lot better than in some stuffy lobby. 'Well for starters, the girls don't like me smoking up here. They say the smell gets everywhere and irritates their noses.' Bobbing your head, you inquire about the other reason. 'I hate what I see up here nowadays.' Drake spits rather bluntly. Curious, you gesture for him to elaborate. 'Hmm,' Drake grumbles thoughtfully, tapping his chin, then unslings his rifle, 'I think it's easier to show ya.'";
	WaitLineBreak;
	say "     'One sec,' he says bringing the scope to his eye. He scans the horizon looking for who knows what. Seconds pass before Drake finds what he is searching for, 'Tck, there they are,' Drake says, clicking his tongue as he lowers his weapon. 'Here kid, take this, stand here,' Drake taps the roof with his boot, 'between the south and west flags, then look straight ahead,' Drake continues passing his rifle to you. Shrugging, you do as he instructs, taking the heavy weapon in hand. You march into position and bring the thing to the side of your face. You can still sense the lingering heat of his person and the conflicting scents of black powder and fragrant smoke coiling about the rifle. As you stare down the barrel, you're about to ask Drake what you should be looking for when the scope passes over two unaltered (to your eyes) Caucasians seated together by a poorly camouflaged tent couched in the ruins of a broken down concrete building.";
	say "     One is a brown haired male dressed in jeans and black T-shirt, the other, a red headed female is wearing gray khakis and a low cut red shirt. Casting a glance at Drake out of the corner of your eye, you ask him what's so special about two uninfected humans. 'They're not, well at least the man isn't. You can't see it right now, but he's got the beginnings of a centaur infection, it won't be long till he turns and probably tries to turn her.' Your interest piqued, you ask him how he knows this. 'I saw him make it with one of the fillies out there, it didn't affect him at first but everyday a little more hair spreads down his back. In a couple of days, I imagine he'll probably start growing a tail or something... then it's only a matter of time.' You tell him that that sounds horrible and that he should do something. 'That's a shit idea, look in the overgrowth behind them, you'll see why,' Drake says, his pupils twitching and narrowing as he points to a patch of scrub brush ";
	if "Touched by Madness" is listed in feats of Player:
		say "a hundred or so meters ";
	else:
		say "several hundred feet ";
	say "behind the pair. Training the scope on it, you spy a half dozen horse men hiding in the foliage.";
	WaitLineBreak;
	say "     From what you recall, these mutants have a habit of abducting people, and are likely waiting for their chance to nab these two. 'Ah, you know about them don't you?' Drake asks, seeing the light of recognition in your eyes. You nod. 'I don't know why they do what they do. I've heard rumors of a sex slave operation run by a [']nightmare.['] Not sure what kind of nightmare though, could be the mythological, or the dream kind for all I know. Maybe these guys work for that thing, perhaps they're copycats,' he shrugs. 'Still, they've been shadowing those two for days.' Curious, you ask why they haven't attacked yet. 'Pure humans are rare, I think they know the guy is on borrowed time. If they pushed him he might turn quicker, or infect the lady. Seen it happen a few times in the field. [italic type]never a fun sight[roman type],' Drake says, though he whispers the part under his breath. 'Those things tend to be cowards too, they're afraid of centaurs and anything larger or vicious than them so they'll wait as long as they can. Course, if they think their game is threatened, they might find the balls to rush'em.";
	say "     Want to do something about it, [Name of player]? I won't stop you if you want to cut in,' he says, stepping under the shadow of his pillbox. A good question, what do you do? With this gun you could easily take down the horse men, or at the very least definitely scatter them, as for the humans. Bullets wouldn't fix things in the long term. You can't save the man anyways, but there is always the chance he might not go feral when he turns. Who knows? The pair might even be happier as centaurs, and at least they'd have a better odds of surviving out here that way. The last option is to do nothing, and let cards fall where they may. This isn't your burden to bear. ";
	if "Touched by Madness" is listed in feats of Player:
		say "After all, the greatest rewards in life come from the personal struggle, to take this challenge from them would only cheapens their lives.";
	else:
		say "If they are to survive, they do so on their own, just as you have.";
	LineBreak;
	say "     [bold type] What do you want to do kid? [roman type][line break]";
	let The_world_he_inhabits_Choices be a list of text;
	add "Take aim at the Horseman." to The_world_he_inhabits_Choices;
	add "Nothing." to The_world_he_inhabits_Choices;
	let The_world_he_inhabits_Choice be what the player chooses from The_world_he_inhabits_Choices;
	if The_world_he_inhabits_Choice is:
		-- "Take aim at the Horseman.":
			say "     You've made up your mind, training the gun on your target. A moment's doubt plays across your mind. What if you're going about this all wrong, a part you asks, but you ignore it. You don't know if there is a better alternative, but it's better to act, to try to help in whatever way you can, than to sit by. Even if it's a tiny thing, little differences add up, at least that's the excuse you tell yourself. As your finger rests heavily on the trigger. It only takes one squeeze and you're done, one squeeze and these people will be safe another day. You tell yourself training the scope on your target's head, just one squeeze, and [italic type]*click*, *click*, *click*.[roman type] Muttering in frustration under your breath, you repeatedly tug on the trigger, though the gun refuses to fire. Glancing at the magazine port, you notice with a small amount of relief it's empty. 'Looking for this?' Drake asks, juggling a magazine in his hand. You nod and ask him to pass the ammo. 'No kid, I don't think so.'";
			say "     Annoyed, you ask him why not he said he wouldn't stop you. 'Because I wanted to know what you would do, and what it's like to be in my position,' Drake says, padding up to you. He extends his hand gesturing for you to return his gun. Groaning, you begrudgingly pass it back while asking what he means. 'Everyday since the outbreak started, I see stories like this play out, over and over. Sometimes it ends well, other times it doesn't. If I got involved with each one, shed a tear for everyone lost, I'd never get anything done.' Shrugging, you tell him so what, at least he'd be doing something not sitting around here like a miserly dragon squatting on its hoard. 'You're not wrong, if I wanted to. I could try forcing my own little version of law and my order over the plains. But that's not something I can sustain, physically or mentally. Once I run out of ammo, or piss off enough of the smarter mutants, I could easily be overrun.'";
			WaitLineBreak;
			say "     'Right now, keeping this Lonesome stretch of Road safe is all I can do. I don't want The Divide between here and the city growing any wider.' He motions to the blacktop in the distance. 'I know it sounds grim, apathetic even, but I don't claim to know what's best for this place. I don't want that responsibility. So the best thing for me to do right now, hard as it is, is nothing.' Drake sighs. 'Shit this is getting depressing, I need a dab or maybe a drink, see you around kid, and don't fall off the roof now. My insurance premiums are high enough as it is,' he quips as he makes way back down the ladder. Before he can make it to the first rung though, you feel a question burning in the back of your mind and without meaning to, you ask, why? The simple, potent, yet vexing word stops Drake mid step as he looks at you queerly, saying, 'Why what?' Why, you ask, did he save Kathy, or take in Ava if he is so content to let sleeping dogs lie? 'Ya about that,' Drake inhales sharply and deeply.";
			say "     'She well... she looks a lot like an old cat, Miss Mittens.' Drake answers. Really, and that's the only reason why he saved her? No other reason, you respond, doing your best to suppress your bemusement. Drake bobs his head and gestures for you to wait as he fishes something out of his pants pockets. 'Here, take a look at the pictures, if you don't believe me,' Drake says, pulling out a very faded brown leather wallet. Flipping it open, he passes it over to you. As you inspect the collection of old cat photos wedged between a lifetime pass to Yosemite from something called: The Mountain Cat Preservation Association. You note much to your surprise, he wasn't lying. His old cat's fur and portly nature looked a lot like a tiny tubby lion. Curious as to her breed you ask Drake what kind of cat she was. Flipping through a few more photos, Drake tells you that unfortunately he doesn't know.";
			WaitLineBreak;
			say "     Much to his regret, his parents had the cat spayed when he was younger, and refused to get any genetic testing done. He realizes now it was because they suspected she was an exotic, and didn't want her taken away. He even points out a few features not seen on domestic cats in a few pics like the tufts on her ears, or her webbed toes that backs up his theory. You also realize from the dates written on the back of each picture that she was alive till 1995 as the last photo shows a slightly slimmer and somber looking Drake laying a bouquet of California Poppies laced together with purple Catmint flowers next to a hand painted wooden tombstone dated 1970-1995 surrounded by serpentine, beach glass, and garnet. Beside him, are two other people. One is a shapely five foot six woman with long black hair who appears to be a mix of Polynesian and Greek descent covered in small bandage strips and old scars. She appears to be wearing low cut blue jean shorts, a black T-shirt, and brown leather sandals. Adjacent to her is a hefty person of Caucasian lineage.";
			say "     You'd put them at about six feet tall with a shaved bald head dressed in black leather biker pants, a white long sleeve shirt, heavy black hiking boots, with a matching black leather button up jacket tied to their waist. Thanks to their size, and haircut you can't tell what gender they are though. Well, you stand corrected, and politely tell him as much. You honestly did not expect that given what you've seen in the city. 'What, did you think I rescued her because I wanted a horny cat-girl for a wife or something?' Well, she is knocked up with his kids, you reason but Drake talks over you, saying, 'Nah kid, she just reminded me of my old cat. Seeing her in trouble just brought back a lot of bad memories. That things have *ahem*,' Drake blushes, coughing into his hand, 'evolved from there is a different story. I don't expect you to believe me, but being with her makes me happier than I've ever been in years,' Drake beams.";
			WaitLineBreak;
			say "     'We can talk for hours, and it feels like Ol['] Blue Eyes is singing for us just for us. When we're apart the world feels so gray, quiet, and empty. And despite what you may think of her, Kathy is a lot smarter than she lets on. I think she could probably pass the G.E.D test soon. She has this amazing ability to cut to the heart of things and see past a lot of human B.S. Honestly, I'd love to introduce her to some of my old professors in the Anthropology department at U.C. Berkeley. They'd kill to hear some of the observations she'd made from behind bars. I just wish I could get her out of here soon. I don't know why, but I feel there is something in the air here making everything a bit too randy.' You ask Drake to elaborate what does he mean by [']something in the air['], is he referring to the nanites? 'I don't know, maybe. I have a ten-twenty year old M.A in business with a minor in Ethics, not science, so fuck if I know. All I can say for certain is the further away I get from the city, the clearer my head is.'";
			say "     'I just hope it's the same for the girls... They have the potential to be so much more than horny breeders or rabid predators. I don't want to see their pure sparks wasted or twisted by this world,' Drake sighs mournfully. Shrugging, you ask him why he took Ava in then. 'Kathy took a liking to her, and after I heard her story I couldn't turn her away. Can you imagine what it must have been like for her to wander the city barely even a day old looking for the parents that abandoned her? The only creature's she could consider her 'people' calling her a freak just because she's a little different. I know it's probably a common story nowadays, so I shouldn't let it get to me. But when it's staring you in the face, begging for help, and just a little bit of love and understanding.' Drake pauses and casts a sad look at the garage. 'It's too hard to ignore, and if I can be perfectly candid with you kid. I honestly don't know how she made it on her own for so long. Leaving her out there just felt so, cruel.'";
			WaitLineBreak;
			say "     'I've also seen her survival skills, and well, they are, or were nonexistent. Good thing the nanites take care of a lot of the parasites and what not out there. She'd probably have died from untreated water, spoiled food, or an infected wound a long time ago. Besides,' Drake grins proudly, 'trying to teach her the how's and why's of things has been... nice. Something about watching her learn, seeing her struggle with a problem, and being there for her in those moments things finally click. It makes me feel a bit better about the future,' Drake opines as he crosses his arm and stares briefly at the open sky. 'It's been good practice for when the kittens come due to. Ava might not know it, but she's really taught me a lot without even trying. No matter what happens, I will always be grateful to her for that gift. Anyways, take care kid,' Drake replies as he makes his way down the roof, leaving you to your thoughts.";
			now World He Inhabits is resolved;
		-- "Nothing.":
			say "     Shaking your head, you shoulder Drake's weapon. There's nothing you can do here. You can't save everyone after all. 'Hhm, not going to do anything kid?' You tell him, no, those people are on their own. 'Really why's that? Don't young people love to butt in and make a difference nowadays? Be the change you want to see and all that?' Drake scoffs. Refusing to rise to his obvious bait, you inform Drake that there's nothing you can do that will fix the underlying problem, that being the rogue nanites. No matter how many mutants you pacify, people you save, until a cure or way to contain it is found all you're doing is rearranging the deck chairs on the Titanic to make yourself feel better. That said, you won't turn your back to those in need when you can provide meaningful help, but this isn't one of those times. 'Then you can see why I hate it up here now?'";
			say "     You nod, telling him you can imagine watching things day after day can slowly wear away at a person. Never really feeling like you're able to do anything about it other than impotently firing off a few rounds in defiance of the status quo. 'Ya, but it's not all doom and gloom kid. Take a look way behind those horses and towards the military's lines. You might like what you see.' Drake counters with a rare smile on his face as his eyes seem to narrow. Shrugging, you return to your rifleman's stance and draw a bead. ";
			if "Touched by Madness" is listed in feats of Player:
				say "Meters drop ";
			else:
				say "The distance drops ";
			say "away in a washed out blur as your scope crawls over the terrain and you're not sure what Drake even wants you to see till your gaze wanders over the outlines of a pack of behemoths stalking through the remains of a large cattle barn. Judging by their direction, you surmise the gathering of mutants is headed right for the horsemen. Factoring in their posture, and the way the lead mutant seems to sniff the air every couple of steps.";
			WaitLineBreak;
			say "     It's safe to assume that they're hunting. If not the equines specifically, then something nearby them. It won't be long until the two large groups bump into one another without your intervention. 'Ah, you see the behemoths now don't you?' You nod. 'Looks like they're almost on top of the horsemen.' Drake says as you monitor their progress, and internally cheer the beasts on. If anyone deserved to be hunted, it's definitely slavers, you muse. That said, how did he know they were there, you query, handing Drake back his anti-material rifle. 'The new eyes are a lot better than I'd like to give them credit for,' Drake replies, tapping his zygomatic arch. 'Still, I wish I had the old ones back. I know there's power in nanite transformation but,' Drake tilts his head back briefly dipping his face in shadow cast by his own hair, remarking somberly.";
			say "     'That strength... is ugly. Besides,' Drake says in a forced joking tone, 'these are way too motion sensitive. It makes it really hard to keep eye contact during conversations when a leaf could rustle just a hair and suddenly my brain locks onto it like I'm a goddamn dog with a ball.' Nodding, you tell him that does sound like it could get a little annoying. 'You don't know the half of it, getting used to it though, who knows they might save my ass one day,' Drake says, shrugging. 'Anyways, it was nice talking to ya [Name of Player] and all but, I'm gonna get going now. Don't stay out here too long now, or if you do stay under the pillbox roof. You never know when a flier might swoop down. Most of them know better when I'm up here, but, eh, no point in taking chances.' Drake adds offhandedly as he heads back down the ladder.";
			now World He Inhabits is resolved;


Table of GameEventIDs (continued)
Object	Name
Doctor will see you now	"Doctor will see you now"

Table of WalkInEvents (continued)
Priority	Name	EventObject	EventConditions	EventRoom	LastEncounterTurn	CoolDownTurns	EncounterPercentage
2	"Doctor will see you now"	Doctor will see you now	"[EventConditions_Doctor_will_see_you_now]"	Doctor's Office	2500	2	100

to say EventConditions_Doctor_will_see_you_now:
	if HP of Augustus Drake is 5:
		now CurrentWalkinEvent_ConditionsMet is true;

Doctor will see you now is a situation.
ResolveFunction of Doctor will see you now is "[ResolveEvent Doctor will see you now]".
Sarea of Doctor will see you now is "Nowhere".

to say ResolveEvent Doctor will see you now:
	say "     Remembering the list that Drake gave you, you ask Dr. Medea if by any chance she'd be willing to help you locate a few medical items. 'I can't see the harm, may I see the list?' she replies. Nodding, you hand her the note. 'Hm, you don't need this, we're out of those... there hasn't been an outbreak of that since the 1970's, that spoiled after the power went out,' Medea says, bobbing her head and clicking the talons of her paws in pace with each item. 'This is quite the request, not an entirely unreasonable one, but are you sure you need these? You appear fine.' Medea says with a note of concern in her voice as she takes out her instruments. Waving her off, you tell Medea the items aren't for you specifically.";
	say "     'I see. You're getting these for [']a friend['] I take it?' she asks in a tone that sounds like she's heard this story many times before. You tell her that that's the case, more or less. 'Ah, would you mind telling me a little bit about the prospective patient then?' Bobbing your head, you inform Medea of Kathy's rather extreme pregnancy, noting how Augustus fears her small stature could lead to labor complications. 'Oh my,' Medea coos, not even trying to hide her interest as she starts probing you for further details about Kathy's swollen kitty factory. Very few of her questions seem to have medical benefits like what does her belly fur feel like, how deep can you push your hand into her pelt, did you see cat paws or human digits when she's quickening. Sighing, you step around Medea's lewder question and stick to facts, much to her dismay.";
	WaitLineBreak;
	say "     When you wrap up your exposition, Medea clicks her reptilian tongue thoughtfully and says, 'I see then why, what did you call him? Augustus Drake? Hm, someone's parents were romaphiles, would be worried. Thankfully the nanite infection seems to handle many of the issues typically associated with childbirth, but I can safely assume you already know this, correct?' You nod. 'So you can safely tell Mr. and Mrs. Drake they don't have anything to worry about. Still,' Medea flips through the notepad again while tapping a clawed toe on the floor. 'I can't in good conscience argue against having some sterile equipment on hand. Give me a moment and I'll see what I can do,' she says, digging through her office. About a minute later, she packs up a little to go bag for you.";
	say "     'Here,' Medea says, plopping it in your hands. 'I don't know if the gloves will fit him, most of the staff here are or were women, but other than that, this should be all he needs. Should Mr. or Mrs. Drake have any further questions, I've included my card along with a few booklets for parents choosing to have their children at home. They probably won't need it though. Lastly, I've included a few pamphlets with advice for new fathers dealing with anxiety that Mr. Drake may find useful.' Curious, you ask why she thinks he needs them. 'Well for starters, I can tell that Mr. Drake wrote this list without talking with his partner. From what you've told Mrs. Drake seems more than comfortable with her condition. Believe it or not, I've seen just as many men, if not more, worry about their partner's pregnancy more than the birthing person.";
	WaitLineBreak;
	say "     'Most do their best not to let it show, but trust me, most guys don't know how to handle situations they have no control or influence over. They would rather worry themselves to an early grave, lash out at others, or turn to substance abuse than admit how they feel helpless,' Medea says, depositing the care package into your waiting mitts. You ask her why she thinks this is the case. 'Eh, handwriting on the note, and most birthing persons don't ask for tourniquets, bone saws and,' Medea pauses to pull up the list you handed her. 'Quote, [']those little syringe things filled with that special gauze the military uses to plug bullet wounds['] to assist in the birthing process.' She smirks. 'Usually it goes something along the lines of epidural-epidural-epidural, oxycontin, morphine, fentanyl, and the like,' Medea jokes. 'Oh, and please do pass on my best wishes to the expectant couple.'";
	now HP of Augustus Drake is 6;
	now Doctor will see you now is resolved;


Table of GameEventIDs (continued)
Object	Name
Angry Wateringcan	"Angry Wateringcan"

Table of WalkInEvents (continued)
Priority	Name	EventObject	EventConditions	EventRoom	LastEncounterTurn	CoolDownTurns	EncounterPercentage
2	"Angry Wateringcan"	Angry Wateringcan	"[EventConditions_Angry_Wateringcan]"	Last Chance Parking Lot	2500	2	100

to say EventConditions_Angry_Wateringcan:
	if HP of Augustus Drake is 99:
		now CurrentWalkinEvent_ConditionsMet is true;

Angry Wateringcan is a situation.
ResolveFunction of Angry Wateringcan is "[ResolveEvent Angry Wateringcan]".
Sarea of Angry Wateringcan is "Nowhere".
Angry Wateringcan is inactive.

to say ResolveEvent Angry Wateringcan:
	say "     Upon arriving at the outskirts of the Last Chance, you immediately spy the shadow of Drake's anti-material set up atop the Chance's roof top pillbox. As you're about to hail him, Augustus roars. 'You! Around the front! Now!' pointing his rifle at you for emphasis. Nervous, you begin backing away, telling Drake not to do anything rash. Yet, you don't get more than a few steps away before Drake fires an explosive round into pavement behind you, showering you in asphalt. 'I won't miss on purpose next time, so get your ass over here!' Drake shouts from behind cover. Sighing in defeat, you schlep on over to the gate. Once you're there, Drake, his tank killer still trained on you, steps out of the pillbox at last revealing his new Felinoid form. Reshaped by the nanites, Drake's already impressive frame has grown to a solid seven feet. Unfortunately for him, this new found bulk prohibits the use of his old clothes, forcing him to walk around in the buff.";
	say "     His face has become incredibly bestial with almost nonexistent black lips, a blunted dark nose, and the proud jaw line of a hardened patriarchal lion. An exotic mane grows around his neck consisting of burnished golden base and tipped with a bright sanguine that bears an uncanny resemblance to freshly spilled blood. Looking at his extremities, you notice Drake's paws and the end of his tail also share this bizarre trait. As your gaze drifts south, you inadvertently get an eye full of Augustus's flaccid feline package. While his cock is nothing you would write home about (probably because he's not happy to see you). Drake's sheath is over two inches thick and three inches long. His fuzzy balls on the other hand, or hands in this case, are comparable in scale to a pair of colossal Texas grapefruits.";
	WaitLineBreak;
	say "     How does he even sit down with those? You wonder as Drake leaps from the top of the Chance and lands without a sound on his digitigrade pads. Unfazed by the impact, he strides over to the gate then unlocks it, but never once does he take his baneful eyes off you. 'Come on,' he grunts, ushering you at the point of a gun up the ladder leading to the flat red tiled roof of the Last Chance. 'Alright kid, before I decide what to do with you,' Drake says, marching you over to his sandbag pillbox. [bold type]'I want to know something, WHY IN THE FUCK DID YOU DO THIS TO ME!'[roman type]";
	LineBreak;
	say "     [bold type]How do you respond?[roman type] [line break]";
	let justifying_your_actions_Choices be a list of text;
	add "Kathy asked you to." to justifying_your_actions_Choices; [Pass the blame]
	add "You thought he'd like being a furry." to justifying_your_actions_Choices; [Mind theory is a myth anyways]
	add "You wanted to fuck Kathy, and this was the best way to do it." to justifying_your_actions_Choices; [Ok, now you're just trying to piss him off aren't you?]
	add "You wanted to fuck him." to justifying_your_actions_Choices; [This is a very bad idea.]
	let justifying_your_actions_Choice be what the player chooses from justifying_your_actions_Choices;
	if justifying_your_actions_Choice is:
		-- "Kathy asked you to.":
			say "     'That's it!? God damn it kid, how stupid are you? She barely understands how IDs or bank accounts work. Why in the hell would you listen to her?' Drake roars, grabbing you by the collar in a brutal one-handed choke hold. 'Did you never once think about how I felt, or why I didn't want to change in the first place?' Augustus raves as he punches your sternum. 'Huh, well did you?' He snaps, hurling you across the roof. You hit the tile in a prone position, and Augustus pads over you, hooking his rifle under your chin. He forces you to look him in the eyes saying. 'But you know what,' Drake says, grinding the muzzle of his rifle painfully against your throat. 'That's not what really pisses me off. What really makes me want to gut you is what you've done to my kids.' Confused, you ask what he means. 'Think about it for a second. Before you did this to me. I could have at least passed for a normal human. Sure, I might have needed contacts, and some cologne, but now look at me,' Drake growls pointing at his feral visage.";
			say "     'I am a giant anthropomorphic lion with balls the size of honeydew melons. Do think it will be easy for me to get a job looking like this, cause I fucking doubt it. And if you haven't noticed, The Chance is basically a total loss at this point. I have my whole financial life tied up in it. If I can't get my insurance payout on this in a timely fashion. I will lose my house, my car, everything my brother and I worked for. Because you just [bold type]had[roman type] to stick your nose where it doesn't belong!' he bellows, as his pupils constrict into paper thin slits. 'We were doing fine before you showed up. I was even starting to feel better than I had in years. I finally had something to look forward to. For the first time, I had reason to live beyond just surviving.'";
			WaitLineBreak;
			say "     'Now,' he shakes his head, 'all I can think of is the fact that my kids could spend the first few years of their life homeless because of you! That I've failed them before they're even born!' Drake roars, while steam coils from the sides of his bestial visage and his whole body shudders with barely controlled rage. 'I'm not even sure I can afford to take care of Ava and Kathy like this! You, did you even consider that moment you dumb fuck! Goddamn it, I should kill right now, feral. No one would care, no one would mourn you, and I'd sleep real damn well at night for the rest of my life knowing I did the world a huge favor,' Drake fumes, as his pointer finger twitches along the edge of the trigger.";
			LineBreak;
			say "     [bold type] What do you want to do Beg his forgiveness or fight him?[roman type][line break]";
			LineBreak;
			let Hobson's_choice_V1_Choices be a list of text;
			add "Beg his forgiveness." to Hobson's_choice_V1_Choices;
			add "Fight him." to Hobson's_choice_V1_Choices;
			let Hobson's_choice_V1_Choice be what the player chooses from Hobson's_choice_V1_Choices;
			if Hobson's_choice_V1_Choice is:
				-- "Beg his forgiveness.":
					say "     If only for the sake of self-preservation, you put on your most sincere face then plead with Drake, telling him that you're sorry, and not to do anything rash. 'You think I'll let this slide just because you apologized, you pathetic piece of shit?' Drake rages, shoving the barrel of his rifle under your chin, forcing you to stand. 'How is an [']I am sorry['] going to keep food on the table, or pay for my kids['] education?' Looking Drake hard in the eye, you tell him it won't. Nothing you say will, but becoming a murderer isn't going to help them either. 'Fuck,' Drake sighs lowering his anti-material rifle, 'get out of my sight.' Drake waves his rifle towards the gate, 'I have some thinking to do,' he says jumping from the roof of the Last Chance and heading into the lobby.";
					move player to Last Chance Parking Lot;
				-- "Fight him.":
					say "     Enraged by Drake's arrogance, since who the hell is he to demand anything of someone like you? You make a grab for the rifle angling to teach this guy a lesson. 'Idiot,' Augustus snaps, spearing your windpipe with the end of his gun before your hands can even move from their original position. Reeling from the force of the blow, you collapse gasping for air. 'You're lucky I don't think you're worth cleaning up after,' he says kicking you off the edge of the roof, letting you fall two stories onto the solid concrete below, then leaps down after you. 'Otherwise, I'd have killed you on the side of the road like the rabid animal you are,' Drake continues, dragging you by the neck out of The Last Chance. 'Now get out of here feral. And don't ever let me see you coming near this place again, or mark my words. I! Will! End! You!' He concludes sealing the Last Chance off, exiling you to the plains.";
					move Player to Dry Plains;
					now Last Chance Parking Lot is unknown;
		-- "You thought he'd like being a furry.":
			say "     'You thought I'd be happy like this you son of bitch. Do you have any idea how fucked up this body is?' he bellows, clasping hold of your throat and hefting you off your feet. 'I can't piss or shit without making a mess. My whole body itches all damn time like I am covered in unwashed beard hair. Hell, I can't go an hour without pulling fur out of my mouth or biting my tongue. And last night I nearly set myself on fire sparking up my camping stove! Do you have any idea how lucky it is I didn't burn this whole fucking place down?' Augustus rants, throwing you over his shoulder. As you hit the tile in a prone position, he pads over you, hooking his rifle under your chin. 'But you know what,' Drake says, grinding the muzzle of his rifle against your throat.";
			say "     'That's not what really pisses me off. What really makes me want to gut you is what you've done to my kids.' Confused, you ask what he means. 'Think about it for a second. Before you did this to me, I could have at least passed for a normal human. Sure, I might have needed contacts and some cologne, but now look at me,' Drake growls pointing at his feral visage. 'I am a giant anthropomorphic lion with balls the size of honeydew melons. Do think it will be easy for me to get a job looking like this? Or how this will impact the benefits my children are supposed to receive? What if people doubt I am actually Augustus Drake and I can't access my bank accounts, lose my house, or can't get access to my health insurance? What then asshole? Are you going to pay for my kid's healthcare?' Drake fumes.";
			LineBreak;
			say "     [bold type] What do you want to do Beg his forgiveness or fight him?[roman type][line break]";
			let Hobson's_choice_V2_Choices be a list of text;
			add "Beg his forgiveness." to Hobson's_choice_V2_Choices;
			add "Fight him." to Hobson's_choice_V2_Choices;
			let Hobson's_choice_V2_Choice be what the player chooses from Hobson's_choice_V2_Choices;
			if Hobson's_choice_V2_Choice is:
				-- "Beg his forgiveness.":
					say "     If only for the sake of self-preservation, you put on your most sincere face then plead with Drake, telling him that you're sorry, and not to do anything rash. 'You think I'll let this slide just because you apologized, you pathetic piece of shit?' Drake rages, shoving the barrel of his rifle under your chin, forcing you to stand. 'How is an [']I am sorry['] going to keep food on the table, or pay for my kids['] education?' Looking Drake hard in the eye, you tell him it won't. Nothing you say will, but becoming a murderer isn't going to help them either. 'Fuck,' Drake sighs lowering his anti-material rifle, 'get out of my sight.' Drake waves his rifle towards the gate. 'I have some thinking to do,' he says jumping from the roof of the Last Chance and heading into the lobby.";
					move player to Last Chance Parking Lot;
				-- "Fight him.":
					say "     Enraged by Drake's arrogance, since who the hell is he to demand anything of someone like you? You make a grab for the rifle angling to teach this guy a lesson. 'Idiot,' Augustus snaps, spearing your windpipe with the end of his gun before your hands can even move from their original position. Reeling from the force of the blow, you collapse gasping for air. 'You're lucky I don't think you're worth cleaning up after,' he says, kicking you off the edge of the roof, letting you fall two stories onto the solid concrete below, then leaps down after you. 'Otherwise, I'd have killed you on the side of the road like the rabid animal you are,' Drake continues, dragging you by the neck out of The Last Chance. 'Now get out of here feral. And don't ever let me see you coming near this place again, or mark my words. I! Will! End! You!' He concludes sealing the Last Chance off, exiling you to the plains.";
					move Player to Dry Plains;
					now Last Chance Parking Lot is unknown;
		-- "You wanted to fuck Kathy, and this was the best way to do it.":
			say "     'You wanted to do what to her?!' he yells, delivering a swift kick to your gut, knocking you back against the pillbox. 'You gormless inbred little shit stain,' Drake raves, his face contorted with hate as he digs his claws into your head. He hefts you off your feet, and punches you square in the solar plexus. 'How dare, how fucking dare you, think about touching MY KATHY,' he spits chucking you to the other end of the roof. As you hit the tile in a prone position, Augustus pads over you, hooking his rifle under your chin, so that you're forced to meet his baneful gaze, saying. 'But you know what,' Drake snarls, grinding the muzzle of his rifle against your throat. 'That's not what really pisses me off. What really makes me want to gut you is what you've done to my kids.' Confused, you ask what he means. 'Think about it for a second. Before you did this to me, I could have at least passed for a normal human. Sure, I might have needed contacts and some cologne, but now look at me,' Drake growls pointing at his feral visage.";
			say "     'I am a giant anthropomorphic lion with balls the size of honeydew melons. Do you really think people will believe me when I tell them I'm Augustus Drake! Think about it. Every fucking scammer and their grandmother is try to hoover up every identity they can get their shitty little claws on. It may take years, decades even to resolve who is who, and during that time, my kids, my [bold type]family[roman type] could be on the streets, living as fucking bums all because you wanted to FUCK MY KATHY!' Drake spits, his face twisting into bestial snarl. 'All I want is to be a good man for Kathy, and a good father for Ava and the cubs. But you...' Drake shakes his bestial head. 'You couldn't just let us be. We-we were happy. I was happy for the first time in years before you fumbled into our lives. Now, all I want to do is break you. And when I'm done. I might go to the Grey Abbey and burn everything you've touched for what you've done,' Drake raves.";
			LineBreak;
			say "     [bold type] What do you want to do Beg his forgiveness or fight him?[roman type][line break]";
			let Hobson's_choice_V3_Choices be a list of text;
			add "Beg his forgiveness." to Hobson's_choice_V3_Choices;
			add "Fight him." to Hobson's_choice_V3_Choices;
			let Hobson's_choice_V3_Choice be what the player chooses from Hobson's_choice_V3_Choices;
			if Hobson's_choice_V3_Choice is:
				-- "Beg his forgiveness.":
					say "     If only for the sake of self-preservation, you put on your most sincere face then plead with Drake, telling him that you're sorry, and not to do anything rash. 'You think I'll let this slide just because you apologized, you pathetic piece of shit?' Drake rages, shoving the barrel of his rifle under your chin, forcing you to stand. 'How is an [']I am sorry['] going to keep food on the table, or pay for my kids['] education?' Looking Drake hard in the eye, you tell him it won't. Nothing you say will, but becoming a murderer isn't going to help them either. 'Fuck,' Drake sighs lowering his anti-material rifle, 'get out of my sight.' Drake waves his rifle towards the gate. 'I have some thinking to do,' he says jumping from the roof of The Last Chance and heading into the lobby.";
					move player to Last Chance Parking Lot;
				-- "Fight him.":
					say "     Oh now he's really crossed the line! Who the hell is he to demand or threaten someone like you? You muse, making a grab for the rifle angling to teach this guy a lesson. 'Idiot,' Augustus snaps, spearing your windpipe with the end of his gun before your hands can even move an inch from their original position. Reeling from the force of the blow, you collapse gasping for air. 'You're lucky I don't think you're worth cleaning up after,' he says, kicking you off the edge of the roof, letting you fall two stories onto the solid concrete below, then leaps down after you. 'Otherwise, I'd have killed you on the side of the road like the rabid animal you are,' Drake continues, dragging you by the neck out of The Last Chance. 'Now get out of here feral. Don't ever let me see you coming near this place again, or mark my words. I! Wil! End! You!' He concludes sealing the Last Chance off, exiling you to the plains.";
					move Player to Dry Plains;
					now Last Chance Parking Lot is unknown;
		-- "You wanted to fuck him.":
			say "     'You sick delusional fuck! That's why you did this!? Because you somehow thought I'd want to plough your rancid ass if I looked like some sick fucks wet dream! God damn it kid! Have the nanites rotted more holes in your brain than a lesbian slut rat orgy at a Catholic-run Swiss cheese factory!?' Drake howls, thrusting his palm over your face, and pitches you over to the edge of the roof. As you hit the tile in a prone position, Augustus pads over you, hooking his rifle under your chin. 'But you know what,' Drake says, grinding the muzzle of his rifle against your throat. 'That's not what really pisses me off. What really makes me want to gut you is what you've done to my kids.' Confused, you ask what he means. 'Think about it for a second. Before you did this to me, I could have at least passed for a normal human. Sure, I might have needed contacts and some cologne, but now look at me,' Drake growls pointing at his feral visage.";
			say "     'I am a goddamn anthropomorphic lion with balls the size of honeydew melons. How can I provide for them like this? On top of that, this sort of change should have been my choice. I'm not a doll, toy, or some bug you found under a rock for you to play with. I'm just a guy. A simple guy with hopes, dreams, responsibilities... a-a family.' He croaks, like he's choking back on his own bile. 'But now, look at me!' He gestures again to his animalistic visage. 'I'm a walking Theseusian paradox! I don't even know if I'm still me, or if I'm just-just a hollowed out shell that's convinced itself it's Augustus Drake. It hasn't even been that long, and I'm already forgetting what I really look like. I stare at my old photos, and don't recognize the man that's looking back at me!' He bleats, clawing at his sternum with his talons. 'What gives you the right to do this to me? What makes you think that I, or anyone else would want to be with someone who does this to people!?' Drake howls.";
			let Hobson's_choice_V4_Choices be a list of text;
			add "Beg his forgiveness." to Hobson's_choice_V4_Choices;
			add "Fight him." to Hobson's_choice_V4_Choices;
			let Hobson's_choice_V4_Choice be what the player chooses from Hobson's_choice_V4_Choices;
			if Hobson's_choice_V4_Choice is:
				-- "Beg his forgiveness.":
					say "     If only for the sake of self-preservation, you put on your most sincere face to plead with Drake, telling him not to do something he might regret. 'You think I'll let this slide just because you apologized, you pathetic piece of shit?' Drake rages, shoving the barrel of his rifle under your chin, forcing you to stand. 'How is an [']I am sorry['] going to keep food on the table, or pay for my kids['] education?' Looking Drake hard in the eye, you tell him it won't. Nothing you say will, but becoming a murderer isn't going to help them either. 'Fuck,' Drake sighs lowering his anti-material rifle, 'get out of my sight.' Drake waves his rifle towards the gate. 'I have some thinking to do,' he says jumping from the roof of the Last Chance and heading into the lobby.";
					move player to Last Chance Parking Lot;
				-- "Fight him.":
					say "     Enraged by Drake's arrogance, since who the hell is he to demand anything of someone like you? You make a grab for the rifle angling to teach this guy a lesson. 'Idiot,' Augustus snaps, spearing your windpipe with the end of his gun before your hands can even move an inch from their original position. Reeling from the force of the blow, you collapse gasping for air. 'You're lucky I don't think you're worth cleaning up after,' he says kicking you off the edge of the roof, letting you fall two stories onto the solid concrete below, then leaps down after you. 'Otherwise, I'd have killed you on the side of the road like the rabid animal you are,' Drake says, dragging you by the neck out of The Last Chance. 'Now get out of here feral. And don't ever let me see you coming near this place again, or mark my words. I! Will! End! You!' He concludes sealing the Last Chance off, exiling you to the plains.";
					move Player to Dry Plains;
					Now Chance Parking Lot is unknown;
	now Angry Wateringcan is resolved;

Table of GameEventIDs (continued)
Object	Name
Old One Eye	"Old One Eye"

Old One Eye is a situation.
ResolveFunction of Old One Eye is "[ResolveEvent Old_One_Eye]". It is inactive.
Sarea of Old One Eye is "Plains".

to say ResolveEvent Old_One_Eye:
	if Cunt Count of Player >= 1 and "UB Pred" is listed in feats of Player and "Vore Predator" is listed in feats of Player and Player is impreg_able and ScaleValue of Player >= 2:
		say "     Following along a rare unbroken stretch of vibrant green grasses, you come across one of the odd watering holes dotting the plains, albeit one that appears to be much cleaner than you usually find, at least compared to the one's frequented by the local Bald Eagles in the region. As this one appears to be unsullied by the native ferals, at least insofar as it doesn't reek of avian cum and much of the tall grasses and native cattails seem to be untrampled. Wondering why this is you shift your gaze to the banks, and spot the culprit. A large Manticore-like creature with feathery white wings convalescing at its edges. From where you're standing, the creature appears to be asleep, for the moment, though how long it will remain so is anyone's guess. Looking them over their slumbering form, you vaguely recall Drake asked you to keep an eye out for an injured manticore that could still have his family's knife.";
		say "     Wondering if this is the real Mccoy, you slowly circle around the side of the creature till you can get a good look at its face. Sure enough, there it is just sticking out of its right eye like Drake said. Uh that must hurt, you whisper under your breath, noting how the creature's skin still hasn't healed over despite the nanite's best efforts. Given its current condition, you could probably creep up and try to pull the thing out, but that would definitely wake the Manticore up. Of course, this will likely lead to a fight, and while Manticore's aren't the strongest ferals around, they're no pushovers either. Perhaps, a cynical section of your subconscious notes, you should just leave it well enough alone, though you will most likely never have the opportunity to retrieve Drake's knife. However, you never promised to retrieve the thing, and have no obligation to help the man after all. You think to yourself as your gaze drifts along the creature's slumbering form, and feel a sudden pang of primal sanguine hunger gnaw at the back of your mind.";
		WaitLineBreak;
		say "     Your twisted psyche starts to wonder if this mutant might make a nice snack, or perhaps a wonderful addition to your growing family. Eyeing over the beast's rip cord muscles and plush fuzzy balls, you can't help but think of what fine prey they would be after all. The mixture of mammalian, avian, and insectoid flavors would surely make for an interesting meal to say the least. Alternatively, the thought of Unbirthing such a prime unique specimen comes to mind. You've never seen a variant of the manticore infection, and as you paw at your empty womb that's just waiting to host its newest occupant. You realize, you may never get the chance again.";
		LineBreak;
		say "     [bold type]Do you give into your urges, stick to your initial plan, or just leave?[roman type]";
		LineBreak;
		say "     [bold type]What would you like to do?[roman type][line break]";
		let Old_One_Eye_vore_Choices be a list of text;
		add "Go for it and get the Knife." to Old_One_Eye_vore_Choices;
		add "Leave them be." to Old_One_Eye_vore_Choices;
		add "Swallow them whole and digest them." to Old_One_Eye_vore_Choices;
		add "Unbirth them." to Old_One_Eye_vore_Choices;
		let Old_One_Eye_vore_Choice be what the player chooses from Old_One_Eye_vore_Choices;
		if Old_One_Eye_vore_Choice is:
			-- "Go for it and get the Knife.":
				say "     Fuck it, lets do this, you muse sneaking your way closer to the still sleeping Manticore. Every step you take you expect the thing to wake up, but through some combination of luck and skill you stealthily creep up on the feral and wrap a hand around the hilt. Just as you start to pull on the handle though, the creature's one good eye flashes open, fixing you with a raw bloodshot stare. In that instant, it glances at your hand then looks up at your arm as your eyes meet, a perplexed look blossom on its bestial mug as its nanites warped mind struggles to process what you are doing. In that moment of confusion, you pull the knife as hard as you can. Though it resists you for a split second, the blade rips free with a sickly wet pop as the nanites rapidly begin healing the wound, halting all blood loss, and scarifying the damaged site before you can even blink. Rightly pissed, the creature wastes no time in rearing up and leaping at you. It's a fight!";
				challenge "Manticore";
				if fightoutcome >= 10 and fightoutcome <= 19:
					say "     Swatting down the wounded feral, the cowed creature falls flat at your feet. As you collect yourself, you decide to indulge a moment of curiosity to look over this odd creature. It's not often you get to safely observe a variant like this, and you doubt you'll get any opportunities to do so again. Kneeling beside it, you peer over its unconscious body, and note the presence of multiple ugly thick gnarled red scars lining its well muscled torso that are just barely covered by a thinning layer of fur. The worst being on its throat and forepaws. Were it not for the nanites, you imagine these wounds would likely have been fatal, or at the very least highly debilitating. The only other thing that stands out to you is the odd shape of its legs and feathered wings. As you observe the former, you notice they have an almost plantigrade bend. In addition, its forepaws appear to have almost finger-like digits, though you doubt that it would ever be able to hold, or manipulate objects with the same efficacy as a person would.";
					say "     Though if the creature applied itself, you suspect it could potentially pick up a pen or throw a rock, albeit very awkwardly. Turning your attention to its wings, you realize that the thing's body may have more in common with the feral gryphons flying around the plains, than a true manticore. The ramifications of which are interesting to say the least. Is this creature a hybrid of the strains brought about by what passes for [']natural processes['] these days, or someone who was overwhelmed by multiple infections? You may never know. Hopefully, at the very least after its encounter with you, and to a lesser extent, Drake, it may at least learn to leave people alone. A part of you doubts this, but it's better to live in hope. Even if it doesn't learn, hey, you at least got the knife back. Too bad the damn thing seems to have picked up a bit of what some might call funk. You might want to get the blade cleaned before you give it back to Drake. Alternatively, you could just keep it; you never promised to bring it back after all. You opine as you head out to the entrance of the Dry Plains.";
					now Old One Eye is resolved;
					ItemGain Drake's Blade by 1;
					now Hunger of Augustus Drake is 3;
				else if fightoutcome >= 20 and fightoutcome <= 29:
					say "     Beaten back by the raging feral, you collapse on the ground as you recover from the thorough ravaging the creature gave you. Seemingly invigorated by the fight, it prowls around you looking rather proud of the mess it's made of your body. Thankfully it doesn't seem interested in a round two and takes wing a few moments later, leaving you, and Drake's blade behind. Once you've recovered enough to move without too much sticky soreness, you collect the slightly rusted and grimy blade from the ground. To say the elements as well as the exposure to the manticore's bodily fluids have not done it any favors would be an understatement. As sickly green splotches of some unknown matter mar the handle alongside streaks of fresh rust. You'll probably get this thing cleaned off before handing it back. The damn thing smells worse than death right now, or you could just keep it you think to yourself as you tuck the thing away and head back to the entrance of the Dry Plains.";
					now Old One Eye is resolved;
					ItemGain Drake's Blade by 1;
					now Hunger of Augustus Drake is 3;
				else if fightoutcome >= 30:
					say "     Feeling the tide of battle turn against you, you break contact with Manticore and beat a hasty retreat away from the watering hole. Thankfully, the feral shows little interest in pursuing you at the moment. Perhaps it's content with this show of dominance over you, or it could still be hurting from its encounter with Drake, either way it doesn't matter. You were only here for the knife, now that you have it. You really have no reason to fight the creature outside satisfying your own foolish pride, or vain battle-lust.";
					now Old One Eye is resolved;
					ItemGain Drake's Blade by 1;
					now Hunger of Augustus Drake is 3;
			-- "Leave them be.":
				say "     Ruminating on it, you honestly couldn't care less about the lone manticore, or Drake's stupid knife. Why not just let sleeping mutts lie, you opine as you head back towards the entrance of the Dry Plains";
				Now Old One Eye is resolved;
				now Hunger of Augustus Drake is 2;
			-- "Swallow them whole and digest them.":
				say "     Running your [facename of player] tongue over your incisors, you decide that this tender morsel would make a better meal than a child. Besides, they deserve some punishment for attacking people anyway. Or at least, that's what your warped mind tries rationalizing to itself as you creep quietly as a church mouse behind the Manticore. ";
				if "Touched by Madness" is listed in feats of Player:
					say "Centimeter by centimeter, ";
				else:
					say "Inch by inch, ";
				say "you sneak over cracked mud and drying grasses. To your ears, every crumbling flake sounds like a bomb going off, each breeze roars as if were the mad howl of some terrible gale. Even your treacherous heartbeat roars in your ears with the fury of a spiteful thunderclap till your face-to-stinger with the slumbering Manticore's tail, and the world goes deadly quiet like creation itself were holding its breath as you place yourself on all fours. You, as quietly as you can, pick up the chitinous mass of its tail, while hoping beyond hope this creature doesn't notice your touch.";
				WaitLineBreak;
				say "     Though once your fingers make contact with the cold, sleek, black exoskeleton of its rear mounted limb, you almost swear that you saw the thing flex its hindleg just a hair. Yet despite this light twitch, it's breathing remains the same slow, shallow, slumbering, unaware tattoo as when you found it. Still, you decide to wait a second or two longer before proceeding with your plan. Once you judge it to be sound asleep, you wrap your [facename of player] mouth around the slick chitin of their stinger, mentally remarking that the glossy smooth material isn't all that dissimilar to toasted hemp seeds as you give the savage appendage an inquisitive lick. A part of you can't help but be intrigued by the alien texture, as your taste buds explore the exotic surface of Manticore's stingers with a few probing laps of your tongue. You can already feel a bit of the unique chemical tang of aphrodisiac venom seeping on to your taste buds. Perhaps it's an autonomic response, or a simple reaction to your body heat.";
				say "     Either way, so long as the beast remains still, it doesn't bother you, you opine, sucking down on the tip of one of the world's most dangerous noodles. You're rather mindful not to jostle the creature until you get in a more advantageous position. Not because you fear the mutant, but for the challenging thrill of stealthily devouring the Manticore, you think to yourself, gently slurping down the creature's sleek appendage one glossy segment at a time. The distance between you and its paws shrink with each succulent click of their tail against your fangs till their supple ebony toe beans are dangling but a hair breadth for your yearning maw. Confidently grabbing hold of them, you deftly slide their murder mittens together in a cute little bundle of furry peets, before popping one of their smooth pads one after the other into your waiting maw. Internally you revel in the enthralling sapid mix of earth and salt accompanied by the scent of fresh corn chips that assails your senses as your oral muscle explores the toned contours of their bestial paws. You decide to give your meal one last hurrah, as you fondle Manticore's pads with your [facename of player] tongue.";
				WaitLineBreak;
				say "     You gleefully suckle on the manticore's slick contours of the slumbering feral's supple toe pads, enraptured by a unique mix of earthen tangs and male musk playing across your senses as you slurp them down. You feel their talons reflexively twitch and tickle along the edges of your throat. This halts you in place, for a moment, and you simply sit there as the creature shuffles slightly in the warm pillowy embrace of your voracious maw. Once they've settled though, you begin working your way up their delectable vermilion flanks, swallowing ";
				if "Touched by Madness" is listed in feats of Player:
					say "centimeter upon centimeter ";
				else:
					say "inch upon inch ";
				say "of carved muscular thigh meat with each not-so-little swallow until your senses are greeted with the heady musk of its potent baby makers as their furry crimson mass of their sack rifles your nose. Perhaps it's the lust-inducing venom seeping through your stomach lining, or the macabre influence of your aberrant nanites affecting you, yet a part of you can't help but want to lick and tease its fat fluffy sack with your tongue as you clamp down on the mutant's toned feral backside.";
				say "     You unhinge your jaw with a well-practiced pop, wedging the creature's rear down your maw like it were a giant piece of dense fluffy velvet cake. You cosset your tongue about the beast's fur-wrapped cum sacks, while you slowly work your nanite-infused jaws over their virile sheath. You lovingly dandle his blood-red cock sheath, relishing the rich masculine flavor leaking onto your taste buds as their cock gently slides out of hiding with a burst, dry salty male juices dripping off and around their feline spines then down your waiting throat. The heady interplay of their manly zest and libido-enhancing venom coursing through your veins ignites some deep primal desire within you. As your nanite-altered brain and belly cry for more, more warm delicious cum as you lap at the feral's engorging member with your oral muscle not caring if you might awaken the mutant. Coiling your predatory tongue around the creature's throbbing tool, as you tenderly pamper its plush rod, your body acts almost like it was on autopilot.";
				WaitLineBreak;
				say "     You pump the beast's burgeoning member in tune with your racing heart beats for all its worth. Thankfully, the manticore seems to be well and truly out of it, as it barely even moves, though you can hear the creature mewling happily in its slumber. Offhandedly, a part of you wonders what it must be dreaming about, but the all consuming need emanating from your gurgling gut pushes back such meaningless thoughts. Whatever their dream is, you're gonna make sure it ends up being a [']wet one['], a distant part of your psyche titters as you vigorously massage the feral's delightfully textured member with a few gleeful passes of your oral muscle. Reveling in the sensation of its soft alien spines caressing your mouth and the enticing alien tang of its chimeric pre, till at last, you're rewarded with a telltale twitch from the beast's cock punctuated with muffled sigh of contentment as it cums a hot salty load of cream into your hungry maw. Its rich seed puffs out your cheeks with its sloppy excess.";
				if Cunt Count of Player >= 1 and Cock Count of Player >= 1: [Herm version]
					say "     Wonderful, you muse, desperately trying to gulp down the creamy meal your potent prey provided you with even as some feline cum drips from your jaws in toasty gentle rivets of pearlescent perfection. Already, you can feel the mutant's colossal load plumping out your tummy into a cute little bump alongside its paws and venom. The warm full feeling of this intoxicating mixture of unearthly sensations only excites you further as you run a hand over the molten swelling mass of your stomach, luxuriating in the feeling of your turgid belly and the outline of the Manticore's paws pushing against your [cockname of player] dick. You don't see why you can't enjoy yourself a bit. As you shift your weight to allow your prey's decadent mass to gently caress your own rod for a nice little hands-free experience while you push the beast's beefy bottom past the rim of your impressive maw with a long hard swallow.";
					WaitLineBreak;
					say "     Your neck bulges out to accommodate its form and you can feel your torso stretch to make way, not that you're bothered by the pressure. If anything, you take a twisted pride in how far you can push yourself as the creature's glorious tool passes past your lips. Your prey slips deeper into your greedy gullet, forming a nice heavy mass braced neatly against your growing pre-slicked [cockname of player] cock. It takes a great force of will to not stop and begin playing with your dual sexes on the spot. Luckily, you're far hungrier than you are horny, and have the presence of mind to grab hold of the creature's toned furry core and hoist the beast into air with one fluid motion. Now with gravity on your side, you work your mouth up their torso like a snake consuming its prey. Aided further by your exotic nanites, you feel your malleable body shifting and engulfing your prey before they even have a chance to stir in your grasp.";
					say "     As the creature's remaining form slowly, almost agonizingly so, starts its final descent, first their hips, then their wings slip past your lips into your yearning stomach with a sweet sinful sensation. Then as if some seal were broken, the rest of manticore's body glides down your throat like you were downing a hot drink till only their paws are left dangling out along the side of your mouth. With a theatrical flourish, you smirk and push those beans down to your exceptionally-packed belly, with a single motion that blimps your overstuffed tummy well past your knees. Looking down at your wonderfully swollen body, you can't resist languidly running a hand down around the lovely swell of your tummy, relishing the feel of the taut surface and vague outline of your prey as it balances atop your stiffening futa dick, then let your eager digits drift back up along the [Breast Size Desc of Player] curves of your [bodytype of player] chest.";
					WaitLineBreak;
					say "     You find it hard on some level, not to smile at the sight of such a mighty creature being reduced to food and fuel for your perfectly voracious figure, though as your prey starts to settle, your stomach begins to gurgle and finally loses its modified acid. In that moment, your prey at last wakes up as you feel it begin thrashing around as your nanites-laced acid works to break them down. Mirthfully, you watch as their claws and teeth play across the surface of your tummy as they nip at your inquisitive digits, though all their flailing does is turn you on as the creature's weight presses down on your prostate and massages your [cock size desc of player] [cockname of player] cock through the drum-taut skin of your belly. Not wanting to waste such a rare experience, you plop onto your back and sneak a hand under the churning mass of your turgid tum. You do your best to heft your tummy out of your moist [cunt size desc of Player] honey pot and throbbing [cock size desc of player] cock.";
					say "     You languidly tease your pussy lips, though gently at first as you want to savor every thrash and gurgle your prey makes on the way out before you cum. Lazily falling into a nice rhythm, you start rocking your futa cock against your paunch, graciously letting the creature's final throes service your [cockname of player] member as its last act. A part of you wants nothing more than to ride out the feral's futile struggle, to enjoy every forbidden sensation he lavishes upon you as he unwittingly pleases you. Though you know your prey won't last much longer, you can already feel those kicks getting weaker every second. Almost angrily, you growl and jostle your shrinking belly urging at the manticore to keep fighting (at least until you finish). Maybe it heard you, or maybe it's just passing into your lower intestines, but your actions push the creature to make one last attempt to break free. As its paws thrashes and dig into the nanite-lined layers of your stomach desperate to inflict some measure of retribution on you.";
					WaitLineBreak;
					say "     Yet, you only coo happily in response as their struggles work over your herm dick, and rub your moist venom-engorged bitch button with your free hand in tandem with their flailing. You lavish your dual sexes with wild abandon, lavishing your sopping cunny with deep penetrating thrusts of your dexterous digits. While you manically stroke the length of your turgid dick against the warm squirming walls of your tummy, reveling in the hybrid bliss such an act provides. You try to hold for just a few more seconds, desperate to edge out just a few more seconds with your prey, but you can't. Crying out half in anger that your prey couldn't last longer, and half in pleasure as cum, basting the air above with more virile cream than you thought possible. Looking up, you see the great ropes of baby batter fills the sky above you almost like a white silvery cloud passing overhead, until gravity reasserts itself, and you're bathed in a sudden downpour of your own seed.";
					if "Safe Appetite" is listed in feats of player and scalevalue of Player is 5:
						say "     Not that you notice, or care, as your blissed out brain struggles to process the exotic high of your dual orgasms. Instead, you just lie there on a bed of soft grasses, marinating in your own seed, waiting for your body to deflate back to it's [']normal['] size and letting your cum dry off on its own. Slowly, but surely, your gurgling bump gradually diminishes back to its pre-meal size, but not before some of the extra bulk starts flowing into the rest of your assets. As you watch in awe as your tits heat up and swell with verdant excess as your body feasts on the rich flood of nutrients seeping into your tainted being. Though you barely have time to marvel at your magnificent mounds as your balls start throbbing with a pleasant warm pulse as your cum tanks rapidly swell before your eyes forcing you to spread your legs wide just to avoid crushing your growing herm hood. Just as quickly as it started, the sudden growth spurt seems to plateau, as this wave of change sweeps down your groin to your [CockName of Player] dick and [cunt size desc of Player] muff. ";
						WaitLineBreak;
						say "     Perhaps not to be out done by your engorged tits and swollen sack, the titillated tissue seems to drink in the lingering essence of your latest meal with an aberrant aplomb. Your [CockName of player] cock twitches and throbs with unnatural energies as your invigorated tool slowly bulges forth with few fresh ";
						If "Touched by Madness" is listed in feats of Player:
							say "centimeters ";
						else:
							say "inches ";
						say "of delightful girth. Enthralled by the decadent raw feeling of this fresh futa flesh straining against your palms, you glide your diligent digits along the underside of your dick, utterly enthralled at the newfound mass. The last meager remnants of your prey's potent strain settles in your puddling pussy. You sense your well-traveled passage lengthening with each breath. You can't resist the sudden urge to run your hand over midriff to feel your body shift and squirm to make room for the extra ";
						if "Touched by Madness" is listed in feats of Player:
							say "centimeters.";
						else:
							say "inches.";
						WaitLineBreak;
						say "     Curious how much you've grown, you dip a few dexterous digits into your sweltering box, you're somewhat pleasantly surprised by the ease and alacrity with which your pussy is able to accommodate your explorative fingers. Considering your recent proclivity, you can't help but be a tad enchanted by these new found elastic qualities, though a part of you still wonders what prompted these changes given your robust constitution. Perhaps there was something special about it beyond its appearance. Not that you're fully opposed to these alterations, you muse as your peer down your enhanced assets. Considering your impressive stature, the extra ";
						if "Touched by Madness" is listed in feats of Player:
							say "centimeters ";
						else:
							say "inches ";
						say "do a good job in keeping things proportional. At least that's what you tell yourself, as you catch a glimmer of your curvaceous figure reflected in the nearby pond. You decide to indulge yourself with a moment of vanity and stroll over to water's edge for a better look.";
						WaitLineBreak;
						say "     Hm, nice, very nice, you purr, observing the gentle bounce of your hybrid assets that accompanies your step. Ya, could definitely have some fun with these, you snicker, as your hands roam the elated curves of your ripe chest and down to the plump mass of your [cockname of player] balls. The productive tissue partially groans with excess as you fantasize about hybrid hijinks you could get into with these. Bigger is better, as they say, you titter internally as you adopt a few playful poses to highlight your hybrid form. Besides you tell yourself, if the new padding ever becomes an inconvenience, you can always shrink back down. It's not like it's a hard thing to do in this day and age, so why not indulge yourself a bit more and enjoy your curves at least for the moment. There's no downside to them and your massive [bodyname of player] frame can easily support them.";
						say "     Yet such minor concerns are a problem for future you, for now though you need to grab Drake's knife and... oh crap baskets. You hiss as a sudden abruptly realization hits you, you just [bold type]ATE[roman type] Drake's knife, how in the heck are to *BURP*! You belch hard, harder than you thought possible. Your neck muscles stain and flex like they were caught in the throes of a grand mal seizure till suddenly you hear a loud wet *clunk* as the knife pops out of your mouth and onto the ground at your feet. How in the... your mind putters trying to process this but you stop yourself, best not to think too deeply about how this aspect of the nanite plague works. You probably don't want to know the answer. All that matters is that you have the knife, yes it smells like boiling hot bile, but you never promised to find it so Drake most likely won't care if you return it in this condition. Well, you hope that will be the case as you wipe the thing off and tuck the blade away for later.";
						now Old One Eye is resolved;
						increase Breast Size of Player by 3;
						increase Cock Length of Player by 6;
						increase Ball Size of Player by 3;
						increase Cunt Depth of Player by 6;
						PlayerEat 20;
						ItemGain Tainted Blade by 1;
						now Hunger of Augustus Drake is 3;
						TraitGain "Mx's Mantle" for Player; [Mania, dementia, paramnesia, and synesthesia! Howling loons and weeping fools, all are but broken tools!]
						if "Mighty Mutation" is not listed in feats of player and "Bestial Power" is not listed in feats of player:
							FeatGain "Mighty Mutation";
					else if "Safe Appetite" is listed in feats of player and scalevalue of Player < 5:
						say "     Enraptured by your potent climax, your pleasure-rattled mind can hardly even parse such frivolous things, as waves of voracious delight echo through your elated being like an unstable fission reaction. You're more than content to wallow in the blissful afterglow and massage your hard working body, encouraging your body's nanites to break down the remains of your recent meal. You simply relax on the soft earth, rubbing your taut tum as it gradually begins to shrink back down to its pre-meal size. Though while you lie there, tracing playful circles along the surface of the hard working organ, you dimly sense some of the extra mass you picked up isn't being absorbed like it normally does. Curious, you watch, with no small amount of satisfaction, as your tummy audibly creak and gurgle with effort. As the lingering essence of your prey seeps into you, sparking some strange, yet enthralling, growth spurt concentrated in your core.";
						say "     In moments, you begin cooing with unrepressed rapture, as your hands drift to your chest and happily paw at your bust as the tender tissue is flooded with waves of pleasant heat and growth. Utterly elated by sinfully sweet swells sensation simmering succulently the supple sphere sitting resting in your palms of your hands, your [Breast Size Desc of Player] tits drink in the potent essence of your prey. Growing larger and tender till the supple tissue soon spills the gaps of your fingers as this unbidden expansion starts spreading to your lower half. You can feel your dual sexes thrum with activity as your hybrid anatomy feasts on the remnants of your prey's oddly potent nanites swirling within your nanite-tainted system. Your [cockname of player] cock and balls swell to the most decadent of proportions right before your eyes. You feel a sense of absolute elation passing through you as your hands are to your throbbing spire and groaning sack.";
						WaitLineBreak;
						say "     You can't help but languidly explore the hypersensitive length of your engorged masculine anatomy with your eager mitts, delighting in the generous girth of your burgeoning throbbing tool straining against your grasp. While your groaning ball sack presses alongside your inner thighs as your sack balloons outward. You have to swiftly readjust yourself to avoid pinching your blossoming hermhood as your cum factories are wracked by the sudden wave of change passing through your baby batter maker's. You can't resist smirking as the productive tissue appears to rapidly grow to a scale that neatly complaints your newly expanded cock. At least to your lust-fogged eyes, you opine, dandling your hands about the sordid tissue. The sensation of unbidden, but not wholly unwelcome expansion spreads to your extremities as your prey's potent prolific nanites fully saturates your being. Your body starts to tingle like your whole being was experiencing an acute case of paresthesia as your [bodytype of player] form expands, becoming larger by the second.";
						say "     The ground seems to slip away from you, as your being swells to the size of a minivan. A feat some part of your nanite-laced psyche can't help but proud of, you opine letting inquisitive digits roam your expansive and generously endowed assets of your newly enriched form. You pick yourself up and saunter over to the clear reflective pool to gaze at your newly enlarged body. On some level, you admit the new curves and improved height does look quite nice on you you opine, adopting a few playful poses that show off the supple bounce of your chest and heavy cum tanks. Though once this brief honeymoon period wears off, and your more rational side reasserts itself does it suddenly dawn on you. You just [bold type]ATE[roman type] Drake's knife, how in the heck are going to *BURP*!";
						WaitLineBreak;
						say "     You belch, hard, as your neck muscles are wracked with heavy spasms punctuated by loud wet *clunk* as the knife pops out of your mouth and onto the ground at your feet. How in the... your mind tries to process this, but you stop yourself, best not to contemplate the depths of the Nietzschean abyss that is the nanite plague. You have the knife, yes it smells like boiling hot bile, but you never promised to find it, so Drake most likely won't care if you return it in this state. Well, you hope that will be the case, you muse, as you wipe the thing off, then tuck it away for later.";
						now Old One Eye is resolved;
						increase Breast Size of Player by 3;
						increase Cock Length of Player by 6;
						increase Ball Size of Player by 3;
						increase Cunt Depth of Player by 6;
						now scalevalue of Player is 5;
						PlayerEat 20;
						ItemGain Tainted Blade by 1;
						now Hunger of Augustus Drake is 3;
						TraitGain "Mx's Mantle" for Player; [Hearing colors, seeing sounds, feeling the world spinning round! Nothing ventured, yet something gained, only the mad are truly sane!]
						if "Mighty Mutation" is not listed in feats of player:
							FeatGain "Mighty Mutation";
					else if "Safe Appetite" is not listed in feats of player:
						say "     However, such meager concerns are the farthest thing from your rapture-wracked psyche as you lay there, luxuriating at the sensation of the lingering motes of voracious sensual fullness sparking across your stuffed midriff. Your hands roam the turgid curves of your prey-packed tummy tracing lazily circuits in the bountiful taut tissue as your hard working nanites feast upon your latest prey. With every pass of elated fingertips, you can feel your being steadily absorbing your rich meal's exotic nanites as thin yet downy soft dusting of vermillion fur slowly blossoming into being on the taut apex of your swollen gurgling tum. Already accustomed to such post-meal occurrences, you feel neither fear nor revulsion at the sight of this sudden change, but rather as a sense of unbridled curiosity welling in your core. Besides what's wrong with a little show after such a fine snack, you ruminate, running your palms over the warm velvety carpet of crimson fur spreading over you.";
						say "     It feels so inviting to the touch and the rich red hue matches your sanguine disposition so wonderfully, you ruminate while your hands glide along the lush borders of your pelt as spill down the edges of your prey laden tumby in a wave of iridescent red fur. A part of you can't help but relish the sensation of your inquisitive digits dancing along the satin hair. ";
						if nipple count of Player <= 2:
							say "Though as you indulge yourself in this simple tactile pleasure, your finger eventually brushes a sensitive series of bumps lining your sides. At first, you suspect these are some more, [']durable['] remains of your meal, yet as your fingers explore the tender territory. You note, these aren't remnants of your prey, but the beginning of four petite tummy teats forming on the flanks of your [bodytype of player] midriff. At any other time, there's a chance you might have found such accents off-putting. However, some twisted segment of your nanite-inundated mind, regards their presence as rather... enticing, you think to yourself as your mitts cup the nascent orbs, delighting on some level at sweet contrast between your tight prey filled core these supple furry nips.";
						else if nipple count of Player > 2:
							say "As a light, yet pleasant tingling sensation simmers across your extra breasts as they drink in this sudden rush of potent nanite laced nutrients. You almost coo at the feeling of raw and ripe virgin nerves wink into being as their supple surface swells in your in your grasp. That pairs so elegantly with the tender caress of your spreading pelt, coating them in glossy embrace, you muse, as you hand roam the pleasantly heavy orbs coddling your prey stuffed core.";
						WaitLineBreak;
						say "     Mh so soft, you purr, tweaking one of your fuzzy teats while you watch the steadily advancing field of red fur roiling over your being as if a curtain of crimson twilight were being drawn over the stillest of seas. Everywhere your pelt touches, you observe a subtle shift in your body as your form drinks the blissful waves of change and becomes ever more beastly. Once your chest is fully encased in the rich red hair though, your core starts to grow larger and barrel-esque, but also more defined as if your body were making space for something. Regrettably, you hardly have any time to contemplate what it may be as the fur spreads down your arms and your biceps ripple and thrum with actives as your powerful muscles reshape themselves into toned sculpted hills of raw bestial might.";
						say "     You mitts to go hot to the touch, as they flow outward into a streamline hybrid of sapien and feline design. Flexing your dominant hand, you observe the growing outline of robust black paw pads swirling into being on your palms alongside the tactical indentions in your fur concealing your retractable claws. Reasonably curious about their appearance, you flick your talons out with an exaggerated flourish accompanied by a satisfying *shing*. Beautiful, you simper in a low hush toned, marveling at the length and opalescent quality of the available light waltzing across their sickled edges. Could get a lot of use out of these, you rumble with almost catty trill as you sense the slow sensual kiss of your pelt flowing down your legs. Though for a moment, the spread of silken red fur seems to have hit a wall as your prey nanites appear to pool at your groin, albeit not from a lack of trying, you muse, detecting the rush of another bout of change as your dick strains against the weight of your shrinking foodbaby and the velvety caresses of your fur along inner thighs.";
						WaitLineBreak;
						say "     Intrigued, you skim your plush paw-like hands along the churning mass of your taut tum and perky teats, rollicking internally at the sensation of the lustrous texture of your pelt playing along your pads. Once your paws crest the tight curve of your well-fed form, they are greeted by the plush touch of your shifting cock rifling their edges. Or at least that what you think at first as your pads grace the tender fuzzy surface of a  no, you pause to correct yourself as the full magnitude of this new delightful reality hits you  [bold type]your[roman type] plump sheath. Wrapped in the glossiest of fur and swaddled in pliable thick hide, your altered cock cover is delightfully inviting to the touch your inner monologue swoons, while you give your tool an endearing squeeze as you struggle to fit the half chubbed rod in the crook of your paws. This simple motion alone is enough to send your voracious heart aflutter as the warm, dense, regal flesh caresses your burgeoning barbs in its tender embrace.";
						say "     Though that's not all that's changing, you opine with deviant smirk, noting the sinfully sweet swelling sensation simmering along your groaning ball sack as the lush orbs rifle your legs as they strain against their pillowy housing. You have to swiftly readjust yourself to avoid pinching your growing hermhood. As your cum tanks are wracked by the sudden tide of transitory titillation passing through your baby batter maker's, you can't resist groping the productive tissue as it appears to rapidly shift and reform itself into four evenly sized orbs that neatly compliments your newly expanded cock. At least to your lust-fogged sensibilities, you think to yourself, dandling your hands about the licentious flesh of your masculine endowments. Your lascivious infatuation deepens all the more once the muffled sonorous hymn of your potent seed sloshing within your quartet of corpulent cum makers reaches your ears. Your toes curl as your pelt leisurely coils down your calves like living crimson vines, digging light furrows in the soft grasses cradling your shifting form at the thought of all the fun you're going to have with these.";
						WaitLineBreak;
						say "     Already enamored with your changes, you're unable to repress the urge to prop up your dominant leg into view. You watch as they twist into a proper digitigrade stance as they're toned, lightly-muscled structure is engulfed in an ocean of sparkling ruby vermillion fur. Once it touches your feet though, your paws-to-be gracefully expand out into a saucer-esque shape as your flesh flows like water into feline configuration tipped with lengthy ivory talons, and cradled by dense black pads. While a slight pinching sensation nips at your heels, curious as to its source you tilt your paw sideways, then spot the sudden emergence of a single umbral boney stiletto. Transfixed by the sight, you hardly even notice the changes steadily sweeping up your neck, vibrant reds cradling you briefly give way to the purest of black fur that coddles your throat protectively as it flows outward in a dense ring of shimmering ebony. Enamored by the gentle caress of the silky fuzz, you playfully rub your chin against this swelling quasi-mane while it spills down your collar, forming a shapely tuft of fur nestled neatly between your uppermost breasts.";
						say "     At least that's how it looks from your current angle, you note with a Cheshire grin as your gaze is drawn to the mirror-like surface of the nearby pond. You pick yourself and strut over to the pool with forced sensual sashay imparted by your form's natural heels. Ow, nice, very nice, you purr at the sight of your ";
						if "Touched by Madness" is listed in feats of player:
							say "almost three meters tall Amazonian figure's reflection. ";
						else:
							say "nine foot tall Amazonian figure's reflection. ";
						if "Touched by Madness" is listed in feats of player:
							say "To your eyes, every centimeter ";
						else:
							say "To your eyes, every inch ";
						say "of your augmented physique radiates with power and lust as if it were hewed from glistening red obsidian. Your gaze drifts along the crimson curves of your sculpted hourglass waist while you observe the clinical definition of the dense muscles lining your limbs. Alongside the artful swell of prey-filled tum, the inviting bounce of breasts, and heavy sway of virile endowment that accompanies your every motion. However, as your pelt closes in on your [FaceName of Player] face, your vision starts to crack and distort as your jaw expands outward becoming a facsimile of a proud leonine form.";
						WaitLineBreak;
						say "     Thankfully, this aberration passes rather quickly as your head rapidly reshapes itself, but not before you notice a series of ebony lumps peeking from under your fur atop your head. Alarm flashes across your mind like sparks cascading off stuck flint as this midnight-hued matter curves about your catty ears, where they ossifies into goat-like horn tipped with golden points. Giving one of your handle bars a light tug, you mentally remark at both their toughness as well as their sleek glassy texture, like they were poured from the Void itself. Finding, on some level, this to be a rather endearing trait, you do a play twirl to get a better view of your bestial accents. On the third or forth pass however, you spy a subtle set of bulges on the trapezius of your back and tailbone decorating your pleasingly thick ass. Intrigued, you contort yourself slightly for better look then watch as your pelt ripples and shifts into a pair of alabaster white wings and long chitinous jet-black scorpion tail.";
						say "     At first the new limbs feel numb, almost like they'd fallen asleep. Yet with each breath, or attempt at manipulating them, sensation along with the last remnant of your prey's nanites floods your exotic being. You ruminate, ogling your tummy as it shrinks into subtle washboard abs capped with a sensual layer of dense fur, though a part is already starting to miss the sight, not to mention the sensation of forbidden fullness your prey laden bump gave you. Still, you take some measure of solace in the knowledge that there's more out there. This body certainly seems built for catching them too, you muse, feeling your athletic thighs and robust wings tense with a potent mix of anticipation at the thought of chasing down some hapless prey. Then again, why eat them when you can adopt them, it would only take a few stings from your tail before they start begging you to claim them. Who knows, you might even find yourself some nice virile cats worth playing with.";
						WaitLineBreak;
						say "     There's bound to be one or two deserving kittens out there who could pump a nice fat litter into you, you think to yourself, running your padded paws along the luxurious fur gracing your midriff, picturing your womb growing round and taut with a [one of]cute clutch of cuddly cat taurs[or]a bountiful brood of anthro kittens[or]a squirming litter of feral cubs[at random] while your new nips get nice and perky as they fill with warm, delicious futa cream. A part of you even flirts with the notion of [bold type]milk[roman type]ing yourself in the future, you ruminate, giving your tummy teats a love stroke. The thought sends shivers down your spine and gets blood rushing to your cock as your barbed and tapered tool edges its way out of its fat, ripe sheath. Every blissful throb is dogged by the genial caress of your dense cock wrapper dandling about the spines of your hybrid spire. A rush of raw primal thought floods your tainted mind as you feel you could almost cum just from getting it up!";
						say "     You muse, as your lush dick sleeve stretches to accommodate the sheer volume of your virile bitch-breaker. Though it's far from being uncomfortable, if anything the gentle tug of sheath about the root of dick is a rather pleasant sensation, you think to yourself as you glide your supple paw pads along its hefty length. Nearing the base, you detect an odd, yet somewhat inviting bulge. Lightly cupping it in your mitts, your far-traveled mind instantly recognizes the turgid mass for what it is, a knot. A rather sizable one at that, you remark internally, as you catch sight of the reflection of the bright glistening gland nestled neatly at the base of your barbed spire. Albeit a slightly out of place one at that given your prey's feline bend, perhaps there was more to it than met the eye. Regardless, on some level you still find its presence rather alluring. Besides, your mates will appreciate it, and you want to let any of your seed go to waste. There's plenty of breedable holes out there who are probably just crying out for the chance to carry a litter of your exotic cubs, you muse with a light chuckle as you picture your favored plaything knocked up with a batch of your beastly brood.";
						WaitLineBreak;
						say "     But that will have to wait, right now you have to get Drake's knife and... oh crap baskets. You hiss, as it suddenly dawns on you. You just [bold type]ATE[roman type] Drake's knife, how in the heck are going to *BURP*! You belch, hard, as your neck muscles are wracked with a heavy spasm that's punctuated by loud wet *clunk* as the knife pops out of your mouth and onto the ground at your feet. How in the... your mind tries to process this, but you stop yourself, best not to contemplate the depths of the Nietzschean abyss that is the nanite plague. You have the knife, yes it smells like boiling hot bile, and its blade appears to have warped [']slightly['] after being exposed to your stomach acid. But, you never promised to find it, so Drake most likely won't care if you return it in this state. Well, you hope that will be the case, you muse, as you wipe the thing off, then tuck it away for later.";
						now Old One Eye is resolved;
						turn the Player into a "Hermacore";
						choose a row with Name of "Hermacore" in Table of Random Critters;
						if Nipple Count of Player < 6:
							now nipple count of Player is 6;
						increase Breast Size of Player by 3;
						increase Cock Length of Player by 6;
						increase Ball Size of Player by 3;
						increase Cunt Depth of Player by 6;
						PlayerEat 20;
						ItemGain Tainted Blade by 1;
						now Hunger of Augustus Drake is 3;
						if "Mighty Mutation" is not listed in feats of player:
							FeatGain "Mighty Mutation";
						TraitGain "Mx's Mantle" for Player; [Choking blood, spitting bile, bitter mercies, and humbling thoughts! All your struggle will be for naught!]
				else if Cunt Count of Player >= 1 and Cock Count of Player is 0: [fem version]
					say "     What a wonderful appetizer, you muse as thin streams of molten cum trickle down your throat, basting your prey's paws in its own juices as your belly bulges slightly from the sheer quantity of jizz wallowing within you. Your jaw unhinges as your body further envelopes the Manticore's toned chest. You watch with a minor sense of amazement as your torso swells out from the sheer bulk of the Manticore's body. Your tongues laps at their hidden pecs. You lavish attention on their hardened masculine physique as you coat them in further layers of natural lubricant, easing their passage through your maw, allowing your predatory body to easily suck down more than half their feral form with but a few greedy swallows. Already, you can sense their hind paws pressing against your vacuous stomach with a pleasant bit of pressure that your warped [bodytype of player] body has come to crave as it stretches out wonderfully to accommodate your meal as you feel their tail and paws skim along the tainted lining of your abyssal gullet.";
					say "     Enraptured by the experience, you grab hold of the manticore's wings and shoulders, ";
					if "Touched by Madness" is listed in feats of Player:
						say "gently like a hamburger, ";
					say "before throwing yourself back into a standing position. At once, gravity asserts its dominance over your prey, allowing you to easily push their wings down your yearning throat. In a flash, their upper body vanishes from sight as a sleek stream of warm downy quills grace your elated pallet till only their head and paws are left sticking out of your malleable maw. At the last moment, you sense them come around as your teeth close about them like the bars of a cell, though the manticore barely has the time to cry out as you swallow them whole. A low pitiful mewl is all that escapes your lips as they're rapidly drawn in by your voracious throat muscles. The creature hits your stomach hard, bloating your figure to delectably decedent proportions with their animalistic form.";
					WaitLineBreak;
					say "     They roil in your tainted stomach acid like bits of driftwood caught in a squall, thrashing, biting, and try to sting at your altered stomach lining desperately seeking to free themselves, or enact some form of futile vengeance upon you. Not that such a thing was possible, greater creatures than them have tried and failed to escape this fate. Still, that doesn't mean you can't enjoy the attempt, you think to yourself, languidly running your hand over their captive mass and exalting at the sensations of the paws pressing against your packed guts. You bask at the feeling of pure forbidden fullness emanating from your core as their clawed digits scrape along your sides. Oddly, you don't feel any discomfort from their struggle even when they try nipping your hand from the inside. If anything, their frantic movements are just making you feel wet, or maybe it's the manticore's lust inducing venom permeating your bloodstream. You note, feeling a pleasant heat seeping through your core.";
					say "     You almost feel like your whole body is blushing, but not in a wholly unbidden way, you opine, stroking your tight hypersensitive skin. The nerves feel so raw, like even the slightest breeze could set you off, and without meaning to you start rubbing your legs together with barely repressed need. Fuck, so full, you moan plopping down on your back, sending an erotic quake though your body as the beast thrashes within. You have to admit, some section of your voracious mind is a bit turned on by their antics as their wild flailing massages your hard working muscles from the inside. Ah love it when they struggle, you simper, lazily slipping a hand along the taut dome of your bloated pooch as you dip a finger or two into your drooling cunny. You fondle your plush button and tender folds while your voracious stomach squirms in your arms in a writhing mass of limbs and gnashing teeth. Though to you, such pathetic resistance feels like you're getting a world-class massage. Mh such a good kitty, you've been trying to work out those knots for a while now, you jeer rubbing the riotous surface of your tummy.";
					WaitLineBreak;
					say "     Enjoying the feeling of your body churning along, you find yourself settling into a nice groove alternating your attention between caressing your clit and engorged nether lips. You almost bite your lip as you lustfully jill a pair of fingers about the lush walls of your gushing muff. You can feel your own dew dripping down your wrist as a twisted idea forms in your mind. You tuck your fingers together in a spear then thrust, hilting yourself to the wrist in your velvety depths. Slowly, at first, you piston your hand along the satin walls of your [cunt size desc of player] passage, stroking your needy sex as your juices are running down your arm in a molten river of voracious desire. You allow yourself to fully cut loose as you roughly buck your hips with each motion, sending the most delectable quakes through your swollen middle, further spurring on your prey's fleeting struggles. Their every quivering frantic motion sends fresh rolling waves of pleasure over your thoroughly packed frame as they rage against their confinement. Riding out these currents of unnatural bliss, your free hand explores your quaking middle, murmuring cruel taunts to the beast as you do.";
					say "     This only serves to egg the mutant on, much to your delight as its body thrashes inside you like an overclocked sex toy, teasing your depths in ways you once never even dared to dream of. Sadly you can hold so long as you, almost angrily, feel yourself peaking. Then like a cord snapping, you feel your climax hit blaze though your core in a flash of sinful tightness and tension, that's then washed away in a tide of cool relief. Unfortunately before you can even consider another go, the manticore's pawing begins to weaken as either the lack of oxygen, or the uncaring bite of your stomach acid catches up with it. Feeling a bit cheated that your toy is running out of batteries so fast, you prod and grope your meal desperately trying to coax some life out of them. But it's too late, you feel them sag to one side of your gut like a rock as they pass out either from oxygen deprivation, or from being claimed by your digestive juices. Come on lazy bastard, you fume, poking your prey filled midriff, to no avail. Shit, well hope this thing makes better padding than a toy.";
					WaitLineBreak;
					if "Safe Appetite" is listed in feats of player and scalevalue of Player is 5:
						say "     You huff, pawing at your stomach as gurgles and balloons into a perfect dome of verdant excess as your nanites generate the excess stomach acid needed to break down such a large meal. This sinfully swollen state doesn't last long, already you can feel the manticore's body dissolving into fuel for your [bodytype of player] body. Though the beast's mass doesn't seem to vanish like your usual prey. Already, you can feel their spread to all the right places as your breasts suddenly grow hot. Placing an inquisitive hand along your [bodytype of player] curves, you can feel the succulent flesh throb and creak with activity as your breasts swell a full cup size in the span of a heart beat, then a second, and a third as the raw ripe tissue slips between your fingers. Hefting your considerably larger breasts, you have to admit you're not exactly disappointed with these results, even though your exotic constitution should be resistant to such changes.";
						say "     If anything, your enhanced bust feels like a trophy, it's too bad your other prey isn't so considerate, you opine, running your hands over the supple surface of your enhanced chest. Till it suddenly dawns on you, you just [bold type]ATE[roman type] Drake's knife, how in the heck are to *BURP*! You belch hard as a wild spasm wracks your throat you feel as if something deep within you is about to rip or tear as the convulsions roil about your core. Till you hear a loud *Clunk* as the knife pops out of your mouth and onto the ground at your feet. How... your internal monologue stammers trying to process this, but you stop yourself, best not to contemplate this latest spore of fresh unfiltered madness. You have the knife, yes it smells like boiling hot bile, and the blade appears horribly warped, but you never promised to find it, so Drake most likely won't care. Well, you hope that will be the case, you muse, as you wipe the thing off tuck it away for later.";
						now Old One Eye is Resolved;
						Increase Breast Size of Player by 3;
						PlayerEat 20;
						ItemGain Tainted Blade by 1;
						now Hunger of Augustus Drake is 3;
						TraitGain "Mx's Mantle" for Player;
						if "Mighty Mutation" is not listed in feats of player:
							FeatGain "Mighty Mutation"; [Clawing teeth and gnashing limbs, these are our favored hymns! We hear their call above the din!]
					if "Safe Appetite" is listed in feats of player and scalevalue of Player < 5:
						say "     You grumble, massaging your hard working stomach as your body's predatory nanites eagerly ply their well-honed craft to your latest morsel. Your bulging tummy slowly shrinks back down to more potable size, yet not all your prey's mass appears to be so readily absorbed by voracious nanites. You somehow sense, on some level, an enduring remnant of their own mixed up strain bonding to your [bodytype of player] body. A strange, yet not entirely welcome heat seeps from your core, you can feel it spread to your bust. You soon find yourself panting with unvarnished Elysium as your [breast size desc of player] chest appears to drink in your prey's odd nanite cocktail, becoming rounder and tauter by the second. Gazing at the perky wobbling mounds balanced ever-so-perfectly on your shrinking tum, your hands are drawn to raw supple orbs as they practically cry out for your attention as they continue growing. Unable to resist their sweet sirens song, your hands almost acting of their own accord gleefully explore the magnificent curves of enhanced chest, eager to lavish some much deserved attention on the ripe virgin nerves lining your [breast size desc of player] tits.";
						say "     You cup the artful curves of your decadently padded chest, delighting in the sensation of the taut [skinname of player] skin of your enhanced bust playing across your digits as they wallow in your grasp. You realize your prey's nanite's aren't done with you yet, sensing the heady echoes of this sudden, but not wholly unappreciated expansion spark through your voracious being like Saint Elmo's fire dancing across a tall ship's hull. Your body begins to grow before your eye almost if it were jealous of your gloriously-endowed nips. The ground appears to slip away from you as your [bodytype of player] body swells larger with every beat of heart and only stops when you've grown to the size of a delivery van. Oddly though, you don't feel the slight bit of alarm at this sudden development, despite your resistance to such post-meal changes. If anything your enhancement feels like a trophy, you think to yourself, gazing at expansive your form with a voracious smirk. A part of your nanite-saturated mind takes a bit of predatory pride in the effect your newest meal has had on you.";
						WaitLineBreak;
						say "     If only all your prey were so potent, you'd be a proper kaiju by now! You muse, strolling over to the clean pond to marvel at the reflection of your enlarged figure and the delectable jiggle of your enchanted bust. Though as you calm down, and your more rational side begins to resurface, it suddenly dawn on you that you just [bold type]ATE[roman type] Drakes knife, how in the heck are to *BURP*! You belch long and hard, and with enough force you feel like you're about to tear something important yet just your body feels like it's about to give. *Clunk* The knife pops out of your mouth and onto the ground at your feet. How in the... your mind tries to process this fresh spore of raw unfiltered madness, but you stop yourself. It's probably best not to think too deeply about how this freaky facet of nanite plague works, you probably don't want to know the answer anyways. You have the knife, yes it smells worse than a sweaty Messy Pig's arse, and yes the blade looks like just did a tour of duty up Xeno Drone's backside, but you never promised to find it, so Drake most likely won't care. Well you hope, as you tuck the blade away for later.";
						now Old One Eye is Resolved;
						increase Breast Size of Player by 5;
						now scalevalue of Player is 5;
						PlayerEat 20;
						ItemGain Tainted Blade by 1;
						now Hunger of Augustus Drake is 3;
						TraitGain "Mx's Mantle" for Player;
						if "Mighty Mutation" is not listed in feats of player:
							FeatGain "Mighty Mutation"; [Something Something the author likes cheesy foreshadowing!]
					if "Safe Appetite" is not listed in feats of player:
						say "     You snap before laying back down on the soft grasses, muttering to yourself about how selfish your prey is to deny you your fun. Oh well, at least they can't take this away from you, you ruminate, running your hand over the warm gurgling mass of your tummy. Your hands roam the turgid curves of your prey-packed tummy tracing lazily circuits in the bountiful taut tissue as your hard working nanites feast upon your latest prey. With every pass of your elated fingertips, you can feel your being steadily absorbing your rich meal's exotic nanites as thin yet downy soft dusting of vermillion fur slowly blossoming into being on the taut apex of your swollen gurgling tum. Already accustomed to such post-meal occurrences, you feel neither fear nor revulsion at the sight of this sudden change, but rather as a sense of unbridled curiosity welling in your core. Besides what's wrong with a little show after such a fine snack, you ruminate, running your palms over the warm velvety carpet of crimson fur spreading over you.";
						say "     It feels so inviting to the touch and the rich red hue matches your sanguine disposition so wonderfully, you ruminate while your hands glide along the lush borders of your pelt as spill down the edges of your prey laden tumby in a wave of iridescent red fur. A part of you can't help but relish the sensation of your inquisitive digits dancing along the satin hair. ";
						if nipple count of Player <= 2:
							say "Though as you indulge yourself in this simple tactile pleasure, your finger eventually brushes a sensitive series of bumps lining your sides. At first, you suspect these are some more, [']durable['] remains of your meal, yet as your fingers explore the tender territory. You note, these aren't remnants of your prey, but the beginning of four petite tummy teats forming on the flanks of your [bodytype of player] midriff. At any other time, there's a chance you might have found such accents off-putting. However, some twisted segment of your nanite-inundated mind, regards their presence as rather... enticing, you think to yourself as your mitts cup the nascent orbs, delighting on some level at sweet contrast between your tight prey filled core these supple furry nips.";
						else if nipple count of Player > 2:
							say "As a light, yet pleasant tingling sensation simmers across your extra breasts as they drink in this sudden rush of potent nanite laced nutrients. You almost coo at the feeling of raw and ripe virgin nerves wink into being as their supple surface swells in your in your grasp. That pairs so elegantly with the tender caress of your spreading pelt, coating them in glossy embrace, you muse, as you hand roam the pleasantly heavy orbs coddling your prey stuffed core.";
						WaitLineBreak;
						say "     Mh so soft, you purr, tweaking one of your fuzzy teats while you watch the steadily advancing field of red fur roiling over your being as if a curtain of crimson twilight were being drawn over the stillest of seas. Everywhere your pelt touches, you observe a subtle shift in your body as your form drinks the blissful waves of change and becomes ever more beastly. Once your chest is fully encased in the rich red hair though, your core starts to grow larger and barrel-esque, but also more defined as if your body were making space for something. Regrettably, you hardly have any time to contemplate what it may be as the fur spreads down your arms and your biceps ripple and thrum with actives as your powerful muscles reshape themselves into toned sculpted hills of raw bestial might.";
						say "     You mitts to go hot to the touch, as they flow outward into a streamline hybrid of sapien and feline design. Flexing your dominant hand, you observe the growing outline of robust black paw pads swirling into being on your palms alongside the tactical indentions in your fur concealing your retractable claws. Reasonably curious about their appearance, you flick your talons out with an exaggerated flourish accompanied by a satisfying *shing*. Beautiful, you simper in a low hush toned, marveling at the length and opalescent quality of the available light waltzing across their sickled edges. Could get a lot of use out of these, you rumble with almost catty trill as you sense the slow sensual kiss of your pelt flowing down your legs. Already enamored with your changes, you're unable to repress the urge to prop up your dominant leg into view. You watch as they twist into a proper digitigrade stance as they're toned, lightly-muscled structure is engulfed in an ocean of sparkling ruby vermillion fur.";
						WaitLineBreak;
						say "     Once it touches your feet though, your paws-to-be gracefully expand out into a saucer-esque shape as your flesh flows like water into a feline configuration tipped with lengthy ivory talons, and cradled by dense black pads. While a slight pinching sensation nips at your heels, curious as to its source you tilt your paw sideways, then spot the sudden emergence of a single umbral boney stiletto. Transfixed by the sight, you hardly even notice the changes steadily sweeping up your neck, vibrant reds cradling you briefly gives way to the purest of black fur that coddles your throat protectively as it flows outward in a dense ring of shimmering ebony. Enamored by the gentle caress of the silky fuzz, you playfully rub your chin against this swelling quasi-mane while it spills down your collar, forming a shapely tuft of fur nestled neatly between your uppermost breasts.";
						say "     At least that's how it looks from your current angle, you note with a Cheshire grin as your gaze is drawn to the mirror-like surface of the nearby pond. You pick yourself and strut over to the pool with forced sensual sashay imparted by your form's natural heels. Ow, nice, very nice, you purr at the sight of your ";
						if "Touched by Madness" is listed in feats of player:
							say "almost three meters tall Amazonian figure's reflection. ";
						else:
							say "nine foot tall Amazonian figure's reflection. ";
						if "Touched by Madness" is listed in feats of player:
							say "To your eyes, every centimeter ";
						else:
							say "To your eyes, every inch ";
						say "of your augmented physique radiates with power and lust as if it were hewed from glistening red obsidian. Your gaze drifts along the crimson curves of your sculpted hourglass waist while you observe the clinical definition of the dense muscles lining your limbs. Alongside the artful swell of prey-filled tum, the inviting bounce of breasts, and pronounced sway of your breedable hips that accompanies your every motion. However, as your pelt closes in on your [FaceName of Player] face, your vision starts to crack and distort as your jaw expands outward becoming a facsimile of a proud leonine form.";
						WaitLineBreak;
						say "     Thankfully, this aberration passes rather quickly as your head rapidly reshapes itself, but not before you notice a series of ebony lumps peeking from under your fur atop your head. Alarm flashes across your mind like sparks cascading off stuck flint as this midnight-hued matter curves about your catty ears, where they ossifies into goat-like horn tipped with golden points. Giving one of your handle bars a light tug, you mentally remark at both their toughness as well as their sleek glassy texture, like they were poured from the Void itself. Finding, on some level, this to be a rather endearing trait, you do a play twirl to get a better view of your bestial accents. On the third or forth pass however, you spy a subtle set of bulges on the trapezius of your back and tailbone decorating your pleasingly thick ass. Intrigued, you contort yourself slightly for better look then watch as your pelt ripples and shifts into a pair of alabaster white wings and long chitinous jet-black scorpion tail.";
						say "     At first the new limbs feel numb, almost like they'd fallen asleep. Yet with each breath, or attempt at manipulating them, sensation along with the last remnant of your prey's nanites floods your exotic being. You ruminate, ogling your tummy as it shrinks into subtle washboard abs, capped with a sensual layer of dense fur, though a part is already starting to miss the sight, not to mention the sensation of forbidden fullness your prey laden bump gave you. Still, you take some measure of solace in the knowledge that there's more out there. This body certainly seems built for catching them too, you muse, feeling your athletic thighs and robust wings tense with a potent mix of anticipation at the thought of chasing down some hapless prey. Then again, why eat them when you can adopt them, it would only take a few stings from your tail before they start begging you to claim them. Who knows, you might even find yourself some nice virile cats worth playing with.";
						WaitLineBreak;
						say "     There's bound to be one or two deserving kittens out there who could pump a nice fat litter into you, you think to yourself, running your padded paws along the luxurious fur gracing your midriff, picturing your womb growing round and taut with a [one of]cute clutch of cuddly cat taurs[or]a bountiful brood of anthro kittens[or]a squirming litter of feral cubs[at random] while your new nips get nice and perky as they fill with warm, delicious cream. A part of you even flirts with the notion of [bold type]milk[roman type]ing yourself in the future, you ruminate, giving your tummy teats a love stroke.But that will have to wait, right now you have to get Drake's knife and... oh crap baskets.";
						say "     You hiss, as it suddenly dawns on you. You just [bold type]ATE[roman type] Drake's knife, how in the heck are going to *BURP*! You belch, hard, as your neck muscles are wracked with a heavy spasm that's punctuated by loud wet *clunk* as the knife pops out of your mouth and onto the ground at your feet. How in the... your mind tries to process this, but you stop yourself, best not to contemplate the depths of the Nietzschean abyss that is the nanite plague. You have the knife, yes it smells like boiling hot bile, and its blade appears to have warped [']slightly['] after being exposed to your stomach acid. But, you never promised to find it, so Drake most likely won't care if you return it in this state. Well, you hope that will be the case, you muse, as you wipe the thing off, then tuck it away for later.";
						now Old One Eye is resolved;
						turn the Player into a "Hermacore";
						choose a row with Name of "Hermacore" in Table of Random Critters;
						if Nipple Count of Player < 6:
							now nipple count of Player is 6;
						increase Breast Size of Player by 5;
						increase Cunt Depth of Player by 3;
						PlayerEat 20;
						ItemGain Tainted Blade by 1;
						now Hunger of Augustus Drake is 3;
						if "Mighty Mutation" is not listed in feats of player:
							FeatGain "Mighty Mutation";
						TraitGain "Mx's Mantle" for Player; [Excerpts from: The Chant of The Chaos Dragons]
			-- "Unbirth them.":
				say "     Looking the creature over, a part of you can't help but feel sorry for them, did they choose to turn into this? Did they want to be a mindless feral, endlessly breeding and feasting with no care for the future, or who they hurt along the way... Actually that does sound kind of fun, a part of your altered mind quips, but you ignore it, because you can help them. Your children don't go around hurting people, so wouldn't it be better if you made them one of yours? You could keep them safe, out of trouble, and, aw fuck it who the heck are you kidding?! You sigh internally, you're a bumpaholic who just wants to see how far this guy will stretch you out before the nanites turn him into your next bundle of joy. Of course, you just need to take care of one thing first; that knife thing needs to go. You are [bold type]NOT[roman type] passing some cursed stinky trench knife when the time comes. Now you just need to get the thing out of there, and you have a good idea how.";
				say "     Making your voice as sweet as possible while stripping any covering you may have and making sure your groin is on display, you call out to the creature. It darts up and looks around in response, but it's still very clearly not feeling well from the way it stumbles and shakes on its paws. Interestingly, despite the hackles rising on its back, it hasn't bared its fangs, so hopefully that's a good sign, you think to yourself as you call out to them again. Now-now, you begin, you're not going to hurt him, you tell them in your calmest tone. Though the beast gives no indication it believes this pronouncement, it doesn't charge either, so you take a step forward. That however earns you a half-hearted growl. Hey calm down, you just want to help with that, if they let you, they'll get a treat, you inform the creature gesturing at its eyes then your groin as you take another step. This time it doesn't growl instead fixating on your groin like a [']normal['] mutant would. Continuing to get closer, you grin to yourself as you notice its hot pink cock peeking out of its crimson sheath. What a simple horn ball, this is going to be a walk in the park. You opine slowly take a step forward.";
				WaitLineBreak;
				say "     You're careful never to move too fast as to be considered a challenge or a threat. Naturally, you also keep your assets in firm view the whole time. The manticore seems to relax as you get closer becoming more fixated on your bits than anything else. When you get your junk close to its snout, he tries affectionately lapping at your groin with his kitty tongue, but you stop him with a ";
				if "Touched by Madness" is listed in feats of Player:
					say "light boop of the snoot. "; [Vulcan: I want to boop the snoot!]
				else:
					say "gentle tap on the nose. "; [Corvus: Oh no, don't you dare boop that merry little suicide bomber's snoot!]
				say "Oh looks like kitty wants a taste, you simper giving the feral a loving head pat. 'Rrrua,' it grumbles, brushing its head against your legs. Ok, but first kitty needs to let you help them, you tell it, traipsing your digits along the area below their injury with a tender brush of your fingertips. A part of you expects them to resist, but instead they cup their head in your hands, purring loudly as you pet their boxy muzzle. What a good boy, you praise him while lightly tugging them to the pond's edge by their mane to clean their wounds. Standing at its banks, you confirm the pool is pure and clean unlike most of the jizz-tainted puddles on the plains.";
				WaitLineBreak;
				say "     Which is probably why they are here in the first place, you note, scooping some up you wash off their eye. You find the damage has mostly healed. It was just caked with dust and tears from the manticore pawing at it in a failed attempt to get the thing out. Looking them in their good eye, you tell them in a calm caring tone that this will hurt, but that they have to do their best to hold still. You're not sure if it understands you, but it makes no effort to back away as you grasp the knife handle. Ok, here goes, you wince jerking the blade up and out, with a slick *PLOP* it comes loose and the tissue steams and knits before your eyes. You guess the nanites were waiting for that. The manticore doesn't make a sound through the affair, but once it opens its eye for the first time in who knows how long it roars in delight. Before playfully headbutting you to the ground, it looks like they want their lollipop now.";
				if Cunt Count of Player >= 1 and Cock Count of Player >= 1:
					say "     Immediately, he pounces on your cock, lovingly wrapping his thin feline lips around your futa [cockname of player] dick. The manic manticore tries his best to take as much of your herm dick as possible from his position. Thankfully, his muzzle takes the whole thing in graceful stride as his snout is easily able to handle all [cock size desc of Player] of your dick with ease. You can feel the horny cat's rough tongue coil and engulf the length of your [cockname of player] tool as he languidly teases the underside of your cock with loving laps of his fleshy barbs. The manticore sneaks his paws and tail around your hips and grabs hold of your [tailname of player] ass for leverage while tenderly bobbing his snout along the [Cock Size desc of player] length of your [cockname of player] [one of]cock[or]dick[or]rod[at random]. Fuck, muzzles are amazing, you coo feeling your eyes almost rolling back into you head, as the odd ridges of their majestic maw and silken spines service the unique shape of your elated cock like the worlds most interactive fleshlight.";
					WaitLineBreak;
					say "     Looking down at your well-pleased plaything, you can't say that you're not enjoying the view either. Seeing such a perceived apex predator blissfully purring along as he diligently bobs his head along the length of your [cock size desc of player] rod like his own salty treat, sends delightful chills down your spine. Not that you'd ever make a move to stop him, you're not about to turn down a free blowjob! Especially one that feels this good, his purr is practically tuned for your pleasure, vibrating your cock flesh in sinfully sweet ways while his tongue lovingly roils about dick swaddling your tool in blissful warmth and sensual caress of his exotic spines. Good boi, take that futa cock, you laugh, stroking their ears and petting their scruffy mane in encouragement. Rumbling happily, your little kinky kitty friend rubs his head against your cock and sack as he lewdly slurps the entire length of your cock, only stopping to lap at your nuts affectionately.";
					say "     You can only babble an incoherent thanks in reply though as your partner starts using a little bit of fangs to graze the base of your shaft. Your heart races with fear and arousal as their razor sharp teeth dance along your [cockname of player] member. Damn, the big cat knows what he's doing. His fangs never linger too long on your sensitive flesh to be threatening but enough to give the heady thrill of perceived danger. Lost in your own personal Elysium, all you can do is dig your fingers into his mane and hold on for dear life as the horny feral has way with you. Your antics earn you a low warning growl as you tug on his mane perhaps a bit too hard, though you don't pay it much mind, or notice subtle wrinkling of their pelt with aggravation. You're focused far more on the delightful cocktail of his barbed tongue lavishing your throbbing cum vein, the bountiful bliss of his ribbed maw caressing your dick, and the thought of feeding your toy a nice hot meal before you claim them. They deserve one last treat before you take them, one that you're very eager to provide.";
					WaitLineBreak;
					say "     You muse, already fantasizing about what your body will do to them as the satin pelt brushes your inner thigh in an invigorating rhythm. As each lap of their tongue evokes new and exotic possibilities that flash along the surface of your mind, you picture all the delightful forms your newest child could take. How you can remold them into the perfect child, or plaything. Naturally, they have no way of knowing this of course, and that feeling of power over them alone is almost as intoxicating as the feeling of their muzzle lavishing your sex. On some level the manticore seems to pick up on your budding excitement, most likely it's merely assuming you're simply enjoying its performance, and you are. Although not for the base reasons it suspects as he gives your [TailName of Player] ass a not-so-gentle squeeze with his claws and prick with his lust-inducing tail. This unsubtle touch elicits a low needy whine from you as the unusual contrast of soft mushy paw pads and rough fur caressing your backside sends a toe-curling tingle down your spine.";
					say "     You soon find yourself bucking your hips in his grasp trying to force more of your [cockname of player] tool to the back of his throat. Impressively, your [one of]leonine[or]feline[or]mythological[at random] mate has no gag reflex, and even as his vibrating throat teases your dick head like a well-tuned living cock ring keyed for your pleasure. He doesn't relent in the slightest in his desperate attempt to please his perceived savior. Swooning, you try to hold on just to edge out a few precious seconds with him, to ";
					if CockName of Player is listed in infections of TaperedCockList and CockName of Player is not listed in infections of BarbedCockList: [Note to Prom: Inform has been acting a little weird when I tried doing something like this during Drake's dom scene, so I'm adding the extra 'nots' to prevent multiple lines from showing up.]
						say "revel in heady innervation of your gracefully tapered rod as the exotic sensation drives you closer to the edge. ";
					else if CockName of Player is listed in infections of BarbedCockList and CockName of Player is not listed in infections of TaperedCockList:
						say "luxuriate in the blissful interplay of your mutually barbed anatomy of your animalist tool as the exotic sensation drives you closer to the edge. ";
					else if (( CockName of Player is not listed in infections of TaperedCockList and CockName of Player is not listed in infections of BarbedCockList) or (CockName of Player is listed in infections of TaperedCockList and CockName of Player is listed in infections of BarbedCockList)):
						say "indulge in affectionate treatment of your cock as the exotic sensation drives you closer to the edge. ";
					say "Heat and tightness flare up from within you and cascades over you like a blissful fever as, acting in instinct, you grab them by the scruff and hilt your cock down his waiting maw. The manticore again makes no effort to resist you as you climax, coating your soon-to-be-prey's palate with a rich vaneer of virile excess.";
					WaitLineBreak;
					say "     Unable, or unwilling, to contest your rough treatment, he hungrily swallows every last drop of jizz your hybrid body can produce. With only a subtle yet needy mewl escapes their lips as you watch his tummy swell with your tainted seed. Their once toned body going from a smooth washboard abs into a bright red sloshing dome tucked neatly between their legs. A part of you can't help but grin at the sight of the once proud beast now reduced to a mewling cum catcher. They don't even try to get away from you either. Seemingly content to lazily nurse your slowly softening tool clean. Regretfully, you have to take the initiative and gently pull your cock free and playfully wipe your dripping [CockName of Player] rod off on their soft cheeks. Oddly, the manticore doesn't seem to mind. If anything he seems pleased with this as they happily paw at their bloated body almost as if they were drunk on cum.";
					say "     He purrs like a well-oiled motor, as he meekly rolls on his back, with a dopy look on its face as he suns himself. You watch the big cat knead his beautifully swollen belly with his cute kitty paws like he just ate a world class feast. Aw, what a good boi, would the kitty like a tummy rub? You coo running a hand down his side and gently massaging his thoroughly abused guts. They grumble something that could be interpreted as gratitude as they stretch out their legs revealing the full magnitude of your work. Looking at them, a part of you takes a great deal of pride in the way their tummy spills over the sides as it heaves wonderfully every time they take a breath. Why, they look positively gravid at this point.";
					WaitLineBreak;
					if "Maternal" is listed in feats of player:
						say "     Smiling at the thought, you trace a finger along their soft drum tight pelt coating their stuffed furry belly, teasing the manticore that it's too bad you can't actually breed them, this is such a good look for it, you wouldn't mind making it a permanent one. As you work your way along their sides, you can't resist playfully kissing and fondling your way down their tummy fur till you get a nice view of plush cat cock and hefty balls brushing against the rust-colored pelt of their stomach. Snickering at the sight, you gibe about how you could give them a sexy little cunt here, as you pat the area between his tail pipe and fuzzy nuts. Maybe a big fat set of hippity-hop balls to rest on, you trill jostling their sack in the palms of your hand. Perhaps a few pairs of cute milky tits for you and the kittens to enjoy wouldn't hurt either, you simper, massaging the fluffy fur of their flat chest. It would be a wonderful look on them, but sadly not everyone can be as lucky as you are to have the best of both worlds, you taunt, giving their tight sheath a gentle stroke which sends an elated shiver down the creature's being.";
						say "     But you can fix that, you purr as the manticore's cock wrapper throbs in your hand. You can give a tasty pussy and a nice thick futa cock and cute little pussy all their own, so they can have all the fun just like you do. You'd bet love being your personal broodmare wouldn't they? You query, as the manticore pants happily at your touch. Something tells you that they'd love being stuffed every morning and letting them ride you every evening. Getting to watch your cute little kitty titties growing bigger and milkier with every litter till they're nothing more than a happily mewling kitten factory. Shit, you need them inside you NOW! You cry sauntering around the manticore you balance on yourself on your back positioning your cunt over his muzzle while using their silky chin as a convenient ball rest telling them to dig in.";
					else if "Maternal" is not listed in feats of player:
						say "     Snickering internally at the notion, you run your hand over the silky smooth swell of their cum-bloated tummy, praising the little cock sucker and opining aloud that they might make a good pet. They've certainly got the drive for it, but their current form is rather... limiting to an inter-gendered person like yourself. Lucky for them, you tease gliding your fingers down their fuzzy happy trail, you're more than equipped to [']help['] them out in that regard. You simper, as your hand brushes their virile cock wrapper. You languidly stroke their plush fuzzy pelt swaddling the length of their dick, eagerly working further south and telling them how cute they'd look with an adorable pussy of their own. While your fingers gracefully slip about their crimson goose-egg-sized sack, you tempt them with the thought of having some fat knee-knocking cum tanks too. Just imagine the wonderful creampies that they could give you, you swoon as you lean over their pungent yet delightfully musky orbs and lay a tender kiss upon the mewling feral's crimson sack.";
						say "     Purring happily at the loving touch of your lips, the manticore purrs like a well-oiled engine as tongue lolls lazily out of its muzzle as you kiss your back up its swollen midriff. As your chin crests its toned flat pecs, you tell how wonderful they'd look with a lush set of furry cock pillows to really tie their look together. Just imagine, you taunt, running your palms over rich red abs, how delightful it would feel to have strong, beautiful, dominant herm's cock nestled between them as you rode its exotic body. Or, the delectable meals the pair of you could share, if you ever deemed them worthy of carrying a litter or two of your cubs. Wouldn't that be lovely, you tempt, pressing your [Breast Size Desc of Player] chest against theirs. Though you doubt it understands you, your prospective plaything mewls needily in response, perhaps interpreting your antic as desire for a round two. Well if that's the case, no point in keeping them waiting, you opine sauntering around the manticore you balance on yourself on your back positioning your cunt over his muzzle while using their silky chin as a convenient ball rest telling them to dig in.";
					WaitLineBreak;
					say "     They bleat something in response, but they don't resist you as you guide their head under your drooling [CockName of player] cock towards your sopping snatch. His breath and whiskers brush along your inner thighs as you spread your nanite-altered lips eagerly to receive them. Your fertile passage yields to them, parting like supple silk as your [bodytype of player] form makes way for your newest cub. Without much resistance, your soon-to-be child's head quickly slips past your nether lips with a lewd, moist, squelching noise, every nerve that they caress, every fold that they touch sends fresh a spark of apocryphal euphoria along your spine. Though even a body as malleable as yours still has its limitations, you have to buck your hips as you guide the stupefied creature to their final destination as their shoulders grace your labial depths. Only when their wings hit on your knees do you truly have a challenge. Not wanting to have them get stuck, you swiftly tuck their massive wings along their sides just as your next contraction hits.";
					say "     So soft, you pant with elation as their wings effortlessly glide between the lips of your honeypot, carried by the forceful muscles of your altered muff. You can't help but coo with delight as their feathers caress your sack and inner thighs, sending waves of toe-curling rapture as the satin quills worship your [cunt size desc of player] cunt, or feel the raw lustful twinge of excitement as a cute bulge begins forming on your [bodytype of player] midriff as the manticore's body is effortlessly pulled in by your enhanced muscles. Peering down at the manticore's rapidly vanishing form, you watch with no meager modicum of pride as your body subsumes the creature's chest just on the edge of their swollen paunch, you lick your lips with anticipation at the thought of claiming such a well-stuffed specimen. Their bulk resists you for a succulently sweet second, but your body won't be denied its latest prey. Your morphic hips and muff greedily flow over their distended tummy like water.";
					WaitLineBreak;
					say "     Your body expands to make room for your prey as your muffin top balloons in tandem swelling large and opulent with the manticore's plush frame. Unwilling to be a completely passive participant in this affair, your rowdy child-to-be meekly squirms and thrashes about as their paws slip inside your hungry depths. Their feeble struggle barely registering as little more than the tenderest of ministrations. Occasionally, they bump your prostate, putting delightful pressure on your male g-spot, and in turn, your cock throbs from the stimulation almost begging for attention. Well, no point restraining yourself at this point, you ruminate, lightly gripping the base of your [cockname of player] dick for another round as its growing mass fights for space with your swelling womb. You feel your turgid member pulses in tune with your heartbeat as you languidly work the length of your [cock size desc of player] tool with long drawn out relaxed motions.";
					say "     You resolve not to cum just yet, you want to hold out till your prey's well and truly inside you. As you marvel as your tummy swells into a towering fertile dome of opulent excess till you're forced to lie helplessly under the sprawling mass of your own womb. Your [SkinName of player] hide almost creaks from the pressure and you can also see the outline of the beastly manticore's body settling into the fetal position. Still, keeping your pace measured is hard with the weight of your womb pressing down on your futa cock and hybrid erogenous zones. Your eager feminine flesh is ravished by the kiss of feral's paws playing off your fertile flower, and [cock size desc of player] dick. You can already see the rust-colored fur of the manticore's lower body vanishing between your legs. Only the sagging edges of their cumflated stomach and their dangling paws remain, though not for long. You can feel your snatch rapidly stretches out perfectly sheathing their soft fleshy spines and plump balls in ways you never thought possible.";
					WaitLineBreak;
					say "     Such a wonderful dick they have, you sigh giving your cock a languid series of long drawn out strokes timed to each pseudo-contraction while they clear their lower body. But, maybe you can give them a better one once they're all nice and prettied up, you joke between breaths as their legs and tail are drawn in with a final pull that rocks your overburdened bump like a bowl of jello. Only then do you let yourself cum, basting your intersex form in warm globs of jizz that you shamelessly let dribble over your tummy and down your leg where it puddles into a silver glaze next to the watering hole, but you're still not done, wringing the last few drops of deviant delights from your prey. Already your nanites flood your womb with transformative fluids hellbent on reshaping the manticore into your ideal child. You'd be lying to yourself if you said that you don't enjoy watching your hypertrophic uterus balancing itself upon your legs.";
					say "     Laps are overrated after all, you muse, sensing your body preparing itself for your last child. You can clearly detect the sweet changes racking your form as your breasts perk up in preparation, and a trickle of rich cream leaks from each of your [breast size desc of Player] tits. Well, waste not want not you muse, pressing your burgeoning boobs against your [facename of player] lips and greedily suckle down a mouth full of thick mothers milk while your hands massage the sloshing mass of your tummy, both to soothe yourself and to exalt in your accomplishment. Your mitts roam your curves in awe of the size you've achieved as you paw the outline of the manticore. They might not be the largest or most exotic creature you've unbirthed, but they were definitely one of the more fun ones, you opine, hugging your stomach as the creature regresses to a more childlike state.";
					WaitLineBreak;
					say "     Regrettably your body does return to its 'normal' pregnancy size, the manticore now reduced to a fraction of its prior majesty as your nanites rebuild them into your latest child. Even now you look on with pride as your belly blossoms outwards into a proper bump. Sadly, you won't get as long as a normal pregnancy to indulge in the changes, but the world can't be perfect. Still, you found Drake's knife, and you got to have fun at the same time, so you can chalk this day up as an absolute win.";
					now HeadName of Child is "Manticore";
					now TorsoName of Child is "Manticore";
					now BackName of Child is "Manticore";
					now ArmsName of Child is "Manticore";
					now LegsName of Child is "Manticore";
					now AssName of Child is "Manticore";
					now TailName of Child is "Manticore";
					now HeadSpeciesName of Child is "Manticore";
					now TorsoSpeciesName of Child is "Manticore";
					now BackSpeciesName of Child is "Manticore";
					now ArmsSpeciesName of Child is "Manticore";
					now LegsSpeciesName of Child is "Manticore";
					now AssSpeciesName of Child is "Manticore";
					now TailSpeciesName of Child is "Manticore";
					now ubpreg is "Manticore";
					now gestation of Child is a random number between 8 and 16;
					now pregtype is 1;
					increase ubcount by 1;
					now Old One Eye is Resolved;
					ItemGain Drake's Blade by 1;
					now Hunger of Augustus Drake is 4;
					increase Breast Size of Player by 3;
					TraitGain "Mx's Mother" for Player;
					if "Safe Appetite" is not listed in feats of Player:
						infect "Manticore";
						infect "Feral Gryphon";
						infect "Succubus";
						infect "Felinoid";
						infect "Werewolf Brute";
				else:
					say "     Landing with a small thud, the manticore leaps forward, casually pinning you down with one paw before briefly lavishing your chest and [bodytype of player] core with gentle kisses and eager nuzzles. Unwilling to resist such a show of affection, you allow him his fun, and instead reach out to gently pet his silky mane and saucer-shaped ears encouragingly. Rumbling happily at your touch, the big cat creature languidly works his fuzzy muzzle down to the cusp of your groin, he pauses to fix you with a humble yet needy look as if asking for your permission to continue. Smirking, you signal your consent with a magnanimous wave of your hand. Mewling happily, the Manticore unceremoniously buries his vermillion head between your legs while his delectable textured tongue plays across your willing folds, diligently caressing your sensitive lily lips with each pass of its dexterous surprisingly-smooth oral muscle.";
					say "     You have to suppress a giggle at both the sensation of its whiskers tickling your inner thighs and the warm wisps of its breath dancing along your [Cunt Size desc of Player] cunny. The manticore purrs like a fine-tuned jet engine, as he eagerly nurses your clit and happily toys with the hood of your button with his spined tongue like it was his own little sweet treat. Ever the gentle lion-morph, the manticore is careful not to graze you with its fangs, content to merely worship your pussy with his oddly soft yet rough tongue. The deep bass of his purr massages your tender box, sending blissful ripples up and down your fecund flower like fingers of erotic lightening. Poor thing, if only it knew what's coming next. You muse, taking hold of their mane and gently press your cunny over their muzzle in deviant parody of a kiss.";
					WaitLineBreak;
					say "     Perhaps enraptured by your flavor, your feminine scent, or the thrill of being handled by a dominant partner, the manticore doesn't resist in the slightest as your body gradually begins to pull him in deep. If anything, you note, listening to his loving purr, he seems to enjoy your assertive hold. What a good boy you think to yourself, stroking his ear encouragingly as more and more of his head passes between your lips, sending sparks of aberrant delight along your elated folds as your cunny stretches to accommodate them. That's right, eat up sweetie, you stammer delighting at the sight of their head passing under your clit without any effort on your part. As if on cue, your predatory nanites, most likely sensing prey, kick in. You feel your hips relax, lips loosen, and cervix dilate in preparation for the Manticore's rebirth. Not that the manticore notices, or could even comprehend the maternal hunger welling within you. He seems more than happy to let himself be pulled in by the nanite-altered muscles of your cunt.";
					say "     Maybe he thinks you'll let him out, and you will, just not right away, you think to yourself patting the mutant on the head as he pleases your [cunt size desc of player] muff. You lie back and let your eager prey work their way deeper inside your eager passage, luxuriating in the sensation of their soft furry form slowly filling your engorged sex with his toned physique. Already, you can see the outline of their muzzle bulging under your taut tummy flesh, their ears just barely visible above your feminine mound. Lovely, you rumble stroking your pliable nether lips as your malleable muscles guide them further inside you till their snoot is practically nuzzling your womb. At their touch, your body's aberrant nanite's activate fully. At once, your malleable passage is rocked by the most blissful of spasms as your eager muscles clench and caress about the Manticore's [one of]leonine[or]feline[or]mythological[at random] form as their rapidly pulled in up to their shoulder blades with a few tugs from your enhanced muff muscles.";
					WaitLineBreak;
					say "     For an instant, they seem to sit there stuck by their wings till your elastic properties assert their dominance over your prey. Fuck, so soft, you pant, internally remarking how you can almost taste their lovely pelt and beastly body as they're pulled into your waiting womb. The velvety feathers of their massive wings graze your quivering sex along the way. Their forepaws are drawn in by your exuberant puddling snatch, and in seconds, your prey's sleek meaty pads and razor sharp claws are rubbing your insides. You barely even get the time to appreciate the dichotomy of this as his lean torso and downy pelt passes betwixt your lush lily lips. Still, the manticore doesn't struggle beyond a playful roll even as his hind paws tickle your moist flower, followed swiftly by their smooth scorpion tail vanishes from sight with a lewd squelching sound as the sleek umbral links of their tail massage your innermost depths. Likely under the impression that you're playing a game with him, he begins grinding and kissing the lining of your altered womb with base abandon.";
					say "     You watch him happily rolling within you, as he services your lush sex, sending delightful tremors through your taut [SkinName of Player] skin. While his massive barbed kitty cock and adorable paws play along your overtaxed womb, creating the cutest little outlines in your [skinname of player] tum, the unsubtle beast merrily grinds his not-so-little spiny prick along the walls of his new temporary home. Impressed with your future child's vigor, you deem to reward his initiative by lavishing a bit of affection on the exotic feral. Your hands drift down the sensual bulge in your thoroughly-packed tum as you lovingly toy with your prey throbbing tool, sweetly stroke the Manticore's barbed meat from the outside, delighting all the while at the hedonistic sensation of your hands gliding along the impressive afterimage that the frisky kitty's cock makes in silken surface of your pack womb. Perhaps encouraged by your attention, you can feel a slight poke and adorable little bulge simmering in your well-stuffed tum as he paws at your uterus, you can't help giggle slightly at the senation of his soft paws playfully kneading your tummy.";
					WaitLineBreak;
					say "     Though from the feel of it, he could have just stung you from the inside too. Already, you can sense the heat and pleasure of the manitcore's venom coating the inside of your impregnable womb. The lust-inducing toxins sweeps into the walls of your engorged frame, but also leaches into the manticore's burgeoning glans. Your venom-coated passenger wildly writhes at your touch sending your belly into a blissful state of false quickening as you're both your bodies are saturated with the stuff. Chemical ecstasy crashes over your being, making your [skinname of player] skin grow hot to the touch like your whole body is blushing in delight. Still, you keep a firm grip on the manticores member, elated at the absolutely decadent feeling of using your own womb as fleshlight for your prey. With each stroke you diligently bestow as much affection on their perverse member as you can before your body start remaking him.";
					say "     You can already feel your womb filling up with amniotic fluid as your tummy starts to push out from the pressure. Slowly but surely, the manticore's outline is displaced as your navel almost pops out from the sheer mass within but it doesn't bother you. Your voracious mind loves the swelling sensation suffusing your being as your aberrant nanites envelope your latest child-to-be. Come on baby, cum for mommy, you plead, feeling your hold loosening on their turgid tool by the second as your nanites subsume them in transformative fluids. Wanting, no [italic type]needing[roman type] him to cum, to feel him baste your insides before you transform him, you rub what's left of the imprint of his cock while fondling his balls hoping you're not too late to make him finish. You feverishly kiss and jerk your passenger off through your bloated bump. Luckily, the horny beast obliges you as best it can, massaging his meat along your growing linea nigra.";
					WaitLineBreak;
					say "     Even then, it's a blissful struggle for you to keep pace with as they thrash and writhe within you till at last you feel a delightful bulge running up their shaft as they cum. At once, your womb swells just a hair larger with their load of cum and venom alongside your exotic amniotic fluids, almost pinning you under its weight. Oddly, as you hug your latest child-to-be, you don't feel the least bit bothered by this. If anything, you feel a powerful maternal high coursing through you as your body's unnatural process works their magic upon them. Running your hand over your swollen middle, feeling the creature curl up into fetal position. You have to admit you love the effect your body has on your prey. Knowing that you can turn any being turned from a disagreeable foe to an obedient child, or eager thrall is a thrill like no other. You simply lie back on the soft grasses coddling your elated form in their emerald embrace, enjoying the sweet afterglow as your body starts to shrink. A part of you even wonders what it must be like for them to be swimming such a delightful mix of sexual fluids.";
					say "     Over time, you watch your body steadily reducing the manticore, jizz and all, down to a childlike state. It takes a little longer than normal though for you to render them into a more portable size as the sexual soup swirling with you seems to be interfering with your body's unnatural processes. Of course, that just gives you more time to wallow in sensation of the fullness and purpose that comes from unbirthing. It's only proper, to take time to talk to your newest child and pamper your hard working bump, you tell yourself. They both deserve it after all. Regrettably, your body does return to its 'normal' pregnancy size, as the manticore, now reduced to a fraction of its prior majesty, is well on its way to being properly rebuilt by nanites into proper child. You look on with a note of maternal pride as your belly blossoms once more into a proper bump. Sadly, you won't get to enjoy this long as a normal pregnancy to indulge in the changes, but the world can't be perfect. Still you found Drake's knife, got to have fun at the same time, so you can chalk this day up as an absolute win.";
					now HeadName of Child is "Manticore";
					now TorsoName of Child is "Manticore";
					now BackName of Child is "Manticore";
					now ArmsName of Child is "Manticore";
					now LegsName of Child is "Manticore";
					now AssName of Child is "Manticore";
					now TailName of Child is "Manticore";
					now HeadSpeciesName of Child is "Manticore";
					now TorsoSpeciesName of Child is "Manticore";
					now BackSpeciesName of Child is "Manticore";
					now ArmsSpeciesName of Child is "Manticore";
					now LegsSpeciesName of Child is "Manticore";
					now AssSpeciesName of Child is "Manticore";
					now TailSpeciesName of Child is "Manticore";
					now ubpreg is "Manticore";
					now gestation of Child is a random number between 8 and 16;
					now pregtype is 1;
					increase ubcount by 1;
					now Old One Eye is Resolved;
					ItemGain Drake's Blade by 1;
					now Hunger of Augustus Drake is 4;
					TraitGain "Mx's Mother" for Player;
					if "Safe Appetite" is not listed in feats of Player:
						infect "Manticore";
						infect "Feral Gryphon";
						infect "Succubus";
						infect "Felinoid";
						infect "Werewolf Brute";
	else:
		say "     Following along an unbroken stretch of vibrant green grasses, you come across one of the odd watering holes dotting the plains albeit much cleaner than the one's that you usually find which are frequented by the local Bald Eagles in the region. This one appears to have been cleared out for the most part, and doesn't smell of avian cum. Wondering why this is, you shift your gaze to the banks, and spot the culprit. A large manticore-like creature with feathery wings convalescing at its edges. From where you're standing the creature appears to be asleep for the moment, though how long it will remain so is anyone's guess. Looking them over, you vaguely recall Drake asked you to keep an eye out for an injured manticore that could still have his family's knife.";
		say "     Wondering if this is the real Mccoy, you slowly circle around the side of the creature till you can get a good look at its face. Sure enough, there it is just sticking out of its right eye like Drake said. Uh, that must hurt, you whisper, noting how the creature's skin still hasn't healed over despite the nanite's best efforts. You could probably creep up and try to pull the thing out but that would definitely wake the thing up. Alternatively you can just leave it, although you'll most likely never get the chance to retrieve Drake's knife again.";
		LineBreak;
		say "     [bold type]Do you go for it and retrieve the knife, or just leave the poor thing well enough alone?[roman type][line break]";
		let Very_Boring_Choices be a list of text;
		add "Retrieve the knife." to Very_Boring_Choices;
		add "Ignore it." to Very_Boring_Choices;
		let Very_Boring_Choice be what the player chooses from Very_Boring_Choices;
		if Very_Boring_Choice is:
			-- "Retrieve the knife.":
				say "     Fuck it, lets do this, you muse sneaking your way closer to the still sleeping Manticore. Every step you take you expect the thing to wake up, but through some combination of luck and skill you stealthily creep up on the feral and wrap a hand around the hilt. Just as you start to pull on the handle though, the creature's one good eye flashes open, fixing you with a raw bloodshot stare. In that instant, it glances at your hand then looks up at your arm as your eyes meet, a perplexed look blossom on its bestial mug as its nanite-warped mind struggles to process what you are doing. In that moment of confusion, you pull the knife as hard as you can. Though it resists you for a split second, the blade rips free with a sickly wet pop as the nanites rapidly begin healing the wound, halting all blood loss, and scarifying the damaged site before you can even blink. Rightly pissed, the creature wastes no time in rearing up and leaping at you. It's a fight!";
				challenge "Manticore";
				if fightoutcome >= 10 and fightoutcome <= 19:
					say "     Swatting down the wounded feral, the cowed creature falls flat at your feet. As you collect yourself, you decide to indulge a moment of curiosity to look over this odd creature. It's not often you get to safely observe a variant like this, and you doubt you'll get any opportunities to do so again. Kneeling beside it, you peer over its unconscious body, and note the presence of multiple ugly thick gnarled red scars lining its well-muscled torso that are just barely covered by a thinning layer of fur, the worst being on its throat and forepaws. Were it not for the nanites, you imagine these wounds would likely have been fatal, or at the very least highly debilitating. The only other thing that stands out to you is the odd shape of its legs and feathered wings. As you observe the former, you notice they have an almost plantigrade bend. In addition, its forepaws appear to have almost finger-like digits, though you doubt that it would ever be able to hold, or manipulate objects with the same efficacy as a person would.";
					say "     Though if the creature applied itself, you suspect it could potentially pick up a pen or throw a rock, albeit very awkwardly. Turning your attention to its wings, you realize that the thing's body may have more in common with the feral gryphons flying around the plains than a true manticore. The ramifications of which are interesting to say the least. Is this creature a hybrid of the strains brought about by what passes for [']natural processes['] these days, or someone who was overwhelmed by multiple infections? You may never know. Hopefully, at the very least after its encounter with you, and to a lesser extent, Drake, it may at least learn to leave people alone. A part of you doubts this, but it's better to live in hope. Even if it doesn't learn, hey, you at least got the knife back. Too bad the damn thing seems to have picked up a bit of what some might call funk. You might want to get the blade cleaned before you give it back to Drake. Alternatively, you could just keep it; you never promised to bring it back after all. You opine as you head out to the entrance of the Dry Plains.";
					now Old One Eye is resolved;
					ItemGain Drake's Blade by 1;
					now Hunger of Augustus Drake is 3;
				else if fightoutcome >= 20 and fightoutcome <= 29:
					say "     Beaten back by the raging feral, you collapse on the ground as you recover from the thorough ravaging the creature gave you. Seemingly invigorated by the fight, it prowls around you looking rather proud of the mess it's made of your body. Thankfully it doesn't seem interested in a round two and takes wing a few moments later, leaving you, and Drake's blade behind. Once you've recovered enough to move without too much sticky soreness, you collect the slightly rusted and grimy blade from the ground. To say the elements as well as the exposure to the manticore's bodily fluids have not done it any favors would be an understatement. As sickly green splotches of some unknown matter mar the handle alongside streaks of fresh rust. You'll probably get this thing cleaned off before handing it back. The damn thing smells worse than death right now, or you could just keep it you think to yourself as you tuck the thing away and head back to the entrance of the Dry Plains.";
					now Old One Eye is resolved;
					ItemGain Drake's Blade by 1;
					now Hunger of Augustus Drake is 3;
				else if fightoutcome >= 30:
					say "     Feeling the tide of battle turn against you, you break contact with Manticore and beat a hasty retreat away from the watering hole. Thankfully, the feral shows little interest in pursuing you at the moment. Perhaps it's content with this show of dominance over you, or it could still be hurting from its encounter with Drake, either way it doesn't matter. You were only here for the knife, now that you have it. You really have no reason to fight the creature outside satisfying your own foolish pride, or vain battle-lust.";
					now Old One Eye is resolved;
					ItemGain Drake's Blade by 1;
					now Hunger of Augustus Drake is 3;
			-- "Ignore it.":
				say "     Ruminating on it, you honestly couldn't care less about the lone manticore, or Drake's stupid knife. Why not just let sleeping mutts lie, you tell yourself as you head back towards the entrance of the Dry Plains.";
				Now Old One Eye is resolved;
				now Hunger of Augustus Drake is 2;


Table of GameEventIDs (continued)
Object	Name
Last Chance Assault	"Last Chance Assault"

Table of WalkInEvents (continued)
Priority	Name	EventObject	EventConditions	EventRoom	LastEncounterTurn	CoolDownTurns	EncounterPercentage
2	"Last Chance Assault"	Last Chance Assault	"[EventConditions_Last_Chance_Assault]"	Last Chance Parking Lot	2500	1	100

to say EventConditions_Last_Chance_assault:
	if Hunger of Augustus Drake is 2:
		now CurrentWalkinEvent_ConditionsMet is true;

Last Chance Assault is a situation.
ResolveFunction of Last Chance Assault is "[ResolveEvent LastChanceAssault]".
Sarea of Last Chance Assault is "Nowhere".

to say ResolveEvent LastChanceAssault:
	if HP of Augustus Drake <= 98:
		say "     Hiking along the lonesome stretch of road leading to The Last Chance, the normal peace and quiet of the area is suddenly and violently sundered by the deafening roar of Drake's anti-material rifle. Going by the muzzle flashes and the almost blinding glow of the tracers rounds illuminating the man's ad hoc pillbox, whatever Drake is shooting at, is high in the air above him. Searching the sky, you pick out the faint silhouette of a manticore with feathery wings strafing The Last Chance, as if searching for something. Even at this distance, you can hear Drake roaring curses at the mutant between every shoot, 'Fuck you!' *BANG* 'You son of a bitch!' *BANG* 'I will flak up this whole goddamn sky till I bring you down!' slotting in a bright red magazine. 'Now! Eat! Airburst!' He bellows, discharging several rounds from his vehicle killer. The phosphorescent shots arc through the sky, though it looks like his shots have gone wide as they sail past the feral's flight path. Only to detonate mere moments later around the manticore in a spherical storm of molten metal and dense black smoke.";
		say "     Unable to dodge the blast, the creature is engulfed in torrent of pyroclastic plume of brass coating its wings in burning metal, as bits of blazing shrapnel shreds its feathers to blackened ribbons. It howls of bestial pain echo through the air, as it tries to right itself as it makes a beeline away from The Chance before its wings are reduced to carbonized stubs. But the damages it already done, and it frantic flapping only serves to spread the magnesium laced flames as the last few ";
		if "Touched by Madness" is listed in feats of player:
			say "centimeter ";
		else:
			say "inches ";
		say "of alabaster down crackles away in a puff of inky fumes. It plummets to the ground, as foul smelling smoke billows behind as if it were the trail of a comet, as it crashes into the center of The Chance. The impact kicks up a tall mushroom cloud of gray and black dust that seeps over the walls in heavy haze. 'HA! How do you like that, you rapey little shit?! Not so fun when the other guy can fight back eh!?' Drake taunts as he dashes from his pillbox, hooks his left hand on the right rung of the roof ladder, and slides down the side.";
		WaitLineBreak;
		say "     As his form dips past the wall, and you rush forward to see what he's going to do next. Arriving at the locked gate, you spy Drake striding over to the prone smoldering form of the manticore, twitching on the blacktop at the heart of the parking lot, Drake snarls at the stricken creature, 'Stupid feral, don't know what you were thinking coming here, least you brought my knife back,' as he stomps a boot down on the scorched remains of the burnt Manticore's mane. He leans down and wraps his hand about the turned wooden handle, then yanks the blade out in single fluid motion, muttering. 'Oh fuck, glad great grandpa and the other [one of]Hell-fighters[or]Men Of Bronze[or]Black Rattlers[at random] aren't here to see this. I'd be cutting my own switches for the next month.' As he looks over the pitted grime-encrusted triangular blade and tarnished brass knuckle-duster guard before tucking the thing in the flap of his vintage paratrooper boots."; [Author's note: the 369th or the Harlem Hell fighters were trench clearers in WWI and transferred to the west coast for WWII. Drake is descended from the almost all white officer corps or afro-haitian/Latin American war fighters. He also has vague ties to the Kaiser Reich as many GIs took wives from the old world.]
		say "     His attention is then drawn back to cowed feral as a pitiful moan escapes the manticore singed lips as it wounds knit shut before your eyes. The downed creature squirms under the big man's boot heel as it claws at the blacktop in some vain effort to crawl away from him. Despite its mewling cries, Drake's hard demeanor remains unchanged, as he roughly grabs the mewling battered thing by the scruff of its singed mane, he unlocks the gate, and hauls it past you. You want to ask what he plans to do, but you figure it's not for the best, not while his blood is still running hot. Besides, you don't think the manticore, or anyone infected by the nanites can even be killed so easily, just knocked down for a while. 'Pardon me [name of player], got to go take care of this before it starts to stink up the place,' Drake remarks in a casual tone as he marches past you, hauling the manticore behind him to [italic type]parts unknown[roman type].";
		now Last Chance Assault is resolved;
		now Hunger of Augustus Drake is 5;
	else if HP of Augustus Drake is 99:
		say "     Hiking along the lonesome stretch of road leading to The Last Chance, the normal peace and quiet of the area is suddenly sundered by the roar of Drake's anti-material rifle. Going by the bright muzzle flashes illuminating the pillbox and the vibrant phosphorescent trails of the rounds sailing overhead, whatever Drake is shooting at is high in the air above him. Searching the sky, you pick out the faint silhouette of a manticore strafing the Last Chance. 'You know what, come on down here you dickless shit! I don't need a gun to take you out!' Drake challenges, as he drops his rifle and runs to the edge of the roof. He throws back his head, losing a primal roar that vibrates not just the air, but your chest too as its deep resonance reverberates through your being. As if in answer to his challenge the Manticore roars back, loosing a cutting knell as it tucks its wings and dive bombs at him. Rather than seek cover, Drake spreads his arms wide howling, 'COME ON YOU BASTARD! Show me what you can do!'";
		say "     As the creature plunges toward him, its claws out-stretched as if were some great crimson comet cast from the heavens as it guns straight for Drake. The big man easily sidesteps the beast though as his hand shoots out grabbing the Manticore's tail. His body ripples with effort, as he twists on the balls of his paws and yanks out of its flight path, crushing several links of its tail in the process as he casts it to the ground. The impact kicks up a huge mushroom cloud of gray-brown dust, and you rush forward to see what will happen next. By the time you arrive at the locked gate, the manticore and Drake are trading blows with one another in the parking lot. 'Bring it,' Drake yells, batting aside the creature's probing attacks. Again and again the manticore tries clawing at the man's leonine face or sculpted sternum, but always from the left side as its frenzied assault pushes him west. Drake back steps and dodges each swipe with contempt and follows them up with swift counterstrike to the creature's face and forelimbs.";
		WaitLineBreak;
		say "     To your eyes, each blow Drake levels upon them is a quick efficient action bereft of theatrics, passion, or wasted movement. As the Manticore counters with a series of wild chaotic attacks, seemingly born of desperation. They appear more to keep the big cat on the defensive or whittle him down, then land a decisive blow. Slowly but surely, Drake is steadily pressured to the edge of his garden walkway, and as his paws brush one of the dwarfed citronella plant's petals. He stops in his tracks, refusing to take one step and risk crushing a leaf of his floral monument, instead he holds his ground, resorting to blocking each blow even as his arms are riddled with vermillion slashes. Perhaps sensing an opening, a steely look crosses Manticore's face as its demeanor seems to change and it lunges forward propelled by a sudden flap of its wings, straight at Drake's neck. You wince reflexively, watching its jaws closer in slow motion, expecting Drake's neck to be torn open, his body go limp like a gazelle, as it hangs from the beast's mouth as manticore's maw closes around the big man's mane.";
		say "     With a loud crunch the Manticore seizes Drake by the jugular, while its claws dig into his back, as he tries to pin Drake to the ground. A part of you expects him to scream, or rag doll in shock, yet he holds his ground, laughing. 'You know,' as his arms shoot up latching onto Manticore's jaw, headless of the damage its teeth do to his palms. 'That doesn't work too well when the other guy has a mane!!' Drake roars, the veins on his shoulder and neck throbbing like angry golden klaxons as he slowly, brutally, forces open the mutants maw. Though it is not so easily denied, as its hot steamy breath coils in the air around them as they were tangles of ghostly eelgrass. While the manticore claws at Drake's golden pelt, trying to overwhelm him, but with a sudden crack. Its bloodied mouth is rent open at an unnaturally wide angle, freed from its grasp, Drake break with feral's hold, and shoves it backwards onto its hindlegs, yelling.";
		if "Touched by Madness" is listed in feats of Player:
			say "'ORA! ORA! ORA!";
		else:
			say "'RRAA!'";
		WaitLineBreak;
		say "     As he delivers a swift series of punches to the stumbling Manticore's core that drives the creature back further. It awkwardly shuffles on its hind legs, wings flapping wildly as if it were caught in a wind storm while it tries to right itself. Drake loses a bestial roar as he cock his left arm, kneels, and springs up to deliver a brutal uppercut to the Manticore's slack jaw, sending it flying backwards across the back top. It lands in a heap making strange smacking noises with this battered maw. 'Had enough?' Drake challenges striding over to the mutant's prone form as he cracks his knuckles. 'M-m-more,' you hear the manticore croaks through its blood spattered lips in a harsh dry raspy androgynous voice as it lifts itself up like a marionette on its strings. ";
		if "Touched by Madness" is listed in feats of Player:
			say "'Nani!?' ";
		else:
			say "'What in the!?' ";
		say "Drake barks, taken aback that the manticore just spoke, and the loud cracking sounds of its bones hastily rearranging themselves into a plantigrade anthro form similar to Drake's own warped physique. In that moment of confusion, the Manticore, flashing a wicked grin on its face, rounds itself and charges on bipedal legs with its fist raised. Oh crap did it just MUTATE, you realize in horror that the creature just absorbed some of Drake's hybrid nanites into its system.";
		say "     'More, give me more! The anthro manticore bellows, launching into Drake with a flurry of lightning strikes faster than your eyes can track at the man's sternum, shouting. 'You, *wheeze* will give [bold type]IT[Roman type] back to me! I! Must! Have! More!' As it pummels Drake torso leaving bruised craters across his chest as his ribs crack and deform. The speed and fury of manticore's blows knock the wind and much of the resistance out the big man, forcing him to his knees. In that instant the enhanced manticore leaps up and delivers a round house to man's right bicep with a cracking knell, sending him hurtling towards the garage. Drake skids and bounces across the blacktop,  he splays and sinks talons into the asphalt as he comes to a screeching halt, leaving a trail of jagged furrows in his wake. You watch as hackles on rise like dragon's teeth as tendrils of steam billow from the big cat's mouth and body like wisps of dying hoarfrost. He tries to rise on his shaky paws.";
		WaitLineBreak;
		say "     Only to fall seconds later, clutching his guts as he vomits a small pool of bright yellow bile at his feet. While his breath comes in short pained rattling gasps as his fractured ribs dig deeper into his vitals. Yet, the altered manticore doesn't seem content to allow him even a moment of reprieve as it launches itself with a beat of its wings at him with his right arm cocked, ready to haymaker to Drake's jaw perhaps hoping to finish him. Barely even able to move, Drake rears back his skull and launches himself into the creature's attack, headbutting the manticore's fist with all of his remaining strength. Bone crashes upon bone, and for an instant, you suspect Drake's head is about to crack as his right eye socket buckles just a hair inward. When a shockwave ripples through the manticore's arm as its muscle spasms uncontrollably as if a bubble of air were pushed between the subcutaneous tissue. Its knuckles crumple and fingers crack inwards as it stumbles back, recoiling in pain.";
		say "     Drake seizes the intuitive as he springs up, grabbing the creature's uninjured arm with his right and delivering a swift blow to its elbow joint with his left. As a violent wet cracking sound splits the air, the creature's bulges upwards at an odd angle then falls limp at its side. Reflexively, it tries to cradle the damaged limb, but Drake doesn't give it the chance, as he spears himself into the creature's core and rams into the gate, knocking the wind out of it as its stunned form slumps against Drake's back. Though the impact deforms the thick steel bars and cracks the plaster, the barrier holds. ";
		if "Touched by Madness" is listed in feats of Player:
			say "'Shi!' ";
		else:
			say "'Die, die, die, you fucking mutant freak!' ";
		WaitLineBreak;
		say "Drake barks, as his hand shoots up, and grabs the creature's neck, his sinks his talon into the feral windpipe as he slams their head against the unyielding sections of the gate's bars again and again till at last, the beast whimpers and goes still. Deep down, you know it's far from dead, despite the damage, it's merely stunned. The nanites are already hard at work repairing it, and Drake, you note, watching their cuts steam shut and Drake's eye socket slide back into proper place as if the damage were never there. You realize the two could probably go on fighting eternally, were it not for Drake's violence of action. 'Stupid feral,' Drake growls, spitting a wad of blood and fractured canines on the ground.";
		say "     'Ugh, my insurance adjuster is gonna have a field day when they read this claim, but first.' He hisses, stomping his clawed foot into the creature chest for leverage, he takes a hold of the knife still lodged in the creature's skull, 'I need this back,' tugging the blade pops free with a single fluid motion. 'Shit,' Drake hisses gazing at rust and grim spotted metal, 'this thing has seen better days, glad my great grandpa and the 369th aren't here to see this. *Sigh*, they'd belt my furry ass bald for the next month, for this,' Drake murmurs as sets the rusty thing down reverently, he then turns to you roaring, 'YOU! MOVE! NOW!' with curt bob of his bloodied mane, as he unlocks the gate, 'I got to get rid of this fucking thing, before it's stink starts bringing in the Neshers.' In no mood to pick a fight, despite Drake's less-than-hospitable attitude, you nod, then make way for him as he lugs the broken anthro manticore to [italic type]parts unknown[roman type].";
		now Last Chance Assault is resolved;
		now Hunger of Augustus Drake is 6;


Section 5 - Knife, Gun, and you

Table of Game Objects (continued)
name	desc	weight	object
"Drake's Blade"	"A modified Nahkampfmesser made during the first world war. This weapons has likely passed hands many times before winding up in the possession of Drake's family as it is composed from parts used by both Allied and Central Powers. The edge itself is obviously of sturdy German make though it is a little thinner one would expect as if someone had to buff out major dents on the fly. The handle appears to be made of a somewhat gamey piece of solid turned-wood likely from the French [']Avenger['] pattern knife, if the style is anything to go by. While the crossguard and handguard taken from a MK. 1 trench knife has been crudely affixed to handle lending it an odd chimeric look. Unfortunately, after is stint in Old One Eye's noggin the thing has picked up some major funk that refuses to wash out."	2	Drake's Blade

Drake's Blade is an armament. It is not temporary.
It has a weapon "[one of]your knife[or]your blade[or]your boot knife[or]your pig sticker[or]your trench knife[at random]".
Weapon Damage of Drake's Blade is 9.
Weapon Type of Drake's Blade is "Melee".
Objsize of Drake's Blade is 3.
Hitbonus of Drake's Blade is 3. [Purpose built weapon]
Scent of Drake's Blade is "Drake's Blade smells of cold steel with just a hint of trench foot and war crimes.".

Table of Game Objects (continued)
name	desc	weight	object
"Driver Carbine"	"Rebuilt from stolen, eh [italic type]liberated[roman type], military ordnance, this short barrel weapon sports a bullpup stock composed of an unknown ultra lightweight black material. Emblazoned upon its grip is an effigy of a bald eagle perched atop a red, white, and blue kite shield bearing the letters RSX. A series of breaks have been built along the muzzle, given its lack of explosive propulsion you suspect it meant to help dispense heat. Below the barrel is a toggleable green laser designed to be visible in almost any lighting situation. Quizzically, no matter how many times you fire it, the carbine never runs out of ammo or experiences excessive heat build up."	8	Driver Carbine

Driver Carbine is an armament. It is not temporary.
It has a weapon "[one of]your service rifle[or]your carbine[or]your shoota most bigga[or]your railgun[or]your mag-rifle[or]your gauss weapon[or]your coil gun[at random]".
Weapon Damage of Driver Carbine is 12.
Weapon Type of Driver Carbine is "Ranged".
Objsize of Driver Carbine is 3.
Hitbonus of Driver Carbine is 3. [awesome Weapon]
Scent of Driver Carbine is "Oi, this here smells like a right proper Shoota it does!".

Table of Game Objects (continued)
name	desc	weight	object
"Tainted Blade"	"Warped by its brief exposure to your stomach acid and saturated with both your predatory nanites and the remains of Old One Eye, this thoroughly Tainted Blade bears only the barest of passing resemblance to its pre-infection form. The edge, once a straight piece of solid dark gunmetal black steel, appears to have taken on a wavy pattern reminiscent of a Keris impregnated with a sickly oily green tint evocative of slug's bloated hide. The handle, formerly a block of solid red turned-wood, is stained a lurid black that seems to drink in the light around it. Only the inlaid brass knuckle dusters on the handguard and iron crossguard appear to have largely remained unaltered, though they still bear some symptoms of corruption. As chaotic streaks of crimson, blue, and lavender veins-like growths pulse with an unnatural rhythm as if the metal were alive, and hungry."	2	Tainted Blade

Tainted Blade is an armament. It is not temporary.
It has a weapon "[one of]your benighted knife[or]your infected blade[or]your hungering edge[or]your thirsting dagger[or]your sliver of chaos[at random]".
Weapon Damage of Tainted Blade is 13.
Weapon Type of Tainted Blade is "Melee".
Objsize of Tainted Blade is 5.
Hitbonus of Tainted Blade is 5. [The gods have blessed this blade! Now show you are worthy of it, little mouse.]
Scent of Tainted Blade is "The Tainted Blade reeks of corruption and dried coppery blood.".

an everyturn rule:
	if Tainted Blade is wielded:
		if XP of Augustus Drake < 8:
			increase XP of Augustus Drake by 1;
		else if XP of Augustus Drake >= 8:
			say "[The_Call]";

to say The_Call:
	if BodyName of Player is not "Hermacore" and XP of Augustus Drake >= 8:
		say "     Clutching the Tainted Blade tightly, the handle throbs like the distressed heartbeat of some living thing as tendrils of its lingering corruption flicker across your being. Your body is flooded with a rush of voracious energy as the latent nanites impregnating the profaned metal are reabsorbed into your system.";
		infect "Hermacore";
		infect "Hermacore";
		now XP of Augustus Drake is 0;
	else if FaceName of Player is not "Hermacore" and XP of Augustus Drake >= 8:
		say "     Clutching the Tainted Blade tightly, the handle throbs like the distressed heartbeat of some living thing as tendrils of its lingering corruption flicker across your being. Your body is flooded with a rush of voracious energy as the latent nanites impregnating the profaned metal are reabsorbed into your system.";
		infect "Hermacore";
		infect "Hermacore";
		now XP of Augustus Drake is 0;
	else if SkinName of Player is not "Hermacore" and XP of Augustus Drake >= 8:
		say "     Clutching the Tainted Blade tightly, the handle throbs like the distressed heartbeat of some living thing as tendrils of its lingering corruption flicker across your being. Your body is flooded with a rush of voracious energy as the latent nanites impregnating the profaned metal are reabsorbed into your system.";
		infect "Hermacore";
		infect "Hermacore";
		now XP of Augustus Drake is 0;
	else if TailName of Player is not "Hermacore" and XP of Augustus Drake >= 8:
		say "     Clutching the Tainted Blade tightly, the handle throbs like the distressed heartbeat of some living thing as tendrils of its lingering corruption flicker across your being. Your body is flooded with a rush of voracious energy as the latent nanites impregnating the profaned metal are reabsorbed into your system.";
		infect "Hermacore";
		infect "Hermacore";
		now XP of Augustus Drake is 0;
	else if CockName of Player is not "Hermacore" and XP of Augustus Drake is 8:
		say "     Clutching the Tainted Blade tightly, the handle throbs like the distressed heartbeat of some living thing as tendrils of its lingering corruption flicker across your being. Your body is flooded with a rush of voracious energy as the latent nanites impregnating the profaned metal are reabsorbed into your system.";
		infect "Hermacore";
		infect "Hermacore";
		now XP of Augustus Drake is 0;
	else if BodyName of Player is "Hermacore" and Player is pure and Player is impreg_now and Cunt Count of Player >= 1 and Cock Count of Player is 0 and XP of Augustus Drake >= 8 and Affection of Augustus Drake is 0: [Preg text while hunger of Place holder is <= 3, gets more voracious and unhinged the higher placeholder hunger gets.]
		say "     [one of]Strutting through the city, your attention is drawn to the tender swell of your thoroughly-bred core, as your growing bundle of joy shifts just a hair inside you. Without thinking, you soon find yourself pawing at the lush fur cradling your taut toned tummy as a sudden rush of nanite-laced maternal hormones simmers though your gravid form. You can't resist purring, delighted at mounting changes while your body prepares for your latest brood. Your [Breast Size desc of Player] tits swelling with bountiful milky purpose as rich beads of pearly white cream drip from your lavish nips as your poor engorged teats struggle to contain your potent mother's milk. You briefly consider [bold type]milk[roman type]ing yourself to save of some as treat for later[or]Running your talons along the silky vermilion curve of your well-seeded tum, you find your tainted hormonal thoughts drifting more towards the care of your lovely bump and managing your exotic cravings. As your current state seems to amplify your voracious appetite to new heights and fills you with an odd potent energy. Of course, that's to be expected, your little ones need all the nourishment they can get. Which you are eager to provide as you have to admit on some level your pregnancy hormones are a rather delightful spice. The knowledge that your actions are directly contributing to you and your kitten's survival as well as enhancing your own predatory physique is a rather intoxicating experience. After all, how many mothers can come out of pregnancy stronger and smarter than they were before? You muse with a predatory smirk on your leonine muzzle as you rub your tummy, fantasizing about your next meal[at random].";
		increase HP of Player by 6;
		PlayerEat 6;
		PlayerDrink 6;
		if humanity of player >= 25:
			decrease humanity of Player by 6;
		increase Morale of Player by 6;
		increase Affection of Augustus Drake by 1;
		now XP of Augustus Drake is 0;
	else if BodyName of Player is "Hermacore" and Player is pure and Player is impreg_now and Cunt Count of Player >= 1 and Cock Count of Player is 0 and XP of Augustus Drake >= 8 and Affection of Augustus Drake is 1:
		say "     [one of]Rumbling happily to yourself as you explore the city, you realize how focused, not to mention jovial, you've been feeling since your heat was properly quenched. Your mind and body are more in tune than ever before both equally prepared for your latest litter. You can't wait to experience more blissful maternal changes as your body ripens into a peerless beacon of fecund power and desire, or the boundless joy of getting to hold your little ones for the first time. Can't wait to meet you all, you whisper to yourself as you pause to give your growing kittens a loving pat[or]Peregrinating about the area, your paws drift to the ripe mass of your growing kitten factory, as you lovingly pamper the silky red fur swaddling your expectant middle. A part of you can't help purr in admiration at the sight of your positively glowing pelt or comforting weight of your brood resting on your supple pads. Perhaps reacting to their mother's touch, your kittens stur ever-so-slightly in your grasp, sending your heart a flutter at the brief moment of connection with your newest cubs. You decide to find somewhere quiet and enjoy a few moments along with them before they're due. Good babies, you coo, running your paws over the tumultuous surface of your cub-laden midriff as you purr contentedly to them[at random].";
		increase HP of Player by 6;
		PlayerEat 6;
		PlayerDrink 6;
		if humanity of player >= 25:
			decrease humanity of Player by 6;
		increase Morale of Player by 6;
		increase Affection of Augustus Drake by 1;
		now XP of Augustus Drake is 0;
	else if BodyName of Player is "Hermacore" and Player is pure and Player is impreg_now and Cunt Count of Player >= 1 and Cock Count of Player is 0 and XP of Augustus Drake >= 8 and Affection of Augustus Drake is 2:
		say "     [one of]Wandering through the ruins of the world that was, you feel a trickle of warm drool leaking from your lips as a low rumble emanates from your decadently rounded core as your voracious hunger makes its presence felt. You can feel your wings flutter, and talons clench with an all-consuming energy as your mind is set ablaze with a sudden urge to hunt and provide for your growing litter's unique needs. Don't worry babies, mommy will get you someone to eat soon, you purr giving your tummy a cheerful rub while you sniff the air for any signs of luckless prey things[or]Strolling about the city, your attention is drawn to the growing weight of your brood-swollen tum, as the ripe tissue stretches just a hair outwards. It won't be long till your little monsters are ready to make their debut. Though you hope won't get much bigger by then, you're already starting to lose sight of your paws, and if this keeps up you doubt you'd even be able to reach your kitty soon[at random].";
		increase HP of Player by 6;
		PlayerEat 6;
		PlayerDrink 6;
		if humanity of player >= 25:
			decrease humanity of Player by 6;
		increase Morale of Player by 6;
		increase Affection of Augustus Drake by 1;
		now XP of Augustus Drake is 0;
	else if BodyName of Player is "Hermacore" and Player is pure and Player is impreg_now and Cunt Count of Player >= 1 and Cock Count of Player is 0 and XP of Augustus Drake >= 8 and Affection of Augustus Drake is 3:
		say "     Out of nowhere, you let out a shocked yet aggravated grunt as a sudden almost painful series of pressure points roiling along the surface of your crimson midriff. Peering down at the graceful curve of your lush core in surprise, you catch sight of your riotous tum squirming with activity as your rowdy little ones whip up a storm with you. The outlines of their tiny paws swarm along your alluring middle as they quicken. Another time, you might have felt a bit of pride at your little soldier's strength, if they weren't punching you in the organs so hard. Having none of this though, you clench your overwrought ab muscles to hold them in place, while growling at them to quit it, or you are going to put them [italic type]ALL[roman type] in timeout once they're born! Which seems to quiet them, for the moment at least.";
		increase HP of Player by 6;
		PlayerEat 6;
		PlayerDrink 6;
		if humanity of player >= 25:
			decrease humanity of Player by 6;
		increase Morale of Player by 6;
		now Affection of Augustus Drake is 0;
		now XP of Augustus Drake is 0;
	else if BodyName of Player is "Hermacore" and player is pure and Player is impreg_now and Cunt Count of Player >= 1 and Cock Count of Player >= 1 and XP of Augustus Drake >= 8 and Depravity of Augustus Drake is 0: [Preg text while hunger of Place holder is <= 3, gets more voracious and unhinged the higher placeholder hunger gets.]
		say "     Sashaying through the city, you find yourself getting sidetracked more and more by the growing activity that your swelling kitty factory is having on your intersexed anatomy, as the welcoming mass of your sordid womb puts the most delectable weight on the all the right place, leaving you in near constant state of low level arousal. A part of you wonders if you are going to end up with priapism from all the lovely stimulation of your futa g-spot. Though you have to admit, your stiffy does make for a convenient tummy rest. The feeling of your fur rubbing against the exotic barbs of your [Cock Size desc of Player] cock, along with the heavenly caress of its tight dick wrapper as if it were a living cockring is such a rare thrill too. Now if only you could find a nice mouth or moist hole to sheath it in.";
		increase HP of Player by 6;
		PlayerEat 6;
		PlayerDrink 6;
		if humanity of player > 69:
			decrease humanity of Player by 6;
		increase morale of player by 6;
		if Libido of player > 69:
			now Libido of player is 69;
		increase Depravity of Augustus Drake by 1;
		now XP of Augustus Drake is 0;
	else if BodyName of Player is "Hermacore" and player is pure and Player is impreg_now and Cunt Count of Player >= 1 and Cock Count of Player >= 1 and XP of Augustus Drake >= 8 and Depravity of Augustus Drake is 1:
		say "     Drifting about the broken remnant of the old world, your awareness is drawn to the bountiful sight of your gestating brood nestled comfortably in your toned tummy, and the heady affect your body's unique hormones are having on your intersexed form. Flushed with raw bestial need, your hybrid sex, as well as all those delightful mommy chemicals coursing through you, seem hellbent on driving your wild, even [bold type]paw[roman type]ing [bold type]off[roman type] barely takes the edge off at this point. Your kittens aren't helping the matter either as their every little kick or motion stimulates your intergender form in ways you never thought possible as the remnant of your human mind struggles to parse the exotic stimulation. Perhaps, you should find another herm to share this with, you muse, running your talons through the shimmering crimson fur pamping your expectant tum as stroke the outlines of your growing litter. Your kittens could always use playmates, and you could certainly use the [']stress relief['].";
		increase HP of Player by 6;
		PlayerEat 6;
		PlayerDrink 6;
		if humanity of player > 69:
			decrease humanity of Player by 6;
		increase morale of player by 6;
		if Libido of player > 69:
			now Libido of player is 69;
		increase Depravity of Augustus Drake by 1;
		now XP of Augustus Drake is 0;
	else if BodyName of Player is "Hermacore" and player is pure and Player is impreg_now and Cunt Count of Player >= 1 and Cock Count of Player >= 1 and XP of Augustus Drake >= 8 and Depravity of Augustus Drake is 2:
		say "     Absentmindedly pawing at your gravid form, you can't help but admire some of the sensual changes sweeping your alluring figure. Your lush [Breast Size desc of Player] tits feel so ripe and taut as they swell with fresh milk. Cupping one, you doubt you'd ever need to wear a bra again as the verdant crimson spheres seems to defy gravity with their prenatural perkiness. Though you might need to [bold type]milk[roman type] yourself soon, your poor teats are starting to get a little too tender. You can practically hear the cream sloshing in tandem with your every step, you muse as a few beads of excess cream leak from the swollen ducts. It would be a shame to let it go to waste, you snicker under your breath as you lap at a few of the rich pearly drops from your fingertips.";
		increase HP of Player by 6;
		PlayerEat 6;
		PlayerDrink 6;
		if humanity of player > 69:
			decrease humanity of Player by 6;
		increase morale of player by 6;
		if Libido of player > 69:
			now Libido of player is 69;
		increase Depravity of Augustus Drake by 1;
		now XP of Augustus Drake is 0;
	else if BodyName of Player is "Hermacore" and player is pure and Player is impreg_now and Cunt Count of Player >= 1 and Cock Count of Player >= 1 and XP of Augustus Drake >= 8 and Depravity of Augustus Drake is 3:
		say "     [one of]Strolling about the city, your attention is drawn to the growing weight of your brood swollen tum, as the ripe tissue stretches just a hair outwards. It won't be long till your little monsters are ready to make their debut. Though you hope won't get much bigger by then, you're already starting to lose sight of your paws, if this keeps up you doubt you'd even be able to reach your cock soon[or]Out of nowhere, you let out a shocked yet aggravated grunt as a sudden almost painful series of pressure points roiling along the surface of your crimson midriff. Peering down at the graceful curve of your lush core in surprise, you catch sight of your riotous tum squirming with activity as your rowdy little ones whip up a storm with you. The outlines of their tiny paws swarm along your alluring middle as they quicken. Another time, you might have felt a bit of pride at your little soldier's strength, if they weren't punching you in the organs so hard. Having none of this, you clench your overwrought ab muscles to hold them in place, while growling at them to quit it, or you are going to put them [italic type]ALL[roman type] in timeout once they're born! Which seems to quiet them, for the moment at least[at random].";
		increase HP of Player by 6;
		PlayerEat 6;
		PlayerDrink 6;
		if humanity of player > 69:
			decrease humanity of Player by 6;
		increase morale of player by 6;
		if Libido of player > 69:
			now Libido of player is 69;
		now Depravity of Augustus Drake is 0;
		now XP of Augustus Drake is 0;
	else if BodyName of Player is "Hermacore" and player is pure and Cunt Count of Player >= 1 and XP of Augustus Drake >= 8:
		say "     A cascade of exotic energy spread across our entire body, as latent power of the Tainted Blade seeping into your alluring form. You feel your wounds knit and mortal needs recede as the corrupted nanite's fill to the brim with unnatural power. Then like a sudden shift in the tide, the sensation leaves you as quickly as it came. Though, you still sense some lingering presence of this otherworldly energy's touch coiling patiently in the back of your mind.";
		increase HP of Player by 6;
		PlayerEat 6;
		PlayerDrink 6;
		if humanity of Player > 69:
			decrease humanity of player by 6;
		if Libido of player > 69:
			now Libido of player is 69;
		now XP of Augustus Drake is 0;
	else if BodyName of Player is "Hermacore" and player is pure and Cunt Count of Player is 0 and XP of Augustus Drake >= 8:
		say "     A cascade of exotic energy spread across our entire body, as latent power of the Tainted Blade seeping into your alluring form. You feel your wounds knit and mortal needs recede as the corrupted nanite's fill to the brim with unnatural power. Then like a sudden shift in the tide, the sensation leaves you and you're left cold, shaken, and cheated as if you were on the cusp of some great unholy revelation, only to have it snatched from you at the last moment.";
		LineBreak;
		say "     [italic type]Author's Note: The Hermacore and Tainted Blade content is meant for females and herms. Males and neuters are never going to be supported by this TF and item, if you wish to see this content in full you will need to TG into a female or Herm. Either way, thank you for playing Flexible Survival! If you wish to support the game further, please feel free to check out our Subscribestar and Patreon pages. You can also chat with fellow mutants on are discord channel, or commission custom content from our team of writers.[roman type]";
		increase HP of Player by 6;
		PlayerEat 6;
		PlayerDrink 6;
		now XP of Augustus Drake is 0;


Augustus_Drake ends here.
