Best Pony by Sundered Dragon begins here.
[This is a placeholder NPC to track stats, ignore them.]
"Add a placeholder NPC to FS."

[Stamina of Best Pony Tracks the every turn rule.]

[HP of Best Pony tracks the PC's decent into horny broodmare girl.]
[ HP = 0 Base line]
[ HP = 1 crotch boobs with milf energy]
[ HP = 2 full milky milf]
[ HP = 3 Stables modded broodmare bimbo]
[ HP = 4 Black equinoid modded milkamazon]
[ HP = 5 Harold modded Celestia coded milfy milk mare]

[Perception of Best Pony tracks the PC tummy mark, changeable via the sundered Codex.]


Table of GameCharacterIDs (continued)
object	name
Best Pony	"Best Pony"

Best Pony is a Woman. [Man or woman. Does not determine genitals, just how the game treats the character's default gender. It's not that deep.]
Best Pony is nowhere.
ScaleValue of Best Pony is 3. [1 is teeny tiny. 2 is small. 3 is human sized. 4 is horse sized. 5 is absolutely massive.]
Body Weight of Best Pony is 3. [scale of 1-9 for body weight, grouped into low weight (1-3), mid weight (4-6) and high weight (7-9)]
Body Definition of Best Pony is 5. [scale of 1-9 for body definition, grouped into low muscle (1-3), mid muscle (4-6), high muscle (7-9)]
[Body Adjective is generated out of the body weight and body definition and can be used in scenes - one word descriptive adjective depending on weight and definition groups: low weight group: skinny/slender/lithe; mid weight group: average/fit/muscled; high weight group: pudgy/husky/jacked]
Androginity of Best Pony is 2. [Gender Adjective is generated out of androginity 1-9: hypermasculine/masculine/somewhat effeminate/effeminate/androgynous/feminine butch/tomboyish/feminine/hyperfeminine]
Mouth Length of Best Pony is 6. [inches deep for face fucking; maximum possible will be double this number (when deep throating)]
Mouth Circumference of Best Pony is 3. [mouth circumference 1-5, "tiny, small, normal, wide, gaping"]
Tongue Length of Best Pony is 6. [length in inches]
Breast Size of Best Pony is 0. [cup size as number, counting Flat Pecs = 0, A = 1, B = 2, ...]
Nipple Count of Best Pony is 2. [count of nipples]
Asshole Depth of Best Pony is 8. [inches deep for anal fucking]
Asshole Tightness of Best Pony is 2. [asshole tightness 1-5, "extremely tight, tight, receptive, open, gaping"]
Cock Count of Best Pony is 0. [number of cocks]
Cock Girth of Best Pony is 1. [thickness 1-5, thin/slender/average/thick/monstrous]
Cock Length of Best Pony is 1. [Length in Inches]
Ball Count of Best Pony is 2. [allowed numbers: 1 (uniball), 2 or 4]
Ball Size of Best Pony is 2. [size of balls 1-7: "acorn-sized", "dove egg-sized", "chicken egg-sized" "goose-egg sized", "ostrich-egg sized", "basketball-sized", "beachball-sized"]
Cunt Count of Best Pony is 1. [number of cunts]
Cunt Depth of Best Pony is 69. [penetrable length in inches; some minor stretching allowed, or more with Twisted Capacity]
Cunt Tightness of Best Pony is 69. [size 1-5, generates adjectives of extremely tight/tight/receptive/open/gaping]
Clit Size of Best Pony is 1. [size 1-5, very small/small/average/large/very large]
[Basic Interaction states as of game start]
PlayerMet of Best Pony is false. [Leave as false. The game will change this once you've used the "look" command on the npc. Can be used for things like knowing an npc's name, etc.]
PlayerRomanced of Best Pony is false. [Leave as false. You can change this to true later within events to have dialogue and scenes specific to "dating" an npc!]
PlayerFriended of Best Pony is false. [Same as above, but for friendship.]
PlayerControlled of Best Pony is false. [Same as above but for making a character your slave.]
PlayerFucked of Best Pony is false. [Leave as false. Changes to true when you have sex with a character.]
OralVirgin of Best Pony is false. [Self explanatory. Whether they've put their mouth on some genitals.]
Virgin of Best Pony is true. [Self explanatory. Vaginal virginity. Set to true or false based on your idea of a character. If they don't have it, leave it as true!]
AnalVirgin of Best Pony is false. [Same as above but for butts.]
PenileVirgin of Best Pony is false. [Same as above but for dicks.]
SexuallyExperienced of Best Pony is true. [How slutty a character is.]
TwistedCapacity of Best Pony is false. [Twisted Characters can take any penetration, no matter the size. Can be changed to allow you to make stomach bulging and other such scenes.]
Sterile of Best Pony is true. [steriles can't knock people up. Use to prevent pregnancies from a character.]
MainInfection of Best Pony is "Ipotane". [A character's infection. Case sensitive. Put the infection name here and that NPC may now infect the player, if the infection itself is infectious.]
Description of Best Pony is "[Best Ponydesc]". [Points to the character description.]
Conversation of Best Pony is { "<This is nothing but a placeholder!>" }. [Leave it as a placeholder. Taken care of by "instead of conversing" lines.]
Scent of Best Pony is "Smell like a place holder wait... how are you seeing this?". [How the character smells. Can be detailed or not.]

To say Best Ponydesc: [Will play when the player uses "look NPCName" Write what they look like in a say!]
	say "     NA, if you're reading please report this on discord.";


an everyturn rule:
	if BodyName of Player is "Ipotane" and Player is pure and Player is impreg_now:
		if XP of Best Pony < 23 and level of Best Pony is 0:
			increase XP of Best Pony by 1;
		else if XP of Best Pony >= 23:
			say "[Horseing_Around]";

to say Horseing_Around:
	if Cunt Count of Player >= 1 and Stamina of Best Pony is 0:
		say "      Huffing after a long day carting around your increasingly heavy foals, you decide to stop for brief rest upon a conveniently empty patch of ground to give your hooves, and lightly swollen equine ankles a well deserved rest. Gods, you girls aren't making this easy, you rumble, blowing an errant lock of hair out your eyes as you rest your hands on your ample belly. Still, it's not their fault, this body doesn't feel like it was meant for carrying around big loads. You chuckle through a tired, but cheerful smile, as you lean back, idly massage the growing curves of your tight, tender middle, watching the adorable impressions of your rowdy daughter's tiny hooves flicker across your hide. [italic type]OUCH[roman type]! Not so rough girls, mommy needs those organs! You plead, gingerly rubbing your sides, trying to calm your riotous brood as you gasp for breath.";
		say "      For all your occasional discomfort though, the strangely endearing sensation of your hands roaming your growing silken figure, and the odd rush of nanite-tainted hormones is more than worth the trouble. After all, there's something so... primal, not to mention satisfying about feeling your body blossoming with new life, that it's difficult for you to stay upset for long. You opine, humming a wordless clarion tune to fillies as you wrap your arms around yourself in tender admiration of your babe's progress. Sure, they might not be human in the traditional sense, but then again neither are you. But the pure excitement gripping you at the thought of bringing more sweet horsey beauties like yourself into this world that any trepidation you might have felt is lost beneath the joy bubbling in your chest. You muse, caringly running your fingers along your puffy navel while you sing to them. Your little ones slowly seem to calm down, leaving a light fluttering sensation, like butterflies dancing in your stomach as if in apology.";
		WaitLineBreak;
		say "     That's better, you pant, giving them an appreciative pat. Now just sit patiently a little bit longer, and when you're born, mommy promises to take you all down to the track for a nice family run. You titter, watching your babes wiggle happily in reply. Good girls, bet you're all going to some real champions one day, you beam, lips curling into a dopey grin as pleasant images of your precious foals standing atop some gleaming white podium. Their necks adorned with all manner of medals and their tight fitting sailor uniforms covered in a brilliant tapestry of corporate logos dancing across your mind's eye. Sighing, you can almost hear the roar of the crowd belting your surname through the stands as your sweet fillies take a bow, giving thanks to their lovely mommy for raising them. Maybe one day, you whisper, feeling the strength return to your legs as you shuffle to your hooves, just a touch refreshed and ready to take on the day once more.";
		PlayerHealed 10;
		increase Stamina of Best Pony by 1;
		now XP of Best Pony is 0;
	else if Cunt Count of Player >= 1 and Stamina of Best Pony is 1:
		say "     Shuffling through the streets, ripe swollen gut wobbling in tune with your every step, you find yourself panting for breath again as the soaring weight of your foals begins to take its toll on you once more. Shit this body just isn't made for this, you grumble, sweating pouring over your tired body as you cup your hands along the glowing mass of your over-packed belly, and collapse into the ground with a defeated neigh. At least this will be over soon, well, you hope so. You shrug, casually stroking the glowing hem of your heavy baby bump in quiet amazement at how quickly you've grown. After all, you don't know how much more of this your ankles, much less your chest can take. You huff, gently wiping aside a few streaks of ambient perspiration from your lustrous bronzed middle and generous underboob. Then again, you do have to admit the view is kind of nice, not to mention the attention you get wandering through the few civil sections of the city is thrilling in its own way. Some facet of your tainted mind preens, watching the [if daytimer is day]sunlight dance along your sexy figure[else]moonshine glitter about your fecund figure[end if].";
		say "     The feeling of your leg fur lovingly caressing your tight little belly as you walk is slowly turning into a guilty pleasure of yours as well, to say nothing of the sex. You knew getting railed while pregnant was one thing[if player is herm] but, you never dreamed having your heavenly [cock size desc of Player] horsey cock blown in this state would feel so good[else] yet, you scarcely dared to imagine how wondrous getting railed by a nice fat monster cock could feel in your more needy moments[end if]. Besides, this body could use the extra endurance training. What good is all your form's natural speed if you don't have the stamina to keep it up for long? Perhaps in another litter or two, you'll get used to the weight, and be made all the stronger for it, you wonder, sensing the strength returning to your limbs. You flex your equine ankles in carefree satisfaction, as you pick yourself off the ground and return to your day with an added spring in your step.";
		PlayerHealed 10;
		increase Stamina of Best Pony by 1;
		now XP of Best Pony is 0;
	else if Cunt Count of Player >= 1 and Stamina of Best Pony is 2:
		say "      Grunting under the weight of your heavy foals while you amble through the city on one of your rougher days, cursing whatever thoughtless brute knocked you up this time. True, you [italic type]could[roman type] have tried to get them to pull out, but would it kill your foals to be a little more considerate of their poor mommy's waistline! You grumble, peering down at the softly glowing dome of your hefty middle slung out before you. It's getting harder to ignore how much tighter your skin has been feeling these last few hours, much less the strain being put on your dainty equine ankles. You huff with a disgruntled snort, giving your bump an inquisitive pinch, wondering if perhaps you might have put on a few pounds since your previous litters, though that should be impossible. You've been more active than the average mother could ever hope to be, although, glancing at your blossoming [breast size desc of Player] breasts, this might be unavoidable. Your cream tanks have definitely gotten a little bigger these past few days. Not that you don't wear it well, or that it's not going to a great cause, you chuckle, admiring the supple impression of your adorable mounds lazing on the roof of your snug midriff."; 
		say "       Pleasant images of your sweet little foals cuddled up against your ample assets while they take their first drink play across your mind's eye as you gently trace a nail along the perky bight of your flush nips. Your calves though are another story, and while it's only natural for your body to ripen in preparation for your foals, as your leg muscles have definitely been getting the workout of a lifetime thanks in part to all the craziness floating around the city. They still feel a bit bulkier than they should, you ruminate, curiously running your hand down your silky thighs, observing the subtle sparkle of your pelt reflecting in the light. What's more, an odd tenderness has been building along your groin for the last few hours. Most likely, you simply sprang something, or overtaxed a muscle or two, but the nanites would have corrected that by now. Perhaps you should give the area a feel just to make sure it's ok, or you could just ignore it? Your healing factor will sort this in no time, and it's not good for your mental health to work yourself into a lather over every little boo-boo.";
		LineBreak;
		say "     [italic type]What would you like to do?[roman type]";
		LineBreak;
		let horsing_around_Choices be a list of text;
		add "Ignore whatever is wrong, it will pass in time anyway." to horsing_around_Choices;
		add "Examine yourself?" to horsing_around_Choices;
		let horsing_around_Choice be what the player chooses from horsing_around_Choices;
		if horsing_around_Choice is:
			-- "Ignore whatever is wrong, it will pass in time anyway.":
				say "     Shaking your head, you decide to ignore it, after all, a few aches and pains are normal for pregnant [if player is female]women[else]herms[end if]. Considering how fast you come to term too, you definitely just overextended something on your travels. Best to put whatever this is out of your mind, and focus more on the important things like surviving, you hum with a lazy shrug as you continue on your way.";
				LineBreak;
				say "     [italic type]Author's Note: Ipotane content ends here for now, and a special thanks to aishanyan for their help filling out the milk item tables.[roman type]"; [aww shucks]
				LineBreak;
				now XP of Best Pony is 0;
				now level of Best Pony is 1;
			-- "Examine yourself?":
				say "     Reasoning it can't hurt to make sure you haven't injured yourself, for your foals['] sake if nothing, you indulgently slip your hand between the toasty bight of your oceanic middle, and silky furry thighs. Internally basking in the vibrant dissonance of your luxurious fur and glassy smooth skin gracing your mitts as[if player is herm] the sinfully sweet saturnalian sensation of your fingers slipping beneath your dense, furry balls plays across your senses as you grope a handful of welcoming maternal flesh[else] the lustful warmth radiating off your blushing muff as you massaged a handful of ample maternal flesh[end if]. Your fingers brush a pair of perky little bumps peeking through your brownish-black fur, alongside an odd layer of added pillowy padding along the top of your [cunt size desc of Player] mare cunt. Rightfully perplexed, you experimentally pinch one of these perky nubs, and audibly gasp as a sudden rush of balmy liquid washes over your digits along with an unusually familiar sense of relief. Alarmed and confused in equal measure, you hastily bring your hand to your face and examine the pale white substance dripping from your fingertips. Is that... milk? You wonder aloud, giving your fingers a quick sniff, as the all too common scent of your cream wafts about your nose.";
				say "     No way! How did that?! When did that?! Why did that!? You sputter, rapidly blinking your eyes as if the simple gesture could somehow wake you from this feverish dream. Try as you might, the milk remains, alongside the odd sense of tenderness roiling through your groin. Your heart is gripped by a cold sobering sense of icy alarm at thought you might have somehow gotten exposed to a heretofore unknown variant. Or worse, you fret, taking a worried gulp, come in contact with an infectious object during your recent travels. Much as you might prefer not to think about it, it only takes a few strands of hair, a drop of tainted fluids, stars above, even a single mosquito bite could ruin your form! You shudder, hurriedly scouring the area for some manner of reflective surface to examine yourself. Fortunately, the city is riddled with all manner of broken glass left behind by the first chaotic wave of change that swept through. You soon find a large slab of shattered glass tucked away in the ubiquitous debris littering the city since its fall. Propping it up, you position yourself over the convenient fragment[if player is herm], gently hefting your [cock size desc of Player] horse cock and supple package out of the way[end if] as you peer down at your feral sex.";
				WaitLineBreak;
				say "     Your eyes widen in raw disbelief as you catch sight of a pair of soft black nipples poking out through your brownish-black pelt just above the glossy lips of your cute puffy pony pussy. Though a torrent of questions bubbles within you at their sudden appearance, you focus instead on checking yourself for signs of further change, or the presence of any foreign objects that might have gotten caught on you during your travels. Yet, despite a thorough search of your motherly personage, not a single hair seems out of place, nor can you detect any of the 'normal' indications of an impending transformation anywhere on you. Then it hits you, the foals! You cry, protectively clasping your hands along the supple hem of your precocious bump. Your equine infection must be gearing up for your latest batch, then that means... your udder is coming in! You stammer, mind waffling between disbelief and arousal at the deviant notion of such changes, while you worriedly paw at the blossoming bulge of the nascent glands. In spite of the oddness of the situation, a sudden flutter of motherly excitement still tugs at the edges of your mind as your fingers explore the burgeoning swell of your crotch breasts with caring kneading motions, while a light trickle of cream beads from your virgin ducts.";
				say "     After all, you haven't seen many infected sporting cream fountains like this, you preen, watching the downy crotch pillows swell with each tender motion. Just thinking of the jealous looks the local mares will give you when they see you strutting through the city with a nice fluffy udder balanced beneath this big sexy belly already brings a smile to your face. You purr, in lewd admiration of the rich glow of your regal bronzed hide and cute little outie reflecting in the glass beneath you. Already, you can only imagine how the local stallions, or some of the naughtier herms will react to the sight of you too! Why, you hum, running a nail about its beguiling bight, they'll be lining up for miles for the chance to gift you with another batch of precious equine prodigies. In time, you might even end up with a stable (or seven), full of your champion thoroughbreds. You smirk, picturing your ripening body draped across a luxurious bed of alfalfa while the adoring faces of your brood crowd around you, eager to present their latest trophies, or medals to you. You pant, watching your fur recede as your hide bulges outward into twin glossy tanned domes, capped with adorable ebon teats, just begging to be suckled upon. Undeniably silky, and just the right kind of supple, you find yourself shivering with unbidden delight as your fingers sink ever-so-slightly into the balmy bludge of your au courant udder. You slowly work your palms upward along your sensitive ducts, tenderly kneading a scintillating jet of cream from your ripening mounds with but the slightest tug.";
				WaitLineBreak;
				say "    Mh this feels good... but, you pause, listening to the bawdy slosh of your burgeoning crotch pillows swaying between your legs, mommy needs more. She needs to be bigger, stronger, faster for her herd. As intoxicating images of your sweet, hungry foals['] faces clambering around their mother's cute, snugly milk tank, and full, heavy breasts. Their eyes alight with wonder and hunger as they gush appreciatively over your maternal bounty. Grinning, you can practically feel their breath wafting about your scrumptious cream spouts as they eagerly wrap their lips about your nips, drinking in all the luxurious cream and wisdom your body has to offer. Ah good girls, you hum, dreamily, feeling the primal maternal urge to provide for your brood taking hold of you as the ample weight of your udder presses down your eager mitts. Perhaps reacting to your latent desires, or acting upon the nanite's own perverse programming, your legs begin to crackle with new found vim as the primal, animalistic muscle, and protective tallow decorating your lower half surges outward. Whinnying excitedly at the motes of change gripping your lovely figure, you soon find yourself stomping upon the ground like an eager mare itching for the track. While the ground creaks, and noticeable ripples pass through the earth as the nearby debris quivers in tune with the riotious pounding of your thunderous hooves.";
				say "     Fuck yes, you moan, watching your ass ripen with blissful contentment as your hips widen by the second into a proper shapely heart-shaped tush, befitting a regal mommy mare[if player is herm]. All the while, your girly cock strains against its sheath as your tool groans with pullulating inches of virile fresh that would put many lesser sires to shame[end if]. Though as the changes soon spread upwards, your lithe core starts to lose some of its prior definition as a creeping softness spreads through you. You can't resist cheekily running your forearms along the silky mass of your blossoming baby bump while you caress your sloshing crotch pillows. Almost basking in the noticeable thickening of your womb, as the productive tissue engorges ever-so-slightly to provide for your growing foals as they kick excitedly within their luxurious home. Oh such strong babies, you're all going to make your mom so proud one day, you coo, riding out each forceful quiver as the your overactive bundles of joy seem to drink in the vibrant change alongside their naughty mother.";
				WaitLineBreak;
				say "     While your breasts start to churn with renewed propose as their satin contours slowly glide over your sylvan middle in a hedonistic tide of milky bliss in preparation for your coming foals. Another time, you might have reeled against these changes to your aerodynamic form, yet your precious babes will need every drop to grow into strapping studs, or flirty mares. You gloat, relishing the saturnalian sight of the tiny beads of savoury pearly cream dribbling from their blushing ducts and down your radiant tan tum in a soothing stream of excess. Besides, this little handicap will just make any future races far more exciting, and surely help you develop your stamina even more, you think of yourself as the vibrant squall of change wracking your milfy body ebbs. Though slow, the heady growth of your now [breast size desc of Player] udders reaches its apex as the last few spurts of rich ambrosial nectar from your au courant cream tanks drip upon the patched earth beneath you. You're left feeling unusually content, not to mention lighter on your hooves in spite of your changes.";
				say "     Delightfully spent, you reluctantly let go of your now prominent nips and ample crotch pillows while you straighten yourself with a playful neigh. As you do a quick little twirling admiring the inviting bounce of your ample ass, and proud shapely legs reflecting upon the mirror's surface. A lustful fragment of your tainted psyche feels somewhat cheated that the changes stopped so abruptly. Yet, even this hard-to-please facet of your mind appreciates your all-the-more motherly figure, and the generous strengthening of your now stockier body. While still every bit the speedster, your enhancements have left you feeling proud, confident, and maybe, just a bit randier too as the lovely little kiss of your satin pelt gliding along the heavy hem of your burgeoning belly is fresh pleasure in and of itself. Not that anyone could blame you for feeling this, you chuckle, giving your ass a wet meaty slap.";
				WaitLineBreak;
				say "     A body like this is meant to be shared, and just think what a few more litters will do to you! You titter, dreamily fondling your turgid stomach at the thought of finding a bawdy stallion to ride and truly put your altered body through its paces[if player is herm]. Who knows, you might even locate a nimble mare worthy of your attention too[end if]. You ruminate, lovingly draping your hands over your blissful bump, cheerfully asking your foals if they'd like a few little brothers or sisters to play with one day. Quickening happily in reply, your little ones['] enthusiasm is almost infectious as the effervescent hormones coursing through you leaves you humming with wordless joy at their exuberance. Thought so, you coo, tickling one of their hooves as you amble off with a duly pleased smile on your lips.";
				now Stamina of Best Pony is 3;
				now XP of Best Pony is 0;
				now HP of Best Pony is 1;
				StatChange "Stamina" by 1;
				Statchange "Intelligence" by -1;
				if "Flat Chested" is listed in Feats of Player:
					FeatLoss "Flat Chest";
				if "Passing Grade Chest" is listed in Feats of Player:
					FeatLoss "Passing Grade Chest";
				if "One way" is not listed in Feats of Player:
					FeatGain "One Way";
				increase Cock Length of Player by 2;
				increase Breast size of Player by 2;
	else if Cunt Count of Player >= 1 and Stamina of Best Pony is 3:
		say "     Listlessly wandering down some dull, solitary section of the wider city, taedium vitae, and a budding restlessness nips at the back of your mind as you scan the vacant area looking for any sign of stimulation. Bored as you are, you'd kill for the attention of some cute feral to take the edge off the building heat in your glossy mare cunt[if player is herm], or throbbing pony prick[end if]. Finding yourself well and truly alone, without even something as simple as a latex fox to give you a spot of fun, much less a pleasant little chase so you can vent some of your pent up horsey energy. You decide to have a quick, impromptu run, after all, it's important to get your cardio in, especially in your current condition. You note, giving your ripening core a gentle rub while you rake the earth with your hooves. Smirking at the thought and the sublime silkiness of your taut tanned hide gracing your finger tips, ";
		if Equinoid Warrior is listed in companionList of player:
			say "you hurriedly pass your equipment over to a rather perplexed looking Liliana, ";
		else:
			say "you hurriedly set your equipment down, ";
		say "and do a quick series of stretches before taking a sprinter's stance. Your leg muscles tense with anticipation while the ground cracks beneath your hooves as you settle in place and count down. One, you hum, tensing your flanks; two, you murmur flattening your ears...Three! You bellow, cracking your tail like a crop as you launch yourself forward in a brunette blur.";
		say "     Heart pounding in your chest, the world narrows to a fine line as you spring into action, barreling down your chosen course. Untold meters vanish beneath your proud gallop as the bracing, brisk air caresses your maternal form like the loving fingers of some treasured mate exploring your generous form. While your flowing hair whips behind you in a shimmering tassel as you make your first flawless turn and dart back towards your gear without even breaking a sweat as your form's inborn desire to race begins to creep over you. In no mood to resist its call as the rush of adrenaline and profound sense of freedom blankets your mind in an enthralling balm. Your return trip is even quicker as your proud thunderous hooves tear into the ground, leaving deep gouges in the earth. As the area rings with their wild clop while you complete your first lap, then barrel into a second, and a third. Each one faster than the last as your runner's high urges you onward while sweat pours down your brow and the deepening chasms of your [breast size desc of Player] breasts in rich, effulgent rivulets.";
		say "      Unbothered, the perspiration only eggs you on as the air cools, and massages your liminal body, pushing you deeper into your speedster's trance. Neighing in delight at the raw horsepower coursing through your being, while the pounding of your pulse washes over you like the roar of some adoring crowd. You slowly lose track of your laps as the desire to push your majestic form to limits spurns you in ways no jockey, or trainer could. In time though, even your nanite-enhanced being starts to ebb as your heart clenches, knees ache, and steam billows from the edges of your lips like ribbons of velvety white hoarfrost. Yet still, you push on, desperately racing against some imaginary clock till every ";
		if "Touched by Madness" is listed in feats of Player:
			say "centimeter "; [only crazy people use metric, huh?] [Its a ref to Lillith's Throne, you can choose to set the game to American mode to get U.S. spellings and imperial measurements. True, I've fallen out of love with the game, but in honor of the effort I keep this running gag around. Further, I got permission to use Touched by Madness as silly mode.]
		else:
			say "inch ";
		say "of your augmented figure starts to cry out in alarm. Pushing back against this feeling, you barrel through that wall with a defiant gasp as the fatigue leaves you and the world goes quiet and serene, your every hoof fall flowing into the next in perfect lockstep as you pound the earth flat beneath you. How long this continues, you can't be sure, but after what feels like hours, you finally allow yourself to rest as your come to rolling stop ";
		if Equinoid Warrior is listed in companionList of player:
			say "beside Liliana.";
		else:
			say "beside your equipment.";
		WaitLineBreak;
		say "     Huffing, and dripping head to hoof in a clinquant shroud of sweat, you stumble over to a nearby bit of broken wall, bracing your arms against it as you pant in exhaustion, and the heady sight of your glossy assets bobbing before you. Fuck that felt good, you huff, watching the perspiration drip down the taut hem of your prominent middle and milky tits while a soft little hungry rumble flickers across your ample bump. Guess that run really worked up your appetite eh girls, you titter, giving your sweet widdle bundles of joy a cheerful pat as thin rivulets of champion's cream bead from your nips. Quivering in reply, your overly-precocious foals rancorously kick and paw at your fingers as you massage your sensuously slippery body. Good, cause mommy is hungry too, and as luck would have it, she has the perfect treat for both of us. You chuckle, cheekily tucking your perky nip to your lips, gleefully lapping at the succulent streams of nutritious cream flowing down your chest and scrumptious rondure of your tight tender body.";
		if Equinoid Warrior is listed in companionList of player:
			say "     While Liliana looks on with a little lewd grin as pearlescent drops of musky herm pre mare dribble from her sheath at the sight of your vulnerable glossy cunt and equine udder. The poor pent up girl seems hopelessly transfixed by the lewd swaying of your hips, as you enticingly rub your heaving tum as it bobs between your legs. You snicker, sparing her a cheeky glance, as you let out a teasing whinny like a wild filly at her smoldering expression, and vivacious blush of her titillating cock wrapper as the blunt flared tip of her foot long spire peeks out from its soft, satin housing. You invitingly flick your tail at her, as eager beads of lucid feminine dew trickle along your glossy ebon folds at the sight of your pet's delicious hermhood. Equine nostrils visibly flaring at the sight of your little display, your pet stumbles forward, shamelessly huffing your needy scent. Her hand drifts to her silky onyx sheath, openly massaging its length like a scrumptious toy. Your eyes widen, and mouth begins to water at the sultry spectacle of her jet black dick wrapper dandling about her mottled cock as she looks to you for permission. Go on, you murmur, arching your back to better highlight the regal swell of your gorgeous gravid figure and nice heavy udder to the wild tribeswoman.";
			say "     Nodding, she struts up behind you with loud, heavy hoof falls, sending a desperate shiver up your spine as the young herm takes hold of your shapely ass, rumbling. 'Mh, you've grown into such a fine mare [name of Player],' appreciatively stroking your lustrous satin fur. Blushing at her touch, and the rich thick flavor of your cream dancing across your palate, you simply bob your head in reply, pressing your sweltering mare cunt along the bestial contours of her gorgeous cock. While you swoon at the virile throbs of her dick lavishing your petal, and the incorrigible kicks of your foals waltzing across your supple, glittering middle. You gently rock your palatial muff along the glossy breadth of Liliana's bestial tool, slathering her cock in a generous coating of your fem honey as she lines herself up behind you. Whickering, the bawdy herm rakes her hooves along the well-trodden earth in a simple-minded rhapsody, as your regal lips engulf the tender tip of her blunt member in their saturnalian embrace while she rears back.";
			WaitLinebreak;
			say "     Drawing the delectable taper of her rod along your rubbery dewy folds, before bucking her hips forward in a single fluid stroke as she hilts her immaculate cock almost to the base in a lascivious, spine-tingling motion. Nickering ecstatically, cream streams from the edges of your lips as your foal flushed petals bulge with the weight of her rod and ambient pounding of her generously lubed cum vein playing along your feral flower. Gasping, you almost lose your hold on your sweat slicked tits at the heady pounding of Liliana's foot long spire reverberating through your fecund body with each rancorous piston of her hips, and lewd patter of her fluffy ebony ball bag bouncing along the silky hem your adorable udder. Yet hunger, and the overpowering primal need to provide for your big sexy foals steels your grip upon your [breast size desc of Player] sweater puppies. As you gulp down great mouthfuls of delectable champion's milk, mentally urging your brood to drink in your gift, and grow into strong mares like your mate. Your satin passage grips the eager girl's cock all the tighter, leaving you shuddering with bestial bliss at the invigorating kiss of her bestial flared head caressing your needy folds.";
			say "     Mh so good, but you need more. You mumble, encouragingly tapping your tail about her tightly muscled flanks like a living crop, as if to urge her on. Snickering under her labored breath, the randy mare leans ever-so-slightly into your touch, while the lewd patter of her thrusts resonates through the area in a sultry samba. Your pet's hands drift toward the pleasantly welcoming contours of your turgid udder as she playfully runs her hands along its pillowy majesty. 'Of course,' Liliana purrs ecstatically, sinking her fingers into your pillowy cream tanks as she leans over your back. Letting the warm, lustful heat of her body play across your back while she nuzzles her equine muzzle through your hair like an affectionate pet. Humming at her words, and the heavenly kiss of her fuzzy abs gracing your spine as your pet hugs you close, in her confident embrace. Your mate tucks her snout to your ears, tenderly kissing their silky tips, as her lustrous pistons of her beastly tool cascade over along your welcoming cunt, leaves you panting for more.";
			WaitLineBreak;
			say "     All to Liliana's building bliss as she tweaks her satin fingers along your prominent crotch nips, remarking. 'Such bounty, you could feed the tribe with these,' coaxing sweet streams of motherly cream from your perky ducts while her digits sink in their smooth pillowy splendor. Positively melting into her caress, your senses reel at the felicitous pistons of her monstrous cock lavishing your throbbing button[if player is herm] and quivering prostate[end if] at the apex of her enthralling strokes. You can only bob your head in thoughtless agreement at the notion of whiling away your days amongst her kind as their prize milky breeder. Enticing images of your gravid form surrounded by her worshipful tribe's people suckling, and pampering your motherly form fills your mind. Briefly closing your eyes, you can practically feel their soft lips roaming your lovely cream spouts and hard sun kissed nips as they feed. The heady caress of their nice, fat cocks filling you with precious foals, and the proud, happy looks on their sires['] faces as you parade your latest litter about their humble camp.";
			say "     Drunk on the fantasy, and the heady slosh of your creamy filled stomach swaying in tune with Liliana's thrusts, your free hand drifts to the sleek bulge of your riotous middle as your foals kick and quicken with shared delight. Such active girls, you murmur, mind alight with the succulent bliss gracing your palms as the potent nanites filling your radiant form whorl to life. Driven by the bubbling desire to provide for kith and kin gripping your [bodydesc of Player] core, your teats grow endearingly warm to the touch. Your productive glands expand in your sweat slicked grasp, as the spill between your finger tips in a sudden gush of rapturous expansion. All the while, Liliana looks on over your shoulder in awe at the fruitful changes gripping your [bodydesc of player] form. Go on, you chuckle, drawing your mitts to your unoccupied tit, cheekily fondling the tender teat, as you languidly jostle its supple weight before her bright hazel eyes in offering.";
			WaitLineBreak;
			say "     Snorting at the sight of your rich, leaky chest pillows wobbling before her, the bawdy herm nuzzles her regal head down the side of your neck, before drawing her lips to your perky nips with a lurid kiss. You're left swooning at the beguiling softness of her fur playing across your hide, and gentle little tug of her hungry mouth along their perky tips, as a relieving stream of balmy cream erupt along her soft flat tongue while she suckles. Her thrusts never once skip a beat, as her bestial rod glides about your walls in an invigorating rhythm all its own, seemingly drawn to your needy folds like a comet caught in your erotic orbit. As each vivacious pulse of her throbbing spire and primal caress of her blunt, flared dick ripples through you in a tidal wave of sensation as your mare muff desperately milks her lascivious rod.";
			if Player is herm:
				say "     Awash in this squall of desire, your poor neglected cock cries out for attention as the bawdy collisions of your foal packed core massaging your cute equine sheath and tainted elysium of Liliana's thrust surges through your desperate sirehood. Panting, your dick wrapper enticingly tightens about your [cock size desc of Player] tool, hugging its bestial bight in a warm, carnal embrace as the first little hints of your adorable pony pecker slips free. Whimpering under your breath, you want nothing more than to wrap your hands about its supple length, to feel the primal pounding of your dick waltzing in your palms. As you stroke yourself off while your loving mate pumps your needy folds full of precious pony batter. Perhaps sensing this, or smelling the earthy musk of your pre saturating the air, Liliana's free hand glides about your waist, casting sensual furrows through your fur as she snakes her mitts about your chubby [cock size desc of Player] cock. Thank you, you whisper, between suckles at the supple kiss of her pads gripping your tool.";
				WaitLineBreak;
				say "     Murmuring some sweet nothing in reply, your caring pet merely nuzzles her cheek against you as she runs her smooth palm about the hardening length of your dick, coaxing it to full mast with lovingly flicks of her wrist. You can't help but bask in the silky kiss of her rich black fur playing around your dick and the deviant attention paid to your flaring cock head at the apex of her strokes almost makes you cum on the spot. Yet, your hermy body seems to crave her prolonged caress almost as much as you do as you mentally push back against the budding pressure surging through you. Your virile pet alternates her focus from your rich, beastly shaft, lavishing its throbbing girth with the unearthly smooth kiss of her palms. To the pillowy mass of your girly sheath as she lightly draws your snug cock wrapper about the base of your dick in a sensuous, practiced motion that leaves the waning fragments of your human psyche reel at her treatment. As your wondrously tight dick wrapper gently glides along your tool like a living fleshlight, hugging and cinching in tune with the steady pounding of your lustful pulse.";
				say "      Stars above, sheathes are amazing! How did you ever live without one? You wonder, surrendering to your confident lover's strokes while the meaty patter of your glossy baby bump along your well-loved dick pushes you all the closer to the edge. Still, you rail against this royal pounding, desperate to eek out just a few moments more with your fellow horsey herm. As your nimble mate's thrusts grow all the more wild and untamed with each passing second while the lewd impressions of her proud rod flicker along your elastic cunt. As she roughly batters your hungry cervix with the delectable tip of her blunt bestial tool, leaves you quivering in delight. More than built for such treatment, your rubbery mare muff greedily hugs the steely length of her tool all the tighter while the subtle ridges of her cockhead brushes your masculine g-spot with the brutish rhythm your liminal body craves. Till with one final elated whinny, you cum, cock straining against your mates grasp as you drenching your midriff, and the ground beneath you in a musky sheen of slutty mare seed."; [merge here]
			say "      The budding symphony of static desire gripping your pony pussy nears its crescendo, enthralling motes of polychromatic light wink across the peripheries of your vision while the once robust flow of transformative milk begins to ebb. Though your stomach aches with the sheer weight of your meal, and adorable kicks of your precocious widdle monsters, as you fondle your fecund mounds, trying to coax just one more rush of delectable cream gushing across your palate. Your boisterous lover's rod hammers your elastic muff with vivacious alacrity sending intoxicating shockwaves through your well-loved form. Till the velvety kiss of your walls and rich regal flavor of your cream overwhelms the young herm, as she cries into the ample swell of your breasts in release. Her girthy cum vein bulges with delectable beads of mare cum roiling across her bestial tool as she finishes, basting your spasming cunt in a molten deluge of fragrant pony batter. Panting, your spent mare loses her hold on your diamond hard nip, she collapses onto your back with an audible [italic type]thud[roman type] and a contented sigh. Huffing in turn, your hand shoots out to brace your both your tired, stated forms as you bask in the messy aftermath.";
			WaitLineBreak; 
			say "     Milk and mare cum dribble down your glowing hide in a pearlescent veneer as you lovingly rub your face against Liliana's gossamer fur, whispering tender words of appreciation in the well-hung herm's ear. Thanking her for treating you, and, you pause, enjoying the look of lustfully rapt attention on your lover's face as you give your glossy bump a duly deserved rub, before continuing. Your foals a much needed spot of fun. Muttering bestial nothings in reply, your mate slowly disentangles her strangely soft body from yours and before stumbling backwards with huff and hoof pounding pop as her dick slips free of your folds with a tail twitching pop. '*Ooof* of course,' she trills, giving your udder one last cheeky squeeze. Tittering, you voice your agreement as you slowly turn to face her, only to have your eyes go wide at the sight of a fluffy food-baby, neatly slung over her sheath and generous milky mustache drawn across her muzzle. Daw, how cute, you giggle, in a gentle airy cadence, drinking the sight of her tight, toned dome-shaped belly, and flustered look in her sweet hazel eyes.";
			say "     Before advancing upon her and lightly, playfully brushing your own tender middle against her silky pelt, shivering in base delight at the endearing caress of her fur brushing your navel. You know, you tease, leaning in to gently lap at the errant drops of cream scattered across her lips, she might look pretty good with a litter of foals one day. Visibly embarrassed, your well-fed pet tilts her eyes to the side, struggling to escape your smoldering gaze. Though only briefly as you work your palms across her pelt, complementing the sputtering equine on her figure. 'M-may-maybe, if I found the right mate that is...' she stammers, a deep wine purple blush spreading across her cheeks while her tail bobs behind her excitedly. Flashing your plaything a devious smile, your hands drift down to your [if Player is herm]meaty flaccid girl cock[else]glossy pony puss[end if] as you trace your nails their borders, telling her that can be arranged.";
			WaitLineBreak;
			say "     Why just think of all the fun the two of you could have as [if player is female]mommy mares[else]futa mommy mares[end if], you ask giving her tool an encouraging squeeze while you press your shimmering mounds against hers. 'Mh that could be nice... one of these days.' she whinnies, peering down at the bountiful hills of your hybrid breasts with unvarnished delight. Nodding, you tell her of course, you don't want to pressure her too much, you simper, giving her one last quick kiss on the snout. 'Thanks,' she hums as you lean back and motion for her to fall in again, after all, you can't spend all day playing. 'Right,' Liliana swoons dreamily, while trotting behind you, though as go to gather you things, you can't help but notice her hands drifting to her prominent milk stuffed middle, and goofy grin on her face as she strokes her fur.";
			now Stamina of Best Pony is 4;
			increase Breast Size of Player by 2;
			now XP of Best Pony is 0;
			StatChange "Stamina" by 1;
			StatChange "Intelligence" by -1;
			increase Cock Length of Player by 2;
			increase Ball Size of Player by 1;
		else:
			say "     Gods this body has it all! Nice, big milky tits! You swoon, indulgently flicking your tongue about your supple ducts in simple minded rapture, at the delectable cheek filling spurt of cream erupting from your growing milk tanks, while your free hand massages their succulent silky smooth surface. Perfect dark olive skin, you hum, as your curious digits pamper the tender curves of your glowing middle. And these legs, fuck you could crack a minotaur's skull with these beauties! You crow, flexing your powerful thighs as you draw your hooves along the earth. Mhh, and this udder, heavens it's so soft and cute, you can barely keep your hands off this thing! You preen, letting your palm slide down your blossoming crotch pillows while your foals quicken ecstatically within their lovely home. Daw, guess you girls like mommy's milkers too? You simper between gluttonous swallows, tracing a pointer finger along the adorable outline of their adorable hooves pressing along the lambent hem of your glossy middle.";
			say "     As a sudden rush of intoxicating hormones surges through you, making you whicker contentedly with the shared glee of your brood suffusing your fecund form. Good, cause mommy loves her udder, and her new body, you murmur, letting your fingers dance along the lovely mass of your nascent milk tank. Utterly glossy to the touch, and just the right kind of sensitive, your lovely little equine accent feels so natural to you now, you find it hard to picture yourself without it, or you chuckle, your precious bump. True, your liminal form still craves the track and admiration of others, just as much as a belly full of foals, but that doesn't mean you can't do both. Perhaps you could even start your own preggy racing league with your fillies, and few hand-chosen mares, you coo with a devious shiver at the thought of parading your luxurious body to a stadium packed full of eager fans. Swooning at the notion, you momentarily shut your eyes mid-suckle as a fresh gout of delectable cream dribbles down the back of your throat in a soothing rivulet. You can almost feel the gaze of the crowd upon your motherly body while they drink in your milfy majesty.";
			WaitLineBreak;
			say "     All the while, a flutter of anticipation crackles the air like a coming storm as your fellow mares take their place beside you at the gate, a shared sense of primal desire coils through the air when the bell is rung and your herd tears down the track. Cooing at the blissful sight of your peers['] cuddly bodies surging beside you, your hands move of their own accord to the satin contours of your ";
			if Cock Count of Player >= 1:
				say "heavenly mare sheath. Already, you can feel the tension building beneath your brunette fur as your fingers sumptuously traces its fuzzy length, coaxing your lovely [cock size desc of player] tool to life with the softest of strokes. Relishing each bawdy throb of your girly dick as your digits sinks ever-so-slightly into your satin fur, casting cute little creases in your tightening sheath. Stars above sheathes are the best, you mumble, milk streaming from your lips and down your flanks like pearly lace as your meaty cock wrapper stiffens beneath your grip.";
				say "     Unbothered, some facet of your liminal mind basks at the kiss of your cream dripping down your well-bred hips and the enthralling trail of goosebumps left in their wake as your tool slips languidly slips free of its home with a welcome gush of pre and equine juices. Fuck this monster is amazing, you purr between gulps of ambrosial nectar at the ambient scents of your stallionhood wafting about your nose and the sublime wobble of your big, heavy middle. As you thoughtlessly rock your hips, letting your glossy sheath lewdly glide about your flaring cock as it surges to life. All the while, the balmy calming fatty flavor of your cream devilishly clings to your palate, basting your mouth in the perfect post workout treat. You ruminate, sensing the heady pinprick of changes spreading out along your core by the second, molding and refining your fecund assets to better feed your herd. Your tits grow sensuously warm to the touch as your prodigious glands ripen with fresh ";
				if "Touched by Madness" is listed in feats of Player:
					say "centimeters of fertile flesh spilling through your fingers.";
				else:
					say "inches of fertile flesh slipping through your fingers.";
				WaitLineBreak;
				say "     The extra heft merely excites you all the more as your digits approvingly glide about their slippery, salacious mass. So good, mmhh babies will love this, you hum with a proud whinny as your girls slowly press against your sweat-slicked bump. Too horny and tired to care, the taboo caress of your fecund midriff only adds to the experience as you work your mitt about your turgid tool in a wondrous mirror of your suckles. Your every motion and greedy swallow sends supple static pulses through your tender body while your form swells with life giving purpose. Even your foals seem to be enjoying their mommy's fun as they luxuriously quicken in their tightly packed home, putting just the right kind of pressure on your hybrid figure. Good fillies, you moan, barely able to keep contain the budding tension simmering in your core as your palms waltz about the throbbing swell of your cum vein and gentle slosh of your boisterous belly pampering your rod as your body sways in tune with your thrusts.";
				say "     The sordid echoes of your pleasure resonates around you in a primal crescendo, as the epicurean drips of your milk patter upon the ground and lewd squelches of your well-loved cock entwine in bawdy tattoo of indulgence, while the heady weight of your brood presses down upon your regal rod. Yet this only enhances the felicitous cocktail of delights coursing through your being, as a feverish tightness grips your chest, and dazzling hues of prismatic light dance along the edges of your visions. Spellbound, you pump your wrists all the faster, reveling in each lovely throb rippling through your cock and the bestial texture of your blunt tool massaging your slutty bump as you cum with a content nicker. The tender base of your [cock size desc of Player] cock flares, and your tight, furry sheath bulges outward with a virile conga line of excess as you blast the ground and gossamer hem of your baby bump with a ";
				if Ball size of Player < 3:
					say "light sheen of musky mare seed. ";
				else if Ball size of Player >= 3 and Ball size of Player < 5:
					say "pearly deluge of sticky pony batter. ";
				else if Ball size of Player >= 5:
					say "prodigious torrent of salty horse spunk. ";
				say "Sighing in relief, you loose your hold on your peerless tits, misting the air with a billowing cloud of cream as your weighty mound thumps against your bump. Fuck, you needed that, you pant, lightly swaying on your hooves as the waning bits of tension clinging to your fecund being melt away, leaving you feeling full, content, and sated. If only for them moment as you heft your now heavier body into a standing position, then look down once more your lascivious being with a proud grin. Damn, you're getting stacked, you huff at the succulent spectral of your heavenly tits lazing upon your softly glowing gut. Oh well, it's all for a good cause, you note, giving your flanks an appreciative pat. Your foals are going to need all the milk they can grow up to be big and strong mares just like their mommy. Besides, you wear them well and the local stallions and mares are sure to take notice of such a prime breeder, you chuff, as you gather up your things and resume your day.";
				now stamina of Best Pony is 4;
				increase Breast Size of Player by 2;
				now XP of Best Pony is 0;
				StatChange "Stamina" by 1;
				StatChange "Intelligence" by -1;
			else:
				say "dripping mare pussy, already flushed desire, the sleek glossy lips of your pregnancy puffed folds could almost swallow a man's hand in toasty depths. You crow, gleefully groping the plump curves of your beastly cunt in mitts as your dexterous digits decadently dandle about the edges of your button. Fuck this thing is so sensitive, you gush, flicking your tailing in raw delight as your muff seems to hug your fingers in its satin embrace. Gods your practically made for taking monster cocks, you giggle, flanks quivering at the thought of treating yourself to a nice [one of]Donkey man[or]Stallion Boi[or]Horse Man[or]Black Equinoid[at random] later as you dip your fingers into the welcoming elastic lips of your [cunt size desc of player] flower.";
				say "     Utterly insatiable, your ravenous passages almost seems to devour your hand with a practiced ease, as your walls grip and conform to your petite mitts, swaddling your wrist in a satin cocoon of rubbery elysium as your fingers waltz about your dripping muff. You find yourself shuddering between sips of rich champion's cream at the lewd squelches of your rubbery mare muff ringing in your ears, as you gently spread your fingers wide, relishing the gossamer caress of your box gliding along your digits as you indulgently stroke your needy folds. Though slowly at first, your practiced finger waltz about your velvety box and plump lips with deliberate care, kneading and massaging your well-breed cunt with the roiling, vivacious languidity your body craves. Each lewd flick and carnal motion of your far-traveled fingers sends a sympathetic twitch through your billowing tail as you thoughtlessly rock on the hooves, exalting in the heady ripple of the ripening swell of your scrumptiously taut tummy and cream flushed teats wobbling before you. All the while, glutting yourself on the soothing rush of epicurean cream petering from your nips in a glorious alabaster tide.";
				WaitLineBreak;
				say "     You find yourself wordlessly humming betwixt suckles, decadently savoring each beguiling drop simmering across your palate, as a heavenly thrum of transformative bliss begins to ripple through your productive mounds. Little by little, your supple breast flesh goes warm to the touch while your firm tanned hide subtly creaks with the weight of growing bounty and your succulent tits straining against your grasp. Purring in rapturous excitement, you can't help but encouragingly fondle them, urging them to grow, to provide for your growing herd, while you wallow in their spreading suppleness spilling through the cracks in your fingers. So good, you moan, milk streaming from the side of your mouth in opalescent lace tracing your supple bump and shapely liminal flanks. All to your foals elation, as their soft little kicks and quivers ripple across your blushing bump as your over-stretched tanned hide creaks with the weight of your nanite-laced cream. Mh good babies, you love mommy's milk now don't you? You preen, reveling in the ensorcelling sight and sensation of body ripening before your eyes as the effects of your cream wash over you.";
				say "     Your tender folds deepen with each hearty swallow as your fertile snatch seems to cinch and tug about your hand as if trying to milk your fingers like some common cock. Blushing at the thought, you lean into your passage's embrace, hilting evermore ";
				if "Touched by Madness" is listed in feats of Player:
					say "centimeters ";
				else:
					say "inches ";
				say "of your [bodydesc of player] arm within your velvety box with each heady thrust. Fuck, the foals are gonna do cartwheels out of this beast at this rate, you murmur, devilishly pampering the fresh virgin nerves surging into being. Fiendishly sensitive, and eager for attention, your cunt spasms with delight at the vibrant cascade of static delight flickering through you like lightning dancing on a still, moonlit pond as your elbow brushes the quivering rim of your button. Dew streams down your arm and luxurious crotch pillows, slathering both in a coiling sheen of shimmering honey as you expertly angle your vigorous thrust along its beastly figure, applying an added sensual thrill to your pistons.";
				WaitLineBreak;
				say "     A lurid creeping tension sparks through your core at the apex of your thrusts, while your flow of luscious cream gracing your palate begins to ebb to a low trickle. Grunting in raw desperation to feed your hungry foals, you knead your slippery satin mound trying to coax just one more delectable gush of cream from your needy nip. All the while, your fingers roil along your thrumming walls, the lustrous flesh seems to grip your digits with peerless alacrity as the first hints of little death bubbles through you. Panting, sweat laced with cream pours down your shapely body till, with one final elated nicker, the feverish tension streaming through you breaks with a static twang as you cum, basting the ground and your fuzzy thighs in sticky coating of horsey honey. Quivering with the numbing quakes of your titillating climax, you withdraw your hand with a lewd squelch, flicking your arm to one side, showing your hoof prints in the musky balm of girly juices."; [I feel like there have to be more words than milk and cream hmm] [There are a few like: Tit squeezings, boob juice, and nipple nectar. But they really don't work here unless the PC were an ant, termite, wasp, goo, ooze, latex, or bee queen/girl.]
				say "     Fuck, you needed that, you pant lightly swaying on your hooves as the waning bits of tension clinging to your fecund being melt away, leaving you feeling full, content, and sated, if only for them moment as you heft your now heavier body into a standing position, then look down once more your lascivious being with a proud grin. Damn, you're getting stacked, you huff at the succulent spectral of your heavenly tits lazing up glowing gut. Oh well, it's all for a good cause, you note, giving your flanks an appreciative pat. Your foals are going to need all the milk they can get to grow up big and strong just like their mommy. Besides, you wear them well and the local stallions and mares are sure to take notice of such a prime breeder, you chuff as you gather up your things and resume your day.";
				now stamina of Best Pony is 4;
				increase Breast Size of Player by 2;
				increase Cunt Depth of Player by 1;
				now XP of Best Pony is 0;
				StatChange "Stamina" by 1;
				StatChange "Intelligence" by -1;
	else if Cunt Count of Player >= 1 and Stamina of Best Pony is 4:
		say "     Galloping down some dull, serene section of the city on the tail end of another of your personal races ";
		if Equinoid Warrior is listed in companionList of player:
			say "with a panting Liliana hobbling behind you, muttering for you to slow down, and let her catch her breath. Whinnying playfully, you ease yourself into a jogging stop to spare the poor girl a side long glance with a sharp, witty tease dancing on the tip of your tongue. Yet, as your eyes drift across her horse lather soaked form, ambling some yards back, the words die on your lips as you halt in place, tutting. Oh sorry dear, guess you and the foals got a little carried away there, draping your arms along the glistening, tanned core, flashing her a disarming bleep. Nodding, the fatigued herm collapses onto the ground with an audible [italic type]*thump*[roman type] as she leans backwards, legs spread wide and her juicy sheath and plump ebony balls throbbing in tandem with her ragged breath. 'Y-yo-you think?!' she huffs, exacerbation and fatigue carved on her equine muzzle as her soft hazel orbs roll skywards while she fans her face.";
			say "     Maybe, but it's just so much fun to run, and it makes the foals happy too, you adoringly coo, idly rocking on your hooves as your resplendent body and generously milk flushed mounds wobble enticingly before Liliana's eyes. 'Right, but how do you have so much energy in your condition?' the young mare chuffs, ears flicking in an eclectic tattoo as she bobs her head in tune with your fanciful display. Dunno, you shrug, prowling up to your pet with a lewd sashay. But, you purr, coming to halt before her, leveling your mifly middle with her nose, while the tired mare's breath cascades about your sweat slicked navel as a clinquant veil of perspiration streams across your fertile form. You do find having a nice post run treat helps take the edge off. Want some? You proffer, gently fondling a prominent nip in your dominant hand while giving your perky [breast size desc of Player] breast an endearing squeeze. Dreamily, the young mare merely bobs her head, watching opalescent pearls of champion's milk bead from your perky ducts. Yes, Liliana wordlessly mouths, eyes never once leaving your delectable mounds while you coyly fluff your chest in offering.";
			WaitLineBreak;
			say "     Sorry, what was that, you didn't quite catch that dear? You simper good-naturedly, drawing your fingers about a single drop, letting it glide upon your nails before bringing it to your lips, theatrically lapping at your fingertip with a toothy Cheshire grin. '*Whine* M-may I please have a drink [Name of Player]?' Liliana stammers, shuffling her toned legs about the satin curve of her cute sheath as she fidgets beneath your gaze. Of course, you sweet widdle foal, growing [']girls['], you theatrically pause, eyes drifting along the inviting contours of her plump dick wrapper before continuing, need all the milk they can get. Now come here, let mommy take care of you, and your cock. You whinny, easing yourself beside the adorable herm, tenderly brushing the gossamer curves of your ripening body against her sheath, smearing your rich bronzed hide in a warm sheen of pony pre. 'Thank you,' Liliana swoons, while you wrap your arms about the incorrigible filly's silky onyx form.";
			say "     Think nothing of it hun, you whisper, drawing a hand through her primal onyx mane, as you pull her cute little pony muzzle to your nips. Obligingly, the eager herm nickers happily at your touch while easing her hale body beneath the comforting swell of your prominent bump and she latches on to your cream spouts with a tired sigh. 'Mhh, you're so nice,' Liliana murmurs, nuzzling her tired head against you as she wraps your silky tit between her balmy gossamer lips with a well-pleased whicker. Daw, thank you, you coo, feeling an upwelling of motherly contentment laced with a strange pride budding in your at the first tug little tug of your cute foal's snout upon your eager milk jugs. Your regal mounds need only the barest little tug before they gush a pleasant, relieving stream of cream across her palate. Humming some melodious tune to the tired mare as you pet her ears, you watch with raw delight as Liliana's cheeks bulge, ever-so-slightly with the sheer volume of your champion's milk as she takes her first adorable drink.";
			WaitLineBreak;
			say "     Huffing under her breath, thin rivulets of ambrosial cream streams down the side of your sweet filly's mouth as she struggles to match your body's output, though only briefly as the contented music of her suckles, and the tender hymn of your own voice whispering encouragement to her fill the air. Good girl, mommy's got you dear, now just sit back, and let her take care of you. You wicker, free hand drifting down her toned athletic furry flanks, tracing your nails around the endearing outlines of her toned muscles in a spiraling pattern. Leaning into your touch like a needy filly, your hungry pet nickers between suckles at the dissonant kiss of your smooth fingers and keen nails parting her pelt as you snake your hand beneath the toasty swell of your blossoming body, gently wrapping your hands about her plump satin shaft in glowing admiration of her hefty cock. Mh, just feel the tension in this thing, you moan, giving her juicy sheath a loving squeeze as the soft echoes of her pulse play across your palm. Why, when's the last time you drained this monster? You trill, indulgently gliding your fingertips about the stiffening outline of her cum vein while her cheeks blush a dark red at your touch.";
			say "     Oh don't be embarrassed cutie, it's a mother's pride and joy to care for adorable little foals like you. Now, just relax and enjoy your treat. You snicker, leaning down to kiss the silky tips of her ears. 'Yes mommy, thank you mommy,' she hums sleepily, eyes fluttering shut as she drapes her arms about your matriarchal majesty. Such manners, you beam, relief and pride cascading through you as the doting herm presses her muzzle deeper into your breast, casting lustful creases in your [breast size desc of Player] chest pillows. All the while, your inquisitive digits cinch about her cock wrapper in unvarnished rapture as your fingers sink ever-so-slightly into her velvety smooth fur, as you work your palms about her sheath like a living fleshlight. Your horsey ears twitch excited at the nearly inaudible little squelch of beastly dick tube dandling about her cock as a molten trickle of musky pre steams down your dominant hand with each tender piston. Gods Liliana your huge, you can barely get your hand around this thing, you pant, as her tool throbs in your grasp, and the first hints of her flared cockhead brushes your heavy belly.";
			WaitLineBreak;
			say "     Though your dreamy mare offers you no reply, you can still see the lewd curl of her lips as her regal dick slowly slides free of its wondrous housing and presses against your cuddly bump with a cute little thump. Such a naughty girl, you simper, drawing the lustrous hem of your nice cuddly middle along her beastly rod, slathering your devilishly sensitive skin in a tropical veil of musky pre as you carefully angle the delectable mare's cock along your ponderous gossamer smooth bump. Purring under your breath, you find it hard not to enjoy the intoxicating hedonistic kiss of her beastly rod gliding along your taut sweat slicked core, while you stroke her to full mast. Earning you a curious, yet needy whimper from the young mare as she fidgets beneath your expert touch. Daw what's wrong dear, this isn't your first belly job now is it? You titter, rollicking at her cute little blushes as she rocks her hips in tandem with your strokes. 'Maybe,' Liliana peeps, hands roaming your vivacious furry waist, while her tongue tweaks the perky edges of your nips in a soft sensual circuit. Then she's in for a treat, and, you tease, enjoying the cute look of rapt attention in her placid eyes as you grip your hand about the turgid base of her rod while sweat and pre dribbles down its thrumming length. If she promises to keep you good and bred, there might be plenty more in the future. Think you can do that hun? You nicker, playfully kissing your beatific mate on the forehead.";
			say "     Why just think of the cute widdle foals the two of you will make? You snicker, lightly rapping your tail against your effulgent middle. Or all the delectable cream she can drink whenever she wants? You tempt, giving your ample love pillows a playful fluff. Now doesn't that sound lovely? You beam, fixing her with a smoldering look as her hands explore the satin majesty of your peerless body. 'Mhh, yes, a big strong herd, all my own.' Liliana mumbles, cock sinking all the deeper into the tight contours of your tender bump as she feeds. All [italic type]our own[roman type], you giggle, drawing your non-dominant hand down her cheeks, enjoying the glossy shimmer of her onyx fur dancing in the light and the blissful suction of lips lavishing your nips as their flow starts to wane to a meager trickle. 'Oh, no more milkies,' she pouts, cracking an eye open, leveling you with an imploring stare while her middle greedily rumbles against yours. Sh, mommy's got plenty more. You tut, nuzzling your other flushed cream tank with your upper arm, gently pressing your ripe, leaky teat to her lips in offering as a shimmering droplet of cream beads along your [breast size desc of Player] breasts.";
			WaitLineBreak;
			say "     Nickering, the adorable herm's pupils widening to onyx saucers, watching the sensuous gleam of your milk dance before her hazel orbs as she strokes her silky ebony cheeks along your magnanimous mounds in simple minded gratitude. That's right dear, this is all for you, you purr, watching the scintillating steam of rich cream pouring across her nose. Giggling at the little milky mustache streaking down her muzzle, you caringly brush the little droplets off her snout, then bring the errant drops to her lips with a matronly grin. Go on, you mouth, watching her nose flare at the scent of your decadent cream greeting her senses. 'Yes mommy,' she rumbles, playfully nibbling your finger as she laps at the proffered treat. Shuddering at her eagerness, and the sympathetic twitch of her cock straining against your grip as your finger roams its turgid length in a frolicking dressage, your lover loosens her hold on your digits with a theatrical flourish and she rears back head. Leaving a thin lace of drop of drool on your digits refracting in the light like a string of glittering diamonds as she presses her eager lips to your [breast size desc of Player] teat with a pleasant whinny.";
			say "     You find yourself happily humming in kind at the lustful heat and satin smoothness of her lips engulfs your devilishly sensitive nip in a whorl pool of maternal satisfaction. As she reverently draws on your needy ducts, coaxing a saturnalian rush of balmy cream from your tight mound. Sighing happily, you reward your hungry foal with an endearing rub along the side of her face, while your tits slowly sag against your well-seeded belly as they are relieved of their nutritious bounty. Your dominant hand glides about the regal hem of her animalistic cock, indulgently caressing and massaging the blunt bell of her cock along the lucent contours of your fertile core. Exalting at the balmy blend of pre and lewd perspiration beading down her massive tool as the devilish mixture coats your plush udder in a decadent balm of excess. You can feel the tension welling in Lilian's pony prick as the hearty pounding of her pulse resonates through your sensitive hide in waves.";
			WaitLineBreak;
			say "     Thin ghostly wisps of steam coil about your pet's snoot as she struggles to match your output, her middle bulges with the warm heavenly bounty of your offering. Undeterred by the lewd sloshing of her tender middle, she pushes onward, desperate to quench her tired body's thirst. Beaming beneath the rush of relief flooding through your poor milk stuff tits, while some fragment of your tainted psyche applauds her zeal. Even as her pace slows while she thoughtlessly bucks her hips in a wild metronome, grinding her delectable dick along your palms with loving alacrity. The enticing scent of her equine desire whorl and doting little suckles ripple through your needy body like the laps of carnal waves washing over you till with one defeated gasp. She cums, sheath bulging, and balls groaning with force of her release as the lurid impression of her load waltzes across your mitt while she bastes your tender body in a molten torrent of carnal release."; [how cold is it out??] [It's just meant to be thematic and a common trope in lewds to show someone is super hot under the collar.]
			say "     More than used to such things, your nanite-touched mind swoons at the intoxicating warmth enveloping your cuddly bump and voluminous fur while you gently rub the sensual veneer of salty seed across your tight tummy. As sticky strands of pearly perfection stream down your flanks as the tired, spent, and sated Liliana desperately hugs herself against you like a fatigued foal. There-there dear, mommy's got you, you murmur, shuffling about to better support your fatigued pet. 'Thank you,' she pants, lightly rubbing her chin along your shoulder. Smirking, you tell her not to worry, caring for cute fillies comes naturally to you now, while you protectively hug your lovely mate in your arms as she slowly drifts off to sleep. In no mood to wake her, you simply hold her close, whispering a quiet lullaby to your doting mate and precious foals as they snooze in your lap.";
			WaitLineBreak;
			say "     [italic type]Some time later[roman type], Liliana slowly begins to regain her strength and hobbles to her hooves with a playful huff. 'Ooof, I think I over did it,' she neighs, eyeing her petite milk-stuffed middle with a clinical eye. Nonsense dear, why her widdle bump looks rather cute on her, you tease, giving her onyx belly fur a well-meaning rub. Snorting, the proud warrior herm giggles in reply running her hands along her snug core, humming. 'Well maybe,' stroking her tail along her glossy pelt, as her taut tum wobbles hypnotically with her every breath. See, she loves this don't she? You tease, leaning forward to kiss her gossamer navel with a light gentle. 'N-no,' she stammers lips curling into a goofy grin as she visibly struggles not to laugh at the soft touch of your lips upon her sensitive fur. 'It just felt nice to have a drink after that stupid run of yours.'";
			say "      Now, now, don't be shy, she's curious what's this is like. You simper, gesturing to your luxurious midriff. Though Liliana refuses to reply, much less meet your gaze, her hands never once leave her core as she absentmindedly strokes her treasure trail, before sighing defeatedly, 'yes.' Knew it, you jeer, but don't feel glum. Maybe one day[if player is herm] you can give her a nice belly full of foals all her own[else] you'll find a nice herm to knock her up[end if]. 'Perhaps, but for now there are other matters to attend to,' she quips, hobbling to her hooves, her cheeks glowing a deep red in embarrassment. Nodding you decide to drop the matter, for now at least, as you leap to your feet and gesture for her to fall in behind you once more.";
			now Stamina of Best Pony is 5;
			now XP of Best Pony is 0;
			StatChange "Charisma" by 1;
			StatChange "Intelligence" by -1;
		else:
			say "without a care in the world beyond your time. True, some bemused side of you notes, you weren't exactly keeping track of anything, but such frivolous concerns are the furthest things from your mind right now. You'd rather enjoy your preferred post workout treat, then pour over some boring spreadsheet or graph on your phone. You muse, lips curling into a broad grin as you gently rest your hands atop the glimmering [breast size desc of Player] tits in admiration of your changes. Tight and shapely, your bust would be the envy of any woman, and maybe even a few bois, you chuckle, running a hand along the sumptuous swell of your rowdy bun as your treasured foals lightly paw at your finger tips. Daw, looks like you girls are getting hungry too, you simper, sensing a brief flutter of activity rippling through your taut baby bump as your precious litter starts to stir. Don't worry though, mommy's got plenty of nice warm yummy milk just for you. You hum, tenderly tracing your finger along the perky contours of your supple nips, as light pearly marbles of scintillating cream bread your ducts.";
			say "     Gods you're never gonna get tired of this view, you titter, watching the thin band of milk dribble along the stately swell of your breasts then down your regal body like a lacey vine. Basking at the enthralling warmth parading down your flanks while your brood kicks in shared anticipation, you ease yourself to the ground, and reverently slipping your fingers beneath the toasty sweat slicked folds of your chest. Generously ripe and wondrously full, you can already hear the lewd slosh of your cream greeting your ears as you heft your ample orbs to your lips. Shit, you're getting stacked, not that you'd have it any other way, you preen, tail fluttering excitedly at blissful weight of your sweater puppies wallowing in your palms as you affectionately run your fingers through along their luxurious contours. Of course, the added ";
			if "Touched by Madness" is listed in feats of Player:
				say "centimeters ";
			else:
				say "inches ";
			say "suit you to a [']T['], you note, eyeing up your luxurious proportions.";
			WaitLineBreak;
			say "     It's not like you're not enjoying your life as a happy milky mare either, everything seems so much simpler now that you've truly started to adapt to this form. Those silly worries about bills, work, and all that stupid boring human stuff you were subjected to for so long feel impossibly distant now since you've started to embrace the [italic type]real[roman type] you. After all, what more could you need in life than a safe place to sleep, a good run every now and then. Some caring mates to keep you company, a belly full of the world's cutest foals, a killer set of big creamy tits, and a nice sexy udder to make you happy. You coo, shuffling your shapely thighs about the fetching curves of your cute crotch pillow as you heft your leaky glands to your lips, savoring their succulent wobble and enthralling scent of your cream wafting about your nose. Almost drooling, you cheerfully lap at the errant streams petering through your fingers, while the faint wisp of your breath caressing your oh-so-productive breasts as your lips engulf your nips in their comforting embrace. Mhh, you purr, eyes rolling skyward, ears flickering in primal satisfaction, greedily suckling on your well-loved milk spouts and your tongue explores their satin catenaries in an indulgent waltz.";
			say "     Already packed with ambrosial delights, your flushed glands need little urging to express themselves as twin rivers of your rich milk erupt along your palate, coating your mouth in scintillating sheen of delectable cream. Your cheeks blush and bulge ever-so-slightly with the sublime weight of your bounty gracing your mouth as you take your first needy swallow, relishing the rush of balmy warmth basting your throat and the vibrant kicks of your foals. There, there, mommy's got plenty for everyone, you whisper, feeling your hide tighten as the raw stream of maternal nectar hits your hungry middle. Relief interwoven with motherly pride flares though your core as you drink, wallowing in the peerless sapor of your milk, and the raw tactile delight of your fingers kneading your heavy mounds as they glide along your smooth, sweat slicked hide in an encouraging waltz.";
			WaitLineBreak;
			say "     So good, you murmur between sips, effervescent motes of maternal pleasure swirling about your flush body as you nurse these tender fonts of delectable cream with wild abandon. Your ripe, lively middle creaks with the balmy bounty of your milk and happy wriggles of your foals, evoking a well-pleased titter from your lips as their forceful little kicks simmer along your tight tanned bump. Despite the odd pinch, or brief flicker of discomfort, it's hard not to be impressed at the strength of your champions-to-be. You muse, dreamily closing your eyes, trying to picture the wonderful future that could await them on the track one day. Lovely images of your prized fillies lined up on the winner's podium fill your mind, as the world around you briefly reseeds. Prim and shapely just like their doting mother, they all cut such fine figures in their tracksuits while they wave to you, and the crowd as the roar of stadium wars with the excited pounding of your pulse.";
			say "     A part of you looks forward to the day they join you in the stables, you preen with a deviant shiver at the notion of your nice, slutty daughters following in your hoof prints. Perhaps one day your fecund line will put the American Quarter Horse to shame, you ruminate with a lewd whinny, idly shuffling your legs beneath the supple blanket of your tender middle. Fanciful images of you and the elder members of your herd parading your bountiful liminal forms upon the stage of some prestigious auction house together while seas of rich, powerful sires bid for the right to claim you for themselves. Swooning, you can nearly feel their eyes roaming your sun-kissed breasts and plump udder as you prance upon the floor like the prize mare you were meant to be. While the stage fills the scent of equine need, and the soft baying of pent-up stallions and naughty herms gazing on the gleaming onyx folds of your cunt, or drooling over the majestic bounce of your heart-shaped ass as they drink in your peerless figure.";
			WaitLineBreak;
			say "     Shivering in sultry delight, you can easily see yourself spending your middle years in well-earned luxury with all manner rich patrons caring for your every whim. Each one eager to breed and pamper you in the hopes you'll give them some storied racer, or burly draft beast. You fantasize, gulping down mouthfuls of libidinous cream, savoring the fanciful flavor roiling across your tongue as the first little gush of milk graces your taste buds, and the heavenly warmth serenading through your core that accompanies each swallow. Though as its heat spreads through you, you can sense the subtle tingle of your nanites whirling to life, spurred on by the incorrigible effects of your tainted milk and your motherly disposition, your ";
			if "Touched by Madness" is listed in feats of Player:
				say "lovely lady lumps ";
			else:
				say "[breast size desc of Player] love pillows ";
			say "grow heavy in your grasp as the enthralling flesh strains against your hold. Mhh more, you gush, kneading your tender tits as their inviting heft weighs down upon your matronly body.";	
			say "      Even your foals seem to be enjoying your changes as they drink in your offering, their fluttering movements become stronger by the moment, you coo watching their widdle hoof prints simmering along your cute fecund middle. Ah such happy dears, you pant, almost drunk on the potent rush of the corrupt hormones coursing through your milk, molding you all the more into the perfect broodmare for your young. Yet, you can only handle so much as painful bands of biting tightness cinch around your stomach as your poor belly struggles to keep up the demands placed upon it. Huffing, you try to push past this meager distraction, concentrating on the rich, fatty flavor of your cream and the silkiness of your skin, if only briefly while your bountiful breast flesh spills between the cracks in your fingers. Until the discomfort grows too much to bear, you release your hold on your leaking mounds with a dejected snort, milk misting the air in a pearly cloud of excess as your tits thump against your radiant baby bump with an audible plop.";
			WaitLineBreak;
			say "     Panting, you ease yourself to the ground, watching cream drip from your luxurious nips in a steady drip of alabaster perfection, coating your curvy core in a glistening veil of delights. Goddamn that looks hot, you swoon, playfully arching your back to better highlight your fecund figure, as your milk glimmers along your taut hide like polished mother of pearl in the light. A part of you almost wants to leave it there to advertise your splendor to all the local mutants, but you think better of it, as you're not sure if you could get milk stains out of your gear right now. Instead, you hurriedly brush the stuff aside, remarking all the while at the pleasant changes to your body and renewed glow of your skin as you pack up and resume your day.";
			now Stamina of Best Pony is 5;
			now XP of Best Pony is 0;
			StatChange "Charisma" by 1;
			StatChange "Intelligence" by -1;
			increase breast size of Player by 2;
			PlayerHealed 50;
	else if Cunt Count of Player >= 1 and Stamina of Best Pony is 5:
		if Equinoid Warrior is listed in companionList of player:
			say "     Rounding some unremarkable bend on the last leg of a long jog with Liliana in tow, you spy a largely untouched shell of some green metal park bench tucked to the sides of your current path. You decide to stop and take a rest, for your pet's sake, though she's rather apt at keeping up with you, the poor mare doesn't have your staying power. Besides, you've both more than earned a little [']water break['] at this point, you snicker under your breath, idly groping the snuggly swell of your udder. Silky and plump, its presence is a constant source of pleasure for you, and a wondrous reminder of your status as a good milky mommy mare. You preen, gently fondling your ripe crotch pillows as thin bands of toasty milk dribbles down your arm while Liliana trots up behind you. 'W-why are we stopping, I-I can *wheeze* keep *pant* going,' she gasps, horse lather pouring down her toned ebon yum gutter, glazing her fur in a lustrous layer of perspiration as she comes to a plodding stop.";
			say "     Tutting, you turn to face her, your hands still fondly caressing your wondrously milk tanks, saying. Of course you can dear, but the girls, you pause, indulgently drawing your milk slicked hands up along your glowing boisterous bump for effect, and you could use a break. Plus, you add, tracing a nail up along your supple bronzed skin as you coyly bring your digits to your lips, your udder could use a good milking. 'Well...' Liliana hums, watching you playfully lap at the scintillating droplets dancing along your fingertip, while your free hand lovingly pumps your prominent teat in offering to your studly pet. 'I guess we could take a short break, and it would be rude to turn down such a fine gift,' she beams, nodding towards the beach with a quick flicker of her ears. Smiling in turn, you prance over to the bench with a sultry waggle of your wide birthing hips, eagerly shaking your tail behind you as you sit yourself down with a fake tired sigh. Come then, you coo, spreading your legs for your caring pet with a comehither wave.";
			WaitLineBreak;
			say "     Whinnying, her nostrils flare as billowing plumes of alabaster steam coiling about her adorable equine visage as she sashays over to you and kneel at your hooves with a lewd smirk. 'Spirits you look so beautiful like this,' she pants, eyes roving the heady swell of your [breast size desc of Player] tits lazing atop your cuddly baby bump, then down your supple breedable flanks. Chuckling, you casually run your hands through your brunette hair, fluffing your flowing locks into a light bracing breeze wafting through the area, saying. Why thank you dear, it takes a lot of hard work, and harder cocks to keep yourself looking this radiant. 'Mhh, and it shows,' your precious pet simpers, hazel eyes fogging over with lustful mist as she reaches out to touch your fertile splendor, yet stops herself but a hair's breadth from your tanned middle. 'Uh may I, uh, you know...' she stammers, tail fluttering behind her like a kite caught in a storm.";
			say "     Nodding, you press your tender stomach to her palms, delighting at both the young mare's manners, and the adoring expression on her face as she runs her hand down the satin curves of your resplendent form. 'So soft,' Liliana hums, reverently stroking your sides as her hand thoughtlessly drift down your groin, a part of you wonders if you should encourage her to play with your needy body while she suckles, or if you should just relax and let her drink at her own pace?";
			LineBreak;
			say "     [italic type]What would you like to do?[roman type]";
			LineBreak;
			say "     [italic type]Author's note: Choosing 'Encourage her' will cause your TF to evolve into its (pen)ultimate milky milfy form and unlock some minor customizations for it in the Sundered Codex.[roman type]";
			LineBreak;
			let Horny_Horses_Choices be a list of text;
			add "Encourage her?" to Horny_Horses_Choices;
			add "Let her drink at own pace?" to Horny_Horses_Choices;
			let Horny_Horses_Choice be what the player chooses from Horny_Horses_Choices;
			if Horny_Horses_Choice is:
			-- "Encourage her?":
				say "[IDKBRO]";
			-- "Let her drink at own pace?":
				say "[Am_lazy]";
		else:
			say "     As you're winding your way down along a quiet path at the end of another of your long jog meant to test the growing limits of your endurance. Fast as you've become despite your current condition, sudden bursts of speed will do you little good if you collapse scant minutes later. Lacking a coach, or a cute trainer to help judge your performance, you can only guess if you've made any meaningful gains in the last few days. Yet, you take some comfort in the budding strength of your limbs, despite the lovely weight of your silky sweat-slicked belly, or mild encumbrance of your adorable snuggly udder. You still have quite a bit of gas left in the tank, and briefly consider pushing on for a while longer to see how much your endurance has improved, then think better of it. Fun as it might be to run yourself to a lather, proper rest, and, you giggle, hands drifting to the milky curves of your [breast size desc of Player] tits, [']hydration['] are an important part of any exercise regime. So why not stop for a bit and have a nice sip of cream? Your precious foals need all the piquant milk they can get to grow up into big sexy mares like their wonderful mommy. You preen, glancing down at the glittering shape of your adorable body wobbling as fresh beads of sweat drip from your bump like peerless diamonds.";
			LineBreak;
			say "     [italic type]Author's note: choosing to stop for a drink will cause your Ipotane infection to evolve to its (pen)ultimate state and unlock some special customization options in the Sundered Codex.[roman type]";
			LineBreak;
			let milk_break_Choices be a list of text;
			add "Stop for a drink?" to milk_break_Choices;
			add "Keep Going?" to milk_break_Choices;
			let milk_break_Choice be what the player chooses from milk_break_Choices;
			if milk_break_Choice is:
			-- "Stop for a drink?":
					say "     Reasoning you, and your precious foals have more than earned a widdle break, you swiftly scour the area for a nice soft patch of ground to rest your weary haunches for some lovely mommy time with your treasured fillies. It won't be long till they're all grown up, prancing about the city looking for mates, or racing about the ruins just like their bawdy mother. So why not enjoy your time with them while you can? You beam, absentmindedly massaging the soft, tanned curves of your cuddly bump with a mix of excitement and melancholy whenever your fingers brush the subtle outlines of their sleepy forms. Soon enough, you find a flat patch of earth tucked away beneath one of the new growth trees spreading through the city in the wake of the outbreak. No taller than a sheltered bus stop, the young sycamore seems to have sprouted up recently with the help of the nanites, at least, you assume as much if the disturbed earth is any indication. Still, despite its accelerated maturation, it looks rather healthy and inviting to you. You muse, listening to the leaves rustling in the breeze, while pinpricks of light stream through the gaps in its canopy. Smirking at the sight, you amble over, then lower yourself to the ground beside it with a content nicker as you rest your back against its patchwork bark.";
					say "     Oh you needed this, you hum, lovingly draping your fruitful glowing midriff across your satin thighs while you lean back against the tree's sturdy truck. Your lips pursing into a rightly pleased smile at the sight of your tight, [breast size desc of Player] chest pillows decadently lazing along your fecund splendor, as the thin beams of light dances across your glistening, sweaty skin. Gods you girls are getting huge, you swoon, drawing your palms along your toned body in raw unvarnished delight at your changes. Mhh and just look at what they're doing to your tits, a few more litters and you could feed a whole herd of [one of]Stallionbois[or]Black Equinoids[or]Mare Sluts[or]Horsemazons[or]Zebras[at random] by yourself. You chuckle, nuzzling your chin along their exalted forms, drinking in the soft subtle slosh of your bounty serenades your ears. And this view, fuck you don't think you'll ever get tired of seeing your cute baby bump, and sweater puppies arrayed about before you like this. You beam, proudly gazing at your matriarchal figure in full, lustrous repose.";
					WaitLineBreak;
					say "     Sure, there are times you miss being able to see your hooves, and big cuddly udder[if player is herm], or nice plump sheath[end if] when you look down. Some cheeky side of you notes, idly rubbing your fuzzy legs about its pillowy swell in rapturous satisfaction at the exotic kiss of your short silky fur gliding along your cuddly crotch boobs. Yet, such minor inconveniences are more than worth it for the simple joy of feeling your body blossoming with life, or experiencing that singular, priceless moment you finally get to hold your foals in your arms. And the sex isn't half bad either, you ruminate, recalling some of your more recent conquests, and the wild elysium you felt as all those wonderful hormones coursed through your body while you were getting railed by some studly beast. Parts of you almost wish you could spend the rest of your days like this in some comfy stable with a team of randy stallions, or naughty herms to keep you full. You whicker, dreamily picturing yourself leaning over some sturdy pummel horse, legs spread wide, glossy cunt[if player is herm], delectable cock[end if], and equine udder on full display for any lustful sire bold enough to claim your tender womb for their own.";
					say "     Quivering at the thought, you can almost smell the musky scents of equine lust pooling about you as your hands drift to your well-loved stomach, excitedly massaging your regal flanks. Till you snap out of your lustful fantasy with a light shake of your head. Tempting as the notion may be, you still have so much you want to do, places you wish to see, and races to win before you can truly kick up your hooves. However, you smirk, slipping your hands beneath the slick folds of your immaculate [breast size desc of player] breasts, that doesn't mean you can't enjoy a little taste of the good life. You hum, running your tongue along your lips, as your fingers sink into the generous contours of your milk tanks, casting scrumptious furrows in your tanned hide while you glide your digit along your perky nips, eliciting a spurt of cream from the turgid mounds. Misting the air, and your adorable blushing bump in a light trickle of scintillating alabaster milk.";
					WaitLineBreak;
					say "     Fuck that's hot, you pant, watching the lacy beads of pearly perfection tracing their way down your now blushing body as you heft your eager cream spout to your lips, lavishing your neglected ducts with a long drawn out lick. Bet you babes are going to love this stuff, you hum, relishing the rich heavy silky tang of your tainted milk spreading across your palate with your first lovely suckle. It almost pains you to swallow and relinquish the sweet ambrosial nectar, yet the plaintive gurgle of your fecund core stills such thoughts. As you gulp down the delectable ambrosia with a well-pleased wicker as a familiar warmth seeps through the empty pit in your belly. So good, but mommy needs more, you rumble, greedily coaxing vibrant streams of cheek filling cream from your plump melons with every worshipful gulp. Even your brood isn't immune to the rich, invigorating effects of the wondrous flavor of your milk as they seem to stir amidst a heady rush of altered hormones surging through your body. Blanketing your senses in an effervescent shroud of maternal bliss as butterflies dance within your well-seeded belly. Leaving you feeling at once ravenous hungry, but also strangely content as your skin creaks ever-so-slightly with the balmy weight of your tainted cream.";
					say "     Too lost in your own world to care, you can only distantly feel the nanites saturating your core whir to life as you rest yourself fully against the tree bark, nips reverently tucked between your lips while thin bands of cream down the sides of your mouth. Following their glittering trails with your eyes in chuffed amusement, you watch as they creep along the contours of your glowing middle, observing your glowing core delectable ripen with each lurid swallow, then spill along the ample hem of your tender udder in an enthralling patter. Whickering, it's hard not to take pride in your blossoming curves and new found strength in your limbs since you started [']training[']. The results certainly speak for themselves, you hum, watching the groaning hem of your flush womb edges outward in a fertile dome of excess as your foals excitedly drink in your offering. Mhh such feisty widdle monsters, bet you dears are going to grow up in time, you coo betwixt hearty suckles, observing the supple impressions of their adorable hooves fluttering along your taut tum.";
					WaitLineBreak;
					say "      As a rapturous squall of transformative tightness spreads through you, you can't help but notice a vibrant line of goosebump seeping outwards from your pregnancy flush navel in a visible spiral. Curious, but unbothered, you watch with a sudden sense of anticipation flooding your mind as porcelain white fur creeps out along the sweltering resplendent bump. Immaculate and radiant, your blossoming pelt sparkles in the light like luminance moonstone while it curls up along the maternal swell of your peerless waist. An enthralling rush of morphic delight surge down along the bestial contours of your horsey legs. Gods its so soft, you preen, at the velvety kiss of your fur gliding along the sensual swell of your well-loved womb stops at verdant hills of your milky mounds, though the visible tide of goosebumps ripples upward toward your throat and shoulders as the fur reemerges about your collar like a living choker.";
					say "     Your arms thrum with regal motes of changes as fur trickles down your elbows, slowly coating your upper arms in a pelt of pearly white hair, a kin to satin bridal gloves. Swooning at the spectacle, you leisurely stroke your finger along the imperial [breast size desc of Player] beasts in untamed delight at the silky caress of your fur playing along your resplendent rack. Fuck this feels amazing, you moan, fingers sinking ever-so-slightly into your rich tanned rack, casting adorable coffee swirls into your milk stuff mounds, while the whirlpool of change sparks across your legs. Though tepid at first, you can sense your muscles throbbing, delectably with the lurid pounding of your pulse, while your legs seem to stretch outward by the moment as your body roils with the tainted essence of change surging through you. Tilting your head for better view, your eyes widen at the sight of prominent cloud white tassels surging into being along your ankles, profoundly regal, the fanciful accents seem to shimmer in the slight breeze like woven stands of mother of pearl.";
					WaitLineBreak;
					say "     Your ass ripens with dense, potent sinew, and sensual padding as your beastly hips seem billow to outward into a large well-cushioned heart. Almost gushing at the spreading softness wracking your body, you appreciatively glide your tail along its beastly curves, delighting at the sudden strength flooring your limbs with each immaculate suckle. Your blushing belly stretches all more to accommodate your lovely meal and cute growing foals. Even now, you can sense your womb swelling with fresh ";
					if "Touched by Madness" is listed in feats of Player:
						say "centimeters ";
					else:
						say "inches ";
					say "of motherly flesh to nourish and nurture your adorable fillies as your cute creamy middle sinks into the welcoming embrace of your pillowy udder. Still even you have your limits, as a coiling tension cinches about your core like a vice with each fruitful swallow, till the blissful sweetness of your cream and immaculate echoes of change are drowned out by the tightness roughly gripping your stomach. Huffing defeatedly with a soft plaintive nay, you lose your worshipful grip on your tender nips, letting your flush milk tanks patter along your turgid belly with a wet, meaty *plop*.";
					say "     Still flushed with your boundless bounty, twin trails of toasty cream cascades down your enhanced body in shimmering opalescent sheen, blanketing your maternal form in a decadent veil of excess. Oddly, your twisting psyche takes a strange mote of pride at the spectacle, as you lean your head against the tree with a happy sigh at the sight of your lustrous transformation. Your new found muscle burns with untold vigor, eager to be unleashed on the track, or shared with some treasure toy. You muse, flexing your legs as you rake the earth with hooves in base anticipation. Then turn your attention to your hands, stretching them out before yourself, reveling at the sight of your latest accents. While by no means exotic, the spectacle of the light catching upon your short glossy pelt nevertheless brings a smile to your lips at the thought of treating your chosen mate's to their touch. You ruminate, imagining the reverent expressions emblazoned on your lover's faces as your silky fingers prances along the yummy taper of their cocks, or drooling lips of some dreamy fling's succulent cunt.";
					WaitLineBreak;
					say "     Of course, such things pale in comparison to the heat spreading through your fertile core, as you run your fingers through your belly fur, exalting at the welcome ripeness of your tainted womb. Your dense, cuddly foal factory brims with maternal purpose, you preen basking in the added heft of your middle pressing ever-so-slighty on lap like a precious treasure. Slipping your hands beneath its sweltering sweat slicked hem, you almost feel a mote of jealousy towards your fillies to have such a lovely little home to snooze in until their big debut. You opine, easing yourself to your hoofs with a tired swagger as you senses adjust to your modest increase in height. Far from giantdom, you could easily give some of the smaller taurs a run of their money, you laugh, playfully examining your broad, stocky legs with a clinical eye. Though as you twist about, you notice your legs are the only thing that seems to have gotten a bit bigger, as the comforting weight of your bust and exotic udder weigh down on you all the heavier.";
					say "     Tucking your hand beneath their ponderous proportions, you note, with a touch of material pride your milk tanks appear to have but one a few more lovely ";
					if "Touched by Madness" is listed in feats of Player:
						say "centimeters of plush padding. ";
					else:
						say "inches of plush padding. "; 
					say "Another time you might have bemoaned the added mass, or fretted about the extra handicap they impart, yet as you drink in your fertile figure's generous curves and shapely muscles, you find it hard to not to like the new you. You muse, lewdly arching your back, to better bask in your duly earned splendor, only to spot a tiny patch of black fur decorating your navel. Curious, you peer down for a better look and spot...";
					LineBreak;
					say "     [italic type]Author's Note: You can change this mark at will via the Sundered Codex[roman type].";
					LineBreak;
					let tramp_stamp_Choices be a list of text;
					add "A cute heart." to tramp_stamp_Choices;
					add "Some fancy four-leaf clover." to tramp_stamp_Choices;
					add "Stereotypical horseshoe." to tramp_stamp_Choices;
					add "Slutty paw print." to tramp_stamp_Choices;
					let tramp_stamp_Choice be what the player chooses from tramp_stamp_Choices;
					if tramp_stamp_Choice is:
						-- "A cute heart.":
							say "     Daw, how adorable, you coo, lightly brushing your furry fingers along the sensitive swell of your blossoming belly button. Shuddering at the enthralling kiss of your nail and satin caress of your pelt, you sultry mind gushes at the thought of parading your cutie mark around town, perhaps you could coax some studly stallion or horny herm into kissing the patch umbra fur during next roll in the hay. Who knows, you might even get it pierced one of these days, you muse, wistfully imagine the your scrumptious middle bejeweled with gems almost as precious as you, or maybe even some slutty little tag to better show off your budding status as a prized mare. Of course, you hum, giving your still leaking tits a loving pat, that will have to wait. For now there are so many places and things you want to see, before you could ever consider kicking up your hooves in some luxurious stable, you opine with well-pleased smile as you trot off, with renewed spring in your step to attend to your business.";
							LineBreak;
							say "     [italic type]Author's Note: Ipotane content ends here for now, and a special thanks to aishanyan for their help filling out the milk item tables.[roman type]";
							LineBreak;
							increase Stamina of Best Pony by 1;
							now XP of Best Pony is 0;
							StatChange "Charisma" by 1;
							StatChange "Strength" by 1;
							StatChange "Intelligence" by -1;
							increase breast size of Player by 2;
							PlayerHealed 50;
							now Perception of Best Pony is 1;
							now HP of Best Pony is 2;
							increase Cock Length of Player by 2;
							increase Ball Size of Player by 1;
							now ScaleValue of Player is 4;
						-- "Some fancy four-leaf clover.":
							say "     Guess you must be one lucky mommy, you coo, lightly brushing your furry fingers along the sensitive swell of your blossoming belly button. Shuddering at the enthralling kiss of your nail and satin caress of your pelt, you sultry mind gushes at the thought of parading your cutie mark around town, perhaps you could coax some studly stallion or horny herm into kissing the patch umbra fur during next roll in the hay. Who knows, you might even get it pierced one of these days, you muse, wistfully imagine the your scrumptious middle bejeweled with gems almost as precious as you, or maybe even some slutty little tag to better show off your budding status as a prized mare. Of course, you hum, giving your still leaking tits a loving pat, that will have to wait. For now there are so many places and things you want to see, before you could ever consider kicking up your hooves in some luxurious stable, you giggle with well-pleased smile as you trot off, with renewed spring in your step to attend to your business.";
							LineBreak;
							say "     [italic type]Author's Note: Ipotane content ends here for now, and a special thanks to aishanyan for their help filling out the milk item tables.[roman type]";
							LineBreak;
							increase Stamina of Best Pony by 1;
							now XP of Best Pony is 0;
							StatChange "Charisma" by 1;
							StatChange "Strength" by 1;
							StatChange "Intelligence" by -1;
							increase breast size of Player by 2;
							PlayerHealed 50;
							now Perception of Best Pony is 2;
							now HP of Best Pony is 2;
							increase Cock Length of Player by 2;
							increase Ball Size of Player by 1;
							now ScaleValue of Player is 4;
						-- "Stereotypical horseshoe.":
							say "     Ha, the nanite must have a sense of humor, you titter, lightly brushing your furry fingers along the sensitive swell of your blossoming belly button. Shuddering at the enthralling kiss of your nail and satin caress of your pelt, you sultry mind gushes at the thought of parading your cutie mark around town, perhaps you could coax some studly stallion or horny herm into kissing the patch umbra fur during next roll in the hay. Who knows, you might even get it pierced one of these days, you muse, wistfully imagine the your scrumptious middle bejeweled with gems almost as precious as you, or maybe even some slutty little tag to better show off your budding status as a prized mare. Of course, you hum, giving your still leaking tits a loving pat, that will have to wait. For now there are so many places and things you want to see, before you could ever consider kicking up your hooves in some luxurious stable, you giggle with well-pleased smile as you trot off, with renewed spring in your step to attend to your business.";
							LineBreak;
							say "     [italic type]Author's Note: Ipotane content ends here for now, and a special thanks to aishanyan for their help filling out the milk item tables.[roman type]";
							LineBreak;
							increase Stamina of Best Pony by 1;
							now XP of Best Pony is 0;
							StatChange "Charisma" by 1;
							StatChange "Strength" by 1;
							StatChange "Intelligence" by -1;
							increase breast size of Player by 2;
							PlayerHealed 50;
							now Perception of Best Pony is 3;
							now HP of Best Pony is 2;
							increase Cock Length of Player by 2;
							increase Ball Size of Player by 1;
							now ScaleValue of Player is 4;
						-- "Slutty paw print.":
							say "     [if Fang is booked]Shit Fang is going to get a kick out of this[else]Gods that looks so hot[end if], you swoon, lightly brushing your furry fingers along the sensitive swell of your blossoming belly button. Shuddering at the enthralling kiss of your nail and satin caress of your pelt, you sultry mind gushes at the thought of parading your cutie mark around town, perhap syou could coaxsome studly stallion or horny herm into kiss the patch umbra fur during next roll in the hay. Who knows, you might even get it pierced one of these days, you muse, wistfully imagining your scrumptious middle bejeweled with gems almost as precious as you, or maybe even some slutty little to better show off your budding status as a prized mare. Of course, you hum, giving your still leaking tits a loving pat, that will have to wait. For now there are so many places and things you want to see, before you could ever consider kicking up your hooves in some luxurious stable, you giggle with well-pleased smile as you trot off, with renewed spring in your step to attend to your business.";
							LineBreak;
							say "     [italic type]Author's Note: Ipotane content ends here for now, and a special thanks to aishanyan for their help filling out the milk item tables.[roman type]";
							LineBreak;
							increase Stamina of Best Pony by 1;
							now XP of Best Pony is 0;
							StatChange "Charisma" by 1;
							StatChange "Strength" by 1;
							StatChange "Intelligence" by -1;
							increase breast size of Player by 2;
							PlayerHealed 50;
							now Perception of Best Pony is 4;
							now HP of Best Pony is 2;
							increase Cock Length of Player by 2;
							increase Ball Size of Player by 1;
							now ScaleValue of Player is 4;
			-- "Keep Going?":
					say "     Shaking your head, you decide against stopping here, tranquil as the area may seem, the city is still host to all sorts of ill-mannered ferals who'd love to get their naughty paws on you. Best to keep moving, besides, you can always stop for a rest at the safety of the bunker the next time you're in the area. You ruminate, plodding off towards your next adventure at carefree gait.";
					LineBreak;
					say "     [italic type]Author's Note: Ipotane content ends here for now, and a special thanks to aishanyan for their help filling out the milk item tables.[roman type]";
					now level of Best Pony is 1;

to say IDKBRO:
	if Player is herm:
		say "     In the mood for some extra attention, you arch your back, playfully cupping your hands beneath the splendid swell of your satin bump in lewd delight at the beguilling sense of purpose and contentment welling in your breast as your finger glides along your the taut base of your yummy sheath, tittering. Oh Lilian, would you be a dear and take care of this? You would yourself but it's getting so, you pause, feeling the blood rush to your delectable rod as the blunt tip of your [cock size desc of Player] cock thrums along the supple length of your beastly dick tube. [italic type]Hard[roman type] to reach, as you carefully heft your tender stomach out of the way of your delectable dick as the faintest hints of your cock slips free of its warm, luxurious housing. 'Of course,' she hums, leaning in to place a soft little kiss on the sensitive tip of your puffy tanned belly button. Shivering, at the ambient wisps of her breath caressing your regal sunkissed skin and profound gentleness of her lips as she tenderly kisses her down your cute treasure trail with enthralling slowness to tip of your sheath.";
		say "     'Spirits, I can feel the tension in you, how do you keep your hands off yourself in your condition?' she titters, lightly rubbing her silky snout along the your tummy's glowing equator. Shrugging, you lovingly draw your legs about her hips, pulling her close, while you tell her in a sultry tone how it can be difficult it can to ignore this beast. But, you add with a well-meaning chuckle, having another set of hands to relieve you of your [']burden['] helps. 'Indeed, it's only proper to help out a mother in her time of need,' she teases, leveling her muzzle with your tightening sheath, lovingly brushing the supple folds of your cock cave with her cushy pony lips in a lewd parody of a kiss. Mh, naughty girl, don't go spoiling your appetite now, you tease, giving her waist an encouraging squeeze. Purring, your doting mare cheekily lavishes your hardening rod with the single sloppy lick, before nuzzling her snout down the tightening curves of your dick tube and dense fuzzy balls. 'Oh to have foals of my own,' she swoons, letting the toasty buffet of her breath gliding along your needy sex, shamelessly huffing your hybrid scent.";
		WaitLineBreak;
		say "     Maybe one day, when she's ready, you chuff, tail twitching in delight at the sordid caress of her fur massaging your groaning balls as she draws her snout along the sweat slicked furrow of your wondrous crotch pillows. Mmhh that feels nice, you hum, as she affectionately cups her lips to your turgid teat swaddling your eager cream font the pillow embrace of her equine muzzle. Your liminal mind can't but swoon at how natural her touch is, as her board tongue coddles and strokes your flush nip, coaxing a generous balmy trickle of cream from your plush udder with the barest of suckles. Such a hungry foal, drink up now, and don't forget mommy's cock. You simper, at the surge of relief flooding your body with each tender patter of her lips upon your perky milk spout. 'Yes mommy,' Liliana coos, pressing her glossy nose against you like an eager filly as she nurses while snaking a hand about your virile sheath. You find yourself panting in primal elysium at the intoxicating cinch of her pads pampering the ripe, juicy swell of your cock wrapper. Good girl, just like that, you moan, leaning into her touch as she reverently dandles your meaty sheath about your blunt tool in like a living sex toy.";
		say "     The bestial flare of your rod straing against its stately housing with each loving piston of her wrist as she coaxes your tool to attention, leaving you whining for more. Fuck sheathes are amazing, you murrmurr, eye rolling skyward as your regal hermhood glides free of its beastly home, with a sensual spurt of salty lucid pre, coating your doting mare's hands in generous glazing of equine desire. Unbothered by the toasty pearls streaming down her wrists, your prized pet's strokes never once slacken even as your juices flow down her wrist and dense padding of your balls as the first invigorating ribbons of air traipses about your hardening animalist tool. Humming in kind, Liliana shuffles beneath your loving hold, working her free hand between the toned curves of her onyx legs as she coyly attends to her own luxurious rod. While the resonating low squelch of shared hermy pleasures saturates your senses as Liliana the turgid length of your sensual stalliondom with doting aplomb. Ah you really know how to treat a 'girl', you whinny good-naturedly, encouragingly stroking her flanks in tandem with her pistons.";
		WaitLineBreak;
		say "     Wickering, the bawdy mare's tails affectionately flutters about your legs while she attends your needy body, sending static echoes of delight through your hybrid body as her hands pamper your needy body in a scintillating sonnet. Now this is the life, isn't it sweeties?  You murrmurr to your foals, while you lean back, letting the weight of your brood wash over you as you drink in sight of your tanned stomach and [breast size desc of Player] tits wobbling before your eyes with your every. You can't resist rubbing your palms along the cute swell of blossoming outie, while your wondrously flush girl cock rocks along the glossy hem of your bountiful bump, smearing your over-stretched bronzed hide in a generous coating of hermy excess. Heavens that feels so good, you nicker, lewdly massaging these shimmering beads along your treasure trail, relishing the unusual emulsion of sweat and tainted fluids gleaming in the light as you pamper your generous body. All the while, Liliana's palms dandle about your throbbing cum vein and equine sheath in a bestial rythm of carnal desire.";
		say "      Your sweet mare encouragingly ministers to your proud blunt rod with an enticing passion you rarely experienced, as her fingers waltz about your supple flared rod, lavishing the hidden contours of your beastly cockhead between the sublime strokes of your doughy sheath. Her gossamer lips indulgently knead perky nip, coaxing a rich tide of balmy creamy from your adorable udder, as the satin curves of your once toned middle ripen with the decadent weight of your offering. Too horny care, your doting filly hardly even seems to notice the first little hints of her satin onyx pelt pressed against your inner thighs. Tittering, you endearing brush your legs along her sides, urging your big strong mate to indulge, after all she's got a lot of growing to do if she wants to be a big sexy mommy herm like you one day. 'Mh, foals...' Liliana whinnies, glacing up at your radiant middle and lewd impression of your well-loved cock sinking ever-so-slightly in the luxurious padding of your tender womb with a dreamily look in her eyes, as the worshipful echoes of her lustful tenor resonate through your ample crotch pillows as she nurses.";
		WaitLineBreak;
		say "     Quivering at her touch, you coyly run your hand along her cute horsey ears, telling your mate how cute she'll look one day with a belly of big beautiful foals, why just of all the jealous stares the tribe will give the two of you as you parade your bountiful bodies about her camp. And, you pause sensing a brief flutter of activity roiling across your refulgent middle as your fillies kick in shared delight, all the fun the two of you can have together as mommy herms. Getting to watch your tummies ripen with each other's foal, you huff, tracing a nail along your adorable navel. Feeling the warm weight of our cream sloshing in our nice milky tits, as you give ourselves goodnight boob jobs. Or starting every day with a tasty treat you tease, cock twitching at the thought of sheathing its [cock size desc of Player] heft in her adorble muzzle. Mhh, just think of all the delectable cream the two of you can share. You tempt, clasping one of your [breast size desc of Player] breasts in your hand and bring it to lips with a theatrical grope. As you incorrigibly knead your tender teats, drawing a decadent little trickle of your succulent cream from your lovey nips.";
		say "     'Ah that does sound nice,' Liliana purrs between worshipful suckles, watching the shimmering beads of titillating milk stream down your arm like lacey velvet. Of course, being a nice stacked mommy herm is such a wonderful experience, especially when you have someone to join in on the fun. You coo, bringing your plump [breast size desc of player] milk jugs to your lips, encouragingly lapping at your perky little creams spout. Delicious, you rumble, letting the tender drops blanket your tongue in a luscious blanket of maternal excess as you sup upon your potent cream while the soft flutters of your young ripple through you. Oh such hungry dears. You murmur, watching the happily little flurry of activity waltzing across your cute middle. You affectionately run your finger along the adorable outlines of their hooves gliding along you pre-slicked middle in a soothing circuit while your fecund figure tightens with each blessed swallow.";
		WaitLineBreak;
	else: [fem alt]
		say "     Considering your condition, you feel like you've more than earned a little extra attention from your lovely mare, you muse, eyeing up the lush taper of her divine sheath as you lean back, letting big heavy udder wobble enticingly in air as you beckon your pet forward. Oh Liliana would you be the sweetest, nicest little dear and take care of mommy's pussy for her. It's getting so... [italic type]hard[roman type] hard to reach these days with this big sexy bump in the way. You pant, gliding your arm along the silky swell of your [breast size desc of player] breasts, then down your glowing middle while Liliana looks in blissful awe. 'Of course,' she purrs between sips, as the vibrant echoes of her voice resonate through your supple crotch pillows while she tenderly slips her hand beneath the sweltering hem of your supple udder, making you shiver in simple minded delight at the welcome caress of her furry fingers drifting along your flush cunt.";
		say "     Humming under your breath, you gently spread your legs for your favored mare, as she coyly traces her fingers about the glossy folds of your equine flower, envincing a needy little whicker from your lips at the merest touch of her fur along your feral flower. 'So warm,' she murmurs happily between suckles, lovingly strokes your desperate onyx petals in a skillful circuit, slathering her pelt in a generous veil of balmy dew. Mhhh, naughty tease, you whimper, in equal parts need and frustration, as you drum your hoofs upon the ground like an impatient filly. Nickering, your bawdy mare simply nuzzles her horsey nose against your glossy middle as she languidly dips a pair of well-lubed fingers betwixt your buttery smooth nether lips in a drawn out lascivious motion. Delightful flush, and impossibly sensitive, your elastic walls hugs her digits in their satin embrace as your box seems to cinch about fingers like a glove.";
		WaitLineBreak;
		say "     'Spirits, you're tight,' Liliana gushes, milk steaming from the sides of her face and the plump camber of your crotch pillows in a tropical stream as she caresses your needy passage with worshipful, caring strokes. Whinnying at her words and gentle kiss of fingers lavishing your breeder's box, you can only purr your appreciation, your hungry mare pussy ravenously milks and hugs her inquisitive digits as your tender muff muscles seems to draw her in. Ever eager to please, your doting filly leans into your body's insatiable pull, letting her arm be drawn in ";
		if "Touched by Madness" is listed in feats of Player:
			say "centimeter by centimeter ";
		else:
			say "inch by inch ";
		say "at the apex of her pistons. Each sordid tug ripples through your glossy lips as your passage spasms in tune with the vivacious gropes of her well-practiced pampers, you can feel ever wondrous motion of her glossamer palms gliding about sopping walls, pampering your neediest depths in a masterful sonnet of succulent supple strokes.";
		say "     All the while, your gluttonous mate's tongue and soft lips flickers about your teat, tweaking and massaging your luxurious cream spout like a cute hungry foal, coaxing intoxicating spurts of scrumptious milk from your luxurious udder the like precious filly she is. My-my such a needy girl, your so glad she's enjoying mommy's milk. You purr, encouraging tracing your legs about her silky sides in open delight at her appetite and the heady sense of purpose flooding your mind as your form's instinct to provide for your pet wars with the radiant bliss coursing along your [cunt size desc of Player] box. 'Thank you mommy, your cream is so yummy, and your udder is so soft. Mmhh, it's like my own widdle pillow.' Lilian gushes, her voice and soft demeanor like placid foal as she draws her unoccupied hand beneath the glossy meniscus of your milk tanks in base admiration of its bountiful heft.";
		WaitLineBreak;
		say "     Mhh, you're so happy to hear that dear, nothing brings mommies joy like knowing their foals are content and full. You beam, basking in the intoxicating tattoo her thrusts simmering along your folds like lightning dancing across a still pond. You reach down, lovingly running your fingertips through her mane while Liliana's nails drift about your productive cream factory, leaving tender goosebumps in their wake as she brushes the satin lips of your clit. Tittering ecstatically at her touch, you murmur loving encouragement to your mate, you lean back, pressing your full weight against the cool bark, letting the supple weight of your assets wash over you. While your doting mare draws her gossamer thumb and forefinger along the stiffening borders of your joybuzzer, evoking a fresh crackle of primal need through your raw sex. As she masterfully jills your pregnancy flushed clit between them in a sordid mirror of her own felicitous pistons.";
		say "     Huffing, your heart pounds in your chest at the lustrous storm of sensation roiling through you while you watch your bump and bust wobble enticingly before you as foals stir from their blessed slumber in sudden flutter of activity. The cute little outline of their hooves ripple along your taut tanned tum while your breast tingle with the audible slosh of scintillating milk serenade your horsey ears. Guess you sweet little munchkins are hungry too, you giggle, observing twin beads of scrumptious milk, streaming from your well-used teats down your glowing bump. Don't worry, mommy will take care of you, you whisper, drawing a free hand to the ripening swell of your [breast size desc of player] chest as you carefully tuck your arm beneath their sweltering flanks, and gently heft them towards your lips, simpering. Gods you love this view, wallowing in the fecund luminances of your skin glimmering in the light and inviting scent of your delectable milk wafting about your nose as you lean in and tenderly wrap your lips about your diamond hard nips.";
		WaitLineBreak;
		say "     Full and heavy, your supple teats need the barest bit of urging, before erupting across your tongue, lavish your eager palate with a generous gush of heavy cream as your tongue dances about the oh-so-sensitive contours of your nip. Stars above, your milk gets better every time you try it, you murmur, delectating in the soothing warmth and fatty texture of your balmy cream basting your mouth as you savor that first heavenly spurt filling your cheeks. 'Blessed ancestors that's hot,' she moans, watching sensual rivulets of cream snaking their way down the flush hem of your lustrous womb like a liquid bands of lacey perfection, and patter along the ground beneath your in an intoxicating tattoo. More than inclined to agree, the hearty rush of tainted fluids gracing tastebuds is a wondrous pleasure that leaves you melting into Liliana's lewd caresses, as lucid beads of girly stream down her arm and plink upon the parched, hungry earth. Unbothered, your horny mare seems rather invigorated by the luminance rivulets of musky honey streaming along her wrist and scrumptious rush of cream rounding her toned sternum.";
		say "     Oh how cute, you chuckle, affectionately massaging your legs about her tightening middle as you encourage your bubbing glutton to indulge. After all, you have so much to give to it would be a shame not to share your body's bounty. You think to yourself, listening to the resonant lewd squelching of your elastic muff and shared suckles of your rich cream filling the area. As you draw your legs down the satin curves of Liliana's sheath with preternatural grace, elating in the tension run through her, and her cock, you note, gently caress your inner thighs about her budding stiffy. As you expertly run the soft fur of your legs about her tightening sheath, coaxing her juicy";
		if "Touched by Madness" is listed in feats of Player:
			say "third of a meter long ";
		else:
			say "foot long ";
		say "rod to attention. Shivering at your touch, you can hear your mate nicker with need as you stroke her beastly spire, though her form suffers from the roil bliss simmering through her, as Liliana's strokes grow wild and untamed, yet never once does your precious mare slacken in her regal attention to your ebony flower.";
		WaitLineBreak;
		say "     Still, the chaotic pistons of her arms along your spasming walls and sputtering tweaks of your pony clit, leaves your body hungry for more as your feral muscles tug upon her arm like it were a regal sire's meat. Whickering at the raw tension simmering through you, Liliana bucks her hips in delight, shamelessly drawing her cock along the satin contours of your legs. Desperate to relieve the burning lewd desire building in her core as her turgid cum vein plays across your thighs in a decadent mirror of the sensual thrum of your own fertile flower. All the while, your belly creaks and tits slosh with the soothing weight of your cream as your skin is pulled devilish tight by the epicurean effect of your fertile nanites course through your hormone addled body, twist and refining your liminal being all the closer to the perfect broodmare."; [merge here]
	say "      Far from discomforting, the enthralling groan of your hide and glossy kiss of your slippery skin upon fingers only strengthens your hunger as the urge to provide for your litter grips your mind. After all, your matronly body needs all the fuel it can get, some twisted facet of your psyche tempts as Liliana's sensual strokes and the enthralling caress of your ponderous tumby course through your thrumming form like waves rippling upon a placid pound. Your belly sloshes with the weight of your milk rounding out your middle into a priceless dome and sunkissed skin goes wondrously warm to the touch as a satin dusting of white hairs creep upward along your gleaming hem. Devilishly soft, your tainted mind registers neither fear, nor revulsion at the spectacle of the lustrous fur blanketing your lovely bump as you glide your fingers against its grain, swooning at the pure tactile pleasure washing over you. Even Liliana seems oddly taken as her eyes wide with a libidinous glint as she watches your pelt cascading upwards to the pleasant curves of your [breast size desc of player] sweater puppies, only to stop but a hairs breadth from your regal milk tanks.";
	say "     Though the tumultuous eclectic heat still rippling through you remains as cute little goosebumps simmer across your bust and out towards your collar as a satin ring of downy bristles about your throat. Peerlessly velvety, you find yourself humming in simple minded bliss, as you nuzzle the living necklace coiling with your cheeks while the wave of euphoric change crashes down your arms. Cresting your elbows, the fur reemerges like smooth gossamer bridal gloves simmering across your fingers. Stunningly radiant, the slightest brush of your luxurious pelt sends a heady shiver down your spine as your dainty fingers fondle your well-bronzed tits with renewed delight. Fuck this feels amazing, you gush, milk dribbling down your chin and saturnalian swell of your burst while you jovial cinch your legs about Liliana's ";
	if Player is herm:
		say "waist all the tighter. ";
	else:
		say "cock all the tighter. ";
	say "Eliciting a surprised peep from your favored mare at the unbidden rush of power flowing to your hooves, as your muscles bulge with fresh vigor while they grow proud and stocky like some stately Clydesdale. All the better carry you, and your precious foals, you ruminate, tilting your head to one side, observing your ass swell with fresh ";
	if "Touched by Madness" is listed in feats of Player:
		say "centimeters of shapely padding.";
	else:
		say "inches of shapely padding.";
	WaitLineBreak;
	say "     Prominent tassels of the purest snowy white blossom along your shins and heels as your hoofs widen by the second, building in raw mass and untamed might. While the rollicking touch of Liliana's onyx fingers upon your ";
	if Player is herm:
		say "girthy tool grows in fervor as your bestial rod and dense balls seems to drink in the ambient essence of change surging through your futa form. Your sheath tightens and proud cock delectably strains in your lover's grasp with each thunderous pounding of your pulse as your blunt dick presses against the satin sinuosity of your heavy bump. Stammering in elated awe, your senses reel with a torrent of sensation flooding your mind in a fruitful squall of tainted elysium as your bulging rod slowly weakens Liliana's hold on your cock. Awash in the vibrant whirlpool of bliss cascading over your changing body, your lust fogged psyche revels in her struggle and intoxicating images of her and her tribeswomen worshiping your cock together as the animalistic flare of your tool peeks over the downy hem of well-cushioned belly.";
	else:
		say "rubbery muff as your well-bred passage drinks in the euphoric waves of mutation coursing through your maternal splendor. Your riotous wombs thicken before your eyes as the plump lining of your foal factory bulges with fresh fertile flesh to nurture your proud fillies. You ruminate observing your ripening belly spills over your legs and onto Liliana's head, making you whinny with wild delight at the satin kiss of her fur playing along your heavy belly as the playful mare nuzzle her face against you.";
	say "     Gods this is the best fucking apocalypse ever, you swoon, eyes widening at the lewd kiss of your fur lavishing your [if player is herm]cock[else]udder[end if] as fruitful growth spurt coiling through you reaches its crescendo. Leaving you feeling tender, yet powerful as you flex your legs about your mate's [if player is herm]waist[else]dick[end if], earning you a gleeful nicker from the suckling mare as her equine roils about your elated teat. The sweet echoes of her voice ripple about your maternal form as you sup upon your heavy mounds with ravenous aplomb, desperately trying to coax more of your ambrosial cream to fuel your changes. Yet your luxurious body has its limits as the heady tightness building in your well-bred body begins to overwhelm you till you huff defeatedly, loosing your hold your milk stuffed melons, misting yourself and your wonderful pet in a pearly sheen of creamy perfection. Panting, at the sight of your milk streaming down your hide and endearing stroke of your precious mare drives your oversexed body over the edges as you finish with a roaring whinny.";
	WaitLineBreak;
	say "     Your [if player is herm]cock bulges, and balls churn as you almost seed the firmament with a vast cloud of mommy cum, briefly darkening the heavens with your excess, before it rains back down upon you[else]cunt quivers and tail flickers behind you as your malleable fold grip her arm in their satin embrace as you cum. Squirting a molten deluge of liminal dew down the length of her arms and along the silky hem of your udder as Liliana withdraws their hand with spine tingling flourish[end if]. All to Liliana's delight as she proudly huffs in shared release, glazing the bench's feet her in musky sheen of hermy seed as she finishes, and collapses against your udder with tired sigh panting. 'Spirtes that was... you were... amazing,' as she nuzzles her head against your crotch pillows. Purring in agreement as the heady patter of your seed dripping off the bench titillates your ears while you withdraw your legs from her hips and supportively plant them beside while the two of you ride out the last fruitful tingles of your transformative climax together in your shared spent silence.";
	say "     [italic type]Some time later[roman type] when the last drops of musky mare seed have all dried up and the strength has returned to both your limbs, Liliana awkwardly hobbles to her hooves like a newborn foal, grunting. 'Spirits so full, but that was so worth it,' as she rests her hands on the welcoming dome of her cream flushed middle. Packed to near bursting, her belly would look more at home on some slutty margay than a proud out equinoid warrior, as the turgid hem of her groaning middle jostles along her enticing sheath with every breath. Still, your lover wears it well, you rumble, observing the cute little impression of her breast lazing upon her tender tum. 'Flatterer,' she blushes, cheeks burning a deep dark red as she absently mindedly strokes her core in a slow soothing circuit. 'I just hope this doesn't stick,' she adds in a sing-song trill, giving her flanks a quick pinch. Smirking, you tell her not to fret, the two of you can run that off in no time. Although, deep down a part of you admits you wouldn't mind it if your mare got a little rounder.";
	WaitLineBreak;
	say "     '*Hrump*, I shall hold you to that, though,' she pauses, eyes appreciatively wandering your shapely flanks and stocky legs, 'something tells me the same can not be said for you.' she chuffs, gesturing to your own voluptuous form with a theatrical wave of her hand. Maybe, you tease, running your hand down your legs in open admiration of the succulent changes and adorable tassels adorning your shins. But, you rumble pulling yourself up off the bench, only to find yourself staring down at your precious mare, you think you could get used to this, as you give her head an appreciative pat. 'Blessed ancestors, how did you...' Liliana stammers, jaw dropping in surprise as she peers up your maternal curves. Shrugging, you tell her you're not sure, though you've heard stories the nanites react to their host's needs and desires. Or maybe, you snicker, tracing your fingers along her muzzle as you tap her mouth closed, your infection just needed a little push from her to reach its full potential, not that you're complaining. This body suits you, and your foals much better, isn't that right dears, you murmur massaging your fuzzy palms along your plush womb in raw delight as your fingers into the thick dome of amniotic fluid.";
	say "     Quicking in response to your touch, your slutty foals seem every bit as pleased with your changes as you, not that you could blame them. You muse, delighting in the added heft of your precious middle, dense and snug, you babymaker seems to have developed surface area, all the better to nurture and protect your young. Meanwhile, your assets too have expanded to meet your demands, devilishly plush and productive, your lurid body could easily fees Liliana's tribe twice over with more than enough to spare for your own foals. Although as you do a playful twirl to admire the lewd ripple of your ass[if player is herm] and sensual bounce of your dense balls[end if], you notice a strange patch of off colored fur on your belly button. Curious you tilt your head one side and see a...";
	Linebreak;
	say "     [bold type]Author's Note: you can change your marking at any time via the Sundered Codex.[roman type]";
	LineBreak;
	let cutie_mark_Choices be a list of text;
	add "Adorable heart." to cutie_mark_Choices;
	add "Lucky four-leaf clover." to cutie_mark_Choices;
	add "Classical horseshoe." to cutie_mark_Choices;
	add "Primal paw print." to cutie_mark_Choices;
	let cutie_mark_Choice be what the player chooses from cutie_mark_Choices;
	if cutie_mark_Choice is:
		-- "Adorable heart.":
			say "    Daw how adorable, just look at this Liliana, it's so cute! You gush at the sight of the tiny heart emblazoned on your navel. Nodding, your doting mare leans, and gives the little heart a tender peck, purring. 'Indeed, it suits you [Name of Player],' as you shiver at the soft wisps of her breath coiling about your sensitive skin. Thanks, you're the best, you hum, though you should probably thank Harold too, if he hadn't served you that wonderful drink, you never would have come this far. Perhaps the next time you're in the Palomino, you might even let him have a go at you to you too, beside it might be fun to carry a few litters of unicorns, you opine, while you motion of Liliana to fall in, there is still a whole crazy world out there for you to explore together.";
			LineBreak;
			say "     [italic type]Author's Note: Ipotane content ends here for now, and a special thanks to aishanyan for their help filling out the milk item tables.[roman type]";
			LineBreak;
			increase Stamina of Best Pony by 1;
			now XP of Best Pony is 0;
			StatChange "Charisma" by 1;
			StatChange "Strength" by 1;
			StatChange "Intelligence" by -1;
			increase breast size of Player by 2;
			PlayerHealed 50;
			now Perception of Best Pony is 1;
			now HP of Best Pony is 2;
			increase Cock Length of Player by 2;
			increase Ball Size of Player by 1;
			now ScaleValue of Player is 4;
		-- "Lucky four-leaf clover.":
			say "     Wow just look at this Liliana, you must be pretty lucky! You gush at the sight of the tiny four-leaf clover emblazoned on your navel. Nodding, your doting mare leans, and gives the little accent a tender peck, purring. 'Indeed, it suits you my fortunate friend,' as you shiver at the soft wisps of her breath coiling about your sensitive skin. Thanks, you're the best, you hum, though you should probably thank Harold too, if he hadn't served you that wonderful drink, you never would have come this far. Perhaps the next time you're in the Palomino, you might even let him have a go at you to you too, beside it might be fun to carry a few litters of unicorns, you opine, while you motion of Liliana to fall in, there is still a whole crazy world out there for you to explore together.";
			LineBreak;
			say "     [italic type]Author's Note: Ipotane content ends here for now, and a special thanks to aishanyan for their help filling out the milk item tables.[roman type]";
			LineBreak;
			now ScaleValue of Player is 4;
			increase Stamina of Best Pony by 1;
			now XP of Best Pony is 0;
			StatChange "Charisma" by 1;
			StatChange "Strength" by 1;
			StatChange "Intelligence" by -1;
			increase breast size of Player by 2;
			PlayerHealed 50;
			now Perception of Best Pony is 2;
			now HP of Best Pony is 2;
			increase Cock Length of Player by 2;
			increase Ball Size of Player by 1;
			now ScaleValue of Player is 4;
		-- "Classical horseshoe.":
			say "     Tee-hee heavens look at this Liliana! You laugh at the sight of the tiny horseshoe emblazoned on your navel. Nodding, your doting mare leans, and gives the little horseshoe pattern a tender peck, purring. 'Ah the spitries seem to have a sense of humor my friend,' as you shiver at the soft wisps of her breath coiling about your sensitive skin. Thanks, you're the best, you hum, though you should probably thank Harold too, if he hadn't served you that wonderful drink, you never would have come this far. Perhaps the next time you're in the Palomino, you might even let him have a go at you to you too, beside it might be fun to carry a few litters of unicorns, you opine, while you motion of Liliana to fall in, there is still a whole crazy world out there for you to explore together.";
			LineBreak;
			say "     [italic type]Author's Note: Ipotane content ends here for now, and a special thanks to aishanyan for their help filling out the milk item tables.[roman type]";
			LineBreak;
			increase Stamina of Best Pony by 1;
			now XP of Best Pony is 0;
			StatChange "Charisma" by 1;
			StatChange "Strength" by 1;
			StatChange "Intelligence" by -1;
			increase breast size of Player by 3;
			now Perception of Best Pony is 3;
			now HP of Best Pony is 2;
			increase Cock Length of Player by 2;
			increase Ball Size of Player by 1;
			now ScaleValue of Player is 4;
		-- "Primal paw print.":
			say "     Stars above look at this Liliana[if Fang is booked], Fang is going to love this[end if]! You gush at the sight of the tiny paw print emblazoned on your navel. Nodding, your doting mare leans, and gives the fancy accent a tender peck, purring. 'Chieftain's teats such auspicious markings,' as you shiver at the soft wisps of her breath coiling about your sensitive skin. Thanks, you're the best, you hum, though you should probably thank Harold too, if he hadn't served you that wonderful drink, you never would have come this far. Perhaps the next time your in the Palomino, you might even let him have a go at you to you too, beside it might be fun to carry a few litters of unicorns, you opine, while you motion of Liliana to fall in, there is still a whole crazy world out there for you to explore together.";
			LineBreak;
			say "     [italic type]Author's Note: Ipotane content ends here for now, and a special thanks to aishanyan for their help filling out the milk item tables.[roman type]";
			LineBreak;
			increase Stamina of Best Pony by 1;
			now XP of Best Pony is 0;
			StatChange "Charisma" by 1;
			StatChange "Strength" by 1;
			StatChange "Intelligence" by -1;
			increase breast size of Player by 3;
			now Perception of Best Pony is 4;
			now HP of Best Pony is 2;
			increase Cock Length of Player by 2;
			increase Ball Size of Player by 1;
			now ScaleValue of Player is 4;


to say Am_lazy:
	say "     Thinking better of it, you decide against pressing your treasured partner for any extra [']favors['] right now, so why not sit back and let Liliana drink in peace. You ruminate, leaning back on to the cool painted metal with a relaxed sigh as a low fragrant breeze wafts about you, filling the air with the soothing scents of distant marigolds, herbal salvias, and earthy oak. Breathing the welcome redolence with a content nicker, you spread your toned legs for your precious mate while the cool brazing air roiling about your welcoming crotch pillows leaves you shuddering in delight. Smiling, Liliana nuzzles her silky cheeks against your thigh murmuring, 'Spirits [Name of Player], you look so radiant like this,' as she eyes up your burgeoning bump, hanging mere ";
	if "Touched by Madness" is listed in feats of Player:
		say "centimeters from her muzzle. ";
	else:
		say "inches from her muzzle. ";
	say "Daw, why thank you dear, it's so nice to hear people appreciate your figure, especially when you work so hard to keep yourself in shape. You tease, coyly drawing your nails along the tender hem of your sumptuous middle, leaving thin rosy streaks in their wake.";
	say "     'Mh, and it shows,' Liliana simpers, reverently cupping her fuzzy palms to the soft heavy hem of your luxurious udders, lightly jostles your tanned milk tanks in open admiration of their heft and bountiful succor. Flatterer, you guffaw, cheeks blushing a muted red at the tenderness of her fur caress your equine udder as your doting mare leans in, brushing her supple lips along your sordid teats like a teasing foal. Chucking under her breath, Liliana merely shrugs, drinking in the cute wobble of your ponderous assets as she wraps her satin lips to your nips with a playful huff, letting the warming wisps of breath cascade over your oh-so-sensitive flesh. Flush and full, your tender udder needs only the gentlest lap of her broad tongue before gushing a balmy stream of delectable along the worshipful mare's respective palate.";
	WaitLineBreak;
	say "     'Delicious,' she purrs, demurely gliding her tongue along the perky creams spout between sips. And it's all for you, you sweet filly. You preen, beaming at her praise and the heady sense of relief flooding your mind, as you encouragingly snake your non-dominant hand behind the back of her head, running your fingers along her onyx mane and cute silky ear in a loving circuit. Earning you a pleasant little nicker of delight from the happy horse girl, her hand roves your plump your cream tanks, kneading and caressing your devilishly productive glands, coaxing balmy streams of scrumptious milk from your motherly. Heavens you needed this, you moan, resting your head along the back of the bench, letting your long flowing hair billow behind you like a cloak of lustrous bronze in the breeze while a feeling of relief and contentment wash over you in waves as your caring pet drinks.";
	say "     Your free hand soon drifts about the welcoming swell of your taut sexy bump and [breast size desc of player] breasts, absentmindedly pampering your growing splendor, as you dream of the moment your foals will come to term. Already, you can picture the sweet little looks on their face as you draw them close, sharing that oh-so-brief, yet precious moment of connection with them while they take their sips of your wisdom and experience. Perhaps one day, you might even get to hold some adorable granddaughters in your arms, or feel the priceless satisfaction of knowing your wondrous herd will succeed you to carry on your name and deeds. For now, you're more than content to simply enjoy your runs with the people you love, and share all the wonderful gifts your body has to offer with your caring souls like your sweet Liliana. You muse, sensing the subtle little wriggle of your sleepy foals greeting your palms. Shh, no need to get up dears, you whisper, gently stroking the outline of one of their widdle hooves with your pointer finger as you hum a wordless lullaby to your fillies.";
	WaitLineBreak;
	say "     Well and truly alone, your maternal voice and the hungry suckles of your pet, are carried along the breeze like clarion chimes as the two of you bask in the shared exalting of your gorgeous body. How long you stay like this though, you can't say. To you, the world might as well be standing still, were it not the succulent meter of Liliana swallows and fluttering of your hair along your generous toned curves. You would have sworn time had halted just for you and your growing family. A feeling some part of you will no doubt treasure for the rest of your days as the warm kiss of your pet's lips and tender caress of her tongue lavishing your well-loved teats is like a grind stone for the soul, polishing away any petty cares and worry that might have weighed down upon you. Yet as your wondrous hymn reaches it zenith, you can feel the pace of Liliana's suckle begin to ebb.";
	say "     Curious, you turn your head to the side, and watch with some small mote of maternal mirth, her eyes begin to flutter shut as she thoughtlessly leans more of her weight against you. Her lips still lovingly wrapped about your well-loved teat like her own personal pacifier. In no mood to rouse her, you carefully shuffle your legs supportively besides her while soothingly caressing her cheeks like you would any tired foal. Purring some distant words of thanks, your sleepy mare soon drifts off to peaceful slumber, still sucking on your teat like her own personal toy. Shrugging, you decide to let her rest, she had a hard run after all and isn't built for such actively. You giggle under your breath, idly flexing your toned runners legs, relishing the power nesting in your haunches. While your eyes drift skyward, watching the clouds sail on overhead in content silence as your lovely pet her mane and stroke her ears.";
	WaitLineBreak;
	say "     [italic type]An indeterminate amount of time later[roman type], and your still suckling mate begins to awaken with an audible smack of her lips grumbling. 'Mh d-di-did I fall asleep,' slowly easing herself into a sitting position at your hooves. Nodding, you right yourself and tell her it would appear so, not that you mind. You beam, giving your now much lighter crotch pillows an appreciative pat. You were overdue for a good milking anyways, you tease, lips curling into a playful grin at the adorable sight of her prominent milky mustache emblazoned on her snoot, and the tiny curve of her cream flush middle tenderly lazing on her thighs. She deserved a nice nap and a [italic type]big[roman type] yummy meal. Blushing beneath your libidinous stare, Liliana simply nods as her hands drift to their tight tum as she tries to cover up her cute widdle food baby.";
	WaitLineBreak;
	say "     Tittering, you lightly brush aside her palms with your hooves and lewdly run your feet along her belly fur, telling your lovely mare not be ashamed of her figure, besides she can work this off in no time. In fact, you exclaim, the two you could head out now and find some silly ferals fight and fuck, that should really get the blood pumping. You proffer, tracing your hoof down her chiseled flanks while motioning the wider city with an exuberant flick of your ears. Snorting twin jets of billowing steam, Liliana nods with a steely look in her eyes as hops to her feet, saying. 'Ha lead on then sister,' while she readies her spear. Good girl, you simper, pulling yourself to your height and trot off with her in tow.";
	LineBreak;
	say "     [italic type]Author's Note: Ipotane content ends here, and a special thanks to aishanyan for their help filling out the milk item tables.[roman type]";
	now XP of Best Pony is 0;
	now level of Best Pony is 1;

Best Pony ends here.