Galaxite by Sundered Dragon begins here.
[Version .01 testing phase]
[Version .02 Dry run phase]
[Version .03 Trawler phase]
[Version .04 End of act 1]
"Adds an angel with scalie wings to the Flexible Survival game."

[       HP of Galaxite           ]
[ 1 = Lowly monster girl form    ]
[ 2 = Half Dragoness form        ]
[ 3 = Anthro Dragon form         ]
[ 4 = Dragon queen form          ]
[ 5 = Spoiled dragon queen form  ]
[ 6 = BBW Dragon queen form      ]
[ 7 = Futa dragon dragon form    ]
[ 8 = Spoiled futa dragon        ]
[ 9 = BBH dragon queen form      ]
[ 8 = Avatar of Tiamat form      ]
[ 9 = Dragon goddess form        ]

[            Energy of Galaxite                    ]
[ 0 = No Breeder TF for Player                     ]
[ 1 = PC has become a dragon breeder               ]
[ 2 = PC has earned their wings                    ]
[ 3 = PC can dazzle                                ]
[ 4 = PC can soon raid the tower                   ]
[ 5 = PC can be pampered                           ]
[ 6 = PC is starting to gain                       ]
[ 7 = PC is getting fat                            ]
[ 8 = PC is a BBD                                  ]
[ 9 = PC surrenders to gluttony and breeding       ]
[ 10 = PC has resisted their urges, blows raspberry]

[        Loyalty of Galaxite             ]
[ 0 = PC is down to play                 ]
[ 1 = The player may have bad taste      ]

[ Affection of Galaxite        ]
[ 0 = first message            ]
[ 1 = second message           ]
[ 2 = third message            ]
[ 3 = Fourth message           ]
[ 5 = Fifth message            ]
[ 6 = sixth message            ]

[ Depravity of Galaxite                 ]
[ 0 = PC can not become a Dragon Knight ]
[ 1 = PC is the knight who saves Dragons]

[ Humanity of Galaxite                   ]
[ 0 = PC can't become a Dragon HandMaiden]
[ 1 = PC can become a Dragon HandMaiden  ]

[                          Charisma of Galaxite                                  ]
[ 0 = Zee Batz not met or dommed                                                 ]
[ 1 = Zee Batz cowed                                                             ]
[ 2 = Zee Batz tamed                                                             ]
[ 3 = Breaking in the Zee Batz                                                   ]
[ 4 = Koboldizing the Zee Batz                                                   ]
[ 5 = Hermafying the Zee Batz                                                    ]
[ 9 = Kai Monah is breeding the Zee Batz                                         ]
[ 10 = Kai Monah's Kobat Spawn are invading the beach/city                       ]
[ 11 = Kai Monah is promoting the raiding                                        ]
[ 12 = Riches and slaves are flowing in                                          ]
[ 13 = Head bat is growing into hir role as a leader of the kobat swarm          ]
[ 14 = the Kobat 'Queen' is born                                                 ]
[ 15 = Kobat Queen starts making requests of the Player                          ]
[ 16 = Kai Monah choose to humor hir                                             ]
[ 17 = Kobat Queen requests fertile pills                                        ]
[ 18 = Kobat Queen requests herm pills and pixie dust                            ]
[ 19 = Kobat Queen requests tits multiplier injection and cunt pills             ]
[ 20 = Kobat Queen desires piercings from Kara                                   ]
[ 21 = Kobat Queen wants clothes from Andromeda                                  ]
[ 22 = Kobat Queen demands more food and servants                                ]
[ 23 = KoBat Queen is gain weight                                                ]
[ 24 = Kai Monah encourages the Queen's growth                                   ]
[ 25 = Kobat Queen swears eternal loyalty to the Kai Monah                       ]
[ 26 = Kai Monah choose not to tame Zee Batz                                     ]
[ 27 = Kai Monah choose not to koboldify the Batz                                ]
[ 28 = Kai Monah leaves the Zee batz as males                                    ]
[ 28 = Kai Monah stopped the raids                                               ]
[ 29 = Kai Monah denies the Queen's requests                                     ]
[ 30 = Kai Monah refuses the Queen's first request                               ]
[ 31 = Kai Monah slaps down 2nd request                                          ]
[ 32 = Kai Monah shoots down 3rd favor                                           ]
[ 33 = Kai Monah poo poos 4th ask                                                ]
[ 34 = Kai Monah says no to 5th demand                                           ]
[ 35 = Kai Monah puts the Queen in hir place                                     ]
[ 36 = Kai Monah likes em slim                                                   ]
[ 37 = Kai Monah hates fatties                                                   ]

[        Stamina of Galaxite used for imports            ]
[ 0 = Baseline                                           ]
[ 1 = can Complete the Ruined Trawler                    ]
[ 2 = Break Water Heist                                  ]
[ 3 = Opened Loot Boxes                                  ]
[ 4 = Gathered Supplies for Tower Raid                   ]
[ 5 = Tower Raid complete                                ]
[ 6 = Knights dealt with                                 ]
[ 7 = Elves enslaved as they should be                   ]
[ 8 = Dragon home has been moved to the Abbey            ]
[ 99 = Tentacle Hosts unleashed                          ]

[ Hunger of Galaxite stat is shared between her and Nui-Koa       ]
[ 0 = PC is viewed as a servant                                   ]
[ 1 = PC is viewed as an aspect of The Challenger (like Mx)       ]
[ 2 = PC is viewed as an aspect of The Destroyer (like Drake)     ]
[ 3 = PC is viewed as an aspect of The Life Bringer (like Olivia) ]
[ 4 = PC is viewed as an aspect of The whisper (like Vix)         ]
[ 5 = PC is mantling/being consumed by the Aspect of Kai Monah    ]

[            Strength of Galaxite                   ]
[ 0 = Kai Monah has not met the sharks              ]
[ 1 = Kai Monah ignored the Sharks                  ]
[ 2 = Kai Monah chose to fuck the Sharks            ]
[ 3 = Kai Monah is called by the Reef-Bolds         ]
[ 4 = Kai Monah has kolboldized the Sharks          ]

[            Dexterity of Galaxite                        ]
[ 0 = baseline                                            ]
[ 1 = Nutted in by a well hung Dragon Taur                ]
[ 2 = Got breed by a feline taur                          ]
[ 3 = Got egged by a late stage Margay tauress            ]

[            Intelligence of Galaxite                      ]
[ 0 = no ovi content for the Dragon Breeder                ]
[ 1 = Ovi content is enable for the Dragon Breeder         ]
[ 2 = tail maw and Ovi content is enable for Dragon Breeder]

[                 Moral of Galaxite                   ]
[ 0 = base                                            ]
[ 1 = empowered by the storm                          ]

A postimport rule:
	if Stamina of Galaxite is 1 and Energy of Galaxite is 0:
		now Ruined Trawler is active;

A postimport rule:
	if Stamina of Galaxite is 2 and Energy of Galaxite is 0:
		now Break Water Heist is active;

A postimport rule:
	if Stamina of Galaxite is 3 and Energy of Galaxite is 0 and Break Water Heist is resolved:
		now Loot Boxes is active;

Section 1 - Stats

Table of GameCharacterIDs (continued)
object	name
Galaxite	"Galaxite"

Galaxite is a woman.

ScaleValue of Galaxite is 3. [five foot six]
Body Weight of Galaxite is 3. [scale of 1-9 for body weight, grouped into low weight (1-3), mid weight (4-6) and high weight (7-9)]
Body Definition of Galaxite is 4. [scale of 1-9 for body definition, grouped into low muscle (1-3), mid muscle (4-6), high muscle (7-9)]
[Body Adjective is generated out of the body weight and body definition and can be used in scenes - one word descriptive adjective depending on weight and definition groups: low weight group: skinny/slender/lithe; mid weight group: average/fit/muscled; high weight group: pudgy/husky/jacked]
Androginity of Galaxite is 9. [Gender Adjective is generated out of androginity 1-9: hypermasculine/masculine/somewhat effeminate/effeminate/androgynous/feminine butch/tomboyish/feminine/hyperfeminine]
Mouth Length of Galaxite is 2. [inches deep for face fucking; maximum possible will be double this number (when deep throating)]
Mouth Circumference of Galaxite is 3. [mouth circumference 1-5, "tiny, small, normal, wide, gaping"]
Tongue Length of Galaxite is 3. [length in inches]
Breast Size of Galaxite is 3. [cup size as number, counting Flat Pecs = 0, A = 1, B = 2, ...]
Nipple Count of Galaxite is 2. [count of nipples]
Asshole Depth of Galaxite is 1. [inches deep for anal fucking]
Asshole Tightness of Galaxite is 1. [asshole tightness 1-5, "extremely tight, tight, receptive, open, gaping"]
Cock Count of Galaxite is 0. [number of cocks]
Cock Girth of Galaxite is 0. [thickness 1-5, thin/slender/average/thick/monstrous]
Cock Length of Galaxite is 0. [Can be made a herm later if the PC wishes to]
Ball Count of Galaxite is 0. [allowed numbers: 1 (uniball), 2 or 4]
Ball Size of Galaxite is 0. [size of balls 1-7: "acorn-sized", "dove egg-sized", "chicken egg-sized" "goose-egg sized", "ostrich-egg sized", "basketball-sized", "beachball-sized"] [Increase by 1 for Alpha, decrease by 1 for Omega]
Cunt Count of Galaxite is 1. [number of cunts]
Cunt Depth of Galaxite is 25. [penetrable length in inches; some minor stretching allowed, or more with Twisted Capacity]
Cunt Tightness of Galaxite is 3. [size 1-5, generates adjectives of extremely tight/tight/receptive/open/gaping]
Clit Size of Galaxite is 3. [size 1-5, very small/small/average/large/very large]
[Basic Interaction states as of game start]
PlayerMet of Galaxite is false.
PlayerRomanced of Galaxite is false.
PlayerFriended of Galaxite is false.
PlayerControlled of Galaxite is false.
PlayerFucked of Galaxite is false.
OralVirgin of Galaxite is false.
Virgin of Galaxite is false.
AnalVirgin of Galaxite is true. [Silly players buttholes are a myth!]
PenileVirgin of Galaxite is false.
SexuallyExperienced of Galaxite is true.
TwistedCapacity of Galaxite is true. [Twisted Characters can take any penetration, no matter the size]
Sterile of Galaxite is true. [steriles can't knock people up]
MainInfection of Galaxite is "Human". [For now, don't worry we'll get them dragoned up in no time!]
Description of Galaxite is "[galaxitedesc]".
Conversation of Galaxite is { "Dragons? Dragons!! Dragons..."}.

the scent of Galaxite is "Galaxite smells of clear ocean waves and the subtle sweetness of Plumeria flowers.";

to say galaxitedesc:
	if HP of Galaxite is 1:
		say "....."; [Placeholder, Galaxite is unlikely to have desc till her HP is 4 or more. However, she may get a figure.]
	else if HP of Galaxite is 2:
		say ".....";
	else if HP of Galaxite is 3:
		say ".....";
	else if HP of Galaxite is 4:
		say "....."; [Real desc will start here soon *TM*]
	else if HP of Galaxite is 5:
		say ".....";
	else if HP of Galaxite is 6:
		say ".....";
	else if HP of Galaxite is 7:
		say ".....";
	else if HP of Galaxite is 8:
		say ".....";
	else if HP of Galaxite is 9:
		say ".....";

Section 2 - Events

Table of GameEventIDs (continued)
Object	Name
Holy Moly	"Holy Moly"

Holy Moly is a situation.
ResolveFunction of Holy Moly is "[ResolveEvent Holy_Moly]". The level of Holy Moly is 15.
Sarea of Holy Moly is "Mall".
when play begins:
	add Holy Moly to BadSpots of HermList;
	add Holy Moly to BadSpots of FemaleList;
	add Holy Moly to BadSpots of FurryList;
	add Holy Moly to BadSpots of MaleList;
	add Holy Moly to BadSpots of BodyHorrorList;

to say ResolveEvent Holy_Moly:
	say "     Traversing the barren claustrophobic tunnels of the city sewers on yet another failed expedition, you're just about ready to call an end to this otherwise boring and all together uneventful trip into the depths. Suddenly, out from the gloom, you hear a panicked feminine voice calling out to you in the distance, 'Hello!? Is anyone out there!?' The voice yells, though its cry is slightly distorted as it echoes off the cold stone walls. 'Hey, if someone's out there, I could really use some help! The floor collapsed out from under me, I'm trapped, and can't feel my legs! Please, if someone's out there [bold type]HELP![roman type]' they wail over an almost resigned pitiable whimper. 'I-I-I, don't want to die down here...' the not too far off voice sobs from the shadows. The sheer desperation of their cry tugs at your heart strings, and a part of you wonders if you should go search for them. A more rational, cynical side of you though cautions against getting involved. The sewers are home to some rather nasty creatures, this call, no matter how realistic it sounds, may be a trap.";
	LineBreak;
	say "     [bold type]What Would you like to do?[roman type][line break]";
	let knight_who_saves_dragons_Choices be a list of text;
	add "No, you do not want to follow the voice." to knight_who_saves_dragons_Choices;
	add "Yes, you want to follow the voice." to knight_who_saves_dragons_Choices;
	let knight_who_saves_dragons_Choice be what the player chooses from knight_who_saves_dragons_Choices;
	if knight_who_saves_dragons_Choice is:
		-- "No, you do not want to follow the voice.":
			say "     Hardening your heart, you turn your back to the pleadings of whoever, or whatever calls to you from the dark. Surely nothing can come from this place, you muse, swiftly dashing back towards the perceived safety of the Mall as fast your [BodyName of Player] legs can carry you. Your hurried footfalls echo throughout the humid corridors as the unseen person screams and hollers after you, begging you for aid. With each passing second, their voice cracks in desperation. They promise you gold, sex, their first born child, anything you want if you'll just save them, or at the very least send help. Though as it becomes ever more obvious you're moving away from them. The voice grows increasingly angry and unhinged, spouting death threats, curses, and all manner of obscenities that would shock an old salt, but your time in the city has made you numb to such obvious ploys. You plug your ears, pressing on with all due till you're well out of range of their warblings, and in no time. You find your back at the Mall Bathroom, a little rattled, but no worse for wear.";
			now Holy Moly is resolved;
			decrease morale of Player by 5;
			decrease humanity of Player by 5;
			now Stamina of Galaxite is 99;
			TraitGain "Orphan Maker" for Player; [*Depressed dragon noises*]
		-- "Yes, you want to follow the voice.":
			say "     Unable to leave this person in the lurch, or perhaps curious about the nature of their situation, you head off in what you think is the direction of the feminine-sounding voice. As proficient a survivor as you may be though, it's easy to get yourself turned around in the oppressive gloom of the sewer tunnels as the resounds and through the interlinked web of passageways. More than once, you find yourself walking down deadends, or stopped by the odd decrepit tunnel in varying stages of collapse. Some are riddled with gnarled black roots and strange red fleshy vines likely originating from the otherworldly nanite-enhanced plants of urban forest or the swamp. Others show signs of water damage as pools of foul-smelling water cascade from deep umbral gouges in the ceiling and pools about the cracked floor as the city's failing utilities likely burst from the lack of maintenance, or result of the geological disturbance brought about by the destruction of the capitol district.";
			say "     Growing desperate, and a tad frustrated by the constant stream of setbacks, you call out to them, asking where they are, not caring who hears you at this point so long as you can locate this fellow survivor. 'I, um I'm not sure, I was following the purple line out towards the bay when the ground gave way,' the distorted voice yells from somewhere. Looking around you can't see anything that could be called a [']purple line['], just pipes, pipes, and more freaking pipes, than it hits you. The overhead utility lines are all painted different colors, likely to denote their contents. Poking around the area, you soon find one dyed a rich magenta. [if perception of player >= 20]Though something about them seems a bit... off, none of them have pipe clamps securing them to the ceiling, and a few even seem to have been woven around the older lines like a wet noodle. Guess the city was cheaping out on maintenance, you opine following the down towards what you hope is the bay[else if perception of player < 20]Oddly, unlike the rest of the pipe which are rather faded, coated in grim, or riddled with rust bubbles, the purple pipelines are all coated in pristine glittering dye as if someone just came by and painted them. Perhaps they were installed recently, you muse, following the branches down towards what you assume is the bay[end if]."; [Note: IRL a purple pipe denotes a line carrying dangerous or toxic chemicals in need of special treatment.]
			WaitLineBreak;
			say "     The further you go, the more the environment seems to change, as the air around becomes more hot, humid, and oppressive by the moment. Unbidden sweat and condensation drip down your face along with the nearby walls in warm copper-scented rivulets. It feels like you've walked into a monsoon jungle, or the mouth of a great decaying creature as the once still air coils and writhes about you. Which should be impossible this far underground, but you push aside such idle intrusive thoughts for the moment to concentrate on the task at hand. As you call out once more, letting the fellow survivor know you've found the line, and you're on your way. 'Oh thank Tiamat! You sound a lot closer now, just watch your step! The whole place has gotten really unstable recently,' the resounding echo of the survivor's voice hollers back in slightly relieved, though still somewhat rattled, tone. Nodding your head in acknowledgement, you voice your appreciation as you eye up some of the jagged cracks forming in the nearby walls with suspicion.";
			say "     You proceed at a measured pace keeping one eye on the ground and the other on the ceiling. As the pathway grows ever more decrepit, you have to duck and dive out of the way of a few falling bits of cement and old brick as the ground almost seems to shift and tremble in aggravation of your trespass. Each loud crash echoes throughout the sewer with a broken distorted knell almost as if you were underwater. Still, you push on and after rounding yet another twisting path in your strange circuit, you finally come upon the trapped survivor. She, at least you assume they are a she going by the presence of the pair of shapely c-cups covered up by a plain black t-shirt, is halfway buried up to their diaphragm in broken concrete. At first glance they at least appear to be mostly human (at least from the waist up) with deathly pale olive skin. Their face, despite being covered in sweat and grime, has classic almost ageless beauty like one would see on ancient Greek statues. While their ears resemble a set of blue aquatic fins with a pronounced reptile or draconic bend, and are framed by long black hair.";
			WaitLineBreak;
			say "     Their soft golden eyes meanwhile are slitted like some sort of Lacertidae and shimmer in the dark like gutted, sputtering pilotlights with bestial desperation and forlorn hope. Strewn all around them are dozens of empty water bottles, the remains of energy bar wrappers, alongside a sturdy looking hiking backpack. As your eyes meet, they wave you over exclaiming, 'Holy shit you're real! I haven't seen anyone in days, even the mutants seem to avoid this place. I thought,' they mumble in cadence boarding on mania as they shake their head in disbelief at the sight of you, 'I thought, I was starting to go crazy when I heard your voice.' Assuring them that you are very much real, you gingerly head over to get a better look at their predicament. You realize the poor person has definitely been here quite awhile if the mess wasn't enough of an indication. The area around them is covered in rusty red speckled scratch marks. Their fingertips likewise have all been ground to raw jagged bloody edges, and their arms are covered to the elbows in gray grime.";
			say "     The cement adjacent to them though is crushed to finely-ground moist gray sand. Almost like it had undergone a partial form of liquefaction then sealed itself perfectly around them like a glove. The more you look at it, it's a wonder they weren't crushed to death, or can even breathe based on how tight the material hugs their hourglass waist. You muse, grimacing at the thought. 'That bad eh?' the post-human asks, noticing the dour look on your face. Offering them a reassuring smile, you try to tell them not to worry as you consider your options. The obvious answer would be to try and pull them out. Your combined strength may just do the trick. Alternatively, you could try convincing the Wolverines at the Mall, or perhaps some of its residents to send down a rescue party to dig them out. If you're feeling particularly malicious, you could also just steal their bag and its contents. A good backpack would be quite useful given the state of the world, after all every pound of carry capacity counts. It's not like they can stop you anyways.";
			LineBreak;
			say "     [bold type]What do you want to do?[roman type][line break]";
			let answer_the_call_Choices be a list of text;
			add "Pull them out." to answer_the_call_Choices;
			add "Get help." to answer_the_call_Choices;
			add "Steal their bag and leave." to answer_the_call_Choices;
			let answer_the_call_Choice be what the player chooses from answer_the_call_Choices;
			if answer_the_call_Choice is:
				-- "Pull them out.":
					say "     Resolving to take the more direct approach to solving this situation, you tell the survivor that you're going to try to pull them out. 'Uh, I don't know if that will work, but it's better than sitting here waiting for my supplies to run out,' the survivor quips as they brace their arms along the edge of the strange sinkhole. Walking behind them, you squat down and hook your arms under theirs telling them on the count of three to push with all them might while you pull. 'Ok,' the monster person replies in a dubious tone, bracing their arms beside them. Right, one, two, THREE! You grunt and lift with all the strength your [BodyName of Player] legs can muster. The ground creaks and groans as the tightly packed rubble resists your efforts, though little by little, you feel it slowly giving way as tiny fissures form across the surface of the compacted gray substrate. Encouraged, you push yourself even harder, and feel the rubble finally give way, with an oddly wet organic pop like someone was cracking their knuckles, as the survivor slips loose.";
					say "     You both go stumbling backwards, landing in a pile a few yards away as the ground you were just standing on seems to knit shut. Equally stunned by the alien sight, the two of you stare slack jawed as the ground seamlessly repairs itself before your eyes. 'D-did you just see that too, or am I really starting to go mad?' the survivor asks, their voice overflowing with fear as they point accusingly to the spot where the hole just was. Nodding nervously you tell them yes, you did. 'Ok, fuck this place and the horse it rode in on, I'm getting the hell out of here!' They cry as they try to rise on bare shaky legs. Looking like a newborn calf trying to take its first steps, they barely even manage to stand up before collapsing in a spread eagle position on the ground with a hard thud. 'Shit my legs must still be asleep and,' they pause to take hold of and massage the shapely thighs of their right leg, 'what in the fucking hell happened to my fucking leather shorts! SHIT! GOD-FUCKING-DAMN IT, those were from Mr. S leather!'";
					WaitLineBreak;
					say "     She, you confirm, noting the plush lips of her slightly dripping pale-bronze pussy, which she makes no effort to cover as she cries, motioning to her sweaty unnaturally-pasty-looking limbs. Unsure what to say to her, and not wanting to stick around in this crazy place any longer, you grab her bag and offer her your hand. 'Thanks, you're a real lifesaver,' she grunts, pulling herself up to her full height of five foot six. She drapes her left arm over your shoulders for support. The pair of you swiftly shuffle off, though you both eye the spot where the pit was mere moments ago, rather banefully. Already the floor seems to have been completely repaired, almost like the large rent in the ground was never even there. While it's not the oddest thing you've seen in recent days, this is definitely going on the list you muse, trudging your way back to the mall. Along the way, the survivor appears to perk up a bit as the color gradually returns to her legs. She's soon able to walk on her own power, albeit somewhat slowly.";
					say "     Not wanting to tire them out, you decide to let them set the pace and try striking up a bit of small talk to pass the time. Minutes pass and you eventually learn her name is Galaxite, or at least she claims it is, and that she was apparently looking for a supposed group of survivors that have set up shop near one of the many ghost stations hidden under the city. If what she says is true, they allegedly have access to water and power but are said to be a tad isolationist. Curious about her plans, you ask what she was hoping to accomplish by finding them. 'Well, I was sort of hoping we could work out some kind of trade deal. I mean everyone needs utilities, right? I've seen huge brawls break out in the mall over who gets to use a half dead power brick. Can you imagine how much folks would pay just to charge their phones or laptops right now? I'd probably be set till help arrives if I could pull this off!' Galaxite proclaims, rather proudly and greedily at the thought. True enough, but why is she in the sewer if she's looking for a ghost station?";
					WaitLineBreak;
					say "     Shouldn't she be prowling the metro lines, not this god forsaken Shaft Beast and demon-infested hell hole, you reply. 'Right... well I probably shouldn't tell you this but-,'  Galaxite pauses to look around the tunnels. 'Most of the decommissioned stations are blocked off in one way or another to prevent homeless people from squatting in them, or to keep copper thieves out,' she adds, gesturing to some rubber insulated wires above you. 'The city still needs access from time to time, never know when a sump pump will break down, or a rat will chew through a power cable. From what I hear, a lot of these hidden accessways are in the sewers. If I find it, I should be able to climb right down to the ghost station. Well,' she shrugs with a bemused half smirk, 'that was the theory,' she adds as the two of you come in sight of the hole leading back up to the mall. Gazing at the lantern light spilling down from the world above, Galaxite pauses and turns to you saying in a bemused tone.";
					say "     'Hey, I know this may be a bit of an ask, but uh,' she hesitates rocking back and forth of her heels as she nervously eyes the exit, 'could you go on ahead and maybe find me a newspaper or something to cover up the goods? I don't feel comfortable walking around half naked this close to the Shag Shack. Wouldn't want the locals to get the wrong idea,' she jokes through a Cheshire smile, motioning to her lower half with a knowing flourish. Shrugging, you reply that's probably wise and hop ahead of her then root around the area for a bit. Thankfully, due to the lack of trash pickups the surrounding environment is littered with all sorts of random crap people abandoned when the pandemic started. It's not long to till you slightly less abused news rag laying about and pass it down to Galaxite. 'Thanks, you fucking rock!' she says, wrapping the moldering paper around herself like a towel and then pulls herself out. Once she's standing on Terra-firma and straightens out her shoddy covering, you follow after and go to offer her bag back, but stops you with a wave of her hand.";
					WaitLineBreak;
					say "     'No, you keep it, it's not much, but you're welcome to help yourself to my bag and what's left of the supplies. It's the least I can do, I've got some stuff squirreled away nearby,' she says, gesturing to the outskirts of the mall with a broad wave of her hand, 'so you don't have to worry about me. It's not my first time slumming it on the streets or anything.' Nodding, you express your gratitude and wish them well. Flashing a warm almost too-toothy smile Galaxite returns the sentiment and heads off to parts unknown, muttering something under her breath about meeting someone at [bold type]the beach[roman type]. Once she's departed, you take a moment to dig through the pack. Inside, you find a pair of sugary sports drinks with a black wolf head on the logo, some clean bandages still wrapped in a thin lucid sheet of plastic, alongside a beat up claw hammer, and a few energy bars. It's not your best haul, but at least you have something to show for your work. Who said good deeds don't go unrewarded?";
					now Holy Moly is resolved;
					now Beach Reunion is active;
					ItemGain Sports Drink by 2;
					ItemGain Clean Bandages by 1;
					ItemGain Claw Hammer by 1;
					ItemGain Chips by 3;
					ItemGain Hiking Backpack by 1;
					increase Morale of Player by 10;
					increase humanity of Player by 25;
				-- "Get help.":
					say "     Recalling some apocryphal news stories about people stuck in similar circumstances, you reason that it would be best to try and enlist some support. For all you know, trying to pull them out or digging around them could just make things worse. At the moment, they and the surrounding area appear to be stable, it wouldn't do you or them any good if you somehow ended up getting trapped down here with them or worse; you end up crippling them trying to save them. Sighing in defeat, you tell them you're going to have to head back to the mall and get help. 'Wait what the fuck! You're gonna leave me here!?' they cry, eyes widening in alarm. Nodding in the affirmative, you regretfully reply that you don't have means to dig them out safely, so you're going to need some help. 'Well could you try pulling me out instead?' they beg, their voice cracking with desperation. Trying to put on a brave face, you explain that you have no idea what condition their lower body is in right now.";
					say "     For all you know, their bottom half could be completely pulped. The pressure of earth and their nanite healing factor might be the only thing holding them together. If you pull them out recklessly well... 'Oh god,' they sob, looking down at their trapped form as the realization of the true weight of their situation hits them. Kneeling down, you pat them on the shoulder, telling them not to panic. Someone will come for them soon, hopefully with the tools necessary to pull them out. 'You mean it?' they croak, wiping a soot-laced tear from their eyes. Smiling warmly, you tell them that you do, and head off towards the Mall at a breakneck pace. Thankfully, the way is just as barren as when you came the way, so you make good time. Once you catch sight of the hole to the bathroom floor along with the odd lantern ever burning illuminating it. You vault up to upper level and set about looking for the nearest member of wolverine security.";
					WaitLineBreak;
					say "     Like all cops, or rent-a-cops in this case, they are never around when you need them, so you decide to cut out the middleman and head for their office in the back of the mall. You push your way through the crowds of people till you reach the back of the mall and the coffee shop that the wolverines have set up in. Most of the assembled mutants pay you no heed as they appear too engrossed in their paperwork, or fleeting moments of downtime. However, the receptionist among them, likely noting the concerned look on your face, waves you over and asks what's wrong. Bounding over to them, you hurriedly explain to them the situation in the sewers. Frustratingly, the man shakes his furry head, informing you that his company is not responsible for what happens in the sewers. His people have enough on their plate worrying about what's going on in the mall and its adjacent area. Justifiably irate, you try telling them if situations were reversed wouldn't he want someone to help him, rules be damned?";
					say "     Your argument falls flat though as the man seems unmoved citing protocols, bylaws, and every tired corporate copout under the flipping sun. Eventually, your argument draws the attention of some of the locals who gather around to watch your tirade. Sensing an opportunity, you call upon your inner demagogue and begin directing your requests more to the crowd than the man alone as you verbally paint an ever more fanciful picture of the situation. Your oration stokes the long simmering fires of distrust and ambivalence many feel towards peace officers and authority in general. Many of the onlookers stories of past grievances with the wolverines (both real and imagined) flow freer than leaded wine and venereal disease at a Roman orgy. All the while, you subtly offer the man an out if he would simply humor the idea of sending a rescue party. Sensing the collective humans and post-human metamorphs growing ire at their continued inaction, the receptionist eventually yields.";
					WaitLineBreak;
					say "     Throwing up his hands in defeat, he promises to speak with his boss and potentially assemble a volunteer search party as soon as she gets back into the office, as he claims that he doesn't have either the authority or the clout to do such things on his own. Satisfied for the moment at least, you tell him that that will have to do, then give him a description of the other survivor alongside her location; all of which the wolverine male jots down on a pad of paper that he stashes away for later. Secure in the knowledge that you've done civic duty, you make your way back to the bathroom to plan your next move.";
					now Holy Moly is resolved;
					Increase Humanity of Player by 10;
					Increase Morale of Player by 10;
					StatChange "Charisma" by 1;
					now Stamina of Galaxite is 99;
					TraitGain "Orphan Maker" for Player; [BOO, bad player, what I'm gonna tell her kids!]
				-- "Steal their bag and leave.":
					say "     Thinking about it, that bag of theirs looks pretty nice. So nice in fact that you can't see why someone as foolish as this should be allowed to keep it. If they're too weak to take care of themselves, it's only natural that a stronger, smarter, more able survivor like yourself should prey upon the weak and put their meager resources to proper use. Who is to say they wouldn't do the same to you if the table were turned? You muse, eyeing their meager possessions. 'Uh hey what's up, you, uh, figured out a way to get me out of here?' the helpless survivor asks in a nervous tittering tone. Chuckling at their weakness, you stride over to them, you kneel down then calmly scoop up their pack and throw it over your shoulder. 'Hey-hey-hey, what are you doing? That's my bag!' the failed survivor bleats as you casually adjust the straps to better fit your [BodyName of Player] body in front of them before turning on your heel and start walking at a lackadaisical pace back to the Mall, without sparing the pathetic failed survivor a second glance.";
					say "     For a moment, they simply stare dumbfounded at the back of your head as the gravity of their situations fully hits them. You can hear them begin to sob meekly followed by a string of cursing and pleading shouts for you to come back that become ever more unhinged by the second. With each bend you round, the sound of their voice grows more distant, and the focus of their cries shifts from you to the ferals. As they try to get their attention, likely as one last desperate attempt to get revenge on you. Sadly for them, the area is just as desolate as when you came through the first. Whether this is due luck on your part, or something about this odd stretch of sewers is anyone's guess. Either way, it doesn't matter to you as you spot the pale sickly yellow light streaming through the large crack in the roof of the sewers that leads to the Mall's bathroom floor.";
					WaitLineBreak;
					say "     You waste no time in mantling the rubble, and set the pack down to rifle through its contents. Unfortunately, the former survivor seems to have run through most of their supplies. Considering all the trash surrounding them when you found them, you're not too surprised. You're only left with a pair of sugary sports drinks with a black wolf head on the logo, some clean rolls of gauze bandages, a number of energy bars, and a beat up claw hammer for your trouble. Bah, you grumble a tad disappointed at your take. Oh well it's better than nothing you suppose.";
					now Holy Moly is resolved;
					ItemGain Sports Drink by 2;
					ItemGain Clean Bandages by 1;
					ItemGain Claw Hammer by 1;
					ItemGain Chips by 3;
					ItemGain Hiking Backpack by 1;
					now Stamina of Galaxite is 99;
					TraitGain "Orphan Maker" for Player; [BOO! Evil player, I hope the horrible tentacle monsters you just unleashed mind flay you!!]


Table of GameEventIDs (continued)
Object	Name
Beach Reunion	"Beach Reunion"

Beach Reunion is a situation.
ResolveFunction of Beach Reunion is "[ResolveEvent Beach_Reunion]". It is inactive.
Sarea of Beach Reunion is "Beach".


to say ResolveEvent Beach_Reunion:
	say "     Wandering around the crowded-yet-calm pathways of the beach plaza, you're struck by the peaceful nature of the humans and post-humans gathered here. Sure, one or two of the infected and the occasional human get a little handsy from time to time, but all and all, the beach goers seem to be conducting themselves rather well. At least compared to what you've seen in the rest of the city, you muse, drifting through the tightly packed maze of towels and umbrellas littering the area. Nearing the northern cliff face bordering the state fair, your idle stroll is cut short as you hear a familiar feminine voice calling to you. 'Holy moly, [Name of Player], is that you?!' Searching around for the source, you spot a bare foot, heavily pregnant, bronze-skinned, bikini-clad monster woman peering over the shapely mound of her fecund tanned tummy and lush blue lycra-wrapped tits at you. As your eyes meet, you recognize that the golden orbs of the reclining figure belong to Galaxite, the woman you rescued from the sewers a while back resting front side up on a long white beach towel with a red cloth backpack set atop it like makeshift pillow by the entrance to the rocky cliffs.";
	say "     Seeing the light of recognition in your eyes, she waves you over enthusiastically. Shrugging, and a bit curious as to what she's doing here, you head on over to her. Meandering through the various beachgoers, you note she seems to be going a lot better than when you last saw her. Her skin is no longer pale and sickly looking, but has taken on a beautiful glowing bronze that highlights her sleek athletic curves and tight runner thighs. Her breasts meanwhile have gained a delightful bit of padding, most likely a result of her current pregnancy as her cute perky DDs balanced atop her taut tum look rather lovely as they strain against her tiny blue bikini top. Perhaps noticing the way you're looking at her curves, the gravid monster girl fixes you with a knowing grin as she arches her back slightly to better highlight her condition saying, 'Oh my gosh [Name of Player] it's so good to see you! I didn't know you came to the beach, here for the [italic type]view[roman type] I take it?' With an polite smile, you tell her something like, and ask her what she's doing out here.";
	WaitLineBreak;
	say "     Shouldn't she be spelunking in the sewers for her ghost station? 'Oh no-no-no,' she laughs, fanning her left hand before her as if to clear the air. 'I'm not going back down there ever again, with all the weird penis monsters, demons, and creepy crawlies, I don't see how anyone could be living down there.' So, she's out of the adventuring game, you ask. 'Nope, in fact, I'm getting ready for my next one right now.' Galaxite pulls herself into a cross-legged sitting position as she gently rests her burgeoning stomach on her lap. Really, what's she going after this time? 'Huh, not sure I should be telling you this, but-,' Galaxite teases, playfully tapping her chin. 'You did save my bacon, sssoooo here's the deal. Not long after the initial outbreak, these weird paramilitary groups showed up and started setting up shop all over the city. Of course, not all of their bases survived all that long, I think the only one left is the Zephyr branch office in the High Rise District. But after doing some digging, I found a few of them along with their equipment are still somewhat intact, but that's not why I'm here,' she says, bobbing her head towards the shore.";
	say "     'See, those bases needed tons of clean food, water, fuel, immunity boosters, not to mention raw materials to keep them running. Now as you can guess, getting that stuff into the city is really hard right now, so a lot of it never made it through. From what I hear, one of these supply convoys was coming by the sea. But, it ended up beaching itself on some rocks out past the break,' Galaxite says gesturing to the ocean, with a languid wave of her left hand. Really how did they manage that, you'd think there'd be charts or records showing where the safe shipping lanes are, you ask. 'You know, I thought the same, but,' she shrugs and reaches into a flap on the side of her pack and pulls out a paper notepad with a pen wedged into the spiral spine. Flipping through its pages, she continues, 'According to this big hunky tiger shark named Kai,' Galaxite rumbling the name in a low lusty draconic treble as she involuntarily crosses and uncrosses her legs, 'and several of the other surfers around here, the ocean floor got a little mixed after the capitol went boom, and Atlantis showed up,' she adds, setting her notepad down beside her.";
	WaitLineBreak;
	say "     Interesting, but what makes her think that anything of value survived, you reply. 'Because the local Sirens and Otters told me so silly, well,' she smirks, lips curling into a far-too-wide predatory grin, 'after I gave them a few of my old bras at least,' she says idly fidgeting with straps of her blue bikini top. 'But apparently the cargo was hermetically sealed, not sure why though. The only reason no one's looted it is because the local Pirate Sharks are fighting some Yuppie Mink in turf war over the salvage rights, and, ha-ha,' Galaxite chuckles into her hand. 'Sorry-sorry, I just realized how crazy that must sound.' Tittering, you tell her not to worry about it doesn't sound any weirder than the [one of]rumors of a invisible floating city populated by transplanar anthropomorphic blue gryphons hovering above the downtown[or]stories of a tribe of mpreg-obsessed orcs running breeding slave camps in the warehouse district[or]tales of den of gay werewolves out in the urban forest[or]scuttlebut regarding a giant bouncy castle populated by living latex monsters off the coast[or]Gossip related to a gang of kobolds running around town using their hyper balls as glorified hippity-hops[at random]. 'Heh, right point taken [Name of Player],' Galaxite giggles, in an amused little trill.";
	say "     'So ya, as I was saying, no one can get near the wreck, but... I've got a perfect plan to deal with them! Can you guess what it is? Galaxite asks, as she leans forward and rests her hand on the taut surface of her gravid middle. Eh, [one of]enlisting a diverse crew of talented ex-air men with nothing to lose to seize the boat by force[or]teaming up with a salvage ship crew led by an old sea captain whose estranged child went down with the ship and who will stop at nothing to retrieve their remains so that they can be properly laid to rest on land[or]convincing a team of veteran thieves that she blackmailed into reuniting for one last job that will leave them set for life to help slip past them[or]the power of friendship[at random]? you query. 'Nope, even better, DRAGONS!' she gushes in a haughty dominant tone as her golden eyes seems to sparkle at the mere mention of the species. 'Well, Feral Sea Dragons to be precise,' Galaxite says with a proud look on her face as she drums her fingers along the hemline of her heavily swollen bronze tummy. Wait, she was able to tame Feral Sea Dragons. How is she able to command them, they don't seem to be the most, well, talkative creatures, you ask, perplexed.";
	WaitLineBreak;
	say "     'Oh, I didn't tame them silly. The wild ones are great lays and give like,' she hesitates a moment as she lightly rocks her head from side-to-side, 'I wanna say the third or fourth best hugs in the city, but they are way too simple for a job like this. However, these guys on the other hand,' Galaxite pants as she leans back to stare at her ripening form. 'After they've had a little drink of mommy's milk,' Galaxite purrs rubbing her chin against the supple mass of her chest, 'become very amenable, not to mention loyal. Why I've already got a small pod of eight handsome little sea dreggys keeping an eye on me out in the surf,' she says, waving towards an oddly-shaped blue-green wave sharking about the shore. 'Once my boys here,' she points to her tummy, 'are done cooking, we're gonna go grab a few supplies and head out,' she says with a dreamy look on her face. 'Say, [Name of Player] since you seem so interested would you like to join in? I can give you a cut of whatever we find?' Galaxite asks, in an eager expectant tone.";
	LineBreak;
	say "     [bold type]How do you respond?[roman type][line break]";
	let To_loot_or_not_to_loot_Choices be a list of text;
	add "Don't hear her out." to To_loot_or_not_to_loot_Choices;
	add "Hear her out." to To_loot_or_not_to_loot_Choices;
	let To_loot_or_not_to_loot_Choice be what the player chooses from To_loot_or_not_to_loot_Choices;
	if To_loot_or_not_to_loot_Choice is:
		-- "Don't hear her out.":
			say "     Shaking your head, you tell her that you don't feel up for it. 'Suit yourself, more loot for me,' Galaxite says. With a shrug, as she waves you off, reclines back on her towel, and resumes sun bathing.";
			now Beach Reunion is resolved;
		-- "Hear her out.":
			say "     'Oh, I knew I had a good feeling about you [Name of Player]!' Galaxite exclaims. 'Now my, mmhh, big boys here,' Galaxite pants lewdly as she strokes her fecund middle, 'can take care of most of the heavy lifting, but they're gonna need some heavy cables to dredge the larger containers. I think we should grab a few gill fruits just in case we need to go underwater.' [if hasgills < 1]Gill fruits? What are those, you ask. 'Right how to explain, uh,' Galaxite says with a thoughtful expression on her face as she wraps her fingers along the sandy shore. 'I guess you could think of them as some sort of mutagenic item like blue gryphon milk or wyvern goop. But instead of turning you into some kind of lowly hybrid or a yucky wannabe dragon, they let you breathe underwater while leaving your current form intact.' Well that does sound useful, where can you find them, you ask[else if hasgills is 1]Wait Gill fruit, you've run into those before. However, you haven't seen another tree in a while. 'My-my, well aren't you well-traveled [Name of Player], not many folks around here know about those things, I'm impressed. Still, no surprised you haven't found more,' Galaxite says, in an approving tone as she eyes you up a renewed interest[end if].";
			say "     'Gill Fruits are very hard to find, much less cultivate. From what I gathered,' Galaxite pauses, picking up her pad, she reclines, crossing one of her shapely legs over the other as she idly flexes her feet and reads through her notes. 'Every time someone tries to pick one, the tree drops all its fruit. Allegedly,' she says, her eyes briefly narrowing to fine umbral pinpricks, as taps her left pointer finger against the brown cardboard-esque backing for emphasis, 'anything that hits the ground, or water instantly rots then the tree either dies, or goes dormant like that,' she adds, loudly snapping her fingers for effect. 'Lucky for us, there is one tree growing out of an old beached trawler down the coast,' Galaxite says, nodding her head towards the Wild Fringes. Right so what's the catch, you ask doubting such a rare find would be left unexploited for long. 'Well,' she says, drawing out the word in lazy drawl as her ears flutter along the tips of her raven black hair, 'it's sort of guarded by some nutty old Fruit Bats who keep attacking anyone that gets close to the [bold type]Ruined Trawler[roman type]. But dealing with a few fly rats should be nothing for a big strong adventure type like you,' Galaxite replies in a sing-song tone, leveling you with a lewd cocksure grin as her gold eyes rove across your [BodyDesc of Player] form.";
			WaitLineBreak;
			say "     Having heard this song and dance before, you ask if by [']deal with['] she means she wants you to beat them up, or scare them off to steal their fruit. 'Daw, you make it sound like wetwork when you put it that way,' she chuckles, 'but pretty much,' Galaxite shrugs, waving her hand before her as if to clear the air, 'and like I said earlier, we also need to salvage the boat's cables and maybe its fishing nets too. Don't get me wrong, given enough time. I'm sure [italic type]my[roman type], heh-heh,' she giggles as she eager traces her well-manicured nails along the supple bronze curves of her well-egged tum, 'dragons could probably haul things back on their own, but once the area is cleared it won't be long till other scavengers try to muscle in on the supply ship. So now that you've heard the plan, what do you say [Name of Player], you still up for a little treasure hunt?'";
			LineBreak;
			say "     How do you respond? [bold type]Note: choosing 'Silence Thot!' will lock you out of erotic content with Galaxite and censor her descriptions. Beware, this choice is irreversible![roman type][line break]";
			let That_is_the_question_Choices be a list of text;
			add "No, you don't want to join her." to That_is_the_question_Choices;
			add "Sure, you'd like to join her." to That_is_the_question_Choices;
			add "Yes, you'd love to join her, but is there anything else she needs?" to That_is_the_question_Choices;
			add "Silence Thot!" to That_is_the_question_Choices; [Fuck around]
			let That_is_the_question_Choice be what the player chooses from That_is_the_question_Choices;
			if That_is_the_question_Choice is:
				-- "Sure, you'd like to join her.":
					say "     'Nice, this job should be a total milk run with someone like you on board!' Galaxite exclaims, loudly clapping her hands once in excitement. 'Now before you go, keep in mind the [bold type]Ruined Trawler[roman type] is down south from here, just stick to the coast, you can't possibly miss it. Once you've cleared the place, get somewhere high up and yell, ahem.' Galaxite pauses to massage her throat, she turns her head towards the sea and shouts in a deep booming voice that seems to shake the sand beneath your feet. '[bold type]Naxokaazthur, naal hin monah's zul los hin bel[roman type]!! And some of my perfect dreggy boys will come and collect everything.' Ok, but why can't you just call them first and have them pacify the place for you. 'Uh, you could but,' Galaxite glances at the sea then reaches for her notepad and cups it to her mouth as she turns away from the water. 'This job calls for more of a gentle touch than my boys are capable of. If the Gill Fruit Tree got jostled by a little whack of their tails, or even slightly singed by their steam breath we could lose the whole tree.'"; [Dovah to stinky human translation: Cruel Sea Tyrants, by your mother's voice are you called.]
					say "     'And if we lose the tree this whole job is borked, so please be careful. This information cost me most of my wardrobe.' Nodding your head, you tell her you understand, clear the area first, collect the fruit, [italic type]THEN[roman type] summon the dragons. 'Exactly [Name of Player],' Galaxite says, giving you a thumbs up. 'Once you wrap things up at the [bold type]Ruined Trawler[roman type] I should have our mmhh [']mounts['] here ready for the journey,' Galaxite swoons with a proud look on her face as she gives her belly an affectionate rub. Right see you soon then, you reply with a respectful bob of your head and set off for the plaza to plan your next move.";
					now Beach Reunion is resolved;
					now Ruined Trawler is active;
					now Stamina of Galaxite is 1;
				-- "No, you don't want to join her.":
					say "     On second thought, when you consider how her last job went for her. You tell her you'd rather not get involved. [if Player is female]'Aw, you're no fun Deb[else]'*Hrump* how drool, you're just as boring as the Old Man[end if].' Galaxite frowns as she waves you off.";
					now Beach Reunion is resolved;
				-- "Yes, you'd love to join her, but is there anything else she needs?":
					say "     'Well, now that you mention it,' Galaxite purrs as she reaches behind her, putting away her notepad, and pulls out a clear bottle of what you assume is tanning oil from her pack. 'I could use a little T.L.C, just look at what these sexy beasts have done to my figure,' she teases as she languidly runs her nails along the length of her rich bronze linea nigra. 'And my poor tits,' she titters, fluffing her bosom with a little flick of her chest, 'they've gotten so swollen these last few days, I can barely even see my feet.' She rumbles, flicking open the lid on her bottle of body oil and drizzles a few thin lines of clear lotion across the length of her bountiful assets. 'Much less this heavy tummy,' Galaxite simpers, as her hands glide down the bountiful curves of the well-seeded middle as she makes a show of trying and failing to wrap her hands around her lush eggy core. 'Oh, if only there were some brave, kind, noble adventurer to comfort a pure innocent maiden like myself in her time of need.'";
					say "     Galaxite swoons, fixing you a lewd look as she leans back and watches the glistening beads of massage oil drip down her top. 'You wouldn't know where I could find one of those, would you, [italic type]kin da mun[roman type]?' she asks, in a sweet tempting tone that makes your heart skip a beat as she traces a delightful swirl in the inviting curves of her midriff with one of the little dollops of shimmering oil streaming down her body in warm inviting rivets. Well, since she asked so nicely, you might, you reply motioning for her to lie back. 'Ah my hero, now don't skimp on that oil, I'm in no hurry to earn my tiger stripes just yet.' Galaxite sighs happily as she reclines on her towel putting her body on full display. Of course, you tell her, grabbing hold of the bottle in one hand. You're unable to resist the urge to marvel at the graceful curves of her motherly body and sun-kissed skin, as you gaze hungrily at her perfect shapely figure. Her every low expectant breath sends a subtle wobble through her delightfully distended tum and perky tits.";
					WaitLineBreak;
					say "     Grinning at the spectacle, you squirt a few cool globs of massage oil into your [BodyName of Player] hands. Your senses are greeted by the sweet exotic scent of Plumeria flowers and the subtle tang of ocean spray. 'Gods, I love that smell, it reminds me of home,' Galaxite coos wistfully, her hands drifting behind her back as she undoes her too-tight bikini top. 'Ah heavens, it feels good to take this off,' she purrs, languidly slipping free of the oppressive slip of clothing. A part of you can't help but admire the taut milk-flushed melons as the glistening mounds laze along the fecund swell of her expectant middle. 'Poor girls, they really needed a little fresh air,' she rumbles, flicking aside the light sheen of perspiration clinging to her once captive chest, 'not to be cooped up in some sweaty spandex prison all day. Don't you agree, [Name of Player]? I mean just look at what that mean old top did to me,' she pouts in a playful trill, gently runs her fingers over the lingering indentation of the bikini's straps as if to soothe herself.";
					say "     Nodding in agreement, you languidly drizzle a heavy sheen of oil over her lush figure in a spiral pattern, and glide your [BodyName of Player] fingers along the tightly packed middle in lazy circles, marveling at how smooth and taut her clutch-swollen belly is to the touch. It's almost as if her bountiful bump is coddled in toned lean muscles and a thin layer of supple maternal flesh. You tease your slick palms along the length of her burgeoning sides as you gently work on the tight tiny knots in her midriff. 'Oh that feels so nice and cool, I could get used to this kind of treatment,' Galaxite simpers delightedly as you gingerly rub the tension out of her toned tummy. Nodding, you leisurely work your way up the graceful curves of her motherly form with loving attention. Your fingertips happily brush the warm tenderness of her almost gravity-defying tits, you flash her a lewd smirk as you gently cup her growing tits in the palms of your hands.";
					WaitLineBreak;
					say "     You remark at how, in her current condition, you doubt that she'd even need to wear a bra anymore as you massage the productive orbs coating them with a layer of shimmering body oil. Your nanite-touched mind delights at the blissful sensation of milky bounty wallowing her heaving chest and the sinful smoothness of her beautiful bronze body playing across your palms. 'Ha, naughty little perv, bet you'd love watching me waddle about the beach in my birthday suit wouldn't you, [Name of Player]? It's not bad enough that I'm so sensitive downstairs I can't wear panties right now,' Galaxite teases, as she bobs her head towards her groin. 'Not that I blame you, a body like this,' she smiles, drawing her hand along her svelte hourglass waist, 'deserves to be worshiped from time to time wouldn't you agree, kin da mun?' She laughs in a sweet enchanting tone like songs of otherworldly birds or the hymns of a smooth breeze dancing upon the leaves of some forgotten glade, as the odd words seems to hang upon you with a strange weight.";
					say "     Nodding, almost dreamily, you tell her that you couldn't agree more as the light seems to dance upon her sensual curves. While your hands glide across her sculpted chest and back down to her vivacious hips and shapely ass in broad sweeping motions. Slathering both in sweet smelling oil, your digits diligently slowly work their way down her pleasantly thick runners legs. Tenderly stroking her inner thighs, you can't detect the slight hint of fat or sag in her fecund form, only soft yielding feminine curves and deceptively dense muscle. 'Mh yes little kau, aam hin thuri,' Galaxite purrs in a captive low draconic rumble, leveling a sweet imploring upon you. Her lustrous yellow eyes shimmer like a sea of molten gold, as she gently hefts her brood swollen belly in her arms providing you ease of access to her bare well-used pussy. Practically blushing with arousal, her plump, blushing, bronze box crinkles with need, as her digits lightly braise her dewy lips invitingly. Her alien words wrap about the edges of your mind like the loving caress of a forbidden flame as you feel a powerful compulsion to please this seraphic beauty welling in your core."; [Dovah to not Dovah: Kin da mun, means child of man and kau, aam hin thuri means: low class servant fit only for menial labor or blood sacrifice, service/show deference to your overlords/tyrants. It should be noted that Galaxite is not calling herself an overlord/tyrant, but her children.]
					WaitLineBreak;
					say "     Your hands move of their own accord like eager magnets drawn to the lush and puffy lips of her breeder's box. You affectionately caress your hands along her well-oiled inner thighs and the sculpted contour of shapely legs, delighting at enthralling interplay of her toned gracile muscles and soft maternal curves. You lean in and happily bury your [FaceName of Player] head between her delightfully sylphian legs as the complimentary scents of fresh ocean air and heady plumeria flowers coil about your like the many heads of a hydra. As you bring your [FaceName of Player] lips to hers, eagerly lapping at her glistening vulva, with the tenderest of caresses as you lavish the dragon breeder's eager box with a potent mix of affection and zeal. Each pass of your tongue along her pleasantly tight passage is greeted by the sweet flavor of Rambutan and a cute needy whimper from the pent up broodmare. As your diligent tongue glides along her pleasantly puffy pussy lips, you feel yourself salivating with delight as her juices dance upon your palate like some exotic feast. You shift your attention toward her petite button, cupping your [FaceName of Player] mouth over her cute little clitty with a nearly vacuum-like seal as you lick and suckle the quivering folds of her joy buzzer.";
					say "     Such loving ministrations elicit needy whines from the sultry monster girl, as her warm dew dribbles down your chin. 'Gosh darn it, never knew pregnant sex felt like this! Everything just feels so new and raw, can't believe I waited so long! Shouldn't have listened to that stupid Old Man,' Galaxite pants as she locks her well-oiled muscular legs around your head and shoulders like a vice. Enthralled by the sensation of her toned thighs, lotion slicked skin, and sweet flavor teasing your body, you make no move to resist her, even as the lustful breeder pulls you in closer with a surprisingly potent tug. All you can do is mewl in mindless gratitude as you lavish your affection on the eager mother's sex with tender flicks of your tongue as your oral muscle explores the warm satin folds of her verdant depths. You move your dominant hand between the pair of you, passionately caressing the welcoming delta of her gleaming bronze cunt. Eliciting a pleased tremble from the blissfully well-seeded woman's body as you dip one than another finger betwixt her molten nether lips.";
					WaitLineBreak;
					say "     Her well-trained muscle clenches and caresses your oral invader with a nearly vice-like grip as you subserviently service her moist muff. Your tongue languidly probes at her silken clitty hood, though never in the same spot twice, much to Galaxite's delight, as the poor woman pants with glee, roughly squeezing your head between her sleek powerful thighs like you were some cheap thrill or lowly disposable toy. Not that that you mind, the sensation of her smooth muscle legs and exotic perfumed scent is a heady brew that only serves to spur you on as you slip your arm under her toned thighs and hoist the woman on her back with one fluid motion. Sending a cute wobble through her expectant form as you tilt your [FaceName of Player] head to the side and press your lips to her vertical smile. Galaxite gasps in equal parts surprise and bliss as you flick and lap at her dewy petals at a pace that would put a pit viper to shame.";
					say "     As the experienced muscles of the eager breeder's box cinch and convulse about your tongue tighter and tighter, swaddling your ecstatic muscle in its sweltering embrace, Galaxite shudders and at last cries out, 'Fu-, flip, yes!' in release as her juicy muff squirts a sweet trickle of exotic fem honey across your related taste buds. Making a show of audibly licking your lips, you gently lower your well-loved bronze bombshell back down to the ground. 'Ah, [Name of Player], you have no idea how much I needed that,' Galaxite pants, losing her hold on your neck as she settles herself on back onto her towel. She shamelessly strokes her blushing cunt as she basks in the afterglow of her climax while shimmering rivers of milk stream from her puffy nips in a rich alabaster river of fecund excess. Smirking at the sight, you ask if she might be up for a round two. 'Ha, maybe some other time, [Name of Player], I know some mutants can just keep going and going, but,' she hums contentedly, eyeing the beads of pearly excess running down her sides.";
					WaitLineBreak;
					if Player is impreg_now and Cock Count of Player < 1 and cunt count of Player >= 1 and "Dominant" is listed in Feats of Player: [TF sex starts here, Olivia leaves the building, and Tiamat takes over]
						say "     'I may have a little present I'd love to share with a fellow mommy and her cute babies,' Galaxite purrs, tracing her nails along the light streams of cream. She hooks the tiniest of dollops to the tip of her pointer finger then brings it to her lips and gently laps at the gleaming droplet. 'Mmhh, so rich, perfect for growing dragons, and,' she rumbles in a low lustful reptilian trill as she draws her nails along the furrow of her tongue, 'ah, big strong adventurers. Come on, my savior, don't be shy, you and your little ones are going to need your strength for the road ahead.' Galaxite purrs, with an inviting bob of her head as she reclines back on her towel bearing the totality of her gravid splendor to you. Smirking at the sight, you ease yourself beside her and gently your lips to breast as you demurely lap at any errant drop daring to deface her perfect form. Your well-traveled palette is greeted with an impossibly rich flavor of sugary vanilla cream, laced with an odd yet exotic floral spice who's name you can't quite place. 'Ha-ha, oh that's tickles, such a diligent little mousy, now don't waste a drop cutie. I guarantee you'll never find anything sweeter out there.' Galaxite preens, while her hand drifts to the back of your head as she encouragingly strokes your ears.";
						say "     Murmuring something in the affirmative, your elated tongue roves the soft warm curves of her ripening tits and the tight swell of her egg-laden core, the rapturous scents of motherly need and Plumeria teasing your senses and lliciting a haughty trill from the draconic breeder, as your oral muscle lovingly works its way toward the potent source of the ambrosial liquid gracing your elated taste buds. Eagerly latching on to her stiff perky nips, a light pleased shudder passes through your playmate, as a tasty torrent of cream floods your ravenous maw as you greedily sup from her tender teat. 'Mh such a hungry kau, no need to hold back now, there's plenty more here just for you, my hero,' Galaxite coos, grabbing hold of your free hand and guiding it to her vacant breast. Despite her svelte build, her grip though soft than silk, is laced with supernatural strength that should be impossible for someone her size.";
						WaitLineBreak;
						say "     You ruminate, as your occupied palm gleefully explores the tight smooth surface of her taut immaculate DD-cups, your free hand roams her curvaceous hips and toned athletic ass, rollicking at the glossy sensation of her silky skin gracing your palms and gentle hills and taut valleys of peerless physique. All the while, glutting yourself on the boundless delights each joyous suckle brings as your tongue dances about her hard nip and plush glands. Much to Galaxite's amusement as she encouragingly presses your head against her shapely chest, murmuring, 'Ruz kau, inu, inok fa zah thuri sulli,' as she buries your nose in the pillowy folds of her lush milky mounds. Her legs coil about your own, as she pulls you into your sleek embrace. You can't help but bask in the interplay of your [bodydesc of Player] form grinding against her trim feminine being."; [Dragon to stinky translation: Good lowly servant meant for sacrifice, drink, and know the true power of your overlords.]
						say "     As your [bodydesc of Player] tummy brushes hers, you can feel Galaxite's unoccupied hand glide along the supple surface of your [SkinName of Player] hide as she massages in the lingering excess oil coating her along the beautiful swell of your bump. 'My-my what an adorable [BodyName of Player] belly you have here,' she croons, provoking a lovely activity from your slumbering brood as her navel kisses yours. 'Mh looks like your little ones are enjoying the meal too, I bet they'll grow up big and strong just like their adventurous mommy,' she titters, while her fingers drift further south as she massages your maternal curves. You can't help but moan into her heaving chest as her far-too-sharp for a human's nails grace the sensitive tissue, leaving fresh tendrils of desire roiling though your [cunt size desc of Player] muff in their wake as your own desperate sex cries out of attention. Without thinking, you shamelessly rub your legs together, desperate to quench the budding font of bestial need within you while you focus on the meal before you. 'Oh is my cute little mousey feeling pent up?' Galaxite giggles, as her digits dance about the edges of your groin.";
						WaitLineBreak;
						say "     Yes, you squeak into her plush ducts while your palms are drawn like erotic magnets across the tight glassy curves of her hale physique to your needy nethers. 'Now-now,' Galaxite tuts, as she entwines her dutifully lubricated fingers with yours, 'let me take care of that for you. You need to focus on feeding your babies lots of yummy dragon milk now, don't you?' Rumbling dreamily, you tell her that of course she's right, you and your brood shouldn't turn down such a thoughtful potent boon, as she drapes your hand over your lovely tum. You can feel the rush of vibrant energy coursing through you as your body swells with power and purpose. Your tits thrum with the essence of draconic maternal majesty as the ripening orbs grow ever rounded and suppler to better feed the new life within you. A blissful heat wells in your limbs as a strange, but not wholly unwelcome power flows from your milk-stuffed core to your extremities as your muscles seem to simmer with renewed vigor and purpose.";
						say "     More, your mind screams, you want, no, [italic type]NEED[roman type] more! As you roll atop her, resting your tummy on top of hers, you firmly grab hold of Galaxite's other nip and bring it your lips, desperate to sup ever more deeply from this bountiful font of power. Her body eagerly responds to your touch as twin streams of alabaster cream baste you tastebuds with her soothing bounty. 'Ha-ha, such a hungry mommy derg,' Galaxite rumbles ominously as her fingers trace the lustful lips of your puddling [Cunt Size desc of Player] pussy, languidly massaging the [bodydesc of player] dewy folds of your button as you feed and grind your burgeoning body against her decadently lubricated frame. Delighting at the sensation roiling through your [bodydesc of Player] core while she dips one finger after the other into your dripping honey pot as she gleefully caresses your [cunt size desc of player] button between her thumb and forefinger. Her remaining digits roil your flush breeders box in decadent waltz of frictionless delight as she pampers your welcoming folds with a passionate rhythm all her own.";
						WaitLineBreak;
						say "     Your elated sex gushes with each loving motion as you feed, desperately trying to quench the twin hungers roiling through you. You hardly even notice the sensual changes taking hold in fertile figure with each swallow of her potent cream. Your body begins to swell and waves of blissful change echoes through your maternal being as a veil of cool gleaming azure scales blossoms into existence along the tender swell of your core. Far from off putting though, you find yourself rumbling with bestial approval at the heady contrast of the sleek armor-like lamina spreading across your tum and the well-lubed contores of Galaxite's own thoroughly-bred middle as your two bumps war for space between you. If anything, a part of you finds their presence somewhat comforting as the prismatic blue carapace evelops you and your brood in its protective embrace. Pulses of morphic delight cascades through you punctuated by the tender flicks of your playmate's talented digits playing desperate button and the gluttonous swallow of mutagenic cream as your limb shifts into menacing yet hydrodynamic bend.";
						say "     You audibly swoon at the intoxicating rush of draconic power flowing through you, as your hands reshape themselves into vicious taloned mitts, perfect for subduing lesser prey, or claiming mates. You cheekily caress your claws along the inviting curves of Galaxite's hourglass waist, utterly enraptured by sensation of her toned warm body pressing against your own and the gentle catch of her smooth scaleless hide playing against the sickled edges of your talons. Glancing up at her beaming expression as she observes your changes, you can tell that she is equally enamored. 'Such a big beautiful mommy derg, I can't wait to see what you two will become,' she preens, rather proudly though you can still detect a hint of jealousy nipping at the edge of her words as her free hand encouragingly massages your growing body. Everywhere her palms touch, you can feel the changes accelerates as your hips widen as pliable velvety scales coalesce about your sopping cunt as your muff deepens and reforms.";
						WaitLineBreak;
						say "     The virgin nerves almost seem to cry out for attention, as your potent aquatic walls milk the tiny monster girl's fingers with preternatural pressure and alacrity. More, you roar into her chest between swallows of fatty cream, desperately bucking your hips against her in some vain attempt to fill the growing need in your unhumble passage. 'Of course scale sister,' Galaxies trills dutifully, as she withdraws her hand ever-so-slightly from your molten muff, evoking a needy whimper from your shifting lips as white opalescent scales spread along the contour of your neck. Your vision cracks and splits into four narrow points that soon flow into one as your jaw stretches out as your face reform noble image of draconic maw. Abruptly, Galaxite forms her hand into spear and thrusts, at once, your vision explodes in a radiant sea of poly-chromatic light as your hungry cunt devours her hand all the way to the wrist. The doting monster mommy, pistons her arm with surprising force and impossible gentleness as she pounds your enhanced new slit.";
						say "     The air echoes with the wet meaty thrum of her loving ministrations, as your shifting sex hungrily sinches about her arm like it were some common toy. Rolling tides of bliss ripple through your needy cunny as the potent tide of change surging through you reaches your feet as they expand outward into sturdy webbed and clawed versions of themselves. Strangely pleased by the sensation of feral might flowing into them, you can't help digging your talons into the soft sand as the ground seems to slip away from you while they grow ever larger still. A brief tendril of primeval fear slithers across the surface of your mind at this sudden development, yet this unbidden sensation of vertigo leaves you just as quickly as it arrives. In its place, is a rush of unbound strength and purpose floods your limbs in a squall of transformative euphoria fueled by every potent suckle of transformative cream gracing your maw and each beatific stroke of your draconic cunt.";
						WaitLineBreak;
						say "     Rumbling happily at the twin pleasures cascading through you, you barely even notice your lower half stretching behind you as your flesh reshapes itself into a new exotic bend. A pair of slender webbed draconic forelimbs begin to form at your waist and your torso starts to lengthen while your flanks flare out like some beast waiting to be bred. Pressure builds along the berth of its terminus as the scales bulge then part as a finned serpentine tail erupts from your hind end. Without even thinking, the new limb coils about legs like a loving pet, sensually massaging your shifting muscles in a soothing tattoo while your altered sex seems to drift away from Galaxite's loving touch towards your rear like flotsam caught in an undertow, only to be met by the loving caress of your newly forged tail, as the lively limb simmers about the rim of your draconic sex. Unerringly smooth and seemingly coated in a rich sheen of natural lubricants, the girthy limb roils about the lust swollen lips of your sex in a heady waltz of eclectic sensation.";
						say "     Swooning under your breath at the euphoric touch of the impossibly smooth scales and glossy sail-esque fins lavishing your [cunt size desc of player] muff with loving strokes, the meager foreplay stokes the burning desire simmering through you all the more as you arc your dexterous appendage in a creative [']U['] bend before hilting your lengthy well-lubed tail with a single thrust. Your malleable tauric snatch stretches and conforms to the exotic shape with blissful ease as your silken wall milk the girthy appendage like a common tool. You can sense each ridge of your glassy scales, every fold for your sail-like fins, and all the delightful bumps of your tail bones as your lower half bulges with the potent weight of your improvised toy. Your liminal psyche reels with the impossible pleasures accompanying the blissful innervation of your seventh limb. You twist and flex your tail fin about the slick walls of your tauric sex in a vibrant storm of sensation that pairs delectably with the constant rush of beatific cream coiling about your shifting palette while your tongue flexes and expands as it takes on serpentine bend as the tip bifurcates into two sharp forks.";
						WaitLineBreak;
						say "     Rumbling contentedly at this development, you dutifully treat your squirming morsel's perky nips to a show of proper draconic affection as you coil their gushing edges and playfully tweak the stiff contour of her milk spouts. The eager dragon breeder shivers ever-so-slightly at your touch as a cute submissive whine escapes from her lips and her flow increases to better match your growing hunger. 'Good girl,' she coos as her hands drift to the warm soft bulge of your well-bred middle, caressing the taut gleaming azure lamina with her soothing touch. A part of you almost swears you can feel a slight tickle of static arching from her fingertips as she gleefully pampers your burgeoning bump while your scales stretch to accommodate her boundless offering. A sense of profound fullness builds in your liminal being as the roiling elysium whirling about your well-fed core and puddling cunt washes over you in erotic squall.";
						say "     Your changing body practically sings in reptilian rapture as an all-too-familiar tightness cascades through you as the dual delights blend together in a hedonic symphony of primeval lust. Your cunt muscles clench about the exotic ridges and sleek valleys of your tail as the tempo of your wild thrusts reach their crescendo and the air crackles as the high slurping kneel of drooling sex desperately milks your prehensile limb. Heavenly pressure and heat arcs through your flanks like lightning playing on a ship's hull as you finish with a ground-shaking roar and a generous gush of feminine juice leaking as your puddling snatch drips along the sleek contours of your rear leg from the force of your release. Delightfully spent, you roll off the tiny monster breeder, licking the last little beads of cream from your lips and languidly slip your tail free of your tauric cunt with flourish. You settle yourself beside her, casting an appreciative gaze down at your exotic form.";
						WaitLineBreak;
						say "     Though it might just be the lingering effects of nanites playing tricks on your sensibilities, you can't help but enjoy the sight of your altered being as your eyes drift along the bountiful hills of your [Breast Size desc of Player] tits. You are utterly enraptured at the spectacle of the bejeweled azure scales coddling the edges of your enhanced mounds and gleaming white alabaster plates gracing your core. You playfully run a webbed padded paw-hand over the flushed orbs, delighting at the wonderous sensation of oily smoothness greeting your inquisitive mitts as your body's natural lubricants play across your pads as you cup the plump scaly milk tanks in your palms. Already, you can feel them going taut with motherly purpose in preparation for feeding your little ones, you muse as your hand glides down to the armored surface of your seeded womb. Replete with thick, tough yet malleable, white scales, along with a subtle soft layer of protective adipose, your liminal mind takes no small amount of pride and comfort knowing your brood will not only be well fed, but protected and not just by [italic type]our[roman type] scales. A slithering choir of voices echoes from the back of your mind as your eyes drift further south to your bestial half. Vaguely serpentine in build, your lengthy hydrodynamic lower body reminds you of the feral sea dragons dwelling along the coast.";
						say "     The heavy scales are evocative of interlocking platemail, though unlike the stocky bloated leviathans trawling the depths, yours are far more subtle and ergonomic in design, yet no less tough, you note tracing a talon on their sturdy glassy surface. Your legs too appear to be better adapted for terrestrial travel as your sleek digitigrade limbs possess none of the awkwardness that you've seen on the bestial sea dragons. Instead, they would look more at home on a Yamato or a wyvern than a waterbound wyrm, though they are no less imposing you muse, experimentally running your paws along the toned lubed contours of your animalistic half. You catch sight of your regal draconic visage reflecting in the mirror-like surface of your forepaw's talons as you lovingly massage the fertile curves of your lower body. Tilting your head for a better view, you note your sleek triangular muzzle bears a passing resemblance to the local Feral Sea Dragoness.";
						WaitLineBreak;
						say "     Though you have a light-blue spined sail down the length of your spine, ringed by a pair of modest swept back onyx horns, alongside a dense layer of jagged toughed scales fortifying your jaw, that is where the similarities seem to end. Your eyes have divided into four verdant glowing gold angular eyes, bereft of irises, the exotic orbs impart an enticing mix of alien abyssal beauty and menace to your appearance which is only enhanced by the tendril-esque hair draped down the back of your head to your [']waist[']. Trying to flex them, your first attempts are rather clumsy as you barely get them to wiggle, yet with each tiny motion, your control grows as feeling spreads to the appendages. Given enough time, you're certain that your mastery over the wonderful accents will improve, you muse, shifting your attention back to your other half, admiring both the beautiful serpentine build of your tauric portion and its lustrous royal navy blue scales lining your resplendent form.";
						say "     You soon spot an unusual series of breaks in the brilliant blue coating your flanks, as the azure gives way to swirls of orange that bleed into metallic magentas then fade away to muted ebony hues. Curious, you focus your senses on these patches and the changes seem to slow then settle in place. Your interest piqued, you further flex your mental muscles trying to bend these chromatophores to your will. Though taxing, the colors soon shift to neutral white streaks, perhaps with practice you'll be able to exert proper control over them and maybe even find martial use for them. As you think to yourself, a muted polite cough from Galaxite snaps you back to reality. '*Ahem* I see the mighty Kai Monah is enjoying her gift,' she preens in a delighted airy trill, though she does little to disguise the envious look creeping along the edges of her face as she kneels before your well-bred being. Ignoring her sour expression, you smirk at the sight of the tiny woman's attempt at a show of proper deference to your majestic form, and magnanimously rumble your appreciation to the lowly creature for bestowing you with such a powerful body."; [Kai Monah = Ocean/Sea Mother]
						WaitLineBreak;
						say "     'Thank you, great wyrm mother, zun zu'ul nun reh-ol reck da han kovve nuthi. May this form serve you well,' your lesser intones, touching her forehead to the sand. Nodding, you bid her rise, informing her that that remains to be seen and that you still need to put this body through its paces. 'Then oh beautiful one,' she simpers in reverence as she returns to a kneeling position, 'if this lowly ape may be so bold as to make a request of your perfection, perhaps acquiring the gill fruits guarded by the insipid bats infesting the Ruined Trawler down south would make fine test for your majesty. Should you deem this trivial task worthy of your attention, I can promise you plunder and power befiting a true dragoness in exchange for this paltry boon,' Galaxite coos, bowing her head before you and clasping her hand over her heart as if in silent prayer. Chuckling, you idly flex your talons before her, reveling in the light that seems to play across their reflective edges as you tell her that you might, though there are other matters that require your attention after all."; [zun zu'ul nun reh-ol reck da han kovve nuthi means but I only do as she of five heads commands. Meaning she's did this because her patron goddess said so, not because she wants to.]
						say "     'Of course honored dragon, I wouldn't dream of commanding you, though should you choose to humor this pathetic mortal's request I have one final gift that could aid you.' She hums, reaching behind herself then pulls her backpack forwards. Setting it between you, Galaxite hurriedly unzips the middle flap, reaches in, and pulls out a large lustrous pearl wrapped in a long strip of black silk. 'Here noble wyrm, this pearl was blessed by my beloved sons the Ullokinne and Naxokaazthur, or Immortal Sky Masters and Cruel Sea Tyrants if you prefer. Carry it, and it will protect your divine form from the corruption of this place,' she dotes, lifting the pearl above her head in offering. Gazing at it, you find yourself feeling oddly drawn to the beautiful bobble as an aurora of blue, red, black, green, white hues dance upon its warm off-yellow surface. You feel covetous energy building in your core at the thought of this weak liminal creature holding such a treasure. Such a prize deserves to kept in a proper wyrm's hoard, not stowed away in a cheap backpack like some dingy bottle of dirty water.";
						WaitLineBreak;
						say "     You muse upon this, carefully plucking the pearl from her outstretched arms and hold it close for inspection. You can't help but remark internally at how right the peerless smoothness feels nestled in the palm of your hand and the beautiful glow of the divine trinket reflected in your eyes. To think that this mewling human kept this to herself, your altered-mind rages as hurriedly stow it away from prying eyes, lest some jealous manlet dare snatch it from you. 'I see you approve of my offering great wyrm,' Galaxite chuckles through a far-too-knowing grin. Nodding, you inform her that it will do, for now, though she should not assume such a pathetic tithe will buy your loyalty or submission. 'Oh, of course not mighty one!' She kowtows, with another deep quick bow. 'That tiny pebble is a gift barely befitting your growing majesty, though you may find it useful nonetheless,' she preens, eyeing your expectant middles with obvious delight. Enjoying the sight of her subservience and a just hair curious about what she means, you demand she explain further.";
						say "     'I do not wish to bore your magnificence with trivial details, but suffice to say that pearl is impregnated with a fragment of my children's power,' she says, her lips curling into a proud reptile-like grin as she tenderly rubs her hand along the bountiful curves of her egg-laden middle. 'Though potent, it lacked both a focus and a vessel worthy of its gifts,' she says as the flicker of a jealous sneer flutters along the edge of her lips. 'Until now Kai Monah, you alone are worthy to bear this tiny sliver of its blessing,' she intones, motioning to your gravid body with a languid wave of her left hand. 'However, your current form is but a pale shadow of the true majesty you could achieve. Help me scale sister, and you could be greater than any chromatic dragon of Kyr, Kai, or Kol. Just picture it my thuri,' she coos, draping her arms along the flush core of your expectant form. The familiar pulse of otherworldly energy arcs from her fingertips as she nuzzles her face against the bountiful swell of your clutch-laden tum. 'You could be the mother goddess of untolds hoards of true wyrms, all of them at your beck and call.'";
						WaitLineBreak;
						say "     'You need never fear the doom of man, or know the bite of time. You will be worshiped, perfect, and eternal reh-ol reck da han kovve nuthi,' the eager demi-human whispers, as her words coil at the edges of your mind as you find yourself repeating the phrase. Reh-ol reck da han kovve nuthi, in a dream tenor, your stomachs swells ever-so-slightly at her touch as the life growing within you resonates with the essence of change flowing through you as hard protective shells grow over their nascent beings. Strangely though, as you run your paws over their resplendent forms, you feel neither fear nor alarm at this development, only pride at thought of birthing majestic creatures. 'Ah, how I envy you thuri, to have such potential growing within you,' Galaxite swoons, tracing her fingers along the taut curves of your lower half.";
						say "     'But for now Kai Monah, rest easy, you are safe by the water edges. When you are ready, seek out the Wild Fringes [bold type]to the south[roman type], defeat the lowly mice nesting in its hull,' she purrs in loving melodic trill as lightning crackles along the borders of your scales in an enthralling waltz of blues, greens, black, reds, and whites. 'When the way is clear, you need only roar [italic type]Naxokaazthur, naal faal hen klov gein los hi bel[roman type], to call my children to your side,' she whispers, as the colors bleed and twist into one another in a vibrant whirlpool of many colors and none. You stare helplessly transfixed by the sight as a sense of weary peace coils about the liminal facets of your mind like the warm inviting waves of some primeval sea. 'Reen Han Na,' Galaxite intones in clear airy cadence as your eyes begin to grow heavy as your consciousness sinks its balmy shadowy depths, 'reh-ol reck da han kovve nuthi.' Reh-ol reck da han kovve nuthi, you reply as dark the water closes over you and all grows quiet."; [Stupid dragon noises to slightly less stupid human dribble: Rest Dream Serve as the fived headed one commands.]
						WaitLineBreak;
						say "     [italic type]An indeterminate amount of time later[roman type], you begin to stir as the dark tide cradling your altered form recedes, washing all traces of fatigue and deprivation from your draconic being. In its place is a rush of maternal purpose and voracious energy as your body thrums with the lingering touch of the strange monster girl. Though she seems long gone, her lofty promise still echoes in your mind, as you feel a subtle slithering pressure tugging at the back of your psyche, urging you to seek out the Wild Fringes, to ascend with all haste. Yet, its call grows weaker with each passing moment as your more rational side begins to assert itself and cautions you against further dealings with Galaxite. Who knows what she has planned for you, perhaps it would be best to rid yourself of this form and move on. Still as you gaze appreciatively at your regal draconic figure, you find it hard to push aside her words so casually. If the glorious body is truly but a shadow of its full potential, then wouldn't you be a fool to spurn her gift so flippantly?";
						say "     After all you did save her life, you muse, flexing your talons before you, delighting in the sensation of primal might coursing through you, waiting to be unleashed on the lowly scaleless creaturing infesting the city. Already, you feel stronger than ever, imagine heights you could achieve with your full potential unlocked! Even the vaunted wyverns and sea dragons of this place would be forced to kneel before you and your brood's majesty, a coiling intrusive voice urges as your eyes drift to the supple curves of your egg-laden middle. You feel a wicked smirk growing on your thin reptile lips at the thought of whelping your own flight of draconic servants. Yes, you rumble under your breath, perhaps you humor the little ape for a spell, at least until you take what you need from her. Perhaps when you're done with her, she makes a nice plaything for your brood, you ruminate, running your paws over the lovely outlines of [bold type]your[roman type] eggs. For now though, you decide to head back to beach plaza and plan your next move.";
						turn the Player into a "Dragon Breeder";
						choose a row with Name of "Dragon Breeder" in Table of Random Critters;
						StatChange "Dexterity" by 3;
						StatChange "Strength" by 3;
						StatChange "Stamina" by 3;
						increase Breast Size of Player by 5;
						increase Cunt Depth of Player by 10;
						ItemGain Dragon Pearl by 1;
						if "Flash" is not listed in Feats of Player:
							FeatGain "Flash";
						If "Breeding True" is listed in Feats of Player:
							FeatLoss "Breeding True";
						if "They Have Your Eyes" is not listed in Feats of Player:
							FeatGain "They Have Your Eyes";
						if "Flat Chested" is listed in Feats of Player:
							FeatLoss "Flat Chested";
						if "Toughened" is not listed in Feats of Player:
							FeatGain "Toughened";
						now Energy of Galaxite is 1;
						PlayerEat 100;
						PlayerDrink 100;
						increase XP of Player by 200;
						decrease gestation of child by a random number from 10 to 15;
						if gestation of child < 1, now gestation of Child is 1;
						now Beach Reunion is resolved;
					else if Player is impreg_now and Cock Count of Player >= 1 and cunt count of Player >= 1 and "Dominant" is listed in Feats of Player:
						say "     'I do have a wonderful gift that I bet a big sexy mommy herm like you would enjoy,' Galaxite purrs, tracing her nails along the light streams of cream. She hooks the tiniest of dollops to the tip of her pointer finger then brings it to her lips and gently laps at the gleaming droplet. 'Mmhh, so rich, perfect for growing dragons, and,' she rumbles in a low lustful reptilian trill as she draws her nails along the furrow of her tongue, 'ah, big strong adventurers. Come on, my savior, don't be shy, you and your little ones are going to need your strength for the road ahead,' Galaxite purrs, with an inviting bob of her head as she reclines back on her towel, baring the totality of her gravid splendor to you. Smirking at the sight, you ease yourself beside her and gently press your lips to her breast as you demurely lap at any errant dribble of milk defacing her perfect form. Your well-traveled palette is greeted with an impossibly rich flavor of sugary vanilla cream, laced with an odd yet exotic floral spice whose name you can't quite place. 'Ha-ha, oh that's tickles, such a diligent little mousy, now don't waste a drop cutie. I guarantee you'll never find anything sweeter out there,' Galaxite preens while her hand drifts to the back of your head as she encouragingly strokes your ears.";
						WaitLineBreak;
						say "     Murmuring something in the affirmative, your elated tongue roves the soft warm curves of her ripening tits and tight swell of her egg laden core, rapturous scents of motherly need and Plumeria teasing your senses. This elicits a haughty trill from the draconic breeder, as your oral muscle lovingly works its way toward the potent source of the ambrosial liquid gracing your elated taste buds. Eagerly latching on to her stiff perky nips, a light pleased shudder passes through your playmate as a tasty torrent of cream floods your ravenous maw as you greedily sup from her tender teat. 'Mh such a hungry kau, no need to hold back now, there's plenty more here just for you, my hero,' Galaxite coos, grabbing hold of your free hand and guiding it to her vacant breast. Despite her svelte build, her grip though softer than silk, is laced with supernatural strength that should be impossible for someone her size.";
						say "     You ruminate, as you palm the taut mass of her immaculate DD-cups. You gleefully caress the tight smooth surface of her chest while your free hand roams her curvaceous hips and toned athletic ass, rollicking at the glossy sensation of her silky skin gracing your palms and the gentle hills and taut valleys of her peerless physique. All the while glutting yourself on the boundless delights each joyous suckle brings as your tongue dances about her hard nip and plush glands. Much to Galaxite's amusement as she encouragingly presses your head against her shapely chest, murmuring, 'Ruz kau, inu, inok fa zah thuri sulli,' as she buries your nose in the pillowy folds of her lush milky mounds  Her legs coil about your own, as she pulls you into your sleek embrace. You can't help but bask in the interplay of your [bodydesc of Player] form grinding against her trim feminine being.";
						WaitLineBreak;
						say "     Smearing your [bodydesc of Player] tummy in a bountiful sheen of sensuous oil, Galaxite's unoccupied hand glides along the ripening surface of your [SkinName of Player] hide, massaging the lingering excess lotion coating her verdant form along the beautiful swell of your bump. 'My-my your belly is getting pretty low isn't it dear,' she says, her hand dipping below taut hem of your well-loved middle. 'Mh,' she purrs as her inquisitive digits caress the tender glans of your stiffening [cockname of Player] rod, eagerly cupping the tender girth of your [cock size desc of player] tool in her palms as she traces her nails along your throbbing cum vein, provoking the neediest little whimper from your lips as she languidly impresses your turgid spire along the supple mass of your growing bump. 'I bet it must feel nice [if cock length of Player < 12]to have such a cute little cock to rest it on[else]to have this wonderful dick support it[end if],' she titters in admiration as she massages the lascivious furrow of your burgeoning maternal curves while her tender flesh gracefully caresses your potent rod. You can't help but moan into her heaving chest at the heady sensation roiling the sensitive tissue, as she playfully strokes your elated member.";
						say "     You find it hard not to buck your hips in tandem with her loving caress as beads of fresh pre-cum dribble down her fingertips like lucid diamonds. 'Oh, what a cute needy mousey, are you feeling a little pent up?' Galaxite giggles, as her digits dance about the base of your cock. Yes, you squeak into her plush ducts while palms are drawn like erotic magnets across the tight glassy curves of her hale physique to your needy nethers. 'Now-now,' Galaxite tuts, as she entwines her dutifully lubricated fingers with yours, 'let me take care of that, you need to focus on feeding your babies lots of yummy dragon milk, now don't you?' Rumbling dreamily in the agreement, you know that she's right, you and your brood shouldn't turn such a thoughtful potent boon, you ruminate as her fingers coil around the stiffening base of your [cock size desc of player] [CockName of Player] dick. You can feel the rush of vibrant energy coursing through you as your body swells with power and purpose.";
						WaitLineBreak;
						if breast size of player >= 1:
							say "     Your tits thrum with the essence of draconic maternal majesty as the ripening orbs grow ever rounder and fuller to better feed the new life within you. You muse, reveling at the comforting heft of your expansive chest lazing upon your flush gravid core. ";
						else if breast size of player is 0:
							say "     Your [bodydesc of Player] pecs throb with paternal purpose as the dormant glands are flooded with potent draconic energies. Despite any reticence you may have once felt towards such endowment, the feeling of raw virgin nerves crackling into being leaves you panting and pawing at your [SkinName of Player] hide with utter delight. You can practically hear your skin creak as the invigorated glands swell with their heavenly bounty. All the better to feed your brood, you muse, as the nascent heavy orbs spill between the gasp in your finger. You find their weight both comforting and decadently enthralling as your plush breast laze along the beautiful pillowy curves of your well-bred middle. ";
						say "A blissful heat wells in your limbs as a strange, but not wholly unwelcome, power flows from your milk-stuffed core to your extremities as your muscles seem to simmer with renewed vigor and purpose. More, your mind screams, you want, no, [italic type]NEED[roman type] more! As your roll atop her, resting your tummy on top of hers, you firmly grab hold of Galaxite's other nip and bring it your lips, desperate to sup ever more deeply from this bountiful font of power. Her body eagerly responds to your touch as twin streams of alabaster cream baste you tastebuds with her soothing bounty.";
						WaitLineBreak;
						say "     'Ha-ha, such a hungry mommy derg,' Galaxite rumbles ominously, giving your cock a gentle squeeze as you feed and grind your burgeoning body against her decadently lubricated frame. Delighting at the sensation roiling through your [bodydesc of Player] core as she diligently strokes your [cock size desc of player] pole against the fecund curves of your motherly mound. You find it hard not to coo with unrepressed raptures at the whirlpool of heat and frictionless static pressure simmering about your spire with each loving pass of her palms. You sluttily rock your hips in tandem with her measured motions, reveling in the heady brew of exotic hormones coursing through your hybrid psyche and the meaty bounce of your thoroughly-bred bump against your elated tool.";
						say "     The air soon resounds with each euphoric wobble of your growing middle and enhanced chest while your body thrums with draconic purpose. You hardly even notice the sensual changes taking hold in your fertile figure with each swallow of her potent cream. Your body begins to swell, waves blissful change echoes through your maternal being as a veil of cool gleaming azure scales blossoms into existence along the tender swell of your core. Far from off putting though, you find yourself rumbling with bestial apporval at the ebullient contrast of the sleek armor-like lamina spread across your tum and the well-lubed contours of Galaxites own thoroughly-bred middle as your two bumps war for space between you. If anything, a part of you finds their presence somewhat comforting as the prismatic blue carapace evelops you and your brood in its protective embrace. Pulses of morphic delight cascade through you, punctuated by the tender flicks of your playmate's talented digits playing with your desperate button and each gluttonous swallow of mutagenic cream as your limbs begin to shift.";
						WaitLineBreak;
						say "     You audibly swoon at the intoxicating rush of draconic power flowing through you, as your hands reshape themselves into vicious reptilian taloned mitts, perfect for subduing lesser prey, or claiming mates. You cheekily caress your claws along the inviting curves of Galaxite's hourglass waist, utterly enraptured by sensation of her toned warm body pressing against your own and the gentle catch of her smooth scaleless hide playing against the sickled edges of your talons. Glancing up at her beaming expression, you can tell that she is equally enamored with your changes. 'Such a big beautiful mommy dragon, I can't wait to see what you too will become, my sweet savior,' she preens, rather proudly though you can still detect a hint of jealousy nipping at the edge of her words as her free hand encouragingly massages your growing body.";
						say "     Everywhere her palms touch, you can feel the changes accelerate as your hips widen and velvety scales coalesce about your neglected sopping cunt as you sense your muff deepening and reforming. While your cock crackles with electric energy all its own, it strains against your eager playmate's grip, the sensual flesh shifting like the tides as your sturdy tool flares at the base and s new aquatic knot surges into being. Though you barely have time to dwell on such changes as your hybrid mind roils with impossible delights at the unearthly sensation racking your twisting sexes. Your liminal cock recedes ever-so-slightly, as raw unsullied sensory cells blossom into being beside your knot as the tissue parts and a reptilian vent begins to form along the base of your cock. All to your partner's apparent delight as the doting monster mommy rumbles approvingly at your changes, saying, 'What a lovely knot you've got here dear,' as she graces the tight moist borders of your cock cave with the loving caress of her delectably lubed digits.";
						WaitLineBreak;
						say "     'And it's got a perfect slit to match your greedy little pussy,' she swoons, as her fingers explore the lush length of your draconic spire. While her free hand dips below your midriff, you feel her other hand shamelessly slip beneath your spunk banks, slavishly braising your sopping muff with her nails, evoking a happy growl from you as your altered walls gush at the light caring caress. 'But there's always room for improvement,' she purrs, as a blissful static roils through your dripping cunt as you suckle. Your body groans with unearthly vigor as the heavenly furnace of morphic rhapsody cascading about you pools in your groin as the hungry receptive flesh expands with each swallow and your scales flow across the tender mass of your balls. Utterly enraptured by the flickers of static delight spreading across their surface, you can only mutter wordless thanks to her while the virile cum tanks seem to drink this potent gift as they strain against their protective housing. Not that you care, the sensation of succulent tightness coiling about your sperm banks is a heady pleasure like no other.";
						say "     You sense the rising tide of change coddling your balls reach its zenith as the plush meaty orbs suddenly divide into four ponderous spheres. 'Mh, these suit you much better, don't they?' Galaxite simpers in admiration as she lightly jostles your glistening sack in the dutifully-oiled palms of her unoccupied hand as if they were priceless jewels. Yes, you whisper in a far-off tone, as she skillfully dandles your swollen cock along the silken curves of your scalie tum. Your body expands by the moment, all the better to accommodate your new assets, a distant mercurial fragment of your mind quips as the soaring weight of your ballooning middle places a decent amount of pressure on your prostate. You find yourself rumbling with the tainted bliss roiling your male endowments in a way that the lingering slivers of your humanoid psyche fails to parse. Even your neglected cunt drips with bestial need as the squall of hybrid sensation evelops you in an flurry of impossible bliss.";
						WaitLineBreak;
						say "     You soon find yourself shuffling your legs in a desperate bid to quench the simmering heat roiling through you before it overwhelms you. 'Ah poor momma, did you think I'd forgotten about your cute little pussy?' Galaxite coos, while the balmy rivulets of feminine dew wicks at her inquisitive digits as they eagerly caress your ponderous sack. No, you moan, as her affections drift towards your altered muff. The doting monster girl languidly brushes her loving lubed finger about the lips of your liminal sex, lavishing your plush button with the tenderest of caresses with her thumb and pointer-finger. An enthralling ripple of lascivious static echoes through your needy petals as she lovingly pampers your futanari button, eliciting a submissive whimper from your occupied lips as the mutual stimulation of your sexes plays havoc with mind. 'Oh now don't cum yet dear, the fun is just getting started!' she teases in an adoring trill, slipping her fingers between the pregnancy-flushed folds of your [cunt size desc of player] cunt.";
						say "     The ripe virgin nerves lining your expanded muff almost seem to sing with nascent elysium, as your potent aquatic walls milk the tiny monster girl's fingers with prenatural pressure and alacrity. More, you roar into her chest between swallows of fatty cream, desperately bucking your hips against her into some vain attempt to fill the growing need in your unhumble passage. 'Of course,' Galaxite trills dutifully as she withdraws her hand ever-so-slightly, from your molten muff, evoking a needy whimper from your shifting lips as the opalescent scales spread along the contour of your neck. Your vision cracks and splits into four narrow points that soon flow into one as your jaw stretches out and your face reforms in to the noble image of a draconic maw. Moments later, she forms her hand into spear and thrusts. At once, your vision explodes in a radiant sea of poly-chromatic light as your hungry cunt devours her hand all the way to the wrist. The doting monster mommy pistons her arm with surprising force and impossible gentleness as she pounds your enhanced new slit and strokes your plump knotted cock with a loving yet bestial rythm.";
						WaitLineBreak;
						say "     The air echoes the wet meaty thrum of her loving ministrations as your shifting sex hungrily cinches about her arm like it were some common toy. Waves of bliss ripple through your needy cunny as the potent tide of change surging through you reaches your feet as they expand outward into sturdy, webbed, clawed versions of themselves. Strangely pleased by the sensation of feral might flowing into them, you can't help digging your talons into the soft sand as the ground seems to slip away from you while your claws grow ever larger still. A brief tendril of primeval fear slithers across the surface of mind at this sudden development, yet this unbidden sensation of vertigo leaves you just as quickly as it arrives. In its place, is a rush of unbound strength and purpose flooding your limbs in a squall of transformative euphoria fueled by every potent suckle of transformative cream gracing your maw and each beatific caress of your draconic cock and cunt.";
						say "     Basking in the whirl of sensation cascading through you, you barely even notice your lower half stretching behind you as your flesh reshapes itself into a new exotic bend. A pair of slender, webbed, draconic forelimbs begin to form at your waist and your torso starts to lengthen while your flanks flare out like some beast waiting to be bred. Pressure builds along the berth of its terminus as the scales bulge then part as a finned serpentine tail erupts from your hind end and, without even thinking, the new limb coils about legs like a loving pet. Your altered sex seems to drift away from Galaxite's loving touch towards your rear like a flotsam caught in an undertow, only to be met by the loving caress of your newly-forged tail, as the lively limb simmers about the rim of your draconic sexes. Unerringly smooth and seemingly coated in a rich sheen of natural lubricants, the girthy limb roils about the lust-swollen lips of your sex in a heady waltz of eclectic sensation as it entwines itself about the sleek contour of [cock size desc of player] dick.";
						WaitLineBreak;
						say "     Your twisting mind gushes at the raw tactile bliss and sudden sense of freedom coursing through you at the sensation of the prehensile appendage coiling about your supple cock and lustful petals. While your proud knotted spire throbs delectably in the glossy folds of your tail, your shifting flesh narrows and tapers at tip with every dandle, slowly reshaping it into a proper draconic spear. While the base of your expansive tail reverently fondles your plush puddling [cunt size desc of player] cunt, your draconic muff gushes a slutty stream of balmy feminine honey down the length of your tail, mixing with your scales['] natural lubricant in an erotic toasty blend of reptilian arousal as you piston the prehensile appendage about ponderous tool. The respective tissue seems to resonate with your body's changes as rich tactile ridges and pleasure grooves form along the underside of wyrm-like cock as it strains against your coils and loving caress of your sail-like fins.";
						say "     You feel your lower half swaying in tune with each artful frictionless strokes of your tail while you pamper your liminal sexes. Your hands are free to revel in the maternal majesty of your hybrid tauric form as you lewdly massage your bountiful curves with your paws, delighting in the heft of your fecund core and the virile mass of your flush balls that pairs delectably with the constant rush of beatific cream serenading your shifting palette. Your tongue flexes and expands with each greedy suckle, taking on a serpentine bend as the tip bifurcates into two sharp opposable forks. Rumbling contentedly at this development, you dutifully treat your squirming morsel's perky nips to a show of proper draconic affection as you coil their edges as you playfully tweak the stiff contour of her milk spouts.";
						WaitLineBreak;
						say "     The eager monster mommy shivers ever-so-slightly at their touch as a cute submissive whine escaping from her lips as her flow increases to better match your growing hunger. 'Good girl,' she coos as her hands drift to the warm soft bulge of your well-bred middle, caressing the taut gleaming alabaster lamina with her soothing touch. A part of you almost swears you can feel the slight tickle of static arching from her fingertips as she gleefully pampers your burgeoning bump as your scales stretch to accommodate her boundless offering. A sense of profound fullness builds in your liminal being as the roiling elysium simmering about your well-fed core and puddling cunt washes over you in erotic squall. Your changing body practically sings in reptilian rapture as an all-too-familiar tightness cascades through you as the dual delights blend together in a hedonic symphony of primeval lust.";
						say "     Your cunt muscles clench along the exotic ridges and sleek valleys of your tail with every euphoric pump of your seventh limb, while your cock thrums in an electric rhythm all its own as your ripe cum vein strains the slick furrows of your tail. A heavenly pressure and heat arcs through your flanks like lighting playing on a ship's hull. Your balls twitch and groan an eager tattoo as you finish with a ground-shaking roar over the generous gush of feminine juice leaking from your puddling snatch and dripping down the sleek contours of your rear legs, followed by the unsubtle eruption of your draconic spire as a potent stream of pearly virility bastes the parched sand in a potent silver veneer of molten desire. Delightfully spent, you roll off the tiny monster breeder, licking the last little beads of cream from your lips and languidly slip your tail free of your tauric cock and cunt with a theatrical flourish. You roll into your back beside the little post-human, and cast an appreciative down at exotic form, though it might just the lingering effects of nanites playing tricks on your sensibilities.";
						WaitLineBreak;
						say "     Your lust-fogged mind still revels at the sight of your tauric majesty as your eyes wallow along the sensual swell of your scaly breasts. You can't resist cupping the ripened orbs in your webbed paw-like hands, shamelessly admiring both their weight and beautiful oily smooth scales ,coddling them in your padded palms as you pamper the tender tissue. Already, you can feel an erotic tautness spreading through the heavy glands while they prepare themselves for your coming brood. Far from off-putting though, your breeding-focused mind basks in the profound sense of maternal purpose sparking about the ecstatic tissue as it spills through the oily gaps between your fingers. A part of you can't wait to put these wonderful cock pillows to work, or perhaps sampling their ample fare in the future. You muse, shifting your attention to the resplendent swell of your tauric bump. Your anthro tummy is jeweled in a toughened ring of gleaming azure scales and accented by a tasteful patch of lustrous white. Denser than any platemail, yet unearthly malleable and smoother than the finest silks, your scales perfectly compliment your tauric physique as you lovingly rub your many paws along their sleek decently-lubed surfaces.";
						say "     Indulging your senses in the fecund splendor of your exotic futa form as your eyes drift along your pearly lower half and the virile impression of your chubbed cock nestled neatly between the bountiful swell of your bestial belly and the heavy mass of your bloated cum tanks. You take no small amount of pride in knowing that your brood will not only be protected by your scales, but be spread far and wide with the aid of this dominant tauric physique. Vaguely serpentine in build, your length hydrodynamic lower body reminds you of the feral sea dragons dwelling along the coast, though unlike the stocky bloated leviathans trawling the depths, yours is far subtler and ergonomic in design, yet no less deadly, you note, tracing a talon over the sturdy glassy surface of your egg-laden underbelly.";
						WaitLineBreak; [Changes stop here for the most part]
						say "     Your legs too appear to be better adapted for terrestrial travel as your sleek digitigrade limbs possess none of the awkwardness that you've seen on the bestial sea dragons. Instead, they would look more at home on a Yamato or a wyvern than a waterbound wyrm, though they are no less imposing. You muse, experimentally running your paws along the toned lubed contours of your animalistic half. Basking internally at succulent weight of your eggs pressing against your masculine g-spot as gestating orbs swell with unbound potential, you catch sight of your regal draconic visage, reflecting in the mirror-like surface of your forepaw's talons as your loving massage the fertile curves of your lower body. Tilting your head for a better view, you note your sleek triangular muzzle bares a passing resemblance to the local Feral Sea Dragoness.";
						say "     Though you have a light-blue spined sail down the length of your spine, ringed by a pair of modest swept back onyx horns, alongside a dense layer of jagged toughed scales fortifying your jaw, that is where the similarities seem to end. Your eyes have divided into four verdant glowing gold angular eyes, bereft of irises, the exotic orbs impart an enticing mix of alien abyssal beauty and menace to your appearance which is only enhanced by the tendril-esque hair draped down the back of your head to your [']waist[']. Trying to flex them, your first attempts are rather clumsy as you barely get them to wiggle, yet with each tiny motion, your control grows as feeling spreads to the appendages. Given enough time, you're certain that your mastery over the wonderful accents will improve, you muse, shifting your attention back to your other half, admiring both the beautiful serpentine build of your tauric portion and its lustrous royal navy blue scales lining your resplendent form.";
						WaitLineBreak;
						say "     You soon spot an unusual series of breaks in the brilliant blue coating your flanks, as the azure gives way to swirls of orange that bleed into metallic magentas then fade away to muted ebony hues. Curious, you focus your senses on these patches and the changes seem to slow then settle in place. Your interest piqued, you further flex your mental muscles trying to bend these chromatophores to your will. Though taxing, the colors soon shift to neutral white streaks, perhaps with practice you'll be able to exert proper control over them and maybe even find martial use for them. As you think to yourself, a muted polite cough from Galaxite snaps you back to reality. '*Ahem* I see the mighty Kai Monah is enjoying hir gift,' she preens in a delighted airy trill, though she does little to disguise the envious look creeping along the edges of her face as she kneels before your well-bred being. Ignoring her sour expression, you smirk at the sight of the tiny woman's attempt at a show of proper deference to your majestic form, and magnanimously rumble your appreciation to the lowly creature for bestowing you with such a powerful body."; [Kai Monah = Ocean/Sea Mother]
						say "     'Thank you, great wyrm maker, zun zu'ul nun reh-ol reck da han kovve nuthi. May this form serve you well,' your lesser intones, touching her forehead to the sand. Nodding, you bid her rise, informing her that that remains to be seen and that you still need to put this body through its paces. 'Then oh beautiful one,' she simpers in reverence as she returns to a kneeling position, 'if this lowly ape may be so bold as to make a request of your perfection, perhaps acquiring the gill fruits guarded by the insipid bats infesting the Ruined Trawler down south would make fine test for your majesty. Should you deem this trivial task worthy of your attention, I can promise you plunder and power befiting a true dragoness in exchange for this paltry boon,' Galaxite coos, bowing her head before you and clasping her hand over her heart as if in silent prayer. Chuckling, you idly flex your talons before her, reveling in the light that seems to play across their reflective edges as you tell her that you might, though there are other matters that require your attention after all."; [zun zu'ul nun reh-ol reck da han kovve nuthi means but I only do as she of five heads commands. Meaning she's did this because her patron goddess said so, not because she wants to.]
						WaitLineBreak;
						say "     'Of course honored dragon, I wouldn't dream of commanding you, though should you choose to humor this pathetic mortal's request I have one final gift that could aid you.' She hums, reaching behind herself then pulls her backpack forwards. Setting it between you, Galaxite hurriedly unzips the middle flap, reaches in, and pulls out a large lustrous pearl wrapped in a long strip of black silk. 'Here noble wyrm, this pearl was blessed by my beloved sons the Ullokinne and Naxokaazthur, or Immortal Sky Masters and Cruel Sea Tyrants if you prefer. Carry it, and it will protect your divine form from the corruption of this place,' she dotes, lifting the pearl above her head in offering. Gazing at it, you find yourself feeling oddly drawn to the beautiful bobble as an aurora of blue, red, black, green, white hues dance upon its warm off-yellow surface. You feel covetous energy building in your core at the thought of this weak liminal creature holding such a treasure. Such a prize deserves to kept in a proper wyrm's hoard, not stowed away in a cheap backpack like some dingy bottle of dirty water.";
						say "     You muse upon this, carefully plucking the pearl from her outstretched arms and hold it close for inspection. You can't help but remark internally at how right the peerless smoothness feels nestled in the palm of your hand and the beautiful glow of the divine trinket reflected in your eyes. To think that this mewling human kept this to herself, your altered-mind rages as hurriedly stow it away from prying eyes, lest some jealous manlet dare snatch it from you. 'I see you approve of my offering great wyrm,' Galaxite chuckles through a far-too-knowing grin. Nodding, you inform her that it will do, for now, though she should not assume such a pathetic tithe will buy your loyalty or submission. 'Oh, of course not mighty one!' She kowtows, with another deep quick bow. 'That tiny pebble is a gift barely befitting your growing majesty, though you may find it useful nonetheless,' she preens, eyeing your expectant middles with obvious delight. Enjoying the sight of her subservience and a just hair curious about what she means, you demand she explain further.";
						WaitLineBreak;
						say "     'I do not wish to bore your magnificence with trivial details, but suffice to say that pearl is impregnated with a fragment of my children's power,' she says, her lips curling into a proud reptile-like grin as she tenderly rubs her hand along the bountiful curves of her egg-laden middle. 'Though potent, it lacked both a focus and a vessel worthy of its gifts,' she says as the flicker of a jealous sneer flutters along the edge of her lips. 'Until now Kai Monah, you alone are worthy to bear this tiny sliver of its blessing,' she intones, motioning to your gravid body with a languid wave of her left hand. 'However, your current form is but a pale shadow of the true majesty you could achieve. Help me scale sister, and you could be greater than any chromatic dragon of Kyr, Kai, or Kol. Just picture it my thuri,' she coos, draping her arms along the flush core of your expectant form. The familiar pulse of otherworldly energy arcs from her fingertips as she nuzzles her face against the bountiful swell of your clutch-laden tum. 'You could be the mother and father god of untolds hoards of true wyrms, all of them at your beck and call.'";
						say "     'You need never fear the doom of man, or know the bite of time. You will be worshiped, perfect, and eternal reh-ol reck da han kovve nuthi,' the eager demi-human whispers, as her words coil at the edges of your mind as you find yourself repeating the phrase. Reh-ol reck da han kovve nuthi, in a dream tenor, your stomachs swells ever-so-slightly at her touch as the life growing within you resonates with the essence of change flowing through you as hard protective shells grow over their nascent beings. Strangely though, as you run your paws over their resplendent forms, you feel neither fear nor alarm at this development, only pride at thought of birthing majestic creatures. 'Ah, how I envy you thuri, to have such potential growing within you,' Galaxite swoons, tracing her fingers along the taut curves of your lower half.";
						WaitLineBreak;
						say "     'But for now Kai Monah, rest easy, you are safe by the water edges. When you are ready, seek out the Wild Fringes [bold type]to the south[roman type], defeat the lowly mice nesting in its hull,' she purrs in loving melodic trill as lightning crackles along the borders of your scales in an enthralling waltz of blues, greens, black, reds, and whites. 'When the way is clear, you need only roar [italic type]Naxokaazthur, naal faal hen klov gein los hi bel[roman type], to call my children to your side,' she whispers, as the colors bleed and twist into one another in a vibrant whirlpool of many colors and none. You stare helplessly transfixed by the sight as a sense of weary peace coils about the liminal facets of your mind like the warm inviting waves of some primeval sea. 'Reen Han Na,' Galaxite intones in clear airy cadence as your eyes begin to grow heavy as your consciousness sinks its balmy shadowy depths, 'reh-ol reck da han kovve nuthi.' Reh-ol reck da han kovve nuthi, you reply as dark the water closes over you and all grows quiet."; [Stupid dragon noises to slightly less stupid human dribble: Rest Dream Serve as the fived headed one commands.]
						say "     [italic type]An indeterminate amount of time later[roman type], you begin to stir as the dark tide cradling your altered form recedes, washing all traces of fatigue and deprivation from your draconic being. In its place is a rush of maternal purpose and voracious energy as your body thrums with the lingering touch of the strange monster girl. Though she seems long gone, her lofty promise still echoes in your mind, as you feel a subtle slithering pressure tugging at the back of your psyche, urging you to seek out the Wild Fringes, to ascend with all haste. Yet, its call grows weaker with each passing moment as your more rational side begins to assert itself and cautions you against further dealings with Galaxite. Who knows what she has planned for you, perhaps it would be best to rid yourself of this form and move on. Still as you gaze appreciatively at your regal draconic figure, you find it hard to push aside her words so casually. If the glorious body is truly but a shadow of its full potential, then wouldn't you be a fool to spurn her gift so flippantly?";
						WaitLineBreak;
						say "     After all you did save her life, you muse, flexing your talons before you, delighting in the sensation of primal might coursing through you, waiting to be unleashed on the lowly scaleless creaturing infesting the city. Already, you feel stronger than ever, imagine heights you could achieve with your full potential unlocked! Even the vaunted wyverns and sea dragons of this place would be forced to kneel before you and your brood's majesty, a coiling intrusive voice urges as your eyes drift to the supple curves of your egg-laden middle. You feel a wicked smirk growing on your thin reptile lips at the thought of whelping your own flight of draconic servants. Yes, you rumble under your breath, perhaps you humor the little ape for a spell, at least until you take what you need from her. Perhaps when you're done with her, she makes a nice plaything for your brood, you ruminate, running your paws over the lovely outlines of [bold type]your[roman type] eggs. For now though, you decide to head back to beach plaza and plan your next move.";
						turn the Player into a "Dragon Breeder";
						choose a row with Name of "Dragon Breeder" in Table of Random Critters;
						StatChange "Dexterity" by 3;
						StatChange "Strength" by 3;
						StatChange "Stamina" by 3;
						if Breast size of Player >= 1:
							increase Breast Size of Player by 4;
						if Breast size of Player is 0:
							increase Breast size of Player by 5;
						increase Cunt Depth of Player by 10;
						increase cock length of Player by 10;
						if ball size of Player <= 4:
							increase ball size of Player by 3;
						ItemGain Dragon Pearl by 1;
						if "Flash" is not listed in Feats of Player:
							FeatGain "Flash";
						If "Breeding True" is listed in Feats of Player:
							FeatLoss "Breeding True";
						if "They Have Your Eyes" is not listed in Feats of Player:
							FeatGain "They Have Your Eyes";
						if "Flat Chested" is listed in Feats of Player:
							FeatLoss "Flat Chested";
						if "Toughened" is not listed in Feats of Player:
							FeatGain "Toughened";
						now Energy of Galaxite is 1;
						PlayerEat 100;
						PlayerDrink 100;
						increase XP of Player by 250;
						decrease gestation of child by a random number from 10 to 15;
						if gestation of child < 1, now gestation of Child is 1;
						now Beach Reunion is resolved;
					else:
						say "'But I *ugh*,' Galaxite grunts with an almost pained look on her face as a sudden tremor passes through her taut bronze tum,' think the little ones are going to be ready soon.'*Up*, yup they definitely want out. *Huff-huff* so *uf* I'm going to go *huff* find a nice quiet spot somewhere. Just *wheeze* remember when you find the stuff shout. *Ah* Nax-, *huff* Okaaz-, ouch, Thur naal hin monah's zul los hin bel from someplace high,' Galaxite pants as she struggles to her feet and hurriedly grabs her stuff. She waddles off to the rocky cliffs cradling her squirming belly as a trickle of clear fluid drips down her legs. With nothing left to do here, you shrug and decide to head back to the plaza to plan your trip to the [bold type]Ruined Trawler[roman type].";
						now Beach Reunion is resolved;
						now Ruined Trawler is active;
						now Stamina of Galaxite is 1;
			-- "Silence Thot!": [and find out]
					say "     In no mood for this trollop's games, you inform her that while you're willing to assist her in plundering the city, you have no interest in the whorish sow. Going forward, you expect her to not only be professional, but keep the moldy bag of cottage cheese she calls her udders and her soon-to-be meat curtain away from you. If she can't handle keeping her scalie claptrap together, then you're going to walk, and she can go back to slutting it with whatever feral inbred drakes get caught in her fly trap of a cunt till the cows come home for all you care. '*Hrump* fine,' Galaxite huffs, crossing her arms over the tumorous masses some might mistake for tits, 'fu-, er flipping prude be that way, I'll behave, I guess.' Good, you're glad you two came to an understanding. 'Ya-ya,' she pouts in a bored machinal cadence as she tightly crosses her legs, 'just head down south along the Wild Fringes till you hit the [bold Type]Ruined Trawler[roman type], beat up anyone you find, and,' she says, her tone brightening ever-so-slightly as a devilish grin blooms on lips.";
					say "     'Get up somewhere nice and high, then yell,' Galaxite pauses to take deep breaths and roars. 'Nax-,' and pain like the uncaring bite of the lash scores your flesh as burning welts ripple across your body. 'Okaaz-,' she shouts, as cold floods your limbs and air forced from your lungs as you feel yourself being pulled by wrists to the sands by unseen chains. Though you try to rise, weight and pressure press down around your neck like an anchor as the foul stench of ancient decay roils across your senses and frostburn licks at your extremities. You feel yourself sinking into sands as your flesh cracks, blackens, and dies as the killing seeps into you. 'Thur!' She bellows while your throat constricts, and the scent of rotten abyssal meat tears senses as fall to your knees before her gasp for a breath which will not come. Hel-, you croak in desperation as the bit of air in your lungs peters from your lips. 'I'm sorry, what was kin da mun?' The spiteful siren crows, through a pitiless smile as you wildly claw at your neck. Help me, you mouth, as your sight narrows and dark tendrils of shadowy nothingness crawl along the edges of your awareness like hagfish burrowing through long dead meat.";
					WaitLineBreak;
					say "     'Of course, little mouse,' she purrs with an unnatural sweetness as she kneels beside and hooks a nail to your chin. She forces your eyes to meet, whispering, 'naal hin monah's zul los hin bel,' and the pain leaves you. In its place comes a gentle wave of verdant warmth, as the color returns to frostbite limbs and sweet clean air fills your lungs. 'Remember these words well little mouse, and my boys will handle the rest, got it [bold type]DURRAN SlAN!?[roman type]' The mad monster girl growls in a deep throaty primeval rasp as all warmth and humanity drains from voices as her nail digs into your palate. 'Or do you need me to repeat myself?' Galaxite menaces, gazing down at your stricken form with obvious amusement. No, that won't be necessary, you cough, as a rush of coppery spittle gushes from underneath your tongue as the world spins on impossibly crooked vertices. 'Good little mousy, I [bold type]HATE[roman type],' she rumbles, lips curling in spiteful grimace, 'repeating myself, now off you trot.' she sneers through her nose as she dismisses with a haught wave of her hand. Not wanting to push you luck, you do as you told and scurry off before she can do whatever the hell that was again."; [Dragon to poopy human: durran slan = cursed flesh]
					now Beach Reunion is resolved;
					now Ruined Trawler is active;
					now Loyalty of Galaxite is 1;
					now Stamina of Galaxite is 1;


Table of GameEventIDs (continued)
Object	Name
Ruined Trawler	"Ruined Trawler"

Ruined Trawler is a situation.
ResolveFunction of Ruined Trawler is "[ResolveEvent Ruined_Trawler]". It is inactive.
Sarea of Ruined Trawler is "Beach".

to say ResolveEvent Ruined_Trawler:
	say "     Following Galaxite's directions, you boldly set off towards the Wild Fringes, strewn with trash, driftwood, and jagged rocks. The area definitely lives up to its name. More than once, you have to stop yourself from accidentally stepping on some rusty algae-encrusted syringe or slipping on a tangle of horrid smelling sun-baked eelgrass. Under other circumstances, you might have been tempted to embrace your inner Susan and complain to the people in the coastal management program, if they even still exist. At least, you take some solace in the fact that the vile state of the area is probably keeping the locals away. Otherwise, you doubt that this alleged Gill Fruit Tree would still be left standing. Such a thing, if real, would no doubt make a fine prize in the world outside the city. You can easily see many countries and corporations clamoring over access to something that could give people the ability to breathe underwater without compromising their humanity."; [Author's Note: a Susan is what we used to a call a Karen here in 2008.]
	say "     Heck, you might even hang on to one, it could make a great nest egg for when you get older. Especially if you could cultivate it, why, you'd be set for life, you muse as you trek along the rough coastline. Though your path, if you could call it that, gets worse and worse as the place steadily devolves into a fetid rat's nest of sharp barnacle-encrusted sandstone mounds impeding your path and heavily-polluted urchin-infested tidepools clustered about the shore, forcing you to carefully wade through the off-smelling waters lest you stab your feet on their wicked-looking spikes, or trip on the moldering medical waste blighting them. You briefly consider trying to scale the nearby hills, but you're not too sure that you'd be able to get back down in a reasonable manner. As the farther you look south along the coast, the higher and craggier the rock face gets. Besides, Galaxite's directions were pretty clear [']keep going along the shore till you find it[']. How long could it really take, you wonder, cresting yet another flotsam ridden sand dune on your search.";
	WaitLineBreak;
	say "     [bold type]An indeterminate amount of time later,[roman type] and you're starting to feel like you're on a freaking snipe hunt. Everything is starting to look the same and you're almost ready to turn around then give that over-bronzed bimbo a piece of your mind. All you've found these last few minutes are new and imaginative ways to get tetanus or lockjaw, but no boat, or tree, you muse, peering down the coast at a large pile of rubble about the size of a modest two house that's fallen over a huge section of the sandbar blocking your view downspin. Gazing at this latest impediment with a growing sense of aggravation, you decide that this will be the last stupid obstacle that you're going to climb. If that damn wreck is not on the other side, you are so done! You think to yourself as you slowly pick your wall of rock and driftwood. As you at last pull yourself over the edge of the loosely-packed debris, you let out a low pleased whistle as you're finally greeted by the sight of your search.";
	say "     Roughly wedged between a formation of pale wave-polished chert, the ruined trawler looks like it's been here for a very long time. Its timbers are almost completely bare and sun-bleached with only a few hints of white and black paint remaining along the dilapidated wheelhouse. Its keel, along with the lower deck, have mostly collapsed under the weight of the frame and the large gill fruit growing out the poop deck. Partially submerged by the waves, the massive piece of flora looming over the wreck reminds you of a mix of a Strangler Fig, Rainbow Eucalyptus, and Banyan tree, at least with the way kaleidoscopic roots have grown around the wheel house and taken much of the processing area. While the odd slitted fruits growing on its many branches, are a rather otherworldly sight. Offhandedly, a part of you wonders where it could have come from. Could it be a result of the nanites messing with the seeds of some long dormant species? A mutation of the Awesome Fruit Tree that somehow found its way to the shore?";
	WaitLineBreak;
	say "     Or perhaps, it's something that got transported here in the gut of one of the fantastical creatures that have shown up after the nanites were released? Shrugging, you realize you may never know, and even if you did, it wouldn't change anything. You look around the rear of the wreck and spy the other item of your search, the still intact remains of the boat nets and lines lazily floating in the surf behind it. It shouldn't be too hard to reel those in, you opine, picking your way down the rubble. Only when your [BodyName of Player] feet hit the sand though, do you remember, a bit too late, Galaxite's warning about the place being home to some Fruit Bats. As a rustling din from what's left of the trawler's lower deck catches your attention, eight Fruit bats swarm out of the rents in the hull. They look at you in unison and screech bloody murder at your intrusion then take to the air.";
	say "     They circle, swoop, and pelt you with rocks like an angry flock of ravens trying to drive off a hawk till one drops low and lands in front of you, yelling, 'This tree belongs to the Zee Batz outsider! Leave now!' as it flaps its wings wildly before you in a base effort to look larger and more intimidating. Thinking on your feet, you wonder if you should take them up on their offer. Fruit bats aren't the toughest things out there, but there are alot them. Something also tells you they won't fight fair if you try to take them all on[if strength of Player > 25]. Then again, you're one tough son of a gun! Maybe you should enlighten them to this fact before [italic type]THEY[roman type] get themselves hurt[end if].";
	LineBreak;
	say "     [italic type]What would you like to do? Note: fleeing or submitting fails this quest and removes Galaxite from the game. There is no special content to be viewed or rewards to be gained if you do so.[roman type]";
	LineBreak;
	let Win_all_or_loss_all_Choices be a list of text;
	add "Flee!" to Win_all_or_loss_all_Choices;
	add "Fight them!" to Win_all_or_loss_all_Choices;
	if Strength of Player > 25:
		add "SMASH PUNY BAT THING!" to Win_all_or_loss_all_Choices;
	let Win_all_or_loss_all_Choice be what the player chooses from Win_all_or_loss_all_Choices;
	if Win_all_or_loss_all_Choice is:
		-- "Flee!":
			say "     Oh fuck this, you are not fighting this lot of nutters! Your mind blares as you scramble back up the rubble wall in an effort to get away from these angry rats with wings. You sprint back down and run back to the beach with your tail tucked between your legs. All the while, you hear the flapping of leathery wings and the cruel jeers of Fruit bats as they harry your every step. They pelt you with rocks and rotten wood everytime you dare to slow down. Only when you arrive back at the beach a tad bruised, a bit battered, but alive do they finally leave you alone.";
			now Ruined Trawler is resolved;
		-- "Fight them!":
			say "     Shaking your head at the bat swarm, you tell them you've come too far to leave empty handed. You raise your[if weapon object of Player is journal]fists[else]weapon[end if] and prepare to fight!";
			say "[ZeeBatFight]";
		-- "SMASH PUNY BAT THING!":
			say "     Undeterred by their weak attempt at intimidation, you calmly punch one of the nearby sandstone chucks comprising the rocky wall behind you, utterly obliterate it in a single hit, saying. Sorry, hand slipped, now what were they saying? All this muscles make it hard to hear sometimes. As the particles swirl about the creature's head, the once bold bat eyes go wide as the reality of what he's facing sets in. 'Uh, on second thought, you can have the tree,' it screeches and takes to the air, yelling at its peers to run. Their morale shattered, they do just that and zip off to parts unknown.";
			say "[MeetingTheDergs]";


to say ZeeBatFight:
	let GroupFightCounter be 0;
	now fightoutcome is 0; [reset]
	while fightoutcome < 20 and GroupFightCounter < 8: [runs for 8 times or until the player loses or flees]
		now inasituation is true;
		if fightoutcome < 20 and GroupFightCounter < 8:
			say "     Staggering from your last blow, the belligerent feral looses an ear-splitting screech as it takes to the air in panicked pained flutter. Though it's barely able to stay aloft, the remaining gnats swarm around you hurling vollys of heavy jagged rocks and shaprend bits of flotsam directly at your head as another rushes in to take its place.";
		PlayerWounded 40;
		challenge "Fruit Bat";
		increase GroupFightCounter by 1;
		now inasituation is false; [reset]
	if fightoutcome >= 10 and fightoutcome <= 19 and GroupFightCounter is 8:
		say "[BatFightVictory]";
	else if fightoutcome >= 20 and fightoutcome <= 29:
		say "[BatFightLose]";
	else if fightoutcome >= 30:
		say "[BatFightFlee]";

to say BatFightVictory:
	say "     Reeling from your last brutal blow, the last Fruit Bat staggers back looking for his reinforcements. When all he sees are the battered forms of his comrades strewn about the sand, a frightful look grows on his furry face as he yells, 'Retreat,' and takes to the air. The others groan in reply and take to the air, albeit rather awkwardly. Their injured bodies are barely capable of flight, much less keeping a consistent altitude. They soar and fall like young birds caught in a tropical storm as they limp towards the nearby hills. Still, you keep an eye on them for a few minutes, as a part of you wouldn't put it past them to try something funny as a last ditch chance for revenge once your back is turned. When nothing happens, you at last turn your attention back to the trawler.";
	now Hunger of Galaxite is 1;
	say "[MeetingTheDergs]";

to say BatFightFlee:
	say "     Sensing the tide of battle turn against you, you rush for the rubble wall. Quickly scrambling up the rock pile, you sprint back down the otherside then make a break for the wild fringes. Lucky for you, the bats don't appear that interested in pursuing you in earnest. Appearing content with the whipping that they gave you, the swarm merely follows you from a distance for a short way then they seem to give up. You're not sure why they could have easily caught you at any time. A part you guess they just wanted to keep their tree safe, or perhaps they think you're a diversion. Either way it doesn't matter, you failed in your quest. ";
	if "Touched by Madness" is listed in Feats of Player:
		say "Your only choice now is to undo, reload, or persist in this doomed timeline you have created.";
	now Ruined Trawler is resolved;

to say BatFightLose:
	say "     Succumbing to the bat's combined assault, you collapse before them. As you lay there beaten and battered, four of the angry ferals leap upon your weakened form. Each one grabs hold of one of your limbs then takes to the sky [if scalevalue of Player <= 3]with only a light struggle on their part[else]with pronounced difficulty due to your above average size[end if]. 'Think we should drop them on the rocks? Their corpse could serve as a nice warning the next time someone comes around,' one of the bats carrying you asks aloud. 'Nah, then we'd smell them rotting for the next few weeks,' another bat replies. 'How about throwing them to pirate sharks then? They might like a new plaything,' a third back says as they sails over the shallow bay. 'Ha now that's a thought! Hey asshole, how do you feel about having your poop deck swabbed by a bunch of pent up double-dicked shark herms?' one of the bats carrying your legs jeers as they circle over the rocky arch. Before you can respond though, the mutants let go of you. All you can do is scream as you plummet to the water, accompanied by the roar of the bat's laughter. The fall though is at least mercifully short and thankful you hit a rock free section of the bay with a loud splash.";
	say "     Completely unable to move your limbs from the pain of the impact of your nasty belly flop, for a moment all you can do is float there in a mild state of shock. Soon enough, you nanites kick into action as they set about repairing the worst of the damage. In no time, the feeling returns to your extremities and you swim back towards shore. Just in time, you realize, as the silhouettes of several shark fins break the surface of the surface then race towards you. In no state to fight, you push yourself harder. With every stroke, your chest burns, heart pounds like it were about to burst, from the combined effect of shock and the lingering effects of the fall. Still though, you force yourself onward and only allow once you've safely hauled yourself back to shore. Do you at last allow yourself the luxury of passing out.";
	if "Touched by Madness" is listed in Feats of Player:
		say "Your only choice now is to undo, reload, or persist in this doomed timeline you have created.";
	now Ruined Trawler is resolved;

to say MeetingTheDergs:
	say "     With the area now clear, you clamber aboard what's left of the trawler and gingerly climb the great Gill Fruit tree. Recalling what Galaxite said about how the moment one fruit is picked, the tree will drop all its fruits and anything that hits the ground or water will instantly rot. You select one of the larger low hanging bushels of six fruits near the stern of the stricken vessel and make a grab for it. Sure as shooting, the instant the stem breaks an eerie creak passes through the trunk of the tree wood blackens and dozens of fruit fall like fetid rain around your. Just like she said, the moment they land each one hiss and rot on the spot in a vile plume of abyssal fumes, thankfully, you manage to grab a bushel of six fruits to show for your efforts. Stashing them away, you move onto the next phase of her plan and climb atop what is left of the wheelhouse and yell, Naxokaazthur! Naal hin monah's zul los hi bel! at the top of your lungs. Yet nothing happens, undeterred though, you shout again, Naxokaazthur! Naal hin monah's zul los hi bel!";
	WaitLineBreak;
	say "     The sea goes calm and placid akin to a tranquil blue-green mirror as the waves seem to halt in place, their furrows and edges perfectly captured in a mote of frozen time. To your eyes, they appear to have turned to serene polished obsidian as the shape of several bright serpentine forms shimmer along its glassy surface. Encouraged, you cry out one last time, Naxokaazthur! Naal hin monah's zul los hi bel! Spiderwebs of lustrous platinum light course through the still luminescent water as the abyssal shapes whorls beneath sea, then burst from the glassy water bellowing in hash guttural tones like the shearing of timber and crashing of rock, 'By the High Cant are we called! For her love! Do! We! Serve!' as six massive dragons surge forth from the depths and crawl onto the sandbar. Far larger than any wyvern or giant you've encountered to date, the titanic wyrms easily tower over the great Gill Fruit Tree as their mighty alabaster horns caress the clouds.";
	say "     You feel your mind reel and rebel at the sheer scale of the dragon brothers as their shuffling steps shake the dunes and weather-worn timbers of the trawler as water cascades over their rippling azure scales akin to ribbons of creamy jade. You find it hard to believe that the svelte monster girl could produce such titans so casually. Though such idle musing will have to wait as the assembled dragons crowd around you in a circle and a dozen blazing red eyes turn upon you. Seemingly unsure what to make of you, there looks equal parts curiosity and hunger, yet their expressions soften, at least your eyes. As they each dip their heads in an almost human-like bow, saying as one in a ductal brassy choir. 'What is her will, ";
	if Hunger of Galaxite is 0:
		say "kau a ko'u makuahine?' ";
	else:
		say "Qunaar?' ";
		say "You're instantly struck by both clarity of their speech, and the odd, almost alien, movement of their maws accompanying each word. As their imperial armor lips move with practiced draconic grace, you find it hard to believe such flawless speech could come so easily from the noble brother titans.";
	WaitLineBreak;
	say "     Doing your best to retain your composure, at the deafening roar of their voices, and surprise at their peerless diction, you hastily tell them Galaxite wants them to collect any intact line or nets for her plan. 'A trifling task ";
	if Hunger of Galaxite is 0:
		say "kin da mun,' ";
	else:
		say "Qunaar,' ";
	say "one of noble wyrms standing at their center rumbles in sharp articulate baritone cadences, 'but one we do gladly. Brothers!' the imperial dragon barks, turning to his kin loosing a roiling stream of bestial noises like the crashing of storm fronts or knell of icy waves. 'Geh zunmah!' the other wyrms rumble, as they surge forward and smash apart what's left of the booms and winches holding the lines together with their tails. With each bash you're showered with sea spray and splinters, not that the creatures care. They seem to delight in destruction although they are still careful to not damage the line or you for that matter. The rest of the boat along with the gill fruit tree are pulped to oblivion, you see now why their mother wanted to hold them back. If you hadn't been patient, they probably would have crushed just the boat to take out the bats, you opine, watching them awkwardly gather up the prize in their webbed paw-like hands.";[Note: Naxokaazthur speak in the 'deep spaces', meaning their language can not properly be heard above the waves, so the PC's brain is unable to hear it all. While the Yamato's speak in the 'High Cant' or definitely not Dovahzul which can only be heard on dry land. Qunaar = Challenger or The roar heard above the storm.]
	say "     A part of you wants to offer to help them out, but the prideful looks on their muzzles as they struggle to wind up the countless yards of algae covered cord, makes you hold your tongue. Feeling that it is best to leave them to it, you're about to take your leave when you remember the gill fruit in your inventory. Reasoning that Galaxite only needs one of them and that her kids can likely get them to her faster than you, you politely wave one of them over. Seeing your gesture, one of them bounds forward, its steps shaking the sandbar beneath you as the ground struggles to support the juvenile sea titan. 'Yes ";
	if Hunger of Galaxite is 0:
		say "kin da mun, ";
	else:
		say "Qunaar, ";
	say "what more do you ask?' the dragon says in a deep menacing voice as its hot fishy breath coils about you like an oppressive fog. Clearing your throat, you explain your request to it and present him one of the fruits. For a moment the sea dragon sits unmoving as it mulls over you, then rumbles, 'Mhh, a most prudent request,' as he snaps his teeth in an alien gesture of what you assume is acquiescence, 'it shall be done, ";
	if Hunger of Galaxite is 0:
		say "child of man.'";
	else if Hunger of Galaxite is 1:
		say "Challenger.'";
	WaitLineBreak;
	say "     As it levels its massive webbed paw before you, larger than even a behemoth's head, the regal wyrm's hand could easily crush a modern tank in its mitts, yet its touch is far gentle than you would expect from a creature its size or bearing as it plucks the fruit from your hand with its claws without issue. Clutching the prize lightly in its paw, the creature lumbers back to water, then silently slips beneath the waves without even making a splash or ripple as it disappears into the surf. Satisfied that you're no longer needed here, you decide to begin the long walk back to the beach. Aided by your knowledge of the area, you make good time compared to your initial trip. It's still a bit of a slog, but nothing you're not used to at this point. Soon enough, you eventually find your back to the beach proper without either fanfare or incident. Now you just need to find Galaxite again, or you could spend some time preparing for her [bold type]Break Water Heist[roman type] who knows what you'll face out there after all.";
	now Ruined Trawler is resolved;
	now Break water Heist is active;
	ItemGain Gill Fruit by 4;
	now Stamina of Galaxite is 2;



Table of GameEventIDs (continued)
Object	Name
Growing Wings	"Growing Wings"

Table of WalkInEvents (continued)
Priority	Name	EventObject	EventConditions	EventRoom	LastEncounterTurn	CoolDownTurns	EncounterPercentage
1	"Growing Wings"	Growing Wings	"[EventConditions_Growing_Wings]"	Wild Fringe	2500	2	100

to say EventConditions_Growing_Wings:
	if BodyName of player is "Dragon Breeder" and Player is pure and Player is female or Player is herm and Energy of Galaxite is 1:
		now CurrentWalkinEvent_ConditionsMet is true;

Growing Wings is a situation.
ResolveFunction of Growing Wings is "[ResolveEvent Growing_Wings]".
Sarea of Growing Wings is "Nowhere".

to say ResolveEvent Growing_Wings:
	say "     Following Galaxite's directions, you boldly set off towards the Wild Fringes, strewn with trash, driftwood, and jagged rocks. The area definitely lives up to its name. More than once, you have to stop yourself from accidentally stepping on some rusty algae-encrusted syringe or slipping on a tangle of horrid smelling sun-baked eelgrass. Under other circumstances, you might have been tempted to embrace your inner Susan and complain to the people in the coastal management program, if they even still exist. At least, you take some solace in the fact that the vile state of the area is probably keeping the locals away. Otherwise, you doubt that this alleged Gill Fruit Tree would still be left standing. Such a thing, if real, would no doubt make a fine prize in the world outside the city. You can easily see many countries and corporations clamoring over access to something that could give people the ability to breathe underwater without compromising their humanity."; [Author's Note: a Susan is what we used to a call a Karen here in 2008.]
	say "     Heck, you might even hang on to one, it could make a great nest egg for when you get older. Especially if you could cultivate it, why, you'd be set for life, you muse as you trek along the rough coastline. Though your path, if you could call it that, gets worse and worse as the place steadily devolves into a fetid rat's nest of sharp barnacle-encrusted sandstone mounds impeding your path and heavily-polluted urchin-infested tidepools clustered about the shore, forcing you to carefully wade through the off-smelling waters lest you stab your feet on their wicked-looking spikes, or trip on the moldering medical waste blighting them. You briefly consider trying to scale the nearby hills, but you're not too sure that you'd be able to get back down in a reasonable manner. As the farther you look south along the coast, the higher and craggier the rock face gets. Besides, Galaxite's directions were pretty clear [']keep going along the shore till you find it[']. How long could it really take, you wonder, cresting yet another flotsam ridden sand dune on your search.";
	WaitLineBreak;
	say "     [bold type]An indeterminate amount of time later,[roman type] and you're starting to feel like you're on a freaking snipe hunt. Everything is starting to look the same and you're almost ready to turn around then give that over-bronzed bimbo a piece of your mind. All you've found these last few minutes are new and imaginative ways to get tetanus or lockjaw, but no boat, or tree, you muse, peering down the coast at a large pile of rubble about the size of a modest two house that's fallen over a huge section of the sandbar blocking your view downspin. Gazing at this latest impediment with a growing sense of aggravation, you decide that this will be the last stupid obstacle that you're going to climb. If that damn wreck is not on the other side, you are so done! You think to yourself as you slowly pick your wall of rock and driftwood. As you at last pull yourself over the edge of the loosely-packed debris, you let out a low pleased whistle as you're finally greeted by the sight of your search.";
	say "     Roughly wedged between a formation of pale wave-polished chert, the ruined trawler looks like it's been here for a very long time. Its timbers are almost completely bare and sun-bleached with only a few hints of white and black paint remaining along the dilapidated wheelhouse. Its keel, along with the lower deck, have mostly collapsed under the weight of the frame and the large gill fruit growing out the poop deck. Partially submerged by the waves, the massive piece of flora looming over the wreck reminds you of a mix of a Strangler Fig, Rainbow Eucalyptus, and Banyan tree, at least with the way kaleidoscopic roots have grown around the wheel house and taken much of the processing area. While the odd slitted fruits growing on its many branches, are a rather otherworldly sight. Offhandedly, a part of you wonders where it could have come from. Could it be a result of the nanites messing with the seeds of some long dormant species? A mutation of the Awesome Fruit Tree that somehow found its way to the shore?";
	WaitLineBreak;
	say "     Or perhaps, it's something that got transported here in the gut of one of the fantastical creatures that have shown up after the nanites were released? Shrugging, you realize you may never know, and even if you did, it wouldn't change anything. You look around the rear of the wreck and spy the other item of your search, the still intact remains of the boat nets and lines lazily floating in the surf behind it. It shouldn't be too hard to reel those in, you opine, picking your way down the rubble. Only when your [BodyName of Player] feet hit the sand though, do you remember, a bit too late, Galaxite's warning about the place being home to some Fruit Bats. As a rustling din from what's left of the trawler's lower deck catches your attention, eight Fruit bats swarm out of the rents in the hull. They look at you in unison and screech bloody murder at your intrusion then take to the air.";
	say "     They circle, swoop, and pelt you with rocks like an angry flock of ravens trying to drive off a hawk till one drops low and lands in front of you, yelling, 'This tree belongs to the Zee Batz outsider! Leave now!' as it flaps its wings wildly before you in a base effort to look larger and more intimidating. Thinking on your feet, you wonder if you should take them up on their offer. Fruit bats aren't the toughest things out there, but there are alot them. Something also tells you they won't fight fair if you try to take them all on[if strength of Player > 25]. Then again, you're one tough son of a gun! Maybe you should enlighten them to this fact before [italic type]THEY[roman type] get themselves hurt[end if].";
	LineBreak;
	say "     [italic type]What would you like to do? Note: fleeing or submitting fails this quest and removes Galaxite from the game. There is no special content to be viewed or rewards to be gained if you do so.[roman type]";
	LineBreak;
	let Say_We_Grow_Wings_Choices be a list of text;
	add "RUN AWAY!" to Say_We_Grow_Wings_Choices;
	add "BREAK THEM!" to Say_We_Grow_Wings_Choices;
	if Strength of Player > 25:
		add "Kai Monah CRUSH TINY BAT THINGS!" to Say_We_Grow_Wings_Choices;
	let Say_We_Grow_Wings_Choice be what the player chooses from Say_We_Grow_Wings_Choices;
	if Say_We_Grow_Wings_Choice is:
		-- "RUN AWAY!":
			say "     Oh fuck this, you are not fighting this lot of nutters! Your mind blares as you scramble back up the rubble wall in an effort to get away from these angry rats with wings. You sprint back down and run back to the beach with your tail tucked between your legs. All the while, you hear the flapping of leathery wings and the cruel jeers of Fruit bats as they harry your every step. They pelt you with rocks and rotten wood everytime you dare to slow down. Only when you arrive back at the beach a tad bruised, a bit battered, but alive do they finally leave you alone.";
			now Ruined Trawler is resolved;
			now Energy of Galaxite is 0;
		-- "BREAK THEM!":
			say "     Shaking your head at the bat swarm, you tell them you've come too far to leave empty handed. You raise your[if weapon object of Player is journal]fists[else]weapon[end if] and prepare to fight!";
			say "[ZeeBatBrawl]";
		-- "Kai Monah CRUSH TINY BAT THINGS!":
			say "     Undeterred by their weak attempt at intimidation, you calmly punch one of the nearby sandstone chucks comprising the rocky wall behind you, utterly obliterate it in a single hit, saying. Sorry, hand slipped, now what were they saying? All this muscles make it hard to hear sometimes. As the particles swirl about the creature's head, the once bold bat eyes going wide as the reality of what he's facing sets in. 'Uh on second thought, you can have the tree.'  It screeches and takes to the air, yelling at its peers to run. Their morale shattered, they do just that and zip off to parts unknown. With the area now clear, you begin to clamber aboard what's left of the trawler, only to hear the weather-beaten wood groan in protest of your tauric weight. At first, you pay it no mind, and try to push on, this puny human vessel be damned, though, as the great Gill Fruit tree begins to sway as the hull shifts around its tangled roots ever-so-slightly, you halt in place.";
			say "     Recalling the ape's warning that the moment one fruit falls, all the remaining fruits will drop and anything that hits the ground or water will instantly rot, you hurriedly leap off the keel in frustration. Grumbling under your breath, you wonder what you should do, call the sea dragons? No, you muse, remembering the ape's words that her children lacked the deft touch needed for this job. Perhaps, you could use the lines to lasso them, or a section of net to grab them. Yet if you missed and somehow disturbed the tree, failed to pull them in in time, or damaged them, this whole venture would be for naught.You opine, feeling your forelimbs clenching in raw annoyance as a strange yet all too familiar thrum of static builds in the shapely muscles as they tense than untense in a wild tattoo beneath your scales.";
			say "[Rejecthumanityandreturntolizard]";


to say ZeeBatBrawl:
	let GroupFightCounter be 0;
	now fightoutcome is 0; [reset]
	while fightoutcome < 20 and GroupFightCounter < 8: [runs for 4 times or until the player loses or flees]
		now inasituation is true;
		if fightoutcome < 20 and GroupFightCounter < 8:
			say "     Staggering from your last blow, the belligerent feral looses an ear-splitting screech as it takes to the air in panicked pained flutter. Though it's barely able to stay aloft, the remaining gnats swarm around you hurling vollys of heavy jagged rocks and shaprend bits of flotsam directly at your head as another rushes in to take its place.";
		PlayerWounded 35;
		challenge "Fruit Bat";
		increase GroupFightCounter by 1;
		now inasituation is false; [reset]
	if fightoutcome >= 10 and fightoutcome <= 19 and GroupFightCounter is 8:
		say "[ZeeBatBrawlWin]";
	else if fightoutcome >= 20 and fightoutcome <= 29:
		say "[ZeeBatBrawlLose]";
	else if fightoutcome >= 30:
		say "[ZeeBatBrawlRanAway]";

to say ZeeBatBrawlWin:
	say "     Reeling from your last brutal blow, the last Fruit Bat collapses to his knees panting for breath. Despite his weakened condition, the light of defiance still blazes in his eyes as he tries to rise. Unwilling to let your prey get its second wind, you bound forward, claws outstretched, and pin him to the shore, roaring for the [']little mouse['] to yield as you press your superior body's weight upon him. You revel at sight of your webbing digging into his soft vulnerable neck and the beautiful bulge of his adam's apple as he fights for every scrap of breath your domineering hold will allow as fitful preyish gasps issue from its vulpine lips with each gurgling attempt. Seconds pass, and its pulse quickens to panicked fevered pitch as the bat meekly struggles delectably between your talons, then realizing its hopeless predicament, sighs bitterly in defeat. 'Alright-alright we surrender, just take the damn fruit and leave us be.' it grumbles, baring its neck to you in a sign of base submission.";
	say "     Enjoying the sight and feeling of the puny rat's supple body under your paws, you momentarily toy with the idea of humoring their request, but where would be the fun in that? After all the trouble they just gave ";
	if "Weak Psyche" is listed in Feats of Player:
		say "us, ";
	else:
		say "you, ";
	say "surely they deserve a measure of... punishment, a sensuous choir of abyssal voices coiling at the back of your mind tempts as your draconic body tenses with excitement as you gaze at the cute little Fruit Bat and his friends. A part of you wonders what it would be like putting those adorable muzzles to work, those pierced tongues would probably feel amazing polishing your slit. Do you wish to dominate these lesser beings with your draconic body, or are such lowly cretins beneath ";
	if "Weak Psyche" is listed in Feats of Player:
		say "the Kai Monah?";
	else:
		say "you?";
	let Zee_Bat_Breaker_Choices be a list of text;
	add "Yes, you would like to dominate these lower lifeforms." to Zee_Bat_Breaker_Choices;
	add "No, you do not truck with inferior beings" to Zee_Bat_Breaker_Choices;
	let Zee_Bat_Breaker_Choice be what the player chooses from Zee_Bat_Breaker_Choices;
	if Zee_Bat_Breaker_Choice is:
		-- "Yes, you would like to dominate these lower lifeforms.":
			if Player is Herm:
				say "     Pressing more of your majestic weight upon your lesser's throat, you explain to the little mouse, in no uncertain terms, that you'll let them go. But, only after they've made amends for attacking you. 'Fine, not like we have a choice, what do we want us to do?' the pinned bat whines in pained frightened gasps. Flashing them a too-toothy grin, you release your hold on his neck, then instruct the assembled bats to attend your hybrid body. 'And you promise you'll let us go afterwards, right?' the bat asks, still laying in a prone position as he rubs his throat. Nodding, you tell them that you promise and lie back on the warm sand presenting your dual sex to them with a haughty flourish of your tail. 'Well it's better than being turned into dragon chow, I guess,' the cowed bat grumbles, motioning for his friends to join him. Though the others gripe over what part of you they have to service, a warning growl from you quickly sorts things out.";
				say "     As the lead bat who tried to intimidate you earlier scurries over to your feminine slit, you internally remark how he's already at the perfect height to make use of your draconic snatch. The head bat hastily rips off his oh-so-tight speedo with an exaggerated flourish and you're greeted by a unique mouth-watering sight as his plump sheath and fluffy balls slip free of their spandex cage. You realize that these Fruit Bats are packing something a bit extra compared to their more banal kin at the beach proper. You watch with mild interest as the led bat strokes his blueberry-striped sheath in the winged furrows of his palm, coaxing his adorable, yet gracefully tapered foxy cock to attention. Off-white pre-cum dribbles from his cock wrapper with each languid pump of wrists, as the brown and blue streaked fur starts to swell in his soft not-so-little palms. A look of bestial contentment blossoms on his face as the bats eight-inch cock slips from its plush housing. The oddly eager bat boi gives his tool a play shake, letting the blue-tinted flesh glisten in the available light, before lining himself up with your feminine draconic flower, then looks to you for approval.";
				WaitLineBreak;
				if Ball Size of Player >= 4 and CockName of Player is not listed in infections of InternalBallsList and internalBallsBypass is false: [For the ball lovers]
					say "     Lips curling into a predatory grin, you beckon the servile mouse onward with a languid come hither wave of your claws while your tail invitingly coils along the ponderous swell of your quad cum tanks. Either enraptured by the sight of your regal hybrid body, or cowed by primeval majesty of your imperial draconic nature as you dexterously heft your heavy spunk bank clear of feminine slit, your thrallish plaything dotingly tuts, 'Mh, quite the set ya got there [italic type][']Miss['][roman type] Dragon, here,' cupping his pleasantly padded palms along their virile mass. 'Let me help you with that,' the lead bat swoons appreciatively, sinking his silken mitts into the pillowy flesh as he balances the bloated bejeweled orbs on his tight lightly-muscled sternum. 'Heh, you must be pretty popular out there with these bad boys,' the slender bat-morph chuckles, running his winged hands along the bountiful curves of your quad nuts.";
					say "     Chuffing at his demeanor as he lovingly pampers your excessive sack in his exotic embrace, you tell the cheeky feral to be careful; if he keeps this up, you might give him a private demonstration of what your tauric body can do. 'Heh, I might hold you to that [']Miss['] Dragon, I bet you taste delicious,' he purrs, licking his sleek studded tongue across his thin bestial lips. 'And not just your cock,' he rumbles, draping his slender frame over the groaning surface of your turgid balls, nuzzling his foxy chin about their groaning surface. His wing-like hands rove your baby batter banks, creating deep sensual furrows in your well-lubed scales as his soft furry midriff rifles against you. 'This cute [cunt size desc of player] cunt of yours, must see plenty of action too, I can't wait to try it out!' he titters, shamelessly grinding his tapered tool about your tender lips, smearing your moist muff in a welcome sheen of toasty sweet smelling pre-cum.";
					WaitLineBreak;
					say "     Intrigued by the boldness and titillating caress of his glossy member, you commend the little mouse to take you then, [if player is impreg_now]your gravid form could use a good rut[else if player is impreg_able]you're overdue for another clutch[end if], you tease. 'Yes ma'am!' he roars, slamming his foxy cock home with enough force to make a lesser being shudder. Yet, your tauric body takes it in stride as the eager bat ruts your feminine passage. His glossy vulpine tool swells with every potent buck of his boyish hips as the vaguely canine tool grows to better accommodate your [cunt size desc of player] slit. As he musters all the remaining post-fight strength in his attempt to please you, your draconic sex roils with elation as his delectable tool brushes your tender folds sending waves of static delight coursing through your tauric being as your aquatic muff's muscles hungrily caress his glossy foxy cock. Good little mouse, you rumble in encouragement, wrapping your finned tail about his waspish waist, coating his puny, scaleless body in a light sheen of your form's natural lubrication as you fondle his chicken egg-sized sack in your tail's coil.";
				else: [For the ball haters]
					say "     With a dominant smirk, you motion for him to attend your regal scalie cunt with a come hither flex of your talons. Propelled by fear, or the exotic delights of your tauric splendor, the obedient creature does as he's told, slamming his foxy cock home with enough force to make a lesser being shudder. Yet, your tauric body takes it in stride as the eager bat ruts your feminine passage, you can feel his vulpine tool swell with every potent buck of boyish hips as his vaguely canine tool grows to better accommodate your [cunt size desc of player] slit as he musters all the remaining post-fight strength in his attempt to please you. Your draconic sex roils with elation as his delectable tool brushes your tender folds sending waves of static delight coursing through your tauric being as your aquatic muff's muscles hungrily caress the inviting contours of his glossy foxy cock. Good little mouse, you rumble in encouragement, wrapping your finned tail about his waspish waist and soft bubble butt and lavishing his puny scaleless body with a light sheen of your form's natural lubrication as you fondle his chicken egg-sized sack in your tail's coils.";
				say "     'Shit Miss Dragon, that-,' the lead bat pants, grabbing hold of your hind legs for support as he drunkenly sways in tune with the meaty thrusts of his tapered cock, 'that feels amazing.' Seemingly encouraged by the spectacle, two of the others share a Cheshire grin as they clamber over your feral half, and nestle themselves beside your male anatomy's vent. Curious, you observe them leaning over your scalie dick slit, happily nuzzling their conical muzzles along the lust-flushed seams of your sensitive reptilian vent. Their ponderously impossibly long, sleek flexible, studded tongues slip from their fuckable snouts as they dutifully lap at the sleek alabaster-white lips of your moist cock cave. You can't help but growl in draconic rapture at the beatific kiss of their dexterous oral muscles slipping between the taut wall of exotic anatomy as they pour "; [Note: I.R.L a fruit bat's tongue is 1.5x its total body length.]
				if "Touched by Madness" is listed in feats of Player:
					say "meter upon meter ";
				else:
					say "foot upon foot ";
				say "of silken bejeweled delight into your masculine slit. The thrallish ferals lavish your hidden scalie cock throbbing in its lascivious depth with eager laps of their pierced tongues. The blissful contrast of their soft oral muscles and smooth barbell studs coddling your cock carrier brings a pleased coo to your lips as the now well-motivated bats pierced prehensile muscles traipse across your ridged tool.";
				WaitLineBreak;
				say "     As they eagerly dandle their lengthy tongues about reptile rod, slowly coaxing your [cock size desc of player] spire out of hiding with every doting pass. Your altered liminal mind revels in the sensation of their talented tongues gliding along the length of your stiffening tool and warm inviting tightness of your aquatic vent, pampering your knotted spire as your quickening pulse simmers along the tactile pleasure-ridges of your cock. As they tease and kiss your draconic spear to full mast, an odd look passes between the eager cock sluts as one climbs about your feral half as he laps the pre off your glistening cock head with a long drawn out brush of his tongue. Meanwhile, the other goes low, his fingers and oral muscle lavishing your tight dick slit with a beatific touch that pairs heavenly with the pounding of your draconic cunt. You don't even bother reprimanding the [']head['] bat as he traces his fuzzy paw-hand about the chiseled contours of your hind legs as he almost angrily ravishes your reptilian slit.";
				say "     If anything, you feel an urge to applaud the mutant's courage as you pull him in close. Sinking your rear talons into the velvety fur swaddling his body, your reveling in the brief look of mammalian terror flashing upon his once smug face at the touch of your claws tracing over his preyish form wars for your attenion with the succulent sensation echoing about your tauric cunt. Not to be left out, the four other bats position themselves next to your fore paws. Though you watch them with no small amount of suspicion as they each take one of your murder mittens in hand. They, perhaps sensing your baneful gaze upon them, hurriedly make a show of kissing and massaging your heavy webbed-paws. Evoking a deep approving chuff from you, as their sensuous tongues coil about talons in a heady display of proper subservience to your regal form. Good paw sluts, you chuckle contentedly, as the assembled aberrant bats bury their cute little vulpine muzzles in your thick pad as they worship your paws. Their skillful tongues almost seem drawn to the well-muscled contours of your massive webbed toe beans as they lavish their better's form.";
				WaitLineBreak;
				say "     So enraptured in their task, they don't bother feigning any pretense of self control. Their free hands drift down to their over-stretched speedos and you mirthfully observe them hurriedly disrobing and playfully rubbing their own blueberry pre-slicked sheaths against your well-lubed scales. Another time you might have considered disciplining them, however, the blissful innervation of your dual sexes by the other bats attending your needy bits stays your tongue. For the moment, you bask in the warm sands, caressing your lengthy spine as the lurid heat of the lead bat's throbbing canine-like cock stuffing your tauric depths to the brim washes over you like a warm tropical wave. As the wondrous rubbing and polishing delivered by the eager bat bois on your reptilian tool and alien vent fights for prominence in your liminal mind, you almost swoon at the erotic symphony playing across your regal form, like lightning skimming over a stormy sea. You absentmindedly lick your draconic chops and motion to the odd bat out, demanding that he drop his trunks and present himself for [']inspection['].";
				say "     Though a worried expression passes over his vulpine visage, a stern glance form his peers lights a fire in his step as the bat boi reluctantly walks over to your anthro half then presents himself to you, albeit half-heartedly. Now strip little mouse, you command, hooking his flattering speedo in the crook of your claws and tug him close. Your draconic mind delights at the look of trepidation on his vulpine muzzle as you stretch the fabric taut, till the pleasant not-so-little outline of his sheath begins to poke through, eliciting a pained whine from the meek morsel as you release his suit with a sadistic flick of your talons. At once, the overstretched fabric rubber bands and smacks him with a loud thunderous crack, bringing a pained whimper to the twinkish morsel as he slips his hybrid fingers through his trunks and shamefacedly strips like a novice burlesque dancer. Despite his reticence, something about the pitiful look on his foxy face does bring a wicked chuckle to your lips, as you watch him fumble and struggle with his trunks. Once his striped sheath flops free, you're not sure why they would be embarrassed, the bastard is even more hung than the rest! You note observing over ";
				if "Touched by Madness" is listed in feats of Player:
					say "fifteen centimeter of plump cock cover and a pair of knee knocking balls slipping free of their lycra cage.";
				else:
					say "half a foot of plump cock cover and a pair of knee knocking balls slipping free of their lycra cage.";
				say "     Mh, looks like they saved the best for last, you preen, leveling your regal muzzle to his crotch as you indulge your predatory senses in the sweet citrusy smell of his body's natural scent mixed with the sharp notes of dragon fear wafting off of him. Though the little mouse bleats ever-so-slightly at the toasty caresses of your breath and imposing gleam of your fangs, he does nothing to resist you as you playfully brush your claws along the length of his unique furry dick wrapper. Some section of your liminal psyche relishes in the frightful shiver running down his soft brown pelt as you kiss your bestial muzzle to his crotch. Good boi, you tease, slipping your forked draconic tongue along the fuzzy lips of his plump fuzzy cock tunnel. Rumbling in a haughty reptilian trill, you languidly glide the supple forks of your tongue along the tight slit of his fuzzy dick wrapper. Though the little rat mewls meekly at your touch, his preyish reluctance seems more for show than anything else, you note, sense the unsubtle throb of his vulpine tool echoing along talons and the light dollops of effervescent juices leaking from his sheath."; [Dragon fear is an effect in D&D/DragonLance that causes most life forms to feel existential dread and terror at the presence of true dragons. Some people/races can block it out though and one or two are immune due to some mental quirks or sheer stupidity.]
				WaitLineBreak;
				say "     Delicious, you tease, slipping your prehensile oral muscle through his oh-so-tight vent, watching the flush striped fur bulge and twitch with repressed rapture as you swaddle his girth tool in the coils of your bifurcated reptilian tongue's dexterous forks. The savory, vibrant, fruity tang of his pre explodes across your palate, as you graciously stroke his sizable tool with your draconic oral muscle. You revel in the bestial pleasure playing acoss your senses at the heady echoes of the lead bat's cock servicing your abyssal depths, the beatific caress of your cock, and the tender worship of your paws as you languidly suckle his throbbing pre-slicked cock to full attention, sending ripples along the fraying edges of your awareness. Your clawed hands languidly roam his plush brown sack, you're almost impressed by the bat's levels of self control as you caress his fuzzy ball bag with your smooth scaly palms. You expect him to whimper, or cower at the touch of your sharp draconic claws, but the eager slut appears to be well and truly getting into the act.";
				say "     A dopey look even grows upon his faux foxy face as your draconic mitts fondle his ponderous striped sack in their warm oily embrace. Though his unique vulpine texture delighting your palate is only a single note in the symphony of bliss the others unleash on your hybrid body. Every ";
				if "Touched by Madness" is listed in feats of Player:
					say "centimeter ";
				else:
					say "inch ";
				say "of your dual sexes sings with rapture in ways that the lingering fragments of your human mind struggles to parse. You still marvel at the way the subby pair of dragon-dick polishers coil their exceptionally long and bendy tongues about your throbbing spire. They extend and contract their malleable muscles about your scaliehood in an intoxicating eclectic rhythm, as their smooth piercings glide about your ribbed cum vein, painting your senses with their divine contrast. Meanwhile, their velvety paw hands tenderly caress the exotic walls of your scalie slit in tandem with their glassy studs. Your reptilian vent gushes beads of warm salty delight as the throbbing sensuous flesh cinches about the plump base of your swollen [cock size desc of player] knot.";
				WaitLineBreak;
				if Ball Size of Player >= 4 and CockName of Player is not listed in infections of InternalBallsList and internalBallsBypass is false:
					say "     All the while, their leader huffs in enthralling emulsion of fatigue and primal desire as he wildly bucks his pleasantly padded hips against your [bodydesc of player] flanks. Each meaty collision sends blissful little shock waves through your draconic body as your heavy cum tanks bounce about his soft fuzzy stomach. ";
				else:
					say "     All the while, their panting leader pistons his boyish hips roughly against your tauric backside. ";
				say "As he languidly slips one of his fuzzy mitts down your inner thigh, the once boisterous bat playfully massages your well-stuffed cunny and draconic button with measured tactile brushes of his padded fingers, eliciting a pleased rumble from your lips at the skillful treatment of your feminine passage. The happy vibration of your sizable maw, sends a delighted shiver throughout the exceptionally hung bat's dick nestled comfortably in your muzzle as you nurse his fruity tool, as the unusual fruity flavor of his blueberry dick titillates your taste buds and feeds into your draconic hunger. You can't resist the growing urge to show a small pittance of affection to your living lolly as you lovingly cup and stroke his plush, heavy, brown nutsack with your slick oily palms. The sensation of your shapely tongue and smooth talons lavishing affection soon proves too much of him and you can feel his dick twitch and throb in your maw's decadent embrace. The well-hung flying fox, tries to hold back though, as he bites lips, fixing you with a pleading look as if to ask your permission to cum.";
				say "     Rumbling in draconic approval at his show of proper submission to his better, you purr your consent through dick-stuffed lips and press your ";
				if "Touched by Madness" is listed in Feats of Player:
					say "dargon snoot "; [Note: this was almost Dovah snoot]
				else:
					say "predatory maw ";
				say "to his groin, forcing him to the ground. The added warmth of your breath playing over him pushes him over the edge, as his batty rod twitches like a broken metronome in your muzzle as he finishes, spraying his rich bounty across your waiting taste buds and bloating your cheeks with what feels like gallons of warm fruity seedy, none of which you let go to waste. Not that your body's draconic pride would permit you, you're not about to show any measure of weakness in front of your toys, you opine, heartily sucking down the seemingly endless stream of molten seed that your plaything can produce. With every decadent swallow, a pleasing warmth builds in the core of your scaly tummy as your [if Player is impreg_able]naturally stretchy belly swells into a beautiful taut dome as your body struggles[else if player is impreg_now]well-bred middle groans at the weight of his bountiful offering as your malleable azure and white scales stretch a hair tighter[end if] to accommodate the bat's inhuman load.";
				WaitLineBreak;
				say "     Still, you hungrily nurse his delectable dick, relishing every drop as he paints your palate till the heavenly deluge of fruity cream stops. Smacking your lips, you release your hold on the still-twitching dick of the well-hung Chiroptera-morph before lying back on the cool sand and languidly caressing the taut scales of your warm hopelessly overstretched tummy, the sight of which further encourages the lead bat. Locking eyes with him, you feel him dip one then another of his hybrid digits into the apex of your moist yet accommodating tauric honeypot. His thumb and forefingers diligently minister to you reptilian button with broad tender motions that rocks your welcoming sex with waves of overpowering ecstasy. Try as you might to ride out these blissful tides, you feel your tauric cunt clench and spasm as your aquatic muscles eagerly milk the lead bats bright-blue, tapered, foxy dick for all its worth. Neither of you can hold out much longer. You can already feel the beautiful pressure building in your draconic sexes as your hybrid body nears its limit.";
				say "     Perhaps sensing this, the lead bat, desperate not to finish first, grits his teeth, trying his best to fight against his own body's impending climax. Unwilling to let yourself be bested by this lesser being, in any regard, you cheekily caress his petite bubble butt with your smooth finned tail while your clawed hands roam your [Breast Size desc of Player] chest and cum-bloated tummy enticingly. All of which he watches with rapt attention as his cock throbs with roiling desire against the supple walls of your draconic box, till at last his resistance shatters and he cries out a hymn of defeat and elation as he cums, hard, though nowhere near as explosively as his more endowed peer. Your feral half nevertheless swells with the heavenly weight of the thick hot ropes of his tainted seed. Only now do you allow yourself to finish, letting the wave of budding bliss wash over you like the first rains of spring.";
				WaitLineBreak;
				say "     Your hybrid sexes roil and thrum in elation as your cock erupts into the air, coating both you and your playthings in a rich veneer of pearly dragon seed. Not that any of them seem to mind, your little paw sluts seem especially enamored by the sight of your virile offering as they shift their attention to your well-fucked scaly body. Their hands and long pierced tongues roam your tauric form as they swarm over your cum-splattered form, lapping at your gleaming scales, and diligently cleaning every dollop of sticky delight while you wallow in the warm afterglow while [if player is impreg_able]lazily massaging the taut curves of your egg-laden middle. You're rather impressed by the delectable feast that these lowly bats provided you. Perhaps, you muse, stroking your ripening scales, these weak warmbloods might have some uses after all[else]lovingly fondling your cum-stuffed core. A part of you hopes that this load sticks. Despite their lowly scaleless nature, these virile bats could make good breeding stock[end if]. A dragon of stature should have plenty of servants to attend to their every need, a slithering sliver of your psyche notes, watching the servile rats polish your hide to a mirror-like shine. Perhaps sensing your imperial gaze upon them, the cowed bats glance at you fearfully and redouble their effort. Good bois, you snicker, leveling what some could call a reassuring smile at them as you reach out and pat one on the head affectionately.";
				say "     You tell them how pleased you are with their performance, and their offering to your majesty, you add, running your claws invitingly over the [if Player is impreg_now]taut curves of your gravid body, basking in the soothing heat of their loads and sensuous weight of your eggs putting pressure on all the right place[else]decadently rounded swell of your cum-stuffed middle, with a calming mix of anticipation and satiation[end if]. At this pronouncement, the bats chirp happily amongst themselves as they nuzzle their soft furry bodies against you in a show of animalistic affection. Inured on some primal level by the sight of their deference, you lovingly wrap your limbs around them, and pull them close to better bask in the warmbloods doting affection as they pamper your lush well-fucked body. You decide to simply enjoy the moment, as you recline back into the sands relaxing to the care-free songs of sea bird and gentle lapping of waves washes over you.";
			else if Player is female:
				say "     Pressing your talons to the bat's Adams apple, you explain to the little mouse, in no uncertain terms, that you'll let them go. But only after they've made amends for attacking you. 'Fine-fine not like we have a choice, ugh what do we want us to do?' the pinned bat whines. Flaunting a too-toothy grin, you tell the broken swarm they will have the supreme honor of attending to your tauric body. 'Then you'll let us go, right?' the bat, still lying in a prone position asks as he rubs his throat. Idly inspecting your claws in a show of proper indifference to your prey, you reply that you will, assuming that they do as they are told. 'Sure, better than being turned into dragon kibble, I guess,' the bat replies, pulling himself to his feet. Good, you respond, turning yourself about, you present your [cunt size desc of player] scalie slit with a flourish of your tail and grant the assembled ferals the high honor of pleasuring your regal form, which seems to put a bit of spring in their step as an argument breaks out over who should be first in line.";
				say "     In no mood to humor such frivolous warbling, you growl at them, ordering each one to drop their trunks so that you may inspect your, you pause to lick your fangs, delighting internal at the sensation of their scything edges of playing along your forked tongue, [']prize[']. Snapping to attention at the sound of your voice, all but one of them appears eager to show off, either because they hope this display of submission will earn them a pardon that much quicker, or because they actually enjoy the chance to flaunt their cute bodies. Either way, you can't be certain, you muse, mirthfully circling about them as you watch all but one of them line up before you. They make a show of slowly shimming out of the tactfully tiny trunks like a practiced burlesque dancer. Their hands drift over soft, brown, furry abs and down to their waist as they languidly pull down their flattering speedos. You're met with a curious spectacle, as these particular Bats appear to be blessed with a lush blue-striped sheath swaddling their vulpine cocks.";
				WaitLineBreak;
				say "     Though nowhere near impressive as some of the more endowed mutants you've seen, the sight of the group of aberrant Fruit Bats playfully teasing their plush sheathes arouses your curiosity. You watch their hybrid hands rove their cock wrappers as they coax their masterfully-tapered, blue, foxy dicks free of their fuzzy housing, the sweet fruit scent of their unusually male musk filling the air and making your mouth water. Even if they all look the same, you still feel spoiled for choice, you opine, observing the little morsels puff out their chests and arch their back as if to show off their adorable bodies. Some even resort to playing with each other's fluffy nutsacks and petite cock socks in an effort to earn your favor. Nearly on the cusp of making up your mind, you notice out of the corner of your eyes the last bat trying to tiptoe away while you're distracted looking at your prey. Enraged, you roar at the foolish little mouse, demanding to know where he thinks he's going! Sensing your malevolent gaze, alongside the scornful looks of the peers that he was about to abandon, burrowing into the back of his head, the not-so-sly fox stops in his tracks.";
				say "     Turning on the balls of his paws, he tries murmuring some weak apology, or hasty excuse, but you're having none of that! You growl, ordering the meek creature to take his place among his comrades. Though he hesitates for a moment, looking to his friends for support, he finds none, sighing defeatedly, he reluctantly shuffles into line beside the other bats. You snap your fingers and direct the others to disrobe him. 'Yes ma'am,' they cry, eagerly grabbing hold of the flighty bat's wing-like arms. 'Thought you were just gonna abandon us, you cowardly shit! Just for that, I think you should be the one who goes first. Hopefully they,' the lead bat nods at you, 'go easy on you. Cause when this is over, we're gonna take turns riding your ass till people think you're bottoming for a pent up Platypus,' the annoyed Chiroptera-morphs leader hollers, grasping the hem of the disloyal bat's trunks. 'I-I,' the treacherous bat bleats as his leader roughly yanks down his speedo.";
				WaitLineBreak;
				say "     Over ";
				if "Touched by Madness" is listed in feats of Player:
					say "fifteen centimeter of ";
				else:
					say "half a foot of ";
				say "turgid, half-chubbed, blueberry, fox cock flops out for all to see. 'Fucking hung ass son of a bitch! I still don't know what you're so bashful about, there are Alpha Huskies who would kill for this,' the lead bat says, cupping the timid creature's cock in his bestial mitts. You watch as the head fruit bat gently strokes the length of his disloyal peers rod to full mast saying, 'So what do you think Miss Dragon?' He pauses as he coils his studded tongue about his disloyal fellow's cock, creating cute off-white furrows in the little traitor's throbbing blue tool, as licks the length of bashful bat dick with theatrical flourish while fixing you with a vivacious grin, 'Mh, want to take this one for a spin first? I got him nice and lubed up for ya, just don't be too [italic type]rough[roman type] with him though,' he chuckles. Oh, we might be starting to like this one, an abyssal choir of voices titters from the back of your mind, as you direct the assembled altered bats to push him to the ground. A task that they carry out with glee. As their leader shoves him off his feet, the others crowd around and stomp on his wings as you stride over to his prone form.";
				say "     Flashing the little mouse a lewd toothy smirk, you line up your feral sex with his comparatively small frame, and unceremoniously slam your dragon ass down hard on his waspish hips. You take no small amount of pleasure from the pained whimper that escapes his muzzle as your cunt effortlessly takes his exotic vulpine cock. You balance yourself on the edges of your draconic paws, bouncing your tauric half on the length of his blue tapered meat, reveling in the sordid sensation of his glossy vulpine dick swelling in the tight grasp of your tauric muff, and the tender caress of his silky brown and blue striped fur gracing your peerless scales. Not to be left out, the other bats cluster about you looking for a chance to cut in. With a regal nod of your draconic head, you select two of them at random and direct them to attend your reptilian flower. The others, you tell to wait in the wings till you've finished with your current, you pause to lick your lips, morsel. Spurred on by the mutual dislike of their cowed cowardly comrade, and fear of your ire, the broken swarm eagerly does as they're told.";
				WaitLineBreak;
				say "     A pair of them quickly crawl beneath your bestial half, tactfully positioning their cute little muzzles between yourself and the bat that you're riding. You can feel more than see their soft paws and sleek pierced tongues roaming your feral flower, as their smooth lengthy studded muscles lavish your delightfully stuffed cunt with broad playful strokes. You almost swoon at the delectable interplay of their warm yielding oral invaders and smooth metallic stubs playing across your scalie petals. With each motion of your [bodydesc of Player] flanks, they slowly slip more of their sinuous tongues between your puddling pussy lips as they skillfully probe your draconic passage like living pleasure vines. The lively cunning linguists['] oral muscles writhe as if they were loose lines caught in a squall as they worship your welcoming walls. Your sex sings with reptilian rapture as you sense their sizable invaders coil around their friend's fruity tapered cock, as if they were the snakes on the Caduceus. You nearly want to purr at the hybrid bliss they create that is so unlike anything that you've experienced before.";
				say "     Their oral intruders almost seem to vibrate in time with the gesticulations of your lower half. As the tips of their oral muscles fork off in different directions as they plumb your tauric depths; their smooth barbell piercings roil wildly about your lurid walls and the disloyal bats delectably tapered tool. You hear a low happy whine from the bat trapped beneath you as the other two cup and fondle his heavy, furry, brown balls in the soft webbing of their winged fingers while their free hands stroke down his twinkish chest, encouraging him to cum, so they can have their turn. Chuffing internally at their antics, you decide to aid them, and entwine your well-lubed finned tail about your toy, and playfully caress his soft furry body and supple bubble butt in your coils. Exalting in the powerful feeling of wrapping his plush furry pelt in your clutches like some base prey, you stroke the cute little outline of shapely cock with your forepaws. You nearly swoon at the raw tactile pleasure of our supple webbed paw pads gliding over the perpetually lubricated scales decorating your lower half and potent thrum of your aquatic cunt muscles massaging the puny bat's servicable tool.";
				WaitLineBreak;
				say "     Though the attention soon proves too much of the poor boi, you can hear him pant roughly as his bestial spire throbs with each motion of your pelvis-breaking hips crashing against his puny foxy frame. Another time, you might have considered going easy, but the little coward deserves the punishment. Judging from the rising tension in his faux foxy core as your tail caresses his washboard abs and the pleased look of his peers as ride him, they're all enjoying the spectacle as they openly stroke their meat at the sight of your tauric lap ride. Sadly, you can tell your poor toy's batteries are already starting to run low, as the heady dual pleasures of your draconic cunt milking his blueberry fox cock and the tender caress of his peers['] sleek studded tongues proves too much for him. With an elated cry, the cowardly bat boi climaxes hard and loud, crying, 'Oh god yes!' as he finishes, his cock straining against the bonds of his comrades['] oral muscles as he bastes your sopping cunt to the brim with his fruity seed."; [And thus the bat was sentenced to death... by Snu-Snu!]
				say "     [if Player is impreg_able]You find yourself rumbling contentedly at the decadent sensation of his molten seed sloshing and rounding out your tauric tum into a cute little dome. More than a tad impressed at the lowly biped's output, you can't resist pawing at the delightful weight of his load wallowing in your taut draconic tummy. Despite his inferior scaleless nature, a part of you wouldn't mind if his offering stuck, you muse dreamily, basking in the balmy warmth radiating about your sticky sodden walls[else if Player is impreg_now]Your roar in bestial triumph at the welcome rush of toasty seed flooding your gravid body as your malleable scales stretch just hair wider[end if]. Still, your greedy body needs more to finish, though going by the looks of the assembled bats as they gaze reverently at your majestic form, they appear eager to serve. Well, no point in making them wait, you muse stepping over your spent toy, and kick sand in his face. You find a somewhat rock-free flat spot on the shore then roll on your back, fanning your still-dripping cunt invitingly with your tail, and beckon them over with flick of your talons. Ever eager to please, six members of the cowed swarm of aberrant Fruit Bats crowd about you while their leader directs them to service different parts of your tauric splendor.";
				WaitLineBreak;
				say "     Two of them are commanded by their leader to attend to your cunny, while another pair nestles up your anthro half. Finally, the two bats who were just eating you out, are told to deal with their overly-endowed peer. Nodding, they grab him by the ankles and drag him off, likely to have some fun on their own. With that dealt with, their boss, who looks oddly pleased with himself, strides up to your muzzle, cock in hand, eagerly stroking his blue-striped sheath meat to attention mere ";
				if "Touched by Madness" is listed in feats of Player:
					say "centimeters ";
				else:
					say "inches ";
				say "from your muzzle as he waits for approval. Smirking at the sight and smell of the little droplets of pre balanced on the edge of his sheath like shimmering pearls as his graceful fox cock poke free of its fuzzy home, you rumble your consent at the adorable creature's display, and gesture for him to sit himself on your collarbone. 'Heh, don't mind if I do beautiful,' the lead bat says, draping his cuddly featherweight form over you. Tucking your muzzle to your chest, you lean forwards slightly and lap at the glistening tip of the sweet blue treat, briefly enjoying the preyish little shiver pass through him, as you lightly caress his twitching dick slit with the inquisitive forks of your tongue, eliciting a tasty gush of fruity juice from his plush cock sock.";
				say "     Magnificent, you purr, taking playful laps of the fresh zesty dollops before slipping your long, forked, draconic tongue into his tight little cock cage. His natural warmth floods your senses like a welcome balmy tropical breeze as you gently coil your serpentine tongue about his meaty member and stroke his tool out of hiding. Delicious, but you need more, you rumble as the taste of fresh ripe blueberries and rich oceanic tangs titillates your palate as if it were some rare salt water taffy treat. You cup your lips to his groin, effortlessly taking all eight inches of his blue manhood in your sizable muzzle. As your ";
				if "Touched by Madness" is listed in Feats of Player:
					say "dargon snoot ";
				else:
					say "predatory maw ";
				say "kisses his silky pelt, you find yourself shamelessly huffing his unique fruity scent, as you gently nurse his girthy batty dick in your deadly maw like he were your own personal lollipop. Almost humming with delight at his unique texture, you languidly caress his tapered cock in the furrows of your forked reptile tongue. 'Shit that feels good,' the lead bat murmurs as he leans back, slowly rocking his dick in your cock pillow, rollicking in the beatific sensation of his animalistic spire gliding along the inviting ridges of your draconic maw and the exotic touch of your bifurcated tongue. 'God damn Miss Dragon, your muzzle is fucking amazing!' he simpers, running his cute paws over your imposing visage as he takes hold of your horns for support.";
				say "     Though a part of you wants to chastise him, something about his boldness and the divine taste his pre stills your coldblooded temper, for the moment at least. Besides, the adorable look on the little bat boi's face as he acts like he's dominating you is too precious to spoil. Perhaps encouraged by the sight of their boss riding your muzzle, the bats spring into action as well. The two behind drop to their knees and nuzzle up to your still-dripping muff, as they slavishly kiss your inner thighs, gleefully lapping at the fruity juice leaking from your slit with lazy flicks of their sleek bejeweled tongues. Languidly working their way up the [bodydesc of Player] contours of lamina lined legs, as their conical muzzle brush scalie cunt, they loose an animalist chirp as their affection shifts to your needy cunny lips and throbbing button as they split their attention between your waiting passage and eager clit. One of them nuzzles his vulpine snout to your [Cunt Size desc of Player] box, gleefully slipping his conical snoot betwixt your leaking nether lips, almost hilting his muzzle in your muff as his bejeweled tongue pampers your sopping cunt with wild abandon, lavishing every ";
				if "Touched by Madness" is listed in feats of Player:
					say "centimeter with his studded oral muscle.";
				else:
					say "inch with his studded oral muscle.";
				WaitLineBreak;
				say "     Meanwhile, his partner diligently attends your reptilian joy buzzer, swaddling your stiff needy button in the welcoming embrace of his brown and blue striped foxy muzzle. He eagerly suckles your elated clit and ecstatic hood with bestial abandon while his cute little padded paw-hands reverently roam your cum-swollen scalie tummy in lazy circles. Rumbling at their pleasant touch, you feel like your whole body is drifting in a roiling ocean of primeval bliss. You practically purr with elation at the loving ministration of your cunt and the delectable cock nestled sweetly in lush ridges of your muzzle. You hardly even notice the two bats at your anthro half cuddle up to your [Breast size desc of Player] chest. They tenderly attend to your nips, reverently wrapping their lips about your cream spouts in the ponderous coils of their pierced tongues. [if Player is impreg_able]The affectate stimulation of their hungry loving kisses, elicits a thin trickle of your tauric cream from your [bodydesc of Player] form. All of which they lap up eagerly like hungry little foxy kits as they devotedly fawn over the subtle curve of your cum-stuffed tum[else if player is impreg_now]Coaxing rich pearls of motherly dragon cream from your brood-flushed tits as they fawn of your maternal majesty, a sense of profound relief and unearthly lightness flooding your liminal mind as you wrap your arms around their soft fuzzy bodies. You lovingly stroke their cute foxy ear in encouragement, murring, good bois, drink up now, between each meaty thrust of the lead bats rod. 'Yes mistress,' they mew, as their exotic paws rove the growing curve of your brood-swollen tummy as they pamper your maternal figure[end if].";
				say "     You sense their legs wrap about your anthro [']hips['] as they pull their cute little bodies close as they indulge themselves in your draconic splendor. You can't say why, but something about the gentle warmth of their soft fuzzy fur snuggled next you, leaves you feeling a tad magnanimous towards the puny warmbloods. Deciding to have to have a little bit of fun with them, you slip your paw-like hands between them as you lovingly fondle their adorable furry bodies with your draconic mitts. You can hear them purr with delight as your digits drift along the subtle swell of their fuzzy milk-laden middles as you caress their supple sheaths in the well-lubed crooks of your webbed paws. You playfully pamper their silken dick wrappers in your sleek pads, provoking happy little coos from your playthings as their free hands join yours. They diligently fondle the thrumming base of their slender tools and chicken-egg sized balls, as their velvety sheaths strain delectable against your grasp. Warm pre and bestial juices casades down your arms like a river of virile desire as their tapered foxy shafts slip free of their lush housing.";
				WaitLineBreak;
				say "     You evoke a pleasant muted shudder from your toys as they shamelessly rock their soft bubbly hips in tandem with the well-practiced motion of your wrists, eagerly slathering their turgid tapered spires in a hedonistic sheen of your intermingling juices, impregnating the air with their potent fruity musk and oceanic tangs as you massage their ripe batty cocks. Your doting feedees mewl in subservient delight at your tender touch, and you can sense their pulse rising by second while tummies bulge ever-so-slightly against your flank with your boundless offerings. Slowly, their resistance begins to ebb with each hearty suckle, as their lush rods throb with a potent rhythm along your supple pads. A beatific heat flares through their ripening forms as a final heady twitch simmers through the hungry little mouses as they finish with a pleased whimper, basting the sands beside you with a light glaze of sweet-smelling seed and collapse into your welcoming arms like loving pets as they murmur vague yet heartfelt thanks.";
				say "     While their peers attend your eager sex and yearning muzzle, your body feels like it's caught in a whirlpool of effervescent bliss. Every nerve sings a beautiful siren's song of draconic rapture as your [Cunt size desc of Player] snatch is coddled in the tender caress of the Fruit bats['] studded tongues. The erotic interplay of smooth cool precious metals, glassy amethyst, and the supple yielding flesh of their oral muscle as they worship your cum-stuffed draconic cunt sends toe-curling shivers down your lengthy spine, while the delectable flavor and unusual texture of the self-assured lead bat's cock has you rumbling with reptilian rapture. 'Fuck damn Miss Dragon, that feels out of this world!' the big bat swoons, clenching his fingers tightly around your horns as your soft palate vibrates about his exotic member like a living fleshlight. He elevates himself to a kneeling position as he bucks his hips like he were the one in charge as he aggressively fucks your toothy maw.";
				WaitLineBreak;
				say "     His antics are rather amusing to you though, so you allow him this little victory, and instead of unbraiding him, you run your reptilian tongue about the throbbing girth of cum vein. Cradling his manhood like it was some precious thing, you fix him with a salacious look as you press your muzzle to his groin so that your chin brushes his fuzzy sack and you aubibly huff his sweet masculine scent. 'Shit Miss Dragon, you have no idea how hot you look right now,' the lead bat simpers, tongue lolling from his lips in ecstasy. 'Why I gonna-gonna,' he pants, as his cock twitches in the heavenly confines of your [bodydesc of Player] muzzle. Cum, you purr, in a deep abyssal throaty tone that sets his heart a flutter. The poor boi's pulse races ";
				if "Touched by Madness" is listed in Feats of Player:
					say "exactly .621 km a minute. ";
				else:
					say "a mile a minute. ";
				say "As the big bat rises to his full height and hilts himself in your draconic  maw with one final thrust, his cock erupts, unleashing a pleasing torrent of fruity seed across your predatory maw. You happily nurse his twitching dick, absolutely unwilling to let a single lascivious drop of fruity delight go to waste. Greedily swallowing every ounce of his virile offering, almost cooing with elation as your tummy stretches to accommodate his glorious load.";
				say "     As the masterful touch of the two cunning linguists attend your sordid sex pushing you over the edge, fireworks and monochrome stars erupt across your vision. Your quivering cunt spasms and squirts a generous stream of fem honey mixed with blueberry cum across the faces of your jovial cunt polishers. Utterly spent, you simply lie there contentedly surrounded by the plush fuzzy bodies of the cowed bats as you nurse the lead bat's cock, luxuriating in the afterglow and the pleasingly toasty weight of their loads wallowing in your tummies as their little paw hands worship your raw scales. Looking rather tired but nonetheless happy, the lead bat eventually, yet reluctant, slips his softening dick free of your maw. He cuddles up beside you, murmuring vague praise as he nuzzles his head along your collarbone like a doting thrall. In no mood to move just yet, and rather pleased by their performance, you allow them to snuggle next you and let the sound of waves and lovely songs of the shore birds wash over you as you bask in the available light.";
				WaitLineBreak;
			say "     [italic type]An unknown amount of time passes[roman type] and you eventually fall asleep in their arms. When you at last wake up the bats are gone, along with all your stuff! Shit! You curse looking around you see neither hide nor hair of them, though you do find your things some distance away, tucked neatly beside the trawler. Rummaging through your gear, you find nothing is missing though a few tasty peaches and a crumpled yellow sticky note has been mixed with your junk that reads: 'See you around Miss Dragon, X.O.X.O -The Zee Batz.' Shrugging at the odd name, you collect your things then turn your attention to the trawler and the Gill Fruit Tree. Which thankfully has been left untouched. A part of you is a bit surprised by this, you would have expected the bats to stabaged the plant before they departed as one last act of petty vengeance. They must be afraid of angering a dragoness of your stature, or you must have made a good impression on them. Not that it matters to you, you have a job to do after all.";
			say "     With the area now clear, you begin to clamber aboard what's left of the trawler, only to hear the weather-beaten wood groan in protest at your tauric weight. At first, you pay it no mind, and try to push on, this puny human vessel be damned, though, as the great Gill Fruit tree begins to sway as the hull shifts around its tangled roots ever-so-slightly, you halt in place. Recalling Galaxite's warning that the moment one fruit falls, all the remaining fruits will drop and anything that hits the ground or water will instantly rot, you hurriedly leap off the keel in frustration. Grumbling under your breath, you wonder what you should do, call the sea dragons? No, you muse, remembering the ape's words that her children lacked the deft touch needed for this job. Perhaps, you could use the lines to lasso them, or a section of net to grab them. Yet if you missed and somehow disturbed the tree, failed to pull them in in time, or damaged them, this whole venture would be for naught, you opine, feeling your forelimbs clench in raw annoyance as a strange yet all too familiar thrum of static builds in the shapely muscles as they tense than untense in a wild tattoo beneath your scales.";
			now Charisma of Galaxite is 1;
			say "[Rejecthumanityandreturntolizard]";
		-- "No, you do not truck with inferior beings.":
			say "     On second thought, you have no desire to sully your regal form with the touch of these weak, pitiful, lesser beings. They do not deserve the honor of pleasing a dragon of your stature! You muse, eyeing up their pathetic soft scaleless hides and meek effeminate frames. You decide to let loose your hold on the pinned creature before some of their weakness taints your draconic majesty and deliver your ultimatum. ";
			if "Vore Predator" is listed in Feats of Player and "Touched by Madness" is not listed in Feats of Player:
				say "Fly little mouse! And be grateful that you have no taste for man flesh this day! "; [Slyrak said, calmly. https://youtu.be/SN07XVqfBko?t=60 ]
			else if "Vore Predator" is listed in Feats of Player and "Touched by Madness" is listed in Feats of Player:
				say "Flee striplings, and be thankful the editor has no love for vorny content! ";
			else:
				say "Leave now, You snarl baring your saber-like fangs, or you will show them what happens when you get between a dragon and their prize. ";
			say "'Fine-fine we'll go. You *cough* can take the stupid fruits you crazy scalie bitch!' the bat that you were just standing on croaks, massaging his throat as he picks himself up off the ground.";
			say "     'Right, you lot you heard 'em, let's go,' the little mouse bellows as he takes to the air. He is swiftly followed by his limping comrades, though they struggle to stay aloft. Despite the nanites['] efforts, their bodies can barely handle the stress of flying. More than once, they tumble and sputter in the air like baby birds caught in a storm. Nevertheless, you mirthfully watch the wretches go, not fully convinced these disgusting flying rats won't try something. They never do though and merely disappear over the top of the nearby hills panting and wheezing with the effort. Still you wait, your eyes glued to the horizon for the next few minutes. Only when you hear the sound of shore birds return to the area do you at last relax and turn your attention to the task at hand.";
			WaitlineBreak;
			say "     With the area now clear, you begin to clamber aboard what's left of the trawler, only to hear the weather-beaten wood groan in protest of your tauric weight. At first, you pay it no mind, and try to push on, this puny human vessel be damned, though, as the great Gill Fruit tree begins to sway as the hull shifts around its tangled roots ever-so-slightly, you halt in place. Recalling Galaxite warning that the moment one fruit falls, all the remaining fruits will drop and anything that hits the ground or water will instantly rot, you hurriedly leap off the keel in frustration. Grumbling under your breath, you wonder what you should do, call the sea dragons? No, you muse, remembering the ape's words that her children lacked the deft touch needed for this job. Perhaps, you could use the lines to lasso them, or a section of net to grab them. Yet if you missed and somehow disturbed the tree, failed to pull them in in time, or damaged them, this whole venture would be for naught, you opine, feeling your forelimbs clench in raw annoyance as a strange yet all too familiar thrum of static builds in the shapely muscles as they tense than untense in a wild tattoo beneath your scales.";
			say "[Rejecthumanityandreturntolizard]";

to say ZeeBatBrawlRanAway:
	say "     Sensing the tide of battle turn against you, make break for the rubble wall. Quickly scramble up the rock pile, you sprint back down the otherside then make a break for the wild fringes. Lucky for you, the bats don't appear that interested in pursuing you in earnest. Appearny content with whipping they gave you, the swarm merely follows you from a distance for a short way then they seem to give up. You're not sure why they could have easily caught you at any time. A part you guess they just wanted to keep their tree safe, or perhaps they think you're a diversion. Either way it doesn't matter, you failed in your quest. ";
	if "Touched by Madness" is listed in Feats of Player:
		say "Your only choice now is to undo, reload, or persist in this doomed timeline you have created.";
	now Ruined Trawler is resolved;
	now Energy of Galaxite is 0;

to say ZeeBatBrawlLose:
	say "     Succumbing to the bat's combined assault, you collapse before them. As you lay there beaten and battered four of the angry ferals leap upon your weakened form. Each one grabs hold of one of your limbs then takes to the sky with pronounced difficulty due to your tauric bulk. 'Think we should drop on the rocks, their corpse could serve as a nice warning the next time someone comes around?' One of the bats carrying you asks aloud. 'Nah, then we'd smell them rotting for the next few weeks.' Another bat replies. 'How about throwing them to pirate sharks then? They might like a new plaything?' A third back says as they sails over the shallow bay. 'Ha now that's a thought! Hey asshole, how do you feel about having your poop deck swabbed by a bunch of pent up double dick sharks herms?' One of the bats carrying your legs jeers as they circle over the rocky arch. Before you can respond though, the mutant let go of you. All you can do is scream as you plummet to the water, accompanied by the roar of the bats' laughter. The fall though is at least mercifully short and thankful you hit a rock free section of the bay with a loud splash.";
	say "     Completely unable to move your limbs from the pain of the impact of your nasty belly flop. For a moment all you can do is float there in a mild state of shock. Soon enough, you nanites kick into action as they set about repairing the worst of the damage. In no time, the feeling returns to your extremities and you swim back towards shore. Just in time you realize, as the silhouettes of several shark fins break the surface of the surface then race towards. In no state to fight, you push yourself harder. With every stroke, your chest burns, heart pounds like it were about to burst, from the combined effect of shock and the lingering effects of the fall. Still though, you force yourself onward and only allow once you've safely hauled yourself back to shore. Do you at last allow yourself the luxury of passing out. ";
	if "Touched by Madness" is listed in Feats of Player:
		say "Your only choice now is to undo, reload, or persist in this doomed timeline you have created.";
	now Ruined Trawler is resolved;
	now Energy of Galaxite is 0;

To say Rejecthumanityandreturntolizard:
	say "     Perturbed, you look down in time to see your chromatophores whirl in chaotic ballet of many colors and none as the scales along your [']waist['] seem to bulge then spread as a pair of raw bony palmate growths poke free then expand out as if they were a fan being pulled open by some unseen hand. Despite these changes, your liminal mind registers neither fear nor revulsion, only a sense of mercurial calm even as the webbed, waxy, blue flesh laces between each finger-like point and pulls the new limbs into a more recognizable shape. Wings, you whisper in muted awe, watching your scales flow over them like a vibrant tide of the purest azure, and grow all the larger still, with it comes an eager sensation of anticipation as the newly forged limbs tower over your head.";
	say "     Intrigued, you experimentally trace your paws along their sleek contours, marveling at their size and the odd multi-jointed structure of the underlying cartilage-esque bones lining them. Flexing one with a mix of trepidation and awe, you find them not just bendable, but highly articulate as the exotic flesh responds effortlessly to your every command. Tucking them tightly to your side, you realize that despite their size, your hydrodynamic nature remains uncompromised as the exotic viscous oils coating you seems to form a sort of barrier. Though such an adaptation, despite its usefulness, means little if they can't bear you aloft, you muse, tentatively flapping them beside you. The motions feel awkward at first as the lingering fragments of your human mind rages against this latest change, but you push on regardless, trying to mimic the bat's vertical take off, though with a pronounced clumsiness as your tauric body seems far too heavy for such a feat.";
	WaitLineBreak;
	say "     Undeterred, you try galloping about the sand bar to build up speed before launching yourself into the air. Aided by the added momentum, you manage to glide along on the light breeze coasting along the shoreline, but only for a few scant seconds before you're brought tumbling down to earth in a less-than-controlled fall. Unwilling to admit defeat, you wonder perhaps instead of flying, you try focusing on gliding them instead. That at least should be a much simpler task, one made all the easier by the high sandstone rubble wall strewn across the shore. With the added elevation it affords you, it could give just enough time to swoop down and claim either branch or bundle fruit, you think to yourself, as you pick your way up the loose slopes and wait for the breeze to shift in your favor. All the while you study the tree looking for the right branch, path you need to take. When moment comes and the breeze turns in your favor, you loose a proud roar and leap into the wind, angling for one of the lower branches.";
	say "     Too late though, you realize that you misjudged both your strength and the gusts carrying you aloft as you began to sail past the tree. With mere seconds to correct yourself, you twist and contort your body midair and slingshot yourself around its trunk. You grasp hold of the nearest breach, trusting in the bite of talons and raw bestial might of your liminal body as you tear the massive limb free with a resound crack that rocks the whole tree. As the remaining spoils falls like rotten hail on a tin roof, you glide past the decaying thing, fruit laden branch still clutched your paws and land in the nearby surf with only a light skid. Not bad too for your first [']flight['] in this form, you preen internally, watching the other fruits boil away in the sand and waves. True, a part of you bemoans theirs and the tree's demise, you muse, observing the once vibrant wood blackening like a blighted wound, still you have what you came for. The loss of the tree is such a trivial thing compared to your promised reward, you ruminate, plucking a bushel of six Gill Fruits from the rapidly disintegrating branch and stow them away in your inventory.";
	WaitLineBreak;
	say "     After they're secure, you leap you atop the rubble wall once more, propelled by a flap of your mighty wings, and bellow the words the lowly monster girl taught you. [italic type]NAXOKAAZTHUR![roman type] You roar as the sea starts to broil then darken, and sinuous serpentine shapes begin to coil through the surf like umbral narcotic veins. [italic type]NAAL FAAL HEN KLOV![roman type] You shout as the clouds begin to fall into shadow and the sky dims. [italic type]GEIN LOS HI BEL![roman type] You intone as the thunderhead gathers about you like a curtain being drawn over the Wild Fringes, yet you see neither hide nor fang of the little human's brood. Growling at their impudence, your roar once more, [italic type]NAXOKAAZTHUR! NAAL FAAL HEN KLOV! GEIN LOS HI BEL![roman type] Seemingly fueled by your shout, inky black rain pours from the sky, pelting the sand with a hiss oily patter as the ebony droplets evaporate in scintillating mist of unnatural hues. Yet despite the biting chill, your abyssal form is impervious to the void wrought cold as the eldritch rain pours harmless off your majesty in steamy black viscous rivulets.";
	say "     As a storm rages across this lonely, forgotten place, streaks of black lightning lick across the clouds['] billowing edges like the pulse of some great creature and the resounding claps of thunder wash over you as if it were the labored breath of a far off giant. Above it all, a choir of brassy voices cut through the storm, 'Gah Kai Monah,' as the surf churns in a whirlpool of velvety blackness, sanguine reds, and luminous azure blue hues before you. Intrigued, you watch the colors coalesce into distinct shapes as six of the largest feral sea dragons you've ever seen burst from the waves. Many fathoms taller than the mindless wyverns polluting the skies above the city, the regal wyrms tower over the decaying tree as their ivory horn rend the stormclouds. Enthralled by the sight, you watch the sea water cascades off their sleek scaled hides like ebon shackles as they pull themselves to shore, while laurels of fell lightning waltz up their lustrous [one of]azure[or]sapphire[or]cobalt[or]royal-navy-blue[or]aquamarine[at random] hides and imposing horns.";
	WaitLineBreak;
	say "     The tide coils and ripples with passage, as six sets of blazing red eyes turn towards you, bellowing, 'By the High Cant are we called. Zaal Haal hen klovve fen dreh mal laam! By the pact of the five heads. Do! We! Serve!' in unison as they crawl up from the shore. Their every step shakes the sands and causes nearby wreck to groan as the crowd around in a semicircle, then dip their heads in reverence to you. 'Tell us Kai Monah, for what purpose have you summoned we Naxokaazthur?' one of the Sea Dragons situated at the center of the shoal queries, his deep articulate baritone voice cutting the gale like an icy blade. Smirking at their display of proper submission, a part of you can't help but be impressed with the little human's regal spawn as you absentmindedly paw at your middle at the thought of dominating such virile specimens of dragon kind[if Cock Count of Player >= 1]. Perhaps, you might even consider whelping their mother as well, who knows what manner of titans such a coupling could produce, a quintet of slithering voices tempts from the back of your mind[end if].";
	say "     Still, such idle musing will have to wait, for now you inform the wyrms of your purpose and command them to serve theirs. 'At once, kau of the five heads, brothers,' the wyrm rumbles as he turns to face his kin, loosing a harsh guttural stream of bestial barks like the crashing of rocks and the gathering of storm clouds, whose meaning is lost on the lingering fragments of your monkey brain. 'Gah zunmah!' the other dragons roar in animalistic jubilation as they set about tearing up the trawler with great slashes of their talons and heavy wacks of their tails. Though their methods of deconstruction appear outwardly brutal and bestial, your draconic mind notes the assembled Sea Dragon's strikes are far from thoughtless as they aim at critical joints and the tangled root balls with clinical precision. All the while, avoiding the valuable lines and nets with a level of care that belies their feral origins. Still, you can't deny that they seem to take an odd bit of glee in their destruction of both the tree and trawler as their blows shower the area in splinters and rusted metal fragments."; [Gah zunmah = Yes Brother]
	WaitLineBreak;
	say "     You can see now why their mother wanted to hold them back. If you hadn't been patient, they probably would have just crushed the boat to take out the bats. As you watch them awkwardly gather up their webbed paw like hands, a part of you wants to offer to help them out, but such menial labor is beneath you, best leave it to them, you muse, as you make ready to leave when you remember the gill fruits in your inventory. Reasoning that the little half-monkey only needs one of them, and that her spawn can likely get them to her faster than you. You wave one of them over with a commanding bat of your talons. Seeing your gesture, one of them bounds its step shaking the sandbar beneath you. 'Gah zen kin,' he pauses, his crimson orbs narrowing in a brief look of contrition before composing himself once more, 'yes true kith, what more do you ask?' the dragon says in a deep menacing voice as its hot fishy breath coils about you like an oppressive fog. Clearing your throat, you state your demand and present him one of the fruits. For a moment the sea dragon sits unmoving as it thinks over your request then rumbles, 'Mhh it shall be done zen Seradovah.' As it reaches out with its claws and far more gently than you would expect from a creature its size plucks the fruit from your hand."; [ zen Seradovah = True snake dragon or creature of temptation and deceit who wears the face of a dragon, yet whose name does not echo in the storm.]
	say "     Clutching the prize lightly in its webbed paw, the creature lumbers back to water, then pauses, rumbling, 'Ah a word Kai Monah,' as he glances over his toned armored shoulder at you. Nodding, you bid it speak. 'Our mother's preparations for this Nier will soon be completed, when you are ready, meet us at the Rocky Arch, [italic type]they[roman type] shall be waiting,' it informs you then silently slips beneath the waves without even making a splash or waiting for your reply. Shrugging and satisfied that you're no longer needed here, you decide to begin the long walk back to the beach. Thankfully, you know the way a bit better now. You make good time compared to your initial trip, though it's still a bit of a slog, but with the aid of your wing you soon make the beach proper without either fanfare or incident. Now, you just need to find Galaxite beyond the Rocky Arch, or you could spend some time preparing for her [bold type]Nier[roman type] as the Sea Dragons called it, who knows what you'll face out there after all.";
	now Ruined Trawler is resolved;
	now Energy of Galaxite is 2;
	ItemGain Gill Fruit by 4;
	now Hunger of Galaxite is 5;
	if Charisma of Galaxite is 1:
		ItemGain tasty peach by 4; [A gift from the bats if you bone them.]


Table of GameEventIDs (continued)
Object	Name
Break Water Heist	"Break Water Heist"

Break Water Heist is a situation.
ResolveFunction of Break Water Heist is "[ResolveEvent Break_Water_Heist]". It is inactive.
Sarea of Break Water Heist is "Beach".

to say ResolveEvent Break_Water_Heist:
	say "     Hiking around the Rocky Cliffs, you spot a large concentration of ten or so very large Feral Sea Dragon fins swimming about the feet of Rock Arch leading towards the open water and the wider world. Under most circumstances, you might consider leaving them alone, yet something about them seems... familiar, if such a thing were possible, you muse, then it hits you. Those must be Galaxite's pod, swarm, shoal, flight, thunder, tyranny, or whatever you call a group of interrelated sea dragons. At least that's what you assume, as you can't see the local beach goers ignoring the presence of so many feral sea dragons this close to the shore. With a bit of trepidation, you decide to head over to the water's edge and see what's going on. Sure enough, as you get nearer to the shoreline, you spy the now much slimmer form of Galaxite swimming between them. From where you stand, she appears to be checking and rechecking a number of high tension trawler cables tied to the dragon's tails. Realizing she must be getting ready to leave for her Break Water Heist, you wave your hands and call out to her.";
	project Figure of Galaxite_clothed_icon;
	say "     Though it takes a few hollers for you to get her attention, Galaxite's finned ears eventually start twitching as she picks up the sound of your voice over the sound of the waves and background chatter. Swiveling her head back and forth, she quickly locks eyes with you yelling, 'Oh hey [Name of Player], great timing! I was just about to go looking for you,' as she bobs in surf gesturing one of her nearby ";
	if "Touched by Madness" is listed in Feats of Player:
		say "[one of]crotch spawn[or]fuck trophys[or]crotch goblins[at random] ";
	else:
		say "draconic brood ";
	say "to her side. The bestial being nods its head saying, '[']Ae makuahine,' as it ducks beneath the waves, the massive leviathan's vast shadowy form roils beneath the waves, till its head hovers directly below her svelte form. You then watch with a small sense of awe as her shimmering bronze form is lifted out of water by the creature's ponderous, large, imposing visage as he barrels towards the shore.";
	WaitLineBreak;
	say "     The ocean churns and roils wildly as the massive creature's body cuts the surf, sending walls of clear curling water streaming towards the shore while his mother stands proud and unmoving atop him. Even though she's wearing nothing but a blue string bikini, bestride the titanic sea beast, the cocksure woman looks like some kind of conqueror returning from a long campaign as her rich raven-black hair billows behind her like a cloak. Though as they get nearer, cries of alarm erupt as people grab their things scurry away from shore, screaming in raw terror at the sight of the great leviathan. [if Perception of player >= 20]As she gets closer, you watch her lips peel back far further than should be possible for a human as her cheeks are pulled past her ears into predatory smirk, revealing row upon row of dagger-like fangs growing in place of her molars. Almost as if she relishes the fearful looks people give her as her child beaches itself on the water edge[else]Growing closer, an amused, yet aloof look blossoms her lips at the needless panic caused by her over-dramatic entrance as her son beaches their titanic frame upon the sands[end if], and filling most of the beach with his regal serpentine form.";
	say "     Galaxite leaps from his head and lands beside him with a muted swish and you notice that her chest has dropped back to the shapely perky C-cups she had when you first met her not all that long ago. Perhaps it's a quirk of her quasi-reptilian nature, or some esoteric facet of her aberrant infection you muse offhandedly as the great sea titan, prods somewhat awkwardly along the shifting sand besides her, while sending large ripples tearing through the waves. The ground thrums with the weight of his passage as her loyal child bows before you rumbling in a brassy storm wrought tenor, 'Rem Kol Kai,' touching his serpentine chin to the surf, ";
	if Hunger of Galaxite is 0:
		say "'kau a ko[']u makuahine. Have you come to join us in this Nier?' Nier? You question, unfamiliar with the term.";
	else if Hunger of Galaxite is 1:
		say "'Qunaar. Have you come to join us in this Nier?' Nier? You question, unfamiliar with the term.";
	WaitLineBreak;
	say "     'Ah, rosus kin da mun, endless pardons, child of man,' the Dragon rumbles in what could be called an apologetic tone as the sea roils in tandem with the deep base of his perfect reptilian voice. 'My desire for telvox overcomes me at times, it is improper to expect a being of your... limited facilities to comprehend the deep places of the Naxokaazthur, or the High cant of the Ullokinne,' he preens, a bit too proudly. 'In this base tongue of man, I believe the rough translation of Nier would be,' he pauses and clicks his fangs like a croc taunting its prey, 'hunt. It pains me,' he rumbles, briefly casting his gaze to the ground, 'I can't provide you with a proper translation kin da mun. Too much is lost in the winnowing of words to fit the bright shallow shoals of your mind, mayhaps my wise makuahine,' the dragon chirps lightly touching the edges of his nose against Galaxite's palm, 'can elucidate you further one day. Her soul resonates with the storm and the will of waves.'";
	say "     'Daw, thanks hun but,' Galaxite chides in a sweet tone, playfully booping her son on the snoot, 'please don't talk down to [Name of Player]. Not everyone can be born perfect like you guys.' 'Rosus makuahine, zinii zul, I meant no disrespect to the one who returned you to us. We had... begun to fear your voice had joined the storm,' the great wyrm mutters, his voice nearly cracking with almost human notes of sorrow as he lowers his eyes to the surf in what you feel is either a gesture of contrition or submission. 'Eh, sorry about all that kin da mun, my beautiful boys tend to forget not everyone knows dov-, *ahem*, their language,' Galaxite coughs, rubbing the back of her head in embarrassment. Shrugging, you diplomatically tell her not to worry about it, and ask if she's ready to go. 'Almost, I was just triple checking the lines. *Sigh*,' Galaxite huffs, blowing an errant lock of hair from her eyes, 'but the salt water did not do the cables any favors,' she says, motioning to the bundles of algae-tainted jute tied to the Feral Sea Dragons tail fins waiting in the surf."; [Rosus makuahine, zinii zul = I'm sorry mommy, you're right.]
	WaitLineBreak;
	say "     Curious, you ask if that will impact her heist in any way. 'Well,' Galaxite says, tucking her arms behind her back as she nervously rocks on her heels sending a distracting wobble through her chest. 'We may end up having to leave some things behind, but really we won't know till we get there.' Fair enough, anything else you can go to help you inquire in an even tone. 'Nopers,' Galaxite shakes her head, 'I'm pretty sure everything's set. If you're ready we can hop on Nui-Koa's back and head out,' she asks with a waiting look on her face as she points her hitch hiker's thumb at the dragon sitting prostrate behind her. [italic type]What would you like to do?[roman type]";
	LineBreak;
	say "     Author's note: backing out now, losing fights, submitting, or running fails the event chain. There are no second chances, fight well, ";
	if Hunger of Galaxite is 0:
		say "kin da mun.";
	else:
		say "Qunarr.";
	LineBreak;
	let Looting_Time_Choices be a list of text;
	add "Wuss out." to Looting_Time_Choices; [God damn it Deb!]
	add "Go on the heist." to Looting_Time_Choices; [The only correct choice]
	let Looting_Time_Choice be what the player chooses from Looting_Time_Choices;
	if Looting_Time_Choice is:
		-- "Wuss out.":
			say "     Shaking your head, you tell her that on second thought that you have changed your mind and won't be going with her after all. 'Oh well, suit yourself Deb, more treasure for us I guess,' Galaxite pouts leaping on the back of Nui-Koa. She motions for him to go with a light tap of her heels against his burly neck frills. The elegant wyrm casts a brief look of disappointment in your direction, then shuffles off to sea and swims off towards his kin without sparing you a second glance. Once reunited, the collection of dragons dive below off the wave, vanishing from sight. With no way to track them or even a rough idea where they're headed beyond [']somewhere past the break water['], you head back to the beach proper to plan your next move.";
			now Break Water Heist is resolved;
		-- "Go on the heist.":
			say "     Heck ya you're ready, who knows what sort of cool stuff you'll find! 'That's the spirit [Name of Player],' Galaxite beams as she directs your attention to the base of Nui's neck. 'Now a little bit of advice, don't sit anywhere but Nui-Koa's shoulders. It's no problem if you put your weight on his cute little sail here,' she says, patting the slight depression in her son's body where his neck and shoulders meet. 'But everywhere else is very sensitive, so please don't grab it unless you absolutely have to,' Galaxite says, brushing her fingers along the shimmering aquamarine membrane. 'You can use his spines as hand grips too, but they are very very sharp. So just be careful if he has to make any sudden stops or turns, I don't want you putting an eye out,' she instructs, tapping one lightly with her pointer finger. 'Got all that?' Galaxite asks, as she begins draping her shapely leg over the large Sea Dragon's neck like it were a saddle. 'Mother please, must you address me so before the ";
			if Hunger of Galaxite is 0:
				say "kau?' Nui-Koa grumbles tucking his snout under his webbed forepaws like a child being unduly fussed over.";
			else if Hunger of Galaxite is 1:
				say "Qunaar?' Nui-Koa grumbles tucking his snout under his webbed forepaws like a child being unduly fussed over.";
			say "     'Daw don't get so bent out of shape dear, our friend here probably doesn't know their way around big hunky derggy boys like I do,' ";
			if Loyalty of Galaxite is 0:
				say "Galaxite teases, draping her arm over his sail-like ears as she arches her back in your direction, giving a nice view of her cute puffy camel toe straining against her bikini bottom as she scratches some hidden patch of scales. ";
			else:
				say "The whorish monster lady tuts as she platonically pats her son on the back of the head. ";
			say "'Zinii zul, you speak the truth,' Nui-Koa says blushing as much as his light blue scales will allow. 'Come then ";
			if Hunger of Galaxite is 0:
				say "kau ";
			else if Hunger of Galaxite is 1:
				say "Qunaar ";
			say "let us depart,' he says, motioning for you to mount up with a bob of his regal visage. 'Though I warn you, once you have experienced the kai on the back of a Naxokaazthur, I fear your envy of dragon kind will only increase!' he preens over a pleased inhuman chuff. Well, if he says so you proffer, seating yourself behind Galaxite. You wrap your arms about her smooth hourglass waist and indicate your readiness. 'Alright hold on [Name of Player]!' Galaxite cries, gently tapping her heels against her son's beefy neck, signaling for him to go.";
			WaitLineBreak;
			say "     'At once makuahine!' Nui-Koa roars, springing to his lumbering feet. The hulking dragon dives into the surf without even making a single splash. Utterly at home in the waves, his sleek body cuts through the water like sailfish chase its prey. Much to the beach goers relief, as they slink out hiding and begin meandering back to shore. You hardly even have time to blink before he's rejoined his kin at the Rocky Arch. Coming to a quick stop, eleven sea-born titans begin to crowd around you and Galaxite in a protective circle, though one soon breaks from their number and swims next to Nui-Koa, saying, 'Rem kol kai upon you Eldest, I shall ferry our makuahine from here,' as he dips his head reverently below the waves. 'Rem kol kai-,' your mount begins then seems to hesitate as he glances back at you then adds, 'Peace of the heavens and sea upon you [']Imi-Koko, Blood-Seeker, protect her well,' Nui-Koa answers, paddling beside his kin. The two bob mere ";
			if "Touched by Madness" is listed in feats of Player:
				say "centimeters ";
			else:
				say "inches ";
			say "from one another as Galaxite hops from Nui's shoulders to [']Imi-Koko back. Seemingly unbothered by gentle rocking of the waves, she casually strides upon his back with practice before seating herself on his while her hand drifts to her shoulders. 'Oh shi-' she hisses as she paws at the straps of her top, 'sh-ship, knew I forgot something. Hey Nui uh, would you be a total sweetie go on ahead, and have some fun with your new friend for a sec? I just realized I left my kit on the ocean floor, I'll be along in a minute,' she says, nodding her finned head towards the Arch.";
			say "     'Gah, as you command makuahine,' Nui-Koa replies as he lets loose a deafening roar and bolts for the Arch accompanied by the other Sea Dragons. Though the sudden acceleration nearly throws you off the dragon's back, you have to admit that the feeling of the wind whipping ";
			if FaceName of Player is listed in infections of Caninelist:
				say "through your canine jowls, sending them fluttering in the wild breeze, ";
			else:
				say "across your face, ";
			say "and sheer speed of your mount is a rush that few thrills can match. Forget jet skis, parasailing, or roller coasters, from now on your riding dragon back! While Nui-Koa, perhaps picking on your mood, begins banking and diving about the surf like a living amusement park ride as you tear through the placid azure waters. Oh what the heck you only live once, WHEE!! You roar in pure childlike joy as him and the other leaps through the air like Flying Fish. They sail the length of several American football fields before crashing belly first into the deep blue. The impact kicks up a huge rolling wave that rockets towards the shore. Looking back, you can see the beach goers run for cover as the wall of water approaches.";
			WaitLineBreak;
			say "     A few brave surfer ";
			if "Touched by Madness" is listed in Feats of Player:
				say "shorks "; [do-do-da-do]
			else:
				say "sharks ";
			say "bellow with delight as they grab their boards and leap into the water with wild abandon. They paddle out each one racing against the other to be the first one to catch one of the largest waves the coast has seen in decades. Though none even get other as the lurid shadow of [']Imi-KoKo bursts from the depths ahead of the pack. Roaring in triumph, his massive hydrodynamic form cuts through the huge wave, as he darts up the side of the sapphire curl of the crashing wave till his angular head crests the foaming lips of the wall of water. He loops back around on himself like a gleaming ouroboros symbol, then plunges through the mighty wave and bursts out the otherside while his mother screams. 'Woo-Hoo! [bold type]BEST FREAKING APOCALYPSE EVER![roman type]' as they dive back below the surf. You observe the fast moving shadow of [']Imi-Koko speed towards you along a crazy zigzagging path.";
			say "     They eventually breach the surface right behind you and fall into line with the other dragons who cluster protectively around her and you in a diamond formation. As Nui-Koa and [']Imi-Koko drift to the center of the group, you notice that Galaxite is now wearing some sort of bright orange dry bag and scuba belt with a collapsible nightstick hooked to it. Curious about what she is carrying, you ask what's in her bag. 'This,' Galaxite taps the right shoulder strap, 'nothing major, a little thermite, some questionably legal bolt cutters, manual charger, a few marine flares, a six pack of water bottles, a hand torch, some D.I.Y healing booster the Old Man showed me how to make, and most importantly of all, Pockys!' She snickers, shuffling the bag from her shoulders then deposits it in her lap. She hastily undoes the zipper, and pulls out a ziplock bag packed to the gills with thin biscuit rolls dipped in dark chocolate. 'See,' she beams, giving the bag a light shake to separate the confections before pulling out and tucking chocolate first between lips.";
			WaitLineBreak;
			say "     Wait Old Man, who's that? You question in an effort to kill time as the shoal of dragons races past the break water to parts unknown. 'Oh,' Galaxite sighs, rolling her golden eyes, as she tucks her arms behind her head and stares listlessly at the sky. 'Just some ancient fuddy-duddy I used to run with at the start of the outbreak. I mean ya he was smart, knew a lot about survival stuff, but he was so *gah*!' she huffs, as her snack bounces between lips, 'prudish all the darn when it came to playing with the infected! He would go on and on about how the infected can't give informed consent. That we have to treat them with respect, and simply release them from their torment, because that could have been us and blah, blah, blah,' Galaxite grumbles in almost petulant cadance, twirling her pointer finger in a conical fashion. 'I don't know what he was going on about though. If they weren't down to play then why do they put out at the drop of a hat?' she rumbles, as prismatic motes light reflecting off the water plays upon her sylvan features.";
			if BodyName of player is "Margay Taur" and Player is pure and Cock Count of Player is 0 and Cunt Count of Player >= 1 and ScaleValue of Player is 5: [She's talking about Drake, Old One Eye, and Ava here.]
				say "     'Not that the boy scout cared, the ol['] grumpy Gus was always shoot first, ask questions never, even when the ferals weren't much of a threat,' she huffs in exasperation as she nips the ends off her impromptu meal. 'Why, this one time we ran into this super cute ocelot tauress near the State Fair,' the monster girl swoons, nibbling away on her confection. 'Gosh she seemed so sweet and fluffy, she must have been the size of an overpass with these huge rows of sweater puppies you could practically swim through and this adorable little muffin top,' Galaxite gushes in open admiration, holding her free hand out in front of herself as far as she can without upsetting her balance as if to demonstrate the feral's size. 'Gods, think of the eh-,' she pauses to look down at her son beneath as her face blushes a deep crimson. '*Ahem*, [italic type]hugs[roman type], that beauty could give. I mean she was no dragon, but mh,' Galaxite purrs in a deep reptilian tribble.";
				WaitLineBreak;
				say "     'I would have loved to snuggle up in those big soft arms, or rest my head on her warm pillowy tummy for a few hours while her lush silky tail coiled around like a huge fluffy snuggly blanket,' she gushes, briefly wrapping her arms about her svelte figure. 'And she wasn't even hostile either, though she did try to get a little handsy with Mx,' your partner in crime says with a casual shrug. And Mx is? You inquire. 'Someone I met through the Old Man, we didn't talk much, but I got the feeling they had a bit of history together, if you know what I mean.' She smirks, cupping her free hand in a circle, casually dandling it in the air beside her head. Right, you reply motioning for her to continue. 'Ya anyways they are, or were what people call shifters at least before they disappeared looking for some place called The Void, whatever that is.' Unfamiliar with the phrase you ask them to elaborate. 'Uh huh,' Galaxite hesitates a moment, ear fins flickings ever-so-slightly against the side as she thoughtfully purses her lips before continuing.";
				say "     'I guess you could think of a shifter as someone who's not able to take new forms without immediately losing their mind, but gets stronger, faster, smarter too. It's a pretty rare ability though, most shifters don't last too long either because they end up getting lost in the sauce or finally settle. Poor Mx though was on their way to the former, though they tried to hide from the Old Man,' she says, her eyes dip down to water lines as tosses the remains of her pocky into the sea and absentmindedly pets her son's gleaming sail. What makes her say that, you ask. 'Oh you know little things at first, a growl here, a bark there then,' she sighs loudly and deeply. 'They started comparing the urges their forms gave, tried working which blend of species would give them the great odds of survival, and what heats felt the best. I guess that's why the big kitty tried pouncing them. Mx must have smelled right cause I could have sworn I heard them call Mx [']daddy['], before the Old Man, well, shot her,' Galaxite peeps, pantomiming a handgun firing into the air.";
				WaitLineBreak;
				say "     'He almost took her head clean off with that tank buster of his, probably would have finished her too if I hadn't stood up to him. That gave the poor meowy face a chance to scamper off, but we never saw her again.' Interesting, you rely on a neutral diplomatic tone, so next you begin to inquire only to be interrupted by a throaty rumble from [']Imi-Koko as he cuts in, saying, 'Apologizes makuahine but we are nearing the wreck, and we do not appear to be alone,' as he bobs his head towards the horizon. Squinting, as you look out across the waves you just barely make out the silhouette of a large ship listing out the water like it were beached on something just below the waves. Getting closer, you recognize the ship as an old stocky T-AOE supply craft. Though the design was largely decommissioned a couple of years ago. Though recalling a news article you once read in passing, the design is currently in the process of being decommissioned; someone has clearly gone to great lengths to up gun the thing.";
			else if Loyalty of Galaxite is 0:
				say "     'Anyways, the group eventually broke up after him and Vix kept getting into fights over what to do with the infected.' And Vix is? 'A gray-furred Succufox herm or that's what she, er shi, xi, or is it hir called themself,' she shrugs. 'Gosh I miss that fluffy fox they-,' Galaxite stammers, her voice petering off to a timid whisper, as her golden eyes drift between her children and an embarrassed look blossoms on her face. 'Hey sweeties,' she hums, leaning over the side of her child to look him in the eye, 'mommy needs to have a bit of private conversation with her friend here, would you beautiful boys mind oh you know?' she simpers, tapping her ears. 'Geh Monah!' the assembled wyrms growl as they tuck their fins tightly along the side of regal visages. 'Thanks hun,' Galaxite mouths wordlessly before turning her attention back to you. 'Sorry about, I know people have gotten pretty loose with the whole [']end of the world thing['] we got going on, but I don't want to set a bad example for my widdle scalie angels here,' she titters in a doting matronly tone, as she bobs her towards her brood. Shrugging, and in no mood to debate her parenting style, you motion for her to continue.";
				WaitLineBreak;
				say "     'Right, so as I was saying, I don't where Vix picked hir form up, but boy the nanites really must have agreed with hir,' she rumbles, as her lips curl into a broad vivacious grin. 'Shi had super soft steely-gray fur with a cute little white splotch on hir tummy, a beautiful long bushy tail you could wrap yourself in, smoldering magenta eyes, and don't get me started on that juicy cock of hirs. Mh,' Galaxite purrs, as her lips caress the sweet treat tucked between them. 'Gods, hir pre tasted delicious, it was so salty and just the right kind of creamy and dry. If their milk didn't taste so gosh darn good, I might never have let hir finish in me, but there's nothing like fresh from the tap, and hir udder made such a great pillow,' she swoons, as her left hand drifts to her toned svelte midriff. Wait udder, you thought she said Vix was a fox, or Succufox as she called it. 'Oh right, well, Vix was packing more than the average mutant I guess. Don't know if shi was a deliberate hybrid, made a deal with someone like that cute jackal lady at The Mall, or if shi's a chimera who survived the initial chaos at the start of the outbreak, but I'm not complaining!' Galaxite simpers.";
				say "     'Whatever the case, hir strain gave hir access to some kind of... demon magic?' She shrugs with a quizzical look on her face, 'Shi could throw fireballs, create illusions, and move stuff with hir mind, even let me grow a big fat dragon cock and try it out on hir,' she says, gesturing to her lower half with a casual wave of her hand. 'Got to admit, it was pretty fun waking up in the morning to that cute look in hir eyes as shi wrapped hir sexy muzzle around my knot.' The lewd monster swoons, as her hands drift to her tight toned midriff. 'And don't get me started on the,' she pauses, ears fluttering as if searching for a word, '[']scissoring[']? It was so out of this world getting stuffed by sweet floofy vixen's cock while hir cute puppy-puss milked me dry,' she pants with unabashed desire, her fingers coasting further south as if searching for something that's no longer there. 'Watching our tummies swell between us with all that hot toasty cum, I don't think either of us would have minded if it stuck, but it wasn't meant to be...' she sighs, dejectedly as her hands fall limply to her side.";
				WaitLineBreak;
				say "     'The Old Man and Vix just kept butting heads till one day shi up and left. With hir gone, my dick disappeared and I split too. Kind of miss it sometimes,' she adds looking down at her svelte figure, 'but it was too bulky and I like being a woman. The whole herm was fun for the moment, kind of like smoking salvia, it's cool every now and then, but not really an everyday activity.' Huh, interesting what happened to them next after they left, you ask only interrupted by [']Imi-Koko as he cuts in, saying, 'Apologies makuahine but we are nearing the wreck, and we do not appear to be alone,' as he bobs his head towards the horizon. Squinting, as you look out across the waves, you just barely make out the silhouette of a large ship listing out the water like it were beached on something just below the waves. Getting closer, you recognize the ship as an old stocky T-AOE supply craft. Though the design is currently in the process of being decommissioned; someone has clearly gone to great lengths to up gun the thing.";
			else if Loyalty of Galaxite is 1:[This is the I don't want to see lewds version or story mode.]
				say "     'Anyways, the group eventually broke up after him and Vix kept getting into fights over what to do with the infected.' And Vix is? 'A gray-furred Succufox herm or that's what she, er shi, xi, or is it hir called themself,' she shrugs. 'Liked to call themself at least, and well to make a long boring story short, their strain gave them access to I don't what to call it, demon magic? They could throw fireballs, mind control things, and levitate stuff with a thought. Well as long as they fed on desire like some kind of sparkly vampire from a bad Y.A. novel,' Galaxite jokes. 'Naturally, the Old Man just [bold type]HAD[roman type] to start complaining about this too, so Vix cut ties after one of their fights got really ugly. Not that I or anyone else blames Vix, the Old Man was totally out of line,' Galaxite adds, casting you a sideways glance. 'After that, we kind of just fell apart,' Galaxite says shaking her head dejected as if to banish a bad memory.";
				say "     A part of you wants to ask what happened to them next, but your line of thought is interrupted by [']Imi-Koko as he cuts in, saying, 'Apologies makuahine but we are nearing the wreck, and we do not appear to be alone,' as he bobs his head towards the horizon. Squinting, as you look out across the waves, you just barely make out the silhouette of a large ship listing out the water like it were beached on something just below the waves. Getting closer, you recognize the ship as an old stocky T-AOE supply craft. Though, recalling a news article you once read in passing, the design is currently in the process of being decommissioned; someone has clearly gone to great lengths to up gun the thing. The old gray paint job has all been covered over with the same Iron Ball paint used in stealth fighters alongside a layer of anti-sonar rubber adhered to the bottom.";
			WaitLineBreak;
			say "     All but two of the crane booms along with the ship's spinal column separating the square wheelhouse and rear mounted com center have been stripped away then replaced with additional rader dishes and manned flak cannons. Swarming around it you can see a massive sail powered pleasure yacht similar to the ones you've seen at the warehouse district, though markedly larger. It appears to be crewed by a single yuppie mink and a smattering of Tenrecs armed with long gaffer's poles. Meanwhile, the waters themselves are dotted with bobbing fins of countless Pirate Sharks circling between the boats, every now and then, you think you can hear angry shouts passing between the two groups. Thankfully, none of them seem to have noticed your group yet but how long that remains true is anyone's guess. Turning to Galaxite, you ask what her battle plan is. 'Plan, *fufu*, who needs a plan when we have [bold type]Dragons[roman type] [Name of Player]!' She laughs in a haughty trill as briefly touches her fingers to lips, then gestures to the tyranny of leviathans around you.";
			say "     Though the rational side of you wants to tell her that dragons aren't like duct tape, and that she can't just throw enough of them at a problem to make it go away, the eager looks on the great wyrms['] faces as they size up the assembled mutants tells you such a line of reasoning would be most unwelcome at the particular juncture. Grumbling internally, you decide it best to let her take point, just this once, and gesture for her to lead the way. 'Oh I'd thought you'd never ask [Name of Player].' Galaxite beams as she mantles [']Imi-Koko's head, shouting, 'Alright kids listen up! I want you all to clear out these wannabe street sharks with [Name of Player], so consider them your Thurri for now. While you're taking care of them, [']Imi-Koko, Mau-Loa-Pahi, and I are gonna steal us a freaking yacht!' as she gestures to the collection of ferals behind her. 'Geh monah!' the dragons roar, abandoning all pretense of restraint as they throw their heads, blasting a jet of steam into air, and cloaking the area in a dense fishy-scented fog."; [Thurri = overlord]
			WaitLineBreak;
			say "     You can hear cries of panicked alarm echoing about you as ferals jump to attention, searching for the source of the sudden mist. Capitalizing on their confusion, Galaxite wastes no time in steering a pair of children towards the ritzy boat under the brief cover provided by her brood. Latching onto the side of the craft, they coil their head above the deck and unleash a scalding stream of steam across the ship's surface. Despite the limited visibility, the damage is done, and you can hear the pained yips of the Tenrecs as they leap overboard and swim away to avoid the worst of it. As the mist clears, only a single slightly-toasted Yuppie Mink wearing a blue navy captain's jacket remains on deck. He immediately runs to the edge of the bow, and yells at his routed crew, 'Get back here and fight you low born pissants! What in the hell am I even paying you useless plebs for?!' 'Fuck you, your check just bounced!' one of the Tenrecs hollers back, flipping the bird at his boss as he dives beneath the waves.";
			say "     'Goddamn skinflints, get back here, and die on your better's behalf!' the sole Yuppie Mink screeches, shaking his fist to the empty ocean waters. 'Ah bloody hell why is it so hard to find good help these days! Fine, I'll take care of these ne'er-do-wells myself! Have at you, you stupid overgrown lizards!' he grumbles, pulling a belaying pin from the ship rigging and dashing over to [']Imi-Koko and Mau-Loa-Pahi serpentine forms with the intent of clubbing them. 'Oh no you don't!' Galaxite yells, leaping in front of him. 'You leave, MY! BABIES! ALONE!' she roars in a bestial almost inhuman tone, brandishing her nightstick with a flourish. She catches the pin on the edge of her baton and twists his hand back at an unnatural angle till a pained yelp issues from the mink's lips as he drops the slab of carved wood and staggers back towards the other side of the ship clutching his wrist. Smirking, Galaxite kicks the pin towards him, chuckling, 'Go on, pick it up, [italic type]little mouse[roman type], I'm not done playing yet.'";
			WaitLineBreak;
			say "     As the frightened mink hurriedly grabs the length of polished timber and lays into her like an amateur fencer. Their match though, is horribly one-sided, as the Yuppie's reach can hardly match Galaxite's as she pushes him back with warding strikes. She almost seems to toying with him as she batters his puny form with a rain of heavy blows, seeming more interested in inflicting pain and humiliation upon the feral then finishing him out right. Confident she doesn't need your help, you turn to the Sea Dragons who appear to be waiting on your command. "; [The reason she's being so mean is to make it easier to MC/koboldify him later once she's beaten the fight out of them.]
			if BodyName of player is "Knight" and Player is pure and "Touched by Madness" is listed in Feats of Player:
				say "You lean over the shoulder of your dragon steed so that your eyes meet, and ask the noble dragon in a bored dispassionate tone. Good sir dragon, do you see those vile pirate naives over yonder that stand between us and our plunder? 'Yes m'lord,' your mount replies, with a knowing goofy grin. You do not wish to, you answer flatly, and punctuate your statement with a disinterested ennuy trill. 'At once m'lord!' Nui-Koko bellows gleefully as he and kin surge towards the sharks. ";
			else:
				say "Smirking at the thought of what you're about to do. You raise your [BodyName of Player] hand over your head and bring it down like you're karate chopping the air yelling. Alright everyone [one of]charge[or]sic'em[or]attack[or]purge them[or]purify them[at random]! In reply the dragons shout as one, 'Str! Bl! Daui comes for the false unahi!' as they swarm forth. ";
			say "A cry goes out from the shiver of sharks as the shoal of Dragons crash upon them. Mounted atop Nui-Koa, you watch the frenzy of ferals scatter then reform their ranks like sea wolves trying to draw out and isolate individual wyrms. In the past, this tactic might have worked against the truly Feral Sea Dragons, Galaxite's brood are far too clever to fall for such an artless maneuver, especially with you coordinating their attacks. They instead spread out in a staggered line formation, at your direction, blasting the sharks with great overlapping plumes of scalding steam as they push them away from the supply ship. Nevertheless, the gam of pirate sharks attacks in waves trying to nip at the Sea Dragon's flanks, only to be repulsed again and again by an overwhelming wall of superheated gas."; [Str! Bl! Daui comes for the false unahi!= War! Blood! Death/The grim reaper comes for the false scales!]
			WaitLineBreak;
			say "     When it becomes obvious that they can't break through without getting blanched out of their hides, the sharks break and flee to deeper fathoms, hurling cruel taunts and jeers as they go. The dragons briefly consider pursuing them, but you caution them against it. Their goal, you remind them, is to secure the ship, not hunt pirates. Not all of them seem to listen though as one tries to break ranks, declaring his desire to chase the fleeing sharks and purge them in Galaxite's name. Only the roar of Nui-Koa stops them in their wake. 'Halt kuu kaikunane, heed our Thurri's words! For they still speak with the wisdom of a Menehune!' Nui-Koa growls with barely restrained bloodlust as he blasts the waters in front of his brother with a breath of superheated steam. 'Rosus Eldest, zenii zul, you are right. I-I forget myself in the red haze of battle,' the dragon says, kowtowing to his sibling."; [Menehune are wise fairy folk from Hawaiian folklore that taught people how to make boats and farm taro. Nowadays though it's an insulting way to call someone a midget or dwarf.]
			say "     'I know brother, I feel the call of Str against the false scales, the desire to give myself to the winds of Bl, to embody Daui, to know the final frenzy and let its fires burn through my veins! Kaldo wa zan! Valldo wa nern! Nun sus nau dii codo! My fangs to their throats! My talons to their hearts! Their blood on my lips!' Nuni-Koko roars, slamming his tail against the water. 'But I do not let its call rule me,' he rumbles, shaking his head like an angry crocodile as the waters ripple in tune with his voice. 'For we are Naxokaazthur!' Nui-Koa bellows, his scales rippling with pride as lightning dances upon his gleaming fangs. 'Not thralls to Atlantis, nor slaves of the five headed one's call! We are perfect beings above such weaknesses, given thought and reason by our beloved mother's voice, never forget this! And never again seek to sell your doom to these lowly foes whose names are unworthy to echo through the storm in front of me again!' Nui-Koa says through gritted teeth as he leers over his brother. 'Of course,' the other dragon replies solemnly, baring its neck to Nui-Koa in a display of bestial submission."; [Author's note: Nui-Koa is actually quoting what he will later claim is a draconic love poem here, he just left out the last line: 'My soul to my love!']
			WaitLineBreak;
			say "     '*RAA* Do not seek rosus from me, Anana-Hohonu-Loa! The ";
			if Hunger of Galaxite is 0:
				say "kau ";
			if Hunger of Galaxite is 1:
				say "Qunarr ";
			say "is the one you should bare your neck to. They are not even zin kin, yet they show greater filial piety than you ever have, brother.' Nui-Koko snaps as he nips the air in front of him. '*ZZAASS* zen Eldest, though your words wound me.' Anana-Hohonu-Loa grumbles, lowering his gaze in shame. He rolls on his back, exposing his neck and light blue stomach to you, saying, '";
			if Hunger of Galaxite is 0:
				say "Kau, ";
			else if Hunger of Galaxite is 1:
				say "Qanaar, ";
			say "please forgive this foolish one.' Uh ok, apologies accepted, you tell them not sure how to respond in the midst of the brother's quarrel or in any mood to play dragon therapist. 'Ah such temperance from the ";
			if Hunger of Galaxite is 0:
				say " kau! ";
			else if Hunger of Galaxite is 1:
				say "Qanaar! ";
			say "Your words humble and shame me!' Anana-Hohonu-Loa grumbles, righting himself. Shrugging, you tell him not to worry about it, and to just focus on getting this job done.";
			say "     'Ha-ha-ha, such grace kin da mun! My brothers could learn from you!' Nui-Koko laughs, or that's how you interpret it. The sound that echoes from his maw has only the barest resemblance to laughter. To your ears, it sounds more like the whirl of water and the knell of distant thunder than a human chuckle. 'Mh, but enough of this pointless arguing, our Nier is not complete. [bold type]Brothers![roman type] Secure this vessel in the name of our makuahine and,' he glances back at you, 'the ";
			if Hunger of Galaxite is 0:
				say "kau!' ";
			else if Hunger of Galaxite is 1:
				say "Qunaar!' ";
			say "Nui-Koa bellows, slapping his tail once more against the water. 'GAH!' The other dragons roar, in reply as they fan out. Half their numbers slip beneath the wave, likely to keep an eye for any remaining sharks still prowling about in the depths. The rest position themselves around the large supply ship while Nui-Koa swims up the side of the stricken vessel. He arches neck up to the deck, saying, 'Regretably, I can be of no use to you here, [if cunt count of Player >= 1]honored rider[else]kin da mun[end if].";
			WaitLineBreak;
			say "     'This meager craft was never meant to bear the regal presence of a Naxokaazthur for long. So for now, my place must be with my kin,' he declares as you climb aboard the floundering ship. Nodding, you tell him that you understand. 'Then I wish you success on your Nier, nah se sturm slayrak, may the fury of the storm empower you, [if cunt count of player >= 1]my rider[else]kin da mun[end if],' Nui-Koko replies as he slips beneath waves to join his kin's vigil, leaving you to check out the ship. Not sure where to begin, you decide to simply make your way around the edge of the ship before checking the wheel house. Making your way about the vessel it becomes apparent that not only has it been here quite awhile, but you're not the first to step foot on it. All the .50 cal turrets have had their looted and many of their internals have either been sabotaged or gutted for parts. Peering through some of the more intact turrets, you find a spent casing lodged in what's left of its belt operating system, pulling it out, you spy the words: [']Air Burst['] stamped on the spent brass hull. Shrugging at the odd designation, you toss it aside then turn your attention to the rest of the ship.";
			say "     The communication arrays fare no better either as someone has gone to great lengths to strip the copper from them. At this point, the hollow shells are little more than overpriced seabird nests. In fact, you can see some have been set up in the radar dishes. As to the fate of the crew, you can't be certain, but from going by the lack of lifeboats, absence of any signs of struggle, or fighting. You assume they all evacuated safely either by boat or via helio. Moving towards the center of the ship, you note the presence of more modifications. The ship's gutted spine column appears to house what looks like a large hydraulic hatch running the length of the ship. Many of the original boom cranes seem to have been stripped out to provide space for large shipping containers. At least that's what you surmise going by the uniform scuff marks on deck, damage to the rails, and presence of sheared off anchor points dotting the floor. You surmise that when the ship ran afoul of the rocks that Galaxite mentioned, the crew either scuttled them, or they got shaken loose.";
			WaitLineBreak;
			say "     Either way, you can't be sure unless you go diving after them, so with nothing else to see, you turn your attention to the wheel house and com center. Both, it appears, have been thoroughly scuttled by the crew. Every piece of electronics has been smashed or roasted by some unknown chemical fire. If it weren't for the fact that you might have liked to use them to call for help, loot the parts yourself, or perhaps even try to salvage the ship, you might actually be impressed with the level of destruction on display. As it stands, you're left with more questions than answers, like what they were hauling and why. Dejected, you decide to look for the entrance to the lower decks. Heading aft though, your search is interrupted by the happy cry of Galaxite from off the port bow. 'Hoi kin da mun! Find anything?!' Following the sound of her voice, your jaw nearly drops to the deck as you catch sight of [']Imi-Koko and Mau-Loa-Pahi pulling the mink's pleasure yacht by a pair of ropes dangling from their maws like a pair of draft horses towards the modded T-AOE supply ship. Between them, you see the grinning form of Galaxite standing proudly on the railing of the forward pulpit with the former captain's jacket draped over her shoulders like a cloak.";
			say "     In her left hand, you spy an open green bottle of what you assume is wine or some fine spirits, while her right holds the rail. At her feet, you spy the unconscious form of the yuppie mink wearing nothing more than his birthday suit and pair of pink water wings with girly frills on them. As they pull up to you, you inform Galaxite that the upper decks have been picked clean. 'Oh well,' she hums, her ear fins flaring outwards as she takes a long pull on the bottle, 'Ah that's good stuff!' Galaxite chuckles, wiping a bit of fizz from her upper lip then tucks the bottle in the sleeping mink's arms. 'Hopefully we can find something worth looting below deck, or on the seafloor. Say, you mind checking the hold while me and the boys do a little diving?' Flashing her the thumbs up sign, you reply that you were already on it. 'Sweet, I'll check back with you in a few, this shouldn't take too long,' Galaxite says, slipping out of her new slightly small for her size jacket and hat.";
			WaitLineBreak;
			say "     She flips her scuba bag around, pulls out a pair of bright blue marine flare tubes. Ignites one with a casual flick of wrists, a bright blue-white flame bursts into being as she clenches the other in her teeth and boldly dives off the side of her ship followed by her sons, leaving you to resume your search. It doesn't take that long for you to locate a door sealed with a hand wheel tucked under a staircase adjacent to the ship's helipad. Grabbing hold of the mechanism, it takes you a few tries to jimmy it, but you're eventually able to undog the aperture and force the thing open. Peering inside, you're greeted by the baneful glare of bright red emergency chem lights casting their warning glow over a long set of stairs leading down the depth, the stench of sea water, and... fish? You muse, not able to properly place the odd aquatic scent permitting the lower deck. Grumbling at the offensive odour racking your senses, you guess you'll find out as you descend into the bowels of the stranded ship.";
			say "     You soon find yourself walking through the crew and mess deck. Each room appears to be picked clean though, almost like someone scoured the place top to bottom to remove all traces of the previous occupants, leading you to believe that whoever owned this ship was either doing a one hell of a black op, engaged in some illegal activity, or both. There's no reason for this level of scrubbing otherwise, as you can't find a single hair, a lick of graffiti, or even a boot mark scuffing the ground, just room after empty room. Even the kitchen and pantry have been emptied of all evidence of habitation, annoyed at your lack of loot, you pick your way about the red-tinged corridors till you find another staircase leading to the next level. Heading down the smell of salt water, fish, and cold humidity is even stronger as it weighs heavily upon you like an oppressive fog. With each step down, the temperature plummets lower and lower till your breath coils about you like red-tinged wisps.";
			WaitLineBreak;
			say "     Here and there, you spy bubbling gray paint leaking rivets of condensation impregnated with dirty brown rust down the walls as the ocean exacts its toll on the ship's internals. While the overhead pipes leak a slow steady tattoo of waste water accompanied by the frightful screech of metal buckling under pressure. A part of you wonders how long this vessel will hold up, but push away such thoughts for now. Your job, you remind yourself, is to find the hold and try to recover anything left behind, not save this ship. Even if it does go under, Galaxite and her kids could probably still pillage the thing just fine, you opine as you stalk about the sub level blindly searching for some sign of the hold. You eventually come to a [']T['] junction with a bit of signage painted into the wall. Though it appears to have been hastily defaced with turpentine and some hard scrubbing.";
			say "     You can still make out a bit of the directions, the left path appears to head to storage while the right leads to engineering. Finally a lead, you think to yourself as head down the left hand. Your path leads you towards a gangway overlooking the hold. Unfortunately, the emergency lumens here appear to be mostly dead or flickering wildly so it takes your eyes a moment to adjust to the variable light. As you take in the hold properly, you immediately spot a large jagged piece of slate-black rock puncturing the hull. This must be what caused the ship to flounder in the first place, you muse, observing a trickle of water pour through the rents in the metal like a lower pressure water fountain. Checking the floor next, you notice a large number of black and red cargo containers lying haphazardly about the area. Looking closer at them, you notice some odd organic mass hanging from the sides. To your eyes, it almost looks like someone cut the fingers off a giant off-white rubber glove and tacked them on to the side.";
			WaitLineBreak;
			say "     Curious about what in the heck you're staring at, you walk along the gangway till you're standing over them, then look down. Oh no, you whisper under your breath as you recognize what they are, squid eggs. No, hatched Squid Girl eggs, you correct yourself peering about the area and spotting the sleeping forms of over two dozen of the weird hybrids snoozing in the lee of the containers pooling in the lowermost level. They must have laid, spawned, or whatever you call it after the ship was abandoned. It might explain why the sharks along with the mink's crew were hovering around here. They must have been waiting for these mutants to leave, or maybe they had some plan to evict them. Unfortunately you don't have the time to wait them out, so you need to think up a plan of action. You muse quietly looking about the hold for something you can use.";
			say "     You soon come to the conclusion you may have to fight your way through them. If you want to clear this place. ";
			if perception of Player >= 20:
				say "Then again, as you look at the large access hatch built into the [']ceiling['] of the ship, you realize the thing is controlled by a hydraulic array. In theory, you could sever the lines, drain the mineral oil, then force it open with help from Nui-Koa and his brothers. Once they have a clear line of sight they easily smoke out the squid without doing much harm to them, or more importantly, the loot. ";
			if intelligence of Player >= 20:
				say "Alternatively, you note the presence of a number of broken power cables floating in the not-so-shallow water with their flayed copper guts exposed to the elements. If you were able to get the power on, you could probably shock the squids into submission without a fight. Of course, you'll probably ruin what's left of the ship power grid, but it's not like you care. This vessel is one step away from Davy Jones['] locker anyways. ";
			if Electric Prod is owned:
				say "Your other option is to turn on your Electric Prod and chuck it in the hold. Sure it will fry it, but the saltwater should make a great conductor which will allow you to tase all the squids at once saving you from having to fight them one at a time.";
			LineBreak;
			say "     [bold type]What would you like to do?[roman type]";
			LineBreak;
			let Dragon_Break_Choices be a list of text;
			if Perception of player >= 20:
				add "Open the hatch and let the Dragons in." to Dragon_Break_Choices; [A prudent if meek choice, eh kin da mun?]
			if intelligence of player >= 20:
				add "Turn on the power and shock the squids." to Dragon_Break_Choices; [A safe play... for a kin da mun.]
			if Electric Prod is owned:
				add "Sacrifice your Electric Prod to tase the squids?" to Dragon_Break_Choices;
			add "Fight them." to Dragon_Break_Choices; ['Ah the direct approach, this Dragon approves!' Nui-Koa said, from off in the wings.]
			let Dragon_Break_Choice be what the player chooses from Dragon_Break_Choices;
			if Dragon_Break_Choice is:
				-- "Open the hatch and let the Dragons in.":
					say "     Reasoning that there is no point in putting yourself in undue danger, you decide to open the hatch. Now, you just need to find where the lines are hooked up and sever them. This should be easy, you muse, stalking about the walkway. You're careful not to make any noise as you search for any sign of the ship's hydraulic system. Thanks to your keen senses and a little bit of common sense, you soon locate a large red and white sign detailing the emergency release procedure alongside the controls and hydraulic fluid pipes not all that far from where you came in. Reading the instructions over a few times, you find that it's not too complicated. You have to hit the bright red [italic type][']purge valve['][roman type] attached to the main fluid line and the hatch should unlock. The instructions do however mention that it will vent the [bold type]WHOLE[Roman type] system and require the thing be refilled before it can be used again. But hey, that isn't your problem, not like you're planning on putting down roots here or something, you think to yourself as you disengage the safeties and pull the purge valve.";
					say "     A low shudder passes through the ship as the hydraulics vent into the ocean. Hopefully the seas don't mind a little more pollution, but it's probably not any worse than the usual illegal bilge dumping that takes place off the coast. At least that's what you tell yourself as the overhead hatch sags ever-so-slightly and small beams of natural light pour through the cracks. You decide to make your way topside. Luckily, since you already know your way around, you're able to get back rather quickly. Dashing up flight upon flight of stairs, you find yourself at the landing leading to the main deck. Heading up, you can hardly suppress the feelings of joy you get at seeing natural light again. The red glare cast by the emergency lights was starting to get a little creepy for your tastes. You muse, striding over the boat's railing and call out for Nui-Koa.";
					WaitLineBreak;
					say "     In moments, the sea before you begins to roil as the great wyrm breaches the surface, sea water streaming about the articulate furrow his sleek azure plates. A part of you can't help but marvel at the subtle rainbow prismatic hues reflecting off the sensuous nacre white scales gracing his toned rippling core as he towers over you, saying, 'Hail [if Cunt count of Player >= 1]honored rider[else]kin da mun[end if] how goes your search?' as he ascends to his full height and his regal draconic horns part the cloud like a blade. It goes well you tell him, but you've hit a snag in the form of a massive nest of squid girls. 'Hhmm these strange creatures are known to me. What does [if Cunt count of Player >= 1]my honored rider[else]the kin da mun[end if] require of the Naxokaazthur?' he asks, tilting his head questioningly. Gesturing to the center of the ship, you tell him how you managed to pop the lock on the hatch leading down to the hold. How if he and his brother's were to work together, they could easily force the thing open and fumigate the place with their breath.";
					say "     'A cunning plan [if Cunt count of Player >= 1]honored rider[else]kin da mun[end if], it shall be done. Brothers to me!' Nui-Koa bellows to the heavens causing the ocean to churn and swell as several Sea Dragons surface beside him. Nui-Koa turns to them and quickly explains the plan in his strange pidgin language. The other's listen with rapt attention and seem very happy with the opportunity to show off their natural power. They waste no time swimming around to the center of the boat. They latch on to the ship then elevate themselves out of the water. Though the ship groans in protest of their draconic bulk, it still holds together even as they sink their clawed paws into the hatch and rip it open. The metal resists for a moment as the bits of fluid are forced out of the hydraulic system, then give out with cracking as the dragons force it ajar. A cry immediately comes out from the lower decks, as the rudely awakened squids realize far too late what's going on.";
					WaitLineBreak;
					say "     They hardly even have time to react as the noble wyrms blast the lower decks with a mighty deluge of superheated gas. Though the ferals cry out in a piercing chaphony of bestial anguish, they all goes quiet in mere moments as the squids fall into pain shock and the dragons reach in pulling them out one at time then drop them in the sea beside them. From your experience regularly beating up mutants, you know that they've fallen ";
					if "Touched by Madness" is listed in Feats of Player:
						say "into a very enthusiastic healing coma ";
					else:
						say "into a deep regenerative slumber ";
					say "right now. By the time you leave they'll be fully restored and no worse for wear. Heck, they'll probably retake the ship too, but that's not a you problem, you muse watching the dragons work. ";
					say "[AlmostDone]";
				-- "Turn on the power and shock the squids.":
					say "     Deciding that it would be best not to waste the opportunity to pacify the ferals in one fell swoop, you quietly head back towards engineering. The path is blessedly free of any surprises, as the ferals don't appear to have any interest in this part of the ship. You can't be sure why. Perhaps these creatures are like veined octopuses, and are using the ship as nothing more than a simple nursery rather than a base, or given their less-than-human bend they could merely be unaware of the true potential this vessel and its cargo could afford them. You muse, journeying through twisting corridors of the ship till you eventually come to the door leading to the ship's engine room. Much like the rest of the ship, you note that the hatch has been closed, but not locked. With twists and a touch of elbow grease, you manage to wrench the hatch open with a light pop. The door edges back and giving it a light push, the thing squeaks open, revealing a tightly packed claustrophobic room.";
					say "     Stuffed to the gills with all manner of computer screens, gauges, and a giant bright-red engine placed in the center, all of which are very well labeled and offline. It seems whoever was in charge of this place is a bit of a stickler for the [']keep it simple stupid['] method of doing things or they were a fan of redundancies, you think to yourself, noting the presence of a start-up primer glued to the engine block written in plain, easy to understand English. Skimming it over a couple of times, you come to the conclusion that you just need to turn on the auxiliary and back up generators rather than turning on the engine properly. From what you've read, those startups are located in the back of this room. Assuming that the ship still has some JP-5 or diesel in its tanks, you should just have to flip a switch, you muse, heading to the rear of the room. You fumble around in the less than ideal lighting conditions as you try to find the start up switch.";
					WaitLineBreak;
					say "     Eventually, you find it tucked away next to some analog gauges denoting fuel, lube, and coolant levels all of which are at, or near zero. Damn it, you hiss under your breath realizing there might now be enough juice to get the gennies to turn over. Oh well, only one way to find out, you think to yourself as you grab hold of the bright red switches and flick. Though nothing happens, you are not so easily dismayed. Rapidly toggling the nob, you soon hear something catch as the generators whir to life. The lights flicker between red and pale white as the P.A blast a deafening stream of static alongside the fragment of an old song accompanied by steel drums and trumpets in the background. '[italic type]Come everybody rock your body and do that funk nnnoowww[roman type]-, *TZT*,' then dies with a low distorted warble as the grid collapses. A final boom of teeth rattling reverberations echoes throughout the hull.";
					say "     You watch sparks fly across the electronics as the ship's P.A screams its horrid deathrattle then goes as the last gasps of power bleeds from the system. The lights shift back from white to red as ships chem lights kick in, bathing the room in a weak crimson glow. You can only hope that was enough to do the job. Going by the smell of ozone and burnt plastic, you can safely assume most of the ship's internals are well and truly fried, so you won't be getting another chance, you muse heading back the hold. You are pleasantly surprised to find your longshot idea may have actually worked better than you expected. As you peer over the edges, you note their stunned forms laying all over the floor at odd angles. You notice a beam of light stream from the roof as the hatch sags slightly. You guess the short must have affected the hydraulics somehow, or you've tripped a here to unknown safety feature. Either way, it doesn't matter to you in the long run. Still, you're curious if the squids are well and truly out, so you snake your way down to the cargo hold and poke one with your foot.";
					WaitLineBreak;
					say "     It doesn't stur, though it's clearly still breathing and will likely come around in a while. With any luck, you should be gone by the time the nanites sort them out, you think to yourself as you head back to the main deck, and make good time thanks to your minor familiarity with the area. In minutes, you reach the landing that leads up top side, and can't help but feel a slight sense of elation at the sight of natural light and fresh, if salty, air drifting down from the open hatch. The oppressive red glow and the stench of ozone combined with burnt plastic was really starting to get to you, you muse. Barreling up the stairs, you rush over to the railing, then call out to Nui-Koa and his brothers. The sea roils about you as the eldest child along with his cohort burst from the waves crying, 'Rem kol kai! [if cunt count of player >= 1]Honored rider[else]Kin da mun[end if], how goes your Nier?' as the water spouts fan around their imperial forms in a vibrant ballet of kaleidoscopic hues as the vast squall of sea spray cascades about them.";
					say "     You feel your breath catching in your throat as you marvel at the sight of the sea foam streaming down his articulated, sleek, azure plates and gentle caress of the clouds playing along their noble serpentine brows as they tower over you. Still, you quickly compose yourself and tell them that it goes well and how you've managed to pacify a group of squid nesting in the bowels of the ship. You just need his help prying the ship open so you can retrieve the cargo. 'HA-HA a clever stratagem [if cunt count of player >= 1]worthy of my honored rider[else]kin da mun[end if], the innovativeness of mortals never ceases to amaze!' Nui-Koa laughs though his voice sounds like the roar of some far off storm and the shattering of stone. 'Come my brothers! Let us see what treasure this vessel hides from us!' He preens, leading his kin to the sides of the ship. They latch on with wicked clawed hands and hoist themselves up over the edge of the ship, much to its protest. You watch as the dragon brothers rip open the hatch leading to the hold and begin pulling the unconscious ferals out one at a time.";
					WaitLineBreak;
					say "     They set the squids gently into the ocean, letting them float away, so they can be someone else's headache, you muse, watching them work. ";
					say "[AlmostDone]";
				-- "Sacrifice your Electric Prod to tase the squids?":
					say "     Taking out your Electric Prod, you prime the thing and get ready to chuck it into the lower deck when a thought occurs to. You are about to throw an unstable electronic control device meant to pacify large unruly animals into a pool of highly conductive salt water while standing in a giant soaking-wet metal cage. A part of you wonders if you're on the verge of tasing not just the squids, but yourself, Galaxite, and her brood as well. Although most boats nowadays are functionally massive floating faraday cages meant to safely absorb lighting strikes, this one is pierced by giant rock and leaking like a dang sieve. Maybe you should be a little careful. You would look pretty stupid if you came this far only to shoot yourself in the foot, you think to yourself as you search the area for something to act as insulation, just to be sure.";
					say "     Thankfully, it doesn't take too much backtracking on your part to find a large lifebuoy ring hooked to the side of the corridor that you came in from. True, you're not sure why one of these things is doing this far below deck, but if you had to guess, some senator got a sweetheart deal to overproduce these things then left it to the armed forces to figure out what to do with them. Oh well, better that they end up here rather than entombed at some Army Depot out in the sticks, you think to yourself. Unhooking the floatation device from the wall, you tuck it under your arm, then head back to the hold and set the thing down a few feet from the gangway. You balance your [BodyName of Player] body atop the plus-sized ring to the best of your abilities. Once you're stable you then pull out your Prod, prime the device, and throw it yelling, [one of]Fire in the hole[or]YEET[or]Lights Out[or]Frag out[or]Kode[or]Boom shakalaka[at random]! as the cattle prod sails through the air.";
					WaitLineBreak;
					say "     The hold is set alight with the flicker of sharp white light that wars with the oppressive red of the emergency globes. Then it hits the water with a fizzling pop that echoes through the still as heavy duty prod unleashes a cataclysmic discharge of raw electricity. Bolts of pure energy dance across the hull all around you the lights flicker like angry strobes from red to pale yellow while the ship's P.A. system belches an unholy cacophony of static and reverb that rattle your teeth. Slowly it peters out as it plays a single line from an old pop rock song. '[italic type]Prance like a Nubian, Do-do-da-da-doooo[roman type]- *TZT*,' then dies as last bits of juice from your Electric Prod bleed out into the aether and the lights shift back to glaring red. Even then, you decide to give it a minute before you step off the insulated ring as the air is still impregnated with the stench of ozone layered with burnt plastic. Once you feel brave enough, you gingerly step onto the metallic ground. When nothing happens, you breathe a brief sigh of relief and go to check on the squids. Sure enough, as peer over the edge of the gangway, you spy the stunned forms of the strange ferals sprawled about the floor at unhealthy angles. After that light show, you're pretty sure that they are all out cold, for now. It shouldn't take them too long to recover once their nanites shake off this bout of unbidden electroshock therapy, you opine. As a sudden metallic creak echoes from overhead, alarm blares through you like an oil slick catching fire as you look for the source. You swiftly locate the origin of the noise as you spot a stream of natural light filtering through a crack in the ceiling, or more specifically from the hatch leading to the main deck. Interesting, the sudden electrical discharge must have tripped or shorted something.";
					WaitLineBreak;
					say "     You can't be sure, but at least it saves you the trouble of jimmying the thing on your own. This way at least you, Nui-Koa and the others can pry the thing open without much trouble, you opine, as you head back to the main deck. Since you know your way around a bit, the return trip is much quicker than your descent. In no time at all, you find yourself at the landing leading to the main deck. Mantling the stairs, a part of you can't help but feel a bit of relief to see natural light and breathe fresh air again. Regrettably, you don't have the time to enjoy the change in scenery just yet, you think to yourself as you run over to the side of the ship then call out, 'Naxokaazthur!' to the open ocean. No sooner does the word leave your lips does the sea in front of you begin to churn and bubble as the shadow of Nui-Koa's majestic form bursts through the waves, saying. 'Rem kol kai, [if Cunt count of Player >= 1]honored rider[else]kin da mun[end if], how goes your Nier?' as water flows along the glossy contours of his handsome serpentine form akin to shimmering rivers of the purest blue velvet.";
					say "     A part of can't help but bask at sight of his towering body looming you as the clouds billow around his swept horns like laurels entwining a crown, or the bestial majesty of his tough, rippling scales reflecting the available light in a beautiful array of chromatic hues. Still, you steady yourself and reply, serviceable, then go on to inform him of your encounter below deck and that you need him and his brothers help to pry the cargo hatch, so that you can finish looting the place. 'Ah,' Nui-Koa nods respectfully, 'Zahrahmiik tol en los vin fah tol vin los zallos. Sacrifice that which is desired to gain that which is needed, a pragmatic plan [if Cunt count of Player >= 1]my rider[else]kin da mun[end if]. I shall be happy to assist you in this. Brothers to me!' Nui-Koa bellows, firing a short blast of steam into the air. A pair of Sea Dragons surge forth from the depths and swim to his side. They bow to both you and Nui-Koa then ask how they can be of help. Turning to face them, Nui-Koa hurriedly explains the situation in his alien creole.";
					now Level of Galaxite is 1;
					WaitLineBreak;
					say "     From the eager looks on their faces, the two dragons appear to relish the opportunity to show their draconic strength. They coast over to the side of the ship, and pull themselves halfway out of the water, much to the chagrin of the ship as she groans in protest of their bulk. Still, the old girl holds it together as they latch on and pull the hatch open. The regal wyrms reach in and pull out the squid girl one at a time, then set gently into water beside them. You watch as they float away and hopefully become someone else's problem, you muse, observing the Dragon brothers work. ";
					say "[AlmostDone]";
				-- "Fight them.":
					say "     Angling to go with the direct approach, yourself, you leap down to the lower level, and bellow your challenge to the ferals. At once the placid squids spring to life as they turn to face you. You can feel the weight of countless bloodshot eyes pressing down upon you as one of them screams, 'Hey who the hell are you?! This is our garden beneath the waves. Leave!' Not without these containers, you counter gesturing to the shipping crates. 'Stupid Land-Walker, you aren't getting anything from us. [bold type]GET [']EM GIRLS![roman type]' one of them yells as they advance upon you. It's a fight!";
					say "[SquidGamesFight]";

To say SquidGamesFight:
	let GroupFightCounter be 0;
	now fightoutcome is 0; [reset]
	while fightoutcome < 20 and GroupFightCounter < 10: [runs for 10 times or until the player loses or flees]
		now inasituation is true;
		if fightoutcome < 20 and GroupFightCounter < 10:
			say "     One down, a bunch more, you cheer internally, casting down another of your fishy foes. Landing with wet thud, the stricken feral hurriedly scurries away under the cover of barrage of flotsam and jagged metal hurled by the remaining squids, as another's surges forward in a rush of cephalopodial fury.";
		PlayerWounded 30;
		challenge "Squid";
		increase GroupFightCounter by 1;
		now inasituation is false; [reset]
	if fightoutcome >= 10 and fightoutcome <= 19 and GroupFightCounter is 10:
		say "[SquidGamesFightWin]";
	else if fightoutcome >= 20 and fightoutcome <= 29:
		say "[SquidGamesFightLose]";
	else if fightoutcome >= 30:
		say "[SquidGameFightFlee]";

to say SquidGamesFightLose:
	say "     Buckling under the sheer weight of bodies pressing down upon you, you collapse into blissful unconsciousness. What happens next, you can't be sure, but you have vague memories of yelling and being dragged somewhere rough followed by a sudden rush of cold. At times you think you hear your name being called, though the speaker's voice sounds rather irate. You want to reply to find out what's wrong, but words fail you, so you slip deeper into the welcoming blackness of your mind. Sometime later though, you awaken floating in the surf with a pair of bright pink water wings scrunched over your [BodyName of Player] arms and a note affixed to your chest with a wad of pink chewing gum. Pulling it off, you see it reads: [']God damn it Deb, you had one job!['] Looks like Galaxite ditched, you sigh picking yourself up and head back to shore. Though a part of you wonders what you should do, now that you've lost out on the Break Water Heist haul.";
	now Break Water Heist is resolved;

to say SquidGameFightFlee:
	if "Touched by Madness" is listed in Feats of Player:
		say "     Shit, you've lived enough hentai to know where this is going, you muse trying to break contact with squids.";
	else:
		say "     Too weak to stand up to the combined assault of the ferals, you attempt to beat a hasty retreat.";
	say "You don't get far though as one the squids leaps upon you and clubs you into submission with her tendrils.You soon blackout from pain and slide into the comforting embrace of unconsciousness. What happens next, you can't be sure but have memories of yelling and being dragged somewhere rough followed by sudden rush of cold. At times you think you hear your name being called, though the speaker's voice sounds rather irate. You want to reply, to find out what's wrong, but the words fail you, as you slip deeper into the welcoming blackness of your mind.";
	say "     Sometime later though, you awaken on the beach with a pair of bright pink water wings scrunched over your [BodyName of Player] arms and a note affixed to your chest with a wad of pink chewing gum. Pulling it off, you see it reads: [']God damn it Deb, you had one job.['] Looks like Galaxite ditched, you sigh picking yourself up and heading back to shore. A part of you wonders what you should do, now that you've lost out on the Break Water Heist's haul.";
	now Break Water Heist is resolved;

to say SquidGamesFightWin:
	say "     With a brutal blow, you slap down your latest challenger, adding yet another unconscious squid girl to the growing pile of ferals at your feet. The remaining creatures['] morale begins to waver as they hesitate to send another of their number into the meat grinder. Sensing this, you offer them one last chance to flee. 'GGRR, fine you win [bold type]LAND BORN SCUM![roman type]' one of them growls, motioning for her kin to stand down. 'Sisters we can not win this day, [bold type]RETREAT[roman type]!' she howls, leaping to the upper level of the hold. You watch as she fiddles with something on the wall. You're not sure what from this angle, but as the ship begins to shudder. The overhead hatch begins to creak open and natural light pours through the growing crack. You watch the Squid girls crawl over the hull as they stream toward the opening. One after the other, they push their boneless bodies through the tiny opening.";
	say "     Though with the passage of each individual, the aperture grows wider as their weight and frantic flailing wedges the hatch further apart until the thing pops open fully with a loud, pained, creak and all the remaining squids that are still able to walk on their own power rush out at once. As they climb up the side of this ship and scurry out of the hold. You hear Nui-Koa bellow, 'Okaaz! Nurts! Sturm!' as lightning arcs overhead and something heavy latches onto the boat. You can feel the metal beneath you groan in protest as Nui-Koa's worried face appears above you yelling, 'Vile creatures what have done with [if Cunt count of Player >= 1]my rider[else]the thurri[end if]!' as electricity dances across his fang like Saint Elmo's fire. Though as he takes in the sight of your most recent battlefield, his expression softens and turns to one of joy. 'Ha-ah-ha, impressive Qunaar! It seems you're making a habit of humbling my kind!' he laughs, although his voice resounds with the howl of storm lashed seas and the rumble of ancient rock."; [Okaaz Nurts Sturm = ocean force storm]
	if Hunger of Galaxite < 1:
		now Hunger of Galaxite is 1;
	WaitLineBreak;
	say "     Ah it was nothing, you tell him, these feral were pretty weak. 'False modesty does not become you Qunaar, so long as your pride does not blind you, there is no shame in reveling in your victory here!' Nui-Koa preens, [if Cunt count of Player >= 1]eyeing up your form with barely concealed interest[else]nodding at you respectfully[end if]. True but perhaps that should wait until after you finish up here to pat each other on the back, you reply to the gesturing to the cargo crates strewn about you. 'Zin, you are correct [if Cunt count of Player >= 1]my wise rider[else]my thurri[end if],' Nui-Koa says, as he shifts his gaze to the ocean beyond you. 'Brothers to me! The Qunaar has won a great battle here, now we must play our part.' 'Geh zeymah!' The others call back as they hoist themselves onboard. Though the ship shrieks at their bulk it still holds as the heads of three dragons appear above you and take in the sight of your handy work. One of them has the presence of mind to drop you a line and offers to pull you up. Thanking them, you grab hold of the algae laced cord then motion for them to get you out of here. 'At once Qunaar,' one of the Sea Dragons says as they gently extract you from the hold and set you down on the main deck."; [Note: Nui has a weird human fetish, and for some reason he thinks the balding apes are worthy of respect since despite their many-many crippling flaws, they still struggle on regardless.]
	WaitLineBreak;
	say "     The others reach inside the ship and pluck the still concussed form of the squid girls off the floor, then set them in the sea. Heading over to the railing, you watch as the pacified ferals float off into the distance where they'll likely become someone else's headache, you muse, watching the dragon brothers work. ";
	say "[AlmostDone]";

to say AlmostDone:
	say "[italic type]Sometime later,[roman type] once the hold is cleared you and the Sea Dragons begin trying to extricate the shipping containers. Unfortunately, despite your best efforts at coordinating the dragon brothers effort, the task proves a bit difficult for them. Strong as they are, their paw-like hands are ill suited for fine manipulation and the ship itself is no help either. More than once, the thing lists at the worst possible moments causing the cargo shift and haphazardly fly around the hold. Attempts at wrangling the crates fares no better, as the dragons are unable to get the proper leverage on them without causing more damage to the hull. Already you can see the ship has sunk deeper beneath the waves and its superstructure is starting to buckle in places.";
	say "     Everyone is getting so frustrated, the great wyrms are openly considering just sinking the thing so they can pillage it beneath the waves. Not seeing a better option, you are about to give the go ahead when Galaxite along with several wyrms breach the surface, yelling. 'Hey [Name of Player] whatever the heck you guys are doing up here you need to stop right now!' Turning to face her, you ask her why. 'Cause the ship's about to snap in half, look!' She cries in alarm pointing to the hull. Wait really, you reply running over to the railing you peer over. Oh crap, [bold type]EVERYONE OFF NOW![roman type] you yell as you take in the sight of the crumpling hull. 'At once Thuri!' the assembled dragons bellow as they leap off the side of the ship. Once they're clear, you ask Galaxite what you should do. 'Uh I don't know hm-,' she says in a thoughtful tone as she appraises the ship. 'Have you tried the cranes?' she asks, pointing to the few remaining booms. No power, you reply, shaking your head. 'Dang... wait,' Galaxite snaps her fingers, 'I got an idea, [']Imi-Koko take me in, I want to try something,' Galaxite says, motioning for her son to drop her off.";
	WaitLineBreak;
	say "     '[']Ae makuahine,' [']Imi-Koko replies as he swims up beside the ailing vessel. He levels neck with the railing, allowing Galaxite to hop off, though as her feet touch the cold metal surface of the deck. Her eyes suddenly widen with alarm as a pronounced shiver crawls up her thigh. 'Brr, h-h-how is it colder up here than underwater!?' she hisses, as she starts wildly hopping from foot-to-foot. ";
	if Loyalty of Galaxite is 0:
		say "You do your best not to stare (too much) at the shivering woman's heaving chest and diamond hard nips straining against the thin straps of her bikini ";
	else:
		say "You quickly turn your head in abject disinterest ";
	say "as she wraps her arms under her bust and begins frantically rubbing her upper arms to warm up. 'Allow me to help makuahine,' [']Imi-Koko says as he blows a tiny puff of steam over Galaxite's shivering form to heat her up. 'Oh thank you dear,' Galaxite coos leaning into the gust of steam, her raven black hair coils about her as she shamelessly basks in warmth of the great wyrm's breath. 'Ah, much better, but,' the dragon mother says as she sniffs her arm and grimaces, 'you should chew on a mint first next time. Your breath is a little fishy,' Galaxite teases.";
	say "     'Apologies mother,' [']Imi-Koko says, lowering his eyes. 'Oh, don't worry about it hun, your heart is in the right place. Now let me see here,' Galaxite says as she pulls off her scuba bag. She sets it down on the deck and begins rummaging around on the floor. 'Ah there it is,' she says, pulling out something akin to a heavily modded generator with the cyrillic serial number MYH-2 on the side. The unpainted thing looks to be affixed with a crude voltmeter and hand pump that looks like it was taken off a pair of jumper cables affixed to one side. The other is host to a number of adapters, plugs, and ports many of which you haven't seen before. 'Let me see if I can breathe some life into this sea hulk,' Galaxite says as she heads over to one of the remaining crane control panels. She kneels down on all fours[if Loyalty of Galaxite is 0]giving you a generous glimpse of her thick camel-toe pressing against the thin blue spandex of bikini bottoms as her hips sways invitingly as she works[end if] and pops a small hatch near its base.";
	WaitLineBreak;
	say "     'Hm, let's see now, which one of you is power...' she murmurs sifting through a tangled mess of wires. 'Ah-ha, there you are!' Galaxite cries triumphantly as she unhooks a pair of red and black, then connect them to her jury-rigged generator. 'Alright here goes nothing,' she says, easing herself into a sitting position. You observe her as she rapidly depresses the analog motor forcing a steady stream of juice into what's left of the ship's subsystem. 'Davai-davai-davai!' she hisses, as voltmeter on her crude contraption wildly bobs back and forth like a metronome till at last the thing turns over with an angry pop. 'Yes, I knew this would work!' Galaxite cries as stands up and heads over to the other crane then repeats the process. Once it's thrumming with life once more, Galaxite calls out to you saying, 'Hey [Name of Player] think you can handle that crane, cause we're gonna need to hurry. I don't know how long this charge will hold, or if this poor girl can handle another jump.' Shrugging, you tell her that you'll give it a try."; [Davai depending on context means come on/hurry up/get moving in Russian]
	say "     However, you don't think you've ever operated something like this before. 'Me neither. Just pretend it's a big old prize claw or something, it'll be fun!' Galaxite chuckles as she starts monkeying around with the controls. Oh well when in Rome, you muse as you start toying with the dials to see what does what. [Italic type]One hour later[roman type], you and Galaxite have have carefully extracted all but one of the containers from the hold and passed them into the brother dragons, who with your combined help secure the crates in an interconnected line that they can carry between themselves. Just to be sure though, both you and Galaxite triple check each loop and knot. Once you're satisfied nothing is going to shake loose, your partner is just about to give the order for everyone to leave, when a strange dark shadow begins to billow along the water adjacent to the port side of the ship. At first, you pay it no mind, and simply assume the growing outline belongs to one of the sea dragons, yet after doing a quick head count.";
	WaitLineBreak;
	say "     You realize all the wyrms are present and accounted for, and make ready to bellow your warning to the others, only for the words die on your lips as the swirling water draws the attention of Galaxite and her dragons. At once all eyes turn port, as the encroaching mass takes on all too familiar shape as eight massive umbral tendrils the size of behemoths lined with person-size lavender suction-cups burst from the churning depths. 'FOUL LAND WALKERS, WHO DARES DISTURB THE SEA QUEEN'S NEST!' a thunderously deep feminine voice shouts while the azure water parts and a deathly pale, almost humanoid, face rises from the deep. You watch as the wrathful yet oddly cherubic face and plump double chin ringed with wriggling purple tentacle hair leers over the vessel. The creature's piercing amethyst eyes narrow into unearthly crisp horizontal pupils at sight of you. As it continues to rise above the building waves, a pair of two, too-big-for-a-cup size tits, nestled atop a pronounced lumpy pot belly and capped by inverse magenta nips, peeks over the edges of the railing.";
	say "     You feel a brief flicker of primitive primeval dread scratching at the back of your mind as the sea beast's corpulant shadow slowly blots out the available light. You stare almost transfixed at the titan's sudden appearance as the self proclaimed queen roars, pointing a bloated sausage finger at you, screeching, 'Vile air breathers, you shall pay for your impudent trespass upon my holy waters! But tell me, before I feed your bones to the kelp, what possessed you lowly ground crawlers to come here and defile my pristine waves with your surface-borne filth!' A heavy oceanic ripple passes through flabby arms and gelatinous middle while they roughly tread water beside the strict vessel. You realize that despite the creature's size, it's blubbery form was never meant to exist above the waves as already, you can see it begin to pant with effort as its rotund arms sink into the rubbery folds of its doughy middle. Still despite it obvious distress and apparent malladaptions, a titan of this scale would have little need for finesse or martial prowess as it could simply roll over and crush you, alongside all your loot to oblivion.";
	WaitLineBreak;
	say "     With only moments to spare as you sense the creature's labored patiences beginning to wear thin, you quickly evaluate your options as you survey the area. The first thing that comes to mind is calling on Galaxite and her dragon to sort the problem out. ";
	if Intelligence of Player >= 20:
		say "Then again, one of the containers is attached to the crane, and it still has power. Given the sea sow's obvious lack of dexterity, it would be trivial to brain the bint into submission with a few well-timed swings of the crane. ";
	if Charisma of Player > 20:
		say "Of course, you could always try talking to them first, you can be pretty darn persuasive when you want to be, and they aren't hard on the eyes either. Perhaps you can come to an accord, or at the very least dissuade them from attacking. Large as they may seem, they're no match for Galaxite's brood should things go south.";
	LineBreak;
	say "     [bold type]What would you like to do?[roman type][line break]";
	let Always_ A_Bigger_Fish_Choices be a list of text;
	add "Have the dragons deal with it." to Always_ A_Bigger_Fish_Choices;
	if Intelligence of Player >= 20:
		add "Brain them with a container!" to Always_ A_Bigger_Fish_Choices;
	if Charisma of Player >= 20:
		add "Talk their ear off." to Always_ A_Bigger_Fish_Choices;
	let Always_ A_Bigger_Fish_Choice be what the player chooses from Always_ A_Bigger_Fish_Choices;
	if Always_ A_Bigger_Fish_Choice is:
		-- "Have the dragons deal with it.":
			say "     Reasoning that this is little above your paygrade, you turn to Galaxite and ask her brood to get rid of this oversized calamari. 'Huh,' she simpers, shaking her head as if to clear it. 'Sorry about that hehe, was just admiring the view, mh, just at those yummy sweater puppies,' she titters, shamelessly eyeing up the hypnotic wobble of the swollen sea beast's impossibly huge mounds and the hearty jiggle of her rubbery, potentially gravid, tum as her decadent body bounces in the surf. 'Wretched mongrel, how dare you gaze upon my majesty in such craven a manner why I'll-,' the wannabe queen roars, as she hefts her tendrils above her head. 'What, smite us? Grind our bones to make your bread?!' the dragon mother sneers, as she steps forward and spreads her arms to her as if to embrace the coming blow. 'Impudent sea louse, I'll start with you first then!' the off-brand sea witch cries as she fixes Galaxite with baneful glare. 'Ha, I'd like to see you try... Kids,' the monster mommy jeers, lips curling into a predatory smile as her brood rears up behind her, looming head and shoulder above the lesser titan. 'Geh Monah?' the dragons rumble, as twelve sets of blazing orbs turn on the corpulent squid.";
			say "     'Get rid of this thing!' she roars, forming her hand into a pantomime of pistol and levels it the feral's heart. 'With pleasure,' the imperial wyrms growl, baring their wicked fangs as their heads coil her svelte form in groups of two while multi-hued lightning dances upon their yearning maws. At the sight of so many true dragons bearing down upon them, the false queen's courage seems to buckle as her eyes go wide with terror and she starts to turn tail. Too late though as brothers roar in unison, 'Kyr!' 'Kai!' 'Kol!' 'Sol!' 'Zaan!' 'Soku!' as blinding orbs of red, blue, white, brown, black, green simmering to existence along steamy serpentine curves of their azure muzzles. The air resounds with the potent static thrum as light and gravity seems to bend around as if caught in the grasp of black hole as the chaotic energies slip from this an unearthly storm of many colors and none. "; [Earth! Sea! Sky! Fire! Life! Death!]
			if "Touched by Madness" is listed in feats of Player:
				say "'FINGER BANG!' Galaxite roars, cocking her hand as if firing a shot.";
			else:
				say "'Bang,' Galaxite whispers, recoiling her mitt in a theatrical parody of a shot being fired.";
			WaitLineBreak;
			say "     'Nurts! Sturm!' The brothers shout as one, unleashing the full fury of voices upon them in a twisting stream of impossible hues directed at the creature's chest. 'Oh NO-NO-NO!' the petulant royal cries as it tries to block the beams of raw draconic energy blaring down upon it with its tendrils, and for a moment it's blubbery limbs seem to hold. But only for an instant, as the creature is pushed further back, blinding light and draconic flames cascading about its hide as it crackles and steams as the water and viscous oils soaking its rubbery umbral flesh boil away while flickers of chilling cold and void-wrought darkness entomb her limbs in eldritch ice.";
			say "     Strange otherworldly coral crawls along its tendrils as its guard breaks, and gravity seems to lose its hold on the crazed feral as it is flung into the distance, propelled by the bright tail of the dragon's combined wrath. 'Well that was fun, good job boys!' Galaxite giggles as she relaxes her stance and reaches out to lovingly pat each of her sons on the nose. Chirping in a soothing reptilian trill, her sons eagerly lean into her touch, as they nuzzle their bestial snouts against her comparatively tiny palms in a base display of affection. 'Daw, I love you guys too, now let's get this stuff back to shore,' she swoons with a look of pure adulation emblazoned upon her face as their doting regal visages coil around her.";
			say "[TheEnd]";
		-- "Brain them with a container!":
			say "     Oh bugger off you stupid feral, you mutter under your breath, deciding to  apply your budding familiarity with crane's controls to full martial effect. As with but a few careful twists of joystick, you send the crate hurling toward the sea sow's face. Caught off guard, the heifer barely even has time to blink as the container's hardened edges slam into their doughy face. The creature is sent reeling as their dome shoots back from the force blow, yet they remain standing, growling, 'Ow, you horrid monster! How dare you strike my royal visage in such an uncouth fashion,' as the wannabe noble hefts their tendrils out of the surf, then aims them at you. Undeterred, you flick your wrists again, importing a heavy spin to the line as you send it soaring back and this time catch them in the back of the head. Though the metal screeches and buckles in places from the impact, it holds nonetheless as the feral's face is rocketed against the ships hull with wet meaty thud.";
			say "     Though its front teeth chip and shatter as they're sent flying about the area, it still refuses to go down and picks itself up, warbling in a proud but dopy tone, 'Fools, I have not-,' it pauses and starts to list ever-so-slightly, 'yet even begin to fight!' Ya whatever, you chuckle as you key up another circuit. All the while, Galaxite and her brood watch in amused silence, as they swivel their heads in tandem with each blow as you pound the lesser titan to the surf only to rise again and as it barks more empty threats. Which you meet with the same bored indifference, as eventually you start to hear the draconic family begin to lightly chuckle amongst themselves as you juggle the creature between the devastating swings of the boom, till the whole deck erupts in a squall of cruel reptilian jeering as the lesser titan finally collapses in a gelatinous heap, warbling in dreamy disgruntled tenor, 'You do realize this, means, war...' as it struggle to peer over the heaving tightly pack mound of it lumpy middle, only to fall flat on its back with a hard splash as it bobs helplessly besides the ship.";
			WaitLineBreak;
			say "     Still cackling at the spectacle, Galaxite strides past you, flashing a mischievous smile in your direction as she leans over the rails, whispering, 'Vix,' as she puckers her lips and blows, sending a pronounced ripple through the feral's rubbery hides as it floats off, gibbering to itself in a broken cadence about how it shall have revenge on the surface world. Yet, such threats ring hollow to your ears, as the only thing the sow could truly threaten is an all-you-can-eat-buffet. With any luck, the military will take care of them before they hit the quarantine line, you muse, as Galaxite tucks her hands behind her head and turns on the balls of her heels to face you, exclaiming, 'Well that was fun to watch!' as she beams a wide Cheshire cat smile. 'And good thinking with the crane, [Name of Player]! Shame about the crate though,' she adds with a shrug, motioning to the dented hunk of metal with a playful flex of her ears. Nodding you tell her it was nothing then ask if she's ready to head back to shore. 'Sure am, kids, how about you guys?' she says, with loving trill."; [Vix = Wind]
			say "[TheEnd]";
		-- "Talk their ear off.":
			say "     In no mood to pick a fight with this creature unless necessary, you motion to Galaxite and her kids to not provoke this creature and let you handle this as you step forward then greet this alleged [']Queen of the Sea['] with a deep respectful bow. 'Ah what's this, manners, from a Land Walker? Why now I've seen everything,' the queen huffs, in a perplexed tone as it seems to relax ever-so-slightly at your sudden display of deference to a being of their supposed status. Encouraged, you introduce yourself, Galaxite and her brood, then politely ask the buxom queen what their name is. 'Echidna, Queen of the deeps, mother of monsters, and eternal enemy of Atlantis,' the voluptuous royal intones with a supercilious trill. Nodding your head, you thank their eminence Echidna for deeming to enlighten you, then proclaim much to your everlasting dismay, that you were unaware that a being of such noble bearing and profound beauty had laid claim to the shoals.";
			say "     Had you been aware, you would have requested an audience with their imperial majesty before setting a toe in their dominion. 'Truly? You are not invaders or thralls of Atlantis?' Echidna inquires with a note of skepticism ringing through their labored breath. Nay, you are neither thralls nor invaders, but a humble salvager tasked with removing the waste left behind by those who dwell upon the surface. 'Hm, then perhaps our goals align Land Wa-,' Echidna pauses to catch their breath, '[Name of Player]. Since my arrival in these strange tides, my brood has been poisoned by the foulness leaking into the waves.' They sigh, running their hands over the rubbery lumps poking through the tender layer of adipose swaddling their middle. 'Though I know not the poison's name, I had hoped this vessel of iron would have protected them, yet this miasma remains and has left my broods weak, small, and ignorant. Most never hatch and those that do lack their essence of change and primal chaos.";
			WaitLineBreak;
			say "     'Where once I birthed scores of ever-changing monsters, whose great and terrible names echo throughout history!' they proclaim with defiant roars, as motion the fecund swell of their titanic form. 'Now only the squid girls, as some call them, emerge from their shells as pale echos of the glory they once possessed. Of these, few remain at my side and instead choose frolic on the shore where they are often preyed upon by the sharks and [italic type]dragons[roman type] of this place,' Echidna sneers, at the assembled wyrms, evoking angry rumbles from the brothers as they glare daggers at the bobbing queen. Thankfully, Galaxite quiets them with a low tut before stepping forward herself. 'Ya uh, sorry to hear that cutie,' she simpers with a corked smile, 'but my boys don't eat people or fishy people, isn't that right kids?' she says, with a proud wave of her hand towards her young. 'Gah, our mother speaks the truth, we of the Nazokaazthur have no quarrel with your kin, nor desire to feed on those gifted thoughts and reason as you and your kind are oh mighty queen,' Nui-Koa rumbles, as he lightly nuzzles the tip of his chiseled reptilian chin along Galaxite's shoulder.";
			say "     'Then perhaps I have misjudged your cohort dragon mother, for I smell not the flesh of my kind on your breath nor hear the tendrils of deceit in your words,' the queen murmurs, with an almost human trill of fatigue. They seem to sink into themselves as if the previous fire within them had been snuffed out. 'I bid you then, take what you can, but leave this cradle, it may yet save some of my brood from the taint of this place,' Echidna says, gesturing to ship with a weak flick of their tendrils. Nodding, you tell them that sounds fine, and follow up by apologizing for any disturbance or distress your presence may have caused. 'Then our pact is struck [Name of Player], go now, but do not return, though I'm willing to overlook this trespass, I will not suffer such violations again!' the queen roars, as they exhale loudly and slip quietly beneath the waves.";
			WaitLineBreak;
			say "     Once their shadow vanishes though, Galaxite turns to face you with an appreciative look in her golden eyes. 'Wow, [Name of Player] you've got quite the silver tongue, honestly thought the boys and I were going to have to get rough with them.' Shrugging, you reply it was nothing, never hurts to try talking first after all. 'Guess you're right, I've spent so much time doing things the Old Man's way I've,' she hesitates a moment, her briefly drifting towards her kids, 'forgotten things don't alway have to end with someone in a ditch. Besides, I'm glad we didn't have to fight them, it would have been a shame to hurt such a milf. Especially one as big and cuddly looking as they were,' she teases, before directing her attention to her kids. 'Right everyone, let's get this show on the road!' she exclaims, proudly pumping her left fist into the air.";
			say "[TheEnd]";

to say TheEnd:
	say "     '[']Ae makuahine, what is your will?' the brothers intone as they draw themselves up to their full height and await her instructions. Smirking at the sight of her dutiful brood, the buxom dragon mother sets about directing all but [']Imi-Koko and Mau-Loa-Pahi to take the containers and go to find some place to hide it from prying eyes at the beach. As for [']Imi-Koko and Mau-Loa-Pahi, she instructs them to help her get the yacht to shore. 'It shall be done!' the assembled Sea Dragons cry as they split off on their assigned tasks while you and Galaxite make your way over to the yacht. Along the way, the buxom dragon mother heads over to the still slumbering Yuppie Mink to retrieve her bottle of wine, jacket, and captain's hat. Swishing the bottle once, she takes a long pull and kicks the Yuppie Mink once in the guts, saying, 'Alright time to wake, you little off-brand kobold. I got an offer for you, so listen up good cause I hate repeating myself,' as she sets the bottle on the deck and watches him stir.";
	WaitLineBreak;
	say "     'Ugh, *hack*,'I'm n-not a freaking Kobold, I'm a mink *weeze* you goddamn over-bronzed bimbo,' the yuppie mink coughs his eyes ablaze with defiance as he tries to pull himself to his feet with the assistance of the pulpit. 'I'm sorry,' Galaxite rumbles, flicking open her nightstick and points it at the mink's throat. 'What was that you just said? I must have a little water in my ears,' Galaxite says patting her fins, 'so I may not have heard you correctly.' She threatens him, hooking the tip of the baton under the mink's chin and roughly pushes his head back against the railing. 'N-nothing what do you want!?' he spits, in an angry, yet meek tone. 'Ah good kobold, that's what I thought you said.' Galaxite smiles a sharp toothy grin at him as she withdraws her baton and pats him on the head.";
	say "     'Now, you see my new ship here,' she nods towards the wheelhouse, 'needs a helmsman, furry mutant thingy,' she says, playfully bobbing her head in tune with each word. 'And while I was going to ask [Name of Player] here,' she points her nightstick in your direction, then collapses it by slamming the tip against the railing and hooks it back onto her diving belt, 'if they want the job, but something tells me the hours may not gel well with their schedule. So what do you say, you want the job?' she asks, in a warm voice that's sweeter than honey. 'What? This is [italic type]MY[roman type] boat you psychotic cunt, how dare you presume to-,' he replies but is cut off as Galaxite stomps her foot on his fluffy white chest, slamming him against the railing. 'Ah-ah-ah, language Mr. Kobold, language. I don't want my pure sweet innocent derggy angels picking up any of your nasty little sailor boi talk,' Galaxite tuts shaking her left pointer finger at him as she nods towards her draconic brood.";
	WaitLineBreak;
	say "     '*Hack* right sorry so, er, hypothetically speaking, what happens if I refuse?' the mink asks as he stares up her shapely leg. 'Oh nothing, I'll just throw you overboard, and you can swim back through the struggle-snuggle monster-infested waters all on your own. Assuming you know which way the shore is, Mr. Kobold,' Galaxite jeers in an overly cute tone, as she withdraws her leg and gestures to the endless blue horizon with a flick of her ears. 'That's not a very good offer,' he grumbles. 'Fine ok,' Galaxite rolls her eyes, 'I guess you can have my hat too, but I'm keeping the jacket, it matches my complexion.' She preens, straightening the gold fringed collar of her royal navy blue jacket. 'Grr... alright, I'll pilot us back to the coast but once we get back to shore, I'm leaving,' he mutters, shaking his head in defeat. 'Oh no-no-no Mr. Kobold, we can't have that. You said it yourself, good help is [italic type]SSSOOO[roman type] hard to find these days. Besides,*fufu* I don't think any of the local tenrecs would enjoy the job as much as you seem to.'";
	say "     Galaxite smirks, as she leers over him, cupping his muzzle in her hand and stroking the underside of his chin. [if perception of Player < 20]You watch her lips move but hear only a low static hum[else if perception of Player >= 20] you hear her whisper. 'Rune-Mir-Gron,' as red, blue, orange, and white wisps of hoarfrost seep from her lips and coil about the minks' nose[end if] as her sordid sweater puppies dangle "; [Translation: Beast Will Bend]
	if "Touched by Madness" is listed in feats of Player:
		say "centimeters ";
	else:
		say "inches ";
	say "from the mink's muzzle as she motions to his groin. *Gulp* what are you going on-,' the mink begins as looks to see his sizable red rocket peeking out of his cute snow-white sheath. 'Ah, goddamn it, that's not for you!' he cries, crossing his legs as he tries to hide his growing stiffness with his fluffy white tail. 'Don't get so bent out of shape Mr. Kobold. Here, I hope this makes you feel better,' Galaxite says, pulling her cap off with the crook of her left pointer finger, twirls it once, then plops the mink's hat on his lap with a playful flourish. 'Uh um thank you, miss?' the mink asks, clutching the hat to his groin as if to preserve his modesty. 'Galaxite, now do be a dear Mr. Kobold, and take us to the beach,' she answers as she helps the man to his feet. 'Ye-yes ma'am,' [']Mr. Kobold['] replies and heads off the wheelhouse with his hat bobbing on his cock and water wings tucked over his arms. Once he's out of earshot Galaxite turns to you and lets out a low sigh of relief saying, 'Oh boy, glad that worked, I haven't tried that trick without some eggs in the boiler before,' as she looks to you for your response.";
	LineBreak;
	say "     [bold type]How do you feel about what just happened?[roman type]";
	LineBreak;
	let You_cool_with_Mindcontrol_bro_Choices be a list of text;
	add "Impressed." to You_cool_with_Mindcontrol_bro_Choices;
	add "Uneasy." to You_cool_with_Mindcontrol_bro_Choices;
	let You_cool_with_Mindcontrol_bro_Choice be what the player chooses from You_cool_with_Mindcontrol_bro_Choices;
	if You_cool_with_Mindcontrol_bro_Choice is:
		-- "Impressed.":
			say "     A bit impressed by Galaxite's ability to so quickly cow the yuppie mink, er Mr. Kobold you correct yourself. You compliment her on a job well done, noting that having a helmsman for this ship could be very useful in future. Especially, if another supply ship grounds itself, or even serves as a trading vessel, despite its limited cargo capacity compared to a dedicated supply ship. You're sure there are plenty of folks in the Warehouse district, Vohr island, or even at the beach you could work with in that regard. Not to mention, it could be a nice mobile base of operations, assuming the military doesn't take offense to your presence on the open water. 'Huh, hm, I never thought about that,' Galaxite says with an odd look of relief on her face. Wait, this wasn't all part of her plan, you ask. 'Nope, I always wanted a boat, so I took this one,' she says with a shrug. 'Besides, this thing is pretty well-stocked too, did you know there's kitchen, bathroom, and a projector below deck? I've never used one before, but I hear you can hook your phone or laptop to the newer ones and watch movies on them. Oh, I bet the boys would love to watch Dragon Soul on the sail of this,' she says, motioning to the main mast.";
			say "     'Gods, I know he probably tastes like raw haggis, but I would totally have bent over for that beefy brown Scottish dragon starring in it. Maybe even let the knight watch too, if he washed up first,' she drools, openly pawing at her toned midriff. 'Eh, sorry about that, what was I saying?' she simpers, shaking her head. Chuckling, you remind her she was telling you about the boat's amenities. 'Right, ya there's only one little problem. This thing's equipment seems to run off of natural gas. So I'll need to find more soon, may have to convert it to solar later. Now that I think about it, I saw some panels at the warehouse district no one was using, and I know a guy who can install them real quick,' she adds, gazing towards the southern end of the city. Nice, can you see? 'Oh no not yet, Mr. Kobold and his friends made a bit of a mess below deck,' she titters nervously. 'I'm gonna need to have him scrub the jellyfish off the walls before I let you go down there.'";
			WaitLineBreak;
			say "     'Don't you want you slipping on a slimy and turning into some weird mink-tenrec hybrid now,' Galaxite teases as she walks over to the door of the wheelhouse. 'Still, I did find a nice little snack and a few bottles of lychee juice we can munch on in all that mess. Ahem, oh Mr. Kobold,' she says, knocking on the wheelhouse door. 'Do be a dear and bring us the cheese desk you were keeping in the back of my fridge.' 'Uh, it's called a [']charcuterie board['] not a cheese desk... ma'am.' Mr. Kobold grumbles from the other side of the door, sounding as if he were talking through his teeth. 'Sure-sure whatever you say Mr. Kobold, now be a good boy and bring it around once you've locked our course. I wanna enjoy the ride back with my partner,' Galaxite counters as she hops on the roof. She leans over the side and offers you her hand along with a jovial smile.";
			if BodyName of Player is listed in infections of FlightList: [Fuck horses]
				say "     Politely waving her hand aside, you flap your wings and boost yourself up in a single bound, land beside her with a muted swish. 'Wow, lucky duck, I was wondering if the wings were for show or not,' Galaxite quips with a pleased smirk on her face as eyes up your form appreciatively. Leaning into her gaze, you tell her they seem to work just fine. You merely haven't had the time to practice with them much. 'Well if that's the case, we should totally ask some of my Yamato's, or the Ullokinne, as they prefer to be called, to give you a few flying lessons one day. It's a shame to just have a beautiful body and make full use out of it.' Huh, you might take her up on that, you opine aloud. It's probably safer than jumping off a random building all on your lonesome and hoping for the best. 'Ya, wouldn't want you to get hurt, now would we?' Galaxite titters in a playful tone.";
			else:
				say "     Nodding, you grab her hand and you're almost taken aback by her sudden show of strength as she effortlessly pulls you up beside her like it was nothing. Justifiably impressed and perhaps just a little shocked that a woman her size could pull you and your belongings up so casually, you politely compliment the lithe beauty on her feat. 'Daw thanks, but you're pretty light compared to my first few clutches of Yamatos, or Ullokine as they liked to be called,' she simpers in a pleased dreamy tone, as she places her hands on the sleek washboard curves of her toned middle. 'Gosh you should have seen me near the end, why if felt like I was almost more tummy then mummy,' Galaxite teases in a wistful saccharine cadence. 'Mh, but it was worth all the hassle just to hear their little chirps when they finally hatched and watching them grow into the handsome daddy dragons they are now,' she murmurs, as her eyes drift towards the state park. 'Shoot,' Galaxite hisses, clicking her teeth, 'I should really check on them! We haven't talked since they dropped me off at the Mall, poor dears must be worried sick about me.'";
			say "     As a reply begins to form on your lips, a rattle from the door below you draws your attention as the yuppie throws the aperture open, hollering, 'All right, I got your damn vittles! Miss,' in a tense combative tone. 'Oh now-now Mr. Kobold, no need to get all feisty,' Galaxite says, rolling her eyes in their direction as she stride over the edges of the platform. 'Don't worry, I'll save you a few pieces,' she chides, as she ";
			if loyalty of Galaxite is 0:
				say "leans perhaps a little too far over the edge as her bikini bottoms dig ever-so-slightly into the subtle yet altogether pleasant padding of her well-exercised ass. A part of you finds it hard not to admire the tight little ripple of her runners thighs, the gentle strain of fabric of the thin blue lycra cradling her tanned oh-so-poundable cake, and the heavenly sway of her maternal mounds as the boat rocks beneath her while she gingerly plucks the proffered tray from Mr. Kobold's paws ";
			else:
				say "hurriedly plucks the tray from the little mink's paws. ";
			say "'Really?' he replies with an odd note of excitement in voice only to have it die a moment later. 'Ugh, *gulp* I mean whatever you say, ma'am,' the cowed mink grumbles. 'Ha-ha, of course Mr. K, what kind of owner would I be if I didn't take care of my-,' she pauses, the edges of lips curling into a hungry primeval grin, 'pets. Now off you trot,' she adds with an overly haughty wave of her left hand.";
			WaitLineBreak;
			say "     'Er, I, ugh, *pant* o-of course ma'am,' the mink murmurs, his voice breaking like he was passing a kidney stone as he loudly marches back into the wheelhouse, slamming the door behind himself. 'Ah, such a willful kau,' she titters under her breath with a nonchalant shrug of her shoulders and a flex of her ear fins. The vivacious dragon breeder, turns on the balls of her heels, and strides over to the center of the platform, tray and sea-green bottles of juice in hand. 'Come on ";
			if Loyalty of Galaxite is 0:
				say "cutie ";
			else:
				say "partner ";
			say "have a seat,' she proffers, sitting herself cross-legged on the ground, as she sets down the tray. 'All this adventuring has really worked up my appetite,' she beams, gesturing to the stately spread of dried fruits - both exotic and common - marbled hunks of smoked meats, loaves of multigrain breads, and all manner of cheeses arrayed on a thick, plastic-wrapped, pale-hardwood cutting board alongside a set of gleaming gilded mahogany-handled knives. Nodding, and not wanting to be rude, you plop down beside her as your host breaks bread and passes you a few pre-arranged treats.";
			say "     Accepting each one with a genuine smile, the two of you lounge on the yacht, munching on rare treats and enjoying a bit of post-apocalyptic water cooler talk. Time seems to fly by as the tranquil music of your voices and the gentle lapping of the waves drowns all sense of its passage. Eventually though, you catch sight of the Rock Arch and the wider city beyond peeking over the horizon and with it comes a grumpy din from the wheelhouse, 'Land-Ho you filthy lot!' as Mr. Kobold roughly rings a heavy brass bell beneath to get your attention. 'Oh awesome, good job Mr. Kobold, but can you bring us to a full stop for a moment? I need to show [Name of Player] something before we try to land,' Galaxite hollers, as she raps the rooftop with her knuckles. 'Aye-aye ma'am!' the salty mink bellows, as the craft roughly lists to one side and comes to a complete, if jarring stop.";
			WaitLineBreak;
			say "     Seemingly unfazed by the sudden jerk, your cohort simply shrugs and motions to a modest cove nestled behind Rocky Cliffs adjacent to the State Fair, saying, 'Right [Name of Player], see that little break in the rocks not all that far from The Beach?' Nodding, you reply in the affirmative. 'Good, the boys should be dropping off our haul on the sandbar any minute. The place is pretty inaccessible unless you swim around the Rock Arch or you follow the old deer trail near,' she pauses, as her eyelids twitch ever-so-slightly and furrows into a sour grimace, 'Dra-, Francis's Point.' She grumbles, spitting out the name with a caustic mix of bile and malice, only to have her tone brighten as she continues. 'So no one should bother us while we're cracking open those [bold type]Loot Boxes[roman type].' Interesting, so is she planning to drop anchor near there? 'Uh, great question,' Galaxite answers, as she peers down at the wheelhouse and raps her knuckles on the roof. 'Hey Mr. K! Think you can park the ship by that patch of rock near the Fair?'";
			say "     'No can do ma'am, too many rocks, and the waves get pretty strong! We might be able to someplace further up spin, or down south towards The Warehouse District,' the mink exclaims with a hair less venom in his voice. 'Rats,' Galaxite hisses with a loud snap of her fingers, 'guess we'll try up north first, hopefully it won't take too long,' she sighs with an exaggerated roll of her gold eyes. 'In the meantime [Name of Player], [']Imi-Koko can drop you at the Beach, whenever you're ready we can meet up at the sandbar to crack those crates open together.' Sounds reasonable, you reply as you and her make your way to the deck as she calls her child over and fills him in on the plan. [']Ae makuahine, I shall ferry your companion with all haste!' [']Imi-Koko bellows, as he bobs over to the edge of the ship with a surprising degree of care and nuzzles his titanic frame but a hairs breadth from the ship's hull. Politely thanking the young leviathan for the ride, you hop on his back and signal your readiness with a light pat on his sail. 'At once kin da mun!' he roars as he jets off towards the shore at breakneck pace.";
			WaitLineBreak;
			say "     Much to the horror of the beach goers, as they scurry away from the noble sea dragon like rats fleeing a sinking ship as he roughly tears through the surf and sand then pulls his hulking body upon the shore. Not wanting to trespass on the dragon's good graces, you quickly dismount, and wish the regal wyrm well. 'Indeed kin-,' [']Imi-Koko rumbles as he shakes his head like an angry crocodile, '[Name of Player], it has been an... honor to have you accompany us this Nier. My brothers and I look forward to our next venture, till then Rem Kol Kai, may the peace of the heavens and sea be upon you, worthy companion of my mother.' Rem Kol Kai, you respond in kind as [']Imi-Koko bobbing his head to you then lumbers into the surf to rejoin his family. With nothing else to do but wait, you head back to the Beach and plan your next move. It shouldn't be too long before those [bold type]Loot Boxes[roman type] are brought to shore.";
			LineBreak;
			now Break Water Heist is resolved;
			now Loot Boxes is active;
			now Stamina of Galaxite is 3;
			PlayerEat 15;
			PlayerDrink 15;
			if level of Galaxite is 1:
				ItemLoss Electric Prod by 1;
		-- "Uneasy.":
			say "     Feeling a tad disquieted, you ask if she really needed to threaten a man's life? 'Aw, don't be such a Deb, [Name of Player], imagine how cool it will look when we glide in on this baby,' Galaxite titters as she waves off your concerns. 'Besides, I wasn't threatening his life, I was just,' she pauses and touches her left pointer finger to her lips, 'giving him some much needed perspective. You saw it yourself, Mr. Kobold was enjoying himself and we need a helms thingy,' she replies, flashing you an oddly sharp-toothed smile. Right, you reply in a dry tone still somewhat unconvinced about the rightness of what you just saw. 'Oh alright, don't worry about it [Name of Player], if Mr. Kobold really [italic type]wants[roman type] to go, I'll let him go,' Galaxite sighs, rolling her eyes. See that wasn't so hard, you tell her. 'Ya-ya, I'm gonna go lay down for a bit, let me know when we reach the shore.' Galaxite grumbles as she picks up her bottle and heads aft.";
			say "     Though a part of you wants to follow her, you decide against it. She obviously wants to be alone, no point in pushing her buttons this far out at sea, unless you potentially want to swim back, you tell yourself as you find a nice spot near the wheelhouse and settle in for the ride back. Which proves to be a rather uneventful one, say what you will about Galaxite's methods, but her spawn and the helmsman know their stuff. You don't think you've been on a smoother boat ride than this. It hardly feels like you're at sea, you opine, watching the ship cut through the surf. As the distance drifts past you like sand in an hourglass, not a single feral dares to get close thanks to the presence of your draconic escorts. Soon enough though, you finally spot the Rock Arch in the distance as a call comes from Mr. Kobold. 'Land-Ho you filthy lot!' he yells as he trims the sail and slows the yacht to crawl a good distance from the shore. Wondering why you stopped, you spring to your feet and ask him what the deal is.";
			WaitLineBreak;
			say "     'Surf's too rocky to land safely here, we might be able to find some clear patches of sand up north, or we head to the Warehouse district. If you want to get to the beach you're going to have to swim or grab the blowup dingy from the hold, your choice,' Mr Kobold grumbles as he waits for your answer. As you weigh your options, one of the sea dragons swims up to you saying, 'Fear not kin da mun, I shall ferry you from here. While Mau-Loa-Pahi and mother find a place to land this crude vessel.' 'CRUDE! How dare you oversized handbag, you could buy the Temple of Wings six times over with all the money I spent on it,' Mr. Kobold screeches. 'Silence Mr. Kobold, you will speak when you are spoken to!' [']Imi-Koko rumbles as he snaps his teeth at the wheelhouse. 'Boys-boys, you can sword fight later, for now let's concentrate on getting [Name of Player] back to shore,' Galaxite yells from the rear of the ship.";
			say "     [']Ae makuahine,' [']Imi-Koko says, bowing his head in her direction. '[Name of Player] shall we go?' he asks, turning back to you. Sure you tell him, but what about the loot? You haven't exactly gotten your share yet. 'Ah a pertinent question, makuahine?' [']Imi-Koko says, casting a glance at the back of the boat. 'Oh right, one second,' Galaxite mutters over the sound of a glass clinking against metal. You watch as she sashays over to the front of the ship and points to a cove some distance north of the End of the Beach. 'See that place over there?' You nod. 'My boys should be dropping the container somewhere over there any minute now. I'll meet you there once Mr. Kobold and I find somewhere safe to drop anchor.' Ok you tell her, but she better not try to short you. 'Aw you don't trust widdle ol me kin da mun?' she asks in a cute sing-song voice that reeks of high-priced liquor. ";
			WaitLineBreak;
			say "     Well, you begin but she cuts you off saying, 'Ha, I'm kidding, don't worry, I understand it's the apocalypse,' as she playfully slaps you on the back. 'Honestly, you'd have to be pretty naive to not be suspicious of people's motives, but trust me, I would rather have you as a partner than an enemy. Besides what kind of example would I be setting for my sweet derggy boys if I ran around betraying people?' Galaxite says, motioning to her son. Right, you tell her, guess you'll take her word for it. 'Hey it will be fine, just give me a few minutes to find a place to park this junker and we'll crack those [bold type]Loot Boxes[roman type] open together, I promise,' Galaxite says, in a good-natured tone as she taps her knuckles against the wheelhouse. Ok you tell her, then head over to [']Imi-Koko who's been bobbing beside the yacht waiting for you to hop on. You cast one last glance at Galaxite, then jump on his back, seat yourself on his shoulders, and tell him that you're ready to go. 'At once kin da mun,' [']Imi-Koko replies as he jets towards the shore.";
			say "     Much to the horror of the beach goers as they scurry away from the noble sea dragon like rats fleeing a sinking ship. Once you arrive back on terra firma and climb off the dragon's back. 'Mhh I know you fret over your share of the plunder kin da mun,' [']Imi-Koko rumbles as he shakes his head like an angry crocodile. 'You have my vow, mother will keep her word. Till then fare thee well [Name of Player],' [']Imi-Koko says, bobbing his head to you then lumbers into the surf to rejoin his family. With nothing else to do but wait, you head back to the beach and plan your next move. It shouldn't be too long before those [bold type]Loot Boxes[roman type] are brought to shore.";
			now Break Water Heist is resolved; [Fucking finally!]
			now Loot Boxes is active;
			now Stamina of Galaxite is 3;
			if level of Galaxite is 1:
				ItemLoss Electric Prod by 1;



Table of GameEventIDs (continued)
Object	Name
Point Nemo	"Point Nemo"

Table of WalkInEvents (continued)
Priority	Name	EventObject	EventConditions	EventRoom	LastEncounterTurn	CoolDownTurns	EncounterPercentage
1	"Point Nemo"	Point Nemo	"[EventConditions_Point_Nemo]"	BeachEnd	2500	2	100

to say EventConditions_Point_Nemo:
	if BodyName of player is "Dragon Breeder" and Player is pure and Cunt Count of Player >= 1 and Energy of Galaxite is 2 and scalevalue of Player is 5:
		now CurrentWalkinEvent_ConditionsMet is true;

Point Nemo is a situation.
ResolveFunction of Point Nemo is "[ResolveEvent Point_Nemo]".
Sarea of Point Nemo is "Nowhere".

to say ResolveEvent Point_Nemo:
	say "     Prowling about the storm-touched coast, you're struck by the odd peace and sublime desolation of the area created by the absence of the once omnipresent beach goers. Likely cowed by the biting cold, dark creeping waves, and howling rain-lashed winds, the lowly bipeds seem to have retreated from the umbral squall coiling about the shore. Still, you can feel the lingering pockets of heat left by the puny [one of]warmbloods[or]manlets[or]apes[at random] trapped in shallow voids buried beneath the icy bone white sands as your powerful paws tear through the frostbitten ground. Casting your abyssal gaze to The Beach Plaza, you can see the patch work of pale sickly yellow glow of artificial light filtering through the shuttered and boarded windows of the surrounding buildings as they huddle in fear of the benighted clouds and void-wrought frost like frightened shoals of fish. Some slithering section of your liminal mind can't help but chuckle at their mammalian fragility, as the blaring gale and heavy patter of viscous rain upon your thick, oily, scales is the gentle caress of a caring nocturnal lover. You would almost feel a mote of sympathy for the meek bipeds, to be live forced to in terror of the salubrious dark clouds and bracing cold.";
	say "     To think you may have once felt the same fear, you muse, observing the roiling spray created by the churning water filtering in a languid spiral of silvery white mist playing across the beach as if an icy veil were being drawn over the land. Here and there, beautiful towers of ice creep along the vermilion rocky cliff like the talons of some great wyrm sinking its lucid talons into the heart of the land as they crawl up the side of hills. Looking deeply into their frozen scintillating depths, your draconic senses are treated to the fluttering of dark scaly wings and the skittering afterimages coalescing in the glacial waters. While storm-born mirrors of wind-polished frost shelter along the shallow pits of the sands carved by the sea and by your lessers['] frightened footfalls, reflect the golden glow of your eyes alongside the ever-shifting hues of the chromatophores lining your [bodydesc of player] hide, in a vibrant tapestry of mercurial hues.";
	WaitLineBreak;
	say "     As the ground crunches under the weight of your reptilian majesty and the scything bite of your claws, such puny thoughts feel all the more distant to you now as the innervating ripples of the far off lightning pulse about the polished contours of your bejeweled tauric body. Along with the succulent wobble of your draconic assets or heady aphonic creak of your glossy scales as the toned muscles contained within your regal reptilian legs propels you along the frost-touched sands titillates your senses. You almost feel each ripple of the thunder heads forming in the distance sparking the natural oily coating of the hardened, yet malleable, plates lining your [bodydesc of Player] form and the beatific song of the crashing waves hungrily gnawing at the land as if trying to claim it. To your scalie ears, these howling cries are like the sweetest of lullabies, as images of coral-cloaked ruins and vast unsullied verdant kelp forests spill across the submerged land in an unstoppable tide of many colors and none. Yet, a sniveling fragment of your shrinking simian psyche still trembles at this great and terrible vision.";
	if Player is impreg_now:
		say "     Still, this intrusive insipid mewling thought is soon quieted by the comforting flutter of your nascent brood squirming in their toughened shells in response to the gale's siren call. The turbulence of your nanite-tainted mind is muffled by the lovely rush of motherly hormones and draconic pride as your paws drift to the pleasant swell of your well-lubed middles. Your lips curl into an abyssal smirk at the lovely reminder of the flight growing within you and the thought of unleashing titans equal to- no, you pause and shake your draconic muzzle, delighting internally at the meaty thrum of your tendrils as they bounce along your horns and regal sail - [italic type]greater[roman type] than the apes['] or any others upon this world, a tempestuous choir of voices swoons as your clawed mitts encouragingly massage the lovely outline of ";
		if "Weak Psyche" is listed in feats of Player:
			say "[italic type]our[roman type] ";
		else:
			say "your ";
		say "eggs as they seem to drink in the vibrant energies lashing the coast. Soon, you purr in anticipation of their coming. But not too soon, a calculating nodule of your liminal mind corrects, ";
		if "Weak Psyche" is listed in feats of Player:
			say "[italic type]our[roman type] ";
		else:
			say "your ";
		say "body is not yet complete and the flight will need to be strong for the days ahead.";
	say "     Your quartet of radiant eyes are drawn to the Rocky Arch and the roiling of the heart of the benighted storm by the reverberant clap of none-to-distant thunder. You watch as streaks of eldritch lightning pool about its borders, framing the lifeless rock with five pairs of shimmering lights suspended evenly around the weather beaten stone's sanguine edges. At least, that's what the flayed cysts of your humanity calls them, no luminance leaks for these orbs, nor warmth, or comfort. Instead, it seems as all color and light were being bled from these writhing motes in the clouds leaving only the gutted, desiccated, corpses of red, blue, green, black, and white hues in their place. Watching these hollow un-lights swirl before you, new golden slits form along their spherical cores as the unearthly aberrations are stretched into grotesque mockery of draconic eyes. Observing their unnatural gaze shift toward you, you realize to call them [']eyes['] is a reach at best."; [Author's note: Mortal Temporary Finite are the words of the 'Dragonrend' shout and are said to be some of the few concepts that the dragons of skyrim can't comprehend.]
	say "     Eyes are mortal, temporary, finite things, with limits to their sight and compression, these, some lyrical facet of your mind notes, have none of the equalities as if they can behold all of creation and all those which dwell within, with but a whim. Strangely, your liminal psyche registers not a lick of fear, nor tendril of dread at their stare, but rather an upwelling of coldblooded kinship with the growing tears upon the face of reality. As if you were gazing upon the half-glimpsed face of some long lost friend or a caring patron passing through a crowd, you feel can their name bubbling to your lips, akin to a ripple rising through the placid depths, that is until your potent vision passes over a tiny mamallan shape seated upon the Rocky Arch as if it were their throne. Galaxite, you whisper, senses sharpening to an honed obsidian razor's edge at the sight of the smirking monkey, playfully fanning her shapely legs off the stone's edges as she watches you from afar.";
	WaitLineBreak;
	say "     Though her long raven black hair flutters behind her like tendrils of umbral eelgrass, she seems untouched by the ceaseless downpour, as the inky rain parts around her trim figure. To your draconic eyes, her once lush DD's appear to have shrunk back down to cute perky C-cups, why though, you can't say, perhaps it's a quirk of her nanite's reptilian nature, or she used one of the unusual body-altering drugs that have found their way into the city. Her toned tum appears to have regained the graceful tight curves you saw when first rescued her. Despite her diminished proportions, you can't shake the feeling she seems larger than before, though not physically. Her presence carries an impossible weight behind it as merely looking at her beautiful, bronze, tanned skin and molten golden eyes puts an almost painful pressure on the back of your head. You feel as if your brain were clamped in a vice or throttled in the palms of some unseen hand, yet with each beat of your coldblooded heart, the throbbing recedes. In its place though, comes a compulsion to join her out in the storm-wrecked surf to bask in the brilliance of her eternal golden eyes and wallow in the velvety black waters lapping affectionately at your webbed talons.";
	say "     Spreading her arms wide as if to embrace you, you watch as the demi-human mouths but a single carilion sweet word that echoes through the storm, '[italic type]Come[roman type].' As the gentle caress of her voice and wonderful golden glow of her eyes cascade over you, you feel your paws move of their own accord as you're drawn into the welcoming, bracing, frost-kissed waters of the eldritch sea roiling, almost affectionately, at your supple pads and craved statuesque legs. With each heavy dreamy step, you feel the onyx waves coiling ever higher about your [bodydesc of Player] form as if welcoming ";
	if "Weak Psyche" is listed in Feats of Player:
		say "[italic type]our return[roman type].";
	else:
		say "you.";
	say "     Another time, you might have felt some degree of trepidation at the killing gelid of the sluggish waters traipsing about your hide. Now though, your abyssal draconic mind swoons at the loving wispy tendrils of the boreal bliss brushing your flanks as you sink beneath the surface. Though a momentary flutter of sapien fear flickers about your heart when you try to breathe while the thick umbral surf coils about the edges of your sleek reptilian muzzle, only to find the sweet kiss of the ocean filling your hybrid respiratory system with a rush of otherworldly invigoration. At once, storm-wrought vigor sings through your veins as the tainted sea embraces your tauric splendor in its cold velvety currents and pulls you deeper into the yearning arms of the squall. Encouraged, you submerge yourself fully in the primeval swell as the sandbars fade into the wondrous eternal gloom. Your altered mind basks internally at the first beatific tug of the surf playing along your webbeding as you take the first experimental paddle in your proper aquatic form."; [Note: PC more or less has eldritch sonar in this next part.]
	WaitLineBreak;
	say "     Though initially awkward, as the landborn segment of your psyche reels at the inhuman movements of your many limbs, you're unable to deny the strange thrill the motions bring as your hydromatic body cuts through the churning surf as the ever-shifting tendrils of the currents caress the sleek contours of your oily lamina. With each stroke of your tauric appendages, the feeling of wrongness wanes, and an exhilarating rush of pure unbridled speed almost overtakes you as you dart through the murky shores, propelled by the heavy bite of your paws and the occasional flap of your wings. Your control grows too with each passing second as your unbound serpentine body pierces the waves with a sensual slither. Your senses seem to sharpen as the perpetual smokey-hued twilight recedes just a hair, shapes both near and far simmer along the edges of your awareness as the subtle vibration echoing through the water fills your mind's eye.";
	say "     Concentrating on them, you can almost [']see['] the ocean floor sprawling before you as every rock, crevice, or errant bit of flotsam floating through the depth shimmering about you in every direction like pale bone white constellations cast upon a silken canvas of comforting darkness. Pushing your awareness further, new images flicker among these waxing stars as the outlines of all manner of sea life wink into being. Each one radiates its own inner light, as placid blues shelter in the lee of hidden caves, cautious yellows scurry through kelp forests, and pulsing pinks intertwine with one another in private carnal encounters. Above them all though, twelve massive serpentine figures outshine them as coiling raging reds, fearful blacks, dutiful golds, and faithful white hues filter through the velvety gloom. In moments, you can sense their awareness touch yours as their colors flare red and gold and a new song cascades through the waves towards you.";
	WaitLineBreak;
	say "     Its first note is hard and ancient, filled with the weight of old words spoken in haste, you feel the echoes of a pact struck long ago, flickering through you, its tones laced with pride, arrogance, and short-sighted desires that form chains of supple silks and beautiful gold about your neck. Then the ripple changes, the bonds loosen, yet the raw touch still thrums about your throat as a sense of hollow kinship, begrudging acknowledgement, and well-meaning betrayal invades your thoughts, as the note flows into the next stanza. Your heart begins to pound with the primal thrill of the hunt and the bestial unity of the pack. The invigorating rush of the chase and the crimson sweetness of the catch roiling on your lips. Then, the bitterness of defeat entwined with a low begrudging respect for the clever prey that got away simmers along your psyche. As the final note of the abyssal dirge passes, something deep within you stirs in reply to the sea titan's call, pressure builds along the base of your skull as this coldblooded presence scratches at the wall of your mind, eager to have its voice echo over the roaring storm lashing the world above the waves once more. In moments, you fear its call may overwhelm you if you don't do something."; [Note: this is part of what Nui's language 'sounds' like.]
	LineBreak;
	say "     What do you do? [bold type]Note: your choices here will not lock you into or out of any content.[roman type][line break]";
	let Call_of_The_Deep_Choices be a list of text;
	add "Surrender to the presence, allowing it free reign to speak before it overwhelms you." to Call_of_The_Deep_Choices;
	if "Weak Psyche" is not listed in Feats of Player:
		add "Let the presence speak, but listen closely to its words." to Call_of_The_Deep_Choices;
	if "Strong Psyche" is listed in Feats of Player:
		add "Push back against the nascent presence with your indomitable will." to Call_of_The_Deep_Choices;
	let Call_of_The_Deep_Choice be what the player chooses from Call_of_The_Deep_Choices;
	if Call_of_The_Deep_Choice is:
		-- "Surrender to the presence, allowing it free reign to speak before it overwhelms you.":
			say "     Yielding to the voice, the pain coursing through your skull recedes as the primeval rumble ripples through your core, loud, domineering, and bellicose, its white and red hues seep from your chromatophores as it lashes out at the distant leviathan. A thunder of pained blacks mixed with servile rusty-green notes stain the tranquil gloom of the storm-touched waters as the juvenile titans seem to bow to the voices slumbering within you. Seemingly pleased, you can sense the otherworldly intelligence preening happily at their reply and praising your decision to let it speak though not with words the fracturing fragment of your human can comprehend. As alien motes of affection bubble in your breast, as the inviting edges of the voice's talons caress your body like a beloved partner. However, their touch is short lived, and soon the other awareness slinks back into the lurid depths of your mind, apparently content for the moment to mirthfully watch your progress from afar, for now.";
			say "[MovingOn]";
		-- "Let the presence speak, but listen closely to its words.":
			say "     Curious yet unbowed, you relax your mental defenses and allow the presence to filter into you like sand passing through a sieve, perhaps mistaking your actions for one of submission, the presence surges to the forefront of your mind. Seemingly unaware you still retain full control of tauric form, the intruder bellows notes of brassy reds and enthralling white laced as words flicker along the edge of your psyche '[italic type]Na reck da han kovve nuthi[roman type].' As they echo throughout your being, you feel the tones twist and distort about the walls of your mind, then return to you in more familiar form: '[italic type]Serve, as the five headed one commands[roman type]!' The slithering choir voices blares, their words lashing at the young sea titans and the motes of gold, white, and red from their blazing outline. You watch awestruck as a rush of fearful blacks and servile rusty-greens engulf their luminous forms, though not completely, as single drop of simmering platinum still clings to their heart scales.";
			say "     You can feel the presence raging at the hated hues polluting the gloom with its baneful light as tendrils of crimson reds and pale whites leak from your chromatophores. Its choler gathers like the curl of a wave, as you sense the slithering sentience's desire to punish the young titans, yet you hold the reins to this form! You will decide when, or if punishment is due! Not this bellicose choir, or anyone else! You roar internally, as the domineering tendrils of your will tightens about the voice's neck like a chain and force it back to the depths of your nanite-touched mind for this insolence! Though it rages, kicks, and squirms in your mind's grasp, your rage and draconic will is far stronger than its wild thoughtless struggle. Till with final push, you hurl the choir back to writhing nanite-laced void of your fragmenting psyche and slam the gate shut behind it. In that instance, your chromatophores blare imperial platinum and luminant gold, and for a scant second, the gloom recedes at the touch of your radiance, then all is black once as the choir vanishes from your mind, for now.";
			WaitLineBreak;
			say "[MovingOn]";
		-- "Push back against the nascent presence with your indomitable will.":
			say "     No stranger to mental intrusion, nanomechanical or otherwise, the sudden rush of presence clawing at your mind, though initially surprising, holds little power over you. Steadying your breathing, you close your eyes and draw upon the boundless well of your draconic will, alongside the deep pools of experience you've accrued in your time exploring the city as you turn your awareness inwards. Your internal world rages with a choir of countless voices snarling and baying like a knot of rabid, umbral, ephemeral serpents as they seep from the depths of your mind in a deluge of chittering madness. Yet, you easily float above the storm, calm, and serene, picturing the silvery motes of your willpower tightening about their necks like a noose. In movements, your mental landscape shimmers with platinum light as the cords of your unbowed will tighten about the budding choir of brassy voices blaring in the back of your mind. Drawing them taut, you feel the dissonant voice hiss and curse at the brilliant chains coalescing about the shadowy serpents as their writhing onyx forms crackle at their touch as they are bound into a chittering sphere.";
			say "     With but a thought, you pull the ropes tauter still and make ready to crush these invaders or cast them to the howling void, yet for all your vast mental strength, the phantasm serpents seem resistant to your will as you try to excise them. A painful tearing sensation soon ripples through your mind almost feels as if you were trying to pull your hair or rip out your own tongue. Undeterred and perhaps believing this to be an artless ploy on the invaders' part, you press on, only to watch in muted horror as the serpentine cyst bursts in your mind's eye. At once, a terrible hiss claws at your ears as the shadowy orb ruptures in the vice-like hold of your grasp, though most boils away on the lingering threads of will, a few manage to slithering fragment retain their [']mobility['] as their scatter about the tainted halls of mental landscape. They hastily burrow deeper into your mind, and flee beyond your immediate touch, for now.";
			WaitLineBreak;
			say "[MovingOn]";

to say MovingOn:
	say "     As the vestige of presence filters from your liminal consciousness, the assembled Sea Dragons dart towards you, their colors waxing between muted whites and pale blues as their impossible massive frames fill the local shore. Or what you suspect is the shore, as even with your altered sight, the all encompassing dark and unfamiliar sea floor gives few clues to your true location. Lost in the unbound joy of your first plunge, you neglected to keep track of your location perhaps sensing this, the dragon bellow in ductal hymn, 'come, we are called,' as their sleek draconic beings dominate your expansive vision as they coil about the gold-tinted water surrounding you in a vibrant shoal of subdued hues. They bare their toned armored necks in an animalistic show of submission to their better, you feel yourself smirks at their deference and the beautiful glow of your eyes playing across their glossy furrow of thick azure scales, highlighting every potent flex of their toned muscular cores.";
	say "     You find yourself idly toying with the idea of claiming such titans for your own lascivious devices. As your dreamily picture the imperial leviathans clamoring for the privilege of mounting your tauric splendor, and the warm heady rush of sampling their serpentine seed playing across your palate. You muse, paws drifting to your [bodydesc of player] midriff as ";
	if Player is impreg_able:
		say "you shamelessly pamper your vacant womb with your supple pads, envisioning yourself swelling with fresh clutch of your own indomitable titans. ";
	else if Player is impreg_now:
		say "you lovingly massage the lush curves of your well-egged middle, whispering wordless encouragement to your nascent flight in the hopes that the mere the presence of such virile titans might in someway rub off on your brood. ";
	say "Pink hues soon shimmer about the borders of their luminescent aura, as the brother leviathans are drawn closer by your wanton display while their ripe vents blush a pleasing red. You can almost feel the heat pouring off them and taste the bestial tang of their pre simmering though the waters as they swim around in roiling sphere of draconic splendor.";
	WaitLineBreak;
	say "     With each sensual circuit of their impromptu parade, you can sense their budding desire to claim your perfection for themselves as their blazing orbs explore your [bodydesc of Player] curves and lush [breast size desc of Player] cock pillows. A part of you almost wants to offer yourself here-and-now, to bask in the embrace of their coils as they worship your folds in an unbound dance beneath the waves forevermore. Only to have this delectable wish shattered, as a single piercing call through the waves, banishes the inviting pinks from their color as velvety black and alabaster white flare to the forefront. Even you are not immune to the throbbing call twisting its talons into the back of your mind, as your body is pulled as if you were a fish on the line by the shifting tendril of benighted current towards the heart of the storm. Try as might to fight it, the summons holds you and the assembled wyrms in total thrall, even the presence strains at the borders of your thoughts in desperation to heed the wordless command.";
	say "     Spurred on by the bite of otherworldly ripple in the waves, you and the titans surge forth in tight chevron pattern with you at its apex, bellowing as one in bestial reply to the call. In the span of a few heart beats, your tyranny is drawn to the craggy waters surrounding the Great Arch as polished edges of weather-worn stone flicker across your enhanced senses. Your cohort's colors flash intricate bands of white, rusty-greens, alongside muted gold as they break rank and breach the surface with but a few mighty flexes of their tails. While their impressive wake ripples through the surf and you push topside, and as your horns piece the water, the eldritch hues recede as your vision reverts to the more banal tones familiar. Your quartet of eyes are drawn to the imposing sheer cliffs of the Rocky Arch and the swarming forms of the juvenile titans coils about the rock. Their serpentine bodies fan out along the tiny figure of Galaxite as she props her chin on her knuckles and coos through a cheshire smile, 'Nah se sturm salrak, Kai Monah.' in a light tender whisper."; [ Nah se sturm salrak, Kai Monah = may the fury of the storm empower you, Ocean Mother]
	WaitLineBreak;
	say "     Her words shimmer through your veins like clear effervescent waters as she rises from her perch. 'I see you are enjoying your gifts, scale sister,' she preens, as her molten golden eye traces the contours of wings as you bob in the surf. Nodding, you reply in an haughty tone, that your new additions, though somewhat limited in their use, are rather fetching in their own way. Still, considering her lofty promise, you were perhaps expecting something a bit more for your service. 'Of course great wyrm, I would not dream of withholding my promise from you sister. You shall receive all that you are owed, and more, but for now,' she pauses, to boldly stride off the rock edge, and into the waiting backs of her brood as they coil their sinuous bodies beneath her feet like chiseled staircase of flowing azure scales. 'Another Qunarr must be mantled by your magnificence, and fresh plunder obtained for the path ahead,' she rumbles, gesturing to the sea with languide wave of her left hand as she strides down upon the backs of the tyranny with otherworldly grace. As the rain seems part with her every as if the storm fears her very presence or marring her athletic form.";
	say "     'Thanks to your actions, we now have the tools needed to secure it, for that you have [italic type]our[roman type] gratitude,' Galaxite swoons, her words fracturing into a quintet of disparate cadences and tones. Though her words remain unchanged, each fractal note puts new and subtle pressures on each syllable, as she steps upon the head of one of her brood, mouth curling into a doting crooked smile as the great wyrm lowers her to the water's edge and she bows deeply before you. 'So come scale sister, the kai heeds your call, and her storm shall shelter us from... unwelcome eyes, ol fala han klovve eth,' she intones as the whorl of fragmented tones slithering through her voice fades back into a single impossibly sweet note that filters through your mind like a ribbon of umbral silk. You feel her words bubble through you and the wyrms, as their blazing crimson eyes crackle with streaks of brilliant gold, and as one, you echo her words. 'Ol fala han klovve eth!' then slip quietly beneath the waves."; [As the five headed one commands.]
	WaitLineBreak;
	say "     Your vision fractures once more, dispelling the gloom amid a rush of gold, white, and black hue that radiate through darkness as you and wyrms glide through the depths. For all your combined splendor, your draconic colors seem muted compared to the lustrous aurora of many colors and none cast by the little demi-human as you cut through the waves. Even the gloom seems to recede at the touch of her radiance, guiding you surer than any lighthouse as you sail in silence to parts unknown. Not a word passes from the brother titans, as you sail over the craggy sea floor. You can see signs of fresh volcanic activity as glassy pillars of red basaltic iron and talons of slate pierce the abyssal floor while pulsing vermilion spiderwebs of raw magma shimmer about their bases. Offhandedly, you wonder how much of this is the result of the capitals destruction and the arrival of Atlantis, or if this shift in the depths is the result of some other power. As the sharp stone shows few signs of erosion, even the simple kelps, barnacles, and algae seem to avoid the fresh habitat these rocks could provide.";
	say "     Still, such minutia means little to you, yet you can't shake the growing sensation this dead zone feels off, almost as if the local flora and fauna were avoiding the area out of fear, rather than any environmental concerns. You muse, as a new shape peter along the edges of your abyssal gaze, or rather the absence of a shape, you correct yourself as the waxy bone white lines of one particularly large slate tower just on the edges of your awareness vanish into an odd gap in your draconic sight. At first, you merely suspect it to simply be a trick of mind, but as you get closer, you notice the all-to-perfect curves of the void in your vision resembles the keel of a large shipping vessel. Then it hits you, as you recall the ape's assertion that the vessel she was searching for had run [']aground['] out in the break water. Though it does not appear to be alone, you note, observing a second smaller boat floating alongside, this one outline however lacks the unusual camouflage of the larger vessel.";
	WaitLineBreak;
	say "     Pushing your senses to their limits, you [']see['] the boat's underbelly far more clearly and realize the thing lacks any manner of propeller blade, leading you to believe its sail powered or perhaps oar driven like one of the viking long ships prowling the coast. Beyond this though, you can ascertain very little as water seems utterly devoid of life, nanite-altered or otherwise. Curiosity and caution piqued in equal measure, you come to a stop and rumble these observations to your tyranny. 'Indeed Kai Monah,' Galaxite says, her voice carrying through the wave with a resounding discordant echo, 'the stillness of this place is strange disquieting, yet I can see a fraction of our prize still sleeps on the floor.' Her hair floating about her like a shoal of ebony hagfish as she gestures to a pile of shipping containers cluttered beneath the ship with a casual bob of her head. 'So all may not be lost, for now [italic type]her[roman type] children will secure what we can.' And what of the vessel, you ask. 'Its fate matters not,' she shrugs, 'but, I suspect there may be more treasure hidden within.'";
	say "     'Still, its riches are yours by right scale sister, regrettably though, [italic type]her[roman type] children can offer little assistance,' she simpers demurely. 'Should you wish it, the little ones can ferry you abroad.' Shaking your muzzled head, you tell the demi-human that you need no such aid. Besides, your body could use the exercise, you preen, as you dart off towards the vessel, alone, relishing the vibrant touch of the waves and roar of the storm covering your passage. In mere moments, you find yourself slithering along the stricken ship's hull. Interestingly, you note how the ship's exterior is coated in a mix of rubberized material along the water line while a thick coat of black iron ball paint enshrouds the remainder. Perhaps, you muse, this would explain the [']hole['] in your enhanced vision. Though why someone would go to the trouble of coating a whole ship in these anti-sonar materials, you can't be certain, you ruminate as you swim along its edges in an effort to some manner of ladder or anchor you could use to scale it.";
	WaitLineBreak;
	say "     Despite doing several circuits, you find neither hide nor hair of either, and briefly consider slinking back to the depths to ask the wyrms for a boost. Your pride stills such thoughts, as you feel your wings flutter at your sides and talons flex with predatory purpose as you realize, you don't need their assistance. Your tauric form has the tools you need to mantle, you snarl internally as you dip beneath the waves and dive down to the sweltering floor. Heat licks at you scale and guttural pressure simmer about the borders of your mind, yet your body endures nonetheless as you slink lower than you may have once dared. Then nearing the ruby red borders of the roiling pyroclastic flow, you right yourself and climb up. Faster and faster, you sail reveling in the unbound joy of your form scything through the darkened water as with a proud draconic roar and might flap of your nascent wings you breach the surface and leap upon the vessel.";
	say "     Unbothered about who or what hears you, you delight in the feeling of your claws effortlessly digging into the blackened metal with a pleasing crackle as you tear your way up the side of the ship, shredding steel plates and heavy support beams with contemptuous ease while oily rain cascades down your imperial scales as you make your ascent. The noise invariably draws the attention of whatever manner of feral dares to lay claim to your prize as a conical muzzle of quilled black fur streaked with vibrant yellow strips peers over the side, muttering, 'What in hell is that all that racket!' Alarm flares about their face as the lowly creature's eyes go wide with terror at the sight of draconic form crawling up this side ship. A bestial rumble of primeval delight issues from your lips as you catch sight of the smoldering glow of your quartet of eyes reflected in the frightened pairs of the [one of]snivling warmblood's[or]faltering biped's[or]lowly mammal's[at random] own as you leap upward with but a single flap of your wings. Soaring past the surprised tenrec in a flutter of your [bodydesc of Player] scaly limbs, you grasp the creature's head in the crook of forepaws as you crest the decks railings, and slam its skull to the hard metal floor, knocking it out instantly.";
	WaitLineBreak;
	say "     Flaring your wings out beside you, you draw yourself up to your full height and issue your challenge to any who dare stand in your way as you quickly assess the area. You spy a small cohort of ten or so tenrecs wielding gaffer's hooks huddled around a gam of three subdued pirate sharks. Each one is bound at the feet and waist by thick brown jute ropes and gagged by flayed strips of fading leather belts to one of several cranes affixed to the deck. Adjacent to the subdued herms, you note the presence of a large multi-tiered trapezoidal structure which you surmise is likely the wheelhouse and command bridge nestled at the bow of the ship. Behind them, a lone Yuppie Mink cowers at the sight of your draconic form from atop the second floor of this edifice as pale lightning and deafening thunderclaps fill the sky. 'W-what in the [bold type]HELL IS THAT[roman type]!' one of the Tenrecs screech, as they level their gaffer's pole with you. 'Ah man Hicks, I d-don't know. Where the fuck did that thing come from!' another stammers, its quills flaring towards you in a warding gesture. 'Shit! Look, it's got Ramirez!' a third cries, motioning to the stricken form of its peer clutched between your reflective talons.";
	say "     'Ah hell man, game over man, game over!' a fourth sobs as he tries to slink away from you only to be stopped by a sudden roar from the mink. 'I don't care what is, if we can beat those sharks, we can beat that thing. Now charge and I'll double your pay!' the yuppie howls, as the tenrecs, poles lowered, advance in a tightly knit ball. Foolish, the presence snickers, its writhing touch caressing the back of your mind. Your senses are pulled to the unconscious shrew nestled in your claws, accompanied by the vibrant of tail and leg muscles as its intent filtering through the shoals of your mind. Smirking at the suggestion, you fling the creature into the air, then whip your lower body around in a violent arc, as you hurl the blacked out blaggard into its peers with a resounding crack of your tail. Caught off guard, and too near to dodge, the stricken creature collides with the others in a heap of entwined limbs and shattered poles as the force of your blow deforms the bulkhead around them.";
	WaitLineBreak;
	say "     All the while, the Yuppie, his will likely faltering, makes for a break as it darts into one the pathways lining the forebridge, yet you're on in a flash as your tear through the hall in a sea of talons and claws. Try as he might to run, the lowly biped is no match for your speed as you shoulder check him into one of the corner railing of the walkway with a satisfying crack. The metal creaks, bolts shear, and timber snap on impact as it crumples beneath you, bruised, but very much alive, you note, listening to the light raspy wheeze of its breath as it slumps to ground in a battered contorted pile. Though a brief flicker of remorse flashes across your mind as if they were sparks leaping from freshly struck flint, the feeling quickly passes as you know it won't be long till it recovers from any damage it took. Still, with the gnats dealt with, you head back to the center of the ship to check on the sharks. Though you doubt that they managed to escape, you'd rather not run into any surprise once you start your search proper.";
	say "     As expected, the wannabe corsairs are right where you left them, going by the pleased looks on their faces, they seem rather hopeful you'll let them go, as they mumble vague praise and adulation at your sudden appearance. A part of you briefly considers freeing them even, yet you're under no illusion that they won't turn on you the moment your back is turned. Besides, your draconic mind finds the sight of the bound herms rather... pleasing, you muse, observing the cute little furrow cast in their gray hide as they strain against ropes, or the enthralling mix of hope and desire playing across their angular muzzles as their bright blue-green eyes trace the imposing contours of your [bodydesc of player] physique. Still, they may prove useful to ";
	if "Weak psyche" is listed in feats of Player:
		say "[italic type]us[roman type] later, so why not lead them on for a little while longer the presence counsels ";
	else:
		say "you later, so why not feign a modicum of concern for them at least until you've pumped them for some information first, you ruminate ";
	say "as you touch your claw to your lips. You lower yourself to their eye level and calmly bid them to be silent, lest they attract unwanted attention.";
	WaitLineBreak;
	say "     Nodding, the bound herms quiet down and allow you to pull off their gags one at a time, once the last one if free, you quickly pepper them with questions about what manner of hazards may remain and the status of the ship's cargo. '*PFT*, thank ya kindly Miss Dragon, *huck-tootie*' one of the shark's gasps, spitting a wad of flayed leather in the direction of the unconscious tenrecs. 'We's thought those filthy fleabag were gonna be turning us into chum, before you came along. Still I's thinks ya may [']O got them all, but those landlubbers be far from the worst of the foulness dis [']er hulk az ta offer.' Bobbing your head, you bare your fangs at the shark and implore hir to elaborate. 'Aya,' the shark replies in androgynous twangy cadence, 'past the aft tower, through da portcullis, and deep down in da rudy depths [']O dis [']ere [']ulk be a nest [']O squiddy lasses. Me mates [']n I thought we could slip past dem [']N da fuzzy goons, an nick whats we could under this [']ere lovely gale,' the shark rumbles, gesturing to storm clouds with a bat of hir girthy tail.";
	say "     'But da blackguards had the same notion, and caught us with our knickers down! Trapped between the squiggly folk an da business end of a gaffer's pole, me mates [']n I bravely stayed behind [']n tried to parley with da scallywags while da rest [']O me crew escaped. But dese boyos gots no love for us gentle fisher folk, un beat us up right-an-proper.' The shark sighs, shaking hir head in dismay. In a feigned forced sympathetic tone, you offer your condolence to the bound biped, then ask what of the ship's cargo. 'Da, it's still in the hold along with those tentacled terrors, if ya want Missy, me gam un I would love to help ya claim it. Assuming, ya can finds it yar heart-o-hearts to take pity on us innocent scavengers, I'z promise will gladly guard yar back and give ye a fat cut [']O da booty,' the shark pleads, though even were you without your draconic senses, you can see the flicker of deceit coiling along the edges of the pirate's words and the devious half-shrouded grins of its gam. Shaking your head, you tell them that as much as you'd like to, you still have a task of your own to complete. Though your cohort will arrive shortly to free them, and you add, claim this ship, once you give the [']signal['].";
	WaitLineBreak;
	say "     Till then, you would rather not draw any more attention than you already have. 'Da suit yar-self Miss Dragon,' the shark shrugs, 'not like we's in any position ta tell yas otherwise,' shi chuckles, in a forced jovial tone as shi wiggles in hir bonds while hir crew grumble amongst themselves. 'Ah stow it ya sodding lot [']O old maids!' the head corsair huffs, roughly slapping their tail on deck with a resounding crack, and splashing the grumpy sharks in a cascade of inky water. 'Better we's lose out on a nip [']O plunder than get to shanghaied and sold to those louts in the canning facility down southwise.' 'Aye aye captain,' the other herms mutter as they slump against the ground defeatedly. Content there's nothing more to gain by further engaging in this nautical nonsense, you set off the rear of ship, you every step dogged by the the light click of your talons and gentle swish of your tail as stalk the ship for any sign of this [']portcullis['] the shark mentioned.";
	if Cunt Count of Player >= 1 and cock Count of Player is 0 and player is Impreg_now:
		say "     Though as your tauric form dips around the hard bend of the ship's stern tower, you manage to overhear the herms chattering amongst themselves as you vanish from sight. 'Cribbins me hearts, did you see the swell on that siren, eh?' the lead shark swoons. 'Aye captain! Must have been one lucky soul to entreat so a tempestuous beauty. If I'z wasn't afraid that lass would crush just as soon as fuck me, I'd [']ev taken a pass at her meself.' another whistles, in open admiration. 'Ah where's your sense of adventure boyo, a few broken bones would be worth it to claim so mighty a sea beastie as a wife. Why imagine what could do with a few [']O her kind in our crew. If she weren't knocked up, I'd be of half the mind to beg her to jump on me own jolly-rogers, *Har-Har*!' the lead shark cackles as their roaring voice is slowly drowned out in the howling gale.";
		WaitLineBreak;
	else if Cunt Count of Player >= 1 and cock Count of Player is 0 and player is Impreg_able:
		say "     Though as your tauric form dips around the hard bend of the ship's stern tower, you manage to overhear the herms chattering amongst themselves as you vanish from sight. 'Stars and garters my lovelies, what a beauty that ravenous naiad was! Why if I didn't know any better, I think this ol['] sea devil might be falling in love!' the head shark preens. 'Da me captain, savage as a storm and beautiful as the waves that beasty was, in better tides I wager that lass would make a fine cabin warmer,' another shark swoons. 'A cabin warmer? *Pah* Where's your ambition me mate, a fine beasty like that deserves no less to be a captain's first wife! Had I the coin to entreat her, I'd happily sweep that monster off her claws, and make her mine. Why imagine what great [']n terrible spawn a pair of sea devils like us could make!' the captain chuckles proudly. 'Aye captain, a few of those on our crew and even those boyos in Atlantis wouldn't be able to stop us from plundering their booty! *Har-Har-Har*.' The sharks crow as the roar of the storms gradually eclipses their voices.";
		WaitLineBreak;
	else if Cunt Count of Player >= 1 and cock Count of Player >= 1 and player is Impreg_now:
		say "     Though as your tauric form dips around the hard bend of the ship's stern tower, you manage to overhear the herms chattering amongst themselves as you vanish from sight. 'Salt and Storm me matey, have ya ever seen so mighty un beautiful a beasty before?!' the head shark gushes. 'Yar Captain, fair as the sea foam and deadly as an undertow shi was! Aye, what I wouldn't give to shake hands with a lucky soul what knocked that lassy up,' one of the sharks chuckles. 'Indeed me matey, though this here black heart can't help but wonder what it would be like claimed by such a virile beast meself,' the captain swoons. 'Truly captain, you'd be brave enough to swim such treacherous seas?' a third shark questions in a trepidatious trill. 'Da of course me lovies, what good is a muff if in yar not willing to use it from moon-to-moon. Why, imagine the mischief we could weave with a few clutches of sea beasty under our bonnets,' the captain swoons in lustful cadence as their voice is gradually subsumed in the storms rising fury.";
		WaitlineBreak;
	else if Cunt Count of Player >= 1 and cock Count of Player >= 1 and player is Impreg_able:
		say "     Though as your tauric form dips around the hard bend of the ship's stern tower, you manage to overhear the herms chattering amongst themselves as you vanish from sight. 'By all the pieces of eight, what majestic beasty shi was, eh my hearts?' the head shark rumbles in a lewd melodic trill. 'Da me captain, fiercer than this [']ere storm and lovelier den da setting sun, shi would be quite the bunk mate!' a second shark titters. 'BUNK MATE! *Bah* where's the fire in your muff matey!?' the captain spits in a jovial tenor. 'A beast like hir would be treasure like no other! Were I'z able to entreat so potent and beautiful a creature, I would gladly spend the rest of my day filling the oceans with our devilish spawn!' shi swoons. 'Truly captain, you'd bury yar pearls in dar cave?' a third shark asks, with an odd note of fear coiling along the edges of their words. 'More than that me loves, I'd proudly bear hir monsters in me own belly forevermore if shi'd have me!' the captain proclaims rather proudly.";
		WaitLineBreak;
		say "     'Why just picture the vivacious sea devils the lot of us could make. We'd never need to leave the island again, and we could spend the rest of our days living like pampered queens while our monstrous spawn spread their terror to the seven seas and beyond,' the lewd herm rumbles over a low needy pant. 'Ha, sounds like ya got a touch [']O da moon sickness cap'n,' the second shark snickers. 'Da and so what if I do!' the captain growls, with a predatory snap of hir fangs. 'What good is having a cunt if I'z don't fill her with a gam or seven of me own, besides I saw ta way ye was looking at the beasty, an ya was pondering much the same boyo,' the lustful herm teases. 'Hm, you may be right cap'n, this profession ain't exactly one that ends in retirement, it might be nice to have a gam of urchins to take care of me in my twilight hours,' the second shark sighs wistfully, as hir voice bleeds away into the tempestuous gale."; [merge here]
	say "     A part of you wonders if perhaps you might have been a little too hasty in passing over such hybrid beauties, although on some level you suspect they might be playing you. You still feel a rising urge to blow off a little steam, especially after the long swim and the brief tussle with the tenrecs. Your tauric form could do with a little relief, it's not like the sharks are any threats to ";
	if "Weak Psyche" is listed in feats of player:
		say "[italic type]us[roman type] the writhing presences councils as the heady thrum of change simmer along your flanks.";
	else:
		say "you, you muse as a pleasant pulse of chaotic energies roils about your [bodydesc of Player] flanks.";
	say "[Italic type]what would you like to do with these sharks?[roman type]";
	LineBreak;
	say "     [italic type]Note: Choosing 'Tail Fuck' or 'Mount them en masse' will cause you to grow a permanent ovipositor on your tail and potentially open up new scenes with them in the future. Further, selecting 'Mount them en masse' as female or mono-dicked herm will cause you to grow two cocks for this scene in addition to your ovi tail. You will also be free to alter your gender at the end of this piece without penalty. Should you decide to get spit roasted or to leave them be, no new content involving them will be unlocked and you will not be barred from anything in the main story.[roman type]";
	LineBreak;
	let Dommy_shorks_Choices be a list of text;
	add "Mount them en masse." to Dommy_shorks_Choices;
	add "Get spit roasted." to Dommy_shorks_Choices;
	if Cock Count of Player is 0:
		add "Tail Fuck." to Dommy_shorks_Choices;
	add "Leave them be." to Dommy_shorks_Choices;
	let Dommy_shorks_Choice be what the player chooses from Dommy_shorks_Choices;
	if Dommy_shorks_Choice is:
		-- "Mount them en masse.":
			if Cock Count of Player is 0 and "UB Pred" is not listed in feats of Player and "Vore Predator" is not listed in feats of Player:
				say "     Deciding to claim the nautical herms for yourself, the aberrant energies whorling within your draconic body begin to pool along the well-lubed contours of your tauric groin and tail in response to your budding desire. At once, your scales start to crackle with sparks of transformative delight as a rush of fresh sensations flickers about tauric sex. You quickly find yourself panting with unbridled rapture at the decadent thrum of virgin pleasure sensors winking into existence just below your [cunt size desc of player] cunt as a new reptilian slit simmers into being. In seconds, wondrous pressure wicks along the supple walls of your exotic vent as a pair of draconic tools begin to coalesce within its velvety embrace. The raw tender flesh gushes with reptilian rapture as the swelling glands rifle along your toasty cock cave, you can feel each tactile ridge and heavenly throb of your aquatic knots straining against the lavish moist housing.";
				say "     An intoxicating tattoo of morphic bliss roils about the twisted shoals of your tainted mind, eliciting a rumble of abyssal satisfaction from your lips at the sensation of the flesh bulging and shifting with virile intent as a quartet of ripe heavy balls form behind your nascent vent. Though a section of your formerly feminine-leaning psyche finds their sudden appearance rather jarring, you can't deny a certain thrill at this development as the sensation of your well-oiled balls caress your inner thighs, or the pleasant bouncing of your massive cum tanks as the ship sway beneath your paws. The wave of change roaring through your body then curls along the base of your tailbone. Curious, you flick the girthy limb forward and watch as your fins recedes into a thin spade and your sail expands further down the length of your spine. In their place, you spy vaguely feminine labia forming on the underside of your tail, meanwhile, you sense an unusual void forming along the tasteful patch of white decorating your underbelly as an exotic mix of muscles and alien nerves surge forth.";
				WaitLineBreak;
				say "     Intrigued and just a hair excited at this development, you lovingly run your paws down the length of the altered limb, delighting at the unearthly elysium your touch evokes from this new addition. Already you can sense the supernatural nerves and concentric cartilage rings lining your augmented limb respond to your inquisitive caress with a heady balm of saturnalian sensations ";
				if "Weak Psyche" is listed in feats of Player:
					say "as the presence lovingly chirps from the depths of your shared mind, 'yes my flawless host, more eggs to grow our flight and expand the ranks for our sisters coming!' You can feel doting tendrils of desire and fertile purpose lavishing your being in their umbral embrace as the presence urges you to make full use of these changes on the bound sharks. Nodding, you find yourself smirking at the thought of heading back to the middeck, and claiming your prizes.";
				else:
					say "as your far-traveled mind realizes this new appendage's true purpose; eggs. You swoon at the thought of bearing such a divine tool to spread your flight even further. You coo at a rush of hybrid hormones coiling through you as your hermaphroditic body tenses with predatory satisfaction at the rich possibilities spreading out before you. You can hardly repress the vibrant pulse of hybrid lust and verdant desire to try out your resplendent anatomy on the delectable treats waiting for you on the middeck.";
				now Intelligence of Galaxite is 1;
			else if Cock Count of Player is 0 and "UB Pred" is listed in feats of Player and "Vore Predator" is listed in feats of Player:
				say "     Deciding to claim the nautical herms for yourself, the aberrant energies whorling within your draconic body begin to pool along the well-lubed contours of your tauric groin and tail in response to your budding desire. At once, your scales start to crackle with sparks of transformative delight as a rush of fresh sensations flickers about tauric sex. You quickly find yourself panting with unbridled rapture at the decadent thrum of virgin pleasure sensors winking into existence just below your [cunt size desc of player] cunt as a new reptilian slit simmers into being. In seconds, wondrous pressure wicks along the supple walls of your exotic vent as a pair of draconic tools begin to coalesce within its velvety embrace. The raw tender flesh gushes with reptilian rapture as the swelling glands rifle along your toasty cock cave, you can feel each tactile ridge and heavenly throb of your aquatic knots straining against the lavish moist housing."; [Changes start below here]
				say "     A heady tattoo of morphic bliss roils about your bestial taint, eliciting a rumble of abyssal satisfaction from your lips at the sensation of the flesh bulging and shifting with virile intent as a quartet of ripe heavy balls form behind your nascent vent. Though a section of your formerly feminine-leaning psyche finds their sudden appearance rather jarring, you can't deny a certain thrill at this development as the sensation of your well-oiled balls caress your inner thighs, or the pleasant bouncing of your massive cum tanks as the ship sways beneath your paws. The wave of change roaring through your body curls along the base of your tailbone. Curious, you flick the girth limb forward and watch as your fins recede into a meaty point and your sail expands further down the length of your spine. While four evenly-spaced furrows form along the edges of your tail, you watch in muted awe as the flesh parts like an azure tulip, revealing a lush tapestry of throbbing veiny crimson tissue.";
				WaitLineBreak;
				say "     Behind this nascent maw, you spy a plump sphincter-esque O-ring leading to a yearning void located just a hand's width from the orifices['] openings. Though initially alarming, your voracious side takes an odd shine to this second mouth as you run your well-oiled webbed mitts about its thick girthy length, reveling in the unearthly sensation of the hybrid passage forming within your alien appendage. Your ecstatic and exceptionally experienced mind can detect not only the presence of multiple concentric rings of cartilage evocative of an insect's ovi tube, but a number of dense muscles that remind you of your specially adapted throat. Tilting your head for a better look at this exotic structure, you catch several sets of crimson tendrils emerging from this hungering void, though your first attempts at commanding these strange appendages are met with little success. Your nanites soon begin to adapt these new addition to your altered form as sensation along with raw sensory information quickly flutters about these nascent appendages as the taste of saltwater layered with the bracing chill of the storm trickles through the nanite-touched halls of your fragmenting psyche as you gingerly try flexing them.";
				say "     You feel a profound sense of dissociation as the lingering shards of your human mind rebel at this newest evolution of your draconic splendor, yet you mentally push back against such sniveling simian sentiments as you levy your draconic will upon the new limbs, compelling them to obey. In moments, your control begins to grow as the tendrils begin to flex and writhe in tune with your commands even if a degree of oddness accompanies every motion. Though this feeling too quickly fades as your voracious fascination overcomes your trepidation as your liminal mind revels at the sheer ocean of possibilities your new limb can affords you. ";
				if "Weak Psyche" is listed in feats of Player:
					say "These feelings of predatory glee seem to be echoed by the presence as it swoons from the back of your mind. 'Ah how our wondrous host continues to spoil us!' as a sensuous feeler of eldritch desire ripple through your core. 'Never before have we borne such gifts,' they coo as your enhanced limb coils lovingly about your arm, 'Oh dutiful host, you should take pride in this feat, for our terrible flight will be the envy of all creation!' the serpentine choir preens as you find yourself nodding in agreement. Already a part of your can't wait to test to out a fraction your new limb's potential on the delectable morsel on the middeck.";
				else:
					say "As your lips curl into a sanguine smile at the thought of passing on such voracious potential to your flight. You muse, in abject awe of the splendid gift your tail maw could bestow on the lowly warmbloods that you deem unfit to bear your line. For what higher honor can such useless creatures dare to aspire to than to be a part of your future divinity? Your voracious draconic mind crows at the notion of using the succulent appendage to its full potential one day. For now though, you have prizes waiting on the middeck that need your... attentions.";
				now Intelligence of Galaxite is 2;
			else if Cock Count of Player is 1 and "UB Pred" is not listed in feats of Player and "Vore Predator" is not listed in feats of Player:
				say "     Yielding to your body's desire to claim the eager prizes waiting for you on the middeck, the chaotic essences swirling within you start to pool along the ripe wall of you scalie vent as your draconic prick seems to drink in these intoxicating energies with a pronounced alacrity. At once, your [cock size desc of player] spire throbs with an enticing pulse of draconic virility, straining against the silky walls of your cock cave. You sense a crease form along the lustful ridges of your cum vein as your potent rod evenly divides within you. A pleased purring issues from your azure lips as your plump knot creaks against the warm tender walls of their cozy housing. You almost feel as if you could cum from just the blissful pressure and salacious sensation of your pricks roiling against one another as they war for space inside you as each wondrous beat of your heart sends fresh potent pulses along your throbbing knot and tactile reptilian pleasure nodes lining your cock.";
				say "     It takes all your draconic will to keep your mitts off yourself as beads of milky abyssal pre drips and reptilian juices gush from your lush vent and down along the [bodydesc of Player] contour of lower half, in a molten stream of draconic excess. Yet all this pales in comparison to the raw bestial pleasure building along the girth of your tail as the wave of change roaring through your body curls along the base of your tailbone. Curious, you flick the girth limb forward and watch as your fins recede into a thin spade and your sail expands further down the length of your spine. In their place, you spy vaguely feminine labia forming on your tail's underside, meanwhile, you sense an unusual void forming along the tasteful patch of white decorating your underbelly as an exotic mix of muscles and alien nerves surge forth."; [Note to Prome this next part cribs the tail mouth free version from the TG scene.]
				WaitLineBreak;
				say "     Intrigued and just a hair excited at this development, you lovingly run your paws down the length of the altered limb, delighting at the unearthly elysium your touch evokes from this new addition. Already you can sense the supernatural nerves and concentric cartilage rings lining your augmented limb respond to your inquisitive caress with a heady balm of saturnalian sensations ";
				if "Weak Psyche" is listed in feats of Player:
					say "as the presence lovingly chirps from the depths of your shared mind, 'yes my flawless host, more eggs to grow our flight and expand the ranks for our sisters coming!' You can feel doting tendrils of desire and fertile purpose lavishing your being in their umbral embrace as the presence urges you to make full use of these changes on the bound sharks. Nodding, you find yourself smirking at the thought of heading back to the middeck, and claiming your prizes.";
				else:
					say "as your far-traveled mind realizes this new appendage's true purpose; eggs. You swoon at the thought of bearing such a divine tool to spread your flight even further. You coo at a rush of hybrid hormones coiling through you as your hermaphroditic body tenses with predatory satisfaction at the rich possibilities spreading out before you. You can hardly repress the vibrant pulse of hybrid lust and verdant desire to try out your resplendent anatomy on the delectable treats waiting for you on the middeck.";
				now Intelligence of Galaxite is 1;
			else if Cock Count of Player is 1 and "UB Pred" is listed in feats of Player and "Vore Predator" is listed in feats of Player: [this copies the fem TG + tail maw TF]
				say "     Yielding to your body's desire to claim the eager prizes waiting for you on the middeck, the chaotic essences swirling within you start to pool along the ripe wall of you scalie vent as your draconic prick seems to drink in these intoxicating energies with a pronounced alacrity. At once, your [cock size desc of player] spire throbs with an enticing pulse of draconic virility, straining against the silky walls of your cock cave. You sense a crease form along the lustful ridges of your cum vein as your potent rod evenly divides within you. A pleased purring issues from your azure lips as your plump knot creaks against the warm tender walls of their cozy housing. You almost feel as if you could cum from just the blissful pressure and salacious sensation of your pricks roiling against one another as they war for space inside you as each wondrous beat of your heart sends fresh potent pulses along your throbbing knot and tactile reptilian pleasure nodes lining your cock.";
				say "     It takes all your draconic will to keep your mitts off yourself as beads of milky abyssal pre drips and reptilian juices gush from your lush vent and down along the [bodydesc of Player] contour of lower half, in a molten stream of draconic excess. Yet all this pales in comparison to the raw bestial pleasure building along the girth of your tail as the wave of change roaring through your body curls along the base of your tailbone. Curious, you flick the girth limb forward and watch as your fins recede into a thin spade and your sail expands further down the length of your spine. In their place, you spy vaguely feminine labia forming on your tail's underside, meanwhile, you sense an unusual void forming along the tasteful patch of white decorating your underbelly as an exotic mix of muscles and alien nerves surge forth.";
				WaitLineBreak;
				say "     Though initially alarming, your voracious side takes an odd shine the second mouth as you run your well-oiled webbed mitts paw at its thick, girthy, length reveling in the unearthly sensation of the hybrid passage forming with your alien appendage. As your ecstatic exceptionally experienced mind can detect not only the presence of multiple concentric rings of cartilage evocative of an insect's ovi tube, but a number of dense muscles that remind you of your specially adapted throat. Tilting your head for a better look at this exotic structure, you catch several sets of crimson tendrils emerging from this hungering void, though your first attempts at commanding these strange appendages are met with little success. Your nanites soon begin to adapt these new addition to your altered form as sensation along with raw sensory information quickly flutters about these nascent appendages as the taste of saltwater layered with the bracing chill of the storm trickles through the nanite-touched halls of your fragmenting psyche as you gingerly try flexing them.";
				say "     You feel a profound sense of dissociation as the lingering shards of your human mind rebel at this newest evolution of your draconic splendor, yet you mentally push back against such sniveling simian sentiments as you levy your draconic will upon the new limbs, compelling them to obey. In moments, your control begins to grow as the tendrils begin to flex and writhe in tune with your commands even if a degree of oddness accompanies every motion. Though this feeling too quickly fades as your voracious fascination overcomes your trepidation as your liminal mind revels at the sheer ocean of possibilities your new limb can affords you. ";
				if "Weak Psyche" is listed in feats of Player:
					say "These feelings of predatory glee seem to be echoed by the presence as it swoons from the back of your mind. 'Ah how our wondrous host continues to spoil us!' as a sensuous feeler of eldritch desire ripple through your core. 'Never before have we borne such gifts,' they coo as your enhanced limb coils lovingly about your arm, 'Oh dutiful host, you should take pride in this feat, for our terrible flight will be the envy of all creation!' the serpentine choir preens as you find yourself nodding in agreement. Already a part of your can't wait to test to out a fraction your new limb's potential on the delectable morsel on the middeck.";
				else:
					say "As your lips curl into a sanguine smile at the thought of passing on such voracious potential to your flight. You muse, in abject awe of the splendid gift your tail maw could bestow on the lowly warmbloods that you deem unfit to bear your line. For what higher honor can such useless creatures dare to aspire to than to be a part of your future divinity? Your voracious draconic mind crows at the notion of using the succulent appendage to its full potential one day. For now though, you have prizes waiting on the middeck that need your... attentions.";
				now Intelligence of Galaxite is 2;
			else if Cock Count of Player >= 2 and "UB Pred" is not listed in feats of Player and "Vore Predator" is not listed in feats of Player: [Past the first line or two, this reuses most of the prior scenes]
				say "     Surrendering to your Maiesiophilic urges, you can feel the eldritch squall of polymorphic energies billowing in your core as if it were lightning cascading upon a still moonlit pond. Though as the strange energies begin to pool at your groin, the magnitude of your virility seems impervious to further augmentation, the whirlpool of morphic power is soon drawn to your tailbone. As the dextrous appendage writhes behind like loose sail on an undiluted essence of change pours into it. Curious, you flick the girthy limb towards you and watch as your fins recedes into a thin spade and your sail expands further down the length of your spine. In their palace, you spy vaguely feminine labia forming on your tails underside, meanwhile, you sense an unusual void forming along the tasteful patch of white decorating your underbelly as exotic mix of muscles and alien nerves surge forth."; [Cribs the tail mouth free version from the TG scene.]
				WaitLineBreak;
				say "     Intrigued and just a hair excited at this development, you lovingly run your paws down the length of the altered limb, delighting at the unearthly elysium your touch evokes from this new addition. Already you can sense the supernatural nerves and concentric cartilage rings lining your augmented limb respond to your inquisitive caress with a heady balm of saturnalian sensations ";
				if "Weak Psyche" is listed in feats of Player:
					say "as the presence lovingly chirps from the depths of your shared mind, 'yes my flawless host, more eggs to grow our flight and expand the ranks for our sisters coming!' You can feel doting tendrils of desire and fertile purpose lavishing your being in their umbral embrace as the presence urges you to make full use of these changes on the bound sharks. Nodding, you find yourself smirking at the thought of heading back to the middeck, and claiming your prizes.";
				else:
					say "as your far-traveled mind realizes this new appendage's true purpose; eggs. You swoon at the thought of bearing such a divine tool to spread your flight even further. You coo at a rush of hybrid hormones coiling through you as your hermaphroditic body tenses with predatory satisfaction at the rich possibilities spreading out before you. You can hardly repress the vibrant pulse of hybrid lust and verdant desire to try out your resplendent anatomy on the delectable treats waiting for you on the middeck.";
				now Intelligence of Galaxite is 1;
			else if Cock Count of Player >= 2 and "UB Pred" is listed in feats of Player and "Vore Predator" is listed in feats of Player: [Past the first line or two, this reuses most of the prior scenes]
				say "     Surrendering to your Maiesiophilic urges, you can feel the eldritch squall of polymorphic energies billowing in your core as if it were lightning cascading upon a still moon-lit pond. Though at the strange energies begin to pool at your groin, the magnitude of your virility seems impervious to further augmentation, the whirlpool of morphic power is soon drawn to your tailbone. As the dextrous appendage writhes behind like loose sail on an undiluted essence of change pours into it. Curious, you flick the girthy limb towards you and watch as your fins recedes into a meaty point and your sail expands further down the length of your spine. While four evenly spaced furrows form along the edges of your tail, you watch muted awe as the flesh parts like an azure tulip, revealing a lush tapestry of throbbing veiny crimson tissue. Behind this nascent maw, you plump sphincter-esque O-rings leading to a yearn void located just a hands width from orifices opening.";
				WaitLineBreak;
				say "     Though initially alarming, your voracious side takes an odd shine the second mouth as you run your well-oiled webbed mitts paw at its thick, girthy, length reveling in the unearthly sensation of the hybrid passage forming with your alien appendage. As your ecstatic exceptionally experienced mind can detect not only the presence of multiple concentric rings of cartilage evocative of an insect's ovi tube, but a number of dense muscles that remind you of your specially adapted throat. Tilting your head for a better look at this exotic structure, you catch several sets of crimson tendrils emerging from this hungering void, though your first attempts at commanding these strange appendages are met with little success. Your nanites soon begin to adapt these new addition to your altered form as sensation along with raw sensory information quickly flutters about these nascent appendages as the taste of saltwater layered with the bracing chill of the storm trickles through the nanite-touched halls of your fragmenting psyche as you gingerly try flexing them.";
				say "     You feel a profound sense of dissociation as the lingering shards of your human mind rebels at this newest evolution of your draconic splendor, yet you mentally push back against such sniveling simian sentiments as you levy your draconic will upon the new limbs, compelling them to obey. In moments, your control begins to grow as the tendrils begin to flex and writhe in tune with your commands even if a degree of oddness accompanies every motion. Though this feeling too quickly fades as your voracious fascination overcomes your trepidation as your liminal mind revels at the sheer ocean of possibilities your new limb can affords you. ";
				if "Weak Psyche" is listed in feats of Player:
					say "These feelings of predatory glee seem to be echoed by the presence as it swoons from the back of your mind. 'Ah how our wondrous host continues to spoil us!' as a sensuous feeler of eldritch desire ripple through your core. 'Never before have we borne such gifts,' they coo as your enhanced limb coils lovingly about your arm, 'Oh dutiful host, you should take pride in this feat, for our terrible flight will be the envy of all creation!' the serpentine choir preens as you find yourself nodding in agreement. Already a part of your can't wait to test to out a fraction your new limb's potential on the delectable morsel on the middeck.";
				else:
					say "As your lips curl into a sanguine smile at the thought of passing on such voracious potential to your flight. You muse, in abject awe of the splendid gift your tail maw could bestow on the lowly warmbloods that you deem unfit to bear your line. For what higher honor can such useless creatures dare to aspire to than to be a part of your future divinity? Your voracious draconic mind crows at the notion of using the succulent appendage to its full potential one day. For now though, you have prizes waiting on the middeck that need your... attentions.";
				now Intelligence of Galaxite is 2;
			say "     You muse, backtracking around the corners of the aft spire, and delighting internally at the potent echoes of your latest evolution simmering through your core. At the sight of your return, the sharks go quiet as they drink in the sight of your [bodydesc of player] physique. 'Uh... cap'n I'z uh *gulp* think they heard us,' one stammers, eyes still roaming over ";
			if player is impreg_now:
				say "the ripening fecund curves of your well-bred middle and the tender swell of your [Breast Size desc of Player] chest with obvious interest ";
			else:
				say "the tight toned contours of your gleaming draconic core and [bodydesc of Player] build of your [breast size desc of Player] chest with acute delight. ";
			say "'Oh, ha-ha, sorry ya heard that lassie,' the still bound captain gulps as shi fidgets under the weight of your abyssal gaze, t'was but some harmless sailor talk, nothing more.' Oh really, you rumble, observing the light rosy blush of their plush vents, as the tapered crimson tips of their dual spires peeks out from their inviting housings. Beads of lucid pre alongside a generous sheen of natural lubricants dribble down the exotic lengths of their stiffening cocks, and streams over the edges of their pleasantly toned thighs and chicken-egg sized sacks.";
			say "     Perhaps feeling the weight from the molten golden glow of your eyes pressing down upon them, they hurriedly cover their waists with their tails, warbling, 'Aye, we meant offense to ya me lovely, but uh,' the captain swallows hard, their expression waxing between fear and desire at the sight of your towering storm-framed form looming over them, 'I'z don't suppose there be anything we can do to make amends?' Well, you think of one way they can show proper contrition to your majesty, you growl in a commanding yet lustful reptilian trill, as your twin rods stiffen along the toasty walls of your moist cock cave. 'Aye, and what might that be?' the captain simpers in hopeful tone as you prowl up to them with a languid sensuous sashay that imparts a decadent wobble to your ";
			if Ball Size of Player >= 4:
				say "heavy sets of potent baby-batter factories and [breast size desc of player] chest. Smirking at their offer, you kneel down then run a claw finger along the side of their stout muzzle, and inform them that you could do with some relief, noting how ";
				if player is impreg_now:
					say "[italic type]hard[roman type] it can be for a herm in your, you pause to stroke the fertile swell of your well-loved tum, condition to carry around such a lush eggy tummy and these ripe, fat, balls and have nowhere to empty them. ";
				else if Player is impreg_able:
					say "difficult it can for well-hung hybrid like yourself to strut around with such plump, heavy, balls and have nowhere to empty them. ";
			else:
				say "compact, at least by taur standards, quartet of cum tanks and [breast size desc of Player] chest. Grinning devilishly at their offer, you take a knee beside them, proudly proclaiming that you could do it with a quick rut[if player is impreg_now], especially in your, you pause to gently caress the beautiful dome of your thoroughly egged tumby, current state. Why, the weight of your brood putting pressure on all the right spots is enough to drive you... wild, you tease[else if player is impreg_able] after that last tussle has left you feeling a little, pent up, you rumble motioning to your flanks with a bob of your tendril-esque hair[end if].";
			WaitLineBreak;
			say "     'Aye, that sounds like a most agreeable penance me Dragon, one me-un-me mates will gladly pay!' the captain pants, leaning into your touch as you trace your talons over the rough, gray, pebbled surface of their aquatic hide and down their chiseled swimmers arms. The scything kiss of your bladed digits provokes a light yet pleasant shudder from the bound herm as their heavy e-cups strain against the thick jute cords binding their impressive chest. You loop your talons around it, deftly hooking the sturdy length of twine in the crook of your claws, delighting at the off-white furrow created in their scaleless gray hide as the water-logged rope digs just a hair tighter into them and the submissive needy whine of the selachian siren. With but a single pull of your bladed digits, you sever the cord, freeing the lithe creature from hir harsh bondage. 'Oh thank St. Brendan the navigator... and you, me Dragon. Da poor girls wuz starting ta chafe,' the captain rumbles, hir paws roaming the decadent swell of hir ripe glistening chest as shi massages the deep knotted marks left in hir hide.";
			say "     Nodding, you remark that bounty such as hir's should be treated with greater care, then turn your attention to the other two herms and quickly cut them free. 'Aye Neptune's blessing upon lassy! I thought I'z was was gonna lose a nip soon,' the shark on the left cries, as they rub the creases emblazoned on their areolas. 'An may Salt favor ya too!' the shark to the right of the captain exclaims, while their webbed paw-like hands rove their shapely legs as they massage the deep indentations left in their breedable flanks. Swooning internally at the sight of their playful antics, you curl your massive frame around the delectable beauties, and lovingly add your paws and tendrils to theirs as you tenderly massage their sore bodies, all the while complimenting them on their lush hybrid figures and buxom builds. 'Aye you're too kind Miss Dragon, but we be but wee nymphs compared to your abyssal beauty,' the captain simpers in a vivacious trill, as you playfully nibble the nape of hir neck.";
			WaitLineBreak;
			say "     Tittering, you find it hard to not agree with the nautical herm, even if shi's likely playing you, you muse, while rumbling aloud that you can think of ways to [']help improve['] their chesty physique, as you kiss your way down the potent curves of hir lush sweater puppies. 'Aye [']N how might ye do that, me sweetie?' the captain mews, as your forked tongue glides across the rich adipose-laden hills of hir heavenly chest. Why, you purr, your head drifting further south, giving them a nice fat clutch of dragon eggs to rest hir prodigious glands on. Especially when shi has such a cute little pair of cocks to support them, you add, catching a glimpse of hir eight-inch prehensile spires coiling about hir hale thigh gap. 'Arg, that would be quite the sight and a treasure like no other,' shi coos reverently, hir eyes glazing over with wispy tendrils of desire at the thought. Indeed, you rumble, motioning for them to roll over and present themselves to you. 'Aye-Aye me Dragon!' the sharks bellow as they scurry over one another, then rapidly drop to all-four in a line with the captain in the middle before you.";
			say "     Rumbling appreciatively, you can't resist the urge to indulge your many eyes for but a moment on the succulent sight of their dense toned asses pressed against each other as their plush cakes war for space while their tails fan their hybrid scent into the storm-lashed air, as rivulets of feminine, dewy, inky-black rains cascade down the small of their backs and petite pendulous balls gently sway in tandem with subtle motions of the ocean. Though perhaps mistaking your brief voyeuristic interlude for hesitation, the captain chuckles aloud, saying, 'Ya-har me Dragon, you feeling a might intimidated at the sight of so wondrous as our coves!?' At once, their words snap you out of daze and you eagerly leap atop of their waiting bodies, landing with a heady thud that shakes the deck beneath you and evoking muted gasps from the salutary wenches, as you simultaneously spear the left and right sharks with heavy thrust of your dual tools.";
			say "     As their hungry muffs dutifully devour the virile mass of your ridged pleasure rod, their glorious heat floods your turgid cum vein as their elastic aquatic muscles cinch about your regal knot. You bend your tail in an instinctual [']U['] bend and hilt the captain with a single powerful meaty thrust of your supernaturally lubed limb, ";
			if Intelligence of Galaxite is 1:
				say "releasing a bellow of unvarnished lust as your spaded tail-cunt glides along hir sweltering passage. Hir exotic muff dutifully clenches about the puddling lips of your virgin box as hir selachian cunt lovingly pools about the lush taper of your tail while hir elastic walls bulge with the weight of your appendage. The captain squirms delectably beneath you as hir pleasantly coarse hide skims about your glassy scales, mewing, 'Ah s-s-o good,' in a dreamy tenor, while hir webbed paws roam the ripening swell of hir well-stuffed muff as shi gleefully fondles the tender outline of your ovi slit.";
			else if Intelligence of Galaxite is 2:
				say "roaring with reptilian rapture as your tail maws unfurls within hir and your unusual tentacular tongue fills hir molten depths. Alongside a pleasant rush of salty feminine delight as the nascent taste buds flicker about the silky walls of hir dripping passage as your virgin sensory cells glut themselves on hir unique flavor. All the while, the captain squirms delectably beneath you as hir pleasantly coarse hide skims about your glassy scales, mewing, 'Ah s-s-o good,' in a dreamy tenor, while hir webbed paws, roam the ripening swell of hir well-stuffed muff as shi gleefully fondles the tender outline of your tentacular tail maw.";
			WaitLineBreak;
			say "     Your liminal mind swoons with fathomless bliss at the touch of hir claws racking your sensitive ovi channel as shi dandles your writhing limb. Meanwhile, hir mates rumble in wordless bestial agreement, as their curvaceous forms sway in tandem with your potent thrusts. You can feel their aquatic bodies ripple with each domineering piston of your tauric half as they desperately try to take as much of your throbbing dick as their comparatively smaller bodies can handle. Good sluts, you chuff in a haughty yet appreciative tone, at the raw rush of the living thermoclines caressing your [cock size desc of player] spires as the vibrant interplay of their hybrid muffs and bracing cold of the storm-forged rain cascading over your imperial assets. Your draconic psyche revels at the heady contrast lavishing your growing majesty as the beads of viscous rain trace the lustrous contours of your tauric form as your dominant forepaw roams your playthings['] supple bodies.";
			if Ball Size of Player >= 4:
				say "     Your delight only grows at the sensation of the pleasingly coarse hide coddling their sizable breasts and the decadent thrum of your heavy sack bouncing against the chiseled swimmer physique of their breedable flanks with each animalistic buck of your tauric hips. 'Gods above and below me dragon, that feels amazing,' the left shark titters as hir tail coils about your hind legs. 'Aye, fill me ya wild beasty,' the shark on the right of you swoons, as their flexible limb caresses the thick lamina of your other legs in a doting, lazy circuit. 'Oi by Salt, yes ye majestic wyrm,' the captain hums, as shi reaches back with hir paws and eagerly fondles the heavy swell of your tightly-packed quartet of spank banks in the soft velvety embrace of hir pads. Your draconic heart almost skips a beat at the heavenly innervation of hir marshmallowy peats and intoxicating strokes of hir claws worshiping the virile hills of your gleaming dragon balls. 'Oh just feel the heft of these pearls me hearts!' shi exclaims in lascivious cadences, as hir gam's tail joins hir inquisitive paws.";
				WaitLineBreak;
				say "     You rumble encouragement at their practiced touch, as the horny herms pamper your alabaster scales in their loving embrace. 'By the nameless ones, what I wouldn't give for a set [']O these,' the left shark hums, as their dexterous fins trace the throbbing borders of your scalie sack. 'Aye, what a lucky beastie ya are me dragon,' the right shark titters. Meanwhile, the captain's tender beans cushion your massive baby-batter banks amidst the squall of hedonistic delights roiling your hybrid senses. You can barely hold back the bubbling whirlpool of bliss and draconic lust sparking like freshly knapped flint along your fraying psych, as the worshipful touch of their tail fin simmers about the lips of your dribbling snatch. A part of your shifting mind can't help but swoon at their exotic texture playing across your tough scalie petals as the thrallish herms caress your respective sex in the succulent folds of their fins."; [salt, storm, and stone are the nameless gods of Zunless sea, I hear Wahn's a fan of those games, so I added them for him.]
			else:
				say "     Your elation deepens all the more at the sumptuous creatures['] tails coiling about your hindlegs, as they thrallishly massage the tight carved contours of your well-muscled legs. A part of you can't help but delight at the unique contrast of the rough hides gracing the glassy surface of your jeweled body as their inquisitive appendages climb up the length of your [bodydesc of Player] limbs in smooth languid motion. 'Mh what a mighty beasty ya are, me Dragon,' the left shark hums as hir fins brush the elastic lips of your tauric cunt. 'Aye, tis like yer body were carved by Storm [']er-self and polished by the waves,' the right shark simpers, as hir tail joins hir peers in the proper worship of hybrid passage. Your fragmenting hall of your liminal mind ripples ecstatically at the touch of their rough yet oddly pleasing caress of their flexible limbs roiling your tough alabaster scales.";
				WaitLineBreak; [merge here]
			say "     'Un ye got such a right tender muff too me dragon, perhaps you'd like us to...' the left shark trills inquisitivity, hir fins curl in upon themselves into fine malleable points, as shi traces the plush borders of your sweltering draconic box. Growling in bestial tenor, you bark your consent to the doting creature between the potent bucks of your heavy tauric hips while your aquatic cunt ripples delectably with each animalistic motion. '*Uf* Aye *ugh* Aye!' the left and right shark pant in unison as you feel their tails entwine around one another as they grind their linked appendages about the molten walls of your [cunt size desc of Player] nether lips. Eliciting a well-pleased reptile chirp from your regal lips as the affectionate herms slather their girthy limbs in a generous sheen of your puddling juices and natural oils, till a balmy patter of erotic fluids drips down the chiseled hills and dense valleys of your muscular scaly legs. The two swiftly pull back their tails, and then with a single, intoxicating, thrust, hilt their selachian tails within you.";
			say "     You roar with reptilian bliss, as your cunt stretches oh-so-wonderfully to accommodate their writhing appendages, evoking an aphonic creak from you bestial belly scales as the sinfully sweet tightness and exotic texture of their tails cascades along your tauric passage. You can barely even keep your pace while their fins swirl along thrumming walls in a chaotic symphony of enthralling sensations. Each ridge and tender nodule of their fins and tail puts the most delicate of pressure on your hybrid g-spots as their surprisingly flexible appendages contort into new and complementary shapes your hermaphroditic mind can hardly comprehend over the rollicking bliss swarming along the supple ridges of your turgid spires and altered tail. As their needy cunt muscles gleefully milk the [bodydesc of Player] contours of your trio of titillating tools while the fuck hungry sharks sway in tandem with your virile form.";
			WaitLineBreak;
			say "     You soon feel an odd, yet not wholly unbidden, sensation billowing around the borders of your thrumming spires as a sextet of throbbing silky smooth spear-shaped tendrils coiling about the ripe masses of your massive cum veins and ovi channel. Hopelessly lost in your own personal elysium, their sudden enticing presence hardly even registers in the bliss-wracked halls of your tainted psyche. Still, you can't deny the vivacious pleasure sparking along your tools as the slippery tendrils wrap themselves about your breeding rods like tempestuous serpents upon a vine. 'Mh, me hopes ya don't mind us cutting in like this Miss Dragon, but we'z can't be letting ye have all the fun,' the left shark coos, as the prodigious tentacles gracefully slither along the virile girth of your draconic cocks, lavishing your dicks in the pulsing folds of their decadent embrace. While you internally gush over the lustful warmth and hedonistic delights playing across your well-swaddled pricks, you can't help but rumble your consent to the enthusiastic creatures, as the buxom corsairs['] dexterous dicks surge along the beatific contours of your draconic pleasure ridges.";
			say "     Mewling wordless praise, the double-dicked herms prehensile anatomy shoots forward as they spear themselves on their own rods. Their lustful bodies shudder with utter rapture as their already stuffed passages swell with added girth and tools join yours in an impossible waltz of hybrid bliss. Your liminal mind swoons at their touch as their taut walls cinching about your spires synchronize with the loving strokes of their tapered tools frottaging you in tune with the heavy pounding of your tauric hips. Meanwhile, your dominant forepaw gleefully roams the tender bulges of their flush tums, delighting at the outline cast by your ensorcelled pricks and the heady squirming sensation of the sharks['] prehensile tools playing along your supple pads and succulent border of your draconic spire. 'Ah s-s-so good, feels like I'z already got a nice fat shiver in me,' the right shark in dreamy tenor, as hir left hand glides about the throbbing swell of hir dick-stretched middle.";
			WaitLineBreak;
			say "     Chuffing approvingly at hir touch, you hardly notice the oddly quiet captain's tools swarming around your altered tail as shi struggles to wrap the titanic appendage in hir vivacious embrace. Still, the erotic pressure and tapered kiss of hir eight-inch tools simmering along your ovi limb is a wonderful accoutrement in and of itself as the virgin passage roils at hir caress. Soon you're panting in a mix of frustration and abyssal bliss, as the lust-drunk hybrid switches tactics and runs hir supremely flexible limbs about the breadth of your ovi channel then the delta of hir own gushing muff, babbling, 'Gods yar huge, me, *huff*, dragon, but I'z needs [bold type]more[roman type]!' as hir malleable spears flicker along the rippling lips of hir aquatic passage. You can't resist rumbling in bestial appreciation at hir virile efforts as the swirling emulsion of your juice trickles about your tough, sleek, scales as shi slips hir lewdly-lubed cocks betwixt hir lurid nether lips.";
			if intelligence of Galaxite is 1:
				say "     Hir tools surge along the conical length of your enhanced tail in a hedonistic spiral of eclectic sensations, while her belly bulges delectably with the potent mass of hir throbbing cocks. Hir beyond-packed midriff creaks with the effort as the trio of hungry sirens sway beneath you, though the hedonistic tightness only adds to the symphony of unearthly pleasure sparking along your dutifully worshiped body as your cunt puddles with the heavenly squirming of their tails moiling your abyssal depths and dual g-spots. The caress of their lush walls and frictionless dandling of their tender tools moils your draconic rods, cascading over your [bodydesc of Player] form in doting notes of effervescent elysium as the captain's cocks grace the gushing lips of your slit. A euphoric rumble issues from your lips, hir prehensile pricks dock with the yearning chasm of the girthy passage, the unsullied nerves sing with eldritch rapture as your exotic box stretches beatifically at their touch.";
				say "     Lascivious sparks shimmering along the alien flesh at the unusual attention, yet you can't but feel a certain hedonistic thrill tracing about the furrows of your psyche as the concentric rings lining your egg-laying walls ripple about these lustful invaders. Your tail muscles gleefully thrum with virile purpose in the twin tools sweltering embrace. 'Holy Zun,' the captain chirps in dissociated cadance, as the silky alien flesh filling your ovipositor massages hir daring assets. You can feel hir body tense and hir pulse pound with each probing thrust of their turgid tools as a beautiful shudder courses through hir body as they cum, basting your virgin passage in a velvety sheen of balmy excess. Your ovi tail throbs with the weight of their gooey offering, the raw torrent of virile bliss pushes you over the edge, as the nascent cells thrum with reproductive purpose. Something shifts within you as a torrent of supple gelatinous eggs parade along the exotic muscles.";
			else if intelligence of Galaxite is 2:
				say "     Hir verdant rods roil about the supple devilishly-lubed contours of your heavily-augmented tails as the captain's twin tools caress your inquisitive limb. Your senses are blessed with a sudden, yet not wholly unbidden, rush of the intoxicating flavor of hir salty and rich aquatic tang as hir glossy tools rifle along your tail maw's elated tendrils. Enthused, the hungry feelers eagerly swarm about hir dexterous prehensile pricks as if they had a mind of their own, gleefully coiling about hir dexterous dicks, tenderly pampering the lustful herm's throbbing tools in their otherworldly embrace. Your heightened hearing delights at the cute creak of hir stomach as hir belly bulges with the hedonistic weight of your entwined appendage as your commingling tendril-esque bits swirl about one another. The captain pants in a loud desperate tattoo, 'Ah by Salt me dragon, where did ya learn this trick? Tis like I'z got a real shiver in me timbers!' as shi paws the ripe squirming border of hir overloaded tum.";
				say "     Your liminal mind revels at the succulent dissonant innervations of hir supple paws and sickled claws tracing the sensitive flesh as shi pampers your beatific additions. Delighted, you add own mitts to the mix as you affectionately stroke the churning mass of the salutary shark's riotous middle as shi wallows in your grasp, your draconic psyche delights at the sensual motions of hir packed cunt playing about your supple pads and your tail mounted mouth tentacles swaddling the crimson tapered forms. Your senses are flooded with raw tactile bliss and wondrous sapors as your sleek appendages dandle about one another. Each vivacious throb of the captain's turgid cum veins pairs with hir satin wall's heavenly thrum as hir body shudders in tune with hir quickening pulse while your predatory muscle devilishly draws the captain's spires towards your yearning maw, provoking a pleasant needy mewl from the captain as the veiny petals of your tail encapsulate hir sensuous anatomy in their sordid clutches.";
				WaitLineBreak;
				say "     Your ravenous muscles diligently roil about hir tender tools as they're drawn into the plush furrows of your exotic O-ring. Your tail is awash in a lustful squall of reptilian bliss simmering along the unearthly flesh lining your hybrid passage as your voracious muscles affectionately milk the captain's ensorcelled cocks. The alluringly tight, yet strangely elastic, tissue ripples with lascivious purpose as the concentric rings decorating your ovi passage dandle the selachian siren's elated peckers, pairing like the grandest of wines with the echoes of the other lewd herms['] supple cunts and lurid tools teasing your draconic rods. Sensual waves of storm-touched bliss patter about your liminal senses as your hybrid sex thrums with each potent buck of your hips and sordid caress of their dexterous cocks.";
				say "     You sense an all-too-familiar tightness well about your toy's lust-wracked cores as the hungry sway of their hips grows ever more bestial. 'Oh holy Zun!' the captain moans in drunken cadance as hir ecstatic pulse quickens with the delectable force of hir climax. Hir twin tools erupt within the voracious confines of your potent tail maw as shi unleashes a deluge of aquatic delights. Abyssal warmth, and salty-sweet tangy sapor invades your senses as your hungry hybrid limb bulges as it devours hir generous offering with draconic aplomb. Decadent drool pools along the edges of your muzzle at the sympathetic caress of hir flavor titillating your senses while a lancet of raw delight prickles along your the nascent passage, sending the virgin pleasure sensors over the edge as your pleasure peaks.";
			WaitLineBreak;
			say "     Roaring in supreme elation, your tail convulses like an overloaded switch board as the unearthly ovum surge forth amid a gush of nautical seed stretching your elastic ovi lips to an almost painful degree. A primeval rush of reptilian rapture flares through you as the heavenly herm's receptive body groans with weight of your exotic load, as your dicks quiver and feminine passage spasms with a bubbling deluge of draconic delight as the shockwave of climax pushes your hybrid body over the edge. Motes of prismatic light swirls across your vision as you finish while a triumphant wave of relief and satisfaction washes across you. You dig your claws into the deck, shearing the metal with your gleaming talons as your spires erupt, loosing a potent squall of pearly virility. Purring happily at the lovely weight and heady of heat of your load as their tummies groan with ponderous weight of your wad, the other sharks['] voices quickly join yours as their dicks throb about yours, unleashing a torrent of intoxicating futa cum. Meanwhile, their cunts hungrily hug the tender contours of your rods as they squirm beneath you, their over-lubed tails slipping from your lush lady lips.";
			say "     Your tainted mind revels in hedonist delight at the toasty caress of your commingling seed moiling your spire and scintillating hum of your dripping muff. You murmur vague praise to the cheeky herms as you languidly un-hilt your trio of breeding tools with a ripe pop and heady shudder as the storm-lashed air dances along the dripping ridges of your moist rods. You then carefully step around your well-seeded toys to gleefully observe the aftermath of your work. Your lips curl into a proud grin at the sight of the herms gently swaying on all fours while lovingly stroking the blushing edges of their cum-stuffed middles as they hang just a hair's breadth from the deck. 'By Salt and Stone me dragon, ya really know how to show a [']girl['] a good time,' the left shark pants as shi carefully rolls on to hir back with a pleased yet goofy grin emblazoned on hir snout as shi stares at the wobbling mass of hir hopelessly bloated tummy.";
			WaitLineBreak;
			say "     'Mh, an I'z feel so warm like I'z got a nice bubbly bottle [']O grog in me,' the right shark purrs, languidly flopping on hir side, letting hir lush middle rest comfortably on the rain-soaked deck as shi lovingly fondles the rosy curves of hir cumflated core. 'Aya, th-thank ya me dragon I'z never felt so full,' the captain murmurs, as shi gingerly shimmies onto hir back. Hir expression waxes between unearthly pride and maternal contentment as shi gleefully massages the lush lumpy swell of hir lap-filling middle. Your brood-focused sensibilities can't help but enjoy the sight of the cute ruby hues blossoming across hir taut tum and the sensual impression of hir plump E-cups balanced atop of hir clutch-laden core. 'Tat least not with such wondrous eggs,' shi adds with a doting note of paternal delight as shi traces their succulent outlines with claws. 'Gods above and below, I hope [bold type]all[roman type] these stick, our gam would be the envy of all! Right me mates!' shi bellows in a maniacal cackle as strange tendrils of many colors and none coil along the edge of hir eyes.";
			say "     'Indeed me captain,' the left shark snickers, nuzzling hir well-seeded belly next to hir skipper, while hir paws tenderly massages the brood-mad pirate's clutch. 'Those lot on ta island will rue they abandoned uz to dis here [']ulk.' 'Aye, cap'in but do ya mind keeping it down, me gam un I'z needz a moment to settle,' the right shark mews in a tired tone as shi protectively hugs hir heavy tum in hir arms. 'Da of course me heart, gifts such as these,' the captain grins, slipping hir webbed fingers under the stiff, wobbling, mass of hir hefty middle, 'should be treated with ta upmost care. An for dis,' shi preens as hir eye drift over your tauric form, 'we thank ya me dragon, when our tides change, I'z promise with Salt, Stone, and Storm as my witness we'll repay ya a hundred fold for our rescue and yer blessing. But for now,' shi yawns, 'me mates un I be needing a moment ta let da lil ones rest,' Shi swoons, bobbing hir tail to hir left and right.";
			WaitLinebreak;
			say "     At this bold pronouncement, you can feel your hackles rise at the notion of these lesser beings commanding your nascent flight, yet before you give voice to these thoughts, the presence begins chirping in a fractal choir from the back of your mind. 'We feel and share your ire, but hold your tongue, our sister will deal with them as is proper soon enough. Besides, they have such,' they pause as the storm crackles around you, 'potential, so let them rest for now, and [italic type]Na reck da han kovve nuthi[roman type],' the presence intones, as your ire bleeds awaying in a cold surge of reptilian calm and mammalian curiosity. You decide to let the matter drop for the moment after all. You can alway collect your wild oats later, and besides, you have little desire to harm the future mothers of wyrmling. Yet, you muse as, with a heavy shrug, you make your back aft more than ready to discover what manner of treasures and dangers await in the lower decks.";
			CreatureSexAftermath "Shark Herm" receives "PussyFuck" from "Player";
			CreatureSexAftermath "Shark Herm" receives "PussyFuck" from "Player";
			CreatureSexAftermath "Shark Herm" receives "PussyFuck" from "Player";
			CreatureSexAftermath "Player" receives "Stroking" from "Shark Herm";
			now strength of Galaxite is 1;
			say "[PartThree]";
		-- "Get spit roasted.":
			if Player is herm:
				say "     Pushing back against your more, fanciful proclivities, the whorl of chaotic flickering across your scales slowly peters out as you decide against claiming the sharks in more primal fashion. Such weak creatures are hardly worthy of bearing your eggs, yet they could serve as a good outlet for your other... urges, you ruminate as the lingering predatory energies flicker away along your flanks and a low hungry rumble simmers along the edges of your [bodydesc of Player] stomach. You turn around, then head back to the middle deck, and your bound, you pause to lick the gleaming fangs lining your scalie maw, morsels. As you stride back along the storm-lashed deck, you can hear the sharks idle boisterous chatter come to an abrupt halt as they catch sight of your tauric silhouette appearing out of the gale. 'Uh captain, I'z think they'z [']erd us,' the left shark stammers, as the piercing gaze of your glowing golden eyes washes over their curvaceous rain-soaked form.";
				say "     'Oh sorry me dragon, we'z meant no offense to ya, t'was nutt'en more den some harmless sailor talk.' The captain fidgets against the ropes binding hir succulent body, while you prowl up to them. 'Is there anything me and me mates can do ta make it up to ya?' shi simpers, in an oddly hopeful tone as a cute rosy blush coils along the lips of hir gray cock slit. Delighting at the sight of the enticing furrows created by the ropes digging into hir plush E-cups and shapely ankles as shi squirms beneath your abyssal gaze, you rumble in a domineering tone, that perhaps shi can. The brief tussle with tenrecs and the puny mink has left you feeling a tad... famished, you tease, eyeing up the gleaming crimson taper of hir dual prick roiling about the edge of hir dewy cock cave. Your tauric form could do with a little [']stress relief['] too, you add as you kneel down and trace the flat of your talons along the angular contours of hir snout, provoking a cute preyish shiver from the captive captain.";
				WaitLineBreak;
				say "     'Aye, dat does seem like a fair penance me dragon, one me mates and I'z would gladly pay,' the shark coos, as the reflective edges of your claws glide along hir throat while the feverish lustful patter of hir pulse plays along the scything contours of your bladed digits. Smirking at hir properly subservient attitude, you quickly flick your rending talons to your left and right, effortlessly severing the bonds of the other two sharks, while leaving the captain's intact. 'Uh I'z think you missed a spot me dragon,' the herm pants in an enthralling mix of desire and fear as well as the rich scent of dragon fear pours off hir as shi gestures to the ropes wrapped about hir bust, hands, and ankles with a wave of hir tail. Tutting in a haughty trill, you tease hir that you'll release hir from hir bondages soon enough, once you've had your [']fun['] as you tuck your muzzle to hir groin, playfully kissing hir plush dripping dick-slit. Your warm breath mists the storm-beaten air with a lush plume of smokey gray wisps of vapor, as the nimble beauty wriggles delectable beneath you then order the other two to service your flanks with a commanding come-hither gesture of your tail.";
				say "     Meanwhile, you languidly glide your bifurcated tongue along the balmy borders of the captain's vent, reveling internally at the heady salty sapor of hir pre leaking from hir twin spires. The inquisitive forks of your tongue lovingly entwine the exotic bend of hir throbbing crimson tools in their predatory coils, you diligently dandle hir dual tools to attention as beads of hermaphroditic delight trickling serpentine edges of your taste buds while hir vent bulges ever-so-slightly as you stroke hir off. 'Ah b-by Salt me dragon!' the captain mewls in a lustful submissive tenor as you ease your lips over hir swelling prehensile rods, though a brief look of terror soon blossoms on hir face alongside a delectable, frightened, quiver as your snout kisses hir toned, sweltering middle. Any apprehension shi might of had swiftly melts away as you pamper the sordid hybrid's turgid dicks along the bestial ridges of your muzzle and loving hold of your tongue as you bob your head about the length of hir cocks.";
				WaitLineBreak;
				say "     Seemingly encouraged by the spectacle and spurred on by a harsh glance from your many luminous eyes, the other two herms quickly scramble to their paws and dash behind you, no doubt eager to be the one to claim your feminine passage. Though their race is close, the left shark is the first to reach your flanks as shi roughly shoves the right herm to the deck then takes hir place place behind you. You watch out of the corner of your expansive field of view, as her paws drift to hir plush dick slit as shi gently strokes the blushing borders of hir lush sex, slowly coaxing hir twin rods to attention. A part of you can't help but enjoy the spectacle of eldritch rain pouring down hir athletic body as the odd fork of umbral lightening reflects off of the sleek contours hir gray pebbly hide while hir selachian cock cave bulges with the weight of hir exotic tapered spires as they slip between the gaps in hir webbed paws. Lips curling into a toothy vivacious grin, the left shark, eagerly cups hir dual tools in the crook of hir hand and flashes you a questioning look as if asking your permission.";
				say "     Go on, you rumble magnanimously through dick-stuffed lips at the lowly creature's show of proper respect to your draconic majesty, further signaling your consent with a cheeky shake of your toned flanks and commandingly wrapping your tail about the well-muscled curves of hir hourglass waist as you pull hir close. Meanwhile, the captain swoons at the heady vibrations of your throat playing along hir twin rods as they glide along the tactile ridges of your maw and potent strokes of your forked tongue explore the bestial taper of hir cocks. The left shark nods, leaning into the silky scaled embrace of your titanic tail caressing hir midriff and the inviting hills of hir vibrant e-cups, simpering, 'Aye me dragon,' as shi takes hold of the sleek, decadently-lubed lamina bejeweling your bestial flanks and lovingly caress your toned inner thighs. Your liminal mind revels at hir touch, as hir clawed paw inquisitively roams your sensitive bestial half as shi lines hirself up with your dripping [Cunt size desc of Player] box, and thrusts.";
				WaitLineBreak;
				say "     Frictionless bliss blossoms along your hybrid passage as hir dual squirming spires slip between your perpetually lubed lips, provoking a pleasant little shudder from your [bodydesc of Player] body as your hungry cunt cinches about hir dexterous double dicks like a living mold as your elastic walls gracefully hug the animalist taper of hir cocks. Almost purring with draconic contentment at the dexterous caress of hir prehensile pricks putting the most succulent of pressure on your masculine g-spot as your tauric passage bulges ever-so-slightly with the weight of hir twin breeding rods. The gentle echoes of the masterful pistoning of hir hips and the ambient crackle of the stormborn lightning arcs about your well-loved scalie hood in an intimate waltz of sensation. You can feel the blood rushing to your own [cock size desc of player] rod, as your plump knot swells along the supple walls of your dick slit at the hearty pater of the rain, meaty thrum of the left shark's chicken-egg size sack rifle against your own bejeweled ball bag, and invigorating thrust of hir malleable masts cascading about liminal mind as you nurse the captain's cocks.";
				say "     Gushing at your tongue's caress, the bound herm lightly bucks hir toned hips in tune with the loving bobs of your head as shi pants delightedly at the touch of your dexterous oral muscles lavishing the salty contours of hir cocks. Hir eyes soon fall on the odd shark out as shi stares dumbfounded at your well-fucked body and your unattended [cock size desc of Player] spire swaying beneath you and a cross look simmers into being on the captain's snout as shi bellows, 'Oi, you lout, what ya doin['] sitting there like a greenhorn on hir first voyage?! Get off yer arse and attend the good dragon!' At the sound of the captain's booming androgynous voice cutting through the storm, the seemingly mesmerized shakes hir head as if to clear, then nods, saying, 'At once captain!' as shi crawls beneath your tauric form. Your heart almost skips a beat at the decadent kiss of hir toothy snout, as the warm wisps of hir breath play along your taut slit and tender ridges of hir muzzle close about your throbbing spire as hir strangely elastic throat effortlessly conforms to aquatic bend of your [CockName of Player] dick."; [Greenhorn is a crew person going on their first trip out to sea, fun fact I'm technically considered an apprentice salt meaning I've done one stint on a ship as a boson.]
				WaitLineBreak;
				say "     Hir exotic predatory throat envelopes and bulges at the beatific weight of your spire as the voracious cocksucker deepthroats your turgid tool with surprising alacrity. Shi practically hums with a deep abyssal hunger as shi dandles the heavenly pleasure-plates lining your spire with hir tongue while shi lavishes your moist cock cave and your potent aquatic knot with loving drawn-out strokes of hir clawed digits. Your hybrid senses are sent roiling in a heady storm of reptilian rapture at the dissonant caress of hir talons and supple pad as shi skillfully slips a few of hir fingers between the gushing lips of your draconic vent and cheekily strokes the sleek walls of your cock slit. As hir free paw roams the heavenly swell of your knot, shi happily pistons hir angular snout along the length of your [cock size desc of player] spire. All the while, hir selachian throat muscles clench and pamper the tactile ridges of your tool in a wondrous rhythm all their own.";
				say "     You can hear the sultry siren coo in a lustful trill, 'Mmh by Storm, delicious,' as rivulets of warm reptilian juices and sumptuous draconic pre drip down hir throat and chin as shi nurses your throbbing cocks while the sharp edges of hir fang traipse about the tender ridges of your [cock size desc of player] spire. Another time you might have felt a note of apprehension at such treatment, yet a part of you finds something about their glossy smooth flats and unerringly honed razor edges oddly enticing as the intoxicating brew of disparate delight flickers along your sex. Your draconic palate is treated to the salty sapor of the captain's own juice as shi wriggles under your muzzle's dominating touch. Hir heart pounds and breath comes in labored yet lustful gasps at the enthralling touch of your sizable forked tongues as you cheekily slip the sleek edges between the lips of hir blushing ruby-gray vent. Your sharp draconic senses are soon greeted by the coiling scent of the captain's gushing feminine flower, as glistening beads of hir exotic dew trickle about hir plush sack.";
				WaitLineBreak;
				say "     Intrigued, you coyly glide your webbed paws along the contours of hir bound legs, rollicking internally at the aquatic grace of hir swimmers thighs and toned hardened core of hir shapely muscles gracing your pads. You slip your paw beneath hir balls and extract no small amount of mirth at the needy whimper your grasp evokes as you skillfully palm hir tender pearls. Despite hir lowly nature and puny proportions, some section your fragmenting mind appreciates the gentle heft of hir salty bounty as you flash the captain a bestial smirk, and playful caress hir moist joybuzzer between your thumb and forefinger. You dutifully dandle hir fishy bottom while your natural lubrication streams down the rain-touched borders of hir balmy muff. 'Ah, ah by Stone me dragon, y-ye know how to treat a [']girl['],' the captain swoons dreamily as you carefully slip your finger past hir tight sweltering cunny lips. Rumbling wordlessly in reply, you angle your digits along hir ecstatic cove, expertly caressing hir supple folds and putting a subtle, succulent, pressure on hir masculine g-spot."; [Honestly, not too sure how popular prostate massage content is but I have a nose to tail approach to writing.]
				say "     You can feel the captain's pulse race all the quicker with each sordid flex of your fingers alongside the dulcet pass of your [bodydesc of player] maw as hir aquatic muff crinkles with unabashed need. Shi strains delectably against hir rain-soaked bonds causing them to cinch all the tighter about hir hearty E-cups, creating the supplest off-white furrow in the plush perky hills of hir stately rack. Wallowing at the sight and hardy motions of the left shark's hips as hir dexterous dicks whorl about your hybrid passage lavishing every inch of your tauric depth in an intoxicating symphony of unbound rhapsody. Hir tools never seem to grace a spot twice as shi pounds your [cunt size desc of Player] cunt, warring for prominence with the beatific caress of the right shark's lips dutifully nursing your turgid rod as your liminal mind is set awash in a chaotic waltz of sensual sensations. You can sense a blissful steady thrum of an all too familiar tightness building in your core as your balls twitch and cunny spasms in anticipation.";
				WaitLineBreak;
				say "     Unwilling to finish before your playthings, you coyly slide the end of your tail between the left shark's legs, evoking the tenderest of wordless trills from hir lips as the smooth lubed edges of your prehensile tail glides along the inviting borders of hir toasty cunt and sumptuous sack. Hir lush warmth and the inviting chill of storm wash over your in a vivacious thermocline as you gleefully jill the welcoming folds of hir muff with long languid strokes of your tail as you coat hir inviting passage in a generous sheen of your eldritch lubricant. Accompanying each innervating pass, you can feel hir cock throb in tune with the loving dandle of hir hips as you arch your tail into an instinctual [']U['] bend and spear hir aquatic cunt with a single artful stroke. Gasping in raw bestial elation, you can feel hir fertile flower stretching delectably with the wondrous weight of your prehensile limb as you lavish hir flush folds with hearty loving motions of your girthy appendage. Already nearing hir limit, the sultry siren's pulse pounds in tune with the lustful throb of hir dual cum veins along your [Cunt size desc of Player] walls as shi dutifully caresses your inner thighs and draconic pearls with hir coarse pebbled palms.";
				say "     Reveling at the touch and salacious rhythm roiling your tauric sex, you coil your augmented limb into new creative shapes as you probe hir silken folds, diligently massaging hir hybrid g-spots till, at last, with an elated bellicose cry, shi cums, basting your cunt in a twin flood of molten salacious seed. Your lower stomach swells with the welcome salty treat as you find yourself purring with reptilian rapture as the potent vibration of throat, beatific laps your tongue, and skillful innervation of your paws overwhelm the captain's waning resistance. Mewling in bestial glee, hir voice swiftly joins hir mates['] as hir spires wallow about the inviting ridges of your maw and pillowy furrows of your forked tongue as shi finishes, loosing a torrent of virile excess upon your respective draconic maw. Your cheeks bulge with the weight of hir load while you ravenously swallow with preternatural ease, basking at hir rich oceanic flavor gracing your far-traveled palate and heavenly warmth of hir generous load titillating your tummy.";
				WaitLineBreak;
				if Player is impreg_now:
					say "     You loose a proud rumble of bestial satiation at the wondrous rush of futa cum further rounding out your already plush well-egged middle into an ever more beautiful dome as your elastic tummy scales stretch just a hair tauter with their heavy offering. A profound upwelling of maternal pride and gluttonous accomplishment simmers about your senses as you affectionately paw at the outlines of your eggs as if to encourage them to drink deeply from this stormborn tithe so that they can one day become massive, powerful members of your [one of]flight[or]tyranny[or]shoal[at random] as the toasty mass of virile seed and heavenly caress of the squall coiling about your liminal awareness sends you over the edge. Prismatic stars of many colors and none cascade across your vision as your cunt spasms and cock twitches with the force of your release as you climax, squirting a lurid sheen of feminine dew mixed with futa cum down yours and the left shark's legs.";
					say "     Meanwhile, the right shark coughs and stammers in near drunken cadence as you blast hir profoundly flexible body in a potent tide of your draconic seed. The storm-lashed air resounds with hir hardy gulps and low lewd pants as shi voraciously devours your magnanimous gift, till with a proud sigh and low sloshing plop, accompanied by the bracing chill of the storm, shi looses hir oral hold on your dick and falls to deck beneath you. 'Oh by all the gods of the neath, me dragon, that was a right good feast,' shi purrs, audibly smacking hir lips as shi drums hir fingers along the tight border of hir cumflated tum. The now spent left shark falls limply against your flanks for support, hir clawed mitts lovingly stroking your feral tum mewling, 'Aye, you be a right good lay miss dragon, tis a shame ye already gots a shiver in ya doe.' Hir cocks soften and slowly retract from your dripping box, eliciting a brassy aphonic rumble your lips as you extract your own maw from the fuck-numbed captain's crotch and sever hir bonds with a nonchalant swipe of your claws.";
					WaitLineBreak;
					say "     'Ah thank ye me dragon, thought the girls was gonna start ta chaff,' the captain chuffs, while hir hands go to chest as shi gingerly massages the unsubtle furrow cast in hir hefty e-cups. Nodding, you enjoy the sight of the buxom herm playfully groping hir lush breasts as hir pillowy tits spill between the tiny gaps in hir webbed paws as shi works over hir flush mounds. You languidly seat yourself beside hir, delighting at the sight of well-bred middles as oily rain pours over the verdant hills of your swollen tums and [breast size desc of Player] breasts as your many limbs dotingly roam the tender swell of your growing maternal majesty. Still, despite the deluge washing over your imperial scales, you can feel some lingering sticky trails of errant seed coiling about the borders of your dual sexes and motion for the sated herms to clean the lingering excess with a commanding growl. Compelled by the dominant draconic tenor of your voice and the exciting yet imposing sight of tauric form in full repose, all but the thoroughly stuffed right shark hurriedly do as they are told and scramble behind you in a flurry of activity.";
					say "     Nestling themselves beside your hybrid anatomy, the captain and the left shark eagerly slide their angular muzzles and supple tongues along the toned borders of your packed middles. They lap at your still-leaking slits with soft loving strokes of their exotic oral muscles, sending a happy little shiver down your spine as they attend your duly fucked sexes. The right shark groans in a plaintive submissive mewl drawing your attention back to hir. 'Ugh, sorry me *pant* dragon,' shi huffs in demure defeated tone, as shi struggles to a sitting position as shi rests hir sloshing tummy on her lap, 'I'z can't eat another *burp* bite.' Feeling a light pang of sympathy for the lowly creature and buoyed by the gentle warmth of hir mates['] delectable seed, you decide to take a modicum of pity on the shark and invite hir to your side with a regal bob of head. Besides, your brood-flushed body could use some proper worship, you muse gazing at the fertile swell of your middle, as you direct hir to show your nascent wyrmling the care they, and you, deserve.";
					WaitLineBreak;
					say "     'Mh, yes me dragon,' the shark hums, as shi drapes hir arms over your ripening core. 'Ah by Salt, yer a lucky beasty,' shi purrs, while hir supple palms sink ever-so-slightly into the taut dome of your gently sloshing upper belly, creating cute, precious indentations in your hide as shi traces soothing circles in your tough lamina. 'To have such sleek beautiful scales what shine like priceless gems un dis wondrous oil coating ya, must be a treat like no other. Ya know,' shi rumbles in a devious lustful trill his plants a tender kiss the barren patch where navel once was, 'me mates would be right un proper honored if ye joined us on Pirate Island. Together with you and yer beasty brood on our side we'd rule the waves. I'z promise we'd take good care of you too, you'd never want fir food, plunder, nor a warm muff to keep yer cock company at night. Now taint that right me mates?' shi intones, flashing hir crew a Cheshire smile as hir plump tum brushes yours.";
					if Ball Size of Player >= 4:
						say "     'Indeed me heart,' the captain chuffs, as hir paws lovingly coil about the edge of your heavy quad sack, openly admiring their heft and the gentle wobble of your draconic virility. 'Ye'd be quite the popular lassie with a set like these! Why I'z doubt even the [']cold fish['],' shi snickers under hir breath, 'among our number could resist the chance to carry yer great and terrible spawn.' The captain leans in and shamelessly nuzzles hir cheeks along the swollen contours of your sack, earning hir a pleased draconic rumble from you at the exotic caress of hir hide and gentle touch of hir breath playing about the borders of your still-dripping cunny scales. ";
					else:
						say "     'Aye me heart, a treasure such a yourself me dragon and yer brood would be more than cared by me crew,' the captain hums as hir paws roam the well-lubed hill of your egg-laden core and the subtle throbbing valley of your cock slit as shi pampers the growing curves of your eggs with hir supple mitts. 'I'z give ya me word, you'd never lack for treasure or company me good dragon. Even the rare prude among us would clamor for the chance to carry a shiver of regal beasties such as yours!' ";
					say "Nodding, you can't say their offer doesn't have a certain appeal, as the notion of becoming an object of worship for an island full of buxom corsairs is an enticing one. You could easily see yourself spending the rest of your days surrounded by all the treasures of the deep, your every want and need attended by an ever-growing flock of horny herms while your flight spread across the globe akin to an unstable tide. Yet compared to Galaxite's promise of godhood and draconic power, such a meager reward pales in comparison. Besides, even if her words ring hollow, you feel this body could achieve so much more and only the strange ape seems to know the secrets of how.";
					WaitLineBreak;
					say "     You ruminate, giving your wings an invigorating flex, basking at the sensation of untapped possibilities welling in your core at the thought of what new gifts await. The thought of limiting not only yourself, but your future flight's potential fills you with a surge of fresh determination to see this path though to end, but not just yet. For the moment, you decide to enjoy this minor dalliance and allow these lesser beings the rare opportunity to service your majesty, as you lay back with your arms tucked behind your head while gazing at your ripening body. You can't help but smile at the spectacle of rain pouring off your scales or your bestial visage reflected in your scything talons as the sharks attend your [bodydesc of player] curves. Eventually, the novelty of their caring touch begins to wear thin, and soon, you dismiss the herms with a regal bat of your tail, informing them that their penance is paid. Perhaps fearing that they may have displeased you, a brief look of confusion tinged with precious fear passes between them as they eye up the cruel mirror-like blades lining your paws and wicked barbs of your fangs housed within your dreadful maw.";
					say "     Chuffing, you give them a quick yet genial assurance that no harm will come to them so long as they leave, now, and do not bother your draconian cohort of sea titans waiting below. 'Ah, aye, whatever ya say,' the captain stammers in an oddly downcast tenor as shi calls to hir crew to attention with a bellicose roar. 'Right me hearts! Ya heard the good dragon. Da books be balanced, un all accounts paid, now lets shove while we'z got the chance.' 'At once captain, un uh, thank ya again me dragon for freeing us,' the left murmurs in nearly mournful cadence as they and hir mate disentangle themselves from your reptilian majesty, and scurry over to the portside then dive over the edge without looking back. Rumbling in a neutral growl, you stretch out, pick yourself off deck then make your way aft more than ready to face whatever dangers await you in the lower decks.";
					CreatureSexAftermath "Player" receives "PussyFuck" from "Shark Herm";
					CreatureSexAftermath "Player" receives "OralCock" from "Shark Herm";
					CreatureSexAftermath "Shark Herm" receives "Stroking" from "Player";
					say "[PartThree]"; [of 5]
				if Player is impreg_able:
					say "     You bellow a lustful roar of animalistic satisfaction at the delectable deluge of fresh seed filling your vacant passage as the blissful weight of the shark's bountiful offering stretches your elastic scales out into a pair of plush toasty domes. Swooning at the pleasant weight of futa cum ballooning your middles, placing the most decadent of pressures on all the right places, you can't help but lovingly paw at your warm tummy's alabaster scales in the hopes that their offering will stick. As your brood-focused body craves the heavenly rush of broodmotherdom and all the blissful changes your preferred state brings you. Your supple pads and scything claws dreamily roam the lush growing curves of your [bodydesc of player] tauric tums as you fantasize about your body swelling with fat clutch of eggs as your [breast size desc of player] tits ripen with gallons of rich cream to feed your growing flight of loyal draconic spawn flashes through your mind's eye. Purring at the thought, your [cock size desc of player] spire twitches with unbound delight and your quad balls throb in tune with each lustful caress of the right shark as the little death creeps over you, and you cum, gushing a light stream of feminine juice and futa seed down the back of yours and the left shark's legs.";
					say "     Your cock erupts into the waiting maw of the right shark as shi gags and coughs, struggling to swallow your immaculate load. Still, hir own pride and the dominant position of your draconic tool keeps hir going as the squall-touched air echos with hir pleasant coos and hardy gulps as shi suckles down every pearlescent drop of your molten cum. Till with one last hearty swallow accompanied by the bracing caress of the icy gale along your imperial tool, the shark languidly releases hir oral hold on your cock as shi collapses to the deck with happy sigh. 'Saints of the neath preserve us me dragon, now dat t'was a feast!' the right shark purrs contentedly as shi shamelessly raps hir clawed finger along the drum taut surface of hir well-fed tum beneath you. 'Aye, ye make for a damn good lay too me good dragon,' the duly spent left shark swoons, draping hir sleek form over your flanks as shi loving strokes your cum-flushed middle. 'Gods, I'z hope this here shiver sticks, I wouldn't mind having a beasty to carry on me name.'";
					say "     Briefly rumbling your agreement as the doting siren caresses hir supple mitts along your jeweled hide as shi massages the tough yet delightfully sensitive scales coddling your sloshing tummy. You slowly extricate your muzzle from the still bound captain's delectable tools, then hook your claws under the ropes holding hir captive and sever them with theatrical flourish. 'Ah thank ye me dragon, the poor girls was starting to chafe,' the captain swoons, cupping webbed mitts about hir perky e-cups as shi rubs the furrows cast in hir gray-pebbled hide. You can't help but delight at the spectacle of the buxom herm's hands roaming the lush hills of hir picturesque chest as hir ripe mound spills between the subtle gaps in the webbing of hir hands as the inky rain pours over hir nimble body. Smirking and feeling a touch magnanimous towards your playthings, you graciously add your own paws to hir as you languidly pamper hir svelte physique with well-practiced motion of your own. 'Stars me dragon, ye be spoiling dis here sea dog, why dat oil of yours be like a soapstone for da soul!' the captain titters, as shi arch hir back and leans into your touch.";
					WaitLineBreak;
					say "     Relishing the moment and the beautiful bounce of hir impressive chest as shi pants needily at the wondrous interplay of your glossy scales, sleek natural lubrication, and inviting tickle of your claw gliding along hir hide. The lingering lines slowly vanish under your expert care. 'Aye thank ya me dragon, the goods never felt better,' captain hums in open admiration, 'but tis only fair we treat ya in kind, doubly so for our rescuer un da mother-O-one of our number,' shi adds motioning for you to lay next to hir with a bob of hir tail. Nodding at their proper show of respect, you motion for the others to make way with a commanding flick of your hips and wings. 'Yes me dragon,' the left shark purrs, almost reluctantly hoisting hirself off your flanks as you gently roll on your back beside the captain. 'Ah now ain't that a sight me hearts!' the captain trills, motioning to your hopefully bump-to-be with a wave of hir hand as shi nuzzles hir salachian body adjacent to your lower half.";
					say "     'Indeed captain, a true treasure of the neath,' the left shark mewls, draping hir arms protectively over your swollen feral belly. 'Ya know, me dragon, we'z got a nice little cove not far from here ye could stay at till the time be right, now taint that right me hearts?' the left shark swoons, as shi lovingly kisses hir way down the flush scales lining your expansive treasure trail. 'Aye matey, tis the only proper thing to do once you've knock up so fine a beasty as ye me dragon,' the Captain hums, as hir paws roam your toned flanks and powerful legs as she massages your sated form. 'We'z got plenty of food, more than enough space for ya, and you'd never want for company neither.' 'Mh, right ye are captain,' the left shark adds, happily licking hir chops as she nestles hir stuffed body along your still drooling sex. 'The crew would kill for a chance to have a go with ya me dragon, why I might be tempted to have a wee gam of me own with ya, should ye have me,' shi chuffs, giving hir blushing tummy an inviting pat.";
					WaitLineBreak;
					say "     'Ha-ha-ha a wee gam!? Pah! Matey, with pearls like these ye'd be lucky to walk away with quints!' the captain crows, hir paws drifting down along the decadently lubed contours of your toned digitigrade legs as shi lovingly cups your lustrous sack in the palms of hir clawed hands. 'Mh, can't say I'z wouldn't mind having a shiver or seven myself one day. Er, if you'd have me, me dragon,' shi purrs, paws sinking ever-so-slightly into the plump inviting flesh swaddling your spunk banks as shi tenderly jostles and caresses your virile excess. Amused by hir boldness, you watch as shi leans over and tucks hir angular snout against your verdant cum tanks as shi plants a languid line of kisses along the plush borders of your virility, sending a pleasant chill along your spine as hir tongue diligently worships your quivering scales. Rumbling happily at hir treatment, you teasingly coil you tail about hir waist, informing the over-eager herm to be careful what shi wishes for, draconic pregnancies can be quite the, you pause as your tail glides about hir the lust flushed borders of her cock cave, handful.";
					say "     'Aye,' shi simpers dreamily, nuzzling hir snout against your freshly-emptied sack, 'but it would be worthy it, more so if ye chose to stay with us me dragon. Why I'z happily hang up me hat and become your wifey if in ye choose to lend us yer brood.' '*Burp* uh captain ye don't wear a hat,' the right shark snickers, beside hir. 'Yarg, its a figure of speech ya sea sow,' the captain teases, flashing the cum-bloated siren a chuffed grin. 'Still, we'd make quite the addition to da crew me dragon, an the loss oh me own wee title be nothing compared to plunder we could have or da monsters I could make ye,' shi swoons in lewd desperate cadance, pulling hir into a kneeling position, as shi arches hir back and lasciviously paws at hir tone middle and plush e-cups with with her webbed mitts as lips curl into a devious cocksure grin.";
					WaitLineBreak;
					say "     Growling in a lewd draconic rumble and brimming with maternal pride at sight of the horny herms paying homage to your [bodydesc of player] cum-stuffed figure, you can't say their offer doesn't have a certain appeal to you. You muse watching them fawn over your tauric majesty, a part you admits that the thought of spending the rest of your days worshipped and pampered by an island full of buxom sharks is an appealing one. You could easily see yourself happily spending the rest of your days feasting on fine foods and finer herms. Watching your bodies swell with untold clutches of eggs as your flight spreads across the globe like a plague while untold riches poured in. Yet for all the potential such a pauper's dream could offer, it still pales in comparison to Galaxite's promise of apotheosis and ever more draconic power. Even if her words ring hollow, to deny not only yourself but your soon-to-be flight its full potential would be a folly like no other. You ruminate, gazing appreciatively at your future clutch as bask in the storm-kissed afterglow of your most recent conquest.";
					say "     No, for now you'll stay the course if not for yourself then for the beautiful wyrms slumbering within you. Who knows what further gifts await at the end of this leg of journey, you think to yourself as you recline back, tucking your arms behind your head as you decide to enjoy this momentary dalliance and hopeful herald of things to come. While the captain and the left shark, utterly oblivious to your idle musing, coo amongst themselves as they pamper your lush body alongside your powerful paws with their servile touch. Eventually though, the novelty begins to wear thin as your native wanderlust nips at the back of your mind worse then the presence ever could. Try as you might to push back against it, its call and the lure of power overcomes your desire to wallow in the moment. Sighing under your breath, you abruptly bid the sharks leave you while informing them that their penance is paid.";
					say "     For an instant, they hesitate as a shared look of terror passes between them as the ambient lightning plays along your reflective talons and gleaming fangs. Chuckling darkly at the sight and pleasant note of dragon fear coiling along their expression, you reiterate your command while assuring them that no harm will come to them, so long as they leave now, and do not bother your cohort. 'A-Aye, whatever ya say,' the captain stammers in an oddly downcast tenor as shi calls to hir crew to attention with a bellicose roar. 'Right me hearts! Ya heard the good dragon da books be balanced, un all accounts paid, now lets shove while we'z got the chance.' 'At once captain, un uh, thank ya again me dragon for freeing us.' the left murmurs in a nearly mournful cadence as shi and hir mates disentangle themselves from your reptilian majesty, and scurry over to the portside, then dive over the edge without looking back. Rumbling a neutral growl, you stretch out, pick yourself off deck then make your way aft more than ready to face whatever manner of dangers await in the lower decks.";
					CreatureSexAftermath "Player" receives "PussyFuck" from "Shark Herm";
					CreatureSexAftermath "Player" receives "OralCock" from "Shark Herm";
					CreatureSexAftermath "Shark Herm" receives "Stroking" from "Player";
					say "[PartThree]";
			else if Player is female: [skip this part]
				say "     Pushing back against your more, fanciful proclivities, the whorl of chaotic flickering across your scale slowly peters out as you decide against claiming the sharks in more primal fashion. Though such weak creatures are hardly worthy of baring your eggs, yet they could serve as a good outlet for your other... urges, you ruminate as the lingering predatory energies flicker away along your flanks and a low hungry rumble simmers along the edges of your [bodydesc of Player] stomach. You turn around, then head back to the middle deck, and your bound, you pause to lick the gleaming fangs lining your scalie maw, morsels. As you stride back along the storm lashed deck, you can hear the sharks idly boisterous chatter come to an abrupt halt as they catch sight of your tauric silhouette appearing out of the gale. 'Uh captain, I'z think they'z [']erd us,' the left shark stammers, as the piercing gaze of your glowing golden of your eyes washes over their curvaceous rain soaked form.";
				say "     'Oh sorry me dragon, we'z meant no offense to ya, t'was nutt'en more den some harmless sailor talk.' the captain fidgets against hir the ropes binding succulent body, while you prowl up to them. 'Is there anything me and me mates can do ta make it to ya?' Shi simpers, in an oddly hopeful tone as a cute rosy blush coils along the lips of hir gray cock slit. Delighting at the sight of the enticing furrows created by the ropes digging into hir plush E-cups and shapely ankles as shi squirms beneath your abyssal gaze, you rumble in a domineering tone, that perhaps shi can. The brief tussle with tenrecs and the puny little mink has left you feeling a tad... famished, you tease, eyeing up the gleaming crimson taper of hir dual prick roiling about the edge of hir dewy cock cave. And your tauric form could do with a little stress [']relief['] too, you add as kneel down and trace the flat of your talons along the angular contours of hir snout, provoking a cute preyish shiver from the captive captain.";
				WaitLineBreak;
				say "     'Aye, dat does like a fair penance me dragon, one me mates and I'z would gladly pay,' the shark coos, as the reflective edges of your claws glide along hir throat while the feverish lust patter of hir pulse plays along the scything contours of your bladed digits. Smirking at hir properly subservient attitude, you quickly flick your rending talons to your left and right, effortlessly severing the bonds of the other two sharks, while leaving the captain's intact. 'Uh I'z think you missed a spot me dragon,' the herm pants in an enthralling mix of desire and fear as rich scent of dragon fear pours from hir as shi gestures to the ropes wrapped about hir bust, hands, and ankles with a wave of hir tail. Tutting in a haughty trill, you tell you'll release hir from hir bondages soon enough, once you've had your [']fun['], you tease, as you tuck your muzzle to hir groin and playfully kiss hir plush dripping dick slit. Your warm breath mists the storm beaten with a lush plume of smokey gray wisps while the nubile beauty wriggles delectable beneath you then order the other two to service your flanks with a commanding come-hither gesture of your tail.";
				say "     While you languidly glide your bifurcate tongue along the balmy border of the captain's vent, reveling internally at the heady salty sapor of hir pre leaking from hir twin spires. While the inquisitive forks of your tongue entwine the exotic bend of hir throbbing crimson tools in their predatory coils. You diligently dandle hir dual tool to attention as beads of hermaphroditic delight trickling serpentine edges of your taste buds while hir vent bulges ever-so-slightly as you stork hir off. 'Ah b-by Salt me dragon,' the captain mewls, in a lustful submissive tenor as you ease your lips over hir swelling prehensile rods. Though a brief look of terror soon blossoms on hir face along with a delectable, frightened, quiver as your snout kisses hir toned sweltering middle. Any apperhanstion shi might of had swiftly melts away as you pamper the sordid hybrid's turgid dicks along the bestial ridges of your muzzle and loving hold of your tongue as you bod your head about the length of hir cocks.";
				WaitLineBreak;
				say "     Seemingly encouraged by the spectacle and spurred on by a harsh glance from your many luminous eyes, the other two herms quickly scramble to their paws and dash behind you, no doubt eager to be the one to claim your feminine passage. Though their race is close, the left shark is the first to reach your flanks as shi roughly shove the right herm to the deck then takes hir place place behind you. You watch out of the corner of your expansive field of view, as her paws drift to plush dick silt as shi gently strokes hir lush sex, slowly coaxing hir twin rods to attention. A part of you can't help but enjoy the spectacle of eldritch rain pouring down hir athletic body as the odd fork of umbral lightening reflects off of the sleek contours hir gray pebbly hide as hir selachian cock cave bulges ever-so-slight as hir exotic tapered spires slip between the gaps in hir webbed paws. Lips curling into a toothy vivacious grin, the left shark, eagerly cups hir dual tools in the crook of hir webbed hand and flashes you a questioning look as if asking your permission.";
				say "     Go on, you rumble magnanimously through dick stuffed lips at the lowly creatures show of proper respect to your draconic majesty, you signal your consent with cheeky shake of your tone flanks and commandingly wrap your tail about the well-muscled curves of hir hourglass wait as you pull hir close. While the captain swoon at the heady vibrations of your throat playing along hir twin rods as they glide along the tactile ridges of your maw and potent stroke of your forked tongue explore the bestial taper of hir cocks. The left shark nods, and leaning into the silky scaled embrace of your titanic tail, caressing hir midriff and inviting hills of hir vibrant E-cups. swooning. 'Aye me dragon,' as shi takes hold of the sleek, decadently lubed lamina linging your bestial flanks and lovingly caress your toned inner thighs. You liminal mind revels at hir touch of clawed paw inquisitive roams your sensitive bestial half as shi lines hirself up with your dripping [Cunt size desc of Player] box and thrusts."; [note to self merge herm intro]
				WaitLineBreak; [new stuff starts here]
				say "     Imperial satisfaction simmers along your [Cunt size desc of Player] passage as hir dexterous dual tools effortlessly fill your tauric depths, eliciting a proud sated rumble from your draconic lips as hir twin spires pound your elastic depth in a hearty meaty rhythm. You can feel the left shark's hands roaming your fecund flanks and [bodydesc of Player] thighs while she diligently bucks hir hips and chicken-egg-sized balls against you. Leaning ever-so-slightly into hir caress, your tauric mind revels at the sensation of hir claws and supple pads pampering your lower half like a proper bestial lover claiming their mate. Meanwhile, your aquatic cunt muscles cinch and roil about hir prehensile cocks, eagerly milking hir throbbing rods with each potent thrust. 'Stars, me dragon, what manner of beastie taught ya that trick!' the left shark hums, as hir dexterous breeding tendrils simmer about your elated depths. Swooning with abject delight as you bob your head along the captain's salty cocks, you can feel the left shark's dicks dance about your molten walls, though never in the same place twice.";
				say "     As hir virile masts twist and entwine within you into new erotic shapes with each powerful buck of hir waist, your breeder's box practically sings with cold-blooded bliss as the twin contours of hir cocks swarm about the folds of your thrumming joybuzzer. You can't resist pawing appreciatively at the tiny dual outlines cast by the left shark's squirming dicks in your regal well-lubed scales. Meanwhile, your bifurcated tongue glides along the bound captain's tools as you masterfully tease hir lush rods along the tactile ridges of your predatory muzzle, delighting internally as hir exotic flavor titillates your tastebuds with hir salty-sweet sapor while the captain looks on with a pleased grin on hir angular muzzle till shi catches sight of right shark staring at your well-fucked form with a dumbfounded look on hir face. At once the captain's expression hardens, hir eyes narrowing to harsh pinpricks as shi bellows, 'Oi ya ninny, stop sitting there like a greenhorn what's got its first pint of grog [']N get off yer arse and attend to the good dragon!' At the captain's command, the right shark shakes hir head as if to clear it then hollers in reply, 'Aye me heart!' then scampers to hir feet then dashes beneath you.";
				WaitLineBreak;
				say "     You feel the warm wisp of hir breath playing across your draconic petals as shi positions hir snout next to your dripping storm-kissed snatch, and begins tenderly lapping at your alabaster scales with long drawn out passes of hir exotic tongue, remarking aloud, 'Mh, delicious,' as hir oral muscle slips past your splayed nether lips, sending sparks of unearthly bliss through your tauric form as the trio of pleasure tools probe your draconic muff. You nearly begin cooing at the profound tenderness of hir touch and the rich thermocline of sensation roiling about you as the bracing chill of the squall and verdant heat of shark plays across your senses. Your sex bulges delectably with the beatific weight of your nautical playthings loving ministrations as you growl in a pleased cadence, and affectionately stroke your tail about the left shark's waist and legs, encouragingly caressing hir toned body in your potent coils while the captain pants at the sight of hir mates claiming your fecund body and wondrous touch of your ribbed muzzle as your forked tongue passionately caresses hir well-loved tools.";
				say "     Chuckling internally, you cast your abyssal gaze upward, drinking in the adorable sight of hir bound body as the taut rope casts the cutest furrows in the blushing gray-pebbled hide coddling hir vibrant e-cups. While oily black rivulet of eldritch rain and umbral lightning reflects off the athletic curves of hir shapely body, you cheekily glide your paws down along hir toned hips and shapely swimmer's thighs as shi shivers delectably at the gentle catch of your talon playing across hir aquatic skin. Enthralled by the spectacle and feeling just a touch generous towards your latest morsel, you work your paws further south along the subtle white splotch decorating hir inner thighs as you cup your silky pad about hir entire sack. Admiring the virile heft of hir package, you lightly jostle hir supple pearls in your mitts, earning you a fresh needy whimper from the horny herm as shi shamelessly squirms at your touch, while the coiling scent of hir feminine juices tickles your senses.";
				WaitLineBreak;
				say "     You watch out of the corner of your expansive vision, as an inviting trickle of glittering dew drips down the sides of hir legs, hir aquatic hide blushing a cute rosy red. 'Ah-ah, stars me dragon, ye really know how to treat a [']girl['],' shi swoons, lewdly rubbing hir legs together as if to quench the lustful heat welling in hir core. Smirking at hir antics, you languidly dip your free hand beneath hir adorable sack and trace your silky digits about hir stiffening joybuzzer, slathering hir respective passage in a generous sheen of your natural lubrication as shi strains all hard against hir bonds. Reveling at the sight of hir struggle, you slowly dip a pair of fingers betwixt hir pleasantly plush nether lips. At once, vivacious heat and the tenderest of pressure engulfs your digits as hir aquatic walls hug your inquisitive mitts as you gently pump your finger along hir sensuous folds while you affectionately stoke hir cute button with your thumb and forefinger and pamper hir weighty sack in your palms like a pair of priceless gems.";
				say "     With each practiced motion, you slip one then another of your scalie digits into hir molten box as you glide your fingers above hir masculine g-spot in a potent squall of sensual sensation, echoing the doting treatment of your lustful passage. As the other sharks gleefully probe your draconic depths with profound alacrity, your clit and elastic walls sing at their unearthly ministrations as the left shark's cocks cinch delectably about your reptilian hood. You can feel every intoxicating throb of hir twin tools coiling about your sizeable button as shi pounds your tauric flanks in a perpetually shifting sonnet. The right shark greedily laps at your exotic dew and well-stuff pussy, though soon, you can hear the unsubtle squelching hum of the herm playing with hir own muff while the pleasant echoes of hir nursing your dripping sex bleed into the wondrous gale lashing the gloom-touched sea. Enthused by hir zeal and the prodigious cascade of bliss simmering though your tauric being, you lewdly rock your [bodydesc of player] paws in tandem with the left sharks thrust and slip your tail between hir legs and benevolently glide your flexible fins along hir lush rain-kissed cunt.";
				WaitLineBreak;
				say "     Mewling in a doting wordless cadence at your tail's caress, the left shark shifts hir stance, eagerly pressing a respectable amount of hir moderate weight upon your tail as hir puddling pussy effortlessly glides along your sleek azure scales. Hir body heat floods your girthy limb, sending heady sparks of static delight along your spine while you artfully angle your the finned appendage in an instinctive [']U['] bend, and dandle your dexterous tail about hir sizable passage, slathering your fins in warm sheen of hir juices, then spear hir welcoming sex in single toe-clenching thrust. You pour ";
				if "Touched by Madness" is listed in feats of Player:
					say "centimeter upon centimeter ";
				else:
					say "inch upon inch ";
				say "of your ponderous appendage into hir respective cunt, eliciting a decadent thrum from hir mirrored prehensile pricks as hir surprisingly elastic passage bulges to accommodate you. 'Yer me dragon, ye be huge!' shi swoons, as you twist and flex your fins inside hir, lavish hir aquatic muff in an oceanic squall of delights.";
				say "     Effortlessly falling into a joyous rhythm with your selachian toys, your tauric sex is awash with abyssal bliss as your [Cunt size desc of Player] cunt spasms with an all-too-familiar tightness as your far-traveled sex molds itself about the left shark's heavenly tools and right shark's clever tongue. Chuffing, you'd almost swear you can taste hir heady salty juices seeping from hir exotic anatomy mix with the captain's as the rich sweet-and-salty sapor of hir turgid cocks titilates the bestial ridges of your predatory palate. Unwilling to finish first, you coyly press your muzzle to hir toned middle, revelling at the sight of streamy wisps of your breath playing across hir bountiful chest while redoubling the tender caress of hir moist muff and futa g-spots. 'Ah-ah, so-so good,' the captain huffs, hir eyes rolling upward and tongue lolling from the side of hir snout. Hir ripe cum veins twitch about the forked coiled tongue and hir balmy aquatic cunt hungrily milks your perpetually lubed digits as shi finishes with a final animalistic roar.";
				WaitLineBreak;
				say "     Hir twin tools erupt in a torrent of toasty delight, filling your cheeks to the brim, all of which you hungrily swallow with loud playful gulps, while a gush of sweet girly honey trickles across your scalie wrist. Purring happily at hir offering, your stomach swells with the heavenly sloshing weight of hir virile tithe. Hir cry is swiftly joined by hir sultry mates as the eclectic caress of your potent walls and dutiful kiss of right shark's tongue pushes the left shark over the edge. With one last heavy thrust, shi hilts hirself to the vent with a bawdy rumble as shi cums, loosing a deluge of futa seed upon your voracious depths alongside lewd trickle of dew from hir sweltering honeypot as hir cunt ripples delectably about your tail. Shi then collapses atop you with a blissful sigh as your moiled muff sparks with unvarnished elysium and formless motes of many colors and none simmer across your expansive vision, as your properly-stuffed cunt gushes tender beads of fem and futa cum down your silken scalie legs as you finish.";
				if Player is impreg_able:
					say "     Rumbling happily, you smack your lips and gingerly disentangle yourself from the captain then rise to your full majestic height, lovingly sinking your paws into the soft toned dome of your jizz-jammed tum, while the captain quips, 'Ah now taint that a sight me hearts!' as shi gazes at the taut, blushing, alabaster scales decorating your middle, wobbling but a hair's breadth from hir snoot. 'Indeed captain,' the left shark hums dreamily, stroking the lightly sloshing swell of your lower half. 'I'z just hope this here shiver sticks!' Nodding in agreement as the beautiful rush of tainted seed wallows within your respective core, you simper a similar sentiment, as you almost drunkenly motion for them to make way so that you can lay down and allow your hopefully future eggs a moment to settle. 'Right me lovelies, you heard the good dragon. Make room, now!' the captain barks. 'Aye me heart!' the other two bellow in unison as the left shark languidly extricates hirself from you, and your tail while the right hurriedly scurries away.";
					say "     Once they're clear, you sever the captain's bonds with flick of your talon and slowly ease yourself and your potential clutch-to-be onto the deck, then roll on your back to better take in the sight of your well-seed splendor. Your brood-focused mind rollicks with maternal glee at the spectacle of the ripe twin domes nestled protectively between your powerful limbs and supple scales. Though of lesser stock, a part of you is looking forward to the coming days as your body swells once more with draconic life and the bountiful changes your preferred state brings. You think to yourself, lazily gliding your paws over the rich curves of your fecund body, you can almost feel your [breast size desc of player] tits grow hot to the touch as your perpetually productive nips prepare for your next potential clutch. Soon, beads of the purest white cream leak from your draconic chest and stream down your lush breasts and tough lamina as your maternal mounds ripen with renewed purpose and glorious heft as decadent rivers of nutritious milk trickle along your curves.";
					WaitLineBreak;
					say "     Enthralled by the sight and heady scent of your potent cream, you nearly consider sampling some yourself, and only the pleased hum from the captain keeps you from going through with this hedonistic notion. 'Oh thank ye me dragon, the goods twas getting a might chafed,' the captain hums, hir webbed paws casually roaming the lush hills of hir remarkable (for a biped) chest as shi massages the light indentation left in hir hide. Buoyed by the sight of hir plush tit flesh spilling between hir webbing and the vibrant sheen of oily rain pouring down hir svelte body, you graciously offer to [']help['] hir with that as you gesture to your replete rack with wave of your tendril hair. 'Mh, that do be quite the tempting offer me dragon, and we'z wouldn't want such a bounty to go ta waste,' the captain snickers as shi drapes hir athletic body beside you and cheekily traces hir claws along the subtle borders of your scales. No, you tease in a lust-numbed trill, tucking your paw behind hir head and lovingly guiding hir snout to your neediest nip. The captain eagerly obliges you with an needy bob of hir head, as you tenderly tuck hir muzzle to your sloshing chest, delighting at the warm caress of hir breath playing across your scales as shi lovingly laps at the errant rivers of cream decorating your chest.";
					say "     You mirthfully watch as hir tongue lavishes your lamina with long affectionate circuits as the captain's paws dutifully explore the growing hills of your plush chest as shi feeds. Hir left paw roves the verdant curves of your cum-stuffed middle, mewling, 'Yar, I'z envy ye new blood, to be raised on so fine a succor and by so beastly a mother! I know ye lot will make some right proper scourges [']O the deep!' as shi gently presses hir angular muzzle into the welcoming hills of your pillowy breasts and hearty suckles from your abyssal bounty, feelings of relief and draconic purpose flood your mind as shi nurses with surprising alacrity. Rumbling happily at hir paise and show of proper respect for your spawn, you stroke the back of hir head with your non-dominant hand while your dominant paw massages the lingering impressions left in hir hide, delighting at the contrast of hir pebbled flesh playing along your sleek scales as you work over hir toned lightly-muscled body in a languid spiral pattern.";
					WaitLineBreak;
					say "     You feel the effect of your potent cream and draconic nanites slowly restoring hir as the deep furrow gradually vanishes beneath your imperial treatment. Good girl, drink up now, you purr in a matronly tone, motioning to the others to attend your flush form and lightly-dripping snatch with a commanding wave of your tail. 'As you command me good dragon,' the right shark simpers with a pleasant trill, as shi tucks hirself behind the vast swell of your heavy tums. Your breath almost catches at the toe-curling caress of hir oral muscle as shi thrallishly kisses the dewy folds of your raw lightly-throbbing [cunt size desc of player] sex. Hir paws fondle the chiseled contours of your hindleg and supple paws in a soothing rhythm. Your sated form practically melts as shi works over your toned muscles and services your draconic majesty. Enthused by the sight and the effects of hir handy work, the left shark seats hirself between the captain and the right shark cooing, 'Of course me lovely a treasure such as ye deserves a mighty touch [']O worship un care,' as shi touches hir snout to your cum-stuffed feral middle and plants a gentle series of kisses upon your blushing scales.";
					say "     'Ye know,' shi hums proudly through a devilish grin, as shi nuzzles hir cheeks against your toasty tummy, 'me mates un I gots a nice little island not too far from here ye could rest at till this [']ere storm dies down. I'z promise we take right proper care of ya, and,' shi pauses to drapes hir arms protectively over your sloshing middle, 'me gam. Ye'd never want fer food, comfort, plunder, nor company me dragon for our crew would love spoiling ya. An if by some miracle the little un's don't stick, me and the other swabbies would be more than willing to keep trying. Why just think of the mischief we could make with your beastly spawn at our back, the world ours for the taking!' shi crows, as hir paws sink ever-so-slightly into the folds of your cumflated middle. Nodding dreamily while you affectionately pet the captain's head, you can't say that hir offer doesn't have a certain appeal to you, you muse as the captain suckles and fondles your swollen chest and anthro tummy.";
					WaitLineBreak;
					say "     The right shark hungrily lavishes your [cunt size desc of player] cunt and paws in a lewd display of bestial gratitude. The chance to have your own sea born lair and harem of virile herms to wait on your every need is a tempting offer. You could easily see yourself nesting atop a pile of treasure like a primeval goddess surrounded by her hoards of worshipers and slaves clamoring for the opportunity to breed you or sample your divine cream. All the while spreading your unstoppable flight far and wide as they plundered the oceans of its riches in your name. Yet, you ruminate, idly flexing your nascent wings, for all the appeal this fantasy has, it pales to Galaxite's offer especially when she asks so very little of you in return. You can only imagine what height you could achieve once you've reached the apex of your body's draconic power. The thought of depriving not only yourself, but your future brood of its full potential for few mere sharks leaves more than a sour sapor in your mouth.";
					say "     Still, not wanting to spoil the moment, you keep such musing to yourself, then recline back into the cool deck, tucking an arm behind your head, and instead bask in what you hope is but a taste of what is to come. As the sharks pamper your soon-to-be clutch-laden form with the all the due worship a dragoness of your stature deserves, you ruminate, watching the servile creature massage your powerful paws and toasty tums while playfully petting the captain as shi feeds. The storm-lashed air resounds with hir doting pleased suckles as shi gradually relieves your chest of its opulent cream. Eventually, hir slothing tummy bulges against yours and your seemingly boundless reserves are emptied for the moment at least. Sighing contentedly, shi soon falls asleep in your grasp. In no mood to wake hir though, you allow the lesser creature the rare honor of slumbering at your side as you motion for hir peers to join. Nodding, they quietly tuck themselves beside hir while you cover them with your wings like an azure blanket.";
					WaitLineBreak;
					say "     Though the aquatic creatures have little need of shelter, the blissful coos that issue from the ferals['] lips tells you that they more than appreciate the gesture as they lazily pet your glossy scaly wings. Murmuring hushed vague thanks to you, the trio cuddle peacefully in protective embrace while the captain digests her meal and the other lovely herms stroke your scalie majesty. Soon enough though, the novelty of the presence begins to wear thin along with the lingering bubbly effects of your post-coital afterglow. Perhap sensing this and the rising tension building in ripcord muscles as your scything claws flicker across their weak scaleless hide, the sharks begin sharing worried glances with one another. Feeling their penance is paid in full, and in no mood to sour your parting, you, perhaps a bit too kindly bid them leave so that you may finish your business here without fear of any harm coming to your potential clutch's kith and kin.";
					say "     '*Yawn*, if in ya say so me dragon may all the gods of the neath preserve ye from the horrors [']O dis [']ere hulk,' the captain simpers, motioning for hir crew to fall in as shi head over the railings. 'Just a moment me hearts,' the left shark croaks almost on the verge of tears, as shi plants one last set of kisses on your middles. 'Gods [']O da neath, I-I don't ask much of ye but, please protect me lil one's un the good lassy [']ere,' shi says in a worshipful tone before darting off to hir crew's side. Nodding to hir, you place your paws protectively on the warm patches left by hir farewell pecks then bid them leave. 'Aye me dragon!' they holler as one and dive off the edge in unison. With them gone, you take one last moment to collect yourself along with any gear you may have brought then head aft and strangely feeling invigorated by your quick romp with the nautical herms.";
					PlayerHealed 50;
					CreatureSexAftermath "Player" receives "PussyFuck" from "Shark Herm";
					CreatureSexAftermath "Player" receives "Stroking" from "Shark Herm";
					CreatureSexAftermath "Shark Herm" receives "Stroking" from "Player";
					say "[PartThree]";
				else if Player is impreg_now:
					say "     Gnarring in blissful satiation at the fresh sensation of hir toasty load warming your well-bred core and delectable salty sapor titillating your far-traveled palate, you leisurely disentangle yourself from the captain with a hearty smack of your muzzle. Licking your lips, you languidly rise to your full imperial height, jovially cupping your paws about the soft layer of motherly adipose and amniotic fluid swaddling your egg-laden middles. Your brood-focused mind can't help but bask in the pleasant rush of maternal pride in claiming such a fine meal for your brood and the enticing sension of fecund excess resting against your pads as you briefly pamper the steadily growing outlines of ";
					if "Weak Psyche" is listed in feats of Player:
						say "our eggs. ";
					else:
						say "your eggs. ";
					say "You mentally encourage them to drink deeply from this virile stormborn-tithe so that they can grow into large powerful wyrms one day. 'Ah now taint that a true treasure [']O da neath me lovelies!' the captain swoons in admiration of your gravid grace, as shi stares, spellbound at your ripening body. 'Aye captain, there be few sweeter sights in all the neath,' the left shark hums, as shi cheekily strokes the heavenly curves of your flush lower body with hir paws.";
					say "     'Though tis a true shame some lucky soul already staked a claim on ye me dragon, I'z of loved to give ye a real shiver in your timbers!' the left shark crows as shi steadily softens inside you. Enjoying the attention paid to your proud clutch-laden form, you lean into hir gaze and playfully arch your back to better highlight your preferred condition. You peer down at the cute herm and wondrous sight of your [breast size desc of Player] tits resting comfortably on the fertile dome of your plush tum with a lewd knowing look. You teasingly rub your paws along the perpetually lubed curves of your [bodydesc of Player] body, reveling at the feel of draconic power and purpose filling your being as you sink into the welcoming mass of your maternal mounds and offer the captain the supreme honor of touching your brood. 'Mh that *huff* do be a right tempting offer me dragon, but, *huff* me hands are a might indisposed at the moment,' the captain pants, watching your palms gliding along your scaly assets and the oily rain pouring down your body in a vibrant glittering sheen.";
					WaitLineBreak;
					say "     Snickering at the effect your lush condition has on the naughty hybrid and sensuous patter of the storm dancing along your bejeweled being, you graciously reach up with your forepaws, and gently hook the rope binding hir prodigious chest in the crook of your reflective claws. Pulling them just a hair tighter, your dominant mind rollicks at the aphonic creak of the waterlogged fiber alongside the encourageable whimper of the buxom siren as hir heavy sweater puppies are drawn into a perky faux-heart shape by the constricting cord before severing them with a commanding flex of your talons. You then swiftly swipe your scything claws down and around along the remaining ropes with a fanciful motion of your forelegs, evoking a relieved coo from the captain as hir bonds fall limply from hir extremities. 'Thank ye me dragon, I feared the goods might have gotten damaged if I'z was bound any longer.' Shi gestures to the deep furrows cast in hir gray-pebbled hide by the too-tight rope.";
					say "     Nodding and savoring the pleasant bounce of the unbound herm's assets, you lovingly press your plush tum to hir angular snout and repeat your offer with a proud lustful trill. 'Oh course me dragon,' the captain hums, as shi leans forward and plants a reserved worshipful kiss on the taut alabaster equator of your midriff. Shuddering happily from the cool kiss of hir lips caressing your sensitive scales, you place your hand on the top of hir head, encouragingly tracing the flat of your claws down the side of hir cheek as you command hir to show your body and your brood the deference that they deserve. 'Aya me heart, a benevolent beasty such a ye deserves no less than me crews full attention,' shi simpers, motioning to the deck beside you with an inviting wave of hir tail. Rumbling at hir proper show of enthusiasm, you lightly tap your tail on the left and right shark's shoulder and tell them to make room for you. 'Aw, un I was getting comfortable back here,' the left shark teases, giving your toned flanks an affectionate pat before, almost mournfully, unhilting hirself from you as hir and the right shark hastily make way.";
					WaitLineBreak;
					say "     Loosing a pleased draconic trill, you make a show of languidly draping your heavily swollen body across the bracingly chilled deck as you roll on your back to drink in the sight of your fecund splendor on full display. Though no stranger to your proper state, your fracturing psyche nevertheless revels at the beautiful golden glow of your eyes reflecting off the taut alabaster scales decorating your reptilian core. Alongside the adorable sloshing sound accompanying your every motions, your decadent maternal mounds wobble against your toned, predatory limbs['] embrace as the heady echoes of milk and cum filling your voracious body serenades your ears. Already, you can feel the well-used glands of your [breast size desc of Player] chest ripen with rich fatty cream as you slip your eager paw about your breasts, wallowing at their marvelous heft as they seem to swell before your many eyes as beads of scintillating milk leak from your puffy nips.";
					say "     Wistfully observing the heavenly drops gliding along your [one of]azure[or]sapphire[or]cobalt[or]royal-navy-blue[or]aquamarine[at random] scales, your senses are greeted by a cute needy growl from the sharks['] stomachs as they eye up your chest. Still warmed by your lovely climax and the intoxicating rush of tainted maternal hormones coursing through you, your motherly side feels a tad sympathetic to the hungry creatures as they desperately gaze at your fertile majesty. You generously wave over the captain and the virile left shark to your side with a come-hither flex of your talons and invite them to sample your fare while they pay homage to your brood then direct the right shark to attend to your still dripping cunt. Cooing contentedly, the captain and the left shark swiftly nuzzle themselves beside you and a part of you can't help but delight at the feeling of their gray-pebble hide rifling against your glass-smooth body, or how neatly their svelte curvacious forms fit next to your powerful brood-laden body. 'Ah thank ye me dragon un your wee sea devils for sharing this gift with us,' the captain purrs, rubbing hir cheeks about your enhanced chest while hir paws explore the taut surface of your scalie middle.";
					WaitlineBreak;
					say "     'Yar, right ye be captain, the good dragon be spoiling us with so fine a fare!' the left shark hums, tucking hir snout to your bosom. You feel hir mitts dance along your forepaws as shi affectionately massages your profoundly productive body. 'Indeed me heart,' the captain swoons, kissing hir muzzle to your chest as shi tenderly laps at the errant streams of milk leaking down the wondrous equator of your breast. Almost shuddering at hir touch, you rest your paws behind hir and hir mate's heads, then encourage them to drink, lest your bounty go to waste. 'Stars me dragon we'z can't have that!' the left shark chuckles, pressing hir angular face to your breast as hir and the captain's lips engulf your stiffening nips. Perhaps sensing hungry mouths, your maternal body quickly responds to their kiss as a light pleasant trickle of cream issues from your flush ducts as they suckle. 'Cribbens, what lucky little uns ye got me dragon to be raised on so fine a succor and so beastly a mother!' the captain crows in abject elysium as shi feeds while hir paws roam your glossy middle, lavishing the adorable faint outlines of your eggs with the passionate strokes of hir padded fingers.";
					say "     Hir mitts are quickly joined by the left shark's as hir hands glide along the opulent curves of your draconic breasts, as shi tenderly massages the productive glands like an eager kitten. Cooing in a dominant matronly cadence, you lovingly whisper encouragement to the hungry herms while you trace your talons along their athletic hourglass waist, tight muscular asses, and chiseled cores; indulging your tactile senses in the exotic contrast of your impossibly smooth scales playing along their gray-pebble hide as you trace your talons along the hardened ridges and valley of hale bodies. Almost purring at your caress, the inquisitive herms playfully wrap their robust swimmers legs about you as they press their bodies closer to yours. While the right shark dutifully nestles hirself behind you, you feel more then see hir, the titillating wisps of hir breath dancing along your alabaster petals as shi languidly tucks hir snout between your hindlegs.";
					WaitLinebreak;
					say "     Humming contently to hirself, shi lewdly huffs your needy scent, while hir hand lightly grasps your dense, toned limbs for balance, as shi playfully slurps the dewy borders of your cum-slicked [cunt size desc of player] sex with long drawn out passes of hir exotic aquatic tongue. Still raw and oh-so-wonderfully tender, every exuberant lap of hir oral muscle evokes a sympathetic flex from your paws as hir tongue traces the [bodydesc of player] contours of your flanks. Likely enthused by your response, you can hear the right shark chuckle at the cute little spasm of your well-used sex and needy clenches of your bladed toes as the left shark glides a hand along your inner thigh, affectionately massaging the hard working muscle lining your reptilian limbs. Wallowing in hir touch alongside the maternal high of the other two sharks suckling peacefully from your breast, you coyly wrap your tail about hir waist and trim core, encouraging hir worshipful touch with pleasant strokes of your dextrous appendage.";
					say "     Chuffing in a wordless trill, you feel hir paws drift up your legs as shi massages your silky paw pads and tauric ankles with loving attention. Hir touch is both confident and caring as shi works over your joints and potent muscles with a practiced grace. Good little paw slut, you purr in a regal comforting cadence as any knots or tension melts away under hir care to be replaced with a sense of profound lightness and motherly satisfaction. Your draconic body revels at the worshipful attention paid to it and your brood as your lush petals, clutch-laden core, and beefy paws echo with cold-blooded satisfaction. Potentially picking up on the warm effervescent emotions welling within you, the right sharks slows hir pace ever-so-slightly, remarking between laps, 'Ye know me dragon me, me mates un I have a nice little island cove not too far from here. If ye wanted, ya could shelter with us till this [']ere storm blows over. Great and terrible as you most certainly be, a beautiful mother like ye deserves a spot of comfort,' as shi leans forwards and kisses the flush curve of your bestial belly.";
					WaitLineBreak;
					say "     'I promise,' shi purrs as hir kisses drift south along your scalie treasure trail, 'ye won't want for food, luxury, nor companionship. If ye wished you could stay till your little un's hatch or longer still, for a mighty sea beasty like you would be right popular with the crew,' shi adds as hir affectionate pecks trickle down your tauric flanks. 'Why just think about it, with your sea devils at our backs, the crew could plunder the neath with ease, taint that right captain?' 'Aye swabbie,' the captain hums as shi looses hir gentle hold on your nip, 'a beasty dragoness such as dis would be more than welcome amongst us. Why, I'z be tempted to hang up me own hat for the chance to wait on ya and your wee monsters here, if ye'd have me,' shi adds, giving your tummy a jovial grope. 'Ha, captain ye don't wear a hat!' the left shark chuckles as shi playfully jabs the captain shoulder with hir tail. 'Yar, it's a figure [']O speech ya chowderhead!' the captain guffaws goodnaturedly.";
					say "     As the sharks snicker amongst themselves, you can't say their offer doesn't have a certain appeal to it, the thought of having your island to nest in and grow your flight is an enticing one. You muse, glancing down at the doting form of the minor gam fawning over your gravid majesty. You could easily see yourself spending the rest of your days brooding atop a pile of treasure, your every want and need catered to by an island full of worshipful buxom herms eager to please and fight for the right to fill you full of countless eggs. All the while, spreading your flight far and wide like an unending tide as they plunder the seas in your name. Yet, as you flex your wings besides you, you realize for all the appeal such an idle fantasy has, it pales in comparison to Galaxite's offer. To deny not only yourself but, you pause to paw at your growing lower half, your brood the chance to achieve their full potential is foolish one, especially when her terms are so fair.";
					WaitLineBreak;
					say "     Still, you have no desire to spoil the mood and merely rumble in a neutral, unreadable, reptilian cadence as you lay back, lazily tucking your non-dominant arm behind your head and motion for them to continue lavishing your body with a wave of your free hand. Nodding and likely hoping to earn your favor, the herms resume their task as they feed and pamper your queenly physique. They take special care to shower you with vague praise while they suckle or massage your burgeoning curves under your watchful molten golden gaze and dominant caress of your many limbs as you pet their sleek cores. Though a part of you can't help notice the cute warm sloshing bulges in the captain and left shark's middle as their stomach swells with potentially gallons of fresh cream. Oddly enthralled by their adorable bumps pressing against yours, you cheekily give them both a tender pat, enjoying the faint drum-like thrum of your digits playing across their saultry forms.";
					say "     Eventually though, the novelty of their care begins to wear thin, the feeling of all-too-familiar wanderlust nips at the back of your mind, along with the unsubtle urging of the presence urging you onward. As muscles tense and claws fidget, the sharks gradually begin to pick up on this as worried looks pass between as their eye's drift along the scything edges of your talon and wicked barbs of your fangs. Bearing your lessers no malice and wanting to put the lowly creatures at ease, you intone in an imperial cadence that their penance is paid in full, they are free to depart, and promise that no harm shall befall them so long as they leave your cohort in peace. Nodding, they, almost mournfully, disentangle themselves from you as the captain hollers, 'Right ya heard the good dragon, anchors up it's time to shove off,' as shi slowly pulls hirself to hir feet and motions to the rails with what some might consider a commanding flick of hir left arm were the gesture not accompanied by the gentle rosy wobble of hir cream laden tum or prominent milky mustache emblazoned on hir lips.";
					WaitLineBreak;
					say "     Trying not to snicker too much at the sight of the other two quickly falling in line behind hir tittering, 'At once captain, un uh, thank ya again me dragon for freeing us,' as hir and hir mate scurry over to the portside, then dive over the edge along with the captain without looking back. Rumbling a neutral growl, you stretch out, briefly flexing your tauric limbs and flaring your claws like a cat, then pick yourself off deck then make your way aft more than ready to face what manner of dangers await in the lower decks.";
					CreatureSexAftermath "Player" receives "PussyFuck" from "Shark Herm";
					CreatureSexAftermath "Player" receives "Stroking" from "Shark Herm";
					CreatureSexAftermath "Shark Herm" receives "Stroking" from "Player";
					say "[PartThree]";
		-- "Tail Fuck.":
			if Player is female and "UB Pred" is not listed in feats of Player and "Vore Predator" is not listed in feats of Player:
				say "     Yielding to your maiesiophiliac urges and your draconic body's desire to claim the nautical herms for yourself, the raw crackling energy roiling about your [bodydesc of Player] flanks begin to spread down the length of your tail as chromatophores blare a chaotic ballet of many colors and none. Intrigued, you glance back and watch as your beautiful fins decorating the ends of your tail flatten and recede into itself. As the flesh steadily reforms into a classical spade, you can feel an unusual tickling sensation building on the underside of its apex and the vertebrae lining your girthy limb as muscles both new and familiar wink into being. Experimentally flipping your tail over, you can't help but marvel at the sight of your scales parting along some invisible seam, revealing a supple pink vent nestled neatly at the end of your exotic limb. You affectionately run your hand about the virgin slit's sensuous edges, as the wave of change begins to spread further south as your tail widens almost imperceptibly as powerful muscles and alien cartilage starts to coalesce within.";
				say "     No stranger to this sudden occurrence, your fracturing mind registers only cold-blooded calm laced with motes of mammalian curiosity, as you reach out and stroke your clawed fingers along its majestic length. Your digits are greeted by an otherworldly assortment of concentric sinuous rings and nascent nerves lining your tail, as the ethereal flood of morphic energies slowly washes over your feral half in a warm tropical balm that quickly gives way to potent, deep, animalistic heat as your feminine flower tingles with reproductive delight as the true depth of your last mutation dawns upon you. An ovipositor, you whisper under your breath in barely muted awe at the sudden but not wholly unbidden rush of motherly hormones sparking through you as you make the mental connection between the tube-like structure decorating your tail with the rare organ some of the more exotic infected possess. Swooning at the lewd utility of having hosting such an exotic mutation, you briefly brush your claws about the silky scales decorating your tail, before letting go, all the while envisioning how much further and faster your brood will spread with these wondrous [']tools['] at their disposal.";
				if "Weak psyche" is listed in feats of Player:
					say "     'Ha-ha-ah, indeed, oh ambitious host,' the presence crows in a lurid doting choir as the tendrils of their ethereal being lovingly caress your consciousness like a caring master pampering a favored pet. 'We have dwelt upon countless spheres through the endless cycles of the great game, and few of our incarnations have achieved such splendor! Truly our sister and her avatar have chosen well this round,' the presence preens as the storm itself seems to coil about your muzzle like an invisible hand gently stroking your cheeks. 'Now go, beloved host, fill this world with [italic type]our[roman type] eggs, spread our flight across Kyr, Kai, and Kol so that they may make ready for her coming, and you shall earn your place amongst us,' the umbral voice purrs as the winds gently pull you aftward."; [sky sea and earth]
				else:
					say "     You muse, imagining yourself surrounded by hoards of obedient thralls and worshipful lovers, their bellies bulging with your eggs while your spawn rampage unchecked through the city. You can almost hear the lustful purrs of the ferals begging to be claimed by your flight along with the beatific chant of your name as they spill across the globe in a vast tide of draconic perfection. Rumbling happily at the thought, who knows what future gifts this venture will bring, or what heights your flight can achieve once you've obtained the zenith of your form's potential! Still, such pleasant thoughts will have to wait, as the lewd energies and potent heat building inside you demand release. You ruminate, turning around then skulking back towards the mid deck and, you pause to languidly flex your altered tail, your delectable prizes.";
				now intelligence of Galaxite is 1;
			else if Player is female and "UB Pred" is listed in feats of Player and "Vore Predator" is listed in feats of Player:
				say "     Surrendering to your draconic breeding instincts, the all-consuming squall of ravenous energy gnawing at your flank begins to filter along the length of your tail. Your eyes are treated to the potent sparks of transformative bliss simmering along your scales, as your chromatophores flare a divine rhythm of many colors and none as the tempest of morphic ripple through your tail. Curious and more than a little aroused by the wondrous sensation of unbridled change arcing across your expansive limb, you look back and observe in impossible awe as your fins bend and twist together like [one of]an azure[or]a sapphire[or]a cobalt[or]a royal-navy-blue[or]an aquamarine[at random] flower bulb. While your sail recedes ever-so-slightly, the scaly bulb begins to flatten out and a seam forms along its edges amid a rush of enticing sensations. Feeling both tactile and gustation senses whorl about the borders of your awareness as the flesh parts revealing a lush pink O-ring muscle nestled within a veiny maw. Tilting the unusual appendage for a better look, you watch with a blend of reptilian serenity and mammalian interest as a set of several tendrils emerge from the yearning void, though they initially feel cold, lifeless, and deadened to you.";
				say "     Sensation along with raw sensory information quickly flutters about these nascent appendages as the taste of saltwater layered with the bracing chill of the storm trickles through the nanite-touched fragmenting halls of your awareness as you try gingerly flexing them. At first, the motions feels profoundly dissociative, as the lingering shards of your human mind rebel at this newest evolution of draconic splendor, yet you mentally push back against such sniveling simian sentiments as you levy your draconic will upon the new limbs, compelling them to obey. In moments, your control begins to grow as the tendrils start to flex and writhe in tune with your commands even if a degree of oddness accompanies every motion. You wrap the altered limb about your left arm and trace your talon along the opalescent scales lining your tail, detecting an odd void forming along its lengths as alien muscles flanked by concentric rings of vaguely insectoid cartilage wink into being.";
				WaitLineBreak;
				say "     Intrigued, you languidly brush your palm down the breadth of this fresh addition as it slowly extends to your toned rear as your well-traveled mind at last places a name to the aberrant channel. An ovipositor, you whisper under your breath while a brief but delightful wave of bestial heat washes over you at the changes sweeping over you as your feminine sex adapts to these blissful alterations. Smirking, you playfully paw at your middle at the thought of not only yourself bearing such a fitting addition but your flight too! You swoon, internally picturing all the wondrous possibilities that await you as you spread your brood to every deserving breeder, and the profound predatory pleasure of consuming or unbirthing your lessers. After all, what higher purpose could such lowly beings aspire to then to become a part of your growing majesty, or to be remade in your imperial image.";
				if "Weak psyche" is listed in feats of Player:
					say "     You ruminate as the presence chuffs proudly in a dissonant choir from the back of your mind, 'Ah beloved host, you spoil us!' as the wind shifts and coils almost tenderly about muzzle like a caring master stroking a beloved pet.";
					say "     Almost chirping happily, you lean into the storm's touch as the otherworldly affection of the presence pours into your being, filling your senses with an ambrosial bliss as the presence roils within you. 'Our sister and her avatar have outdone themselves this cycle, never before in all our incarnations have we borne such a wondrous gift or been bonded with such a flawless vessel. Now go, oh precious champion, claim your prizes, spread our voracious brood to all the corners of these strange lands so that they may make way for her coming and [italic type]Na reck da han kovve nuthi[roman type]!' the presence rumbles, as the fractured choir of tones and inflections whorl together in a single unified voice brimming with elation and almost human notes of glee while the eldritch winds gently tug upon your wrists urging you towards the middeck. Nodding dreamily, you heed the storms pull and prowl towards your sumptuous prizes."; [serve as the five heads commands]
				else:
					say "     You crow in a wicked cadence at the thought of experimenting with this new tool as you prowl back to the middeck and your delectable prizes.";
				now Intelligence of Galaxite is 2;
			say "     Returning to the middle deck, the once boisterous chatter of the bound sharks quickly comes to an abrupt halt as their eyes are drawn to the molten unfeeling glow of your own refracting upon the rain swept floor. Fidgeting under your abyssal gaze, the trio of restrained herms stare dumbfoundedly at your imposing figure emerging once more from the gloom, despite their shock, you still note the looks of bestial longing emblazoned on their angular snouts as their selachian orbs appreciatively drift along the [bodydesc of player] contours of you maw, then to the curves of your [breast size desc of player] chest. 'Uh *gulp* captain, I'z um think they heard us,' the left shark stammers weakly as shi slumps closer to the ground in an effort to look small and unnoticeable. 'Er, sorry me lovely dragoness... t'was nothing more than some harmless wee sailor talk,' the captain mewls apologetically, idly covering hir lower half and subtle blush of hir cock vent with hir impressive tail.";
			say "     'Though we'd be more den happy to do anything ya ask ta make amends me dragon, now taint that right me hearts?!' the lead herm simpers, gently nudging hir crew with hir shoulders. 'Aye captain!' the others reply with a mix of enthusiasm and delectable fear as the harsh yellow metallic light of your many eyes and umbral shadowy bolts of benighted lightning plays across their buxom features. Enjoying the sight and sweet coiling scent of terror, arousal, and storm-lashed ocean spray lacing through the air, you languidly stalk towards them with a hungry grin on your predatory maw as you cheekily repeat the phrase, anything, in a dark deeply alluring tone. 'Of course me good dragon,' the captain says with a vigorous nod. Well, you begin, casually inspecting your reflective talons in a show of proper draconic indifference to your lessers, you can think of a proper penance for their imperantice. You kneel down before them and languidly traces your left pointer claw along the side of the captain's gray-pebble cheek, delighting at the pleasant catch and the subtle velcro-esque knell of your rending blades playing along hir hide as you cup your claws under hir chin.";
			WaitLineBreak;
			say "     'And *huff*, what *whimper* m-might that be me good dragon,' shi pants needily as you gently brush your clawed thumb against hir thin gray lips. Flashing them a far-too-toothy grin, you tell hir that the trek here and your brief tussle with the Mink's stooges has left you feeling a tad pent up, while your claws glide down past hir neck. You commandingly arc your talons between the lush valley of hir flush weighty breasts and hook the peerless edges of your claws under the thick rope wrapped oh-so-tightly about hir. You pull hir bonds but a hair tighter, reveling in the desperate submissive shiver passing through hir as the fibers dig adorable furrows into the verdant swell of hir sizable e-cups, as they're drawn into a cute faux heart-shape. 'Of course me dragon, da mates un I would be most eager to assist ye!' the captain exclaims, amid a pillowy plume of lustful white mist coiling from the edges of hir mouth. Good [']girl['], you snicker, drawing yourself up to your full height and effortlessly severing hir bonds with a graceful flex of your claws then twist your paw midswing, cutting the others partway free while you nonchalantly rive the ropes binding their legs with bat of your forepaws.";
			say "     'Oh thank ya wonderful dragoness, t'was afraid the goods might start ta bruise soon,' the captain hums in a relieved trill, hir paws roving over the artful curves of hir sordid rack as shi massages the beautiful gray and white borders of hir aquatic hide. 'I'll say captain, just look at what those blackguards did to ya,' the left shark titters, motioning to the ruby friction marks lining the expansive swell of the captain's chest as shi leans over and affectionately adds hir own mitts to the mix. You mirthfully watch as shi tenderly fondles the heavenly curves of the delightly endowed herm, eliciting happy coos from the lead shark as shi leans in to hir mate's touch. 'Aye un look what they did to yer nips me cap'n, why yer lovelies are getting a might chafed,' the right shark quips, easing hirself beside the captain as shi gingerly tucks hir angular snout against their blushing chest and plants a sensuous trail of kiss along the lingering impression in hir hide.";
			WaitLineBreak;
			say "     'Aw, bless ya me mates. You lot know just how to bring a smile to an old sea devil's face,' the captain purrs, draping hir arms about the other buxom hybrids as shi cheekily runs hir hands along their athletic curves in an enticing circuit. Smirking at the sight of the prurient creatures as they casually lavish the captain's glistening rain-soaked figure between them, you watch a shade of enticing red blush simmer across the plush white flesh decorating their cock caves as the bright-red tapered tips of their twin prehensile tools languidly peek out from the depths of the supple lips of their hybrid anatomy. Flashing you a brief but knowing look, the captain makes a show of cooing contentedly as shi pulls the two horny herms all the closer to hir while hir ripe eight inch dicks slink across hir groin and towards hir mates['] as shi languidly caresses hir profoundly dexterous dick about hir crew's impressive bright red tools.";
			say "     Sighing in wordless trills as their paws pamper the captain's toned form and verdant chest, they casually drape their legs over the captain's, their own malleable spires shamelessly entwining themselves with hirs. You watch as they mirthfully stroke hir turgid yet flexible shafts in the lush coils of their dual dicks with surprising ease. Enthused by the spectacle of the overly-familiar fishes playing with one another, a lewd thought of how best to claim all three of these beauties for yourself flashes across your mind's eye while your ovi tail thrums behind with an eager energy all its own. Loosing a commanding rumble to get their attention, you quickly inform the sultry sirens of your intent and order them to pile atop one another. With the captain, of course on top, you add with a libidinous smirk. Though a brief look of confusion mixed with note of annoyance flares across their visages at the impromptu interruption, a domineering tattoo of your talons along the metal deck swiftly lights a fire under them, as the left and right shark hastily bicker amongst themselves in hushed tone about who's going to bottom.";
			WaitLineBreak;
			say "     In no mood to entertain their nautical nonsense, you growl at the right shark then order hir to hir knees before she wears on the thin shreds of your patience. 'A-a-aye-aye me dragon!' shi stammers as shi promptly disentangles hirself from hir coterie and drops down on all-fours before you. You are enthralled by the spectacle of hir tight curvaceous hips and adorable cunt on full display while the rain beads down the toned contour of hir athletic leg and plush sack as shi waggles hir breedable ass at hir mates. The other two giggle and clamber to their paws as they climb atop hir prone body, forming a gently swaying tower of hybrid beauty, while their clawed paws jovially roam their hale hourglass waists and majestic chests. A part of you can't resist marveling at the glow of your golden eyes refracting off their rain-kissed skin and ambient streaks of distant lightning dancing across their exotic cunts, ripe chicken-egg sized sacks, perched atop their oh-so-gropable asses as they carefully line up their puddling sexes in a beautiful ballet of hermaphroditic excess.";
			say "     The trio of sensuous selachian sirens vivaciously glide their twin cum veins along their prominent cunts as they lavish one another's supple passages with each languid pass of their tapered ruby tools. Moaning affectionately to one another while their paws and tails explore their entwined figures, they gleefully trace their tight athletic curves and enticing balls. You watch as they arch their spire in wordless union and spear one another like an overloaded switchboard, roaring together in bestial elation, their elastic muffs bulging delectably with the virile weight of the potent rods stretching their aquatic flowers as they rock and piston their hips atop one another. The captain glances back over hir shoulder with a smoldering primal look in hir eyes as shi bobs hir tail towards hir own unattended passage and gently swaying balls.";
			WaitLineBreak;
			say "     Growling in a low, lustful, draconic cadence at the subtle blush of hir cunt framed by the subtle white splotch lining hir inner thighs and respectable sacks like a living runway, you can feel the rising urge to claim them nipping at the edges of your mind as your tail flicks behind you in an eager predatory rhythm. Lost in the beatific view and lurid symphony of their mutual meaty thrusts, your paws seem to move of their accord as you bound forward and mount the writhing tower of titillating proportions like a proper wyrm claiming her prize. Collectively gasping in a preyish trill as you land upon them, you gleefully grope your dominant forepaw about the middle shark's pillowy rack, rollicking internally at the intoxicating interplay of your silky pads gracing the gray-pebbled curves of hir supple chest as you sink your claws into the rain-kissed swell of the busty herm's sweater puppies.";
			if intelligence of Galaxite is 1:
				say "     Meanwhile, you carefully arch your tail into a sensible [']U['] shape and lightly brush the flush petals of your perpetually lubed ovi-cunt along the captain's own dripping passage. Your liminal mind rollicks at the raw sensation of static bliss crackling along your sleek nether lips gliding along the captain's exotic sweltering aquatic flower. Hir plush sex quivers in delectable tandem with every inviting pass of your wondrous tail as you playfully trace the sleek edges of your spaded appendage about hir muscular inner thigh, coating hir bountiful figure in generous sheen of your native oils. Hir fertile box positively gushes and spasms exquisitely at the inquisitive caress of your girthy egg-laying limb as hir warm sultry dew streams along the tiny borders of your immaculate scales. Rumbling in libidinous trill at the pleasant thermocline tracing the sleek contours of your tail and heavenly kiss of your velvety muffs, you draw back your sordid limb, twisting your native spade to vertical angle, and thrust, splaying hir elastic passage in a single meaty stroke.";
				say "     At once, silken elysium and potent coddling pressure shimmers along your ovi-slit as you almost hilt your girthy limb betwixt hir plush folds, evoking an elated gasp from the captain as hir pliable passage stretches to accommodate you. A fresh wave of saturnalian sensation courses through along the tender lips of your exotic cunt as the thrumming flesh glides along the captain's rippling velvety walls while shi squirms beneath your tauric majesty. Not wanting hir to fall over, you carefully shift the position of your paws beside hir and graciously allow hir to brace hir swaying form against you. 'Ah-Ah, th-thank ya benevolent beastie,' the captain purrs in a doting bawdy trill, nuzzling hir angular snout against your digitigrade leg. Though shi never once loses hir pace as air the echoes with the rakish patter of hir and hir crew's mutual frenzied passions warring with the omnipresent gale.";
				WaitLineBreak;
				say "     Your expansive field of view catches sight of your reflections dancing along the ever-present pools of umbral water filling the deck, you watch the middle shark teasingly nibble the pointed ear fins of hir mate while hir paws jovially pamper hir partner's toned core and the cute outlines of hir prehensile pricks. Evoking deep misty pants from the bottom shark, hir eyes seem to glaze in a lustful fog in sumptuous simulacrum of a shameless beast lost in the deepest of heat as hir tongue lolls along the side of mouth. All the while, hir turgid tapered tools needily coil about one another like snakes upon a caduceus. Perhaps sensing this, the middle shark lovingly draws hir paws along the adorable white patch decorating hir mates core tutting, 'Mh here swabby, let me take care of those for ya,' as shi expertly wraps hir mitts about the bottom shark's throbbing robs and slowly dandles hir webbed hands about the bottom's elated tools. A grateful sigh issues from the elated bottom shark as hir dicks squirm in tune with each potent pump of the middle shark's wrist.";
				say "     You are enthused by the sight of the playful crew, alongside the effervescent caress of the captain's aquatic satin walls coddling your alien muff as hir exotic passage lavishes your altered tail with the tenderest of ripples accompanying hir own feverish thrusts. Panting happily, hir selachian muscles peerlessly pamper your nascent ovi slit in their abyssal embrace, while you tactfully angle the sleek spade adorning your tail about the border of the captain's masculine g-spot, placing a sensuous succulent pressure on hir prostate. You coyly slip the glossy edges of your expansive tail about hir stiffening joybuzzer and molten cunt between the powerful thrusts of your tail extolling well-pleased chuffs from hir as shi mewls, 'Yarg, by all the Gods [']O da neath, ye really know how to treat a [']girl['],' while hir own tail slithers affectionately about your ankle like a servile pet as shi languidly draw hir own impressive tail along the amazonian contours of your legs.";
				WaitLineBreak;
				say "     'But,' shi hums in salacious cadence as hir fins lightly stroke the unattended alabaster borders of your sensitive [cunt size desc of Player] scaly cunt, 'yer not da only one what knows her way around a maiden's cove.' Shi lovingly traces the dexterous tips of hir tail about the lips of your eager muff, gently lavishing your flush draconic flower and ripening clit with slow sensual passes of hir prehensile appendage as if asking your permission. Chirping your consent, you hungrily back your breedable haunches against the inquisitive limb, basking at the heady interplay of hir rain-soaked tail as shi folds hir malleable fins in on itself and teasingly hotdogs hir faux-tool about your sweltering pussy. Your tainted mind wallows at the intoxicating texture coddling your draconic sex as beads of beatific dew laced with your potent lubrication and oily eldritch rain pour down the length of the captain's tail. Till at last, shi seemingly judges hirself suitable lubed, curls hir fins into a familiar bend and hir tail shoots forth like an arrow as shi sheathes hir ponderous appendage within you tauric depths.";
				say "     Toe-curling bliss sings though your elastic passage, and your tummy scales bulge delectably with the sapphic mass of finned tail as shi corkscrews hir aquatic appendage about your regal [cunt size desc of player] walls. Hir fins shift and contort with every potent motion as the pleasing exotic pebbled texture of the captain's selachian skin echoes across your bliss-racked cunt. Though never once does the sublime caress of hir tails and decadently coarse hide lavish the same place twice, as the cunning captain's clever tool plumbs your abyssal depths. Rumbling happily at hir touch alongside the wondrous waltz of hir own muff cinching about your tail-cunt as hir toasty walls ripple about nascent ovi-passage with each lustful buck of hir hips, you leisurely glide your occupied forepaw along the middle shark's svelte curves, reveling at the gentle catch of your talons upon hir hide and the succulent preyish quiver of hir body as your velvety pads grope hir trim hydrodynamic figure.";
				WaitLineBreak;
				say "     When you brush the tender well-stuffed bulge of the captain's supple midriff, you pause to affectionately trace your claws about the salacious outline of your tail between each meaty thrust of your sordid limb. Mewling in a cute needy tone, the captain's pulse thrums all the quicker as hir satin sex ripples and caresses your inquisitive limb ever tighter about your ovi-slit. Every lush spasm of hir muff and alluring piston of hir own girthy fins roil the plush folds of your [cunt size desc of player] pussy, sending bountiful sparks through your tauric sex as an enthralling tension shimmers about the edge of your senses. The exotic passage decorating your altered limb throbs with an unbidden fertile rhythm while something shifts within you as the virgin nerves are set alight in a squall of rapturous sensation. Panting in a deep lustful draconic tenor at the rising tension flickering along your flanks, you quicken your thrusts, desperate to edge out just moment more bliss as the concentric rings lining ovi-tail's alien convulse wildly as you cum with a deafening roar.";
				say "     Your tail bulges and stretches with hedonistic purpose, loosing a heady rush of sensual fluids laced with soft gooey eggs to stream along your alien channel one after the other. The echoes of each erotic faux-contraction sends shivers along your spine as a deluge of draconic proportions is unleashed upon the elated captain as hir hungry cunt eagerly drinks in your offering. Hir stomach swells against your paws as the fertile outlines your future brood rifle along your pads as the weight of your eggs massages hir innermost depths and the potent caress of your tail pushes hir over the edge as hir voice joins yours in bestial bawdy bellow of profound release. A great relieved shiver passes through hir curvaceous figure as hir cascading climax arcs about hir crew, almost in unison, a similar rakish roar issues from the middle and bottom sharks as the coiling scents of futa seed and feminine juices spreads out around you, amidst a light sheen of off-white cum mixing with umbral rain. Sighing in base contentment, the trio of herms wobble beneath as they collapse in a sated pile.";
			else if intelligence of Galaxite is 2:
				say "     Languidly arching your altered tail in an inventive [']U['] bend, you gently tuck your dexterous appendage between hir toned swimmer's thighs, liminal mind delighting at the verdant heat pouring from hir passage as your yearning maw engulfs the supple inviting borders of hir plush muff. A delightful little shudder passes through the captain at the exotic caress of your inquisitive tendrils flickering across hir pleasantly plump pussy and stiffening joybuzzer with languid motions of your nascent appendages. Hir sultry salty sapor floods your far-traveled palate as your nimble tendrils diligently coil about hir aquatic button. 'Ah-ah by all da gods [']O da neath me dragon, what manner of beastie taught ya that trick,' the captain pants in a dreamy bliss-wracked tenor as the toothless veiny walls of your tail-maw ripple about hir puddling sex. Ignoring hir question, you merely chuckle in an alluring trill in reply, as a number of your tendrils rove hir receptive passage in an ballet of exotic sensations.";
				say "     You coyly slip of a pair your malleable feelers down the shapely contour of hir groin and gleefully intwine them about hir plush sack, eliciting a wordless lustful gasp from the captain as your supportive pleasure vines masterfully swaddle hir potent packing in their tender clutches. Enthralled by their heavenly weight and exotic texture, you jovially jostle hir chicken-egg sized ball bag in the sensual embrace of your voracious tendrils as the slithering embrace of your glossy limbs roil about in a chaotic waltz. Hir cunt gushes with unbound rapture at the serpentine cosset of your alien limb washing over hir senses as you find yourself nearly drooling at the rich echoes of hir selachian flavor lapping at the edges of your senses. Your tail-mounted tentacles teasingly dandle about the lips of hir off-white snatch in a leisurely rhythm till delectable rivulets of hir feminine honey pour from the sides of your exotic maw and down the supple length of your tail.";
				WaitLineBreak;
				say "     Swooning at the lustful heat of hir sumptuous dew tracing the [bodydesc of player] edge of your scales, you feel a voracious hunger welling in your core, as your gluttonous mind burns with desire to sample hir inviting depths. You lovingly dip your tendrils betwixt hir flush cunt, rollicking internally at the blissful tightness of hir walls coddling your nascent appendages and the exotic tang of hir girly dew titillating your senses as hir surprisingly elastic passage stretches to accommodate your draconic majesty. Delicious, you purr under your breath at the eclectic sensation cascading over your altered anatomy as you expertly flex and whorl your prehensile pleasure tools about hir velvety box, lavishing the buxom siren's sex with a squall of abyssal delights. You hungrily press the veiny borders of the alien muscles adorning your yearning maw, gleefully nursing hir throbbing button and ecstatic nether lips as the captain sways in tune with the felicitous strokes of your tendrils pampering hir hybrid body.";
				say "     Not wanting hir to fall, you gently prop your powerful legs beside hir curvaceous form for support. 'Oh thank ye, you wondrous bestie,' the captain mewls dotingly as shi lovingly nuzzles hir angular snout against your chiseled physique. The air reverberates with the meaty thrum of the shark's passionate thrusts, intoxicating squelching of your tail maw, and the wet patter of your tendril affectionately pampering the captain's lush pearls in their vivacious grasp as you diligently swaddle hir virile package in your loving clutches. Spurred on by the imperial caress of hir verdant balls and the heavenly strokes of your tendrils moiling hir rippling, velvety muff, the captain's pace never once slows as the rakish notes of the sharks['] shared frenzied passion wars with the eldritch gale washing over your entwined form.";
				WaitLineBreak;
				say "     Your expansive field of view catches sight of your reflections dancing along the ever-present pools of umbral water filling the deck, you watch the middle shark teasingly nibble the pointed ear fins of hir mate while hir paws jovially pamper hir partner's toned core and the cute outlines of hir prehensile pricks. Evoking deep misty pants from the bottom shark, hir eyes seem to glaze in a lustful fog in sumptuous simulacrum of a shameless beast lost in the deepest of heat as hir tongue lolls along the side of mouth. All the while, hir turgid tapered tools needily coil about one another like snakes upon a caduceus. Perhaps sensing this, the middle shark lovingly draws hir paws along the adorable white patch decorating hir mates core tutting, 'Mh here swabby, let me take care of those for ya,' as shi expertly wraps hir mitts about the bottom shark's throbbing robs and slowly dandles hir webbed hands about the bottom's elated tools. A grateful sigh issues from the elated bottom shark as hir dicks squirm in tune with each potent pump of the middle shark's wrist.";
				say "     Invigorated by the spectacle of the libidinous crew and the intermingling bliss of the saporous tang of hir hybrid dew and titillating spasms of the captain's fathomless passage milking your exotic tendrils, you luxuriantly glide your inquisitive appendages across the innervating contours of hir plush ball-bag towards hir sensuous cock cave. Your liminal mind swoons at the hedonistic zest of salty pre roiling your opulent tendrils as you teasingly pamper hir unerringly tight vent and turgid spires in your coils['] buttery-smooth embrace. You luridly slip the supple tips of your alien limbs about the tapering base of hir cocks, eliciting a priceless whimper of primordial need from the captain as you casually dip a pair of dexterous tendrils in to hir toasty aquatic vent. Hir supremely elastic slit bulges delectably with the majestic weight of your tentacles as you lavish hir throbbing cove and the tender base of hir prehensile dicks with loving alacrity.";
				WaitLineBreak;
				say "     While hir lush gushing walls cinch about your muscular invader and the meaty pulse of hir cum veins simmer the elated length of your tendrils with each potent buck of hir athletic hips, you can almost feel each of hir heady thrusts coursing through hir hale body as shi pounds the middle shark beneath hir. Grinning at the vivacious sensation and succulent flavors of the selachian creature playing along your liminal palate, you decide to have a bit more fun with the exotic hybrid. You masterfully angle your tendrils and diligently apply savory pressure on hir futa g-spot from both ends. Alternating the heady preternatural strokes of your augmented limbs as your tendrils cunningly rollick along hir dual satiny passages while the voracious muscles of your tail maw nurse hir stiffening button in their warm exotic embrace. Mh good little egg slut, you purr, running a forepaw along hir taut tendril-stuffed tum as you trace the cute little outlines of your coils at the thought of filling hir svelte body with ripe of clutch eggs as shi writhes beneath you.";
				WaitLineBreak;
				say "     'Ah-ah st-sta-stars me dragon, ye really know how to treat a [']girl['],' the captain stammers, leaning ever-so-slightly into your touch. 'But,' shi hums in a devilish trill, as hir tail traipses up the chiseled lineament of your inner thigh, 'yar not ta only one what knows her way about a maiden's muff.' The gray-pebbled edges of hir tail fins dance about the supple borders of your [cunt size desc of player] scalie cunt in a toe-clenching waltz as the exotic texture of hir rain-kissed hide pampers the sweltering imperial folds of your slit as if asking your permission. Rumbling in a domineering yet altogether pleased cadence at hir proper show of deference, you grind your tauric passage against hir probing limb, reveling at the beatific sensation of your hungry lips coddling the captain's tail in a show of bestial consent. 'Aye-aye me dragon!' the captain exclaims, furling hir fins into a tight tapering point. Shi gleefully dandles hir tail about your dripping lips and the glossy lamina decorating your bejeweled splendor as shi slathers hir tail in a generous sheen of your body's natural lubrication till hir girthy limb positively drips with your girly juice and sensuous oils.";
				say "     Judging hirself suitably lubed, shi arcs hir tail into an all-too-familiar bend, then thrusts, at once frictionless rapture mixed with delightful fullness surges through you as your cunt stretches to accommodate hir impressive limb. No stranger to taking larger lovers, you find yourself purring under your breath, at the sensation of the captain unfurling fins like the petals on some exotic flower. The bifurcated edges of hir dexterous limb tenderly ministers your [bodydesc of player] sex in a chaotic whorl of saturnalian sensations that pairs like the sweetest of wines with the supple milking of your tendrils as the lustful herm's ecstatic muff and toasty cock cave convulse in tune with the heavenly pistons of hir tail. Hir fins seem drawn to your neediest folds like living erotic lodestone; raw static joy laced with the ambient kiss of the umbral storm washes over your majestic being as a potent pleasurable sense of tightness flicker along the exuberant length of the ovi passage nestled within your tail.";
				WaitLineBreak;
				say "     Nearly drooling at the virgin sensation simmering along your bliss-wracked egg-laying channel, you feel something shifting inside you as the nascent flesh spasms and contracts akin to an overloading switchboard. You sink your forepaws into the toned curves of the captain's hourglass waist like a proper taur claiming her mate. A lustful feverish heat filters along your lengthy spine as you cum with a proud bestial roar while you flare your wings beside you in triumph. Your tail ripples with unbound delight as torrent of feminine juices and gooey eggs stream through its elastic passage. Far from painful, the virgin limb practically sings as a heavenly conga line of malleable sphere fill your ovipositor to the brim, each lurid contraction echos through your body like ripples on a still pond as mini-orgasms grace the concentric rings decorating your altered limb. Basking in the impossible elysium, you hurriedly press and clamp your tail-mouth tightly about the captain cunt till your maw's muscular o-ring nearly engulfs hir muff and looses a deluge of delectable sensual fluids laced with your supple eggs.";
				say "     Aided by the malleable coils of your tendrils and the potent caress of your maw, not a drop of your precious offering is wasted as your aberrant appendages seamlessly push the doughy mass of your future brood. You can't help but enjoy the feeling of hir balmy egg-laden belly pressing against your talons as the captain's body grows riper by the second. Rumbling happily, you encouragingly pamper hir taut off-white tummy in the caring clutches of your silky pads while your tail writhes with abyssal release as you deposit your countless eggs into hir fertile depths. All the while, your remaining tendrils vigorously stroke hir twitching turgid tools till the roiling squall of their caress and the lush pressure of you eggs filling hir middle finally overcomes hir.";
				WaitLineBreak;
				say "     With one last aphrodisiacal shudder, shi cries out in animalistic satisfaction as hir dicks thrum against the satin coils of your tendrils as shi finishes. A great relieved shiver passes through hir curvaceous figure as hir cascading climax arcs about hir crew, almost in unison, a similar set of bawdy roars issue from the middle and bottom sharks as their androgynous voices bleed into the howling gale coiling about the middle. The gentle patter of the bottom's release and intoxicating scents of fishy futa seed laced with feminine juices spread out around you amidst a light sheen of off-white cum mixing with the umbral rain. Sighing in base contentment, the trio of herms wobble almost drunkenly beneath you as they soon collapse in a sated heap and they mumble contently to one another."; [rejoin main body here]
			say "     You and the captain unceremoniously disentangle yourselves from one another as you dismount hir, though a pleased almost inaudible purr still issues from your lips at the rich sensation of the last few inches of hir tail slipping from your draconic flower with a pleasant pop. You carefully step back and gaze at the sight of spent herms with a profoundly proud grin as the left and right shark gingerly roll into a sitting position as your elated eyes take in the full majesty of their blushing cum-stuffed tums lazing comfortably between their legs while the captain sways beside them on all-fours, clutching hir stomach with hir tail. Positively packed with liters of aquatic seed, the left and right sharks['] creamy off-white middles have gained more than few fresh inches of supple roundness as their taut little domes wobble ever-so-slightly with each elated breath. You watch with more than a little interest as they gleefully run their paws along the plush mounds of their sumptuous tits and ripening cores in abject delight. 'Mh how I'z missed this feeling,' the right shark hums in low wistful trill as shi arches hir back to better highlight the lush curves of hir blushing tum.";
			WaitLineBreak;
			say "     'Aye, tis a wondrous one,' the left shark purrs, as shi idly rests hir hand atop hir own sloshing belly, affectionately stroking the cute borders of hir glistening hide. 'By holy Zun I hope yer load sticks me captain, just hope ye don't mind me taking a few moons of paid leave to properly enjoy ta experience,' shi adds with a lewd expectant cackle as hir paws drift around the tender equator of hir plush core. At the mention of hir title, the captain coos with a mix of fatigue and satisfaction as shi plops onto hir back, hir face alight with manic pride as shi seems to revel in the full majesty of hir absurdly-bloated body as shi plops hir egg-laden belly upon the deck with a gentle wet thump. Hopelessly beyond stuffed, hir rosy tummy stretches well past hir knees in a beautiful mountain of fertile excess. You watch as shi lovingly massages hir palms along the impressive outline of your countless eggs, swooning in a dreamy cadance, 'Aye-aye, whatever ye say swabby, just keep yer voice down, da wee ones here need a moment ta get settled in right proper like,' as shi watches the rain trickle across hir bountiful bump.";
			say "     'Sorry cap'n, un you too maties,' the left shark whispers, as shi scoots hirself over to the captain's side and tenderly kisses the supple forms of your eggs. 'Ye little sea dogs got quite the adventure ahead of ya, we're gonna need all yer help when the time comes,' shi adds with a dark chuckle. 'Indeed my lovelies,' the captain preens, tracing hir left pointer along the ripe curves of hir plush middle, 'with these beastie at our back we can retake the island and even the scales with the blighters what abandoned us to dis [']ulk.' 'Ha-ha why stop there captain,' the right shark hums, crawling over to hir peers['] side, shi thrallishly drapes hir arms around the captain's egg-stuffed middle and nuzzles hir cheek along the well-seeded herm's flush form. 'With a few more gams of these beasties even those boyos at Atlantis would be fair game for our crew.'";
			WaitLineBreak;
			say "     'Mh, I love the way ye think me hearts,' the captain purrs, hooking hir arms about their svelte waists as shi gleefully strokes hir crew's tender tums in a slow sensuous circuit. 'Just the thought of all that treasure be setting me mind ablaze, and,' shi simpers, looking back at you with a hungry grin on hir face. 'Its all thanks to ye me dragon, I swear with the gods [']O da neath un above as me witness, me crew un I will pay ya back ten thousand fold for bestowing us with yer blessing. But for now,' shi yawns, tucking hir arm behind head while hir crew fawn over hir resplendent form, 'me mates un I be needing a moment ta get rest un acquainted with da wee ones before we leave,' shi swoons, bobbing hir tail to hir left and right.";
			WaitLinebreak;
			say "     At this bold pronouncement, you can feel your hackles rise at the notion of these lesser beings commanding your nascent flight, yet before you give voice to these thoughts the presence begins chirping in a fractal choir from the back of your mind. 'We feel and share your ire, but hold your tongue, our sister will deal with them as is proper soon enough. Besides, they have such,' they pause as the storm crackles around you, 'potential, so let them rest for now, and [italic type]Na reck da han kovve nuthi[roman type],' the presence intones, as your ire bleeds awaying in a cold surge of reptilian calm and mammalian curiosity. You decide to let the matter drop for the moment as you can alway collect your wild oats later, and besides, you have little desire to harm the future mothers of your wyrmlings, yet. You muse as with a heavy shrug, you make your back to aft more than ready to what manner treasures and dangers await in the lower decks.";
			CreatureSexAftermath "Shark Herm" receives "PussyFuck" from "Player";
			CreatureSexAftermath "Player" receives "Stroking" from "Shark Herm";
			say "[PartThree]";
	-- "Leave them be.":
		say "     In no mood to sully yourself with the touch of lesser beings, you push back against the tempestuous urges nipping at the back of your liminal mind with a heavy shake of your regal head as you mentally steady yourself. The chaotic squall of morphic energies coiling about your flanks seems to bleed away into the storm as you reign in your draconic urges and refocus on the matters at hand. Reasoning, that the insipid bipeds are merely trying to trick you into freeing them so that they can lull you into a false sense of security and betray you, or perhaps claim this vessel and plunder it for themselves. True, it's unlikely they could succeed in this artless foolhardy ploy, but there's no point in tempting fate, you think to yourself as you shut out the bawdy echoes of the chatty herms voices and continue on to the aft section of the ship.";
		say "[PartThree]";


to say PartThree:
	say "     Rounding the sharp bend in the ship's deck, you quickly spy the entrance to the lower levels tucked into a small recess in the modded ship's rear tower and right behind the vacant helipad. Though small by your tauric standard, the simple undogged hatch blowing listlessly in the pouring rain should be just wide enough to accommodate you, you muse. Peering down the staircase to the lower deck, your eyes are greeted by the harsh red glow of emergency chem lights reflecting off the cramped walls of the ship internals. Taking in the sight of the narrow flight of metal stairs, a part of you worries your draconic bulk might not be able to fit, yet with the aid of your body's natural lubrication and just a bit of careful maneuvering, you're just barely able to squeeze your way down. Along the way, your sharpened senses pick up an enticing medley of abyssal brine and... fish? You think to yourself between steps, trying to place the aquatic scent, to no avail as further down the odor becomes heavily impregnated with the ambient remains of off gassing fuel, coolants, industrial lubrication, and various metal oxides permeating the area.";
	say "     Nostrils twitching in revulsion at the horrid brew of malodorous scents intermingling with the groans of distressed metal reverberating through the hold gnawing at your ears, you realize this ship may be in far worse shape than you initially surmised, and who knows how much longer its superstructure will hold in this storm. You ruminate as your paws finally reach the landing and you're relieved to find the corridor open up just enough for you to walk, though you still have to watch your horns as more than once your draconic horns scrape a number of overhead pipes. Carefully tilting your head upward, the molten golden glow of your many eyes pushes back the linger shadows cast by the ship's utility lines enough to see the poor state of the ship's internals. Here and there, you spy large paint bubbles forming along the walls, leaking foul smelling rust tainted liquid, or the occasional pipe oozing what you dearly hope is gray water as you prowl through the deck. All the while listening for any indication of the [']tentacular terrors['] the sharks mentioned, yet only the low groan of the stricken ship's hull and bestial patter of your talons greets you as you go from room-to-room looking for plunder.";
	WaitLineBreak;
	say "     Yet, for all its size and apparent modification, these bottom decks appear to be completely barren, as every room you search through shows few, if any, signs of habitation. Grumbling in aggravation, you can't even find even a single bit of trash or scuff mark on the floor, even the area labeled Mess Hall, is beyond spotless as if someone came through and scrubbed every nook and cranny of all signs of its former inhabitants. True, you've heard second-hand stories and the odd news report of soldiers in the field scrubbing all evidence of their presence when they abandon a position, still this level of obscuration seems... excessive, you think to yourself as you come upon another set of stairs nestled into the back of a nondescript wall. Huffing under your breath, you descend this next flight of stairs and pick your way deep into the bowels of the ship. With each step, you can feel the bracing chill of the storm-touched water bleeding into the ship grow in intensity as the welcoming blanket of abyssal humidity grows all the more potent.";
	say "     The pained groaning of this puny ship's hull bucking under the omnipresent weight of the ocean pressing down on the bulkheads increases in volume. Another time, you might have felt a lick of fear at the thought of wandering this strict ship as it teeters in structural failure. Now, you can only chuckle at the thought of such mammalian triviality like drowning, or the bends, as you meander through the ruby-hued hall till you come to a [']T['] junction in the lowermost deck with a somewhat intact bit of signage affixed to the grayish-white wall, though it appears to have been scrubbed heavily with turpentine or some manner of industrial solvent and what you assume is a scouring brush going by the light scratching emblazoned on the rust-scarred steely metal.";
	WaitLineBreak;
	say "     Aided by your enhanced vision, alongside your natural luminance, you're able to make out the words storage and the remains of an arrow pointing left, underneath which are the remains of the words engine room alongside a second marker indicating left hewn into the metal. Grinning at the find, you follow the left hand path, eager to see what manner of treasure, resources, and trials await you. Prowling along the icy halls, you trek through the ruby-hued gloom that leads you to the entrance of what you assume is the cargo hold as the path widens and gives way to a heavy, lurid, shadowy void. Hidden among the umbral pall, you can spy the brilliant shine of countless bright blue tapetum lucidum peering back at you like a sea of malevolent stars. Even without your draconic senses, you could feel the hate pouring from the innumerable orbs painted about the rippling darkness at your trespass. Regardless, you push onward knowing that you're about to walk into an ambush, then as you crest the entrance, you flare your chromatophores, filling much of the hold with a pale bone-white light. All around you, your latest foes hiss in aggravation as the velvety shadows recedes, if only for a fraction of an instant.";
	say "     In that brief moment, your expansive range of vision drinks in the area as you notice the massive slate pillar piercing the hull and inky-black water spouts pouring through the rents in the corroding metal. While a sizable number of shipping containers painted red or black are strewn about the area at wild angles, along their edges, you can spy a number of deflated off-white rubbery bean-shaped husks which you surmise are hatched Squid Girl eggs. The same Squid Girls that now surround you as they cling to the walls and containers. Though most appear unarmed and fully nude, one of them has taken it upon themselves to fashioning crude, highly ineffective, if not outright useless bits of ad-hok armor from life rings and chunks of driftwood bound with length of tough kelp. As your eyes roam across the rubbery yellow hide decorating their willowy frame and puny A-cups glistening in the dark, the innumerable gaps and poor ergonomics of their protective equipment almost brings a chuckle to your lips. More worryingly though, are the bits of debris clutched in their pad-like mitts, as you spy others wielding sharpened metal fragments and hastily hewn lengths of waterlogged wood coiled in their hybrid hold.";
	WaitLineBreak;
	say "     From their posture, their purpose becomes clear as you observe them awkwardly cocking their arm tentacles as they aim the impromptu projectiles at your head. Occasionally, one will pause to look in the armored squid's direction as if waiting for her command. Strong and fast as you may be, the hold offers very little in the way of reliable cover, and despite their strain's weakness, the sheer volume of fire they could unleash will likely make any fight with them a tough one. With only scant seconds to spare before the shock of your abyssal draconic majesty and the blinding effect of your chromatophores wears off, you quickly weigh your options, such as they are. Your first thought is to seize the initiative, trusting in your martial prowess along with any supplies and weapons you may have brought to help you weather the storm. Or, you could ask the presence for help as you can feel its writhing influence straining at the bulwarks of your mind. ";
	if Charisma of Player >= 20 or Perception of Player >= 20:
		say "Then again, as the gloom coils around the odd creatures, your eldritch eyes can pick up notes of fearful blacks and servile rotten green hues warring with veins of raging red as dragon fear nips at the back of their minds. Perhaps, you muse, with but a little... gentle encouragement from the Nazokaazthur swarming about the depths, you could pacify them without a fight.";
	LineBreak;
	say "     [italic type]What would you like to do? Note: fleeing or submitting fails this quest, removes Galaxite, your Dragon Breeder infection, along with all boons you have acquired thus far. There is no special content to be viewed or rewards to be gained if you do so.[roman type]";
	LineBreak;
	let Squid_Breaker_Choices be a list of text;
	add "Attack!" to Squid_Breaker_Choices;
	add "Ask the presence for help?" to Squid_Breaker_Choices;
	if Charisma of Player >= 20 or Perception of Player >= 20:
		add "Cow them." to Squid_Breaker_Choices;
	let Squid_Breaker_Choice be what the player chooses from Squid_Breaker_Choices;
	if Squid_Breaker_Choice is:
		-- "Attack!":
			say "     Boldly striding forward, you flare your chromatophores once more in an array of many colors and none as you bellow your challenge to the inspid Squids that dare stand between you and your rightful treasure. As your roar echoes through the hold, many of the squids flinch, or clutch their flat sucker-laden palms to their alien heads as the sea itself seems churn in tune with your call. For a moment, you suspect they might break as you leap for the ledge overlooking the hold, propelled by a single mighty flap of your wings as you advance on the nearest pod of squids. That is, until a cry comes from the [']armored['] squid wielding a gaffer's pole, screaming, 'Hold fast sisters, if we defeated the Land Walkers when they came en masse, then we can best this lone monster too! [bold type]NOW CHARGE!!![roman type]' as she levels the crude weapon with you while a hail of twisted metal and flotsam rains upon you. It's a fight!";
			say "[TentacleFun]";
		-- "Ask the presence for help?":
			say "     Turning your awareness inward, you can feel the shadow presence of your many passengers surge to meet you as the many umbral worms nesting inside your inner world probe your mental barriers. Oddly though, their touch is not wholly unpleasant, as notes of alien curiosity twinged with animalist pride lap at the dark shoals of your draconic psyche. 'Ask,' they hiss in a resounding choir impregnating the simple word with innumerable inflections as your body roils with the coiling touch of their word. At once, you filter your thoughts to the presence, and you can feel the multitude of voices bristle with activity as they seem to bicker amongst themselves in a maddening din of fragmenting tones that wears heavily on the fracturing mortar of your mind, till one voice emerges victorious howling in a broken slithering echo. '[italic type]Karmyn-Nurts-Sturm[roman type],' as the sensation of raw sunlight burning through your eyelids washes over your psyche, and brilliant nameless hues strobe along your chromatophores."; [Sun or Plasma force storm]
			say "     Lush pulses of familiar change ripple through your flanks and tentacle hair as your luminescent scales glow all the brighter then go cold and muted as the jet black pall rushes forth to fill the void alongside the cobalt blue eyeshine of the squids. You can feel the shifting cells thrum with activity as the clarion word of draconic power burns on the tip of your tongue. Inhaling deeply, your tainted mind revels at the bountiful upwell of eldritch power pouring into you as the lingering touch of the presence fills your mutable body with an intoxicating rush energy crackling through your veins as the presence roars through you, 'Karmyn-Nurts-Strum!' At once, your scales flare as a brilliant wave of pyroclastic heat, blinding kaleidoscopic light, and pressure issues form your maw. Though the squid try to dodge or leap behind cover, the resounding blast echoes through the hold with a frightful knell as those closest to you are sent flying and crash into the bulkheads with loud, wet crunches as the hull reels from the force of impact. The few manage to hang on or avoid the initial wave, fare little better, you note observing them swaying listlessly in place, as their eyes turn milky white while drool and yellow bile leak from their lips as the potent mix of overpressure and sensory overload exact their harsh toll.";
			WaitLineBreak;
			say "     However, you know this won't last long, as their nanites are already hard at work undoing much of the damage. Briefly, you consider imploring the presence to shout through you once more, but think better of it as you catch sight of the [']armored['] squid slumped against her gaffer's pole driven into the metallic shell of a black shipping crate. Surmising she might be. if not their leader then a being of some importance to these odd scaleless creatures, you dash over the railing leap upon her with your claws out stretch and pin her to the floor in a single wing-powered bound. Still reeling from shock, the pathetic creature can do little to resist you as talons sink into the thin metal amalgam beneath her as you roar to the remaining squids that can still hear you to stand down. Unless, you add angling a reflective claws over her supple collar bone, they want something to happen to her. 'Foul monster, fell me if you dare!' the squid spits defiantly at you as she glares in your general direction though off-white eyes as hints of blue slowly filter across her pupils, 'but you'll never be able to take us all down!'";
			say "     Chuckling darkly, you languidly trace your claws along the cute rubbery furrows of her puny breasts and inform her that perhaps, but how many of her sisters is she willing to sacrifice to protect this ship and its cargo? At this pronouncement, the squid girl's body goes deathly still and the color drains from her face as she sighs, 'Fine... w-w-what do you want, monster?' Momentarily drinking in the sublime look of defeat and submission emblazoned on her face, you deliver your ultimatum, leave now and no further harm will come to her or her sisters. Once you and your cohort have plundered this ship, you will depart and they will be free to return. '*Arg*, I suppose we have no choice, take these crates then,' she warbles defeated, gesturing to the containers with a nod of her head. 'We have no great use for Land Walker trinkets that have only brought strife and ill-mannered scavengers to our garden beneath the waves, but all I ask is that you leave this cradle of iron unharmed.'";
			WaitLineBreak;
			say "     Rumbling commandingly, you make a show of mulling over her terms, before signaling your agreement with a haughty nod of your horned head. 'Then our pact is struck, SISTERS!' she roars over the groans of her sticken kin, 'gather the wounded, and make ready to open the great portal for we must depart with all haste!' Though some initially balk at her orders, a quick warning flare of your chromophores swiftly sorts them out as the stricken squids fall into line and hurriedly begin collecting the less fortunate among them while a small group of monster girls scurry along the catwalk lining the hold and begin fiddling with some gloom shrouded mechanism tucked into a wall at the far corner. Curious and perhaps just a tad wary, you're about to ask what they're doing when a violent shudder passes through the sea hulk as the roof above sags ever-so-slightly and oily rain begins pouring in. Tilting your head at a questioning angle, you watch as the ceiling parts inward, revealing a large hatch leading to the main deck, and the storm wracked sea beyond.";
			say "     Growling in a pleased cadence, you release the squid girl and order them to leave, though you caution that if they try to double cross you, your draconian cohort will be far less [']gentle['] with them then you are. 'I,' she grimaces, gingerly rubbing her throat as she rises to her full height, 'understand creature, just take what you came for and leave us in peace.' Nodding, you bid her to depart with a bat of your tentacle hair. Returning the gesture in kind, she and her kin swiftly crawl out of the hold in a great tide of cephalopod limbs as they scurry over the walls and deck in a flurry . Though you can't see them from your current angle, you can still hear the numerous splashes made by their hasty exit as they dive over the side in droves. When, at last, the few remaining stragglers depart, you quickly follow suit and climb out after them rather them make the long trek through the ship internals.";
			now Perception of Galaxite is 1; [if this gets too high Kai-Monah is able to fully control the PC during an ending]
			WaitLineBreak;
			say "[PartFour]";
		-- "Cow them.":
			say "     Maw curling into a malevolent grin, you recall the words of power the ape taught to you and inhale deeply, relishing the potent rush of draconic energies coiling in your breast like a bow being drawn, then shout into the inky void. [italic type]NAXOKAAZTHUR! NAAL FAAL HEN KLOV! GEIN LOS HI BEL![roman type] As your shout resounds through the hull, the metal quivers and buckles as bolts are shorn from their housing while fresh spouts of water burst from subtle fissures in the steel amalgam as a choir of brassy voices echo from the deep. 'Gah Kai Monah!' At once, the squids['] color flares a fearful black as the red bleeds from their ghostly aura while eyes are drawn to low churning whirl beneath their tendrils as the sea titans are drawn to you. 'F-first sister wa-what is that noise, it sounds like mother but... but something is wrong,' one of the armed squids stammers, tilting her head in the armored squid's direction. 'I-I don't know little one,' the armored monster girl croaks her voice crackling with abyssal fear as the walls creak all around as she casts her gaze at the frighten squid.";
			say "     Then, seemingly regaining her composure, she levels her gaffer's pole at you, bellowing, 'You there, monster, what manner of foulness have you dragged from the molten depths?!' Striding forward, you flare your chromophores once more, filling the hold with your inner draconic radiance and rumbling, Naxokaazthur. While the water churns and roils in an almost pained knell as the dragons are drawn to your call, in seconds you can hear them swarming about the ship's hull, listening with baited breath for your command. You watch the last drops of red are swallowed in a rush of velvety black and rusty green hues as the effects of dragon fear leaching through the hull washes over the squids. Though not all of them, you note observing ribbons of white, beads of gold, and motes of imperial platinum clinging to the armored squid's core, as the brilliant motes war with the terrible colors scratching at her resolve. Just a hair impressed with her, you spread your wings wide and roar your demands to the squid's potential leader, leave now so that you may plunder this ship, or you will order you cohort to attack.";
			WaitLineBreak;
			say "     'You must be touched by madness creature! We have you surrounded, should this alleged cohort attack, my sisters will be your end long before they can come to your aid!' Almost on the verge of laughter, you gesture to the nearest puny scaleless mongrel with a languid flick of your claws, delighting internally at the panicked look on her face at this simple motion as you advance upon them. You reply that all you're surrounded with is fear, and soon-to-be-dead ferals, so by all means, feel free to attack, you pause then rap your talons along the deck as the voices of the dragons chant, 'Str!! Str!! Str!!' in a brassy bone rattling tenor. If they dare, unless you add letting the word hang like a lure as the dragons brush the ship's exterior with a [']light['] scratch of their talons or hard bump of their titanic limbs. All the while, the bulkheads creak in protest as squids mutter amongst themselves in hushed, frightened tones, till at last the lead squid speaks. 'Unless,' she gulps as rivets of viscous body oil drop from her brow as the bright hue simmering in her core dim little by little, 'what creature?'";
			say "     Strobing your chromatophores for effect, you tell her that you'll leave them be, but only after you've helped yourself to these crates. Once you've taken what you came for, you'll happily depart. Growling under her breath, pale misty wisp pools about the edges of her mouth as she grinds her teeth in aggravation while she looks over her faltering sisters, then sighing deeply, the lead squid seems to deflate ever-so-slightly, saying. 'Fine... take your trinkets, all they've ever done is bring hardship to our garden beneath the waves. All I ask is that you leave this cradle of iron untouched.' Making a show of debating her offer, you idly flex your talons infront of yourself, before replying that her terms are fair. No harm shall come to the ship, and her along with her family will be allowed to leave and return in peace. '*Grrr* then our pact is struck, monster, I only hope these crates bring you the same fell tides they have us,' the lead squid huffs, rapping her gaffer's pole against the hull of black container, then turns to her sibling. 'Sisters we must away, now go open the great portal!'";
			WaitLineBreak;
			say "     Though some initially balk at her orders, a quick tap of your talons on the deck to indicate your impatience sends a small group scurrying up and along the catwalk lining the hold to begin fiddling with some gloom-shrouded mechanism tucked into a wall at the far corner. Curious and perhaps just a tad wary, you're about to ask what they're doing when a violent shudder passes through the sea hulk as the roof above sags ever-so-slightly and oily rain begins pouring in. Tilting your head at a questioning angle, you watch as the ceiling parts inward, as a large cargo hatch leading to the main deck, and the storm-wracked sea beyond opens. Growling in a pleased cadence, you order them to leave, though you caution that if they try to double cross you, your draconian cohort will be far from [']gentle['] with them.";
			say "     'I,' she grimaces at the metallic click of your claws and harsh blares of your bioluminescence, 'understand creature, just take what you came for and leave us in peace.' Nodding, you bid her to depart with a bat of your tentacle hair. Returning the gesture in kind, she and her kin swiftly crawl out the hold in a great tide of cephalopod limbs as they scurry over the walls and deck. Though you can't see them from your current angle, you can still hear the numerous splashes made by their hasty exit as they dive over the side in droves. When finally, the last of them is gone, you quickly follow suit and climb out after them rather than make the long trek through the ship's internals.";
			say "[PartFour]";

To say TentacleFun:
	let GroupFightCounter be 0;
	now fightoutcome is 0; [reset]
	while fightoutcome < 20 and GroupFightCounter < 10: [runs for 10 times or until the player loses or flees]
		now inasituation is true;
		if fightoutcome < 20 and GroupFightCounter < 10:
			say "     Crushing another lowly feral under the weight of your draconic assault, the stricken feral hits the deck with a wet meaty thud. Briefly dazed, the luckless mongrel quickly regains its senses and scutters away under the cover of a barrage of flotsam and jagged metal hurled by the remaining squids. Soon, another roars its challenge then surges forward in a rush of cephalopodial fury while the rest ready their next volley.";
		PlayerWounded 35;
		challenge "Squid";
		increase GroupFightCounter by 1;
		now inasituation is false; [reset]
	if fightoutcome >= 10 and fightoutcome <= 19 and GroupFightCounter is 10:
		say "[TentacleFunWin]";
	else if fightoutcome >= 20 and fightoutcome <= 29:
		say "[TentacleFunLose]";
	else if fightoutcome >= 30:
		say "[TentacleFunFlee]";

to say TentacleFunLose:
	say "     Unable to withstand the squids war of attrition, you collapse in a dazed heap as one last lucky hit manages to finally overcome your draconic resilience . What happens next, you can't be sure, but you have vague memories of yelling and being dragged somewhere rough followed by a sudden rush of cold. At times you think that you hear your name being called, though the speaker's voice sounds rather irate and fragmented as if an unearthly choir was blaring in your mind. You want to reply to find out what's wrong, but words fail you, so you slip deeper into the welcoming blackness of your mind. Sometime later though, you awaken floating in the warm surf with a strong taste of salt, copper, and iron stinging your palate. Cracking your eyes open, you cast your gaze to heavens and see the storm has long since blown itself out and the area returned to pleasant amiable temperature. Curious as to what happened, you start to rise, and feel an odd lightness pervading your limbs alongside a note of sobering lucidity.";
	if Strength of Galaxite >= 1:
		say "     Pulling yourself out of the waist deep water, you realize why as you catch sight of weak, scaleless pig-like flesh blighting your draconic majesty. Bellowing in alarm you hastily look over your body and much to your dismay, you've reverted to the sad, useless human body that nature cursed you with! Howling in raw bestial rage, you scour your body for some fragment of your true form, but all you find is bare waterlogged skin, stumpy nails, tailless backside, and ugly human genitals. Sighing, you even try entreating the presence for aid, yet it is gone, leaving you feeling gutted and empty inside as it seems that you've been abandoned by Galaxite and her brood. However for all your displeasure and profound diminishment, you feel strangely relieved at the same time as whatever power was influencing you is gone, at least now you are the master of your own mind and fate. Though you can still sense the nanites nipping at the edges of your psyche, their call has lost much of its power over you, for the moment at least, and you now have a second chance to live your life as a pathic short-lived human once more. You muse as you trudge your way out of the surf and back on to the beach to plan your next move.";
		LineBreak;
		say "[italic type]Please select your preferred configuration.[roman type]";
		LineBreak;
		let Knot_a_bad_dragon_Choices be a list of text;
		add "Twin dicked herm?" to Knot_a_bad_dragon_Choices;
		add "Single dicked herm?" to Knot_a_bad_dragon_Choices;
		add "Pure Female?" to Knot_a_bad_dragon_Choices;
		let Knot_a_bad_dragon_Choice be what the player chooses from Knot_a_bad_dragon_Choices;
		if Knot_a_bad_dragon_Choice is:
			-- "Twin dicked herm?":
				say "     [bold type]Your wish is granted![roman type]";
				LineBreak;
				Humanify_Player;
				StatChange "Dexterity" by -3;
				StatChange "Strength" by -3;
				StatChange "Stamina" by -3;
				if "Dazzle" is listed in Feats of Player:
					FeatLoss "Dazzle";
				FeatLoss "Flash";
				FeatLoss "Toughened";
				now Energy of Galaxite is 0;
				TraitGain "Deb" for Player;
				if cock count of player < 2:
					now cock count of Player is 2;
				now strength of Galaxite is 0;
				now Point Nemo is resolved;
			-- "Single dicked herm?":
				say "     [bold type]Deus ex cockhina![roman type]";
				LineBreak;
				Humanify_Player;
				StatChange "Dexterity" by -3;
				StatChange "Strength" by -3;
				StatChange "Stamina" by -3;
				if "Dazzle" is listed in Feats of Player:
					FeatLoss "Dazzle";
				FeatLoss "Flash";
				FeatLoss "Toughened";
				TraitGain "Deb" for Player;
				if cock count of player > 1:
					now cock count of Player is 1;
				now Energy of Galaxite is 0;
				now strength of Galaxite is 0;
				now Point Nemo is resolved;
			-- "Pure Female?":
				say "     [bold type]Benis be gone![roman type]";
				LineBreak;
				Humanify_Player;
				StatChange "Dexterity" by -3;
				StatChange "Strength" by -3;
				StatChange "Stamina" by -3;
				if "Dazzle" is listed in Feats of Player:
					FeatLoss "Dazzle";
				FeatLoss "Flash";
				FeatLoss "Toughened";
				TraitGain "Deb" for Player;
				if cock count of Player > 0:
					now cock count of Player is 0;
				now Energy of Galaxite is 0;
				now strength of Galaxite is 0;
				now Point Nemo is resolved;
	else:
		say "     Pulling yourself out of the waist deep water, you realize why as you catch sight of weak, scaleless pig-like flesh blighting your draconic majesty. Bellowing in alarm you hastily look over your body and much to your dismay, you've reverted to the sad, useless human body that nature cursed you with! Howling in raw bestial rage, you scour your body for some fragment of your true form, but all you find is bare waterlogged skin, stumpy nails, tailless backside, and ugly human genitals. Sighing, you even try entreating the presence for aid, yet it is gone, leaving you feeling gutted and empty inside as it seems that you've been abandoned by Galaxite and her brood. However for all your displeasure and profound diminishment, you feel strangely relieved at the same time as whatever power was influencing you is gone, at least now you are the master of your own mind and fate. Though you can still sense the nanites nipping at the edges of your psyche, their call has lost much of its power over you, for the moment at least, and you now have a second chance to live your life as a pathic short-lived human once more. You muse as you trudge your way out of the surf and back on to the beach to plan your next move.";
		Humanify_Player;
		SanBoost 20;
		StatChange "Dexterity" by -3;
		StatChange "Strength" by -3;
		StatChange "Stamina" by -3;
		if "Dazzle" is listed in Feats of Player:
			FeatLoss "Dazzle";
		FeatLoss "Flash";
		FeatLoss "Toughened";
		now Energy of Galaxite is 0;
		TraitGain "Deb" for Player;
		now Point Nemo is resolved;

to say TentacleFunFlee:
	if "Touched by Madness" is listed in Feats of Player:
		say "     Shit, you've lived enough hentai to know where this is going, you muse trying to break contact with squids. ";
	else:
		say "     Too weak to stand up to the combined assault of the ferals, you attempt to beat a hasty retreat. ";
	say "You don't get far though as one the squids leaps upon you and clubs you into submission with her tendrils. You soon blackout from pain and slide into the comforting embrace of unconsciousness. What happens next, you can't be sure, but you have vague memories of yelling and being dragged somewhere rough followed by a sudden rush of cold. At times you think you hear your name being called, though the speaker's voice sounds rather irate and fragmented as if an unearthly choir was blaring in your mind. You want to reply to find out what's wrong, but words fail you, so you slip deeper into the welcoming blackness of your mind. Sometime later though, you awaken floating in the warm surf with a strong taste of salt, copper, and iron stinging your palate. Cracking your eyes open, you cast your gaze to heavens and see the storm has long since blown itself out and the area returned to pleasant amiable temperature. Curious as to what happened, you start to rise, and feel odd light pervading your limbs alongside note of sobering lucidity.";
	if Strength of Galaxite >= 1:
		say "     Pulling yourself out of the waist deep water, you realize why as you catch sight of weak, scaleless pig-like flesh blighting your draconic majesty. Bellowing in alarm you hastily look over your body and much to your dismay, you've reverted to the sad, useless human body that nature cursed you with! Howling in raw bestial rage, you scour your body for some fragment of your true form, but all you find is bare waterlogged skin, stumpy nails, tailless backside, and ugly human genitals. Sighing, you even try entreating the presence for aid, yet it is gone, leaving you feeling gutted and empty inside as it seems that you've been abandoned by Galaxite and her brood. However for all your displeasure and profound diminishment, you feel strangely relieved at the same time as whatever power was influencing you is gone, at least now you are the master of your own mind and fate. Though you can still sense the nanites nipping at the edges of your psyche, their call has lost much of its power over you, for the moment at least, and you now have a second chance to live your life as a pathic short-lived human once more. You muse as you trudge your way out of the surf and back on to the beach to plan your next move.";
		LineBreak;
		say "[italic type]Please select your preferred configuration.[roman type]";
		LineBreak;
		let Dragon_of_my_word_Choices be a list of text;
		add "Dual dicked herm?" to Dragon_of_my_word_Choices;
		add "Mono dicked herm?" to Dragon_of_my_word_Choices;
		add "Female?" to Dragon_of_my_word_Choices;
		let Dragon_of_my_word_Choice be what the player chooses from Dragon_of_my_word_Choices;
		if Dragon_of_my_word_Choice is:
			-- "Dual dicked herm?":
				say "     [bold type]Your wish is granted![roman type]";
				LineBreak;
				Humanify_Player;
				StatChange "Dexterity" by -3;
				StatChange "Strength" by -3;
				StatChange "Stamina" by -3;
				if "Dazzle" is listed in Feats of Player:
					FeatLoss "Dazzle";
				FeatLoss "Flash";
				FeatLoss "Toughened";
				now Energy of Galaxite is 0;
				TraitGain "Deb" for Player;
				now cock count of Player is 2;
				if Cock Length of Player < 12:
					now Cock Length of Player is 12;
				now strength of Galaxite is 0;
				now Point Nemo is resolved;
			-- "Mono dicked herm?":
				say "     [bold type]Deus ex cockhina![roman type]";
				LineBreak;
				Humanify_Player;
				StatChange "Dexterity" by -3;
				StatChange "Strength" by -3;
				StatChange "Stamina" by -3;
				if "Dazzle" is listed in Feats of Player:
					FeatLoss "Dazzle";
				FeatLoss "Flash";
				FeatLoss "Toughened";
				TraitGain "Deb" for Player;
				now cock count of player is 1;
				if Cock Length of Player < 12:
					now Cock Length of Player is 12;
				now Energy of Galaxite is 0;
				now strength of Galaxite is 0;
				now Point Nemo is resolved;
			-- "Female?":
				say "     [bold type]Benis be gone![roman type]";
				LineBreak;
				Humanify_Player;
				StatChange "Dexterity" by -3;
				StatChange "Strength" by -3;
				StatChange "Stamina" by -3;
				if "Dazzle" is listed in Feats of Player:
					FeatLoss "Dazzle";
				FeatLoss "Flash";
				FeatLoss "Toughened";
				TraitGain "Deb" for Player;
				now cock count of player is 0;
				now Energy of Galaxite is 0;
				now strength of Galaxite is 0;
				now Point Nemo is resolved;
	else:
		say "     Pulling yourself out of the waist deep water, you realize why as you catch sight of weak, scaleless pig-like flesh blighting your draconic majesty. Bellowing in alarm you hastily look over your body and much to your dismay, you've reverted to the sad, useless human body that nature cursed you with! Howling in raw bestial rage, you scour your body for some fragment of your true form, but all you find is bare waterlogged skin, stumpy nails, tailless backside, and ugly human genitals. Sighing, you even try entreating the presence for aid, yet it is gone, leaving you feeling gutted and empty inside as it seems that you've been abandoned by Galaxite and her brood. However for all your displeasure and profound diminishment, you feel strangely relieved at the same time as whatever power was influencing you is gone, at least now you are the master of your own mind and fate. Though you can still sense the nanites nipping at the edges of your psyche, their call has lost much of its power over you, for the moment at least, and you now have a second chance to live your life as a pathic short-lived human once more. You muse as you trudge your way out of the surf and back on to the beach to plan your next move.";
		LineBreak;
		Humanify_Player;
		SanBoost 20;
		StatChange "Dexterity" by -3;
		StatChange "Strength" by -3;
		StatChange "Stamina" by -3;
		if "Dazzle" is listed in Feats of Player:
			FeatLoss "Dazzle";
		FeatLoss "Flash";
		FeatLoss "Toughened";
		now Energy of Galaxite is 0;
		TraitGain "Deb" for Player;
		now Point Nemo is resolved;


to say TentacleFunWin:
	say "     Crumpling under your unflinching reptilian onslaught, your last victim collapses in a pained heap at your paws, mewling pitifully to itself, it curls into a small fetal ball as it cowers before your splendor. Rumbling wickedly, you swiftly kick the weak feral onto its back, then stomp down on its collar bone to silence its insipid cries while ordering the remaining legions of squids to stand down, or else. You growl, tapping your claws along its supple, nearly featureless, chest for effect and delighting at the gentle catch of its rubbery hide playing along your talons. '*Arg* HOLD sisters, let the serpent speak, but keep your weapons ready!' the armored squid bellows, flaring her many limbs out in a warning gesture as she glares venomous daggers at you. Good, you have their attention now, you muse as you deliver your ultimatum, and tell them to leave now or you will purge them to last, starting with this stricken, you pause and trace your talons about her carotid artery, morsel.";
	say "     'Vile creature, even if strike one of us down, ten more will take their place! So surrender now and we may just let YOU leave!' the armored squid cries, hefting her pole to air as if to rally her sibling. While around her cries of defiance echo through the hull as those left standing find their courage and rally to her side. Commendable, you chuff, but how many of her kin is she willing to sacrifice, tens, dozens to bring you down? What good is victory if there is almost no one left to celebrate it with? 'We could say the same to you, snake,' she hisses, as the legions of squids take a step forwards. Amused but undaunted, you motion to the waters beyond with a wave of your hair tendrils and inform them that as dreadful as your majesty may be, you are but the herald of that which is to come. Should they strike you down, they will have worse beings to contend with. 'What are you babbling about creatures, you are alone and we are many!' she howls.";
	WaitLineBreak;
	say "     No, not alone, little mouse, you rumble, feeling the presence coiling within as strange alien words bubble on the tips of your serpentine tongue, NAXOKAAZTHUR! Reh-ol reck da han kovve nuthi! You shout in discordant splintering knell, as once the storm-kissed waves churn ever more violently around the ship as the wyrms respond to your shout in kind. 'Gah Kai Monah, by the High Chant are called! By her will, DO! WE! SERVE!' Evoking a teeth chattering groan from the floundering vessel's hull as dragon's voice ripple through the waves and metal, you can almost feel your lungs rattle, and ears ring while the sickly taste of copper laced with acrid basaltic iron flickers along your palate. Though for all your minor irritation, the squids fare little better, as they clutch at their ears and dig their paddle-like hands into their heads, trying desperately to blot out the call, to no avail.";
	say "     In seconds, many drop to their knees, howling in agony at the merest touch of the titan's voice, others eyes grow milky and weapons fall from their hands. Still, the armored squid remains standing with the aid of her pole, though not unscathed as spittle drips from her lips and color drains from her pasty-yellow hide. Feeling their resolve wavering, you reiterate your demands once more, leave or face your wrath. '*Hack*,' the armored squid retches, spitting a wad of yellow bile mixed with flakes of vermillion red at her feet, 'f-f-fine monster,' she stammers, her eyes alight with defiance as she wipes spittle from her lips, 'take these crates and whatever trinkets they carry, they aren't worth the trouble. All I ask is that you leave this cradle of iron intact.' Making a show of debating her offer, you idly flex your talons before replying that her terms are fair. No harm shall come to the ship, and her along with her family will be allowed to leave and return in peace. '*Ggrr* then our pact is struck, monster,' the lead squid huffs, rapping her gaffer's pole against the hull of black container, then turns to her sibling. 'Sisters we must away, now go open the great portal!'";
	WaitLineBreak;
	say "     Though some initially balk at her orders, a quick tap of your talons on the deck to indicate your impatience sends a small group scurrying up and along the catwalk lining the hold to begin fiddling with some gloom-shrouded mechanism tucked into a wall at the far corner. Curious and perhaps just a tad wary, you're about to ask what they're doing when a violent shudder passes through the sea hulk as the roof above sags ever-so-slightly and oily rain begins pouring in. Tilting your head at a questioning angle, you watch as ceiling parts inward, as a large cargo hatch leading to the main deck, and the storm-wracked sea beyond opens. Growling in a pleased cadence, you release the squid girl and order them to leave, though you caution that if they try to double cross you, your draconian cohort will be far from [']gentle['] with them.";
	say "     'I,' she grimaces at the metallic click of your claws and harsh blares of your bioluminescence, 'understand creature, just take what you came for and leave us in peace.' Nodding, you bid her to depart with a bat of your tentacle hair. Returning the gesture in kind, she and her kin swiftly crawl out the hold in a great tide of cephalopod limbs as they scurry over the walls and deck. Though you can't see them from your current angle, you can still hear the numerous splashes made by their hasty exit as they dive over the side in droves. When finally, the last of them is gone, you quickly follow suit and climb out after them rather than make the long claustrophobic trek through the stricken ship's internals.";
	say "[PartFour]";

to say PartFour:
	say "     In moments, you effortlessly hoist yourself onto the rain-slicked deck of the ship with a low grunt, only to find yourself greeted by the smirking figure of Galaxite sitting upon the ship's railings. 'Ah it's good to see you scale sister, I trust your Nier was fruitful,' she hums in cheerful carefree cadance, as her eyes drift appreciatively along the [bodydesc of Player] curves of your tauric body. Shrugging, you tell her that that remains to be seen, and though you've dealt with the ship's lowly inhabitants you still have to find a way to get [bold type]your[roman type] plunder to shore. 'Indeed that would be a most vexing problem,' she purrs, touching her middle and pointer fingers to her lips as if she were stifling a laugh. 'For lesser beings, but not for us oh honored wyrm.' Curious, you ask what she proposes, this ship seems to be completely without power and you doubt her brood could safely extract the containers without sinking the ship.";
	project Figure of Galaxite_clothed_icon;
	say "     'Zinii zul, you speak the truth most astute wyrm maker,' she says, placing her palm on her collar and bows before you, 'even now the pillar holding this ship tetters on the edge of breaking and we have no wish to deprive your magnificence of your duly earned rewards. Thankfully, in your fathomless wisdom scale sister, you have provided us with ample kau for this task,' she adds motioning to the pile of tenrecs slumped next to the foretower with a casual bat of her ear fins. Unsure what the little demi-human means, you ask her to elaborate as you doubt the puny ferals could be of much use in their current condition. 'True, these kau are barely even fit only for menial labor, or sacrifice, in their present form,' she says with a purposeful click of her tongue. 'Amusing as it would be to watch them struggle for your entertainment scale sister, with but a modicum of effort they can be made into something better suited for your needs, should you wish it,' she chuckles, as a bolt of umbral lightning strikes the waves behind her.";
	WaitLineBreak;
	say "     Your interest piqued, you motion for her to continue with a magnanimous bat of your talons. ";
	if Charisma of Galaxite is 1 and Intelligence of Galaxite >= 1: [fucked the bats and bred the sharks]
		say "'Of course sister, though from what we've seen, this lesson will be a short one, without even trying you have already started the process more than once. Zinii!' She exclaims, clapping her hands, 'it please us to see you two working so well together, *fu-fu* to think she doubted you!' Galaxite crows as she struts towards unconscious ferals with a pronounced predatory gait. ";
	else if Charisma of Galaxite is 1 or Intelligence of Galaxite >= 1: [either fucked the bats or bred the sharks]
		say "At once sister, but do pay attention though you show great promise, I fear the softness of this place has begun to affect you,' she says in oddly concerned cadence. 'But worry not my beloved dragon in time you will be free of such,' Galaxite pauses, her lips curling into a hateful grimace, 'human sentiments,' she says, sashaying over to the slumbering bipeds ";
	else:
		say "By your leave sister, and I do hope you find this lesson a most... instructive one, your progress thus far has been, wanting. Why,' Galaxite growls in bestial draconic treble as her lips peel back into a spiteful far-too-toothy scowl. 'I'm beginning to worry she was right to doubt your worthiness, but,' she pause to take a deep steadying breath, 'even our most ardent believers have stumbled from time-to-time, so let this demonstration remind you of the gifts I offer and the price of displeasing me.' She huffs as she prowls to the fallen feral with a menacing, nearly inhuman, stride. ";
	say "Coming to their side, Galaxite loudly snaps her fingers bellowing, 'Laas-Nurtz, now awake little ones, and aam ol faal hen klovve uth!' as a knell of eldritch thunder blares overhead. You watch the tenrecs begin to stir as their bodies begin to convulse and spasm like cadavers in the middle of an archaic Galvani experiment as their unfocused eyes flutter open and they gasp for breath. '[italic type]Vix-Grune-Zamii![roman type]' The little demi-human roars, spreading her arms to the heavens as the wind shifts and roils about the deck in biting wall of overpressure."; [ Laas-Nurtz = life storm Vix-Grune-Zamii = Wind Bind Slaves]
	say "     All around you, the cranes creak and moan as the heavy lengths of chain begin writhing across the deck and foretower like metallic vines in a hellacious cacophony of twisting, tortured metal. You watch in muted awe as they coil around the tenrecs['] wrists and roughly hoist them into the air before you and the strange ape as they sway wildly in the storm's uncaring grasp. Slowly, one starts to rouse from their slumber with a chorus of coughs and broken rattling gasps, his bestial face still beaten, battered, and swollen with innumerable bruises. He mewls in a frightened pained trill, 'Wh-who are y-you?' as he struggles to open but a single bloodshot eye and tries to meet Galaxite's smoldering golden stare. 'Hm, who am I? What a good question little mouse,' Galaxite purrs, pawing up to the dazed biped and hooking her pointer finger under his chin as she levels his gaze with hers. 'I have gone by many names across countless spheres,' she preens, lightly wiping a bit of blood-laced spittle from his lips with her thumb.";
	WaitLineBreak;
	say "     'To the knights of my loathsome platinum brother's stagnant order, I am the lady of many colors and none. Among the dwarves and elves now inhabiting the urban forest, I'm known as the empress of wyrms and the fool's metal, but to you, lovely kau of this dying world, I. Am. Tiamat, Goddess of control, domination, submission, and servitude,' she whispers in a dark alluring tone. 'I-I am sorry I don't understand what any of that means,' the tenrec says in a dissociated warble as feet sway across the deck, 'but listen lady. Th-there's something on this ship, I don't know what to call it but it's mean and took me and my crew out like it was nothing! If you help me down, we've got a yacht nearby that we can use to get out of here before it comes back.' 'Thing, oh *tut-tut-tut* naughty little mousy, you shouldn't refer to my sister like that, you'll hurt her feelings,' the creature calling itself Tiamat tuts, cupping its hand about the feral's muzzle and tilts his head towards you. 'Sister? What in the hell are you-,' the tenrec stammers as his voice dies mid sentence at the sight of you. 'Oh SHIT! Guys get up! The fucking freak is back! GET UP! GET UP! We gotta get out of here!' he screams in priceless terror as he strains against whatever eldritch force holds him captive. At the sound of his panicked proclamation, the others are quickly roused from unconsciousness and begin howl and clawing at the air and deck in a desperate, but ultimately futile bid to flee.";
	say "     'Shh my sweet little mousey no need to fret, you all are under my protection now, kin da rune, child of beasts, and so long as you remain under it, no harm shall befall you,' Tiamat coos in a soothing matronly tone, her expression softening into a reassuring smile as she strokes the side of his muzzle with her thumb like a caring master comforting a frightened pet. 'W-w-what, you mean it?' the tenrec stammers in an oddly hopeful tone as he seems to relax in her grasp. 'Of course kin da rune, well,' she titters, tilting head to the side as a Cheshire smile blossoms on her lips, 'for now. Though should you wish it, I can extend my grace to you and your kith,' Tiamat hums, nodding in the direction of his crew, 'on a more permanent basis. I only ask a small favor in return,' she adds as she presses herself against his rain-kissed body and traces her opalescent nail along his chest in an elongated spiral pattern. '*Gulp* name it,' the tenrec gasps as he seems to melt in her grasp.";
	WaitLineBreak;
	say "     'Smart boy, the task I have for you and your friends is a simple one. This ship holds something precious to my coterie and we require your aid in retrieving it. Do you think you can help with that my lovely little mousey?' she murmurs in an enthralling whisper, while her hands drift down his oily chestnut pelt until her fingers gently brush his inner thigh. 'Yes ma'am, but, um, I'm kind of er stuck...' the tenrec pants in an all too eager tone as Tiamat's finger drift about the plush border of his sheath. 'Ah fear not, just repeat these words with all your heart, then the chains will let go and I shall make you [italic type]more[roman type] than whole again,' she swoons as she leans to kiss one of the fat, lumpy bruises lining his brow and at once the flesh seems to heal and knit before your eyes. 'Then,' she continues motioning to the hold with a languide wave of her hand, 'you can aid us in plundering this ship, and you will never need fear my sister's or any other's ire again: zu'u aam.' Tiamat purrs in an alluring abyssal trill.";
	WaitLineBreak;
	say "     Nodding vigorously, the tenrec begins his recital, 'Zu'u aam!' 'Ol faal,' she says, the velvety word pours from her lips and seems to lap affectionately at your senses while the storm itself seems quiet as if you were passing into the eye. 'Ol faal!' the tenrec bellows as eyes seem to dilate with each syllable. 'Hen klovve uth,' Tiamat simpers, voice crackling and distorting with each utterance. 'Hen klovve uth!' the tenrec hollers as whatever that once held him loosens it hold on him and he tumbles into Tiamat's waiting arms. 'See little mouse that wasn't hard now was it?' she says, carefully lowering him to deck with surprising care, as she makes a show straightening his ruffled fur. 'No ma'am, thank you ma'am!' he rumbles through a dreamy grin while wisps of steam billow from his [one of]whippy[or]limber[or]lithe[or]slender[at random] body as all signs of your prior encounter vanish from his being."; [Zu'u aam ol faal hen klovve uth = I serve as the five heads command]
	say "     'Oh you are most welcome my kau,' she says, helping him to his feet, then turns to his peers. 'Now for the rest of you, speak the words and our pact will be sealed, or if you prefer to take your chances with my scale sister?' she crows, her lips peeling back into predatory smirk as she gestures to with a bat of her ear fins. 'Then by all means, feel free to take a head start.' She chuckles with a snap of her fingers as remaining tenrecs fall to their knees before her a with wet thud and harsh rattle of chains. Though momentarily shocked by the sudden fall, they swiftly begin muttering amongst themselves over whether to not take the deal till their comrade steps forward with a proud smirk on his face saying, 'Oh come on guys, quit arguing and just say the words, nothing bad is gonna happen to you just look at me, I'm fine. In fact, I feel better than ever!' as he gestures to his gently groomed fur with a playful flourish. 'Man Ramirez I don't like this shit, that lady sounds like she's got a screw loose,' one of the tenrecs grumbles. 'Ya man whos to say she ain't gonna sell us or something,' another growls.";
	WaitLineBreak;
	say "     'Hm you got point there Hicks. Say Miss Tiamat, you'll, um, let us go after this, you're not gonna sell us to the shag shack or something right?' Ramirez asks with a hopeful innocent look in his eyes while his tail wags in a eager doting rhythm. 'Oh of course not kin da rune. Should you wish it, you will be free to leave once your [italic type]honest[roman type] service is concluded. Though, you may remain at my side if it pleases you, I promise I can be a very loving and accommodating mistress,' she teases as she struts beside him and affectionately strokes the back of his ears. 'Ugh, fine. Everyone, let's just get this over with,' Hicks says with an aggravated shake of his head. Nodding the other tenrecs steady themselves and shout as one, 'Zu'u aam ol faal hen klovve uth!' as the chain falls lifelessly to the deck. 'Right Miss... Tiamat,' Hicks begins idly rubbing his wrists while his wounds steam shut, 'I hope you can pull a generator out your hat or somethings, cause those cranes aren't gonna move anytime soon without juice,' he adds, jabbing his thumb in the direction of the broken booms.";
	say "     'Oh, silly mouse, I have no need for such base parlor tricks, not when all that I need is right here, Zaami-Daav-Grune!' Tiamat crows, snapping her fingers once more as all but one the tenrecs are suddenly racked by violent spasms and drop to their knees clutching their chests in raw agony. 'What the, who the in hell are you, s-stay back!!' one gasps in a wet throaty rasp as he claws wildly at the air as if struggling with some unseen assailant. All the while, his and the others['] chestnut brown hides ripple and bulge as the silhouettes of countless wriggling annelids flicker just below the surface of their skin. With each passing second, their bodies begin to expand in a chaotic ballet as the alien shapes pool along their extremities forming twisted mockeries of raw muscle and bestial sinew. Chuffing at the sight, Tiamat turns to you, her face alight with predatory glee, saying, 'Now observe sister and see what can be made of the rich clay of this world,' motioning to the convulsing ferals as their back's widen and fur splits along invisible seams, revealing ghostly splotches of writhing flesh."; [Slave Wyrm Bind]
	say "     Curious, you watch as all but Ramirez start howling in broken bestial voices as they claw at these pale patches of flesh, while a verdant carpet of thick emerald green scales spreads out over their once puny frames. A new layer of toned, carved, sinewy muscles flows out from their core, their shoulders shift towards proud herculean bend that ripple with each panicked breath. Their spines lengthen, darken, and seep down their backs in row-upon-row of cruel bristling barbs while the glossy lamina lining their shifting flesh bubbles and parts as a dense pronounced fin erupts out from between their wicked quills, flowing to the tips of their tails. The wave of change starts coursing through the lower half as their seizure-wracked legs are pulled together at groin and appear to weave into one another, while their balls and sheathes steadily shrink as they are absorbed by the beautiful blanket of glistening scales swaddling their changing bodies.";
	WaitLineBreak;
	say "     Their hips widen by the second, as their once lithe, willowy flanks ripple with fresh ";
	if "Touched by Madness" is listed in feats of Player:
		say "centimeters ";
	else:
		say "inches ";
	say "of supple, almost maternal, padding round their growing body as their legs and feet meld into a single impressive serpentine tail, tipped with a boney, bladed point, slithering wildy out behind them. Tilting your head for a better look, you observe a number of overlapping tiers of toughened, off-yellow, heavy, chitin-esque plates coalescing along the [']underbellies['] of the amphibious appendages as they snake across the deck while shifting tenrecs howl in primeval terror at the sight as they tear and claw at the floor. Their paws thicken with each blow as the last of their fur crumbles into dust, giving way to a great tide of raised bone thicker than a man's thumb washing over their arms, blanketing them in an interlocking coat of bestial armor. Roaring in disbelief at this latest violation, their shouts of pain turn to cries of rage, as their conical muzzle flatten, then flare out like some manner of Crocodylidae while their ears recede into the sides of their vaguely reptilian head forming sensory pits ringed by regal emerald scales.";
	say "     Soon, the last patches of their hide is subsumed by the glossy lamina, and all but Ramirez go silent as their eyes briefly grow dim and pupils stretch into vertical slits flanked by tarnished golden irises. Rumbling in a brassy bestial cadance, the altered ferals visibly appear to relax as they puff out their flat chiseled chests and lift themselve up to their new lofty height of nearly nine feet tall. Though, you suspect that they could, with the right encouragement and terrain, easily hold themselves far higher as yards of ripcord tail extend behind them, you muse, letting your eyes wander along the carved statuesque peaks of their armored pecs, then down the rich hills of their toned scalie yum gutters, till your far-traveled gaze is greeted by their flush cloacal slits nestled neatly where their sizable cock and chicken-egg sized sacks once were. Intrigued, you momentarily consider inspecting the newly minted naga on a more intimate level as your inquisitive gaze roams the shapely androgynous curves of their gropable hips then back up their reptilian maws. A part of you can't help but find the exquisite blend of primorial crocodilian and sensuous sea serpentine features adorning their long blunt muzzle a rather enticing sight.";
	WaitLineBreak;
	say "     Though such lurid thoughts are swifty interrupted as the pleased coos and low elated whispers of the seemingly unaltered Ramirez draw your attention to as he stares deeply into the storm clouds billowing overhead, babbling. 'Wow... you look pretty and strong, I bet nobody messes with you miss! Gosh I-I am so jealous... I wish I was like you,' swaying in a daze listlessly from paw to paw. His body seems to crackle with vibrant pulses of untamed prismatic energy while the near omnipresent black drains from his eyes as they slowly turn a bright rich magenta. 'Wait really you can show me how!?' he cries, seeming oblivious to the world around him as his long furless tail thumps along the deck. 'That's awesome, but *gulp*,' the little tenrec pouts as some of prior enthusiasm bleeds from his voice while his ears furl down to the sides of his head, 'only if it's okay with Miss Tiamat, she said she needs me for something and I promised to help her first.' Ramirez simpers sheepishly as the thundercaps roil and churn above.";
	say "     'Really, well ok then show me real quick, but then we gotta help Miss Tiamat!' he beams in unvarnished jubilation, spreading his arms wide as if to embrace the umbral squall. He begins to glow with an inner light, and his body seems to swell before growing tall and more curvaceous as the Tenrec's no-longer-little hips ripple with fecund purpose. His once featureless and profoundly dull ass flares out with lush inviting padding, capped by sensuous, pleasingly tight cheeks, meanwhile his waist narrows to a fine shapely hourglass. Not that the tenrec seems to notice, instead, his paws are drawn to his ripening chest as his formerly flatter-than-a-board breasts creak and wobble enticingly with his every breath as a pair of petite A-cups blossom into being. 'Ah so soft, just like hir's,' the busty boi purrs, encouragingly fondling his cute fuzzy chest. 'But they're sssooo small, they need to be bigger, sssoo much bigger, and heavy,' the shifting anthro huffs, his voice crackling with distinct serpentine hiss as his paws rove shamelessly over the plush hills of his chest pillows.";
	WaitLineBreak;
	say "     'Yes *pant* more *pant*,' he swoons in a needy bestial cadence. The tender maternal flesh groans in tune with the passionate caress of his adorable paws as the flush nascent orbs spill between the gaps in the webbing lining his hands. His body seems to grow in proportion to his ever-swelling cup size, oddly though compared to his peer's chaotic transformation, Ramirez's change appears far more uniform if not gentle as his conical head is soon level with the first tier of the forespire. You look down at the changing man's legs, they're seamlessly drawn together then meld into one another along some invisible seam, while his plush sheath alongside his respectable sack seems to be expanding too. Intrigued, you can't help but gaze at the sight of his engorging sheath stretching wondrously taut as the graceful tapered tip of his cock peeks out from its lush housing and his cute not-so-little balls ripple with reproductive purpose and dangle delightfully down to his vanishing knees.";
	say "     The fur swaddling his virility recedes, giving way to a glossy forest of smooth teardrop scales that steadily creep along the curvaceous contours of his maidenly hips then snake southward along the length of his entwining legs, blanketing him in a shimmering forest of emerald green lamina. Either oblivious or unbothered by such changes coiling down his lower body, his feet are subsumed by the prismatic sea of green that spreads out past them, forming yard upon yard of sensuous serpentine tail. The ensorcelled mutant's attention remains locked on his nearly view-obscuring chest as his ponderous sweater pillows are swallowed by the advancing tides of slithering scalie perfection. 'So beautiful and heavy, just like hir's,' he rumbles in Ophidian delight, seemingly awestruck by their gem-like quality as he eases himself unthinking into the welcoming embrace of his new-found coils. The emerald tide of lustrous scales crawl up his throat and head as the few patches of his fur are reabsorbed by his changing body.";
	WaitLineBreak;
	say "     Ramirez's face flows outward in a tide of burnished jade, as his jaw widens, muzzle blunts, and his lips thin to fine, nearly imperceptible lines like some deep sea serpent; while his pointed ears retreat into the sides of his flattening head forming subtle sensory pits. His spines remain untouched, if only briefly as most of the keratin quills soon fracture and dissolve to ash, their remnants carried away by the weak breeze roiling about the eye of the storm. Those few that remain untouched migrate to the center of his back, forming a single file row down his lengthy back and elongated tail while a thin golden membrane laces betwixt them from a proud sail not all that dissimilar to your own. Not that the massive siren-to-be appears to mind, lost in the tactile bliss of pampering his beyond M-cup breasts as they spill over the glossy borders of his ponderous tail while he gleefully nuzzles his serpentine snout along the verdant hills of their monumental mounds.";
	say "     'Mh perfect, sssooo ripe, fat, and,' the busty creature pauses, as a long bifurcated tongue slips from their maw then flickers through the air as if tasting it, '*gasp* milky,' the unusual hybrid purrs, cupping their slender scalie paws about the perky emerald ducts decorating their tits They sink their fingers into their expansive jugs, creating subtle creases in their lamina as thin trickle of alabaster delight leaks from their puffy cream spouts. 'Oh goddess, yes I can't wait to try these out!' they cry in jubilation, gingerly hefting one of their sordid teats to their Ophidian maw, casting cute little furrows in their supple tit flesh. They recline back into their impossibly long bed of jade coils, providing you with a delectable view of their sumptuous watermelon-sized sack perched atop their tail like priceless jewels and heavenly bulge of their throbbing glistening sheath tucked beside their tits. The milky hybrid mewling contentedly to themselves as they suckle while their free hand worships the lustrous curves of their serpentine form and opulent mass of their lusterous dick holster.";
	WaitLineBreak;
	say "     The lust addled hybrid shamelessly dandles their dainty digits about the base of their scalie cock holster, with slow, almost deliberate motions as they nurse. With each succulent pass, you watch their lamina stretch with a low aphonic creak as beads of lucid pre dribble down the back of their hand as they coax the ripe tapered tool to attention. Your mouth nearly waters at the sight of their throbbing crimson tool slipping free of its velvety confines in a gush of liminal juice. Spellbound, you find it impossible to look away as nearly three feet of glossy ribbed dragon cock is lovingly coaxed to full mast by the gentle dandle of their shifting paws. Your many eyes wander the inviting pleasure ridges lining their cum vein, the plump, vaguely canine, knot swelling at their base framed by the growing perky mound of their adorable tummy and sloshing emerald hills of their breasts. Even Tiamat is enthused by the sight of the busty boi stroking themself to full mast as her eyes mirthfully roam the horny hybrid's bountiful body.";
	say "     Seemingly energized by the attention, they lean into your cohort's collective gaze, mewling between hardy suckles, 'Mh Goddess this thing is huge, I can barely get my hand around it, but I love the way it feels,' as they make a show of playfully trying and failing to wrap an effeminate mitt about their girthy breeding rod. 'These ridges are so soft to the touch,' they pant, brushing their hand about the reptilian pleasure nodules with deliberate care while rocking their voluptuous hips in tune with the languid motions of their paws, sending enticing ripples through their jeweled body. 'And *pant* this knot *whine* the way it throbs, goddess how *whimper* do those slut puppies keep their paws off these!' they moan in a sensuous reptilian trill, their hand drifting further along the turgid tapered curve of their draconic spire as their digits glide along the silken borders of their almost painfully-tight emerald sheath and bitch-breaking gland.";
	WaitLineBreak;
	say "     Meanwhile, their blushing stomach swells and sloshes with untold liters of hybrid cream, forming an adorable fecund dome that wars for space with their ponderous assets. All to the cooing creature's apparent delight, as they greedily sup on the seemingly boundless supply and press their massive rod into the plush mass of their taut tum while they playfully pamper this saurian spire. The air fills the unsubtle spicy scent of masculine draconic arousal as their paws dandle about the artful contours of their cock and glistening tummy scales as they massage a succulent sheen of fresh pre into their ripening midriff with wanton abandon. However, your well-versed senses can't help but pick up the sweet coiling aroma of feminine need wafting off them as a light tickle of lucid dew leaks down the side of lengthy coils. 'Goddess getting so full it's making me wet,' the enthralling hybrid simpers with a tender purr as the tip of their tail slithers, unbidden about the engorged pearls.";
	say "     They brazenly slip their prehensile appendage between their heaving sack and velvety tail, mewling to the eye of the storm. 'Ah that feel nice miss,' while the deck resounds with a lewd schlurping knell as their tail seems to piston of its own accord, sending further blissful wobbles through the newly formed herm's body as shi pounds hir obscured reptilian depths. Enthused by the sight, a part of your fractured mind can't help but delight at the spectacle of the shameless naga indulging hir altered body's needs. ";
	if Player is impreg_now:
		say "You find yourself absentmindedly pawing at your own gravid middle at the thought of claiming such a fertile futa broodmare for yourself, ";
	else if Player is impreg_able:
		say "You find yourself leisurely stroking your vacant tum at thought of whelping a clutch of such a bountiful creatures for yourself, ";
	say "or perhaps finding a way to fill hir with a litter or seven of your own wondrous wyrms. It would certainly be amusing experience, you ruminate, observing the erotic symphony playing out before you as you picture yourself wrapped in hir coil while your bodies swell in each others with untold legions of mighty wyrms eager to conquer in your name and doting nagas to wait on their every word.";
	WaitLineBreak;
	say "     Nearly drunk on the blissful image, you almost miss the lustful change in the lewd broodmare's pace as hir hands and tail move all the quicker, while hir cock twitches in hir grasp and hir hips buck with fervent energy. Till hir massive cum vein bulges with the force of hir release as shi presses hir potent spire into the taut folds of hir milky middle, and cums, basting hir silken scales in a shimmering sheen of futa seed. Sighing happily, the titanic naga herm looses hir hold on hir plush assets then collapses to deck, panting in a spent yet elated rhythm. 'Oh wow miss that was amazing... hey miss where are you!? Miss!?' Ramirez cries in alarm, as shi rolls on to hir side, desperately looking for someone or something. No longer able to remain silent, you ask the former male who shi's looking for. At the sound of your regal draconic voice, a frightened shudder passes through the voluptuous naga as shi struggles to hir [']feet[']. Though hir movments are somewhat awkward, you can't help but enjoy the sight of the busty scalie rising from hir seat with a look of pleasant contentment on hir ophidian muzzle as shi rests hir arms on hir vast assets and supple curvy middle while shi absentmindegly runs hir fingers along subtle borders of hir taut scales.";
	say "     Blinking in confusion, hir magenta eyes scan the deck as shi stammers, 'Uh well I didn't get hir name but shi was this pretty green snake [']lady['] with huge tits, this massive cock an-,' they pause to smack their lips, 'hey where's Hicks, and who are those hunks?' shi hums in a lustful trill as hir eyes roam the chiseled unmoving pecs of the seemingly zombified nagas. Chuffing in raw amusement, you point to the altered herm, telling them that the only snake [']lady['] you've seen since coming aboard is hir. 'Hir what do you?' they rumble then look down at their enhanced figure. '*gasp* Oh goddess shi wasn't kidding. I look so pretty!' they exclaim, gleefully gazing down at their plush body as the true depth of their changes dawns on them. They happily grope vast pawfull of their taut futa flesh as they eagerly explore lustful serpentine curves. 'This is amazing! This body feels so soft and-,' shi pauses lips curling into a proud predatory grin, 'powerful.' shi crows, giving hir sheath a jovial squeeze.";
	WaitLineBreak;
	say "     'Fuck, I can't wait show them this monster, now where are they?' the former tenrec huffs offhandedly while shi peers around the deck. 'Trouble yourself not my sweet Seradovah,' Tiamat preens, her golden eyes alight with a deep alluring gold glow as she strides over to the towering naga and offers her open hand to them. 'You need not look far, come to me and I will show you to them.' At the sound of her voice, Ramirez ceases hir search, then bounds towards her in flurry of slithering excess as shi throw hirself thrallishly at her feet, purring, 'Yes Miss Tiamat,' as shi worshipfully nuzzles hir serpentine cheeks along the tiny human-shaped creature's palm. 'Such a good supplicant,' Tiamat coos, lovingly stroking the former male's scalie visage with her thumb, 'you're submission is most pleasing to me kin da daav, now as for your crew, you need look no further,' she says, gently bobbing her head in the direction of motionless nagas."; [kin da daav = child of wyrms]
	say "     'Wait, that's Hicks and the others? What did you do to them? Why are they just standing there?' Ramirez queries, hir voice waffling between confusion and intrigued as hir gaze drifts over the assembled serpents. 'Simple my dear Seradovah. Unlike you, their oaths of submission were half-hearted at best; as such they were punished. Does this displease you, [']Rameriz[']?' Tiamat simpers, though you can't help notice the slight barbs in her voice as she speaks the former male's name. 'Heck no ma'am, fuck those guys!' the chesty naga exclaims in a brief burst of enthusiasm, only for it die a moment later as hir head sinks into Tiamat's grasp. 'I-I never wanted anything to do with them, and uh my name's not Rameriz either... at least I don't think it is,' shi adds with a dejected shake of hir head. 'Interesting, so you truly have no love for these creatures then?' Shrugging, the snake lightly shakes its head, almost sobbing, 'No ma'am,' as hir chin sinks into the palm of her hand. 'Ah, why is that dear?' Tiamat prods, as she tenderly pats them on the head with her free hand. 'Cause, they-they did things to me...' the titanic herm bleats, tears forming on the edges of their eyes as they seem to melt into Tiamat's comforting embrace.";
	WaitLineBreak;
	say "     'Sh, there-there, you are safe now my precious supplicant, now tell me, what did they do to hurt you so?' the odd human rumbles in an impossible sweet cadence as she wraps her arms about the weeping creature's head and tucks hir chin to her shoulder. 'Well ma'am,' the naga whines, 'not long after the outbreak, the power went out, and all the food in my apartment started rotting, so I started exploring the city looking for something to eat. But ya see, I'm not strong or brave, so I was too scared to really scavenge and I didn't have any money or freecred to trade for supplies either. I looked around for days trying to find real work and eventually I found my way to the dock where I met Hicks. He,' the naga hesitates as a ripple of bestial tension simmers along its visage at the mere mention of the name. 'He promised me a room on their boat and that I could stay on till this whole thing blew over. I agreed, but when I got on board they threw this stinky cum-stained coat on me, told me I was the new Ramirez, then locked me in the hold wrapped in that awful coat while I... changed.' They peep defeatedly."; [this is a Ghazghkull Mag Uruk Thraka and makari easter egg]
	say "     'I don't know how long I was down there Miss Tiamat, but they kept me busy gutting fish, beat me when I took too long, fed me offal and bits of bone they left behind. Eventually, my body finished turning and they let out of the hold. Still, they never let me leave the ship, they said I was part of their crew now until...' The post-human mumbles listlessly. 'Until what little one,' Tiamat inquires with a velvety trill. 'Until this Mink approached the other tenrec crews, said he needed help looting this ship,' they huff, lightly rapping their tail along the deck. 'He'd pay us in gold and military hardware, but the thing was, he rubbed everyone the wrong way, he was always looking down on us, calling us lowborne peasants or [']the help['], no one wanted the job though, except Hicks. He took the job but the other couldn't stand the yuppie, so he dragged me and a few other [italic type]expendables[roman type] along. Honestly ma'am, I don't know what I did to deserve all this. I tried real hard my whole life to keep my head down, and do whatever I was told. What did I do wrong Miss Tiamat?! I did everything everyone told me all my life and look where it got me,' they ask imploringly.";
	WaitLineBreak;
	say "     'You have done nothing wrong little one, this is just the way of things,' Tiamat tuts in a knowing tone as she wraps her hands about hir snout and gingerly strokes their head. 'I have seen this on countless spheres, the strong dominate the weak and in turn grow stronger. The weak submit to the strong in the hopes of protection and care,' she lectures, motioning for them to stand tall. Nodding, the cowed scalie does as bidded as shi presents hirself to the self-alleged goddess. 'Your only failing is serving masters and leaders who could never appreciate the purity of subservience, nor uphold their side of the bargain, but I will, my wayward child. Merely do as I say, sing your praises to me alone, uphold your oath, and I will reward your service in ways you could never dream of,' she hums, locking her smoldering golden with the naga's magenta orbs. 'Uh,' the naga fidgets meekly unable to look away, 'I really-really want to say yes, but I'm pretty useless I don't know what could do help you Miss Tiamat.'";
	say "     'Now-now dread not my pet, even the man who has nothing can still offer his life to me, though in your case I require only your tummy,' she purrs, arching her heels as she stands on the tips of her toes and places the softest of kisses on the flush naga's belly. As a rich pink light spreads out from her lips along the supple equator of hir tummy in a perfect ring, you watch its edges bend then contort into a luminous magenta heart tattoo while the flustered monster herm swoons in submissive delight. 'Ah-ah, so warm wh-what it is this?' shi pants, while wisps of magenta steam coil about hir middle as shi hesitantly touches the glowing borders of hir tattoo. 'A priceless gift,' Tiamat coos, giving her newest pet's belly a loving rub. 'One only bestowed on Seradovah queens such like yourself to remind them of their true purpose; to fill their bodies with my favored servants,' she rumbles in a deep draconic cadence, as her hand drifts along the glistening curve of the marked serpent's voluptuous body till her finger brush the glassy edges of the doting herm's plump sack. 'And in turn to fill others with these same blessings, does this not appeal to you my pet?'";
	WaitLineBreak;
	say "     Seemingly smirking at the thought, the buxom naga leans ever-so-slightly into her touch, crowing, 'Ha, ya know, that does sound kind of nice Miss Tiatmat, and this body does seem made for it. Would be a shame not to put it too good use.' As shi dreamingly gazes at hir new mistress's svelte curves, hir sheath twitches in its lush housing. 'Indeed, and much like my sister's imperial form,' she simpers, motioning to you with a languid wave of her hand, 'the greater your service, the greater your boons shall become, for this is but a taste of majesty that awaits you.' 'Really, you mean that!' the soon-to-be broodmare swoons in a manic cadance, as shi cups hir paws about the milk-stuffed hem of hir stomach. 'Yes, in time you could be a titan second only to my sister,' Tiamat hums, tracing playful swirls about the border of hir lamina. 'Your scales will be harder than diamond yet softer than silk,' she adds as she places her comparably tiny hands over hir. 'Your claws could rend the veil between worlds, and you will never again know fear... so long as keep your faith, my Harbinger.'";
	if intelligence of Galaxite is 0:
		say "     'Harbinger, I think I like the ring of that more than Rameriz Miss T-, er goddess,' shi says with a hasty bob of hir head. 'Then that shall be your new name from this day forth, Harbinger. Who knows, it may yet echo alongside my scale sisters but for you have a job to do. To aid you and in recognition of your new title, I offer these lesser Seradovah to fill and be filled in turn with fresh consorts of Kai Monah's flight and chaff for the road ahead,' Tiamat says, loosing her hold on the curious naga's body. 'But first you must bind these lowly worms to your will, merely shout this phrase and they will be yours, forever. ";
		if perception of Player >= 20:
			say "*Ahem* stupid mortal body,' she mutters under her breath, as she clears her throat. ";
		else:
			say "*Ahem*,' she pauses to clear her throat. ";
		say "'Seradovah-Aam-Quellassa.' Tiamat whispers nearly inaudibly. Nodding, Harbinger turns to hir soon-to-be thralls, magenta eyes roiling with anticipation as shi bellows the words of power, 'Seradovah-Aam-Quellass!'"; [Seradovah-Aam-Quellassa = snake dragons serve harbinger]
		WaitLineBreak;
		say "     At once a sudden almost violent twitch passes over the once placid scalies['] bodies as they jerk and convulse like marionettes caught in a squall, if only briefly as they kneel in unison before your cohort, chanting in a deep hissing octave, 'Nu aam hen klovve! Nu aam Kai Monah! Nu aam Quellassa!' as they touch their heads to the deck. 'Uh Miss T-, sorry I mean goddess, what did they say? I don't think I've ever heard that language before,' Harbinger asks, tilting their own head in confusion as the momentary look of pride drains from their face. 'Nor have many of your kind child, till now, the High Cant is only spoken by the gods and their favored, in time I may deem to teach to it you and my sister, but for now, know that they are merely proclaiming their allegiance to us,' Tiamat preens, fixing her newest toy with a haughty stare. 'Thank you goddess but if I can't understand them how can I, you know, command them?' Harbinger asks, demurely."; [We serve the five heads! We serve the ocean mother! We serve the harbinger!]
		say "     Cocking an eyebrow in aggravation, the warmth seems to drain from Tiamat's visage as her lips curl into a cruel reptilian grimace and for a moment you suspect she might strike the impudent wench. Shrinking at the sight, Harbinger quickly drops to hir [']knees['] mewling, 'I sorry I-I,' as her voice peters off into the breeze. Smirking at the sight Tiamat's expression softens as she sighs in a soft whisper, 'Your full understanding is not required dear, so be content in knowing these are enough to compel them to serve, simply recite the words, speak your demands and they will listen. However,' the alleged god creature hums thoughtfully touching her left knuckle to her lips, 'as your brood grows so too will your understanding, in time the High Cant could come to you naturally and with it many doors will open to you. But,' Tiamat adds as the storm cloud crackles in tune with her voice, 'never forget that these gifts are a privilege, one that can be taken just as easily as it is given, do you understand?'";
		WaitLineBreak;
		say "     'Yes goddess,' shi kotows, vigorously nodding hir head. 'Good my dear, now rise it is time you met my wayward angels. Naxokaazthur aam hen klovve!' Tiamat bellows as the umbral waves roil with the passage of the mighty leviathans. In seconds the air resounds with their bellicose cry as they breach the surface sending a heavy spray of jet black water cascading over the deck and the crowd around your coterie in a line, rumbling, 'Gah hen klovve?' as chains of inky water flow along their imperial frames and regal horns rend the billowing thunder heads while they rise above deck. 'What is your will?' they inquire with a formal bow towards Tiamat and you. Though as their luminous crimson eyes drift over the plush figure of Harbinger alongside the other Seradovha, their posture seems to stiffen as one snarls, 'Seradovah, false dragon, temptress, mindless thralls, traitors!' and pounds the waves beneath them with its tail. 'Duraan Slaan, cursed flesh, whose name is unworthy to echo through the storm!' another growls and bites the air above Harbinger.";
		say "     Howling in fear at the bone-rattling sonic boom created by the snap of the titan's jaws, the massive naga throws hirself at Tiamat's feet like a whimpering pup, screaming, 'Goddess help!' Stepping between them, Tiamat presses the pearlescent nails adorning her left hand to her carotid cooing, 'Now now little wyrms is that any way to greet the newest member of my flock?' Eyes widening in alarm at this odd gesture, the fire drains from the wyrms['] eyes as they dip their heads below the railing while the center dragon mewls, 'No, rosus,' defeatedly. 'Good boys, she raised you well,' Tiamat says mockingly, 'now our task is almost done here but you still have a role in assisting my lovely Quallassa's thralls in gathering [italic type]this[roman type] Kai Monah's plunder. When you have finished the task, you are to escort them,' she pauses motioning to the still-cowering naga, 'somewhere so they may brood in peace and safety.' 'Gah', the brothers bark curtly as they return to their full height.";
		WaitLineBreak;
		say "     'Splendid, now my lovely Harbinger,' the thing once called Galaxite purrs, motioning for her pet to rise, 'gather your thralls, and plunder this vessel in my sister's name!' Happily wagging hir tail against the deck, Harbinger hurriedly scrambles to hir [']feet['] then fixes the still prone nagas with a somewhat curious stare as shi bellows, 'Seradovah-Aam-Quellassa!' 'Gah Quellassa?' the creatures inquire with a harsh, unified, almost mechanical rumble. 'Uh do what Miss,-' shi pauses to straighten hir spine and puff out hir perpetually perky chest, 'I mean do as our goddess commands!' shi hollers in an adorable attempt at a domineering voice. 'Anset unda,' they respond dryly as they silently slither into the hold to begin the long and arduous process of untangling the chaotic mess of crates. Thankfully, their bulky forms seem more than up to the task, as the team of altered ferals wordlessly split up into teams carefully sorting and extract each container with contemptuous ease."; [Anset unda = at once]
		say "     Perhaps, you muse, watching them scavenge and repurpose the former chains into crude pulleys, powered by their reptilian might and shattered booms, these thralls retain a modicum of their former skills. Were this the case, you could easily see yourself claiming a few unfortunate souls in a similar fashion as having access to a legion of skilled disposable slaves could be quite useful. Of course, something tells you that it won't be as simple as getting someone to speak a few words, there must be a trick to it; one you need to puzzle out on your own. Perhaps, if Tiamat creates a few more you might be able to gleam fresh some insights. Regardless, you have plenty of time to ruminate on this as you watch Harbinger gleefully oversee the thralls passing crate after crate to the brother titans; though they appear reluctant to work with these creatures, their combined effort and macgyvered tools quickly empty the hold off it bounty.";
		WaitLineBreak;
		say "[NearlyThere]";
	else if intelligence of Galaxite >= 1:
		say "     'Harbinger, I think I like the ring of that more than Ramirez Miss T-, er goddess,' shi says with a hasty bob of hir head. 'Then that shall be your new name from this day forth, Harbinger, one day I'm sure it will echo alongside my scale sisters but for you have a job to do. But before we get ahead of ourselves dear, I have one last loose end to take care of-,' Tiamat smirks, suddenly turning on the balls of bare heels and swipes her hand in the direction of the aft spire. 'Vix Vell!' she shouts as a wall of raw icy overpressure streams across the deck, kicking up a heavy spray of inky water as it cuts through the little drizzle still raining through and slams into the rails middle, severing a huge section of walking. As it falls, you hear a trio of bawdy androgynous scream as the wreckage along with the well-seeded forms of the sharks are sent tumbling through the air as they grab onto two one another crying out for you to save them."; [vix = wind vell = cut dim = stop drun = bring]
		say "     Though only for a second as Tiamat swings her arm around, forming her hand into a cup-like shape adjacent to her breast, chuckling, 'Vix Dim,' as they come to a gentle stop mere moments from hitting the deck. Dumbfounded, the sharks['] eyes go wide with bestial terror as they gaze listlessly at the alleged god thing as she flips her hand upside down murmuring, 'Vix Drun,' as whatever force holding them eases them to the rain-swept floor. No doubt rattled by the sudden fall and even more abrupt [']rescue['], the sharks make no move to flee and instead simply stare in awe at the sight of your cold-blooded coterie. 'By salt this be yar crew me dragon?!' the captain stammers, as shi almost reluctantly disentangles hirself from the other. Nodding, you quickly introduce Galaxite, er, Tiamat and Harbinger to them then ask what they're still doing here. 'Ah well, we were about on our way but when ya drove off all dem fishy lasses away the blighters darn near trampled us un the wee one's here,' shi says, leveling you with an exploring gaze while she gives hir egg-laden middle an affectionate pat.";
		WaitLineBreak;
		say "     'So we made for higher ground lest we get swept up in the squiggly tide, but once they were gone, yar mate here,' she motions to Tiamat with a worried poke of hir left pointer finger. 'Along with some of the biggest sea beasties I'z ever seen rose from da waves, un not to disturb the good, righteous, most mercifully, benevolent, un,' they add along with a slew of hasty, hollow honorifics you don't even bother listening to, 'Lady. We made ourselves scarce-like in accordance with our promise to ye. So if er,' the captain gulps, 'ya don't mind, me mates un I would like ta leave,' the captain concludes. 'Ha-ha I wise move kin da rune, the Nazokaazthur have little love for your kind, unfortunately I can not allow you to leave with those,' Tiamat crows, golden orbs shimmering with profound interest as they rove across the sharks gravid bodies. 'Yar I mean no offense to me lady, but we wuz promised safe passage, if in ya don't mind we be going now,' the captain titters nervously, as shi eyes the railing.";
		say "     'Ah-ah, naughty mouse, though I would loathe to sacrifice even a single member of my sister's flight, I can not allow you to corrupt those eggs, even if it means sending them and you to the depths of Limbo,' Tiamat tuts, idly flexing her nails before herself. Perturbed, you rumble that these herms and their brood are yours and won't stand by and let them come to harm, not when you gave your word. Perhaps she could merely detain them till such time as they've given birth instead? 'Zen, regrettably sister, these creatures have seen too much for me to simply let them leave, but perhaps a compromise then. Harbinger here,' she casually waves to the chesty naga, 'could use some company while shi broods and these mortals have potential,' she preens knowingly. Curious, you ask her to elaborate. 'Simple my dearest scale sister, bind these creatures to you, make them your priestesses, so that they may spread your name and flight and insure they will never betray us. Their bodies are more than suited for the task,' she teases through a Cheshire smile. 'Er priestess? Me good lady, do me un mine look like we're cut out for the cloth?' the captain warbles, gesturing to hir brood-swollen body and potentially stolen earrings.";
		WaitLineBreak;
		say "     'Oh little mouse, I think you would make a fine [']lay['] person for my dear sister. Besides,' Tiamat coos as strides over to hir side and kneels before them, 'you will not be gathering alms, washing the feet of lepers, or studying some musty tomes, for that is not my way. Instead, empowered by my grace and armored in her love, you will spread our dominion through the seas by tooth and talon,' she simpers as she reaches out and gently cups the shark's face in her hand, evoking a scared yet needy purr from hir as the strange alleged god-creature's luminous gaze bathes hir in their soft golden glow. 'You will pillage the depths in our name, bejewel our halls with all the treasures of this world, and fill this sphere with my angels. In return, I shall extend not only my protection but my blessings too, so what say you, priestess?' she asks, as her eyes dim and she looses her hold on the shark's snout. 'Uh that be a tempting offer m'lady, but ye ain't gonna turn us into snake folk are ya?' the captain queries, casting an apprehensive look at the zombified former tenrecs.";
		say "     'No my dear,' Tiamat shakes her head, 'though the thought had crossed my mind, willful and ambitious souls such as yourselves would make a poor Seradovah. Though in time you may find my many blessings manifesting in ways you will undoubtedly find... pleasing,' she teases, motioning to the chesty herm's lush assets with a languid wave of her hand. 'Aye how so, m'lady? Though I mean no offense, I saw what you did to those lot un any sailor worth their grog knows pacts like these come with their fair share [']O catches un clauses,' the captain inquires in a shrew business-like tone while hir crew nods in quiet agreement. 'Ah clever mortal, then allow me to speak plainly. As your affinity for domination grows, so too will your connection to me. Through this bond, you will become faster, stronger, and gain access to the same words of power you have seen. In time, your powers will become indistinguishable from ranks of TRUE dragons, and you will obtain mastery over not only your form, but freedom from the ravages of time. Please me further and I may even give you your own spheres to rule in my stead. Does that not appeal to you?' Tiamat preens. 'Yar mayhaps it do, but ya taint told me what the catch is yet?' the captain huffs, crossing hir arms defiantly.";
		WaitLineBreak;
		say "     'Perceptive, why I'm beginning to see why my sister likes you. There is a [']catch['] as you call it. Should you defy me or try to leave my service for another god, then I will snuff your soul out with but a thought. Now choose little mouse, either your crew takes their place at my sister's side, or be condemned to wander the ashes of a thousand dead worlds hounded eternally by the laughter of a broken god, I care not which.' she menaces, as she flicks her hand open and a sphere of rippling inky blackness no larger than a man's head winks into being above her palm and levels it with the captain's face. Though, a part of you considers stepping in if only to protect your brood, a quick warning glance from the captain stills such thoughts as shi takes a deep pensive gulp. 'Aye, then I guess we'z got no choice, I eh, we accept yer offer, but on one condition; that ye not force yer [italic type]boons[roman type] on us without,' shi bobs hir head towards you, 'the good dragon's consent,' shi proclaims rather boldly.";
		say "     'Agreed, I will withhold such gifts until my sister beseeches me. Now rise, daughter of waves, you have an important role to play as the nurse maid of dragons and herald of Kai Monahs's cult,' Tiamat rumbles, clenching her fist and banishing the eldritch orb in a puff of inky smoke. 'Kai what? Who in the devil be that Miss T-, ahem, I mean m'lady?' the captain queries, perplexed. 'Ah she never told her true name did she?' The captain shakes hir head in the negative. 'Then it seems I have much to teach you priestess, for now I need you only to speak the words: [']Zu'u aam Kai Monah['] and our pact will be sealed,' Tiamat says tempestuously, bidding the sharks to rise with a haughty flick of her wrist. Nodding, the sharks scamper to their feet, though a worried look still passes between them as the left and right shark mutter something into the captain's ear while they cast worried glances at the alleged god. 'Right, right me mates, I'z ask um,' the captain hums. 'Ok m'lady we got one last question for ya. What happens to us once we do? Not that we don't trust your worshipfulness, but yar compact do be a might,' shi pauses, as a sly smirk coils on the edge of hir snout, 'vague in some spots.'";
		WaitLineBreak;
		say "     '*Fu-Fu*,' Tiamat chuckles mirthfully, 'rest assured under no circumstances shall any changes befall you or be powers thrust upon you, unless my sister requests it,' she crows. 'Fair nuff, ready me hearts?' the captain queries, nervously. 'Aye cap'n' 'Yes captain,' the other sharks reply 'Good, on three den. One,' the lead shark say hir eyes narrowing to frightful pin pricks. 'Two,' the left shark continues, while shi fidgets with hir tail. 'Three!' the shark cries as shi visibly tense up. 'Zu'u aam Kai Monah!' they roar as one while they shut their eyes tight, clasp their hands, and audibly inhale as if bracing for something, yet the moment passes and nothing happens. Relaxing slightly, they let go of one another's mitts and look themselves over, only to find their body unaltered. 'See Kai Sunark, Ocean Priestess, you have nothing to fear,' Tiamat simpers darkly."; [Kai Sunark = Ocean Priestess]
		say "     'Yar-yar right so er what happens now m'lady?' the captain asks. 'Now we finish our task here, this storm will not last,' she rumbles motioning to the swirling clouds above her, 'soon the jealous eyes of my siblings will gaze upon this world more and I'm not ready to tip my hand yet. So we must work quickly, Harbinger!' she roars, shifting hir attention back to the former Tenrec. 'YES GODDESS!' the chesty naga bellows as shi bolts up to hir full height. 'It is time for you and the good priestesses to learn how to command the lesser Seradovah, the process is a simple one; you need only speak this phrase and they will follow your will to their dying breath. ";
		if perception of Player >= 20:
			say "'*Ahem* stupid mortal body,' she mutters under her breath, as she clears her throat, ";
		else:
			say "'*Ahem*, she pauses to clear her throat, ";
		say "'Seradovah-Aam-Quellassa,' Tiamat whispers nearly inaudibly. Nodding, Harbinger turns to hir soon-to-be thralls, magenta eyes roiling with anticipation as shi bellows the words of power, 'Seradovah-Aam-Quellass!'";
		WaitLineBreak;
		say "     At once, a sudden almost violent twitch passes over the once placid scalies['] as their bodies jerk and convulse like marionettes caught in a squall, if only briefly as they kneel in unison before your cohort, chanting in a deep hissing octave, 'Nu aam hen klovve! Nu aam Kai Monah! Nu aam Quellassa! Nu aam Kai Sunark!' as they touch their heads to the deck. 'Impressive, but what in da the name [']O da neath did they say?' the captain chuffs with a loud click of hir tongue. 'Ya, uh sorry goddess but I didn't understand a word of that. Is there a way I can get them to speak English?' Harbinger asks, tilting hir head in confusion. 'No my dear, the minds of lesser Seradovah are too blessedly small for doubt and too rigid to learn,' Tiamat answers with a shrug. 'But how can we order them around if we don't understand them?' Harbinger asks, demeruly. 'Aye da [']lady's['] got a point dare, how do we know these boyos will follow orders if in we'z can't talk to dem all proper-like?' the captain says while hir slightly awe-struck crew bob their heads in agreement."; [We serve the five heads! We serve the ocean mother! We serve the harbingers! We serve the ocean priestess!]
		say "     'You need not understand them to command them little mouse. Your will and intent is enough to compel their service,' Tiamat growls with deep harsh draconic rumble as the storm crackles in tune with visible ire. 'However,' she adds her voice softened to a smooth, velvety cadence, 'my sister's progress thus far has left me in a good mood so allow me to introduce your fellow servants who can serve as intermediaries until such time as I deem you worthy of learning the High Cant of the gods, [bold type]Nazokaazthur aam hen klovve[roman type]!' she howls, lifting her left hand into the air as the umbral water roils with the passage of the mighty leviathans. In seconds, the air resounds with their bellicose cry as they breach the surface, sending a heavy spray of jet black cascading over the deck and the crowd around your coterie in a line, rumbling, 'Gah hen klovve?' as chains of inky water flow along their imperial frames and regal horns rend the billowing thunder heads while they rise above deck.";
		WaitLineBreak;
		say "     'What is your will?' they inquire with a formal bow towards Tiamat and you. Though as their luminous crimson eyes drift over the plush figure of Harbinger along the other Seradovha, and the gravid shark herms their posture seems to stiffen as one snarls, 'Seradovah, mockery of dragons, temptress, mindless thralls,' and pounds the wave beneath them with its tail. 'False unahi, pretenders, vile scavengers of the Kai! Brigands of the lowest order!' a second roars, shaking its head in disgust. 'Duraan Slaan, cursed flesh! Zaan fyn syn, soulless beings!' another hisses, biting the air above Harbinger. Howling in fear at the bone-rattling sonic boom created by the snap of the titan's jaws, the massive naga throws hirself at Tiamat's feet like a whimpering pup alongside the sharks, screaming for protection from the rabid titans. Stepping forward, Tiamat touches the pearlescent nails adorning her left index finger to her carotid cooing, 'Now-now my wayward angels, is that any way to greet the newest members of my flock?' Eyes widening in alarm at this odd gesture, the fire drains from the wyrm's eyes as they dip their head below the railing while the center dragon croaks, 'No,' shaking its regal head in an oddly human display of dismay, 'rosus.'"; [Center Dragon is Nui BTW, you'll never learn his name here though.]
		say "     'Good boys, [italic type]she[roman type] raised you well it seems,' Tiamat says mockingly, withdrawing her nail. 'Now our task is almost done here, but you still have a role in assisting my lovely Quallassa's thralls in gathering [italic type]this[roman type] Kai Monah's plunder. When you have finished this task, you are to escort them,' she pauses motioning to the still-cowering naga and sharks, 'somewhere so they may brood in peace and safety.' 'Gah', the brothers bark curtly as they return to their full height. 'Good,' Tiamat huffs dismissively, then turns her attention back to the others. 'Now my supplicants, gather the thralls and plunder this ship in my sister's name.' Bobbing hir head, Harbinger slithers forward puffing out hir plush chest, only to be roughly shoved aside by the captain as shi strides past hir toward the prone Seradovah bellowing, 'Ah don't hog all da fun lassy, I'z want to give these beasties a whorl. All right ye lot, Seradovah-Aam-Quellassa!' as shi snaps hir fingers. 'Gah Kai Sunark?' the creatures hiss with a near mechanical cadence.";
		WaitLineBreak;
		say "     'Now listen here me boyos, ya heard da good lady, un when yer done yer ta take us ta [bold type]Pirate Island[roman type]. I'z gots score to settle with dem blackguards, now hop to it ya globs, or I has ye flogged for lollygagging!' shi roars, with a haughty wave of hir tail towards the holds. 'Anset unda Sunark!' they shout in a spirited reply as they break ranks. Half their number slither down into the hold to begin the slow and monotonous process of disentangling the horrible jumble of crates lining the lower deck. The rest split off under the captain and hir crew's direction, and start gathering up their former chains and set about jury-rigging and cannibalizing the cranes to set up ad-hok pulleys. Surprisingly, the Seradovah need little instruction, perhaps, you muse observing their toil, they retain some modicum of their former skills. If this is the case, you can easily see yourself creating a few scores of such thralls for yourself.";
		say "     Though you suspect that the process is not as straightforward as Tiamat makes it seem, otherwise it would be a trifling task for her to force more unfortunate souls to speak the words and quickly raise an army of them. Whatever the case, you have plenty of time to mull things over while they work, you ruminate as you step back to give your lessers space to work. Meanwhile, you notice the mewling hurt form of Harbinger coiling about hir mistress's feet with a defeated look in hir magenta eyes. Oddly, despite her at times callus attitude, the alleged god-creature appears to express an almost genuine affection to the overshadowed herm as she dotes upon the massive serpent as one would a beloved pet by patting hir ophidian head, murmuring comforting words to them while the others toil. Hissing happily, the buxom naga coils hir lower half into an emerald bed and offers the strange woman a seat while she waits with an inviting wave of hir hand. Smirking, Tiamat nods and sits herself upon the proffered seat while they chat in muted tones. Scoffing, but in no mood to interrupt them, you instead content yourself with watching the brother titans and Seradovah collect the bounty of this ship for your later perusal.";
		WaitLineBreak;
		say "[NearlyThere]";

to say NearlyThere:
	say "     [italic type]An indeterminate amount of time later[roman type], and the Serdovah have removed the last of the containers with the dragons['] aid, though the great wyrms are reluctant at best to work with them. They nonetheless comply with Tiamat and their minder's directions as they disappear along with a reticent naga beneath the waves to collect their bounty. Though a part of you considers following after them to ensure your due plunder is unharmed, such tasks are the purview of the help not beings of your stature, you muse as you shift your attention to Galaxite, no, Tiamat you correct yourself and ask in a bored tone if she's ready to depart. ";
	if intelligence of Galaxite >= 1:
		say "'In but a moment sister,' she says languidly as she rises from her living throne and motions for Harbinger to stand. 'Now my lovely pet, you have your orders, so go carry them out with all haste and I will be in contact with you shortly. Till then stay close to my sister's priestess.' 'Yes goddess, of course goddess, I won't let you down!' Harbinger rumbles, dutifully yet somewhat mournful, as she reluctantly straightens hirself, slithers to the railing, and leaps into the waters below.";
		say "     'I know you won't, my beautiful pet,' Tiamat coos, eyes drifting toward the captain while her tone hardens just a hair. 'As for you priestess, ensure no harm comes to my precious servant for shi has an important role to play in the coming days, understood?' she says, authoritatively, cocking an eyebrow. 'Aye m'lady, it will be so,' the captain replies with a light bow as shi and hir crew make ready to leave as well. 'Oh and captain, take [italic type]her[roman type] Naxokaazthur with you. Tell them you are their thurri and they along with the Seradovah will assist you to pacify your former lair in our names,' Tiamat interjects, halting the shark in hir track. Positively grinning from ear-to-ear, 'Ah, I was hoping you'd say that Miss, er, Tiamat, consider the island un all its wayward souls yours,' shi preens as shi and hir mates leaps from the deck.";
		WaitLineBreak;
	else if intelligence of Galaxite is 0:
		say "'In but a moment sister, I must bid my new pet farwell, now come dear,' Tiamat beckons warmly to her toy with a regal come-hither gesture. Rumbling happily, the servile serpent slithers forwards to kowtow at its mistress's feet. 'Yes goddess?' shi swoons kissing the deck before hir. 'Though it sadden me, we must part ways for a spell, but fear not [italic type]her[roman type] wyrms will keep you safe while you build our numbers beneath the waves,' Tiamat simpers, as she reaches down to pat hir one last time on the head, 'I regret that I will not see you for some time, but keep faith my child and listen for my call.' Hissing in a pleased reptilian trill, the thrallish naga places hir paws on hir stomach mewing, 'Of course, I promise to put this body to good use, in your name,' as shi languidly pats hir milk-flush middle. 'See that you do, my chosen Seradovah, go find a den and fill the waves with your spawn!' Tiamat crows, as the broodmother-to-be bounds to rail and fixes hir mistress on last worshipful look before diving over the edge.";
		WaitLineBreak; [merge here]
	say "     With the thralls dismissed, the self-proclaimed god turns her attention back to you. 'As for you my great wyrm maker, I hope this lesson was a most instructive one. For now, come along sister, I have a gift waiting for you aboard the little mink's yacht,' she says, pointing in the general direction of the yuppie's pleasure craft and strolls over to the railing. Your interest piqued, you inquire what happened to the puny biped after his... encounter with you. 'Ah the little mouse is secured below the deck of my new ship, though I had considered turning him,' Tiamat says with a casual disinterested shrug. 'He has a role to play in the great game, one that requires his mind to remain intact. Perhaps when I'm through you might enjoy turning him yourself sister, ha-ha,' Tiamat teases. Intrigued, you admit you might, but for now you'd rather see this reward of hers first. 'At once sister, Vix Drun,' she whispers, sweeping her left hand before herself in a wide arc, then clenching her mitt into a fist as her wrist taps her right shoulder.";
	say "     'Come let us depart,' she purrs, dropping her arm to her side as the wind picks up then shifts directions as the sleek silhouette of the impressively-sized luxury ship drifts into view some meters away from the stricken supply ship. Even from a distance, its simple yet elegant design is plain to see as a large single sail peeks from around its ovaloid wheel house painted a dark blue-black while the deck is floored with burnished mahogany that shines with a deep warm glow despite the storm. You muse, watching Tiamat mantle the railing, invoking the High Cant once more, 'Vix Drun,' then steps off the edge. For a brief moment, you almost suspected she would to fall to the waves below, yet, somewhat unsurprisingly, the squall bends once more to her word as the gale gracefully guides her to the deck. Not to be outdone and on some level curious if you can command the Cant as well, you leap into the air blowing the phrase as you stretch your wings. Sadly, the storm refuses your command, yet your growing familiarity with your form is more than enough to compensate for this, as you ride the wild currents after her.";
	WaitLineBreak;
	say "     Though your landing still needs some work, the brief joy of flight and invigorating caress of the storm-kissed air blunts any displeasure that you feel as you come to a skidding stop on the yacht's hardwood deck. 'Ha-ha, a most admirable attempt kin da mun,' Tiamat teases, with an almost mocking clap of her hands, 'but mere recitation is not enough to wield the High Cant, one must truly know its meaning, or resonate with the words. Take heart though, scale sister, as the two of you grow closer it will come to you, but for now kneel before me, let me channel the raging essence of Qunarr within bring you one step closer to your true majesty,' she says expectantly. Though eager to receive your latest boon, after what you just saw aboard the stricken supply ship and having experienced the growing influence of the presence coiling along the borders of your mind, a part of you wonders if aiding Tiamat further is such a wise idea. True, she has kept her word to you thus far, and you have little reason to believe that she'll renege on her deal or betray you, but who knows what the long term effects of these gift might be, or how long you'll be able to resist the presence growing within you.";
	say "     Furthermore, you're under no illusion that Taimat's behavior just now is a one off fluke. Should you keep supporting her more people will likely fall under her yoke, willingly or not. Then again, you've managed to control, if not master, the degenerate call of the nanites and even learned to exploit their twisted gifts from time-to-time, so surely this will be no different? At least if you remain at her side, you might have the chance to steer things in a humane direction, perhaps with her backing you could even blunt some of the damage caused by the nanites and the slow trickle of extra dimensional invaders filtering into this world, or sphere as she calls it. That said, you're under no obligations to this world, or its largely pathetic people, and her offer of godhood remains a tempting one. Now that you've glimpsed what she can do with but a few words, perhaps you should cast all such doubts aside, embrace this path fully, and walk its end. You muse, as Tiamat fixes you with an annoyed impatient stare.";
	WaitLineBreak;
	say "     [italic type]What you would like to do?[roman type]";
	LineBreak;
	say "     [bold type]Note: Choosing: [']Ask to be released from service['] will result in you losing not only your Dragon Breeder body, all perks and stats you have gained, but will remove Tiamat and her servants from the game. This choice is irreversible and will not confer any special rewards or open up any new content.[roman type]";
	LineBreak;
	let Point_of_no_return_Choices be a list of text;
	add "Kneel and commit to the path." to Point_of_no_return_Choices;
	add "Ask to be released from service." to Point_of_no_return_Choices;
	let Point_of_no_return_Choice be what the player chooses from Point_of_no_return_Choices;
	if Point_of_no_return_Choice is:
		-- "Kneel and commit to the path.":
			say "     'What's wrong dear, is something wrong, you seem pensive?' Tiamat asks, cocking an eyebrow at you. Shaking your head, you tell her that it's nothing, just momentary malaise brought about from the long swim here and swiftly kneel before her. 'Indeed,' she says almost skeptically as her eyes drift over your tauric body as if searching for something, 'but take heart you have done well, and more than earned my favor this day. Now,' she simpers, placing her left hand upon your head, 'open yourself to me, pledge yourself to me once more, and drink deep of this blessing, my champion.' Rumbling in the affirmative, you close your eyes, relaxing your guard, and speak the all too familiar phrase again: Zu'u aam ol faal hen klovve uth. At once, draconic strength filters through you as your scales creak and groan while your body swells with raw untamed might and bestial vigor, if only for a moment. As the roiling abyssal energies filtering through you steadily pool about your tendril hair and [bodydesc of player] flanks while you crack an eye open in time to watch as your hair lengthen by the second and spills down past your waist.";
			WaitLineBreak;
			say "     With it comes a rush of virgin sensations as your scales part like some eldritch flower as suction cups, oddly reminiscent of squid girls you just encountered form along their under sides. Strangely, you're liminal mind finds these latest alien additions rather charming as they further highlight your abyssal splendor. Flexing one experimentally, you realize your control has deepened too. True this latest evolution lacks the same utility as your nascent wings, but you find the sight of them enticing nonetheless as a torrent of fresh sensory data flickers through them as your awareness expands outward. You feel as if you could 'see' further than before as you can almost perceive every ripple of the wind and waves around you, you muse while the morphic powers coursing through you begin to settle along your chromatophores, though visibly unaltered, they feel stronger somehow as if their imperial radiance has been magnified. Flaring one small patch of these alien color cells, you're nearly blinded by a dazzling burst of light emanating from your scales.";
			say "     Wincing, at the violent strobe of many colors and none searing you golden orbs, unbidden tears stream down the side of your face as hurriedly shut your eyes with a pained hiss. 'Careful now sister,' Tiamat coos affectionately, her hand glides down the side of your cheek as wipes the errant droplets aside. 'Though this may appear to be a simple boon, you shouldn't underestimate its effects on your foes,' she says, withdrawing her hand and motioning for you to stand. Indeed, you rumble in mixed agreement rising to your full height, though still voice a measure of disappointment at receiving such a trifling blessing. 'Worry not my scale sister, your full reward will come in time, as your body is not yet ready to shed its mortality. Take heart, with each evolution you take another step on the path to apotheosis and soon you shall be ready to take your place at [italic type]her[roman type] side,' she says with an ominous trill.";
			WaitLineBreak;
			say "     Perturbed by her tone, odd inflections, and nebulous goals, you ask Tiamat to elaborate on this and enlighten you what precisely she means to accomplish here. 'All in good time,' she titters with a dismissive wave of her hand, 'but first let us depart. Your plunder awaits, then I shall answer all your questions. For now, Vix-Kai-Drun-Kyr,' she hums, making a show of blowing a puff of air towards the ship's trimmed sail. At her divine urgings, the wind shifts while waves curl as they push the unpowered yacht away from the stricken ship and out to the open water. Once clear, the gale deadens ever-so-slightly while the waves grow in strength and size all around you as a sable swell pushes you towards what you assume to be the shore. Impressive, you remark as despite the heavy resounding crash of the umbral waters and bracing caress of the frost-touched air whipping through your tentacle hair, the boat doesn't feel like it's moving at all."; [Vix-Kai-Drun-Kyr = wind ocean bring bring me to shore]
			say "     'Think nothing of it sister,' Tiamat shrugs. 'Come, walk by my side I have one last thing to show you,' she beckons with a languid wave of her left hand as she turns on her heels and strides towards the front of the ship with graceful predatory gait. Intrigued, you pad up beside her while the ship cuts through the squall at breakneck pace. Nearing the bow, you can already see the outline of the Rocky Arch framed by the ambient glow of the city's few waning lights peeking out of the mist. 'Now my wyrm maker,' Tiamat says, as marches up to the railing and leans against it, 'cast your gaze north towards the twisted place known as the State Fair.' Shrugging, you do as she instructs and watch as the fog recedes, revealing a small sand bar tucked into the cliffs beneath the fairground. Ringed by sharp imposing slate pillars jutting from the surf and battered by inky black waves, the area seems utterly devoid of life; nanite-touched or otherwise.";
			WaitLineBreak;
			say "     Not that you could see anyone visiting such a desolate place, as the nearby sheer cliffs stretching out from the beach appears almost untraversable beyond a few crumbling deer trails snaking through the sun-bleached chert. 'A truly desolate place, is it not? Perfect for storing your plunder,' Tiamat says with a haughty wave of her hand towards the dead patch of sand. Rumbling in agreement, you voice a similar sentiment, though you can see neither hide nor hair of the containers yet. 'They will be here soon, the Seradovah and Tyrants should have them brought to shore shortly, when you are ready, simply meet us there and I shall answer any lingering question you may have, scale sister. Till then, I must take my leave and find a place for this craft before the storm dies down.' Tiamat says, gesturing to the roaring storm clouds overhead with a casual flick of her ear fins. Curious, you ask her what her rush is and why you can't simply remain on board until your just rewards are delivered.";
			say "     'Regrettably kin da mun, our hold on the Kai is tenuous,' she replies, shaking her head in dismay. 'Already the creature wearing the face of Triton chaffs at our violation of its alleged dominion, soon it will come looking for me and I have no desire to reveal your existence to the others until the time is.' Cocking a scalie eyebrow, you ask her to elaborate. 'Another time sister, but suffice to say, our bond is hidden from the gods and mun and must remain so. Fear not though,' she preens through a devilish smirk, 'neither the kinslaying scions of Olympus, gluttonous mongrels of Nyx, Erebus, and Aether, inbred spawn of Ptah, nor the infernal broods of the many hells will be able to detect this should you encounter them. However, they are no fools and if they see you in my presence this will not be the case. Now go, aam ol faal hen klovve uth!' she hisses with a commanding snap of her finger in the direction of the shore as the presence stirs within you urging you onwards.";
			WaitLineBreak;
			say "     Briefly, you consider defying her in a bid to wring more answers out of her, but think better of it, as the storm clouds begin to part and a worried look of genuine panic flickers along the edge of Tiamat's expression. Though as you look deeply into her golden eyes, you realize it's not herself she's worried about, but you as she mouths a single word, please. Nodding, you acquiesce to her urging and leap over the side of the ship with a mighty flap of your wings. Hitting the water, you almost swear you can hear her sighing relief if only monetarily as she hurriedly shouts, 'Vix-Kai-Nurts-Strum!' and claps hers before herself. Instantly, the breeze and current shift again as a blast frigid air slam into the aft section of the ship launching north while kicking up a heavy wall of water in its wake, pushing you roughly towards shore."; [Vix-Kai-Nurts-Strum = wind sea force storm]
			if Strength of Galaxite >= 1:
				say "     Tumbling through the surf end over end, you're unable to follow her course, though the flicker of your eldritch reveals something stirring deep in the umbral pall as a pulse of raging red thrum about the gloom. Dimly, you can almost feel a primal elemental fury coursing about the currents, probing, scratching, baying at the walls of your mind as the water seems to boil you in tune with its crimson wrath. As lancets of the infernal heat sears your scales and abyssal pressure grips your hybrid lungs as the water tightens accusatory hold, a part of you wishes to cry out for help or beg its mercy but you're spared such indignation as the wake crest the shoreline and crudely deposits you on the beach in a sizzling, wheezing heap. For an instant, you lay there, stunned by the touch of whatever primeval forces laid its hands upon you while you collect yourself, all the while watching as the storm surges northwards towards the nature reserve. Unsure what to make of this, you hurriedly struggle to your paws before anyone can see your sorry state and head back to the safety of the Beach Plaza to decide your next move.";
				LineBreak;
				say "[italic type]Congratulations on completing this event! As a reward for thoroughly claiming the captain and all hir crew you will now be given the chance to modify your gender free of cost. Please select your preferred configuration and we'll see you next time on Dragon Raider Galaxite![roman type]";
				LineBreak;
				let Dragon_Dick_Shuffle_Choices be a list of text;
				add "Become a double dicked herm?" to Dragon_Dick_Shuffle_Choices;
				add "Turn into a mono dicked herm?" to Dragon_Dick_Shuffle_Choices;
				add "Change into a female?" to Dragon_Dick_Shuffle_Choices;
				let Dragon_Dick_Shuffle_Choice be what the player chooses from Dragon_Dick_Shuffle_Choices;
				if Dragon_Dick_Shuffle_Choice is:
					-- "Become a double dicked herm?":
						say "     [bold type]Your wish is granted![roman type]";
						LineBreak;
						now cock count of Player is 2;
						if Cock Length of Player < 12:
							now Cock Length of Player is 12;
						now Energy of Galaxite is 3;
						now Strength of Galaxite is 0;
						StatChange "Perception" by 3;
						StatChange "Intelligence" by 3;
						StatChange "Charisma" by 3;
						if "Dazzle" is not listed in feats of Player:
							FeatGain "Dazzle";
						now Point Nemo is resolved;
					-- "Turn into a mono dicked herm?":
						say "     [bold type]Deus ex cockhina![roman type]";
						LineBreak;
						now cock count of player is 1;
						if Cock Length of Player < 12:
							now Cock Length of Player is 12;
						now Energy of Galaxite is 3;
						now strength of Galaxite is 0;
						StatChange "Perception" by 3;
						StatChange "Intelligence" by 3;
						StatChange "Charisma" by 3;
						if "Dazzle" is not listed in feats of Player:
							FeatGain "Dazzle";
						now Point Nemo is resolved;
					-- "Change into a female?":
						say "     [bold type]Benis be gone![roman type]";
						LineBreak;
						now Point Nemo is resolved;
						now cock count of player is 0;
						now Energy of Galaxite is 3;
						now Strength of Galaxite is 0;
						StatChange "Perception" by 3;
						StatChange "Intelligence" by 3;
						StatChange "Charisma" by 3;
						if "Dazzle" is not listed in feats of Player:
							FeatGain "Dazzle";
			else if Strength of Galaxite is 0:
				say "     Tumbling through the surf end over end, you're unable to follow her course, though the flicker of your eldritch reveals something stirring deep in the umbral pall as a pulse of raging red thrum about the gloom. Dimly, you can almost feel a primal elemental fury coursing about the currents, probing, scratching, baying at the walls of your mind as the water seems to boil you in tune with its crimson wrath. As lancets of the infernal heat sears your scales and abyssal pressure grips your hybrid lungs as the water tightens accusatory hold, a part of you wishes to cry out for help or beg its mercy but you're spared such indignation as the wake crest the shoreline and crudely deposits you on the beach in a sizzling, wheezing heap. For an instant, you lay there, stunned by the touch of whatever primeval forces laid its hands upon you while you collect yourself, all the while watching as the storm surges northwards towards the nature reserve. Unsure what to make of this, you hurriedly struggle to your paws before anyone can see your sorry state and head back to the safety of the Beach Plaza to decide your next move.";
				now Energy of Galaxite is 3;
				StatChange "Perception" by 3;
				StatChange "Intelligence" by 3;
				StatChange "Charisma" by 3;
				if "Dazzle" is not listed in feats of Player:
					FeatGain "Dazzle";
				now Point Nemo is resolved;
		-- "Ask to be released from service.":
			say "     'Hm, what troubles you kin da mun, why do you not bow before us?' Tiamat asks, tilting her head at a questioning angle. Shaking your head in a rare instance of self-reflective introspection and lucidity, you realize you can not sit by and support this alleged god-creature anymore, not after you've seen aboard the ship. Mustering all your courage and willpower, you straighten your back then tell Tiamat in no uncertain terms, you're done here, she can keep her damn blessing along with the tainted body, for you can't remain party to such abominable acts. Come what may, you will not allow yourself to be further bound to her or the presence's mercurial will any longer. Seemingly taken aback, Tiamat stares at you with a look of pure bewilderment, but only for a moment as a look of profound sadness blooms on her face. '*Sigh* truly kin da mun, you would scorn my gifts over such trifling concerns?' Tiamat asks, tilting her head at a questioning angle. Trifling to her to maybe, but not you, you huff.";
			say "     'Then it seems my sweet Olivia was right about you all along little, a pity, you and her would have wondrous avatars for us, but alas if you will not serve the five heads then you leave me with few options little mouse,' she tuts, cocking back her left hand while spreading fingers wide then lunges towards you in a blinding blurr with her arm aimed at your throat. Caught off guard by her sudden burst of inhuman speed and the accompanying subsonic boom washing over your senses, you don't even have the time to even consider blocking or dodging her as she barrels into you and sinks her nails about your larynx. Stunned by both the sudden wall of overpressure nearly popping your eardrum and the strength of her superhuman grip, you can only stare at her in pure bewilderment as her hand seems to flow into your scales while your body goes limp. In that instance, the presence surges forward, smothering your awareness in a chittering and maddening tide of umbral coils while Tiamat slams her feet into your [breast size desc of player] chest, knocking the wind out you.";
			WaitLineBreak;
			say "     Helpless, you can only watch in muted terror as she pushes her soles against your upper half while she pulls on your neck will all her might. Oddly though, you feel neither pain or pressure, but a profound sense of tearing course though your body at her sudden bestial attack. In seconds, the sensation intensifies and your vision cracks then distorts as Tiamat rebounds off your tauric body with your throat still clutched in her grasp. At once, primeval fear laced with unbound dread surges through you as she somersaults through the air, as she sails through the breeze, though you catch sight of your still intact tauric body, its golden eyes dimming by the second as it sways listless in the gale. Before you can give this impossible sight a moment's thought, Tiamat lands on the deck with a gentle swishing sound, then releases her hold on you, letting your body tumble to the floor in a rattled heap. Looking down at yourself, your eyes are greeted by the sight of your original body, though you still retain your prior size and ratios, you are once again for all intents and purposes, human.";
			say "     Chuckling at your confusion, Tiamat strides past you to stand beside the soulless husk of your former self crowing, 'Ah would that I could bottle the look on your face, did you think I was going to kill you?' as she turns on her heel to face you. Barely even able to nod as your every frayed nerve suddenly in agony as the biting cold of the and shock of your violent separation from your old body, you reply you weren't sure what she was going but so long as you're free of her, being turned back into human is a small price to pay. 'Well,' she pauses to languidly run her hand down the side of your former self, 'the thought had occurred to me, but in recognition of your service in returning my Olivia to me and the gracious donation of these wondrous nanite's here. I have decided to let you live,' Tiamat says with a haughty reptilian chuckle. Who, you question. 'Ah silly me, you never told them your real name, did you dear?' she says as her eyes drift over your shoulder. Following her gaze, you worriedly look behind only to have your eyes be met with a sudden burst of ghosty white light and a tittering jeer, 'BOO!' The blinding flash crows as you wince reflexively while blinking tears from your eyes.";
			WaitLineBreak;
			say "     As your vision clears, the pale alabaster light coalesces and shifts into a second translucent grinning Tiamat floating on her stomach with her chin proppeed neatly in the palms of her hand while she playfully fans her legs behind herself. Utterly flabbergasted, you can only mutter a single question. Olivia? 'In the flesh, er,' she hesitates a moment to flex her left hand before her own ethereal face, 'ectoplasm I guess,' she says as she levitates past you to Tiamat's side. 'See T.,' she preens coming to a stop next to the alleged god-things left shoulder, 'I tried to warn you, they weren't up for this,' they add motioning to you with a dismissive wave of her right hand. 'Indeed, you did my [bold type]FAILED[roman type] avatar,' Tiamat grumbles, grinding her teeth in aggravation. 'Daw T., you're not mad at widdle old me are you?' Olivia simpers sweetly as she rolls onto her back and leisurely floats above you. 'No my dear,' Tiamat sighs wistfully, shaking her head, 'as ever you have been a faithful, if willful servant. Still, with no others to claim the mantles of Kai Monah and Hen Klovve, I fear I have no further use for this world,' she rumbles dejected.";
			say "     'A pity,' she tuts idly casting her gaze hither and thither, 'for all its flaws, I would have liked to preserve this place and its peoples from the coming doom, in my own way.' Coming doom what is she talking about, you question. 'Silly mouse, like many of your kind, you are truly blind to the world around you. Tell me, how long do you think the other gods or devils will sit quietly in their little corners content to play their own games? How long do you believe the horrors stalking your sphere will remain content in their current hunting grounds?' Tiamat lectures, motioning to the vague direction of the city with a casual flick of her ears. Confused by her words, you ask her to elaborate. '*Sigh*, foolish creature, perhaps your short-sighted kind deserve their fate so heed my words well little mouse!' She roars, pointing an accusatory finger at you.";
			WaitLineBreak;
			say "     'One day, your world will fall, either by the hands of jealous gods seeking to expand their dominion, the ravenous appetites of the infernal hells, the unholy touch of transcendental horrors, or swallowed whole by the yearning maw of Limbo all because you lacked the faith and will to follow me. For I would have delivered your sphere from this doom, remade it into a realm of perfect order ruled over by you and my loyal Olivia forevermore! But no kin da mun!' she spits, stomping her left foot against the deck. 'You lack the ambition, faith, and stomach to make the hard choices necessary for salvation unlike,' she swoons, all the fire draining from her voice as she tilts her head upward to watch the reclining form of Olivia drift above her, 'you my child,' she adds beckoning Olivia to her side with a come-hither flick of her fingers. Nodding, the ghostly image of Olivia floats down and kneels before her fleshy counterpart, humming, 'Yes T.?' in a sweet honeyed tune. 'You alone have shown the spine and flexibility needed to survive and thrive in this sphere, for this I offer you the chance to continue service to me and take up the mantle of Kai Monah. So tell my child, what say you? Will you remain here to idle away what little time this world has left, or will you join me and become the dragon you always dreamed of being?' Tiamat purrs, motioning the mindless husk of your Dragon Breeder body behind her.";
			say "     'Wait really?! I'd love to! But-,' she exclaims, her eyes alight with wonder as she gazes longingly at your cast off shell. Merely to have her tone darken seconds later as her translucent head drops her chest as she croaks, 'Damn it, I can't leave boys here T., they need their mommy, and I-I-I need them,' as she punches the deck in dismay though her strike produces no sound or impact. 'I did all this for them, so they could be free and we could be together forever like you promised!' she sobs, ghostly tears streaming down her face as she fixes her doppelganger with an imploring look. 'I have not forgotten my loyal dragon mother,' Tiamat coos, as she kneels beside the translucent woman wraps her arms around her ethereal head, 'they will be free to join us and recognition of service thus far, I shall altered the oath, no longer shall Naxokaazthur or Ullokinne be bound to my will. But yours instead,' she adds, patting the see-through woman's hair. 'Really T., you mean it?' Olivia asks, her tone brightening. 'Yes child, but I have but one stipulation,' she says, her hands drift down along Olivia's supple hourglass curves as she gently fondles her svelte middle.";
			WaitLineBreak;
			say "     'You will be tasked with expanding my broods with all manner of wyrms. I warn you though, it will not be an easy task. Your every day shall be spent in the company of innumerable dragons endless fighting for the chance to claim your womb for their own, so their kind may play their part in the great game of the gods and earn my favor. While your nights will be filled with the ecstasy of birth and the eternal attention of scores of supplicants waiting on your every need. Now I ask you again, will you serve as the five heads commands and take your place at my side, or throw your lot in with a doomed species?' Tiamat intones, as she rises to her full height to await Olivia's reply. 'Mh, that's a tough choice T.,' Olive chuckles through an amused Cheshire smile, 'either get stuck on this rock waiting to die with the rest of the dumb monkeys, or spend the rest of my days playing with every flavor of dragon in the multiverse with my boys,' she rumbles, pawing at her toned tummy.";
			say "     'Indeed, so what say you Olivia or should I say, Kai Monah?' Tiamat simpers expectantly. Bobbing her head, Olivia touches her forehead to the deck in deep reverent kowtow, whispering, 'Zu'un aam ol faal hen klovve.' 'Well spoken Kai Monah, now go claim your mantle while I deal with the kin da mun,' Tiamat says, whipping her left arm toward the churning storm lashed sea. A sudden ripple passes through your old tainted shell, as the soulless body jerks to and awkwardly prowls over the side of the yacht. Seemingly blind and lacking any manner of awareness, your unwanted body hits the railing with heavy thump, yet still keeps prodding till this timbers break and it goes plummeting to the ocean below while the ship, still carried by the waves, sails on without it. Yelping in alarm, Olivia swiftly dives in after it while Tiamat redirects her attention to you. 'As for you little mouse, begone I have no further use for you or this damned world, but feel free to stay and watch the show, or crawl under a rock like the rats your kind descends from! I CARE NOT WHICH!!' she hisses with a snap of her fingers before you can utter a single word in reply as the world goes dark and reality melts away into a gray fog.";
			WaitLineBreak;
			say "     You're assailed by an overpowering rush of vertigo as images of a distorted cityscape cast in a low red glare populated by malformed creatures tumble past you. Though undeniably alien at first, the familiar, yet impossibly warped places whizz past as here and there you spy the corrupted images of Trevor lab, its cement walls replaced by innumerable rotting bestial hides coated in weeping sores oozing yellow-bile while wyverns fly through the air in reverse around it. Pictures of the State Fair shrouded in mist and various plushie and latex creatures, their unnatural bodies swollen with twitching masses of pale pulsating fungi dancing arm and arm in a great chain through its gloom-touched pathways singing in broken electronic voices. 'Cyn loves you! cYn LoVeS YoU! CyN 10VE$ y0u!' in an endless loop. Seemingly oblivious to the decay consuming from the inside, they never cease their plague waltz even as their peers disintegrate into gibbering puddles of ooze. While a kineograph of the bunker flickers, littered with floating huskies, their arms stretched to their sides in crude [']T['] poses blitz past you till at last the feeling leaves you and the fog recedes as you appear on the beach along with all your equipment.";
			if Strength of Galaxite >= 1:
				say "     Though the storm still rages about you, and bereft of your draconic splendor, the biting cold swiftly tears into your extremities, forcing you to retreat back to the meager shelter of the boardwalk, rather than risk frostbite. You think to yourself as you dash over the ice-slicked sand leading to the rows of temporarily abandoned stalls, hurriedly ducking between some of the more sturdy looking kiosks. Nestled between the trash and frost-laden structures, you curl up into a pitiable ball to conserve heat while you wait for the storm to blow over rather than tempt fate, elements, or the predation of opportunistic ferals by marching into the tail of a near blizzard in search of better cover. Fortunately, the storm begins to peter out as time goes by as cracks gradually appear in the sable squall as rays of natural light filter over the bay. All the while, your nanites['], likely reacting to the cold, appear to be adapting to some limited degree as the chill recedes to a more bearable level and color returns to your extremities.";
				say "     Eventually, the gale dies and the last remnants of the thunderhead are blown away as a tranquil faux mediterranean heat wafts across the sandy shores, erasing all signs of the eldritch weather. But not entirely, the rocky cliffs are still pot marked with fresh cracks left by the unnatural squall while scabs of vermillion dust litter the pristine white sand. In time though, these too will be washed away as erosion, the tides, and inevitable march of time assert their dominance once more, yet gazing at them, a part of you can't help but ruminate on Tiamat's warning of a coming ragnarok or further invasion of extra dimensional terrors. Perhaps, her words were idle treats, yet you can't shake the lingering kernels of doubt remain wedge in your nanite-tainted mind, only time will tell though, for now you decide to simply refocus you on the more immediate concerns like your survival.";
				LineBreak;
				say "[italic type]Congratulations on surviving this event, as promised you will now be able to alter your gender configuration free of cost. Please select your preferred configuration and thanks for playing Dragon Raider Galaxite![roman type]";
				LineBreak;
				let debby_duck_swap_Choices be a list of text;
				add "Double dick herm?" to debby_duck_swap_Choices;
				add "Mono dicked herm?" to debby_duck_swap_Choices;
				add "Normal female?" to debby_duck_swap_Choices;
				let debby_duck_swap_Choice be what the player chooses from debby_duck_swap_Choices;
				if debby_duck_swap_Choice is:
					-- "Double dicked herm?":
						say "     [bold type]Your wish is granted![roman type]";
						LineBreak;
						Humanify_Player;
						StatChange "Dexterity" by -3;
						StatChange "Strength" by -3;
						StatChange "Stamina" by -3;
						if "Dazzle" is listed in Feats of Player:
							FeatLoss "Dazzle";
						FeatLoss "Flash";
						FeatLoss "Toughened";
						now Energy of Galaxite is 0;
						TraitGain "Deb" for Player;
						now cock count of player is 2;
						if Cock Length of Player < 12:
							now Cock Length of Player is 12;
						now Strength of Galaxite is 0;
						now Point Nemo is resolved;
					-- "Mono dicked herm?":
						say "     [bold type]Deus ex cockhina![roman type]";
						LineBreak;
						Humanify_Player;
						StatChange "Dexterity" by -3;
						StatChange "Strength" by -3;
						StatChange "Stamina" by -3;
						if "Dazzle" is listed in Feats of Player:
							FeatLoss "Dazzle";
						FeatLoss "Flash";
						FeatLoss "Toughened";
						TraitGain "Deb" for Player;
						now cock count of player is 1;
						if Cock Length of Player < 12:
							now Cock Length of Player is 12;
						now Energy of Galaxite is 0;
						now Strength of Galaxite is 0;
						now Point Nemo is resolved;
					-- "Normal female?":
						say "     [bold type]Benis be gone![roman type]";
						LineBreak;
						Humanify_Player;
						StatChange "Dexterity" by -3;
						StatChange "Strength" by -3;
						StatChange "Stamina" by -3;
						if "Dazzle" is listed in Feats of Player:
							FeatLoss "Dazzle";
						FeatLoss "Flash";
						FeatLoss "Toughened";
						TraitGain "Deb" for Player;
						if cock count of player > 0:
							now cock count of player is 0;
						now Energy of Galaxite is 0;
						now Strength of Galaxite is 0;
						now Point Nemo is resolved;
			else if Strength of Galaxite is 0:
				say "     Though the storm still rages about you, and bereft of your draconic splendor, the biting cold swiftly tears into your extremities, forcing you to retreat back to the meager shelter of the boardwalk, rather than risk frostbite. You think to yourself as you dash over the ice-slicked sand leading to the rows of temporarily abandoned stalls, hurriedly ducking between some of the more sturdy looking kiosks. Nestled between the trash and frost-laden structures, you curl up into a pitiable ball to conserve heat while you wait for the storm to blow over rather than tempt fate, elements, or the predation of opportunistic ferals by marching into the tail of a near blizzard in search of better cover. Fortunately, the storm begins to peter out as time goes by as cracks gradually appear in the sable squall as rays of natural light filter over the bay. All the while, your nanites['], likely reacting to the cold, appear to be adapting to some limited degree as the chill recedes to a more bearable level and color returns to your extremities.";
				say "     Eventually, the gale dies and the last remnants of the thunderhead are blown away as a tranquil faux mediterranean heat wafts across the sandy shores, erasing all signs of the eldritch weather. But not entirely, the rocky cliffs are still pot marked with fresh cracks left by the unnatural squall while scabs of vermillion dust litter the pristine white sand. In time though, these too will be washed away as erosion, the tides, and inevitable march of time assert their dominance once more, yet gazing at them, a part of you can't help but ruminate on Tiamat's warning of a coming ragnarok or further invasion of extra dimensional terrors. Perhaps, her words were idle treats, yet you can't shake the lingering kernels of doubt remain wedge in your nanite-tainted mind, only time will tell though, for now you decide to simply refocus you on the more immediate concerns like your survival.";
				LineBreak;
				Humanify_Player;
				StatChange "Dexterity" by -3;
				StatChange "Strength" by -3;
				StatChange "Stamina" by -3;
				if "Dazzle" is listed in Feats of Player:
					FeatLoss "Dazzle";
				FeatLoss "Flash";
				FeatLoss "Toughened";
				TraitGain "Deb" for Player;
				now Energy of Galaxite is 0;
				now Point Nemo is resolved;


Table of GameEventIDs (continued)
Object	Name
Loot Boxes	"Loot Boxes"

Loot Boxes is a situation.
ResolveFunction of Loot Boxes is "[ResolveEvent Loot_Boxes]". It is inactive.
Sarea of Loot Boxes is "Beach".

to say ResolveEvent Loot_Boxes:
	say "     Figuring enough time has passed for Galaxite's brood to have finished dropping off your haul from the Break Water Heist, you decide to set out on the long hike towards the craggy hills and over to the secluded cove Galaxite pointed out to you on her yacht. Though the path itself is little more than a thin strip of chert worn smooth by the passage of innumerable hoofed creatures, or the uncaring kiss of the elements, it seems, at least for a moment, to be clear of prying eyes or ferals. You muse, following the winding zig-zag trail as you drift away from the beach and closer to the State Fair, the path seems to widen as the steep cliffs give way to the roiling azure waves lapping at the thin stretch of hidden sandbar covered in rows upon rows of black shipping containers intermixed with a few red ones. All of which appear to be unopened, you note as you pick your way down the hillside, you spot Galaxite, still wearing nothing more than her scuba bag and blue string bikini doing a playful series of cartwheels along their damp seaweed encrusted edges. Though you don't see any sign of her leviathans, you suspect they are likely swimming below the surf as you call you to her. 'Oh hey [Name of Player]!' she hollers mid flip as she grasps onto the side of the container with her right hand while she cheerfully waves at you with her left.";
	say "     'It's good see y-,' she stammers as she tips just a hair too far to one side, then goes tumbling off. '*OOF*', she grunts as she lands head first onto the wet sands, with a loud thump, then goes still. Oh shit Galaxite! You roar, fear piercing your heart like an icy blade, as you dart forward, ready to render whatever aid you can. Only to witness her rise, neck twisted well past her shoulders at an unnatural angle as she mutters, 'Oh, I'm ok, I'm ok,' as she rolls herself into sitting position with a sickly pronounced lurch, grabs hold of her head and snaps her neck back into position with a wet crack. 'Ah, sorry about that cutie,' she simpers in an oddly cheery tone as leaps to her feet. 'Hope the climb wasn't too rough on you.' Shrugging, and doing your best to hide your shock, you tell her that it was nothing special and sprint on over to her. Once you're at her side, you ask if she's really ok, that was a pretty nasty fall. 'Heck ya I am, that was nothing compared to the time someone dropped a road roller on me, or when an I.E.D shot me through a roof.'";
	WaitLineBreak;
	say "     Wait she what now, you stammer at her insane claim. 'What? It's no biggie kin da mun,' she says, her face alight with mischievous glees as she dismissively waves her left hand before herself. 'We're all darn near immortal, as long as well-,' she pauses to nervously click her teeth, 'we don't starve to death. Why, I've been set on fire by an ebonflame spawn, staked to a telephone pole with rusty razor wire by an angry spartan on top of the dam, had a Behemoth use me as a sounding rod, been dissolved into cum by a wyvern, and eaten by Sierrasaur.' She chuckles, counting off each experience on her left hand in a jovial sing-song tone. Shaking your head as if to clear it, you inquire if she's serious. 'Sure am silly, I don't know why people are stressing over the whole [']dying['] thing. The worst that ever happens is you just wake up a few days later with a hangover then boop you're back to normal.' She beams as she takes off her pack and pulls out a miniature version of a hydraulic rescue tool sometimes called the [']Jaws of Life.['] 'Anyways, here take this and let's get to it, these loot boxes don't open themselves!' Galaxite says, pressing the tool into your hand.";
	say "     Shrugging and unsure how to respond to such insane assertions, you hastily look over the contraption and see that it consists of a heavy metal handle sort of like the kind you've seen on handheld vacuum cleaners or leaf blowers, which likely contains the thing's motor. A rubberized foregrip affixed to the frame connects it to a deadly-looking set of flat metal pincers. Flipping it over a few times, you don't see any signs of an exhaust system or fuel reservoir though, so you assure the thing is battery powered. Quite the find, you note and ask where she got it from. 'I stole it from the back of a fire truck not too far from Fire Station 69. Ya it was covered in dal cum when I found it, but,' she pauses to tap the side of the contraption with her knuckles, 'still works.' Lucky find, you quip as you prime the thing and get ready to start cutting. You notice out of the corner of your eye, Galaxite pulling a huge clear sandwich baggie filled to the brim with a silvery metal shaving out of her pack. ";
	if Intelligence of Player >= 20:
		say "Is that thermite, you ask, recalling how Galaxite said she has some on hand a while ago. '*Ha-ha* good eye [name of player], you have no iead how long I've been waiting to use this stuff,' Galaxite smiles, shaking the bag once.";
	else:
		say "Hey what's with that metal stuff, you inquire. 'Thermite, oh you have no idea how long I've been waiting to use this stuff,' Galaxite smiles, shaking the bag once.";
	say "     'The others would never let me set this stuff off before, but screw them, they're not here to stop me this time!' she titters watching the silver metallic sand dance in the available light. Why'd they stop her before, you ask. 'Oh some boring old noise about it not being safe,' she says, rolling her slitted eyes. '*PFT* Don't know what they were on about though, it's not like I'm gonna burn the whole city down with this one itty-bitty-baggy!' she laughs, pulling out a black handheld blowtorch and a fist-sized spool of what you assume is magnesium ribbon. Fair enough, as long as she doesn't set any of that off near-, you start to reply only to have your words drowned out by the hissing of her torch. 'Oh sorry, what was that?' she asks, as she gazes longingly at the streak of blue flames issuing from her tool with a goofy cross-eyed look. Nothing, you tell her with a playful roll of your eyes as you set about cutting open the many rows of rusted padlocks and warped latches. You can hear Galaxite laughing with glee as she sets off dozens of thermite charges in the background. The area resounds with choir of destruction for the better part of an hour as the pair of you cut your way through countless locks.";
	WaitLineBreak;
	say "     Once the last one has been disabled, you and Galaxite decide to crack open one of black ones first; you each grab a door and pull, though it initially refuses to give. You have the smart idea to grab a large piece of flotsam wood and use it as a lever, with added toque alongside a touch of clever positioning, the thing finally gives way as a rush of sea water spills out at your feet. Well so much for that hermetic seal Galaxite was going on about, you muse as the two of you peer inside the crate. You're greeted by an odd sight, rows of unlabeled medical equipment hooked up to dozens of heavy metal gurneys lay scattered throughout the waterlogged storage unit while pools of moldering syringes and half dissolved pills slosh about the rust tinted waters. 'Now what in Tiamat's name is going on here?' Galaxite mutters, as you two look over the strange container. Your first impression is that the thing looks like it is or more accurately was a mobile I.C.U or isolation ward then simple shipping crates as you spy a number of tattered clean suits and clear plastic room dividers strewn about that area. 'Hey [Name of Player] what do you make of this?' Galaxite asks as she wheels one around and points to the heavy solid metal restraints welded to its frame.";
	say "     Shrugging you tell her, maybe the government, or a company with more money than sense was trying to evacuate an infected V.I.P. No way a normal person would need this level of restraint, you note trying to give the wrist cuffs a shake. Tough as you are, they don't budge, no matter how hard you try though. 'I don't know about that [Name of Player], there's no padding on this thing, it doesn't even have room for a bedpan.' Galaxite says as she leans down and motions for you to try crushing one of the cuffs with the Jaws of Life, to no avail as your power tool can't even make a dent in the silvery metal. 'Titanium-Rubidium alloy too from the looks of it, must have been expensive to make, and look,' she adds gesturing to what looks like a combination of an E.K.G and an autonomous I.V. device tucked under the gurney's frame. Unsure what to make of it, you ask Galaxite if she can shed some light on it. 'Well,' she hums with a light flick of her ears, 'I've seen something like this when I did a stint at Herrick Hospital after buying some bad acid in the Presidio, huh, or was it the [italic type]really[roman type] good acid at People's Park?' she adds wistfully, tapping her left pointer finger against her chin.";
	say "     'Eh, anywho, it was meant to keep some of the more eh, vocal patients quiet, hm,' she murmurs, kneeling and fiddling with the contraption as she unhooks an undamaged sleeve of some clear yellow chemical slurry. 'Now what are you little guy,' she says in an inquisitive tone as pricks the tube open and she squeezes out a few drops of the odorless fluid on her left pointer finger, then proceeds to wipe a drop on her gums. 'Mh,' she hums as you watch in abject disbelief at her brazen, devil-may-care attitude towards her own health, 'Tastes like Special K, Diphenhydramine, yellow number five, and-,' she pauses to take another lick, 'ooowww Tizanidine, Mommy likey! Don't know who whipped this up, but they really know how to throw a good slumber party!' she titters in open admiration as her eyes begin to dilate and her shimmering golden pupils are swallowed in a sea of velvety blackness. 'Oh hello there, now what are you?' Galaxite remarks, with an inquisitive bob of her head, motioning to one of the far off corners of the gloom shrouded container with a wave of her left hand."; [These chems are muscle relaxants, downers, sedatives, and an illegal in europe food dye, no idea if NZ bans yellow 5 or not cause I'm too lazy to check.]
	WaitLineBreak;
	say "     Following her gesture, if only to humor her, your eyes are greeted by only a vast curtain of inky blackness shrouding the rear of the container in an oppressive umbral pall, yet as your vision adjusts, you can just barely make out a misshapen light brown lump bulging out of the corner of the crate. Curious, you stride forth, with Galaxite in tow, picking your way through a pile of moldering medical supplies and random ocean detritus, till you reach the back and spy a lump of light brown waxy plastic affix to black rectangle piece of plastic no larger than a man's hand adhered to the wall. Though it takes you a moment to place a name to the odd substance, till it hits you, oh crap C-4! You exclaim with a mix of fear and surprise as a rising urge to flee nips at the back of your mind. 'Ah don't worry about it [Name of Player]. That stuff can't go off, look, detonators fried,' Galaxite remarks as she casually walks up and pulls the lump of explosive off the wall then motions the waterlogged L.E.D screen affixed to its surface. 'See, guess someone cheaped out and forgot to waterproof this.' Eyeing the thing with an air of incredulity, you ask if it's really safe to handle that. 'Well, it could still explode if you ran some but juice through it, but it's pretty much harmless like this,' she adds with a shrug as she tosses it over her shoulder like a wadded up gum wrapper."; [Fun fact: C-4 can be set on fire, shot, dropped, and it won't go off. In a pinch, soldiers are even trained to use it as emergency fuel for fires. Also you can smoke it in a pipe but it rots your brain/lungs and it's highly addictive according to my mil contacts.]
	say "     'Oh well, let's see what the other crates have in them,' she remarks as she heads over to another black container and motions for you to join in. Flashing her the thumbs up sign, you grab your bits of driftwood and repeat the process on the other black crates. Much like the first one you opened, each one has a similar set up though the gurneys are different. Some appear to not only be far larger than any normal person could ever be but have between three to five sets of restraints on them while others have some manner of clear plastic blisters attached to them. Disquieted by your find, you realize the true purpose of the boat you just raided. It wasn't here to bring in supplies, deliver aid, or extract some V.I.P, it was here to capture mutants for study or sport though, you can't be certain. 'Damn fu-,' Galaxite hisses as she bites her tongue, 'flubbing idiots, I can't believe I'm saying this, but thank the gods they went down like they did! Can you imagine what would happen if the nanites breached quarantine!? This thing would be global by now!' Galaxite grumbles, idly kicking the sand in aggravation. Nodding in agreement, you can't believe the bullet the whole world just dodged.";
	WaitLineBreak;
	say "     'Ya,' Galaxite sighs, her ear fins sagging melancholically then shoots right back up as she continues, 'anywho, let's check the red ones,' in an overly enthusiastic tone. Oh what the heck, might as well, you reply grabbing you the bits of driftwood. You and Galaxite head over to the nearest red container and wrench the thing open. This time though, the doors open with a gust of overpressured stale atmosphere instead of a deluge of seawater revealing dozens, if not hundreds of sealed cardboard boxes packed to the ceiling in tight rows. 'Now this looks promising,' Galaxite says as she tears into several of them and pulls out a handful of plasticized brown paper bags. 'Nice M.R.Es, water purification tablets, condoms, antiseptics, feminine hygiene stuff, now this is what I'm talking about!' She grins, reading off the printed black labels one at a time. 'Come on [Name of Player] let's open some more, I got a good feeling about this!' Galaxite says, as she sprints off the next red crate. Following along behind her, you go through the motions of jimmying the last few remaining containers.";
	say "     You're happy to find each is host to a plethora of consumables, including fuel, painkillers, chocolate, toilet paper, coffee pods, and a few packs of cigarettes. You even find a bottle of hand sanitizer. All of which you're sure people would pay very, very, good money for during this pandemic, you muse, as you take in the sheer bounty of supplies the two of you are accumulating. Once you tear open the last container though your jaw almost drops as the whole thing is stuffed with guns, sweet glorious [bold type]GUNS[roman type] neatly secured in black metal mesh cabinets affixed to the wall. 'Jackpot!' Galaxite exclaims as she grabs a rifle off the rack and brings one over to you for inspection. Giving it a hasty once over, you realize these aren't normal firearms, these are PHASRs (Personnel Halting And Stimulation Response Rifles)!";
	WaitLineBreak;
	say "     A rather famous type of non-lethal, albeit very illegal, directed energy crowd control weapon developed and later abandoned by the U.S. Department of Defense. To your eyes though, they look like some kind of sci-fi gun taken right out of a movie, as the full-sized rifle has a shapely ergonomic stock, flowing almost organically into a sleek barrel with absolutely unnecessary muzzle breaks built into the side. They even have a light up red, white, blue toggle for the beam's intensity, you note watching Galaxite flip the thing on. 'Oh this looks so cool! Here [Name of Player] you should be the first to try firing it at one of these egg sacks,' she says, pointing to the squid egg pods still attached to the side of one the container. Really? you ask. Galaxite merely smiles and nods knowingly. Sweet, you almost moan in pure Americanized joy and flip it all the way on, you can feel the thing purr in as its reactor pulse to life in your hands.";
	say "     Oh you are going to enjoy this, you muse, toggling the Phaser to full power, take aim, then fire at the egg sack, unleashing a blinding stream of dazzling polychromatic light erupts from the gun. It hurts to look at but boy it is beautiful, you opine, watching the egg sack shrivel under the concentrated hypnotic barrage of enhanced photons. You bet that you could pacify anything short of a god with this bad boy, and not even leave a scratch on them. Best waste of taxpayer money ever, you swoon as you release the trigger. 'Ow he-he-he pprrreeettttyyy, mh I think I know what doing tonight,' Galaxite remarks in an odd almost dissociated tenor, then briefly casts her gaze back to the containers full of chems. 'Now lets see what else they got in here,' she says, in a much more level tone as she rifles through the gun locker. 'Uh what is this,' Galaxite asks as she pulls out something that looks like a subwoofer welded to were the weapons magazine port should be, covered in heavy watt wire running along the base.";
	WaitLineBreak;
	say "     You tell her you have no idea, but you have no problem looking it over. 'Ok,' Galaxite replies as she hands the strange gun. Giving it a once over, you find the rifle to not only be supremely heavy and unwieldy as a large radar dish or some manner of speaker has been affixed to the barrel. There's no magazine port or sign that it plugs into any sort of external system, much like the P.H.A.S.E.R, it must run on an internal power supply. You muse flipping the alien weapon over in your hand to inspect the rest of it. Your fingers brush an engraving on the handle that reads: [italic type]Mk.I Microwave Amplification Device[roman type]. Odd, you muse and show it to Galaxite. 'Wait microwaves... oh clever monkeys,' she says, clicking her tongue. Clever how, you ask. 'Right, so I don't know how common this knowledge is but the nanites can't really handle microwave emissions. Give someone a good jolt of this,' she quips, tapping her nails on the rifle's housing, 'and you could stun the nanites, from what I've gathered, most mutants need the nanites to hold themselves together, so this is basically ricin in gun form to them.' Wouldn't that kill them, you inquire.";
	say "     'Nope, it's probably temporary at best, if that weren't, don't you think the military would have set off a low orbit nuke or two and just be done with it?' Touche, does she want you to fire it? 'No thanks, I still have a few more lockers to search back here,' Galaxite replies in a good-natured tone as she rifles through the containers. She pulls out a set of rubberized black body gloves with yellow paneling on the chest, forearms, and glutes. 'This is new. I knew the military was super puppy play coded, but I never took them for latex fetishists. Wow, even comes with boots and a helmet,' Galaxite trills, tossing the item of clothing your way. Catching it, you look the thing over and wonder aloud what it could be for. 'Well I have an idea,' Galaxite says, pulling out another body glove. 'This suit might block EM waves, considering everyone who comes here is infected, this could be shielding for whoever has to use that gun we just found. Looks pretty durable too,' she says, yanking on one of the sleeves to no effect.";
	say "     Maybe but you're not going to test it, you reply. 'Ha good call, you might wind up sterile, or pregnant for the rest of your life, never know these days,' Galaxite chuckles as she digs through a few more boxes full of suits, power bricks, and fold out solar panels. None of which she seems particularly interested in, if anything she seems rather annoyed, muttering, '*Grr* Come on, where are you hiding little guys? I know you're here somewhere! Homaru and Sidorovich have never been wrong before,' under her breath as she frantically rips through the boxes searching for who knows what. You watch her pile up munitions and materials behind herself as rips the place apart till she finds a small nondescript gun-metal gray suitcase tucked underneath one of the mesh lockers. To your eyes, the laptop sized case appears to be a solid piece of congruent metal created through either explosion or friction welding. The surface appears to be completely devoid of buttons, latches, or keyholes leading you to believe it's either opened with a fob or some hidden pressure points, you muse watching Galaxite fumble with the container.";
	WaitLineBreak;
	say "     'Ha found you little so and so,' she rumbles in a deep, pleased, draconic tone as she pounces upon it like some kind of beast pinning its prey, panting happily. 'You are going to make me so rich!' as she kicks and paws at the container searching for some way to open it. Curious about what's got her so excited, you're about to ask what she has found when you notice something that looks like a large heavily-discolored bruise on her tailbone. Did she hurt herself, you wonder as the mass seems to grow before your eyes. The skin of her shapely ass rapidly shifts from a healthy sun-kissed shade of bronze to the same rich blue hue as her sea dragon offspring have. You watch in awe, as the mass expands by the second gaining shape and definition, as the sudden growth rapidly reforms into a thick draconic tail that wraps itself sensuously about her toned legs. Not that Galaxite even notices, so wrapped up in her find, she seems completely oblivious to sleek blue scales blossoming into existence like desert flowers blanketing the parched earth after a rainstorm in the wake of her tail's touch.";
	say "     The vibrant carpet of royal navy blue spreads across her leg as they grow all the more muscular and dense while adopting a more digitigrade stance. 'Ha-ha, come on open!' She moans, still tearing at the case, as her feet begin to swell as large shiny pink paw pads form on the soles of her feet. While her toes bulge out and warp into long wicked ivory white talons supported by supple peach beans. The wave of change soon creeps back up to her curvaceous hip, her generously toned ass ripples and expands with a supple layer of scale-wrapped padding as it strains against her thin string bikini. With each passing second, the poor spandex is stretched further and further to the breaking as her hips shift towards proportions better suited for an egg layer than human. You muse, watching the last vestiges of her bottoms snaps with an audible crack. ";
	if Loyalty of Galaxite is 0:
		say "Freeing her lower half from its lycra prison and revealing her puffy tanned cunt alongside a burst of reptilian pheromones laced with fresh plumeria flowers fills the area in a lustful fog. The twin aromas coil about you like tempting serpents, fuddling your senses as your eyes are drawn to her glistening sex and gently swaying hips.";
	else:
		say "Though you swiftly look away as a burst of reptilian pheromones laced with fresh plumeria flowers fills the area in a lustful fog.";
	WaitLineBreak;
	say "     You feel a rising urge to claim the budding half-dragoness's vivacious body for yourself here and now! Still, a part of you tries to fight against this strange compulsion, though with each breath of the potent brew of reptilian arousal, you can feel your resistance ebbing by the moment as the almost overpowering scent of draconic heat erodes your willpower like the lashing of tides as the inviting gleam of her scales plays across the tainted facets of your mind. You know need to make up your mind and quickly before your body makes it up for you.";
	LineBreak;
	say "     [bold type]What do you want to do?[roman type] [italic type]Author's note: [']Give in and claim her['] has special variants for Pureblooded male and intersexed Dragontaurs, Panther taurs, Tigertaurs, baseline Margay taurs, as well as late stage female Margay taurs and female Dragontaurs.[roman type]";
	LineBreak;
	let Never_Put_Your_Dick_In_Unmedicated_Crazy_Choices be a list of text;
	if Loyalty of Galaxite is 0:
		add "Try to warn her." to Never_Put_Your_Dick_In_Unmedicated_Crazy_Choices;
	add "Get away from her, NOW!" to Never_Put_Your_Dick_In_Unmedicated_Crazy_Choices;
	if Loyalty of Galaxite is 0:
		add "Give in and claim her!" to Never_Put_Your_Dick_In_Unmedicated_Crazy_Choices;
	let Never_Put_Your_Dick_In_Unmedicated_Crazy_Choice be what the player chooses from Never_Put_Your_Dick_In_Unmedicated_Crazy_Choices;
	if Never_Put_Your_Dick_In_Unmedicated_Crazy_Choice is:
		-- "Try to warn her.":
			say "     Biting your tongue almost to the point of puncture, you use the pain to focus yourself and push back against the unbidden compulsion playing havoc with your nanite-laced mind. In seconds, the lustful haze clears from your mind like tule fog in the morning sun till once more you are the master of your own mind, for now. Drawing upon this well of mental clarity, you cry out to Galaxite urging her to control herself. Perhaps it's the tone of your voice, the triumph of your will, or some lingering spark of self control still present in the strange woman. Whatever the case, your cry seems to have some effect on her as she stammers, 'Huh... wa?' dreamily in reply as she ceases her strange frenzy and peers over her shoulder at you. 'What's wrong [Name of Player] why are you shouting?' she asks in a dazed, glazed-over tone as she sways lightly on all fours. Unsure how to properly break the news, you decide to rip the metaphorical bandage off and tell her plainly what happened.";
			say "     'Wait really?' she inquires in a surprised, but by no means unhappy, tenor as she moves herself into a seating position and stares at her draconic feet and legs. 'AW! [bold type]NO WAY[roman type] it finally happened I have pawbs!' she cries with an almost ear-splitting elated trill as runs her still-human mitts along the sleek toned contour of her digitigrade legs. 'Dear sweet Tiamat, these scales are so smooth and soft. Oh just look at my widdle pink jelly beanies,' the budding half dragon swoons, as she reclines slightly, flexing her plush pads and scything ivory talons before you. 'I even have a tail too!' she gushes as her hands glide up along the shapely curves of her pleasantly-padded hips. '[bold type]OH MY GOD[roman type] these are so fu-, freaking cute! I'm so going to buy some toe rings and bangles for these the second I get out of here. Say [Name of Player] what do you think would go best with my claws gold, bronze, or silver?!' she preens, flashing her new found murder mittens at you.";
			WaitLineBreak;
			say "     Wait cute, that's not exactly the reaction you were expecting. Isn't she worried about losing her humanity, her sanity, or hardship she will have to endure as a non-human once she leaves the city. 'Heck no why would I? I've been trying to become a dragon since the outbreak began, and now it's finally starting to happen. Ow, this is so exciting I can't wait to show these to the boys!' she exclaims as she runs her hand down her scaly legs as if to confirm the presence. Sorry, she what!? You feel your lower right eyelid twitch in aggravation. You don't even know how to respond to this and merely stare flabbergasted at Galaxite. 'Hey don't look at me like that, not everyone wants to stay human, you know. Some of us want to be big *pant* sexy *pant* dragonesses like the one I saw at the start of the outbreak. Goddess, you should have seen hir and hir daughters!' Galaxite coos, coiling her tail in her lap and dreamily stroking the sizable limb as if it were a treasured pet.";
			say "     'Shi was like six stories tall with these massive milkers bigger than a pair of minivans,' the lewd quasi-dragoness simpers as she holds her hands out in front of bust as if to indicate the scale. 'Gosh I wish I took a picture of those melons, they looked so perfect nestled atop of hir huge eggy tummy, and that massive ribbed cock of hir's. Mh, I still dream of the smell of hir pre glistening in the sun as it dribbled down that huge throbbing spire.' Galaxite swoons, as her hands drift to her to vacant middle. 'It must have been the size of a house, with these giant pendulous balls swinging beneath hir,' the salutary dragon fanatic rumbles in a deep appreciative trill. 'And you should have seen hir beautiful dripping cunt I bet you could swim in!' she says, her mouth practically watering at the memory. 'Not that I ever got the chance to try, shi kept passing me over for a bunch of undeserving lucky fu-,' Galaxite pauses, her face blushing a deep wine red, to take a breath. 'Ahem folks,' she continues, through an ugly horribly forced smile as she corrects herself.";
			WaitLineBreak;
			say "     'Mh, what I wouldn't have given to waddle the city in hir state. Watching people flee in terror as the ground shook with my every step, or getting to crush cars and buildings like a real kaiju! Feeling every inch of my big beautiful body swelling with life as shi pumped me full of eggs, or having a hoard of doting dragons waiting on my every word like some kind of goddess,' Galaxite simpers as she paws at her washboard abs. 'I tried so hard to get their attention but they were always, [']occupied['] with someone else.' she sighs. 'Then one day, poof,' she huffs with a dejected snap of her fingers, 'they vanished along with a lot of the original infected, no one has seen hide nor hair of them after that. Since then, I've been kicking myself every day for missing my chance and hooking up with every dragon I can find in the hopes one of them might turn me,' Galaxite says rather proudly. 'But none of their nanites stuck, even my eyes and ears,' she pantomimes drawing a circle around her face, 'aren't even from a dragon they just kind of showed up after I got trapped in that weird hole. I didn't even get to see them come in! Which was so unfair, everyone else got to turn into such sexy beasts but not me,' she pouts, hugging her tail.";
			say "     Right, ignoring that rich, vibrant bouquet of over a dozen bright red flags, is that what she's here for? To look for some sign of the missing infected, or find a way to become a dragon herself, you ask. 'What, no silly, I came here to steal this!' Galaxite says, as she dangles the suitcase she was just messing with before you. 'I just can't seem to GET! IT! OPEN!' she huffs digging her fingers into the metal briefcase. You watch as the air around her arms seems to crackle with streaks of multi-hued light coiling about her limbs as a layer of cobalt scales suddenly erupts across her palms. As her hands shift to clawed Dragonic paws, bejeweled with lustrous pearly talons. 'Fu-, frick yes!' Galaxite cries, observing her enhanced nails cleave into the silvery with contemptuous ease as she tears the briefcase in half, sending a number of tiny unlabeled silver aerosol cans, no larger than a common tube of spray on deodorant plinking over the floor.";
			WaitLineBreak;
			say "     'Now this is what I'm really after!' she roars, hurriedly trying to pluck one off the ground as scales and the ambient flicker of morphic energies spread up from her shoulder to encase her altered arms in a rich coat of reptilian beauty. Meanwhile, the lingering sparks of many colors and none, waltz about her hair and ears as two large discolored bumps wink into existence atop her forehead. In seconds, her skin suddenly peels back as a pair of swept-back horns surge forth amid a low static pop, not that she seems to be aware of this, as she somewhat gingerly fumbles with the tiny cylinder at her feet. Eventually, she sandwiches one between her glossy thumb and pointer finger, and, mindful of her talons, she carefully rises to her paws to shows it to you. So what are they, you ask. 'Not sure what the chemicals in them are,' Galaxite says, tossing one your direction. Catching it in your dominant hand, she continues, 'but based on some documents my contacts dug up the gas, [']Revert All['] is allegedly able to turn you back into a boring old human, physically at least.'";
			say "     That's amazing you tell her, think of lives they can save or restore with these things. 'Oh ya-ya-ya we totally could do that, or, and hear me out on this: We sell them for lots of money and live comfortably for the rest of our lives,' she replies, matter of factly. Hm, that is a difficult choice, financial security or saving lives, you opine aloud, not sure how to respond to such an offer. 'I know right, [Name of Player], but I really like you and I'm in a very good mood right now so how does this sound?' Galaxite says, examining her new claws with a smile. 'You can have half the cans in this case, some guns, suits, and all the supplies you can carry. Pass them out, use'em, or sell them, your choice. But I've got plans for the rest of these,' she adds, motioning to the remaining canister with a broad sweep of her tail. Nodding, you tell her that sounds fair. 'Good, I knew you'd make a great partner, [Name of Player]. You're nothing like the old man and his mostly boring crew, at least you let me have my fun!' Galaxite says in a sweet yet eager tone as she clasps her hand once excitedly.";
			WaitLineBreak;
			say "     'Now let's get you packed,' She says as she begins dividing up the haul. You and her spend the next few hours going through the selection of M.R.Es, along with the other supplies to pick out the stuff you like. Sadly, there is only so much you can carry in a single journey over the craggy hill separating the beach and cove. To her credit, Galaxite offers to help carry some for you in her scuba bag. An offer which you're more than a bit grateful for, as you're not sure you'd be able to take all this stuff back to the bunker by yourself. After all, you can always stash a few items at the beach for later, you never know when you need them, you think to yourself as the pair of you pick your way back to the beach, your arms and inventories packed to the brim with valuable loot. Eventually, you arrive at the End of The Beach without incident and say your goodbyes, though as you make ready to leave, Galaxite mentions she may have another job for you in the near future. When you try to question her about it more, she becomes rather coy and tight-lipped, stating that she doesn't want to ruin the surprise. However, she does hint that this next one could leave the two of you very rich. Guess you'll have to find out, ";
			if "Touched by Madness" is listed in Feats of Player:
				say "next time on [bold type]Dragon Raider G! Enter the twenty four Protective Deities![roman type]";
			else: 
				say "the next time you see her.";
			now Loot Boxes is resolved;
			ItemGain Food by 10;
			ItemGain Water Bottle by 10;
			ItemGain Medkit by 10;
			ItemGain Soda by 10;
			ItemGain Chips by 10;
			ItemGain Revert All by 12;
			ItemGain Black Ops Helmet by 2;
			ItemGain Mini Helmet by 2;
			ItemGain Advanced Tactical Helmet by 2;
			ItemGain Hazmat Body Glove by 2;
			ItemGain Oversized Bodyglove by 2;
			ItemGain Flex Boots by 2;
			ItemGain Beastly Boots by 2;
			ItemGain PHASR by 2;
			ItemGain MAD Gun by 2;
			now Stamina of Galaxite is 4;
		-- "Get away from her, NOW!":
			say "     Fearful of whatever change is suddenly gripping Galaxite and the effect it's having on you, you bite your lower lip almost to the point of drawing blood as you force yourself to think of tax law, dead kittens, moldy old nuns, unwashed neck beard hair, anything to push back against the unnatural compulsion clawing at the edges of your mind. Fueled by pain and disgust, the fight or flight section of your psyche surges to the forefront and like a rising tide, extinguishes the budding lustful fire building within you as it quickly rises. Drawing upon this upwelling of lucidity, you waste no time in darting away from the siren's scent scraping at your inhibitions as fast as your [BodyName of Player] legs can carry you. You hurriedly sprint up the hill you behind, kcikgin up a vast plume of vermillion dust in your wake till the wind shifts and pushes the nearly overpowering scent out to sea. Secure in the knowledge that, at least for the moment, you're upwind of the odd pheromones Galaxite's body was producing, you slump down to rest and collect yourself after your frantic climb. Still, you wonder what she is turning into and why?";
			say "     You didn't see anything that looked like a transformative item in any of the containers, and assuming she was telling the truth about whelping dozens of dragons, she sounds rather resistant to nanites in general. What could have changed, or what could have been exposed to cause her to shapeshift so suddenly? You think to yourself as you hunker down in the lee of a sandstone boulder and wait to see who, or what will emerge from the container. Will it be an altered Galaxite, or some new, potentially dangerous horny mutant? You wonder to yourself as you listen to the scraping metal and heaving panting emanating from the shipping crate. In time though, the dreadful din begins to ebb as the sounds of crashing waves and seabirds reassert themselves. You feel you're about to get your answer very soon as a proud reptilian roar of triumph echoes from the dark confines of the red shipping crate. A single clawed hand covered sleek royal navy blue scales, tipped with wicked ivory talons shoots forth from the blackness and grabs hold of the container's shell.";
			WaitLineBreak;
			say "     You watch with a mix of awe and horror as these same claws pierce the sheet metal hull like it was made of wet tissue paper, carving huge rents in the metal as a jovial voice that sounds just like Galaxite cries out to you, 'Hey kin da mun where'd you go?' as she emerges from the shipping crate, changed yes, but she sounds no less sane than when you met her. As you eye up her moderately altered body, you note that she's now sporting a pair of muscular, yet pleasingly feminine, blue digitigrade dragon legs that end in cute scaly paws capped by ivory claws alongside an impressive swept back set of horns growing from her forehead. Her hips have grown a little wider that would be more appropriate on an egg laying species than a human. Yet from the way she carries herself and enticing sashay they impart on her, you have to admit on some level she does wear them well. Tilting your head slightly, you spot a long blue tail with a white underside swaying gently behind her, beyond that though, she seems to be more or less the same.";
			say "     Still, you're justifiably leery after your time in the city, so you decide to keep your distance for now and holler at her to inquire about what just happened. At the sound of your voice, Galaxite's ear perks up as she searches for you. 'Oh there you are [Name of Player]!' she yells as your eyes meet. 'Sorry about, I don't know what came over me, I guess I got so wrapped up in my find, I sort of... lost control I guess.' She shrugs and sticks her tongue out to the side like a happy kitten. So, she's fine now, you ask. 'Ya whatever it was, it seems to have passed. It did feel kind of nice though in a primal sort of way. Oh and I got the case open!' she adds in a proud tone, as she furnishes the now battered remains of a metal briefcase hooked in the crooked of her left ring finger. As she gives a quick shake, causing the thing to flip open and spill several unmarked cylinders no larger than travels size cans of aerosolized deodorant into the sand. 'Oh tartar sauce!' she hisses as she drops to her knees and scoops them off the ground.";
			WaitLineBreak;
			say "     Observing her fumble with her prize, you decide things seem safe enough now, so head over to her and ask what she's found. 'Well...' Galaxite pauses and rocks on heels nervously. 'To be honest,' she shrugs, her tail flicking nervously behind her, 'I don't know what chemicals were used to make these, but my contacts say the gas in these called [']Revert All['], can make anyone human again, at least physically. Here, take a look,' she says, low balling a cylinder your way. Huh neat, you reply, snatching it out of the air and look over the unadorned canister over. You bet you could help a lot of people with something like this, you remark aloud. 'Ya, you could, but what if we mh, oh I don't know, sell it to the highest bidder?' Galaxite smiles in tone sweeter than sugar cane as she squints her eyes and tilts her head at a cute angle. Cocking an eyebrow at her, you tell her not sure. You could save or restore a lot of lives with something like this. It doesn't exactly sit right with you to potentially sell a cure to nanite transformation.";
			say "     There are a lot of people out there who could definitely use something like this, not everyone wants to change and people deserve a chance to be human again, if they want to be, you contend. '*Huff* darn it, you're not wrong [Name of Player], so tell you what,' Galaxite sighs defeatedly as she taps her chin. 'You can have half the cans in this case, some suits, guns, all the supplies you can carry, and play hero if you want. How's that sound?' she asks, her voice waffling between indifference and annoyance. Briefly thinking it over, you tell her that sounds fair. 'Nice, I knew you were a reasonable person [Name of Player]. Now let's get you packed up, I hope you don't mind, but I want to have some *ahem* alone time to try out my new [']accessories[']. If you know what I mean,' she preens, proudly gazing at her gleaming claws like they were fresh from the manicurists. Nodding understandingly, the pair of you sort through the piles of M.R.Es and comfort snacks. You pick the ones that appeal to you along with a few you're curious about trying.";
			WaitLineBreak;
			say "     In the end you collected a sizable amount of supplies which Galaxite offers to help carry to the beach in her scuba bag. Not wanting to be rude, you politely accept, with all the stuff you've picked up, you're not even sure you're strong enough or have enough space in your inventory to take it all back to the bunker in one go. After all, you can always stash a few items at the beach for later, you never know when you need them, you think to yourself as the pair of you pick your way back to the beach, your arms and inventories packed to the brim with valuable loot. Eventually, you arrive at the End of The Beach without incident and say your goodbyes, though as you make ready to leave, Galaxite mentions she may have another job for you in the near future. When you try to question her about it though, she becomes rather coy, stating that she doesn't want to ruin the surprise. However, she does hint that this next one could leave the two of you very rich. Guess you have to find out, ";
			if "Touched by Madness" is listed in Feats of Player:
				say "next time on [bold type]Dragon Raider G! Enter the twenty four Protective Deities![roman type]";
			else:
				say "the next time you see her.";
			now Loot Boxes is resolved;
			ItemGain Food by 10;
			ItemGain Water Bottle by 10;
			ItemGain Medkit by 10;
			ItemGain Soda by 10;
			ItemGain Chips by 10;
			ItemGain Revert All by 12;
			ItemGain Black Ops Helmet by 2;
			ItemGain Mini Helmet by 2;
			ItemGain Advanced Tactical Helmet by 2;
			ItemGain Hazmat Body Glove by 2;
			ItemGain Oversized Bodyglove by 2;
			ItemGain Flex Boots by 2;
			ItemGain Beastly Boots by 2;
			ItemGain PHASR by 2;
			ItemGain MAD Gun by 2;
			now Stamina of Galaxite is 4;
		-- "Give in and claim her!":
			if BodyName of Player is listed in infections of TaurList and BodyName of Player is not listed in infections of EquineList and Cock Count of Player >= 1:
				say "     Gazing at the inviting sway of the lush fertile hips of this budding half dragoness, the sweet enticing scents of draconic heat and plumeria flowers waft about your elated senses. You find it hard to turn away from her vulnerable form or the irresistible invitation of her opalescent cunt gleaming in the available light, besides, she's in such a perfect position for a taur like yourself to have a little fun with. You muse, feeling the blood rush to your stiffening [cock size desc of player] [CockName of Player] cock at the thought of having her underneath your [Bodydesc of Player] body and the enthralling aroma of her bestial heat tugs at the corners of your mind. You quietly paw up behind her, almost drunk on the twin pleasures of her heady pheromones and inviting motions of her tail and shapely ass. Alongside her delightfully curves and the cute pattern of her blue and white scales practically guiding your focus to her perfectly plump alabaster pussy as if they were lights on a runway, you think to yourself, proudly lining your tauric half up with her puddling ivory passage and thrust, spearing the distracted half dragoness on the throbbing length of your [cock size desc of player] [CockName of Player] rod with confident well-practiced stroke.";
				say "     Her welcoming sex devours every inch of your virile tool with preternatural alacrity, as she pants, ";
				if BodyName of Player is "Dragontaur" and Player is pure:
					say "'Oh goddess yes [Name of Player], breed me you regal wyrm!' ";
				else: 
					say "'Oh naughty monster!' ";
				say "as her draconic cunt muscles ripple about your [CockName of Player] member saturating your [cock size desc of player] spire in the blissful embrace of her toasty scaly cunny with every potent buck of your tauric hips. ";
				if CockName of Player is listed in infections of TaperedCockList:
					say "Her exotic muff seems to conform itself to the graceful taper of your [cock size desc of Player] [CockName of Player] dick, as her sopping well-traveled cunt gleefully milks the throbbing curve of your bestial prick. ";
				else if CockName of Player is listed in infections of BarbedCockList:
					say "Her stained walls dotingly dandle the tender bards of your [cock size desc of Player] [CockName of Player] cock as the tender echoes of her silky scales simmer about your bestial tool in a welcome waltz of senations. Your fleshy pleasure-spines seem drawn to the satin folds of her glossy reptilian hood with loving beatific caresses all their own. ";
				else:
					say "Her supple, ecstatic sex lovingly molds to the erotic shape of your [cock size desc of Player] [CockName of Player], eliciting a well-pleased moan from your lips as the heavenly kiss of her draconic folds coddles your throbbing cum vein in the tender embrace her glossy scales and warm velvety walls.";
				say "'Dear sweet Tiamat don't stop you wicked beast!' she coos, pawing at her well-stuffed middle. Your heart almost skips a beast, at the affectionate touch of her fingers brushing the unsubtle bulge in her tight core created by the supple mass of your turgid tool as she lavishes the lustrous impression of your spire with gleeful strokes of her experienced digits. You find yourself rumbling with bestial delight at the decadent pressure simmering about your [cock size desc of player] [CockName of Player] dick as the honed edges of her nails trace the lewd outline of your cock cast in her tight bronze tum.";
				if Player is Male:
					say " Simultaneously, her tail snakes its way up your left hindleg, like an enticing serpent as the sleek sensuous limb coils about your sack and eagerly rubs your [CockName of Player] package between the lurid length of her newly-forged limb remarking, ";
					if Ball Size of Player <= 3 or CockName of Player is listed in infections of InternalBallsList:
						say "'Aw what a cute little trap sack! I don't think I've ever seen such a tiny taur before.' ";
					else if Ball Size of Player > 3 and Ball Size of Player <= 5 and CockName of Player is not listed in infections of InternalBallsList:
						say "'Mh, goddess I love the heft! You're such a naughty taur aren't you [Name of Player]?' ";
					else if Ball Size of Player > 5 and CockName of Player is not listed in infections of InternalBallsList:
						say "'Goddess [Name of Player] your huge! I bet you give the best creampies in town with these don't you, you big sexy beast!?' ";
					say "as she happily fondles your baby makers in the loving folds of her prehensile limb. You find yorself rumbling affectionately at the succulent feeling of her smooth glossy scales traipsing over the mass of your virile cum tanks as it pairs perfectly with the sensation of her silken muff hungrily cinching about your cock. Goddamn you're fucking tight, you simper, pawing at the petite swell of her shapely C-cup breasts with your forelimbs, delighting at the tender weight of her orbs resting comfortably against your pads as her svelte form sways beneath you. A part of you swears you can sense her draconic cunt muscles vibrating about the length of your tool as if it were ribbed with concentric rings of pure, velvety bliss.";
					WaitLineBreak;
				else if Player is Herm:
					say "     Her tail snakes its way up your left hindleg, like an enticing serpent as her sleek, sensuous limb coils about your sack. She eagerly rubs your package between the lurid length of her newly-forged limb remarking, ";
					if Ball Size of Player <= 3 or CockName of Player is listed in infections of InternalBallsList:
						say "'Ah what a cute little itty-bitty-trap sack, you got here! I don't think I've ever felt such a modest herm before. ";
					else if Ball Size of Player > 3 and Ball Size of Player <= 5 and CockName of Player is not listed in infections of InternalBallsList:
						say "'Mh, I love the heft! You're such a naughty taur aren't you [Name of Player]? ";
					else if Ball Size of Player >= 5 and CockName of Player is not listed in infections of InternalBallsList:
						say "'Oh wow [Name of Player] you're huge, just like a big sexy herm should be! Goddess, I bet you give the best creampies in town with these, don't you, you adorable hybrid? ";
					say "Of course, we can't forget about your cute little pussy here,' she simpers as the sleek glassy smooth coils of her tail slips beneath your elated sack. You find yourself rumbling happily at the gentle kiss of her fifth limb tracing the lips of your [cunt size desc of Player] passage as her reptilian muff roils delectable about your throbbing tool. 'Ah you're such a lucky duck, you got the whole package right here!' Galaxite coos approvingly, dandling her dexterous limb about your puddling snatch as she slathers her spaded tail in a generous sheen of your own glistening feminine dew before she arches her tail in a creative [']U['] bend and thrusts. This provokes an ecstatic gasp from your [facename of player] lips as your tauric cunny hungrily devours the graceful taper of her tail with divine ease. You can't help but roar in bestial elation as your [bodydesc of player] flower stretches to accomadate the sordid heft of her draconic limb.'";
					say "     Fuck, you swoon in a lewd trill, feeling your feral stomach bulging ever-so-slighty as the glorious weight of the lustful scalies['] tail flexes and contorts in tandem with the animalistic sway of your bestial [bodytype of Player] hips. Practically seeing stars at the enticing touch of her glossy toy playing along your tauric folds, the lingering fragments of your human mind can barely process the dual fonts of rapture sparking along the liminal facets of your psyche. As the loving ministation of her fluidic appendage gracing your exotic g-spots in beatific rhythm as the steady masterful motions of her tail put the most delectable pressure on your prostate. Meanwhile the humbling caresses of her unearthly velvety smooth scales cascading about your tauric button feeds your ever-growing desire to breed this lustful demi-dragoness and fill her wondrous body with your brood. Some animalistic segment of your tainted mind demands of you, as you glide your supple paws along the tender swell of her still human breasts and well-loved tum, remarking aloud, good slut take that futa cock!"; [merge here]
					WaitLineBreak;
				say "     Engrossed in her own personal elysium, the budding half-dragoness doesn't reply, as she merely nods and pants like a lust-addled beastess while raking her nails across the sheet metal floor of the container. Your rhythm is briefly interrupted by the sounds of metal tearing as her hand begins to change before your eyes. Shifting in an instant from graceful sun-kissed digits to wicked royal blue draconic paws, tipped with ivory talons as she writhes beneath your ";
				if BodyName of Player is "Dragontaur" and Player is pure:
					say "draconic majesty. ";
				else:
					say "tauric splendor. ";
				say "Her claws cut into the hull of the shipping crate like it was made of tissue paper creating deep gouges on the floor in front of you, crying, 'H-ha-harder you cheeky brute!' As she roughly, yet hungrily, bucks her athletic form against you, her changing body quivers delectably at each meaty thrust of your [cock size desc of player] [CockName of Player] pecker[if Player is herm], and the heady pounding of her tail about your bliss-wracked walls[end if].";
				say "     Her wanton bestial antics only excite your tauric body further, as your paws roam her smooth still-human core, delighting at the sensation of your pads drifting down her craved midriff as you trace with one of your toe claws along the unsubtle impression that your throbbing spire casts in her sylvan ab muscles and the erotic bulge that your [CockName of Player] cock head emblazons upon her lean core. You can hear her gasp in abject animalistic delight despite the enticing preyish shiver coursing through her liminal form beneath you, a deviant sliver of your nanite-laced mind fantasizes about this fey creature's body growing round and ripe with your hybrid spawn. Your [bodytype of player] paws are swiftly joined by Galaxite's own taloned hands as she strokes your mitts encouragingly, swooning, ";
				if BodyName of Player is "Dragontaur" and Player is pure:
					say "'Mh, you have such beautiful scales [Name of Player]. I bet all the other dragons go wild over you,' as her warm velvety cunny muscles lovingly milks the sordid breadth of your [cock size desc of player] [CockName of Player] tool.";
				else:
					say "'Naughty monster, you shouldn't play with your prey like this. You might give them the wrong ideas,' as her warm velvety cunny muscles lovingly milks the sordid breadth of your [cock size desc of player] [CockName of Player] tool.";
				if CockName of Player is listed in infections of TaperedCockList:
					say "This earns her a lustful rumble of approval from you at the feeling of your artfully tapered [CockName of Player] cock being swaddling in her cloacal embrace. ";
				if CockName of Player is listed in infections of BarbedCockList:
					say "This elicits a pleased chuff of profound elation as the soft fleshy barbs of your bestial spire are pampered by the mallable wall of Galaxite's malleable passage. ";
				else:
					say "This evokes a lewd bestial moan from you as a whirlpool of bliss caressing the tender curves of your [CockName of Player] cock. ";
				say "As she ravenously sways her half-dragon body in tune with the potent thrusts of your tauric spire, you can sense her pulse quicken like an overclocked engine as she tries to take more of your bestial girth into herself in desperation, trying to quench the lewd draconic heat coursing through her shifting body. Practically hilting her svelte demi-human body on your tauric tool, a section of your nanite-warped psyche is almost impressed by the tiny biped's zeal. All that time ";
				if BodyName of Player is "Dragontaur" and Player is pure:
					say "slumming it with the lesser dragons ";
				else: 
					say "playing with the many feral wyrms ";
				say "populating the city must have taught her a thing or two about how to handle a larger lover like yourself, you opine, sensing the rapturous a tide of pressure building in your lower half as your body thrums with lurid need.";
				say "      Dispensing with all remaining pretenses of form or technique, you allow your growing tauric instincts to take over as you rut her pliable sex with bestial abandon, delighting at the wet meat slaps that your spunk-laden nuts make as they collide with your mate's pillowy ass. ";
				if Player is herm:
					say "Along with the chaotic waltz of her unerringly flexible tail, as it coils about itself in blissful parody of lush knot simmering about your sopping feral honeypot. ";
				say "Not that Galaxite minds, as the blissed-out woman can barely even support herself as she shudders with delight at the touch of your ";
				if CockName of Player is listed in infections of TaperedCockList:
					say "majestically tapered [CockName of Player] rod. ";
				else if CockName of Player is listed in infections of BarbedCockList:
					say "gloriously barbed cock. ";
				else:
					say "potent [cockname of Player] spire. ";
				say "Your body grows hotter and hotter with desire then like fever breaking as you roar your satisfaction to the heavens as you cum.";
				if BodyName of Player is "Dragontaur" and Player is pure:
					say "     Your [cock size desc of player] [CockName of Player] dick throbs with the virile volume of your offering as you baste Galaxite's eager passage in a great torrent of regal Dragonic seed. The blissful heat and monstrous volume of your imperial load pushes the horny half-dragon over the edge as she pants wildly at the sensation of her toned midriff subtly swelling to accommodate your virile offering. Yet, you still have much more to give, you muse, commandingly digging your forepaws into her athletic form, reveling in the heady sensation of her scalie cunny-muscles gripping your tapered spire like a glove as you pour what feels like gallons of potent dragon cum into her. 'Goddess, yes! Fill me you virile dragon!' Galaxite cries as her receptive womb bulges out in a decadent fertile dome that would look more at home on an overdue broodmare than a person. Her skin creaks from the sheer volume of your climax as a gentle sloshing sound reverberates throughout the shipping crate, the seeded half-dragoness swaying drunkenly beneath your exalted form as her hungry snatch devours the last pearly drops of your rich baby batter.";
					if Player is Male:
						say "     Galaxite rumbles like a sated beastess as you gingerly extract your [cock size desc of player] [CockName of Player] from her thoroughly-stuffed cunt. ";
					else if Player is herm:
						say "     The sated half-dragon coos delectably as she collapses face first beneath you and her tail slips free of your tauric folds with a sensuous pop. ";
					say "A part of you is somewhat impressed that not even a single speck of your offering leaks from her ivory-scaled muff as the cum-bloated half-dragoness sighs happily to herself as she slowly rolls over on her back and gazes at the hopelessly swollen state that you've put her in, cooing, 'Mh [Name of Player] you're such a kind wyrm to bless little old me with the honor of carrying your hatchlings.' She languidly massages the taut bronze skin of her heavily engorged belly as it rests comfortably on her upper thighs. 'Mh I can't wait to see how they develop, just thinking about all those cute little taurs kicking and squirming inside is getting me wet!' she exclaims, lightly hugging her spherical tummy with her tail. So, she's not mad you just mounted her without asking, you inquire as you are hit with a rush of post-nut clarity.";
					say "     'What? Oh no-no-no you silly goose!' Galaxite says waving her hand in a dismissive gesture. 'If you needed to blow off some steam you should have told me. Why,' she sobs almost on the edge of mock tears, 'it breaks my heart to think a poor, innocent, dragon like yourself was suffering in silence from such a severe cummie ache,' she teases, eyeing up your plump cock slit. ";
					if Player is mpreg_now and Cunt Count of Player is 0:
						say "'And given your condition, I can't imagine how hard it must have been for a big hunky daddy derg like you to be so pent up. It must have been so horrible for you to waddle around town carrying that big sexy tum all on your lonesome; why your poor ankles must have been killing you dear. If you'd let me know sooner, I could have helped lighten the load, or maybe rubbed your sweet little pawbs,' she snickers, eyeing up your adorable boi bump. 'Besides, you've given me such a wonderful gift here,' Galaxite says, tracing a clawed pointer finger down her hemline.";
						WaitLineBreak;
						say "     'I've never had a litter of *pant* dragontaurs before or been knocked up by a handsome breeder boi. Mh, I can't wait to see how they turn out. Gosh, wouldn't it be wonderful if they come out as big studly seahorse daddies just like you,' she moans, lewdly at the thought. Smirking, you idly pat the slumbering outlines of your latest clutch, reveling at the pleasant rush of paternal hormones coursing you and supple weight of your brood nested in your palms as you teasingly tell her the notion of having a few more studly boi breeders to carry on your legacy does have a certain appeal to. 'Oh let's hope so you adorable hunk, but could you be a mensch and help me find that suitcase I was fiddling with. I'd look myself, but the kids are going to need some time to settle in first,' she chuckles good-naturedly, as she protectively caresses her new found matronly curves with the tip of her tail.";
						now Dexterity of Galaxite is 1;
					else if Player is impreg_now:
						say "I can only imagine how hard it is for a big sexy mommy herm like you to be so pent up in your condition,' she jokes, eyeing up the graceful swell of your midriff and heavy sack. 'It must have been murder on your poor back and ankles to carry those cute eggy tummies. Why if only you'd told me sooner, I would've happily helped lighten your load or massage your beautiful paws for you dear. Besides, you've given me such a wonderful gift here,' Galaxite says, tracing a clawed pointer finger down her darkening hemline. 'I've never had a clutch of *pant* dragontaurs, much less herms before!' She purrs in a vivacious reptilian thrill at the thought.";
						say "     'Goddess, I hope they come out just like you! Mh, just the thought of having some big sexy dragon herms of my own is so excitng!' she mews in a worshipful trill as lovingly fondles her swollen middle. Rumbling happily in agreement, you cheekily tell her that you might enjoy the sight. Besides, you add, dotingly caressing your well-egged tum, delighting internally at the beautiful heft of your brood nestled in the palms of your hands, your [']girls['] could always use more playmates. 'Oh that does sound nice,' she coos dreamily, as her simmering gold eyes explore the gravid curves of your bountiful tauric figure. 'But say, could you be like a total mensch and please help me find that suitcase I was fiddling with? I'd look myself, but I think the kids are going to need some time to settle in first,' she chuckles good-naturedly, as she protectively caresses her new found matronly curves with the tip of her tail.";
						now Dexterity of Galaxite is 1;
					else:
						say "'Besides, I've never had a litter of big *pant* sexy *pant* dragontaurs before,' she rumbles, her eyes alight with manic glee as she idly strokes the tight curves of her packed tum. 'Oh I'm just so excited and I bet the boys would love playing with their widdle brothers and sisters!' Galaxite titters excitedly. Nodding, you cheerfully tell her that would be quite the sight. 'I know right!?' she exclaims, her eyes alight with motherly glee as she hugs the verdant swell of her pleasantly-rounded middle in her arms. 'These sweeties are going to be in for such a treat once they hatch,' she lovingly simpers as she leans down to plant a soft series of kiss upon the taut roof of her blushing tum.";
						say "     Enthused at the sight of the lustful demi-dragon playfully pampering her lush not-so-little bump, you can't help but feel a mix of pride and jubilation at the thought of your latest clutch being raised by such a doting mother. Who knows, you muse, as you gentle sit yourself next to Galaxite and gently wrap your arms around her while you affectionately pamper her resplendent form with your bestial mitts, they might even pick up some of Galaxite's or her brood's tricks. If nothing else, her and her titanic young will make for the perfect guardians in the unlikely event something were to happen to you. 'Mh, that feels so good, I think I could get used to this kind of treatment,' Galaxite purrs, snuggling her supple body next to your tauric splendor as you caringly massage her toasty tender body. 'Goddess your paws feel so nice and cool,' she hums, idly tracing her talons along the tough lamina decorating your [bodydesc of player] arms. 'But say, could you be like a total mensch and please help me find that suitcase I was fiddling with? I'd look myself, but I think the kids are going to need some time to settle in first,' she chuckles good-naturedly, as she protectively caresses her new found matronly curves with the tip of her tail.";
					say "     Shrugging, you tell her that shouldn't be a problem then dexterously step around her and begin poking around the container. After a few moments of searching though, you locate the thing near the back of the crate under one of the mesh lockers. Kneeling down, you carefully slip your tail underneath and pull the thing free, then cheerfully pass it off to Galaxite. 'Aw you're such a gentle taur,' she simpers, taking the case from you and gliding her talon along edges. She slices through the metal suitcase like it was made of wet tissue paper with a quick flick of her wrist. With its locks severed, the travel case pops open with a muted hiss, revealing a number of unmarked and unpainted aerosol cans held in place by a thin black velcro strap. Slipping one out, she raises it into the available light, saying, 'Good the seals are intact. See these kids, because of this and your wonderful father here, Mommy is going to be able to take extra special good care of you,' as she sets one the canister on her tummy.";
					say "     Curious about what she's talking about, you ask what's so special about those cans. 'Right, here,' Galaxite pauses to toss one your way. Catching it, she continues, 'I don't really know what's used to make these, but according to my contacts the gas in these is something called [']Revert All['] that could turn just about anyone back into a *bleh* human.' She retches, shuddering at the thought. Interesting, you reply, something like this could help a lot of people, or if you found the right person sold for a lot of money. 'Exactly and since you've been such a mh generous helper,' she smirks, peering down at her altered form, 'I want you to have half of the canisters in this case, along with all the loot you can carry of course,' she adds, gesturing to racks of guns and supplies with a theatrical wave of her tail. That sounds fair, you reply. 'Good, I hope you find some stuff you like, I'd help out but I think I'm gonna rest here for a while longer.' She yawns, as she lays on her back luxuriating in the afterglow of your mating.";
					WaitLineBreak;
					say "     Nodding in agreement, you set about going through the various crates and boxes you and Galaxite opened earlier, picking out the various flavors of M.R.Es that appeal to you alongside a few you're curious about. Once you've gathered those up, you then turn your attention to remaining sundries, strong as your tauric body may be, you can only carry so much in one go. By the time you're just about ready to go though, you hear Galaxite call out to you, 'Hey [Name of Player] could you come here a sec? I forgot to mention something.' Shrugging you stride over to the container she's sheltering in. Peering inside, you spot the positively glowing half-dragoness lovingly stroking her distended tummy with her tail and ask what's up. '*Yawn* So, I may have another job lined up for us in the future, if you're interested, you should hit me or the boys up the next time you're at the beach,' she says, flexing her ivory claws in the available light. What's the job this time, you ask.";
					say "     'Oh nothing special, just gathering supplies from an abandoned black site in the high rise district. I don't have much information on it right now, but once my contacts get back to me, I should be able to fill you in properly. But, from what I hear, the humans there were being very-very naughty little monkeys, and left all sorts of fun and expensive toys behind for us to play with,' She preens happily in a deeply draconic tone. That does sound promising, you reply diplomatically. 'Oh trust me [Name of Player], we're going to have a lot of fun this haul,' she titters. We'll see, you answer in a noncommittal tone and head off back towards the beach. Weighted down with all your supplies though, you find the trip back is a bit more difficult than the way there. Luckily, your tauric physique can handle the rugged craggy terrain far better then a weak biped. More than once you save yourself from a near fall with a shuffle of your legs or quick beat of your wings. Offhandedly, you wonder if you should thank whoever gave it to you. It certainly has its uses, you muse, picking your way down the last few meters of sandstone hills and arrive back at the End of The Beach. You wonder what you're going to do, ";
					if "Touched by Madness" is listed in Feats of Player:
						say "next time on [bold type]Dragon Raider G! Enter the twenty-four Protective Deities![roman type]";
					else: 
						say "the next time you see her.";
					LineBreak;
					say "     [bold type]Author's Note: Dragon Raider Galaxite ends here, for now.[roman type]";
					now Loot Boxes is resolved;
					ItemGain Food by 10;
					ItemGain Water Bottle by 10;
					ItemGain Medkit by 10;
					ItemGain Soda by 10;
					ItemGain Chips by 10;
					ItemGain Revert All by 12;
					ItemGain Black Ops Helmet by 2;
					ItemGain Mini Helmet by 2;
					ItemGain Advanced Tactical Helmet by 2;
					ItemGain Hazmat Body Glove by 2;
					ItemGain Oversized Bodyglove by 2;
					ItemGain Flex Boots by 2;
					ItemGain Beastly Boots by 2;
					ItemGain PHASR by 2;
					ItemGain MAD Gun by 2;
					now Stamina of Galaxite is 4;
					now Dexterity of Galaxite is 1;
				else if BodyName of Player is "Panther Taur" and Player is pure:
					say "     Your spined spire throbs with the sheer volume of your offering as you baste Galaxite's eager passage in a great torrent of your toasty catty seed. The blissful heat and monstrous volume of your imperial load pushes the horny half-dragon over the edge as she pants wildly at the sensation of her toned midriff subtly swelling to accommodate your virile offering. Yet, you still have much more to give, you muse, digging your forepaws into her athletic form, reveling in the heady sensation of her scalie cunny-muscles gripping the fleshy spines of feline tool like a glove as you pour what feels like gallons of potent feline seed into her plush cunt, as she cries, 'Dear sweet heavens yes! Fill me you naughty kitten!' as her receptive womb bulges out in a decadent fertile dome that would look more at home on an overdue broodmare than a person. All the while her skin creaks and groans from the sheer volume of your climax, as the gentle sloshing sounds of your immaculate load reverberates throughout the shipping crate. The seeded half-dragoness sways drunkenly beneath your exalted form as her hungry snatch devours the last drops of your rich baby batter.";
					say "     You loose a happy mewl and languidly unsheath your still-dripping rod from her molten passage, catty mind reveling at the tender caress of her velvety petals coddling your spines. A feeling Galaxite seem to share as the little half-dragon rumbles in bestial satisfaction at the all-too-pleasant catch of your barbs lavishing her sex as you slip your dick free with a beatific pop. ";
					if player is Herm:
						say "Carefully stepping over her prone form, you're pleasantly surprised to see, not single rivet of your pearly offering slip from her plush alabaster cunt as she gingerly rolls on to her back and skillful slips her tail free of your sweltering catty cunt with a playful flourish. ";
					else:
						say "Carefully stepping over her prone form, you're pleasantly surprised to see, not single rivet of your pearly offering slip from her plush alabaster cunt as she gingerly rolls on to her back. ";
					say "Eliciting a well-pleased purr from your lips at the raw innervating kiss of her spaded tail gracing your tauric button, she proudly presents her flush body to you rumbling. 'Mh such a mean cheeky kitty, I hope you're proud of yourself you just ruined my figure,' sensuously wagging her sloshing tanned middle before you.";
					WaitLineBreak;
					say "     Smirking at the sight of her well-packed belly swaying in her lap and the cute little indentations that her perky c-cup cast in her beautiful bronze tum as they laze comfortably atop her hopelessly swollen bump. You coyly stride up beside her and gently place a forepaw atop her verdant midriff and lovingly massage her creaking belly with your soft silky paw pads telling her very much so. Besides, you add, tracing soothing circles in her blushing bump-to-be, she's going to look absolutely adorable with a belly full of kittens. 'Mh, maybe,' Galaxite swoons, leaning into your touch as she affectionately fondles her supple body. She languidly draws her paws about her cute petite breasts, as she cups her scalie mitts about the lush curves of her toasty tum as if to admire the virile weight of your potent load. 'I've never had a litter of taurs before, it could be nice to kick back on the yacht for a few days getting waited on by Mr. K. till I'm due,' she pants, giving her midriff a jovial pat. Nodding, you teasingly tell her it would be a great look for her too and getting to feel all their sweet peets kicking will be a real treat for her as well.";
					if Player is mpreg_now and Cunt Count of Player is 0:
						say "     'That does sound nice, and it's not like I can be mad at a cute peach widdle boi like you [Name of Player],' Galaxite quips as her golden eyes appreciatively drift along the [bodydesc of player] swell of your plush paunch. 'It must be so hard for you to wander around the city like that carrying those big heavy balls and sweet little boi bump around. Your ankles must be killing you, why I've got half a mind to give you a whittle pawb rub, maybe put out a nice saucer of mommy's milk the next time I see you. Bet you'd like that wouldn't you big boi?' she titters with an encouraging wink, tracing a talon along the taut tan contours of her cum-laden body as she teasingly fondles her own soon-to-be milk-flushed chest, eliciting a sympathetic hungry rumble from your catty form at the mere mention of fresh milk. 'Daw, how adorable, kitty hungie?' she coos, clasping her talons about her perky nips and gives her supple teats a gentle squeeze. Mewling at the sight, you playfully tell her maybe, while your tail wags behind you.";
						say "     'Well, if this litter sticks,' she says with an eager pop of her hips that a sensual ripple through her fecund form, 'I'll let my big strong kitty boi have all the yummy cream he can drink and if you're an extra special good cat daddy, I'll even brush out your fur for you. Doesn't that sound nice, cutie?' she snickers though a knowing smirk. Chuffed, you indulgently inform her that the offer does have a certain appeal to it, you purr, arching your back to better highlight your curves while you openly caress your own bountiful tumby, delighting internally at the beautiful glow of your paternal pelt reflected in the available light as you lovingly pamper your latest litter. You note how your fur could use a little tender love and care, so you might just hold her to that while you dotingly paw at her hopefully cub-flushed tum with your catty forepaw. 'Of course sweetie,' Galaxite coos, leaning forward to give you a quick yet worshipful kiss, 'a pretty coat like yours deserves all the care in the world, but first could you be the world's biggest mensch and find the case I was fiddling with? I'd get it myself but I want to give the cubs a minute to get settled into their home,' she chuckles good-naturedly, as she protectively caresses her new found matronly curves with the tip of her tail.";
						WaitLineBreak;
						say "     Shrugging, you tell her that shouldn't be a problem then dexterously step around her and begin poking around the container. After a few moments of searching though, you locate the thing near the back of the crate under one of the mesh lockers. Kneeling down, you carefully slip your tail underneath and pull the thing free, then cheerfully pass it off to Galaxite. 'Aw you're such a gentle taur,' she simpers, taking the case from you and gliding her talon along edges. She slices through the metal suitcase like it was made of wet tissue paper with a quick flick of her wrist. With its locks severed, the travel case pops open with a muted hiss, revealing a number of unmarked and unpainted aerosol cans held in place by a thin black velcro strap. Slipping one out, she raises it into the available light, saying, 'Good the seals are intact. See these kids, because of this and your wonderful father here, Mommy is going to be able to take extra special good care of you,' as she sets one the canister on her tummy.";
						say "     Curious about what she's talking about, you ask what's so special about those cans. 'Right, here,' Galaxite pauses to toss one your way. Catching it, she continues, 'I don't really know what's used to make these, but according to my contacts the gas in these is something called [']Revert All['] that could turn just about anyone back into a *bleh* human.' She retches, shuddering at the thought. Interesting, you reply, something like this could help a lot of people, or if you found the right person sold for a lot of money. 'Exactly and since you've been such a mh generous helper,' she smirks, peering down at her altered form, 'I want you to have half of the canisters in this case, along with all the loot you can carry of course,' she adds, gesturing to racks of guns and supplies with a theatrical wave of her tail. That sounds fair, you reply. 'Good, I hope you find some stuff you like, I'd help out but I think I'm gonna rest here for a while longer.' She yawns, as she lays on her back luxuriating in the afterglow of your mating.";
						WaitLineBreak;
						say "     Nodding in agreement, you set about going through the various crates and boxes you and Galaxite opened earlier, picking out the various flavors of M.R.Es that appeal to you alongside a few you're curious about. Once you've gathered those up, you then turn your attention to remaining sundries, strong as your tauric body may be, you can only carry so much in one go. By the time you're just about ready to go though, you hear Galaxite call out to you, 'Hey [Name of Player] could you come here a sec? I forgot to mention something.' Shrugging you stride over to the container she's sheltering in. Peering inside, you spot the positively glowing half-dragoness lovingly stroking her distended tummy with her tail and ask what's up. '*Yawn* So, I may have another job lined up for us in the future, if you're interested, you should hit me or the boys up the next time you're at the beach,' she says, flexing her ivory claws in the available light. What's the job this time, you ask.";
						say "     'Oh nothing special, just gathering supplies from an abandoned black site in the high rise district. I don't have much information on it right now, but once my contacts get back to me. I should be able to fill you in properly. But, from what I hear, the humans there were being very-very naughty little monkeys, and left all sorts of fun and expensive toys behind for us to play with,' she preens happily in a deeply draconic tone. That does sound promising, you reply diplomatically. 'Oh trust me [Name of Player] we're going to have a lot of fun this haul,' she titters. We'll see, you answer in a noncommittal tone and head off back towards the beach. Weighted down with all your supplies though, you find the trip back is a bit more difficult than the way there. Luckily, your tauric physique can handle the rugged craggy terrain far better then a weak biped. More than once you save yourself from a near fall with a shuffle of your legs. Offhandedly, you wonder if you should thank whoever gave it to you. It certainly has its uses, you muse, picking your way down the last few meters of sandstone hills and arrive back at the beach. You wonder what you're going to do, ";
						if "Touched by Madness" is listed in Feats of Player:
							say "next time on [bold type]Dragon Raider G! Enter the twenty-four Protective Deities![roman type]";
						else:
							say "the next time you see her";
						LineBreak;
						say "     [bold type]Author's note: Dragon Raider Galaxite ends here, for now[roman type].";
						now Loot Boxes is resolved;
						ItemGain Food by 10;
						ItemGain Water Bottle by 10;
						ItemGain Medkit by 10;
						ItemGain Soda by 10;
						ItemGain Chips by 10;
						ItemGain Revert All by 12;
						ItemGain Black Ops Helmet by 2;
						ItemGain Mini Helmet by 2;
						ItemGain Advanced Tactical Helmet by 2;
						ItemGain Hazmat Body Glove by 2;
						ItemGain Oversized Bodyglove by 2;
						ItemGain Flex Boots by 2;
						ItemGain Beastly Boots by 2;
						ItemGain PHASR by 2;
						ItemGain MAD Gun by 2;
						now Stamina of Galaxite is 4;
						now dexterity of Galaxite is 2;
					else if Player is impreg_now:
						say "     'Oh that does sound heavenly, and I've never had a litter of big kitty herms either, or been knocked up by such a sexy mommy taur like you!' she simpers, shamelessly eying up the [bodydesc of player] curves of your feline figure and the tender contours of your [breast size desc of player] chest. 'Lucky duck, I bet it feels amazing waddling around town in your condition, knocking up all the cuties you can get your paws on while your body grows nice and ripe.' Enjoying her indulgent stare, you playfully adopt a proud maternal posture that better highlights your assets while your paws roam your expectant form, telling her that she's not wrong. Your intersexed tauric form definitely has its perks, like these nice strong paws, you tease idly raking your claws along her middle. Evoking a sensual shiver from the lewd half-dragon as thin crimson blossom on the taut surface of her tum in their wake. These soft fluffy balls, you swoon cheekily popping your hips in theatrical flourish just to feel the virile weight of your package as they bounce between your legs.";
						say "     The wonderful bubbly cocktail of mommy hormones coursing through you and the sumptuous weight of your brood putting pressure on the right places, you tease, dutifully groping a generous pawful of your ripening middle, wallowing at the sight and sensation of your gravid curves titillating your senses. And, you purr, admiring the growing radiance of your pelt, the eye-catching glow of your fur as your padded finger glides across the silken surface of your hide. 'Heh-heh your fur looks wonderful although,' she pauses to reach out and pet your bestial forpaws, 'I bet a pretty momma herm like you could use some T.L.C too, just look at your poor ankles when they last time someone got on their hand and knees to give them a good rub?' she teases, her eyes drifting along the predatory contours of your graceful body. Enjoying both her gaze and the attention, you playfully ask if she's offering to perform such a service. 'Maybe, if this litter sticks, but first do you think you could be a total mensch and grab that case for me? I'd get it myself, however the cubs could use a few minutes to get settled,' she chuckles good-naturedly, as she protectively caresses her new found matronly curves with the tip of her tail.";
						WaitLineBreak;
						say "     Shrugging, you tell her that shouldn't be a problem then dexterously step around her and begin poking around the container. After a few moments of searching though, you locate the thing near the back of the crate under one of the mesh lockers. Kneeling down, you carefully slip your tail underneath and pull the thing free, then cheerfully pass it off to Galaxite. 'Aw you're such a gentle taur,' she simpers, taking the case from you and gliding her talon along edges. She slices through the metal suitcase like it was made of wet tissue paper with a quick flick of her wrist. With its locks severed, the travel case pops open with a muted hiss, revealing a number of unmarked and unpainted aerosol cans held in place by a thin black velcro strap. Slipping one out, she raises it into the available light, saying, 'Good the seals are intact. See these kids, because of this and your wonderful father here, Mommy is going to be able to take extra special good care of you,' as she sets one the canister on her tummy.";
						say "     Curious about what she's talking about, you ask what's so special about those cans. 'Right, here,' Galaxite pauses to toss one your way. Catching it, she continues, 'I don't really know what's used to make these, but according to my contacts the gas in these is something called [']Revert All['] that could turn just about anyone back into a *bleh* human.' She retches, shuddering at the thought. Interesting, you reply, something like this could help a lot of people, or if you found the right person sold for a lot of money. 'Exactly and since you've been such a mh generous helper,' she smirks, peering down at her altered form, 'I want you to have half of the canisters in this case, along with all the loot you can carry of course,' she adds, gesturing to racks of guns and supplies with a theatrical wave of her tail. That sounds fair, you reply. 'Good, I hope you find some stuff you like, I'd help out but I think I'm gonna rest here for a while longer.' She yawns, as she lays on her back luxuriating in the afterglow of your mating.";
						WaitLineBreak;
						say "     Nodding in agreement, you set about going through the various crates and boxes you and Galaxite opened earlier, picking out the various flavors of M.R.Es that appeal to you alongside a few you're curious about. Once you've gathered those up, you then turn your attention to remaining sundries, strong as your tauric body may be, you can only carry so much in one go. By the time you're just about ready to go though, you hear Galaxite call out to you, 'Hey [Name of Player] could you come here a sec? I forgot to mention something.' Shrugging you stride over to the container she's sheltering in. Peering inside, you spot the positively glowing half-dragoness lovingly stroking her distended tummy with her tail and ask what's up. '*Yawn* So, I may have another job lined up for us in the future, if you're interested, you should hit me or the boys up the next time you're at the beach,' she says, flexing her ivory claws in the available light. What's the job this time, you ask.";
						say "     'Oh nothing special, just gathering supplies from an abandoned black site in the high rise district. I don't have much information on it right now, but once my contacts get back to me. I should be able to fill you in properly. But, from what I hear, the humans there were being very-very naughty little monkeys, and left all sorts of fun and expensive toys behind for us to play with,' she preens happily in a deeply draconic tone. That does sound promising, you reply diplomatically. 'Oh trust me [Name of Player] we're going to have a lot of fun this haul,' she titters. We'll see, you answer in a noncommittal tone and head off back towards the beach. Weighted down with all your supplies though, you find the trip back is a bit more difficult than the way there. Luckily, your tauric physique can handle the rugged craggy terrain far better then a weak biped. More than once you save yourself from a near fall with a shuffle of your legs. Offhandedly, you wonder if you should thank whoever gave it to you. It certainly has its uses, you muse, picking your way down the last few meters of sandstone hills and arrive back at the beach. You wonder what you're going to do, ";
						if "Touched by Madness" is listed in Feats of Player:
							say "next time on [bold type]Dragon Raider G! Enter the twenty-four Protective Deities![roman type]";
						else:
							say "the next time you see her";
						LineBreak;
						say "     [bold type]Author's note: Dragon Raider Galaxite ends here, for now[roman type].";
						now Loot Boxes is resolved;
						ItemGain Food by 10;
						ItemGain Water Bottle by 10;
						ItemGain Medkit by 10;
						ItemGain Soda by 10;
						ItemGain Chips by 10;
						ItemGain Revert All by 12;
						ItemGain Black Ops Helmet by 2;
						ItemGain Mini Helmet by 2;
						ItemGain Advanced Tactical Helmet by 2;
						ItemGain Hazmat Body Glove by 2;
						ItemGain Oversized Bodyglove by 2;
						ItemGain Flex Boots by 2;
						ItemGain Beastly Boots by 2;
						ItemGain PHASR by 2;
						ItemGain MAD Gun by 2;
						now Stamina of Galaxite is 4;
						now dexterity of Galaxite is 2;
					else:
						say "     'That does sound nice, and I've never had a cute widdle litter of kittens before, much less been knocked up by a big sexy taur before,' she hums, eyeing up your catty body with obvious delight. Enjoying the attention, you can't help but adopt a playful pose for the lewd demi-dragon. 'Mh you're such a beautiful kitty, you know, I hope the little ones come out just like you, it will be so fun to spoil and pamper the sweet little dears,' she purrs, as a pair of joyful tears stream down the sides of her face, 'I can't wait to hold all these adorable fluff balls in my arms, and I just know the boys are going to love playing with them too,' she says, running her hand along the heavenly swell of her ripe heavy middle."; [Note: Big cats love swimming]
						say "     Mewling delightedly in reply, you tell her that would be quite the spectacle. '*Tee-hee* I know right, just think of all the fun they'd have getting to fly around the city, or exploring the ocean with their big brothers,' Galaxite gushes, as her eyes drift towards the surf while a proud motherly smile blossoms upon her lips. Bobbing your head, you inform her how wonderful that sounds, after all you can't think of many better minders for your precious kittens than a Tyranny of titanic dragons and who knows, perhaps they could even learn some of their sibling tricks. 'Maybe, I don't think the boys have ever tried to teach anyone else before. Hopefully, this litter sticks and we can find out together cutie, but first do you think you could be a total mensch and grab that case for me? I'd get it myself, but the cubs could use a few minutes to get settled,' she chuckles good-naturedly, as she protectively caresses her new found matronly curves with the tip of her tail.";
						WaitLineBreak; [merge here]
						say "     Shrugging, you tell her that shouldn't be a problem then dexterously step around her and begin poking around the container. After a few moments of searching though, you locate the thing near the back of the crate under one of the mesh lockers. Kneeling down, you carefully slip your tail underneath and pull the thing free, then cheerfully pass it off to Galaxite. 'Aw you're such a gentle taur,' she simpers, taking the case from you and gliding her talon along edges. She slices through the metal suitcase like it was made of wet tissue paper with a quick flick of her wrist. With its locks severed, the travel case pops open with a muted hiss, revealing a number of unmarked and unpainted aerosol cans held in place by a thin black velcro strap. Slipping one out, she raises it into the available light, saying, 'Good the seals are intact. See these kids, because of this and your wonderful father here, Mommy is going to be able to take extra special good care of you,' as she sets one the canister on her tummy.";
						say "     Curious about what she's talking about, you ask what's so special about those cans. 'Right, here,' Galaxite pauses to toss one your way. Catching it, she continues, 'I don't really know what's used to make these, but according to my contacts the gas in these is something called [']Revert All['] that could turn just about anyone back into a *bleh* human.' She retches, shuddering at the thought. Interesting, you reply, something like this could help a lot of people, or if you found the right person sold for a lot of money. 'Exactly and since you've been such a mh generous helper,' she smirks, peering down at her altered form, 'I want you to have half of the canisters in this case, along with all the loot you can carry of course,' she adds, gesturing to racks of guns and supplies with a theatrical wave of her tail. That sounds fair, you reply. 'Good, I hope you find some stuff you like, I'd help out but I think I'm gonna rest here for a while longer.' She yawns, as she lays on her back luxuriating in the afterglow of your mating.";
						WaitLineBreak;
						say "     Nodding in agreement, you set about going through the various crates and boxes you and Galaxite opened earlier, picking out the various flavors of M.R.Es that appeal to you alongside a few you're curious about. Once you've gathered those up, you then turn your attention to remaining sundries, strong as your tauric body may be, you can only carry so much in one go. By the time you're just about ready to go though, you hear Galaxite call out to you, 'Hey [Name of Player] could you come here a sec? I forgot to mention something.' Shrugging you stride over to the container she's sheltering in. Peering inside, you spot the positively glowing half-dragoness lovingly stroking her distended tummy with her tail and ask what's up. '*Yawn* So, I may have another job lined up for us in the future, if you're interested, you should hit me or the boys up the next time you're at the beach,' she says, flexing her ivory claws in the available light. What's the job this time, you ask.";
						say "     'Oh nothing special, just gathering supplies from an abandoned black site in the high rise district. I don't have much information on it right now, but once my contacts get back to me. I should be able to fill you in properly. But, from what I hear, the humans there were being very-very naughty little monkeys, and left all sorts of fun and expensive toys behind for us to play with,' she preens happily in a deeply draconic tone. That does sound promising, you reply diplomatically. 'Oh trust me [Name of Player] we're going to have a lot of fun this haul,' she titters. We'll see, you answer in a noncommittal tone and head off back towards the beach. Weighted down with all your supplies though, you find the trip back is a bit more difficult than the way there. Luckily, your tauric physique can handle the rugged craggy terrain far better then a weak biped. More than once you save yourself from a near fall with a shuffle of your legs. Offhandedly, you wonder if you should thank whoever gave it to you. It certainly has its uses, you muse, picking your way down the last few meters of sandstone hills and arrive back at the beach. You wonder what you're going to do, ";
						if "Touched by Madness" is listed in Feats of Player:
							say "next time on [bold type]Dragon Raider G! Enter the twenty-four Protective Deities![roman type]";
						else:
							say "the next time you see her";
						LineBreak;
						say "     [bold type]Author's note: Dragon Raider Galaxite ends here, for now[roman type].";
						now Loot Boxes is resolved;
						ItemGain Food by 10;
						ItemGain Water Bottle by 10;
						ItemGain Medkit by 10;
						ItemGain Soda by 10;
						ItemGain Chips by 10;
						ItemGain Revert All by 12;
						ItemGain Black Ops Helmet by 2;
						ItemGain Mini Helmet by 2;
						ItemGain Advanced Tactical Helmet by 2;
						ItemGain Hazmat Body Glove by 2;
						ItemGain Oversized Bodyglove by 2;
						ItemGain Flex Boots by 2;
						ItemGain Beastly Boots by 2;
						ItemGain PHASR by 2;
						ItemGain MAD Gun by 2;
						now Stamina of Galaxite is 4;
						now dexterity of Galaxite is 2;
				else if BodyName of Player is "Tigertaur" and Player is pure:
					say "     Your spined spire throbs with the sheer volume of your offering as you baste Galaxite's eager passage in a great torrent of your toasty catty seed. The blissful heat and monstrous volume of your imperial load pushes the horny half-dragon over the edge as she pants wildly at the sensation of her toned midriff subtly swelling to accommodate your virile offering. Yet, you still have much more to give, you muse, digging your forepaws into her athletic form, reveling in the heady sensation of her scalie cunny-muscles gripping the fleshy spines of feline tool like a glove as you pour what feels like gallons of potent feline seed into her plush cunt, as she cries, 'Dear sweet heavens yes! Fill me you naughty kitten!' as her receptive womb bulges out in a decadent fertile dome that would look more at home on an overdue broodmare than a person. All the while her skin creaks and groans from the sheer volume of your climax, as the gentle sloshing sounds of your immaculate load reverberates throughout the shipping crate. The seeded half-dragoness sways drunkenly beneath your exalted form as her hungry snatch devours the last drops of your rich baby batter.";
					say "     You loose a happy mewl and languidly unsheath your still-dripping rod from her molten passage, catty mind reveling at the tender caress of her velvety petals coddling your spines. A feeling Galaxite seem to share as the little half-dragon rumbles in bestial satisfaction at the all-too-pleasant catch of your barbs lavishing her sex as you slip your dick free with a beatific pop. ";
					if player is Herm:
						say "Carefully stepping over her prone form, you're pleasantly surprised to see, not single rivet of your pearly offering slip from her plush alabaster cunt as she gingerly rolls on to her back and skillful slips her tail free of your sweltering catty cunt with a playful flourish. ";
					else:
						say "Carefully stepping over her prone form, you're pleasantly surprised to see, not single rivet of your pearly offering slip from her plush alabaster cunt as she gingerly rolls on to her back. ";
					say "Eliciting a well-pleased purr from your lips at the raw innervating kiss of her spaded tail gracing your tauric button, she proudly presents her flush body to you rumbling. 'Mh such a mean cheeky kitty, I hope you're proud of yourself you just ruined my figure,' sensuously wagging her sloshing tanned middle before you.";
					WaitLineBreak;
					say "     Smirking at the sight of her well-packed belly swaying in her lap and the cute little indentations that her perky c-cup cast in her beautiful bronze tum as they laze comfortably atop her hopelessly swollen bump. You coyly stride up beside her and gently place a forepaw atop her verdant midriff and lovingly massage her creaking belly with your soft silky paw pads telling her very much so. Besides, you add, tracing soothing circles in her blushing bump-to-be, she's going to look absolutely adorable with a belly full of kittens. 'Mh, maybe,' Galaxite swoons, leaning into your touch as she affectionately fondles her supple body. She languidly draws her paws about her cute petite breasts, as she cups her scalie mitts about the lush curves of her toasty tum as if to admire the virile weight of your potent load. 'I've never had a litter of taurs before, it could be nice to kick back on the yacht for a few days getting waited on by Mr. K. till I'm due,' she pants, giving her midriff a jovial pat. Nodding, you teasingly tell her it would be a great look for her too and getting to feel all their sweet peets kicking will be a real treat for her as well.";
					if Player is mpreg_now and Cunt Count of Player is 0:
						say "     'That does sound nice, and it's not like I can be mad at a cute peach widdle boi like you [Name of Player],' Galaxite quips as her golden eyes appreciatively drift along the [bodydesc of player] swell of your plush paunch. 'It must be so hard for you to wander around the city like that carrying those big heavy balls and sweet little boi bump around. Your ankles must be killing you, why I've got half a mind to give you a whittle pawb rub, maybe put out a nice saucer of mommy's milk the next time I see you. Bet you'd like that wouldn't you big boi?' she titters with an encouraging wink, tracing a talon along the taut tan contours of her cum-laden body as she teasingly fondles her own soon-to-be milk-flushed chest, eliciting a sympathetic hungry rumble from your catty form at the mere mention of fresh milk. 'Daw, how adorable, kitty hungie?' she coos, clasping her talons about her perky nips and gives her supple teats a gentle squeeze. Mewling at the sight, you playfully tell her maybe, while your tail wags behind you.";
						say "     'Well, if this litter sticks,' she says with an eager pop of her hips that a sensual ripple through her fecund form, 'I'll let my big strong kitty boi have all the yummy cream he can drink and if you're an extra special good cat daddy, I'll even brush out your fur for you. Doesn't that sound nice, cutie?' she snickers though a knowing smirk. Chuffed, you indulgently inform her that the offer does have a certain appeal to it, you purr, arching your back to better highlight your curves while you openly caress your own bountiful tumby, delighting internally at the beautiful glow of your paternal pelt reflected in the available light as you lovingly pamper your latest litter. You note how your fur could use a little tender love and care, so you might just hold her to that while you dotingly paw at her hopefully cub-flushed tum with your catty forepaw. 'Of course sweetie,' Galaxite coos, leaning forward to give you a quick yet worshipful kiss, 'a pretty coat like yours deserves all the care in the world, but first could you be the world's biggest mensch and find the case I was fiddling with? I'd get it myself but I want to give the cubs a minute to get settled into their home,' she chuckles good-naturedly, as she protectively caresses her new found matronly curves with the tip of her tail.";
						WaitLineBreak;
						say "     Shrugging, you tell her that shouldn't be a problem then dexterously step around her and begin poking around the container. After a few moments of searching though, you locate the thing near the back of the crate under one of the mesh lockers. Kneeling down, you carefully slip your tail underneath and pull the thing free, then cheerfully pass it off to Galaxite. 'Aw you're such a gentle taur,' she simpers, taking the case from you and gliding her talon along edges. She slices through the metal suitcase like it was made of wet tissue paper with a quick flick of her wrist. With its locks severed, the travel case pops open with a muted hiss, revealing a number of unmarked and unpainted aerosol cans held in place by a thin black velcro strap. Slipping one out, she raises it into the available light, saying, 'Good the seals are intact. See these kids, because of this and your wonderful father here, Mommy is going to be able to take extra special good care of you,' as she sets one the canister on her tummy.";
						say "     Curious about what she's talking about, you ask what's so special about those cans. 'Right, here,' Galaxite pauses to toss one your way. Catching it, she continues, 'I don't really know what's used to make these, but according to my contacts the gas in these is something called [']Revert All['] that could turn just about anyone back into a *bleh* human.' She retches, shuddering at the thought. Interesting, you reply, something like this could help a lot of people, or if you found the right person sold for a lot of money. 'Exactly and since you've been such a mh generous helper,' she smirks, peering down at her altered form, 'I want you to have half of the canisters in this case, along with all the loot you can carry of course,' she adds, gesturing to racks of guns and supplies with a theatrical wave of her tail. That sounds fair, you reply. 'Good, I hope you find some stuff you like, I'd help out but I think I'm gonna rest here for a while longer.' She yawns, as she lays on her back luxuriating in the afterglow of your mating.";
						WaitLineBreak;
						say "     Nodding in agreement, you set about going through the various crates and boxes you and Galaxite opened earlier, picking out the various flavors of M.R.Es that appeal to you alongside a few you're curious about. Once you've gathered those up, you then turn your attention to remaining sundries, strong as your tauric body may be, you can only carry so much in one go. By the time you're just about ready to go though, you hear Galaxite call out to you, 'Hey [Name of Player] could you come here a sec? I forgot to mention something.' Shrugging you stride over to the container she's sheltering in. Peering inside, you spot the positively glowing half-dragoness lovingly stroking her distended tummy with her tail and ask what's up. '*Yawn* So, I may have another job lined up for us in the future, if you're interested, you should hit me or the boys up the next time you're at the beach,' she says, flexing her ivory claws in the available light. What's the job this time, you ask.";
						say "     'Oh nothing special, just gathering supplies from an abandoned black site in the high rise district. I don't have much information on it right now, but once my contacts get back to me. I should be able to fill you in properly. But, from what I hear, the humans there were being very-very naughty little monkeys, and left all sorts of fun and expensive toys behind for us to play with,' she preens happily in a deeply draconic tone. That does sound promising, you reply diplomatically. 'Oh trust me [Name of Player] we're going to have a lot of fun this haul,' she titters. We'll see, you answer in a noncommittal tone and head off back towards the beach. Weighted down with all your supplies though, you find the trip back is a bit more difficult than the way there. Luckily, your tauric physique can handle the rugged craggy terrain far better then a weak biped. More than once you save yourself from a near fall with a shuffle of your legs. Offhandedly, you wonder if you should thank whoever gave it to you. It certainly has its uses, you muse, picking your way down the last few meters of sandstone hills and arrive back at the beach. You wonder what you're going to do, ";
						if "Touched by Madness" is listed in Feats of Player:
							say "next time on [bold type]Dragon Raider G! Enter the twenty-four Protective Deities![roman type]";
						else:
							say "the next time you see her";
						LineBreak;
						say "     [bold type]Author's note: Dragon Raider Galaxite ends here, for now[roman type].";
						now Loot Boxes is resolved;
						ItemGain Food by 10;
						ItemGain Water Bottle by 10;
						ItemGain Medkit by 10;
						ItemGain Soda by 10;
						ItemGain Chips by 10;
						ItemGain Revert All by 12;
						ItemGain Black Ops Helmet by 2;
						ItemGain Mini Helmet by 2;
						ItemGain Advanced Tactical Helmet by 2;
						ItemGain Hazmat Body Glove by 2;
						ItemGain Oversized Bodyglove by 2;
						ItemGain Flex Boots by 2;
						ItemGain Beastly Boots by 2;
						ItemGain PHASR by 2;
						ItemGain MAD Gun by 2;
						now Stamina of Galaxite is 4;
						now dexterity of Galaxite is 2;
					else if Player is impreg_now:
						say "     'Oh that does sound heavenly, and I've never had a litter of big kitty herms either, or been knocked up by such a sexy mommy taur like you!' she simpers, shamelessly eying up the [bodydesc of player] curves of your feline figure and the tender contours of your [breast size desc of player] chest. 'Lucky duck, I bet it feels amazing waddling around town in your condition, knocking up all the cuties you can get your paws on while your body grows nice and ripe.' Enjoying her indulgent stare, you playfully adopt a proud maternal posture that better highlights your assets while your paws roam your expectant form, telling her that she's not wrong. Your intersexed tauric form definitely has its perks, like these nice strong paws, you tease idly raking your claws along her middle. Evoking a sensual shiver from the lewd half-dragon as thin crimson blossom on the taut surface of her tum in their wake. These soft fluffy balls, you swoon cheekily popping your hips in theatrical flourish just to feel the virile weight of your package as they bounce between your legs.";
						say "     The wonderful bubbly cocktail of mommy hormones coursing through you and the sumptuous weight of your brood putting pressure on the right places, you tease, dutifully groping a generous pawful of your ripening middle, wallowing at the sight and sensation of your gravid curves titillating your senses. And, you purr, admiring the growing radiance of your pelt, the eye-catching glow of your fur as your padded finger glides across the silken surface of your hide. 'Heh-heh your fur looks wonderful although,' she pauses to reach out and pet your bestial forpaws, 'I bet a pretty momma herm like you could use some T.L.C too, just look at your poor ankles when they last time someone got on their hand and knees to give them a good rub?' she teases, her eyes drifting along the predatory contours of your graceful body. Enjoying both her gaze and the attention, you playfully ask if she's offering to perform such a service. 'Maybe, if this litter sticks, but first do you think you could be a total mensch and grab that case for me? I'd get it myself, however the cubs could use a few minutes to get settled,' she chuckles good-naturedly, as she protectively caresses her new found matronly curves with the tip of her tail.";
						WaitLineBreak;
						say "     Shrugging, you tell her that shouldn't be a problem then dexterously step around her and begin poking around the container. After a few moments of searching though, you locate the thing near the back of the crate under one of the mesh lockers. Kneeling down, you carefully slip your tail underneath and pull the thing free, then cheerfully pass it off to Galaxite. 'Aw you're such a gentle taur,' she simpers, taking the case from you and gliding her talon along edges. She slices through the metal suitcase like it was made of wet tissue paper with a quick flick of her wrist. With its locks severed, the travel case pops open with a muted hiss, revealing a number of unmarked and unpainted aerosol cans held in place by a thin black velcro strap. Slipping one out, she raises it into the available light, saying, 'Good the seals are intact. See these kids, because of this and your wonderful father here, Mommy is going to be able to take extra special good care of you,' as she sets one the canister on her tummy.";
						say "     Curious about what she's talking about, you ask what's so special about those cans. 'Right, here,' Galaxite pauses to toss one your way. Catching it, she continues, 'I don't really know what's used to make these, but according to my contacts the gas in these is something called [']Revert All['] that could turn just about anyone back into a *bleh* human.' She retches, shuddering at the thought. Interesting, you reply, something like this could help a lot of people, or if you found the right person sold for a lot of money. 'Exactly and since you've been such a mh generous helper,' she smirks, peering down at her altered form, 'I want you to have half of the canisters in this case, along with all the loot you can carry of course,' she adds, gesturing to racks of guns and supplies with a theatrical wave of her tail. That sounds fair, you reply. 'Good, I hope you find some stuff you like, I'd help out but I think I'm gonna rest here for a while longer.' She yawns, as she lays on her back luxuriating in the afterglow of your mating.";
						WaitLineBreak;
						say "     Nodding in agreement, you set about going through the various crates and boxes you and Galaxite opened earlier, picking out the various flavors of M.R.Es that appeal to you alongside a few you're curious about. Once you've gathered those up, you then turn your attention to remaining sundries, strong as your tauric body may be, you can only carry so much in one go. By the time you're just about ready to go though, you hear Galaxite call out to you, 'Hey [Name of Player] could you come here a sec? I forgot to mention something.' Shrugging you stride over to the container she's sheltering in. Peering inside, you spot the positively glowing half-dragoness lovingly stroking her distended tummy with her tail and ask what's up. '*Yawn* So, I may have another job lined up for us in the future, if you're interested, you should hit me or the boys up the next time you're at the beach,' she says, flexing her ivory claws in the available light. What's the job this time, you ask.";
						say "     'Oh nothing special, just gathering supplies from an abandoned black site in the high rise district. I don't have much information on it right now, but once my contacts get back to me. I should be able to fill you in properly. But, from what I hear, the humans there were being very-very naughty little monkeys, and left all sorts of fun and expensive toys behind for us to play with,' she preens happily in a deeply draconic tone. That does sound promising, you reply diplomatically. 'Oh trust me [Name of Player] we're going to have a lot of fun this haul,' she titters. We'll see, you answer in a noncommittal tone and head off back towards the beach. Weighted down with all your supplies though, you find the trip back is a bit more difficult than the way there. Luckily, your tauric physique can handle the rugged craggy terrain far better then a weak biped. More than once you save yourself from a near fall with a shuffle of your legs. Offhandedly, you wonder if you should thank whoever gave it to you. It certainly has its uses, you muse, picking your way down the last few meters of sandstone hills and arrive back at the beach. You wonder what you're going to do, ";
						if "Touched by Madness" is listed in Feats of Player:
							say "next time on [bold type]Dragon Raider G! Enter the twenty-four Protective Deities![roman type]";
						else:
							say "the next time you see her";
						LineBreak;
						say "     [bold type]Author's note: Dragon Raider Galaxite ends here, for now[roman type].";
						now Loot Boxes is resolved;
						ItemGain Food by 10;
						ItemGain Water Bottle by 10;
						ItemGain Medkit by 10;
						ItemGain Soda by 10;
						ItemGain Chips by 10;
						ItemGain Revert All by 12;
						ItemGain Black Ops Helmet by 2;
						ItemGain Mini Helmet by 2;
						ItemGain Advanced Tactical Helmet by 2;
						ItemGain Hazmat Body Glove by 2;
						ItemGain Oversized Bodyglove by 2;
						ItemGain Flex Boots by 2;
						ItemGain Beastly Boots by 2;
						ItemGain PHASR by 2;
						ItemGain MAD Gun by 2;
						now Stamina of Galaxite is 4;
						now dexterity of Galaxite is 2;
					else:
						say "     'That does sound nice, and I've never had a cute widdle litter of kittens before, much less been knocked up by a big sexy taur before,' she hums, eyeing up your catty body with obvious delight. Enjoying the attention, you can't help but adopt a playful pose for the lewd demi-dragon. 'Mh you're such a beautiful kitty, you know, I hope the little ones come out just like you, it will be so fun to spoil and pamper the sweet little dears,' she purrs, as a pair of joyful tears stream down the sides of her face, 'I can't wait to hold all these adorable fluff balls in my arms, and I just know the boys are going to love playing with them too,' she says, running her hand along the heavenly swell of her ripe heavy middle."; [Note: Big cats love swimming]
						say "     Mewling delightedly in reply, you tell her that would be quite the spectacle. '*Tee-hee* I know right, just think of all the fun they'd have getting to fly around the city, or exploring the ocean with their big brothers,' Galaxite gushes, as her eyes drift towards the surf while a proud motherly smile blossoms upon her lips. Bobbing your head, you inform her how wonderful that sounds, after all you can't think of many better minders for your precious kittens than a Tyranny of titanic dragons and who knows, perhaps they could even learn some of their sibling tricks. 'Maybe, I don't think the boys have ever tried to teach anyone else before. Hopefully, this litter sticks and we can find out together cutie, but first do you think you could be a total mensch and grab that case for me? I'd get it myself, but the cubs could use a few minutes to get settled,' she chuckles good-naturedly, as she protectively caresses her new found matronly curves with the tip of her tail.";
						WaitLineBreak; [merge here]
						say "     Shrugging, you tell her that shouldn't be a problem then dexterously step around her and begin poking around the container. After a few moments of searching though, you locate the thing near the back of the crate under one of the mesh lockers. Kneeling down, you carefully slip your tail underneath and pull the thing free, then cheerfully pass it off to Galaxite. 'Aw you're such a gentle taur,' she simpers, taking the case from you and gliding her talon along edges. She slices through the metal suitcase like it was made of wet tissue paper with a quick flick of her wrist. With its locks severed, the travel case pops open with a muted hiss, revealing a number of unmarked and unpainted aerosol cans held in place by a thin black velcro strap. Slipping one out, she raises it into the available light, saying, 'Good the seals are intact. See these kids, because of this and your wonderful father here, Mommy is going to be able to take extra special good care of you,' as she sets one the canister on her tummy.";
						say "     Curious about what she's talking about, you ask what's so special about those cans. 'Right, here,' Galaxite pauses to toss one your way. Catching it, she continues, 'I don't really know what's used to make these, but according to my contacts the gas in these is something called [']Revert All['] that could turn just about anyone back into a *bleh* human.' She retches, shuddering at the thought. Interesting, you reply, something like this could help a lot of people, or if you found the right person sold for a lot of money. 'Exactly and since you've been such a mh generous helper,' she smirks, peering down at her altered form, 'I want you to have half of the canisters in this case, along with all the loot you can carry of course,' she adds, gesturing to racks of guns and supplies with a theatrical wave of her tail. That sounds fair, you reply. 'Good, I hope you find some stuff you like, I'd help out but I think I'm gonna rest here for a while longer.' She yawns, as she lays on her back luxuriating in the afterglow of your mating.";
						WaitLineBreak;
						say "     Nodding in agreement, you set about going through the various crates and boxes you and Galaxite opened earlier, picking out the various flavors of M.R.Es that appeal to you alongside a few you're curious about. Once you've gathered those up, you then turn your attention to remaining sundries, strong as your tauric body may be, you can only carry so much in one go. By the time you're just about ready to go though, you hear Galaxite call out to you, 'Hey [Name of Player] could you come here a sec? I forgot to mention something.' Shrugging you stride over to the container she's sheltering in. Peering inside, you spot the positively glowing half-dragoness lovingly stroking her distended tummy with her tail and ask what's up. '*Yawn* So, I may have another job lined up for us in the future, if you're interested, you should hit me or the boys up the next time you're at the beach,' she says, flexing her ivory claws in the available light. What's the job this time, you ask.";
						say "     'Oh nothing special, just gathering supplies from an abandoned black site in the high rise district. I don't have much information on it right now, but once my contacts get back to me. I should be able to fill you in properly. But, from what I hear, the humans there were being very-very naughty little monkeys, and left all sorts of fun and expensive toys behind for us to play with,' she preens happily in a deeply draconic tone. That does sound promising, you reply diplomatically. 'Oh trust me [Name of Player] we're going to have a lot of fun this haul,' she titters. We'll see, you answer in a noncommittal tone and head off back towards the beach. Weighted down with all your supplies though, you find the trip back is a bit more difficult than the way there. Luckily, your tauric physique can handle the rugged craggy terrain far better then a weak biped. More than once you save yourself from a near fall with a shuffle of your legs. Offhandedly, you wonder if you should thank whoever gave it to you. It certainly has its uses, you muse, picking your way down the last few meters of sandstone hills and arrive back at the beach. You wonder what you're going to do, ";
						if "Touched by Madness" is listed in Feats of Player:
							say "next time on [bold type]Dragon Raider G! Enter the twenty-four Protective Deities![roman type]";
						else:
							say "the next time you see her";
						LineBreak;
						say "     [bold type]Author's note: Dragon Raider Galaxite ends here, for now[roman type].";
						now Loot Boxes is resolved;
						ItemGain Food by 10;
						ItemGain Water Bottle by 10;
						ItemGain Medkit by 10;
						ItemGain Soda by 10;
						ItemGain Chips by 10;
						ItemGain Revert All by 12;
						ItemGain Black Ops Helmet by 2;
						ItemGain Mini Helmet by 2;
						ItemGain Advanced Tactical Helmet by 2;
						ItemGain Hazmat Body Glove by 2;
						ItemGain Oversized Bodyglove by 2;
						ItemGain Flex Boots by 2;
						ItemGain Beastly Boots by 2;
						ItemGain PHASR by 2;
						ItemGain MAD Gun by 2;
						now Stamina of Galaxite is 4;
						now dexterity of Galaxite is 2;
				else if BodyName of Player is "Margay Taur" and Player is pure:
					say "     Your spined spire throbs with the sheer volume of your offering as you baste Galaxite's eager passage in a great torrent of your toasty catty seed. The blissful heat and monstrous volume of your imperial load pushes the horny half-dragon over the edge as she pants wildly at the sensation of her toned midriff subtly swelling to accommodate your virile offering. Yet, you still have much more to give, you muse, digging your forepaws into her athletic form, reveling in the heady sensation of her scalie cunny-muscles gripping the fleshy spines of feline tool like a glove as you pour what feels like gallons of potent feline seed into her plush cunt, as she cries, 'Dear sweet heavens yes! Fill me you naughty kitten!' as her receptive womb bulges out in a decadent fertile dome that would look more at home on an overdue broodmare than a person. All the while her skin creaks and groans from the sheer volume of your climax, as the gentle sloshing sounds of your immaculate load reverberates throughout the shipping crate. The seeded half-dragoness sways drunkenly beneath your exalted form as her hungry snatch devours the last drops of your rich baby batter.";
					say "     You loose a happy mewl and languidly unsheath your still-dripping rod from her molten passage, catty mind reveling at the tender caress of her velvety petals coddling your spines. A feeling Galaxite seem to share as the little half-dragon rumbles in bestial satisfaction at the all-too-pleasant catch of your barbs lavishing her sex as you slip your dick free with a beatific pop. ";
					if player is Herm:
						say "Carefully stepping over her prone form, you're pleasantly surprised to see, not single rivet of your pearly offering slip from her plush alabaster cunt as she gingerly rolls on to her back and skillful slips her tail free of your sweltering catty cunt with a playful flourish. ";
					else:
						say "Carefully stepping over her prone form, you're pleasantly surprised to see, not single rivet of your pearly offering slip from her plush alabaster cunt as she gingerly rolls on to her back. ";
					say "Eliciting a well-pleased purr from your lips at the raw innervating kiss of her spaded tail gracing your tauric button, she proudly presents her flush body to you rumbling. 'Mh such a mean cheeky kitty, I hope you're proud of yourself you just ruined my figure,' sensuously wagging her sloshing tanned middle before you.";
					WaitLineBreak;
					say "     Smirking at the sight of her well-packed belly swaying in her lap and the cute little indentations that her perky c-cup cast in her beautiful bronze tum as they laze comfortably atop her hopelessly swollen bump. You coyly stride up beside her and gently place a forepaw atop her verdant midriff and lovingly massage her creaking belly with your soft silky paw pads telling her very much so. Besides, you add, tracing soothing circles in her blushing bump-to-be, she's going to look absolutely adorable with a belly full of kittens. 'Mh, maybe,' Galaxite swoons, leaning into your touch as she affectionately fondles her supple body. She languidly draws her paws about her cute petite breasts, as she cups her scalie mitts about the lush curves of her toasty tum as if to admire the virile weight of your potent load. 'I've never had a litter of taurs before, it could be nice to kick back on the yacht for a few days getting waited on by Mr. K. till I'm due,' she pants, giving her midriff a jovial pat. Nodding, you teasingly tell her it would be a great look for her too and getting to feel all their sweet peets kicking will be a real treat for her as well.";
					if Player is mpreg_now and Cunt Count of Player is 0:
						say "     'That does sound nice, and it's not like I can be mad at a cute peach widdle boi like you [Name of Player],' Galaxite quips as her golden eyes appreciatively drift along the [bodydesc of player] swell of your plush paunch. 'It must be so hard for you to wander around the city like that carrying those big heavy balls and sweet little boi bump around. Your ankles must be killing you, why I've got half a mind to give you a whittle pawb rub, maybe put out a nice saucer of mommy's milk the next time I see you. Bet you'd like that wouldn't you big boi?' she titters with an encouraging wink, tracing a talon along the taut tan contours of her cum-laden body as she teasingly fondles her own soon-to-be milk-flushed chest, eliciting a sympathetic hungry rumble from your catty form at the mere mention of fresh milk. 'Daw, how adorable, kitty hungie?' she coos, clasping her talons about her perky nips and gives her supple teats a gentle squeeze. Mewling at the sight, you playfully tell her maybe, while your tail wags behind you.";
						say "     'Well, if this litter sticks,' she says with an eager pop of her hips that a sensual ripple through her fecund form, 'I'll let my big strong kitty boi have all the yummy cream he can drink and if you're an extra special good cat daddy, I'll even brush out your fur for you. Doesn't that sound nice, cutie?' she snickers though a knowing smirk. Chuffed, you indulgently inform her that the offer does have a certain appeal to it, you purr, arching your back to better highlight your curves while you openly caress your own bountiful tumby, delighting internally at the beautiful glow of your paternal pelt reflected in the available light as you lovingly pamper your latest litter. You note how your fur could use a little tender love and care, so you might just hold her to that while you dotingly paw at her hopefully cub-flushed tum with your catty forepaw. 'Of course sweetie,' Galaxite coos, leaning forward to give you a quick yet worshipful kiss, 'a pretty coat like yours deserves all the care in the world, but first could you be the world's biggest mensch and find the case I was fiddling with? I'd get it myself but I want to give the cubs a minute to get settled into their home,' she chuckles good-naturedly, as she protectively caresses her new found matronly curves with the tip of her tail.";
						WaitLineBreak;
						say "     Shrugging, you tell her that shouldn't be a problem then dexterously step around her and begin poking around the container. After a few moments of searching though, you locate the thing near the back of the crate under one of the mesh lockers. Kneeling down, you carefully slip your tail underneath and pull the thing free, then cheerfully pass it off to Galaxite. 'Aw you're such a gentle taur,' she simpers, taking the case from you and gliding her talon along edges. She slices through the metal suitcase like it was made of wet tissue paper with a quick flick of her wrist. With its locks severed, the travel case pops open with a muted hiss, revealing a number of unmarked and unpainted aerosol cans held in place by a thin black velcro strap. Slipping one out, she raises it into the available light, saying, 'Good the seals are intact. See these kids, because of this and your wonderful father here, Mommy is going to be able to take extra special good care of you,' as she sets one the canister on her tummy.";
						say "     Curious about what she's talking about, you ask what's so special about those cans. 'Right, here,' Galaxite pauses to toss one your way. Catching it, she continues, 'I don't really know what's used to make these, but according to my contacts the gas in these is something called [']Revert All['] that could turn just about anyone back into a *bleh* human.' She retches, shuddering at the thought. Interesting, you reply, something like this could help a lot of people, or if you found the right person sold for a lot of money. 'Exactly and since you've been such a mh generous helper,' she smirks, peering down at her altered form, 'I want you to have half of the canisters in this case, along with all the loot you can carry of course,' she adds, gesturing to racks of guns and supplies with a theatrical wave of her tail. That sounds fair, you reply. 'Good, I hope you find some stuff you like, I'd help out but I think I'm gonna rest here for a while longer.' She yawns, as she lays on her back luxuriating in the afterglow of your mating.";
						WaitLineBreak;
						say "     Nodding in agreement, you set about going through the various crates and boxes you and Galaxite opened earlier, picking out the various flavors of M.R.Es that appeal to you alongside a few you're curious about. Once you've gathered those up, you then turn your attention to remaining sundries, strong as your tauric body may be, you can only carry so much in one go. By the time you're just about ready to go though, you hear Galaxite call out to you, 'Hey [Name of Player] could you come here a sec? I forgot to mention something.' Shrugging you stride over to the container she's sheltering in. Peering inside, you spot the positively glowing half-dragoness lovingly stroking her distended tummy with her tail and ask what's up. '*Yawn* So, I may have another job lined up for us in the future, if you're interested, you should hit me or the boys up the next time you're at the beach,' she says, flexing her ivory claws in the available light. What's the job this time, you ask.";
						say "     'Oh nothing special, just gathering supplies from an abandoned black site in the high rise district. I don't have much information on it right now, but once my contacts get back to me. I should be able to fill you in properly. But, from what I hear, the humans there were being very-very naughty little monkeys, and left all sorts of fun and expensive toys behind for us to play with,' she preens happily in a deeply draconic tone. That does sound promising, you reply diplomatically. 'Oh trust me [Name of Player] we're going to have a lot of fun this haul,' she titters. We'll see, you answer in a noncommittal tone and head off back towards the beach. Weighted down with all your supplies though, you find the trip back is a bit more difficult than the way there. Luckily, your tauric physique can handle the rugged craggy terrain far better then a weak biped. More than once you save yourself from a near fall with a shuffle of your legs. Offhandedly, you wonder if you should thank whoever gave it to you. It certainly has its uses, you muse, picking your way down the last few meters of sandstone hills and arrive back at the beach. You wonder what you're going to do, ";
						if "Touched by Madness" is listed in Feats of Player:
							say "next time on [bold type]Dragon Raider G! Enter the twenty-four Protective Deities![roman type]";
						else:
							say "the next time you see her";
						LineBreak;
						say "     [bold type]Author's note: Dragon Raider Galaxite ends here, for now[roman type].";
						now Loot Boxes is resolved;
						ItemGain Food by 10;
						ItemGain Water Bottle by 10;
						ItemGain Medkit by 10;
						ItemGain Soda by 10;
						ItemGain Chips by 10;
						ItemGain Revert All by 12;
						ItemGain Black Ops Helmet by 2;
						ItemGain Mini Helmet by 2;
						ItemGain Advanced Tactical Helmet by 2;
						ItemGain Hazmat Body Glove by 2;
						ItemGain Oversized Bodyglove by 2;
						ItemGain Flex Boots by 2;
						ItemGain Beastly Boots by 2;
						ItemGain PHASR by 2;
						ItemGain MAD Gun by 2;
						now Stamina of Galaxite is 4;
						now dexterity of Galaxite is 2;
					else if Player is impreg_now:
						say "     'Oh that does sound heavenly, and I've never had a litter of big kitty herms either, or been knocked up by such a sexy mommy taur like you!' she simpers, shamelessly eying up the [bodydesc of player] curves of your feline figure and the tender contours of your [breast size desc of player] chest. 'Lucky duck, I bet it feels amazing waddling around town in your condition, knocking up all the cuties you can get your paws on while your body grows nice and ripe.' Enjoying her indulgent stare, you playfully adopt a proud maternal posture that better highlights your assets while your paws roam your expectant form, telling her that she's not wrong. Your intersexed tauric form definitely has its perks, like these nice strong paws, you tease idly raking your claws along her middle. Evoking a sensual shiver from the lewd half-dragon as thin crimson blossom on the taut surface of her tum in their wake. These soft fluffy balls, you swoon cheekily popping your hips in theatrical flourish just to feel the virile weight of your package as they bounce between your legs.";
						say "     The wonderful bubbly cocktail of mommy hormones coursing through you and the sumptuous weight of your brood putting pressure on the right places, you tease, dutifully groping a generous pawful of your ripening middle, wallowing at the sight and sensation of your gravid curves titillating your senses. And, you purr, admiring the growing radiance of your pelt, the eye-catching glow of your fur as your padded finger glides across the silken surface of your hide. 'Heh-heh your fur looks wonderful although,' she pauses to reach out and pet your bestial forpaws, 'I bet a pretty momma herm like you could use some T.L.C too, just look at your poor ankles when they last time someone got on their hand and knees to give them a good rub?' she teases, her eyes drifting along the predatory contours of your graceful body. Enjoying both her gaze and the attention, you playfully ask if she's offering to perform such a service. 'Maybe, if this litter sticks, but first do you think you could be a total mensch and grab that case for me? I'd get it myself, however the cubs could use a few minutes to get settled,' she chuckles good-naturedly, as she protectively caresses her new found matronly curves with the tip of her tail.";
						now dexterity of Galaxite is 2;
						WaitLineBreak;
						say "     Shrugging, you tell her that shouldn't be a problem then dexterously step around her and begin poking around the container. After a few moments of searching though, you locate the thing near the back of the crate under one of the mesh lockers. Kneeling down, you carefully slip your tail underneath and pull the thing free, then cheerfully pass it off to Galaxite. 'Aw you're such a gentle taur,' she simpers, taking the case from you and gliding her talon along edges. She slices through the metal suitcase like it was made of wet tissue paper with a quick flick of her wrist. With its locks severed, the travel case pops open with a muted hiss, revealing a number of unmarked and unpainted aerosol cans held in place by a thin black velcro strap. Slipping one out, she raises it into the available light, saying, 'Good the seals are intact. See these kids, because of this and your wonderful father here, Mommy is going to be able to take extra special good care of you,' as she sets one the canister on her tummy.";
						say "     Curious about what she's talking about, you ask what's so special about those cans. 'Right, here,' Galaxite pauses to toss one your way. Catching it, she continues, 'I don't really know what's used to make these, but according to my contacts the gas in these is something called [']Revert All['] that could turn just about anyone back into a *bleh* human.' She retches, shuddering at the thought. Interesting, you reply, something like this could help a lot of people, or if you found the right person sold for a lot of money. 'Exactly and since you've been such a mh generous helper,' she smirks, peering down at her altered form, 'I want you to have half of the canisters in this case, along with all the loot you can carry of course,' she adds, gesturing to racks of guns and supplies with a theatrical wave of her tail. That sounds fair, you reply. 'Good, I hope you find some stuff you like, I'd help out but I think I'm gonna rest here for a while longer.' She yawns, as she lays on her back luxuriating in the afterglow of your mating.";
						WaitLineBreak;
						say "     Nodding in agreement, you set about going through the various crates and boxes you and Galaxite opened earlier, picking out the various flavors of M.R.Es that appeal to you alongside a few you're curious about. Once you've gathered those up, you then turn your attention to remaining sundries, strong as your tauric body may be, you can only carry so much in one go. By the time you're just about ready to go though, you hear Galaxite call out to you, 'Hey [Name of Player] could you come here a sec? I forgot to mention something.' Shrugging you stride over to the container she's sheltering in. Peering inside, you spot the positively glowing half-dragoness lovingly stroking her distended tummy with her tail and ask what's up. '*Yawn* So, I may have another job lined up for us in the future, if you're interested, you should hit me or the boys up the next time you're at the beach,' she says, flexing her ivory claws in the available light. What's the job this time, you ask.";
						say "     'Oh nothing special, just gathering supplies from an abandoned black site in the high rise district. I don't have much information on it right now, but once my contacts get back to me. I should be able to fill you in properly. But, from what I hear, the humans there were being very-very naughty little monkeys, and left all sorts of fun and expensive toys behind for us to play with,' she preens happily in a deeply draconic tone. That does sound promising, you reply diplomatically. 'Oh trust me [Name of Player] we're going to have a lot of fun this haul,' she titters. We'll see, you answer in a noncommittal tone and head off back towards the beach. Weighted down with all your supplies though, you find the trip back is a bit more difficult than the way there. Luckily, your tauric physique can handle the rugged craggy terrain far better then a weak biped. More than once you save yourself from a near fall with a shuffle of your legs. Offhandedly, you wonder if you should thank whoever gave it to you. It certainly has its uses, you muse, picking your way down the last few meters of sandstone hills and arrive back at the beach. You wonder what you're going to do, ";
						if "Touched by Madness" is listed in Feats of Player:
							say "next time on [bold type]Dragon Raider G! Enter the twenty-four Protective Deities![roman type]";
						else:
							say "the next time you see her";
						LineBreak;
						say "     [bold type]Author's note: Dragon Raider Galaxite ends here, for now[roman type].";
						now Loot Boxes is resolved;
						ItemGain Food by 10;
						ItemGain Water Bottle by 10;
						ItemGain Medkit by 10;
						ItemGain Soda by 10;
						ItemGain Chips by 10;
						ItemGain Revert All by 12;
						ItemGain Black Ops Helmet by 2;
						ItemGain Mini Helmet by 2;
						ItemGain Advanced Tactical Helmet by 2;
						ItemGain Hazmat Body Glove by 2;
						ItemGain Oversized Bodyglove by 2;
						ItemGain Flex Boots by 2;
						ItemGain Beastly Boots by 2;
						ItemGain PHASR by 2;
						ItemGain MAD Gun by 2;
						now Stamina of Galaxite is 4;
						now dexterity of Galaxite is 2;
					else:
						say "     'That does sound nice, and I've never had a cute widdle litter of kittens before, much less been knocked up by a big sexy taur before,' she hums, eyeing up your catty body with obvious delight. Enjoying the attention, you can't help but adopt a playful pose for the lewd demi-dragon. 'Mh you're such a beautiful kitty, you know, I hope the little ones come out just like you, it will be so fun to spoil and pamper the sweet little dears,' she purrs, as a pair of joyful tears stream down the sides of her face, 'I can't wait to hold all these adorable fluff balls in my arms, and I just know the boys are going to love playing with them too,' she says, running her hand along the heavenly swell of her ripe heavy middle."; [Note: Big cats love swimming]
						say "     Mewling delightedly in reply, you tell her that would be quite the spectacle. '*Tee-hee* I know right, just think of all the fun they'd have getting to fly around the city, or exploring the ocean with their big brothers,' Galaxite gushes, as her eyes drift towards the surf while a proud motherly smile blossoms upon her lips. Bobbing your head, you inform her how wonderful that sounds, after all you can't think of many better minders for your precious kittens than a Tyranny of titanic dragons and who knows, perhaps they could even learn some of their sibling tricks. 'Maybe, I don't think the boys have ever tried to teach anyone else before. Hopefully, this litter sticks and we can find out together cutie, but first do you think you could be a total mensch and grab that case for me? I'd get it myself, but the cubs could use a few minutes to get settled,' she chuckles good-naturedly, as she protectively caresses her new found matronly curves with the tip of her tail.";
						now dexterity of Galaxite is 2;
						WaitLineBreak; [merge here]
						say "     Shrugging, you tell her that shouldn't be a problem then dexterously step around her and begin poking around the container. After a few moments of searching though, you locate the thing near the back of the crate under one of the mesh lockers. Kneeling down, you carefully slip your tail underneath and pull the thing free, then cheerfully pass it off to Galaxite. 'Aw you're such a gentle taur,' she simpers, taking the case from you and gliding her talon along edges. She slices through the metal suitcase like it was made of wet tissue paper with a quick flick of her wrist. With its locks severed, the travel case pops open with a muted hiss, revealing a number of unmarked and unpainted aerosol cans held in place by a thin black velcro strap. Slipping one out, she raises it into the available light, saying, 'Good the seals are intact. See these kids, because of this and your wonderful father here, Mommy is going to be able to take extra special good care of you,' as she sets one the canister on her tummy.";
						say "     Curious about what she's talking about, you ask what's so special about those cans. 'Right, here,' Galaxite pauses to toss one your way. Catching it, she continues, 'I don't really know what's used to make these, but according to my contacts the gas in these is something called [']Revert All['] that could turn just about anyone back into a *bleh* human.' She retches, shuddering at the thought. Interesting, you reply, something like this could help a lot of people, or if you found the right person sold for a lot of money. 'Exactly and since you've been such a mh generous helper,' she smirks, peering down at her altered form, 'I want you to have half of the canisters in this case, along with all the loot you can carry of course,' she adds, gesturing to racks of guns and supplies with a theatrical wave of her tail. That sounds fair, you reply. 'Good, I hope you find some stuff you like, I'd help out but I think I'm gonna rest here for a while longer.' She yawns, as she lays on her back luxuriating in the afterglow of your mating.";
						WaitLineBreak;
						say "     Nodding in agreement, you set about going through the various crates and boxes you and Galaxite opened earlier, picking out the various flavors of M.R.Es that appeal to you alongside a few you're curious about. Once you've gathered those up, you then turn your attention to remaining sundries, strong as your tauric body may be, you can only carry so much in one go. By the time you're just about ready to go though, you hear Galaxite call out to you, 'Hey [Name of Player] could you come here a sec? I forgot to mention something.' Shrugging you stride over to the container she's sheltering in. Peering inside, you spot the positively glowing half-dragoness lovingly stroking her distended tummy with her tail and ask what's up. '*Yawn* So, I may have another job lined up for us in the future, if you're interested, you should hit me or the boys up the next time you're at the beach,' she says, flexing her ivory claws in the available light. What's the job this time, you ask.";
						say "     'Oh nothing special, just gathering supplies from an abandoned black site in the high rise district. I don't have much information on it right now, but once my contacts get back to me. I should be able to fill you in properly. But, from what I hear, the humans there were being very-very naughty little monkeys, and left all sorts of fun and expensive toys behind for us to play with,' she preens happily in a deeply draconic tone. That does sound promising, you reply diplomatically. 'Oh trust me [Name of Player] we're going to have a lot of fun this haul,' she titters. We'll see, you answer in a noncommittal tone and head off back towards the beach. Weighted down with all your supplies though, you find the trip back is a bit more difficult than the way there. Luckily, your tauric physique can handle the rugged craggy terrain far better then a weak biped. More than once you save yourself from a near fall with a shuffle of your legs. Offhandedly, you wonder if you should thank whoever gave it to you. It certainly has its uses, you muse, picking your way down the last few meters of sandstone hills and arrive back at the beach. You wonder what you're going to do, ";
						if "Touched by Madness" is listed in Feats of Player:
							say "next time on [bold type]Dragon Raider G! Enter the twenty-four Protective Deities![roman type]";
						else:
							say "the next time you see her";
						LineBreak;
						say "     [bold type]Author's note: Dragon Raider Galaxite ends here, for now[roman type].";
						now Loot Boxes is resolved;
						ItemGain Food by 10;
						ItemGain Water Bottle by 10;
						ItemGain Medkit by 10;
						ItemGain Soda by 10;
						ItemGain Chips by 10;
						ItemGain Revert All by 12;
						ItemGain Black Ops Helmet by 2;
						ItemGain Mini Helmet by 2;
						ItemGain Advanced Tactical Helmet by 2;
						ItemGain Hazmat Body Glove by 2;
						ItemGain Oversized Bodyglove by 2;
						ItemGain Flex Boots by 2;
						ItemGain Beastly Boots by 2;
						ItemGain PHASR by 2;
						ItemGain MAD Gun by 2;
						now Stamina of Galaxite is 4;
						now dexterity of Galaxite is 2;
				else:
					say "     You commanding clench your forepaw about her delightfully soft yet unerringly toned middle as you heft her small form off ground and almost hilt your [cock size desc of player] [CockName of Player] spire with one potent climatic thrust. Thrown off balance, the little demi-dragon is sent tumbling to the ground as your cock thrums with heady pulses of aphrodisiacal delight as your turgid rod strains against the supple silky embrace of eager passage as you loose a flood of molten seed upon her respective depths. Hopelessly lost in her lustful elysium, the horny half-dragon merely rumbles beneath you in bestial elation as her tummy swells with the beatific weight of your animalist offering. Enthused by her lurid pants and the gentle caress of her quivering walls rippling about the unique contours of your tool, you cheekily glide your dominant forepaws down the along the taut curves of her silky bronze middle, reveling at the inviting warmth of your load gracing your pads, before easing her to the ground.";
					say "     'Mh, you're such a naughty monster [name of player], just look what you've done to me,' Galaxite hums in a sweet sing-song voice, as you hear her roll over onto her back ";
					if player is Herm:
						say "and dexterously slips her spaded tail from the tender hold of your tauric cunt with a theatrical swish. Evoking a happy rumble from your lips at the heavenly caress of her dexterous appendage roiling your tauric muffle as the potent echoes of her silk scales waltz about delightfully raw passage. ";
					else:
						say "with a content sigh. ";
					say "Following her cue, you carefully sidestep her prone form to gaze at the blissful sight of the lewd demi-dragoness in full repose, you find yourself chuffing with animalist pride at the sumptuous spectacle of her rosy tanned middle resting comfortably on her draconic laps, purring in a teasing tone, 'You cheeky little monster, I can't believe you're trying to burden a poor defenseless maiden with your wicked spawn,' as she playfully traces her talons along her bountiful curves of her delectably cum-flated tum. Smirking, you coyly brush your forepaw against her supple body, wallowing internally at the cute preyish shiver passing through her toned form as your talons affectionately traipse across the sweltering tum, leaving streaks of rosy lover's marks in her wake, jokingly asking her if she can really blame you? A sweet treat like her is such a tempting treat of virile beast like yourself.";
					WaitLineBreak;
					say "     'Ha-ha, I guess you're right you naughty flatterer, besides...' she swoons, gently lifting her left leg before herself, openly admiring the lustrous reflections of her royal navy blue scale playing across the shipping crate hull while she flexes her cute paws and scything talons in a languid predatory rhythm as if to confirm their existence. 'That felt amazing! And,' she adds, casting you a catty sidelong glance, 'you weren't half bad either.' Tittering good naturedly, you politely ask if that means she's not mad at you for mounting her. 'Of course not you sneaky brute, I've never been topped by a big sexy taur before,' she hums as her eyes drift appreciatively about your [bodydesc of player] form. 'It felt so wild and primal getting claimed by such a savage beast, I can't believe what I was missing out on.' So does them mean she's up for a round two, you simper through a wide cheshire grin.";
					say "     'Maybe later cutie,' Galaxite rumbles, awkwardly hoisting herself to her paws, as a pearly sheen of your tainted seed shamelessly streams down the toned contours of her legs. She teasingly arches her back to better highlight the taut swell of her gleaming tum as she struts towards you with a hungry draconic look in her eyes as she presses plush bump against your titanic frame and drapes her arms around your anthro waist. 'Next time though,' she purrs, lightly drawing her talons along the small of your back as she longingly gazes up at your [facename of Player] face. 'I think I wanna be the one on top, after all, a [bodydesc of player] body like yours is just made to be ridden, wouldn't you agree, kin da rune?' she titters, as she leans in and dotingly nuzzles her cheeks against your [breast size desc of player] chest. Nodding, you affectionately cup your paws to the side of her head and tenderly run your fingers through her hair as you playfully tell her that could be arranged. Still as the harsh reality of post-nut clarity begins to washes over you, you can't help but voice a modicum of concern over the sultry half-dragoness sudden transformation."; [kin da rune = child of beasts or animal essentially she's saying you animal and she no longer thinks of the PC as human... which is a good thing in context.]
					WaitLineBreak;
					say "     One moment, she seemed fine, the next she was all over the case and started mutating right before your eyes. What's more, you were under the impression she seems to be somewhat resistant to transformations general, at least, if her claims of siring an impressive number of dragons are to be believed, so what changed? 'Hm,' she says with a neutral shrug and takes a step back. 'Not sure but,' Galaxite chuffs, her lips curling into a predatory smirks as she idly examines her talons, 'I can't say I don't like the results though.' Cocking an eyebrow at her, you ask if she's serious isn't she worried about what life will be like for her outside of the city. 'Mmaayybbee,' she chuckles in a mischievous sing-song voice, 'but I kind of like the new me. Now, where did that case get to?' she continues, her tone flattening into a more business-like cadance as she makes a show strutting around the container and dropping down to her hands and knees to peer under each mesh locker.";
					say "     All the while, the shameless demi-dragon makes no effort to conceal her still dripping sex as litters of alabaster excess leak upon the sheet metal floor in a low lewd patter as her swollen tummy slowly deflates before your eyes. A part of you can't help but enjoy the cute little spectacle of her gently swaying hips and adorable blush of tummy peaking out from between her thicc muscular legs as she searches every nook and cranny. Eventually, Galaxite's eccentric circuit brings her to the back of the container where she suddenly exclaims, 'HA there you are, now come to momma!' as she hurriedly jams her left arm beneath one of the rearmost lockers and plucks what suspect is the case out from underneath. 'Got ya!' she roars, bolting back up to her full height with the briefcase hooked upon the crook of her talons and turns on the balls of her paws to face you. 'Now lets see if Homaru was right about that ship,' she beams, casually swiping her talons along the borders of the case in a quick fluid motion.";
					say "     At once, a light pressurized hiss echoes through the area as the thing folds open upon some internal hinge revealing two rows of silvery unadorned aerosol cans, not all that dissimilar to the kind used in spray-on deodorant, held in place by a thin strip of black velcro. 'Nice, the seals are still intact!' Galaxite preens as she gingerly plucks one of the small vessels out of the box with her thumb and pointer finger then holds it before herself. Reasonably curious about her find, you ask what's so special about those canisters. 'Right, I'm not too sure what's in these exactly, but my contacts say it's something called: [']Revert All[']. Allegedly,' she says, somewhat incredulously, as she taps her toe talons against the sheet metal floor. 'This stuff is able to turn just about anyone back into a, *gag* human.' She retches, as a disgusted shiver passes through her athletic form. 'At least, *ahem*,' she pauses to clear her throat, 'physically, I should say.' Facinating, you quip, she could do a lot of good with those and they'd could be rather valuable to the right person.";
					WaitLineBreak;
					say "     'Exactly and since you've been so,' she hesitates a moment, while her hands drift over the sensual bulge of her midriff as she lovingly fondles her toasty cumflated core with languid enticing strokes. 'Helpful, I want you to have half of these, along with all the loot you can carry of course,' she adds, gesturing to the piles of supplies and materials littering the area with a broad sweep of her tail. Nodding, you tell her that does sound more than fair all things considered. 'Right, let's get you packed then cutie,' Galaxite simpers sweetly as she pulls out a dozen vials of Revert All and deposits them into your waiting mitts. Swiftly squirreling them away for later, the two of you set about picking the impressive collection of supplies. Rather spoiled for choice, you decide to pick out some of the more interesting flavors of M.R.E.s along with a few packs of sweets and sodas, alongside for your trouble.";
					say "     While you're packing, Galaxite grabs a number of suits and guns for you as well and offers to help carry them on the climb. A service you're rather grateful for, as despite your strong tauric build, there's only so much you can safely carry on the winding weather-beaten deer tail, you muse as the two of you begin slowly trek back to The End of The Beach. Along the way though, a now fully slimmed down Galaxite mentions she might have another job lined up for the next time you're in the area, one she claims will make the pair of you very wealthy. Try as you might to coax a more information from her though, she remains tight lipped, claiming she doesn't want to ruin the surprise for you. Guess you'll have to find out, ";
					if "Touched by Madness" is listed in Feats of Player:
						say "next time on [bold type]Dragon Raider G! Enter the twenty four Protective Deities![roman type]";
					else:
						say "the next time you see her.";
					LineBreak;
					say "     [bold type]Author's note: Dragon Raider Galaxite ends here, for now[roman type].";
					now Loot Boxes is resolved;
					ItemGain Food by 10;
					ItemGain Water Bottle by 10;
					ItemGain Medkit by 10;
					ItemGain Soda by 10;
					ItemGain Chips by 10;
					ItemGain Revert All by 12;
					ItemGain Black Ops Helmet by 2;
					ItemGain Mini Helmet by 2;
					ItemGain Advanced Tactical Helmet by 2;
					ItemGain Hazmat Body Glove by 2;
					ItemGain Oversized Bodyglove by 2;
					ItemGain Flex Boots by 2;
					ItemGain Beastly Boots by 2;
					ItemGain PHASR by 2;
					ItemGain MAD Gun by 2;
					now Stamina of Galaxite is 4;
			else if BodyName of Player is "Dragontaur" and Player is pure and Cock Count of Player is 0 and Cunt count of Player >= 1:
				say "     Drinking in the sight of the vulnerable half-dragoness's gently swaying hips as she feverishly fiddles with the odd metal case, your eyes slowly roam the sweet blush of crimson playing across her ivory cunny scales, and the tantalizingly teasing scent of her heat. You find it hard to resist the growing urges of your draconic form to indulge yourself upon her liminal form, especially when she's in such a prime position to be claimed by a tauress like yourself. You think to yourself, observing the available light gently playing across the curves of her almost heart-shaped ass, and the adorable white scales swaddling the delta of her sex that seem to draw your gaze to her scaley cunt like gleaming blue road studs on a moonless night, you opine, stealthy pawing up behind her. Engrossed in her strange frenzy, the budding half-dragoness doesn't even react to your presence in the slightest or the gentle click of your claws along the sheet metal floor. Only as your spaded tail cheekily coils about the newly formed demi-wyrm's toned legs, gently caressing her sleek nether lips does a low yet pleased draconic rumble escapes her lips.";
				say "     She eagerly, if thoughtlessly presses the sweltering lips of her altered sex along the glossy scales decorating your sizable tail, as she languidly grinds her lower half against you, coating the graceful accents of your seventh limb in a generous sheen of her floral honey. You find yourself rumbling with reptilian delight as the welcoming heat of her draconic sex gently trickles up your spine as if the warm kiss of tranquil tropical sun were saturating the sleek lamina bejeweling your dexterous limb in a growing layer of natural lubricant with each pass of your sordid tail. The heavenly caress of her pleasantly plush sex flickering about your tail as lustful beads of her glistening juice traces the tiny borders of your scales. Once you judge yourself suitably lubed, you arch your extra appendage in an intrinsic [']U-bend['], and thrust, spearing the smaller dragon girl upon the girthy spade of your tail in a single fluid motion.";
				WaitLineBreak;
				say "     'Oh f-flip yes! I don't know what's come over you [Name of Player] but don't stop!' Galaxite cries, her stomach bulging to accommodate your lengthy limb as you glide your elated tail along her velvety passage in a wild bestial rhythm. Your reptilian mind revels in the blissful needy spasms of her altered cunny as it seems to mold itself about your tapered spaded tail as it plumbs her fiery depths. Each primal piston of your tail elicits a pleasant, and wonderously pleasing to your ears mewl from the newly forged half-dragoness's lips, while she rocks her altered form in tandem with the sordid motions of your prehensile limb. All the while, your forepaws roam Galaxite's athletic figure, exalting at the sensual sensation of her smooth bronzed skin and spreading scales gliding over your pads alongside the tactile catch of your talons as you trace the glossy borders of her shifting hide. You playfully massage the cute bulge your tail makes in her otherwise tight body, delighting internally at the adorable squelching sound of your tail reaming her elastic passage.";
				say "     Perhaps encouraged by your lustful antics, her own tail caresses your hindleg as she teasingly snakes the royal navy blue appendage up your digitigrade leg. As the tapered tip of her tail lightly brushes the tender petals of your draconic flower, you find yourself rumbling approvingly as she lavishes the glossy folds of your scaly vulva and exotic clit with generous strokes of the thinnest part of her prehensile limb. Your lust-flushed cunt gushes with coldblooded rapture as the cheeky half-dragon slathers her silken tail scales in a fresh coat of your own draconic juice with the languid strokes of her sleek pleasure tool. Almost dripping with your girly honey in a sensual mirror of your own inquisitive limb, she teasingly slips her new appendage betwixt your exotic nether lips, simpering, 'Mh you're so tight, lucky duck, I bet you have all the fun out there with this cute body,' as her tail writhes about your satin walls."; [I was gonna make some variants based on cunt size but no one wants to hear: 'Damn girl fucking you be like throwing a hot dog down a mine shaft.']
				WaitLineBreak;
				say "     You find yourself rumbling in bestial satifaction at the sensual kiss of her spaded tail twisting and contorting alongside the heady quivering of your tauric sex as her smoother-than-sea-polished-glass scales traipses about the well-loved passage of your [Cunt Size desc of Player] muff, lavishing your reptilian box in a wild whorl of bestial sensation. A part of you is almost impressed by the lesser wyrm's control over her newly transformed body, her malleable tail seems drawn like the alien poles of a living pleasure magnet to the rawest and most tender nerves of your animalistic cunt. While the exotic texture of her scales simmers along your ecstatic passage as she shifts her coils in on itself like an animated corkscrew that never stays the same shape for long as she gradually hilts her own tail into your sweltering depths amid a gush of your draconic juices. You almost roar your elation to the rafters as her sinuous tail brushes your cervix and the feelings of profound fullness waltzes about your senses. Not to be out done though, you fold your own bitch-breaking limb in a glistening azure knot of your own, rollicking at the alien sensation of her toasty cunny spasming about your vibrant scales and the verdant heat roiling along the elated borders of your tainted psyche.";
				say "     You'd nearly swear her passage was ribbed, as her draconic snatch ripples about your sordid limb in an unearthly ballet of carnal delight that pairs oh-so-heavenly with the generous railing of your own sex. Your every tender fold thrums with unbound elysium as enthralling pulses of storm-wrought static blissfully cascade along your feral depths, while your forepaws roam her toned liminal form's heavenly curves. The sensation of your scything talons and soft paw pads gliding over her hybrid hide sends a heady chill down your lengthy spine as you cup and fondle her perky breasts while she sways in your grasp. Your altered mind rollicks at the supple weight of her supple tits playing against your mitts as you cheekily grope her maternal mounds. Not that the cute little demi-dragon seems to mind, if anything, she moans happily at the rough treatment of her draconic cunt as she hungrily bucks her hips in tune with the potent piston of your tail, practically hilting her svelte body on your spaded limb.";
				WaitLineBreak;
				say "     Your paws glide along the lissome curves of her hourglass waist as you indulge your curious mitts upon the tight contours of her core and generous maternal padding adorning her still shifting flanks. Her hips seem to widen ever-so-slightly as your claw sinks into her shapely ass, provoking a cute, almost reptilian, chirp from her as she rakes her nails across the floor of the container like an eager heat-addled beast. As you ravish her altered sex with the hard meaty thrust of your spaded tail sending light shockwaves through the thin metal shipping crate, the area echoes with the lurid rhythmic sounds of your draconic mating elegantly mirroring the heavy impassioned beats of your tauric heart as the lesser female's tail brushes your exotic clit. Only the sudden harsh sounds of tearing metal breaks the rapturous spell cast by the meager half-dragoness's loving touch. Looking down at the source of this dreadful din in dry annoyance, you notice with some strange sense of satisfaction that Galaxite's arms have begun towards a more draconic bend.";
				say "     Her growing pearlescent nails rip deep furrows into the sheet metal with contemptuous ease, while a shimmering layer of aquamarine scales spreads across her sun-bronzed skin like pure azure sky breaking through a blanket of storm clouds. You watch them spreading up her lithe arms while they appear to gain a pleasant degree of definition, highlighted all the more by the lustrous royal navy blue lamina hugging the athletic contours of her limbs. In moments, her arms are almost totally engulfed all the way to her shoulders in blue opalescent imperial scales, though a few patches of these glistening lamia still filter into her core. Dimly, you can hear her hiss something in the alien pidgin her children speak at this, but lost in your own whirlpool of draconic passions, the meaning of her strange words are lost to you. Your senses are solely focused on a squall of desire building in your core, the sensation of Galaxite's mutant muff swaddling spaded tail, and the gleeful caress of her silky bronze skin playing upon the beautiful scales jeweling your [bodydesc of player] lower half.";
				say "     Enraptured by the sight of her changes and the raw unbound bliss of her sensuous body writhing beneath you, you cup your unoccupied anthro arm to ";
				if Breast Size of Player is 0:
					say "your toned, gleaming, washboard chest, reveling in the pure unsullied reptilian majesty of your draconic being. ";
				else if Breast Size of Player >= 1 and Breast Size of Player <= 4:
					say "your cute petite [breast size desc of player] tits adorning your steely blue torso. As you indulge your tactile senses upon sumptuous perky hills and delightfully stiff nips of your sensible sized rack. ";
				else if Breast Size of Player >= 5 and Breast Size of Player <= 12:
					say "your tender tauric tits, marveling at their gentle heft and lightly bounce of your voluptuous [breast size desc of player] breasts playing across your elated pads as you pound the squirming lesser wyrm beneath you while the available light seems to dance along your lustrous steely blue scales, casting a bountiful prismatic ballet of many colors and none upon the shaded walls of the container. ";
				else if Breast Size of Player >= 13 and Breast Size of Player <= 19:
					say "your immensely immaculate [breast size desc of player] orbs that so perfectly match your imperial height and regal draconic form. Their every sensuous wobble and plush weight pairs elegantly with the heavenly echoes of reptilian rapture flitter through your well-fucked form. ";
				else if Breast Size of Player >= 19:
					say "the plush decadent swell of your [breast size desc of player] tits. Though you're barely even able to get your paws around their plump ponderous mass, despite your impressive size, the enticing struggle and subtle creak of your vibrant blue-steel lamina brings a proud smirk to your draconic lips. You lovingly trace your fingers along the taut borders of your scalie breasts while they wobble in tune with bestial rhythm with the hearty pounding for your [cunt size desc of player] cunt. ";
				say "Meanwhile, the glass-smooth folds of the shifting woman's prehensile tail cinches about the exotic border of your draconic joybuzzer, as she dexterously jills your throbbing clit in her impossibly glossy coils. Evoking a well-pleased rumble from your lips as the ponderous length of her girth roils along the bestial walls of your [cunt size desc of player] cunt, she desperately spears herself upon your meaty tail as her muff feverishly milks your nimble appendage. Cold-blooded bliss cascades through your [bodydesc of player] being as these intersecting fonts of felicitious rapture coil about your mind as if they were the spiraling arms of a hurricane enveloping your consciousness in an ever growing gale of delight.";
				say "     Till at last, like you're passing through the of eye of your own personal storm, your senses are set awash with relief and release as you cum with a bestial draconic roar that drowns out the simpering mewls of the lesser wyrm beneath you. Your cunny shudders and spams like an overloaded switchboard as Galaxite squirts a gentle trickle of floral fem honey down the length of your spaded tail as she collapses face first into the scratched-up floor with a loud room-rattling thud. 'Holy sh-, ship [Name of Player] that was, that was, mh fun,' Galaxite pants, limply extricating her tail from your sodden depths with a delightful toe-curling pop as your still-tender pussy gushes at the unsubtle innervation of her scales['] worshipful parting kiss. You in turn disentangle your tail from her while doing your best to suppress the heady shiver running up your spine at the harsh contrast of the coastal air and Galaxite's toasty dew nipping at your senses. Carefully backpedaling off her, you can't help but smirk at the sight of a lowly sated half-dragoness collapsed face down before you as lucid drops of dew waltz down the chiseled contours of her digitigrade leg or the rosy blush of her cunt as she lays there.";
				WaitLineBreak;
				say "     Snickering under your breath, you cheekily ask if perhaps you were a bit too rough on the newly forged half-dragon or she needs a hand getting up. 'N-no I'm goooooood,' Galaxite purrs like a drunken kitten as she lists and rolls onto her back, panting like a bitch in her deepest heat. '*Tee-hee* ah, just let me lay here a minute, the floor feels so nice and cool,' she murmurs, gently stroking her tender tummy and abused ivory cunny as she rides out the lingering dual highs of her climax and transformation. Sure thing cutie, you tease sitting yourself down next to her. You tuck your fem-cum-slicked tail behind her head like a pillow as she recovers. 'Mh, thanks. You're the best,' she coos, lovingly nuzzling her chin against you as she dozes. [italic type]Sometime later[roman type] once Galaxite has fully recovered from her sudden change and her thorough tail-fucking, you ask her what happened, one moment she was fine and next she acted like a moon-mad feral clawing at that weird metal briefcase.";
				say "     'I don't really know what came over me, [Name of Player],' Galaxite shrugs as she lays in your tauric embrace, idly fondling your tail as if it were some beloved pet. 'But it felt really good and... primal, can't say I don't love the results either. I mean just look at these cute little claws!' she squeals, as she lifts her toned leg into the air, flexing her reptilian toe claws so that they catch the available light. 'Not that yours aren't super pretty too,' she adds hastily, fixing you with an earnest apologetic look. 'But just look at the sheen! They're almost like they are made of mother of pearl, don't they!?' she swoons as the local lumens dance across the sharp edges of her talons, reflecting tiny rainbow prisms along the walls of the container. Nodding, you tell she should look into having them lacquered at some point. 'That does sound nice, maybe I should get some toe rings to go with it. Oh we can get you some too bestie! So what do you think would go with our scales: rose gold, electrum, or platinum?' she preens, cocking her talons in your direction. Shrugging, you tell her that it depends on the style, weight, and the adornments after all.";
				WaitLineBreak;
				say "     'Ya you're right, we should probably see a jeweler first, but when this is all over I'm so taking you out shopping later, and I am not taking no for an answer! I even know this great place on the border of Berkeley and Piedmont that does great custom fitting. Before that, we're gonna need funds and as luck would have it I know just where to get some,' Galaxite simpers as she springs to her feet, or paws you mentally correct yourself, and begins rooting around the container. 'Gosh darn it where is that thing,' she grumbles peering under the rows of mesh lockers. 'AH-HA! There you are, slippy little sh-, arg, so-and-so!' she cries, pulling the briefcase she was obsessing over moments prior from beneath one of the lockers in the rear. So what's in that, you ask. 'You know, I'm not actually sure but,' Galaxite pauses and sinks her claws into [']edges['] of the case like it were made of wet tissue paper then slices the thing open.";
				say "    With a low whine, the case folds outward on its internal hinge revealing two rows of tiny gray aerosol cans akin to the spray on deodorant men like to use, secured by a line of black velcro on the folded out halves of the case. 'According to my ";
				if "Touched by Madness" is listed in feats of Player:
					say "simps ";
				else:
					say "contacts ";
				say "the gas in these things can turn just about anyone into a lowly *ich* human.' Galaxite grumbles, rolling her slitted eyes. Interesting, she could do a lot of good with those, or sell them for lots of money, you note. 'Heh, exactly bestie, which is why I want you to have half the canisters. Here, my treat,' Galaxite says pulling a handful of gas containers out and drops them into your waiting mitts. 'Oh, don't forget to grab whatever you like from the rest of the shipping crates. No way me and the boys can use it all, even if we wanted to,' Galaxite says in a cheerful tone, motioning to the assembled containers with a commanding wave of her left hand. Not one to turn down free supplies, especially when you've worked so hard to secure them, you nod your head in the affirmative. 'Right let's get you packed then,' Galaxite says as she begins dividing up the haul.";
				WaitLineBreak;
				say "     You and her spend the next few minutes going through the selection of M.R.Es, along with the other supplies to pick out the stuff you like. Sadly, there is only so much you can carry in a single journey over the craggy hill separating the beach and cove. Galaxite does however offer to help carry some for you in her scuba bag. Which you're a bit grateful for, you're not sure you'd be able to take all this stuff back to the bunker by yourself. After all, you can always stash a few items at the beach for later. Never know when you need them, you think to yourself as the pair of you pick your way back to the beach. You both say your goodbyes, though Galaxite does mention that she may have another job for you in the near future. When you try to question her about it, she becomes rather tight-lipped, stating that she doesn't want to ruin the surprise. However, she does hint that this next one could leave the two of you very rich. Guess you'll have to find out, ";
				if "Touched by Madness" is listed in Feats of Player:
					say "next time on [bold type]Dragon Raider G! Enter the twenty-four Protective Deities![roman type]";
				else:
					say "the next time you see her.";
				say "     [bold type]Author's Note: Dragon Raider Galaxite end here, for now.[roman type]";
				now Loot Boxes is resolved;
				ItemGain Food by 10;
				ItemGain Water Bottle by 10;
				ItemGain Medkit by 10;
				ItemGain Soda by 10;
				ItemGain Chips by 10;
				ItemGain Revert All by 12;
				ItemGain Black Ops Helmet by 2;
				ItemGain Mini Helmet by 2;
				ItemGain Advanced Tactical Helmet by 2;
				ItemGain Hazmat Body Glove by 2;
				ItemGain Oversized Bodyglove by 2;
				ItemGain Flex Boots by 2;
				ItemGain Beastly Boots by 2;
				ItemGain PHASR by 2;
				ItemGain MAD Gun by 2;
				now Stamina of Galaxite is 4;
			else if Affection of Ava is 1 and BodyName of player is "Margay Taur" and Player is pure and Player is female and scalevalue of Player is 5:
				say "     Wallowing in the blissful sight of the curvaceous half-dragon's breedable ass gently wobbling before you, and the sweet coiling scent of girly heat wafting about your catty nose, your eyes are slowly drawn to the sumptuous spectacle of her blushing alabaster slit nestled between her shapely reptilian thighs while she fiddles with the case. Your tail cunt thrums with needy pulses of aberrant delight at the lewd thought of indulging your exotic body upon the budding scalie as you watch warm beads of sensual dew trickle down the bejeweled contours of her legs while her toe talons lighty rake the sheet metal beneath her. Enthused by the sight of her lush sex and convenient position, you leisurely paw atop her prone figure, internally delighting at the subtle click of your claws on the reverberative floor as you cheekily coil your ovi tail about the frenzied demi-derg's left leg, provoking a cute little quiver from her altered body as the silky spotted pelt bejeweling your tail cunt lovingly glides along her sleek glossy scales, while a needy well-pleased draconic rumble filters through her lips.";
				say "     Galaxite's spaded tail languidly brushes your rear ankles as she leans into the sensual caress of your inquisitive limb, murmuring in a dissociated yet appreciative cadance, 'Mh so soft,' while you coyly trace the supple folds of your ovi cunt about her glistening inner thighs. Mewling appreciatively in reply, you expertly snake your tail along the toned contours of her reptilian legs, basking in the heat-laden warmth of her athletic figure and the beatific dissonance of your entwined bodies as your plush tail pussy succulently caresses her puffy alabaster snatch. You affectionately pamper her lust-flushed muff with slow enthralling dandles of your ponderous prehensile limb, evoking a heavenly gush of sweet balmy dew from her draconic folds as her decadent engored and blushing sex hungrily hugs your tail. Meanwhile, you jovially cup your dominant forepaw about her svelte hourglass core, delighting yourself upon her smooth sun-kissed skin playing upon your cute catty pads and the subtle catch of your claws upon her shifting form.";
				WaitLineBreak;
				say "     'Such a naughty kitten,' Galaxite teases, rocking her pleasantly thicc hips in tune with the lurid motion of your dexterous limb, as her plush welcoming cunt slathers your fur in a toasty sheen of fem honey. The familiar scents of bestial heat and feminine lust flicker along the edges of your senses and your tail cunt and lengthy ovi passage are set awash in blissful medley of sensations as the pernatural muscles lining your egg-laying limb thrum with fertile purpose amid the tender caress of the liminal woman's plush folds playing across your exotic appendage. Elated by the blissful echoes of desire coursing through your augmented limb and the lovely patter of Galaxite's balmy dew trickling down your pleasantly-lubed spine, you languidly arc your tail into an instinctive [']U['] bend. You sensuously stroke the lust-flushed lips of your ovi-cunt along the molten tender petals of her blushing inhuman box, sending sparks of felicitous desire dancing about your enhanced limb as her molten honey streams about the silky borders of your spotted pelt like lucid diamonds glittering in the available light.";
				say "     Judging yourself suitably lubed up, you leisurely wrap your tendrils about her comparatively tiny frame for support, reveling in the intoxicating rush of your malleable tentacles gleefully groping and fondling her hale physique in their glossy clutches as they explore her bountiful form. You find yourself mewing happily at the tight, chiseled majesty of the shifting woman's liminal body playing against your pads and alien tendrils. You can't resist playfully massaging your voluptuous figure with your bestial paw-hands, internally exalting in the heady contrast of your forms simmering across your senses. Waves of raw tactile elysium crash over your tainted psyche as your padded fingers sink into the rich layer of motherly adipose and velvety fur swaddling your [bodydesc of Player] body in its comforting downy embrace. Despite your familiarity with your preferred form, a part of you still rollicks at the supple sensation of your pelt gracing your paws and ";
				if Player is impreg_now:
					say "the sumptuous maternal high of pampering your latest litter and the gentle sloshing of your milky chest.";
				else:
					say "the feeling of your cute pot belly nestled in your mitts eagerly awaiting your latest brood.";
				WaitLineBreak;
				say "     All the while, your tentacles explore the toned profile of her athletic core and pillowy C-cup breasts as you prime your well-practiced tail and thrust with bestial abandon. Likely no stranger to the affections of larger lovers, the buxom demi-dragon breeder's box effortlessly stretches and conforms to the exotic shape of your ovi-tail amid a gush of her balmy dew. You find yourself swooning in unvarnished bliss as her satin depths decadently hug your plush tail like a toasty glove, you can almost feel each tender beat of her heart as you piston your writhing pliable appendage about her elastic sex. Your ovi-slit practically drools at the rollicking caress of her pliable walls hugging the exotic structure of your egg-laying limb as the container echoes with each hearty wet thrust of your potent appendage. As your paws drift along the imperial curves of her still-human core to the growing bulge in her tight midriff, your sex spasms delectably at the sordid kiss of your padded peets inuring caress and light catch of your talons waltzing about the outline of your ovi-tail.";
				say "     You twist and contort your flexible limb into new and enthralling shapes, as you lavish her rippling walls and your own eager paws in a torrent of unbridled bliss. The euphoric dragon-to-be squirms beneath you like a tawdry bitch lost to her deepest of heats desperately trying to quench her changing body's burning need as she ravenously sways on all fours beneath you in tandem with your every thrust. Chuffing mirthfully, you coil a pair of your powerful tendrils about her liminal form and hoist Galaxite off the ground with a commanding tug as you press her warm liminal being against your voluptuous tauric form. Caught off guard, the horny hybrid looses an adorable panicked yip as the case is sent tumbling from her grasp and you press her lithe body between the lush gently-swaying rows of your catty dugs. Still as the plush, silky weight of your bestial breasts encompass her hybrid being in their balmy, pillowy folds, Galaxite seems to relax into your dominant hold, chuckling, 'Ha-ha what an adventurous kitty, but two can play this game,' as her spaded tail teasingly snakes its way up your cuddly legs while she affectionately nuzzles her chin against your gorgeous pelt.";
				WaitLineBreak;
				say "     In no mood to stop her more-than-welcome advances, you expertly adjust your quadrupedal stance to accommodate her inquisitive limb, earning you a pleasant simper from the bound breeder as the tip of her unerringly smooth tail traces the lurid lips of your [cunt size desc of player] tauric cunt. You find yourself chuffing internally in catty contentment at the vivacious touch of her ponderous spaded tail coiling about the borders of your [cunt size desc of player] honey pot as she leisurely glides the tactile ridges of her fifth limb about your folds in long drawn out strokes. Swooning at her affectionate touch, your well-used cunt decadently hugs her graceful tapered limb as she generously coats her gleaming cobalt blue scales in a balmy sheen of your feminine juices. The air fills with the enthralling scents of feminine need and unsubtle squelching echoes of your exotic limb as you hungrily piston your own augmented tail in a lewd animalistic rhythm.";
				say "     That's soon joined by the gentle patter of yours and your plaything's feminine dew plinking along the sheet metal floor, as Galaxite languidly withdraws her sensuous tail from your needy sex, evoking a plaintive mewl your lips as your desperate sex cry out for her touch. 'Daw, how cute,' she titters in reply while a feeling of predatory tension ripples through her shapely body as she arches her delightfully padded flanks against your soft breedable body. You watch out of the corner of your sharp feline eyes as she arches her own tail into position and thrusts. Resistanceless rapture floods your elated sex as her natural spade and girthy tapered tail spear your [cunt size desc of player] snatch in a fluid beatific motion, and she nearly hilts herself upon your respective folds. You can feel your feral belly bulge ever-so-slightly with the heavenly weight of her dexterous appendage as your cunt stretches delectably to accommodate the cheeky little half-dragon.";
				WaitLineBreak;
				say "     More than used to such treatment, your tauric body roils delectable at the profound feeling of fullness shimmering about your bestial passage as your sweltering walls gleefully hug the glassy-smooth scales bejeweling her fifth limb. The nimble woman artfully lavishes your feline flower with intoxicating pistons of her draconic tail, sending blissful little ripples through your soft voluptuous form. All the while, she skillfully pampers the puffy folds of your inverse button in the devilishly lubed coils of her tail between the heady thrusts of her draconic limb. Rumbling in a deep pleased cadence at the tender affections paid to your [cunt size desc of player] cunt and drooling ovi-slit, you lean down to gaze upon your entwined playmate as she writhes in your tendrils['] enduring hold, smirking at the sight of her athletic body sandwiched between your bountiful rows of [breast size desc of player] dugs and her blissful expression, as her tongue lolls shameless from the side of mouth.";
				say "     Your tendrils diligently pamper her supple C-cups and the tender swell of her well-stuffed middle as her blushing tummy bulges and ripples with the sordid outline of your ponderous limb. Loosing a sweet, comforting, motherly purr, you affectionately cup your comparatively massive paw-hands to her face, gently stroking her smooth cheeks with your silk pads as you teasingly tell her how cute looks like this. Nodding ever-so-slightly, she worshipfully kisses your paws mewling, 'Such a nice kitty,' in bestial agreement as she corkscrews her dextrous limb in tandem with the pleasing motions of your catty tail. Good girl, you simper gliding your dominant forepaw along her gracefully swaying curves, reveling in the lovely sensation of her liminal body playing across your mitts as you tenderly caress her toned middle. Of course, you add, lightly raking your claws along her flawless bronze skin, leaving a decadent trail of rosy lovemarks in their wake, she's going to look even better with a nice fat clutch of your eggs to keep her company.";
				WaitLineBreak;
				say "     'Eggs?' she mews expectantly, her golden slitted eyes sharpening at the mere mention of the word. Yes dear, you have a whole litter of big, fluffy, kitty eggs just for her, you purr gently groping your paws about her petite shapely C-cups then down the sumptuous curves of her tail-packed middle. Even if there's little chance your load will stick, a part of you can't help but tease about how much you're going to enjoy watching her lovely little scalie body ripen with a big belly full of your tauric kittens. Or, you add, lightly tweaking her sensuous nips in the malleable embrace of your tendrils, mentally delighting in the pleasant heft of her motherly mounds as her cute assets laze comfortably in your tentacular embrace, pampering her ripening tits as they swell with untold gallons of warm fatty cream to feed your cubs. She'd love that wouldn't she, just being able to lie back in your pillowy embrace while a big strong kitty takes care of her? You tempt, as the exotic muscles lining your ovi-tail spasms with an all-too-familiar energy.";
				say "     Swooning wordlessly, Galaxite merely nods as she seems to hang on your every loving word as you rail her welcoming depths with ever-increasing vigor. The whole container resounds with the meaty thrum of your mutual passions and the heavy patter of your dugs bouncing about her svelte figure. Each tender thrust and playful grope of your coils evokes a pleasant quiver from Galaxite's well-used cunt as her silky walls hug the elated folds of your tail-mounted sex as her respective body sways your grasp. A blissful sweltering heat cascades through your tauric body like a tropical storm as the horny half-dragon's spaded tail roils about your expansive [cunt size desc of player] muff in a waltz of unbound rapture while a raw, but not wholly unbidden pressure flickers about the length of your exotic tail. Try as you might to desperately attempt to holdout and edge just a few moments more of imperial satisfaction, the forceful thrum of impending release builds along the borders of your katty mind can't be denied for long.";
				WaitLineBreak;
				say "     Your tail muscles ripple with fertile intent as if your unique anatomy could sense her respective nature while her own elastic sex hungrily caresses the sensuous rings lining your ovi-passage overwhelms your fraying senses as you cum with a feral room-shaking roar. Your egg-laying limb ripples and tauric muff sparks with waves of static delight as the plush appendage looses a deluge of feminine honey laced with a heavenly stream of soft gooey eggs upon Galaxite's elastic box while your catty cunt gushes a generous trickle of lucid honey down the length of your inner thigh and the small of the mewling half-dragon's back as her draconic voice joins your satisfied bellow. Your forepaws drift to the growing swell of her toasty tummy as you affectionately knead the lovely outlines of your potential kittens-to-be with gently encouraging strokes of your supple pads, all the while cooing in abject delight. Good tail slut, as the well-egged woman pants in a pleased draconic tenor, as her belly audibly groans with the beautiful weight of your brood-to-be. 'Ah-ah-ah yes, don't stop, f-f-fill me!' she cries as your tail roils delectable with each faux-contactraction.";
				say "     Her midriff slowly blossoms into a taut fertile dome as you pour untold dozens of soft goopy ovum into her fecund folds till her ripening bump slips between the tender grasp of your silky pads and plops against the sheet metal floor with heavy thump. Still, your tauric body has more to give as the combined weight of your tauric load and bounty rounds out her heaving middle to an almost obscene degree as her decadently egg-swollen tumby brushes against the side of your tauric paws. Not that the ecstatic breeder appears to mind, as her devilishly tight sex eagerly spasms about your ovipositor, ravenously milking your sordid tail, roaring in a lustful frenzy, 'Yes, must have more eggies, must make more dragons!' while the sheer sensual mass of your tauric offering steadily lifts her svelte body into the air and presses her liminal being against the [bodydesc of player] swell of your feral half. Enthused by her unnaturally elastic nature, you gently release your hold on her shifting form and ease her hybrid body onto the pillowy mass of her ovi-flated middle as her tummy spreads out before her like a groaning bronze mattress.";
				WaitLineBreak;
				say "     All to the overjoyed half-dragon's glee, as she sinks ever-so-slightly into the sloshing of her queen-sized tummy and withdraws her tail from your elated [cunt size desc of player] sex with an innervating tug accompanied by a light toe-tingling pop as her spaded limbs slips free of your molten cunt. Mewling contentedly, you carefully backpedal off her vulnerable form to gaze at the heavenly sight of the sated breeder wallowing atop her brood-bloated belly. Beyond hopelessly engorged, the well-fucked half-dragon's cute reptilian paws can't even reach the ground, you note watching her pleasantly thicc and muscular legs gently rest against the blushing borders of in an inviting V-shape as a glistening trickle of fem-cum leaks down her bronze treasure trail. While her spaded tail lovingly fondles the vibrant outlines of your eggs in slow loving circuits, you dexterously paw around her potentially immobile form till your slitted eyes are met by the sensual sight of the fuck-numbed demi-dragoness massaging her overtaxed body rambling, 'Mh, good eggies,' as her hands appear to darken and shift to a rich shade of royal navy blue that steadily creeps up her shoulder.";
				say "     You watch in muted awe as a verdant blanket of glossy scales flickers into existence, coating her extremities in their pearlescent embrace while her nails sharpen and extend outwards, steadily reforming into gleaming ivory talons. Meanwhile, a pair of throbbing thumb-sized bumps pulse into being atop her forehead, and with each elated pant, you observe the flesh around these growing lumps turn pale, then part, revealing a set of swept-back boney points. More than accustomed to such sights, your far-traveled mind instantly recognizes these new additional horns as the ossifying matter arches back over the top of her head forming a beautiful gem-like rack. Galaxite rumbles wistfully, 'Ah more scales to keep eggies safe,' while she pampers her tender tum with altered mitts. Though perhaps feeling your eyes upon her, she turns her head to look at you with a far-off gaze, muttering in broken voice, 'Did I-,' she pauses as her head lolls from side-to-side, 'did I do good?'";
				WaitLineBreak;
				say "     Nodding, and in no mood to upset your liminal lover for fear of causing her post-transformative mind any distress, you gingerly kneel down beside the belly bound demi-dragon and heap vague reassuring praise upon her, while you affectionately pat her on the head. 'Yea,' she peeps though a drunken smile, as her eye slowly begins to refocus. Spirits buoyed by the effect this simple gesture has on her, you lovingly drape your cuddly body around her, cooing the sweetest of affirmations upon the egg-laden woman as you pamper her lush curves with many limbs and glossy tendrils. Your altered mind can't but take a certain maternal pride at the sight of her cub-swollen body or feel a rush of intoxicating maternal sensations as your paws glide over the innumerable little outlines of your brood and the demi-dragoness's ability to handle your prodigious load. Even if they don't stick, part of you can't help but delight at the sumptuous state of her fecund body.";
				say "     A sentiment Galaxite appears to share as she cattishly caresses her flush curves, purring in a more even tone, 'Such a naughty girl, you must be proud of yourself, just look at what you did to my poor figure,' as she gestures to her hopelessly gravid body with a languid wave of her tail. 'Why, the boys are going to have a field day when they see me like this,' she adds with a well-meaning snicker. Chuckling, you tell her not to worry, as far as you know, your eggs are nonviable in other strains, so in a few minutes, or hours her body should harmlessly absorb them. 'Daw, that's no fun, I was just starting to get attached to the little dears,' she pouts, nuzzling her chin along the taut surface of her bed-like belly. Really, she wants to carry your kittens? You ask, tilting your head at an inquisitive angle. ";
				if player is impreg_now:
					say "'Of course silly, I've never had a litter of kittens or taurs, much less been knocked up by pregnant women before! Lucky duck, it must be nice having such a big sexy body like that, why, I'm almost jealous,' she gushes, eyeing up the bountiful swell of your tauric tummies with obvious interest. Leaning into her gaze, you lewdly paw at your bountiful curves, teasingly tell her your form certainly comes with its advantages like this soft pillowy fur, you pur running your paws through your pelt, delighting at the growing maternal shimmer of your radiant gold, white, and black fur reflecting in the available light.";
					WaitLineBreak;
					say "     Getting to feel the gentle bounce of the cute and inviting adipose coddling your voluptuous assets accompanying your every step as your bountiful tits fill with fresh creams. Not to mention, you add, coiling a pair of your tentacles about Galaxite's lumpy quivering body while you lovingly pat her brood-flushed middle with your forepaws, the wonderful utility of your tendrils and catty paws. 'Mh that does sound nice, and I can't wait to see how the little ones will turn out, just thinking about it is getting me wet,' she simpers, proudly hugging her broodmare body. 'Of course,' she adds, fixing you with a cheeky sideways glance, 'I think I like this body more, not that yours isn't super pretty,' she titters with an earnest trill. 'But mh,' she pauses to languidly flex her talons before herself, openly admiring the scintillating sheen of claws reflecting in the available light, 'just look at that shine,' Galaxite hums happily as luminous rainbows of many colors and none refract off her pearlescent talons and dance along shadows of the container's walls.";
				else:
					say "Well why wouldn't I you silly widdle kitten?' she teases in a catty sing-song trill, as she cheerfully waves her left hand before herself as if to brush aside your concerns. 'I've never had a litter of cute cat girls, or a big sexy taurs, much less gotten knocked up by women before!' She giggles, enviously eyeing up your voluptuous curves. Chuffing proudly in reply, you tell her your current form certainly has its perks compared to your dull old human one as you fondly massage the sumptuous curve of your brood-bound with your forepaws.";
					WaitLineBreak;
					say "     'I'll bet, but it must nice to be covered in all this soft cuddly fur,' she swoons in a sweet sing-song trill, as she reaches out and leisurely traces her claws through the immaculate borders of your spotted pelt coddling your [bodydesc of player] flanks, evoking a well-pleased purr from your lips as the gentle catch of her talons simmering about your pale pliable hide. 'Daw, and just look at these sweet pink kitty toe beans, they're just so cute! Why I don't know how you keep your hands off yourself!' she gushes, as she gently brushes her cum-slick tail about the edges of your fluffy paws. 'Of course,' she rumbles, flexing her scintillating talons before herself, 'I think I like my new ones more, not that yours aren't super cute,' she interjects with a hasty well-meaning trill, 'but gosh just look at the shine of these!' Galaxite hums happily, as luminous rainbows of many colors and none refract off her pearlescent talons and dance along shadows of the container's walls."; [merge here]
				say "     Nodding along, you can't say that she doesn't wear them well after all. 'Oh thank you cutie,' she simpers, with a light click of her tongue while her cheeks blush a light wine-red, 'it's too bad whatever that was stopped, I never knew changing felt so good and primal, I can't wait till it happens again!' she preens in a proud draconic rumble. Tilting your head at an inquisitive angle, you diplomatically ask if she is serious, isn't she worried how the wider world will treat her or fearful of losing herself like so many others. 'What!? No silly kitty, why, I've been trying to become a dragon like this Huge Dragoness I saw the start of the outbreak, but none of their fu-,' she pauses with an almost pained hiss as she visibly bites her lower lips, 'ahem, flubbing nanites ever stuck. Gosh,' she swoons, idly rubbing her legs together, 'I wish you could have seen hir. They must have been like six stories tall with huge minivan sized breasts,' she pants, while holding her arms out before her chest as if to demonstrate the giant dragon's cup size.";
				WaitLineBreak;
				say "     'And shi had this huge ribbed cock and massive balls, mh, I can only imagine how that must have felt walking around the city like that, feeling the ground quake with hir every step, getting to crush buildings while a hoard of loyal daughters fawned over them! Oh that must have so much FUN!' she crows glibly, her golden eyes alight with manic delight. 'But,' she sniffles melancholically as her ear fins begin to droop, 'they never wanted to play me, no matter how hard I tried to get their attention. Then... *sigh* one day poof, they just disappeared along with a lot of the other infected, and on one's seen them since,' she huffs fixing you with a dejected look as she presses her chin into the petite swell of her perky chest. Unsure how to respond to such an admission, you instead ask if that's why she's here, to find the missing infect and perhaps become a Huge Dragoness herself. 'No,' she peeps flatly, gently caressing the sensual swell of her brood-laden belly, 'I'm here for that case, say uh could be like a totally sweetie and find that thing, I'd get it myself, but the kittens need time to settle,' she purrs with a salacious grim as the teasing half-dragon fans her paws behind herself.";
				say "     Not seeing any harm in indulging her simple request, you bob your head in the affirmative. 'Thanks babe, I think I saw it slide under one of these lockers in back,' Galaxite simpers, gesturing to the rear of the container with a wave of her girthy tail. Following her directions, you carefully paw your way over to the mesh storage containers, then kneel down to peer underneath. Though it takes a moment for your eyes to adjust to the tiny gloomy void beneath the locker, you quickly spy the silver container resting next to the wall. Far too large to have any hope of safely fitting your bestial mitts into puny gap, you roll onto your side with low grunt, slip your dexterous tendrils into the narrow space, and slide the sleek metal case out with a careful push. Once it's free, you hook its comparatively small handle in the crook of you claws and proudly present it to Galaxite with a catty grin. 'Oh thank-you-thank-you!' she hums, plucking the case from your paws and hurriedly flicks her talons along the edges of the metal briefcase.";
				WaitLineBreak;
				say "     At once, it makes a low pressurized hiss just on edge of your exceptional hearing issues from the clean rents in the metal as she sets the briefcase upon her flush tummy and flips it open revealing two rows of silvery-gray aerosol containers lining both halves of the case secured by a thin black velcro strip. Lacking any formal marking or labels, they appear to not be all that dissimilar to the pressurized nitrous oxide canister used by chefs to fluff up whip cream or infuse spirits. Justifiably intrigued, you politely ask Galaxite what they are. 'Hm,' she begins with a light click of her tongue as she tilts the case to face her. 'I'm not sure what's in them but according to my contacts the gas, something called Revert All, can just about turn anyone back to a, ick, human,' she shudders as she carefully pulls one of the sleek cylinders free of its bindings and tosses it at you. Dexterously plucking it from the air, you turn the thing over in your paws while opining aloud how useful or potentially valuable a find like this could be in the right hands. Not that you'd think you'd ever need such a thing as you've grown rather fond of you current form still what's her plan with these, sell them?";
				say "     'Wweell,' she hums slyly as she stretches out on her expansive hypertrophic womb, while casually bracing her chin against her palms. 'Kind of, you remember those black sites I mentioned a while back?' she asks, her lips curling into a Cheshire grin. Yes, if you recall correctly she said they were largely abandoned or overrun, you reply. 'They are, and according to an information broker in the high rise district, one of them was funded by some very rich and very silly little monkeys trying to find a way to get the nanites back under control but,' she pauses and waves her tail towards the wider city. 'As you can see the naughty apes failed.' Why, you ask. 'Simple, they tried to use one of the lost strains to retake control of them, perhaps you've heard of the Sluts, Dominators, and the old Mastermind?' she inquires with a little flick of her ears. Shaking your head, you tell her no though something about their names feels oddly familiar.";
				WaitLineBreak;
				say "     'No surprise there cutie, I've never encountered them myself, but I know a guy who did. From what he told me, they were a pretty virulent infection that could spread just by being near them. I guess,' Galaxite shrugs, sending an adorable little ripple through her egg-laden body, 'that's why they got taken out, I don't have the full story but they were said to be a hivemind of sorts that were taken out by some nameless foxy adventurer before they could spread. However, someone must have kept a sample of their nanites and passed it along to Zephyr. If my contacts are to be believed,' Galaxite says, playfully fanning her tail behind herself, 'the military and a few very wealthy people got their hands on it and tried to revive the mastermind, hoping to use its strange mental powers to stop the ferals. Ha-ha what the silly monkey didn't expect,' she chuckles darkly, as idly taps her chin with her talons, 'was that even in its weakened state the old Mastermind was able to influence the staff and almost broke out with their help, if not for the timely intervention of several ranger teams. Still, they only managed to seal away it.'";
				say "     Nodding along, you rightfully ask how in the world she knows this. 'Oh Mr. Kobold told me, his family was one of the original backers of Travor and,' she hesitates a moment, as if relishing the look of curiosity emblazoned on your face, 'the nanites.' She whispers in toned in a sensuous serpentine trill. Eyes widening in alarm, you ask if she's serious. 'Of course sweetie, I wouldn't lie to such a cute fluffy kitten, but wait I haven't even gotten to the best part!' She crows, her eyes alight with catty glee. 'You see, my contacts and Mr. K believe there's still evidence tying not only his family but members of the government and dozens of rich companies left behind in that facility. Evidence that they would all pay a rather hefty sum to keep hidden.' So she wants to blackmail these people, isn't that risky, with all the chaos going it wouldn't be all that hard for them to disappear her instead.";
				WaitLineBreak;
				say "     'Perhaps, but that's a chance I'm willing to take, besides we can't leave the mastermind to its own devices. Sooner or later, it will break free, when it does, it could potentially dominate not just the ferals but us as well and I WILL,' Galaxite snarls, eyes dilating to deep frightful umbral pits, 'NOT LET THAT HAPPEN TO MY BABIES!! *RAAR*!!' She howls, lips peel backing into a feral inhuman grimace, revealing row upon row of dagger-sharp fangs lining her mouth as she protectively hugs your potentially kittens-to-be. Her voice crackles with draconic rage as she slams her tail against the sheet metal floor with a teeth chattering knell. The very ground beneath you shakes as this container groans with the reverbent echoes of her shout, your head begins to pound while the acrid taste of copper laced with iron flickers across your palate. Hurriedly clasping your paws to your ears, you try to shut out the dreadful roar, to little effect as the bellicose cry seems to cut into your every being as your beg the demi-dragon to control herself.";
				say "     At the sound of your plaintive mewl, Galaxite seems to reign herself in as her roaring quickly peters off into the background while her eyes return to their lustrous gold hue as she fixes you with a profoundly apologetic look, murruring. 'Oh sorry kitty, I uh, guess I got a little worked up there,' she hums bashfully, flashing you a well-meaning blep. Nodding and wanting to avoid another fit, you tell her that's all right, but in the future, you appreciate a little warning next time. 'Sure thing cutie, I promise,' she simpers, earnestly. Politely telling her you're going to hold her to that, you return to the more pressing matters at hand, like why she chose to keep this information to herself and what's her plan for dealing with this revived mastermind. 'Well,' she titters, nervously tapping her pointer fingers together as she bob her head side-to-side, 'it's not that I wanted to keep things from you, but until Mr. Kobold and these crates confirmed the rumors, I wasn't sure if the stories were true.'";
				WaitLineBreak;
				say "     Grumbling under your breath, you diplomatically tell her that's fair, with all the strangeness happening across the city it is getting harder to tell truth from fiction. Still, now that she has her proof, what's she planning to do about it, go to the military, Zephyr, or one the more well-connected researchers still operating in the city? 'What no!' Galaxite huffs, aggressively shaking her head. 'You think they'd leave well enough alone, for all we know they'd probably try to tame or something silly like that,' she rumbles with a deep exaggerated roll of her eyes. 'Even if they could pull it off I wouldn't trust any human with that kind of power.' Idly tapping your talons against the sheet metal floor, you find it hard to dispute her, despite the advantages shackling such a creature could bring, if it broke free once, it could do so again.";
				say "     Much as you'd like to believe your own skills, contacts, and experience could tip the scales, if the government and these wealthy companies with all their vast resources couldn't keep the beast contained. You doubt that you, Galaxite, or any allies you might have would fare any better, best end the thing now while it's weak then risk getting yoked to its will later. You opine aloud as you ask Galaxite what her plan is then. 'See that's the tricky part, since if you haven't noticed things don't seem to die or stay dead the way they used to, so even if my boys dropped the black site down around it, it might... reform. In time, its nanites could adapt from the experience, or even mutate further,' she says sheepishly with a distressed flick of her ears. But she must have some plan, she said it herself the old mastermind was beaten once before, couldn't they find this nameless fox and ask them for help. 'Sorry, I already tried but they just seemed to have just vanished without a trace, however,' she adds with a note of pride. 'My contacts did find references to some tools they left behind.'";
				WaitLineBreak;
				say "     And what are these [']tools['] you ask. 'A set of enchanted swords called the swords of Blood and Darkness, [italic type]allegedly[roman type],' she says, nervously thumping her tail against the ground in a quick fricative tattoo. 'They're from another world, the problem is no one knows where they are not even that super cute jackal lady at The Mall,' she hums with a lustful trill as she idly paws at her beyond bloated belly. 'Well at least for now, Homaru thinks he might be able to find them but he lacked the means to pay people off, until now,' she crows, as she glances down at the tiny case perched upon her tummy. 'With a few of these bad boys, he should be able to bribe the right people in no time. After we've got our hands on those, my sweet dergy boys and I are going to head out and end that thing once and for all!' Galaxite preens, her eyes alight with coldblooded delight. 'Well,' she pauses as her gaze drift down to her bed bound body, 'after the kittens here,' she says given her tummy loving pat, 'are born, I wouldn't want something to happen to our little ones after all.'";
				say "     Naturally, you reply with a cheerful smirk, in the meantime though is there anything you can do to assist her? 'Hm,' she coos, eyeing up your tauric bod with obvious interest, 'maybe a foot rub would be nice, but for now I think I'll just need rest before heading back to the yacht. In the meantime, help yourself to all the supplies you want, and of course, you can have half the canisters in this case,' she says, tightly tapping her talons on the sleek aresola cans. 'Homaru, only needs a few of them and who knows, you might find someone out there who could use them.' Nodding, you carefully pluck one of the lower rows of cylinders from the case and stash them away for later. Though you doubt you'll ever need these, it can't hurt to keep something like this around, and as she said, they might be worth quite a bit to the right person one day. You muse, you gently shuffle to your feet and begin shifting through the various lockers and shipping crates. Despite your size and your tentacular tauric build, you can only safely carry so much equipment back across the weathered deer trail leading back to The Beach proper.";
				WaitLineBreak;
				say "     So you wisely select only the choicest of food stuffs alongside several sets of weapons and armor from among the piles of high end salvage. True some of the smaller helmets might not fit your current form, but it's hard to turn down your nose up at them regardless, you think to yourself as you pack up your growing pile of plunder and get ready to begin the potentially treacherous climb. Before you leave though, you decide to check on Galaxite one last time and quietly paw your way back to her, only to find her sound asleep with her arms and legs lovingly wrapped around her delightfully swollen middle. In no mood to wake her and more than certain her brood is nearby, you whisper some simple well-wishes to your little ones then depart, secure in the knowledge that should your latest litter stick, they'll be properly cared for. You ruminate as you pick your way back up the hillside, your inventory stuffed to the gills with more supplies than you know what to do with.";
				say "     Still, your exotic sure-footed form is more than up to task, as you've gotten quite used to carrying huge loads in this body, you ruminate giving your plush feral half an affection pat as you plod along the loose winding rock pathway. Soon enough though, you eventually find yourself safely back at the End of The Beach, with nothing left but wait till Galaxite contacts you. You decide to take a moment to think about what you've learned and plot out your next move as something tells this coming black site raid will be anything from straightforward. Perhaps, you muse, you should use this time to train, organize, and prepare for whatever is to come as something tells you, you'll likely only get one shot. Till then guess you'll have to wait and find out, ";
				if "Touched by Madness" is listed in Feats of Player:
					say "next time on [bold type]Dragon Raider G! Enter the twenty-four Protective Deities![roman type]";
				else:
					say "the next time you see her.";
				say "     [bold type]Author's Note: Dragon Raider Galaxite end here, for now.[roman type]";
				now Loot Boxes is resolved;
				ItemGain Food by 10;
				ItemGain Water Bottle by 10;
				ItemGain Medkit by 10;
				ItemGain Soda by 10;
				ItemGain Chips by 10;
				ItemGain Revert All by 12;
				ItemGain Black Ops Helmet by 2;
				ItemGain Mini Helmet by 2;
				ItemGain Advanced Tactical Helmet by 2;
				ItemGain Hazmat Body Glove by 2;
				ItemGain Oversized Bodyglove by 2;
				ItemGain Flex Boots by 2;
				ItemGain Beastly Boots by 2;
				ItemGain PHASR by 2;
				ItemGain MAD Gun by 2;
				now Stamina of Galaxite is 4;
				now dexterity of Galaxite is 3;
			else:
				say "     Smirking at the enticing spectacle playing out in front of you, you can't deny the growing urge to indulge yourself upon the curvaceous demi-dragon building inside you as you watch Galaxite's shapely hips sway before you. A part of you can't help but delight at the sight of the available light playing across the glossy royal navy-blue scales bejeweling the newly-forged half-dragonesses pleasantly padded ass and the inviting wobbles of generous assets accompanying every motion of her shapely liminal form. While her tapered tail coils about the shapely contours of her well-muscled legs, languidly caressing her toned thighs as if it were a serpent on a vine, the thin spaded tip of her draconic limb brushes her blushing alabaster lips of her cunt, gently teasing her pleasantly puffy pussy lips with subtle strokes of her sensuous limb, slathering her tail in a thin sheen of her floral fem honey. You get the most wonderful idea of how to play with her as you tiptoe up behind her, stealthy kneel down beside Galaxite's curvaceous flanks, and lightly grasp her dew-slicked tail in your [BodyName of Player] hands.";
				say "     A slightly lewd quiver rocks the freshly changed woman's lurid form as you run your mitts along the glossy girth of her tail, smearing her aromatic dew about her spaded two-toned tail. All the while, reveling internally at the lustrous glow of her gem-like hide and tactile bliss of her silky lamina gliding across your palms as you idly trace your digits along the subtle borders of her scales. Hopelessly lost in her own world as she mindlessly claws at the case, she merely rumbles like one of her draconic offspring as her scalie cunt lovingly hugs the tapered tip of her tail in a base show of lustful, animalistic need. Undeterred, you lineup Galaxite's sordid limb with her lush scalie muff and thrust, spearing the distracted half-dragoness on her own meaty tail with one masterful motion while her ivory sex bulges and blushes delectably. A part of you marvels at the sight of her pearlescent cunt lips hungrily devouring ever ";
				if "Touched by Madness" is listed in Feats of Player:
					say "millimeter ";
				else:
					say "inch ";
				say "of her exotic appendage. '*Gasp* Mh, naughty little creature!' Galaxite cries. Despite her cheeky tone, she makes no move to stop you as her cunny clamps down about the malleable mass of her tail with a lurid squelch.";
				WaitLineBreak;
				say "     She needily backs her sopping cunt into her tail, creating a cute little bulge in her draconic sex and toned bronze tum as you piston her spaded limb about her supple walls in an erotic choir of sensual squelching. 'Mh so full,' she coos lewdly, rocking her body in tandem with the lustful rhythm of her tail. The container fills with the enticing scents of draconic lust and Plumeria flowers, and the moist squelching thrum of her altered cunt ravenously milking her dexterous limb with each thrust. Her twin complementary aromas coil about your senses like jealous serpents, tempting you to further indulge your senses in her hybrid body. You lean over her buxom figure, while you guide the wild pistoning of Galaxite's tail with your non-dominant arm, and shamelessly run your dominant hand down the length of her dexterous limb, then along the graceful curves of her liminal body, rollicking in the exotic contrast of her gossamer smooth scales and silky tanned skin playing across your palms as they drift about her athletic core.";
				say "     Your digits grace the gentle swell of her tail-stuffed tummy, as you lovingly tease the demi-derg telling her how cute she looks like this. Earning you a pleased reptilian rumble from your eager playmate while your digits trace the supple outline of her malleable limb emblazoned on her tight midriff, then up to the bountiful hills of her delectably perky C-cup breasts, as you tenderly pamper her tight gently-swaying rack between each potent thrust of her tail. All the while, indulging your tactile senses upon the pleasant heft and silky curves of Galaxite's motherly mounds as they laze comfortable in your elated mitts. You gleefully sink your inquisitive digits into the ripe welcoming swell of her cute palmable tits while lovingly tweaking her tender nips between your thumb and forefinger. 'Oh, is my cheeky little adventurer hungry?' she trills, in a dreamy far-off voice as she arches her core ever-so-slightly as if to present her lustrous cunt to you.";
				WaitLineBreak;
				say "     Enthused by the sight and needy bestial nature of her posture as you pound her elastic muff with the heady pistons of her spaded tail, you swiftly find yourself chuffing in agreement as a tiny rumble of profound delight passes through your stomach as you languidly set yourself behind her to gaze upon the sumptuous view of her liminal body in beautiful repose while her tight alabaster walls cinch about the lustrous tapered tip of her tail. You loosen your hold on her sordid limb and commandingly grasp her shapely hips with your [BodyName of Player] hands and bury your face in the sweltering embrace of her powerful digitigrade legs. Your senses are greeted by a feeling of profound warmth and heavenly softness as her thicc yet firm scalie ass and muscular thighs brush over your [FaceName of Player] nose. Kissing and lapping at her glossy tail-stuffed cunny lips, the exotic taste of rambutan juice explodes across your soft palate and leaves you rumbling with delight at her sweet flavor simmering about your tongue, fueling your ";
				if "Touched by Madness" is listed in Feats of Player:
					say "desire for drussy. ";
				else:
					say "desire for her. ";
				say "You slip your [FaceName of Player] tongue between her taut nether lips and meaty tail, lavishing her delightfully stretched sex with tender flicks of your tongue as you nurse the toasty folds of her exotic muff. The horny half-dragoness, jackhammers her yearning cunt with bestial strokes of her lengthy limb, sending vivacious ripples through her pleasantly thicc body.";
				say "     Purring with reptilian rapture, she abruptly looses her hold on the strange case as her left hand drifts unbidden to her sternum as she lovingly traces the lurid bulge in her still-human middle. All the while cooing in a lewd animalistic trill as your oral muscle glides about the alabaster borders of her toasty box and massive tail. You languidly massage her delightfully plush silky muff with the practiced toe-curling strokes of your [FaceName of Player] tongue, teasing your way towards her glistening button as her floral honey drips down your chin in a shimmering sheen of feminine delight. The lustful demi-dragon's hale curvaceous form squirms enticingly at your touch as her fertile body sways almost drunkenly in your grasp as your oral invader caresses the sumptuous folds of her throbbing bestial clit. You lovingly cup your [FaceName of Player] lips to her draconic joy buzzer euphorically nursing her ecstatic button, Galaxite's tender sex quivers with unbound rapture at your touch, squirting bountiful rivulets of fruity dew down your chin at the sordid innervation of her scalie sex. 'So good, don't stop!' she cries, raking her fingernails across the sheet metal surface of the container floor in delight like a needy beast.";
				WaitLineBreak;
				say "     In moments though, the low scraping sound builds to a dreadful din as her hands seem to writhe and convulse with a fresh wave of change as her mitts shift before your eyes, spouting a rich coat of regal navy blue scales. Her fingers begin to contort as her beautifully-tanned natural bronze skin shifts towards the purest of pearlescent cobalts, while a set of wicked ivory claws grow from the tips of her nails. As Galaxite mindlessly gouges large streaks in the metallic floor as she lewdly moans at your touch, her pulse racing like a screen door flapping in a hurricane as you flick your tongue between her lurid lady lips and moist muff, never once giving her the chance for her pleasure to plateau as you skillfully caress her silky scales. 'Oh ya just like that my eager little kobold!' Galaxite teases as her exotic cunny muscles seem to clamp down on your oral muscle, as if her desperate sex were trying to milk your [FaceName of Player] tongue.";
				say "     Her tactile treatment spurs you on as you slip your [BodyName of Player] fingers into the poor half-dragoness's crowded cunny. Your dexterous digits lavish her spasming walls and tapered tail with wild abandon, as your every delectable stroke evokes a fresh gush of floral honey from her salubrious sex as the freshly transformed half dragoness collapses face first into the ground no longer willing or able to support herself, mewling, 'F-fudge, more!' as her face grinds roughly against the cool metal floor with each hearty piston of her tail. Beaming internally at the shameless state of the lusty dragon breeder, you cheekily glide your hand along her tight tail-stuffed tum and flush perky C-cups. Your senses rollick at the heavenly tension building in her core as a storm of ecstasy wells inside her as she finally howls to the heavens, 'F-frick YES!' as she climaxes, squirting a generous trickle of warm fruity fem honey down your chin and chest.";
				WaitLineBreak;
				say "     'Ah-Ah I never k-knew transforming felt so *pant* so amazing,' Galaxite stammers, sweat glistening off her brow and glossy scales as she tumbles onto her back, her tail still tucked in the glimmering folds of her draconic sex. 'I-I think I understand why Mx liked it so much now, lucky... duck. Thank you for that [Name of Player],' Galaxite moans, as she flicks her tail free of her sodden depths. You're welcome, you reply as you set yourself beside her then ask what just happened. She seemed fine one instant, then the next she was all over the metal case and started transforming. 'Mh, I don't know but,' Galaxite simpers, her hands drifting to her waist as she languidly brushes the tips of her pearlescent claw against the imperial navy blue scales of her upper thigh. 'It felt really good in a primal sort of way,' she beams, lifting her left leg into the air. She stares with a thoroughly-pleased predatory look on her face at the fine layer of scales decorating her toned form. So she's fine now, you ask.";
				say "     'Ya-ya-ya totally, now where's that case!?' she roars with a manic gleam in her eyes, as she springs to her feet as she begins looking around the container. 'Ah there you are!' she cries, spotting the thing a few feet from the rents in the metal her claws created, Galaxite swoOps in, scooping it off the ground and hurriedly slices the top off the briefcase with a flick of her claw. At once the container pops open revealing a collection of unmarked gray aerosol cans no larger than a man's middle finger secured by a strip of black velcro. Undoing the strap, she gently plucks one out then inspects it, saying. 'Nice, seals are perfectly intact.' What are those, you ask. 'These? Huh,' she shrugs, 'not sure what's really in them, but according to my contacts the gas in here can turn anyone back into a boring old *bleh* human.' She retches with an audible gag. 'At least physically,' she adds, tucking the thing back in its case. Interesting you tell her, you probably could do a lot of good with those. 'Ya you could, but what if we. Mh, oh I don't know... sell it to the highest bidder?' Galaxite smiles in tone sweeter than sugar cane as squints her eyes and tilts her head at a cute angle.";
				WaitLineBreak;
				say "     Cocking an eyebrow at her, you tell her that you're not sure; you could save or restore a lot of lives with something like this. It doesn't exactly sit right with you to potentially sell a cure to nanite transformation, there are a lot of people out there who could definitely use something like this, not everyone wants this kind of change after all. Regardless of means, everyone deserves a chance to be human again if they want to be, you contend. '*Huff* you're not wrong [Name of Player], so tell you what,' Galaxite sighs defeatedly as she taps her chin. 'You can have half the cans in this case, some suits, guns, all the supplies you can carry, and play hero if you want. How does that sound?' she asks, diplomatically. Briefly thinking it over, you tell her that sounds fair, after all, she did promise you a cut of the loot after all. '*Tee-hee* I knew you were a reasonable person [Name of Player], now let's get you packed up. I hope you don't mind, but I want to have some alone time to try out my new [']accessories[']. If you know what I mean,' she preens, proudly gazing at her gleaming claws like they were fresh from the manicurists.";
				say "     Nodding understandingly, the pair of you sort through the piles of M.R.Es and comfort foods. You pick the ones that appeal to you along with a few you're curious about trying. In the end, you collected a sizable amount of armaments and supplies which Galaxite offers to help carry to the beach in her scuba bag. Not wanting to be rude, you politely accept. With all the stuff you've picked up, you're not even sure that you're strong enough or have enough space in your inventory to take it all back to the bunker in one go. Then again you tell yourself, you can always cache a few items at the beach for later. Never know when you migth need them, you think to yourself as the pair of you pick your way back to the beach. You both say your goodbyes, though Galaxite does mention she may have another job for you in the near future. When you try to question her about it, she becomes rather tight-lipped, stating that she doesn't want to ruin the surprise. However, she does hint that this next one could leave the two of you very rich. Guess you'll have to find out, ";
				if "Touched by Madness" is listed in Feats of Player:
					say "next time on [bold type]Dragon Raider G! Enter the twenty four Protective Deities![roman type]";
				else:
					say "the next time you see her.";
				LineBreak;
				say "     [bold type]Author's Note: Dragon Raider Galaxite end here, for now.[roman type]";
				now Loot Boxes is resolved;
				ItemGain Food by 10;
				ItemGain Water Bottle by 10;
				ItemGain Medkit by 10;
				ItemGain Soda by 10;
				ItemGain Chips by 10;
				ItemGain Revert All by 12;
				ItemGain Black Ops Helmet by 2;
				ItemGain Mini Helmet by 2;
				ItemGain Advanced Tactical Helmet by 2;
				ItemGain Hazmat Body Glove by 2;
				ItemGain Oversized Bodyglove by 2;
				ItemGain Flex Boots by 2;
				ItemGain Beastly Boots by 2;
				ItemGain PHASR by 2;
				ItemGain MAD Gun by 2;
				now Stamina of Galaxite is 4;


Table of GameEventIDs (continued)
Object	Name
Just Rewards	"Just Rewards"

Table of WalkInEvents (continued)
Priority	Name	EventObject	EventConditions	EventRoom	LastEncounterTurn	CoolDownTurns	EncounterPercentage
1	"Just Rewards"	Just Rewards	"[EventConditions_Just_Rewards]"	Rocky Cliff	2500	2	100

to say EventConditions_Just_Rewards:
	if BodyName of player is "Dragon Breeder" and Player is pure and Cunt Count of Player >= 1 and Energy of Galaxite is 3 and scalevalue of Player is 5:
		now CurrentWalkinEvent_ConditionsMet is true;

Just Rewards is a situation.
ResolveFunction of Just Rewards is "[ResolveEvent Just_Rewards]".
Sarea of Just Rewards is "Nowhere".

to say ResolveEvent Just_Rewards:
	say "     Deducing that Tiamat has had more than enough time to shake her primordial pursuer, and deposit your rightly-earned plunder upon the dunes, you reason that it's time to make your way towards the sheltered sandbar your patron showed to you prior to her departure. Though, as you warily eye up the twisting weather-worn paths crisscrossing the vermillion chert hills, you decide against making the treacherous climb, noting that the lingering touch of the eldritch storm has washed out a great deal of the thin deer trails, leaving only deformed puddling terraces of red and tan waterlogged soil. The few section that remain are strewn with red pebble-laden mud and appear on the verge of collapse, you think to yourself, as your many eyes roam the fracturing hillside observing the fragmenting stone and terraced muck with a clinical gaze. You realize this saturated mix of off-red rock and muddy brown soil could easily give way at any moment, so you decide instead to swim your way around to the sheltered cove rather than risk starting a landslide and drawing attention to yourself.";
	say "     You casually stride along the borders of the cliffs towards the shore, noting the harsh spider web cracks running about the hill left by the eldritch frost till you reach the glassy azure waterfront. Though as you warily paw across the red tinted sands of the shoreline, you can't help but experience a slight sense of reservation at the thought of re-entering the waves as the seemingly placid water gently brushes the webbing lining your powerful pads, nor are you able to escape the feeling that something has changed in your absence. No more do you feel the welcoming tug of the currents lapping affectionately at your beautiful scales, or the subtle elated tingle of the presence roiling along the borders of your mind. Instead, the ocean's touch is a tepid, sterile, lifeless embrace, you ruminate, shaking your head in dismay as you push such disquieting thoughts aside and plod into the waves with a slow purposeful gait. As the water rises over your majestic form, the presence within you seems to recoil ever-so-slightly deeper into the darkest corners of your mind like a Sand Viper waiting to strike.";
	WaitLineBreak;
	say "     Dimly, you sense frosty tendrils of tension and apprehension filtering through your psyche as the shadow sentience coils about itself in a tight chittering ball as the waves crest your head and with it comes a low probing pressure building along the edges of your extremities. Though far from painful, the strange movements of the waves coiling along your lamina leaves you with a profound feeling of being watched as the currents shift almost imperceptibly about you like the frayed edges of a long abandoned spider's web. But only briefly, as soon, the odd whorls of water traipsing about your [bodydesc of player] core gradually bleed into the surf with each passing step as the shoreline gradually drops away entirely leaving you floating in the tranquil eddies waltzing about the area. Leisurely righting your tauric form into a slithery spear shape, you propel yourself beneath the waves with a single bat of your nascent wings. Your liminal mind delighting all the while at the raw rush of speed and the heady tug of the water playing across the majestic contours of your hydrodynamic body as you surge out past the Rocky Arch.";
	say "     Sailing out into the open water though, your vision begins to darken as your eldritch sight returns once more while pulses of placid blue, lustful pinks, and cautious yellows wink into existence about you as your awareness expands further out into the bay. You're nearly overwhelmed by the sheer rush of sensory data flickering over your mind's eye as the umbral gloom is set alight with the swirling images of the seafloor and its many inhabitants. You can [']see['] each little ripple of the tide as the water ebbs and flows about you, alongside the motions of countless sea creatures as they hunt, feed, or play beneath the waves. Idly casting your abyssal gaze toward the depths, you spy a romp of feral otters as they comb the sea bed for abalone, looking closely, your enhanced senses observe faint little trails of possibility like heat thermals raising off a desert road accompanying their every action as a flicker of electrical impulse spark along their calm azure auras as the creatures hunt."; [Note: the PC is seeing the world like a hammerhead shark.]
	WaitLineBreak;
	say "     Narrowing your gaze, your altered mind can almost read and predict these signals coursing through their soft little bodies as you watch them comb the ocean floor searching for the choicest shellfish. Though the process is far from perfect, you can still see the faintest echoes of their every potential movement rolling through their tiny fluffy beings as they dart along the craggy sea floor in a wide staggered search pattern. Intrigued, you allow yourself a moments dalliance as you observe the subtle shifts in their color and vibrant sparks of their nervous system filtering through tentacle hair as their enhanced sensory cells drink in the sight of their cute little ";
	if "Weak Psyche" is listed in feats of Player:
		say "nier. ";
	else:
		say "hunt. ";
	say "Though your reads are somewhat imperfect, your eldritch sight can almost see the moment their eyes catch sight of their latest meal as their blue aura's shift to purposeful whites laced with dutiful gold. Or draw a mental path towards their chosen prey as the pulses of electric tension simmer through their limbs before they lunge at the hidden shellfish. Still, the novelty of this minor interlude soon begins to wear thin as the consummate lure of Tiamat's promise pulls your awareness back towards the desolate sandbar, sheltered amidst the rows of glossy black basalt spires coiling about the shoreline.";
	say "     You allow your extensive draconic senses to filter towards this hidden lee, yet despite your best efforts, your enhanced awareness can't detect any sign of life, nanite-altered or otherwise. Perturbed, but undaunted, you close your eyes and allow your body's sonar-like senses to wash over the area, yet even then the picture you receive is a hazy one as if you were viewing the world through a fine mesh net. Still, drifting peacefully along the currents, the picture of the area gradually appears before your mind's eye as the hard flat boxy outlines of what you assume are the shipping containers nestled along the sandy shore simmer into being. Pushing your augmented awareness further, you can detect the subtle movement of several large ophidian tails patrolling near the water's edge. Serahdovah, you whisper under your breath as the chiseled outlines of their girthy tails and dense spiny fins trickles along the alien sensory cells lining your tendril hair.";
	WaitLineBreak;
	say "     Cracking your many eyes open, you pour the totality of your awareness towards the echoes of their beings rippling across the waves only to have your blood freeze and heart pound wildly in your chest as you behold the terrible yearning void nestled in their core's. Bereft of color or warmth, their aura is more akin to a sickening wound than the vibrant ballet of hues and intent you've observed so far. Spellbound, you watch, mind waffling between dread and curiosity as the whirlpool of black upon lurid black swirls within them like the gaping maw of Charybdis herself. Hungry, desolate, and cold, the tattered lifeless pits of the Seradovah's core seem to draw you as if you were in the pull of some massive inverse star as a painful tearing sensation flows through the tainted hall of your mind.";
	if "Strong Psyche" is not listed in feats of Player:
		say "     Try as you might to tear your eyes away from the voracious abyss, your body refuses to look as the icy hooks of this impossibility dig into your thoughts. You feel as if your consciousness is being stretched thin and threadbare as even the simple act of breathing is a struggle. All the while, your vision clouds as streaks of red and black billow around the edges of your sight as the voracious void pulls you in. Second by second, a hoarfrost of biting pressure grows along your regal muzzle like the pinch of an angry mother pulling on your ears alongside a numbing sense of dissociation pervades your being. Your vision swirls in on itself like a child's kaleidoscope, only to have it snap back into focus as a harsh, violent bestial roar from the presence raging within you shocks you out of this stupor. 'Tosos miiraak ni kis bix, KIN DA MUN!' the choir of dissonant voices chastise, as your vision cracks and fades into the banal hues you've always known."; [Some doors are not meant to be opened, human.]
	else:
		say "     Alarm races through you as the ravenous unlights pooling from the tear at the heart of the Seradovah sink into your being, you feel your thoughts become sluggish as a profound malaise creeps across your psyche. Caught off guard, you can do little but float there helplessly as a lurid quintet of enthralling feminine voices whorl at the borders of your awareness whispering promises of care and protection if only you would relax and let them in. While the waters tenderly caress the bestial contours of your powerful tauric body, despite the unusually wrongness of their touch, a part of you delights at the comforting cold seeping into your abyssal being as these ghostly currents ripple and pull you towards the void-wrought wound in the Seradovah's core. Little-by-little, their clarion call wears down upon you as you feel yourself sinking into the welcoming gloom, yet drawing upon your vast reservoirs of mental fortitude, you begin to push back against the psychic fog pouring into you like a numbing rime.";
		say "     Perhaps sensing your resistance, the loving icy voice's coo all the sweeter as the mercurial ebony hues of the void-born wound in the Seradovah's chests tug none-too-gently upon your awareness while the soothing cold sinks into your core like supple silken chains. [italic type]'Come to use little one.' 'Let go, and begin again.' 'Let us in.' 'Join us.' 'Make us whole.'[roman type] The five voices swoon with a soft, caring trill as glossy cracks of many colors and none pool across your vision. A sensation of unnatural dissociation floods your being as the world twists in upon itself as these hypnotic hues lovingly pull you in and for but a moment you almost succumb to this siren's call, almost. You rumble under your breath, your scales blaring a brilliant platinum as you summon all your draconic willpower and shout your defiance to this choir of sensual voices. At once the water's seem to recoil at the void wounds nestled within the oblivious Seradovah's toned cores sputters and shrinks beneath your draconian cry. Seemingly sent reeling, the unnatural hold your awareness slackens just a hair and in the briefest of instances, you will your enhanced vision to fade lest the sight of festering sore upon reality sinks its claws into you once more.";
	WaitLineBreak; [merge here]
	say "     As your eldritch sight wanes, so too does the frightful hold of this void-wrought anomaly, you hurriedly surface with a bat of your wings. Breaching the topside, the effects of it still nip at the back of your mind as your thoughts feel sluggish and muddled like they were passing through cheese cloth, yet you mentally rage against this creeping fugue state with a disgruntled growl. In moments, the feeling recedes, however, the experience has left you more than a touch rattled as your fracturing psyche struggles to parse whatever alien influence held you in its grasp. Perhaps you should ask Tiamat about this, you muse, casting your abyssal gaze towards the sandbar as you take in the sight of the various rows of red and black shipping containers arrayed on the shore. Between them, you spy several Seradovah slithering about them in a methodical crisscross pattern along the water's edge. To your eyes, their motions border on mechanical as they glide in unison betwixt the crates, stop then swivel their crocodilian heads about as they taste the air with their forked serpentine tongues then resume their rounds.";
	say "     Strangely though, even as their cold reptilian eyes drift over your potent draconic majesty, they remain utterly indifferent to you beyond a slight flicker of recognition flashing across their cold golden eyes before returning to their rounds. Perturbed, you briefly consider chastising them for their lack of deference to you, yet these thoughts quickly wilt on the vine as you recall your prior experience with these creatures and reason they likely were likely told to keep an out for intruders, not to kowtow to your magnificence. You muse, slithering through waves with an invigorating sway of your shapely body till your powerful paws are greeted with a satisfying crunch of stone as your talons rake the smooth rock scattered about the shoreline and ascend past the plunge point then rise to your full imperial height as the water cascades down the glossy contours of your being. A part of you can't resist admiring your reflection cast in the clear waters as the velvety band of alabaster seafoam cascades down your [breast size desc of player] chest highlighting the beautiful curves of your tauric profile.";
	WaitLineBreak;
	say "     The available light dances upon your [one of]azure[or]sapphire[or]cobalt[or]royal-navy-blue[or]aquamarine[at random] scales as you purposefully plod along the soft sands, delighting at the gentle bounce of your [bodydesc of Player] assets accompanying your every step. Prowling onto the shore, you leisurely stride between a pair of red and black shipping crates, observing the slight chips and dents littering their hulls left by the chains used to ferry them across the depths. Here and there, you spy tiny silvery rents in the metal no larger than a man's thumb where the chains cut too deep, or the unsubtle impression of claw marks left by the Naxokazzthur lacing their exteriors. Pausing next to one of the larger streaks, you idly run your dominant hand across them in wistful admiration of the titanic brother dragons['] impressive stature and power. While your free hand casually drifts to ";
	if Player is impreg_now:
		say "the beautiful swell of your well-egged tum as you encouragingly caress the taut, glossy, smooth alabaster scales decorating your middle at the thought of one day hosting a clutch of such beastly dragons all your own one day.";
	else:
		say "the bestial majesty of your tight, yet sadly vacant tumby as you dotingly pamper the sensuous contours of your alabaster scales at the thought of whelping such beatific beasts all your own one day.";
	say "     Intoxicated by the idea, you playfully paw at your feral middle with your forepaws as you picture yourself ripening with a fat clutch of draconic titans as seas of worshipers cater to your every whim. Soon, you purr in a velvety draconic trill as you let this lovely image gently slip from your mind's eye and turn your attention back to your more immediate rewards. You ruminate, as you continue down the narrow by tauric standards corridor between the crates till you emerge on the other and spy a rather pleased looking Tiamat sitting with her left leg folded atop her right upon the back of the yuppie mink you encountered upon the supply ship in a table pose beneath her like he were some manner of living throne. Your many golden eyes meander appreciatively over the divine bronze beauty's svelte and athletic body as you indulge yourself upon her cute, perky C-cup breasts as they strain ever-so-slightly against her blue string bikini top with each gentle breath. Then down to her hale hourglass waist and lush swimmer's ass lovingly coddled in her wafer thin bottoms as they hug and highlight her generous camel toe.";
	WaitLineBreak;
	say "     Though as your gaze dips further south to the once boisterous creature serving as her cushion, you can't help but note the oddly glazed-over look in his now milky white eyes as he sits there like a lifeless statue. For a brief instant, some section of your liminal mind muses if he's even still alive, yet such trivial fears for the lowly creature's wellbeing flicker away as you observe the faint little motion of his [one of]elegant[or]aristocratic[or]compact[at random] chest as he takes low shallow breaths. All the while, Tiamat returns your inquisitive gaze with a disarming smirk, saying. 'Nah se sturm salrak, Kai Monah,' as she places her hands over her chest and bows lightly before you. 'It is good to see you again my scale sister, I trust your journey here was an... uneventful one?' she purrs with a doting trill, though your sharpened senses still detect a low note of knowing mockery as her lips curl into a predatory reptilian grin.";
	say "     Shaking your head in the negative, you grumblingly relate your encounter with the ghastly void nestled at the heart of the Seradovah patrolling the area while demanding to know what happened. 'Ah my apologies kin da mun, what you experienced was but a taste of my true self,' she preens, casually flicking a stray lock of her raven black hair to the side. True self? You question her, tilting your head at an inquisitive angle. 'Indeed my champion, this body you see before you belongs to my sweet Olivia, or Galaxite as you know her,' Tiamat crows, her voice fragmenting and shifting along a quintet of disparate reptilian octaves as she playfully traces a pearlescent fingernail across the mink's spine. Curious, you ask her to elaborate. 'Of course my champion, as penance for failing her test, my loyal supplicant offered her body to me so that I may guide you along the path in her stead.' And what [']path['] would that be? 'Why the path of yours, and my sister's ascension, my wonderous champion,' she says mirthfully as her golden eyes her roam your [bodydesc of Player] form.";
	WaitLineBreak;
	say "     And who pray tell is this sister of hers, you inquire, idly drumming your fore-talons upon the sands. '*Fu-fu* ah [italic type]the[roman type] Kai Monah or the presence as your liminal mind calls her,' Tiamat chuckles as languidly raises from her seat and strides towards with graceful sashay. Wait, you rumble, the presence is Kai Monah? 'Indeed child of man, though her connection to you is but faint shadow,' she whispers, as she halts before then reaches out with her left hand to touch your tummy. 'You nonetheless bear within yourself a fragment of one of my oldest servants and most devout scale sister: Kai Monah, the Ocean Mother, The Herald of The Five Heads, The Scourge of Worlds, and Nursemaid of Dragons,' Tiamat purrs, as she traces an impossibly sharp nail along your toned abs while the presence writhes within like a worm on a fishing line at the mention of her titles.";
	say "     'Ah I feel you waking at last my old friend,' your patron crows, lips curling into a catty smirk as she touches her, no, you correct yourself, Galaxite's left ear fin to your midriff. 'Mh, soon dearest this body will be ready for you to manifest,' she murmurs, planting the lightest of kisses upon your belly button. 'Reen Han Na, reh-ol reck da han kovve nuth,' then tilts her loving gaze back up at you as she disentangles herself from you. 'As for you champion, you undoubtedly have questions for me, and in recognition of your service thus far, I shall answer them, now, ask,' she rumbles in a knowing sing-song tone as strides aback towards her living throne and seats herself upon it once more while a pair of lesser Seradovah wordlessly slither out from behind the various crates and seat their statuesque body behind her. As the proud god creature lazily reclines into their tight muscular cores, idly strokes hands along silky smooth contours of their chiseled emerald abs and shapely hips.";
	LineBreak;
	say "     [bold type]What would you like to ask Tiamat?[roman type]";
	LineBreak;
	let Thus_spoke_zarathustra_Choices be a list of text; [Fellow creators the creator seeks]
	add "What are her plans?" to Thus_spoke_zarathustra_Choices; [not corpses, not herds and believers. Fellow creators the creator seeks]
	add "Why did she keep her nature a secret?" to Thus_spoke_zarathustra_Choices; [those who write new values on new tablets.]
	add "Why is Kai Monah bonded to you?" to Thus_spoke_zarathustra_Choices; [Companions the creator seeks, and fellow harvesters]
	add "What's her connection to Galaxite?" to Thus_spoke_zarathustra_Choices; [for everything about him is ripe for the harvest.]
	let Thus_spoke_zarathustra_Choice be what the player chooses from Thus_spoke_zarathustra_Choices;
	if Thus_spoke_zarathustra_Choice is:
		-- "What are her plans?":
			say "     'Mh, a most pertinent inquiry kin da mun, but one I am happy to answer,' Tiamat hums, as she playfully purses Galaxite's lips into a magnanimous grin. 'You see, I have come to this sphere to save it, and you, from its inevitable demise,' she says with a sweeping gesture of her host's left hand toward the azure bay. Cocking an eyebrow, you politely ask her what demise she's referring to. 'Well as you have no doubt noticed kin da mun, your world has attracted the attention of a great many beings, both wondrous,' she pauses to tap her breast with her host's left pointer and middle fingers, 'and terrible,' she continues drawing her vessels left hand towards the State Fair as her host's eyes narrow ever-so-slightly in aggravation. 'Though I'm sure many appear playful and perhaps even... amenable, your kind are not yet ready to deal with some of the more predatory creatures prowling the infinite. As such, I have come here to restore the barriers between your sphere, or universe as you call it, and the rest of creation. Well,' she titters in a soft sylvan trill, 'for a price.'";
			say "     Nodding along sagaciously, you ask her what precisely she wants in exchange for such a boon. 'Why, these nanites your people have birthed, my champion, and your worship,' Tiamat purrs, running her finger down the glassy-eyed mink's back. '*Fu-fu* Though rudderless, never before have I seen such delightful instruments of domination and subjugation. Truly your kind have out done themselves with their creation.' Really, you inquire, surely a goddess such as herself could effortlessly conjure up like the little horny robots infesting the city with but a thought. 'Of course I could, but,' she adds with a muted sigh, 'that would be against the rules of the great game of the gods.' Great game? Rules? What is she talking about? You ask, inquisitively. 'Ah perhaps a little history lesson is in order then,' Tiamat says, thoughtfully tapping Olivia's finger to her lips. 'You see long ago when my kind were first born from the minds of mortals we fought over your worship in a seemingly endless cycle that led to the deaths of innumerable spheres, in an event your kind called: [bold type]Ragnarok[roman type],' she says, her voice cracked into a venomous quintet of hisses.";
			WaitLineBreak;
			say "     'Ah, how I wish you could have seen such wondrous destruction as reality sizzled and burned beneath my paws! To hear the death knell of trillions of souls as their minds are exposed to the infinite, then consumed by the pittless tides of the eternal ocean!' Tiamat preens amid a thunder of draconic glee as her host's golden eyes gleam like pools of molten metal. 'However, one day my [']brilliant['] platinum brother in his boundless wisdom put forth an idea, that we limit our power to cat's paws and cults of the sphere we fought over lest we break all of our toys. Though we resisted his words at first, the lesser deus rallied around him and forced a brief pause in our fun as we drew up the rules of the great game.' And those are? You ask. 'There are five, first,' Tiamat begins lifting her left hand before you and raises her pointer finger, 'no god shall make weapons to war against another, lest the arms races consume us. Second,' she raises her host's middle finger, 'no divine shall fully manifest upon a contested sphere for doing so may lead to another Ragnarok and the death of yet another reality. Third,' she lifts her index while crossing her thumb and pinky, 'only priests, cults, demons, angels, and avatars of the gods may wield divine power such as the High Cant upon contested spheres.'";
			say "     'Next,' she extends her pinky, 'no gods shall form alliances with one another, and finally,' she says clenching Galaxite's hand into a tight fist, 'any god found breaking these rules will face the wrath of all the divine.' Right but how do the nanites factor into this? 'Because my champion, your little machines are quite the potent tools and as mortal creations, they are fully exempt from the rules of the great game. With them, I can easily empower my armies to fight beyond mortal limits, breed loyal followers who will never stray from the path, and convert whole worlds to my ways without ever setting foot on another's sphere. Ha-ah,' she cackles darkly, 'in time, even my brother's dull little worlds will fall under my yoke. Oh,' she pants as she wraps her arms about herself, 'to see the look on his face as his paladin's turn upon one another in an orgy of delights!' Huh, quite the plan but how does she intend to bring the nanites to heel if she can't use her divine power here without censure. You reply with a casual flick of your tail. 'That my dear champion is where you and this little mouse come in,' she simpers, resting her left hand on her lap while affectionately patting the mink's elegant alabaster fur.";
			WaitLineBreak;
			say "     'You see, our [']friend['] here comes from what it thinks is a rather storied lineage,' Tiamat rumbles domineeringly, raking her host's nails roughly against the yuppie's spine. 'Though like all nepotistic lines, this pathetic creature does little more than leech off of the greatness of its blood. As such, in its arrogance, its family backed the original creators of the nanites, however your kind's reach far exceeded its grasp, but much to your sphere's credit,' she purrs, as the spell bound mink winces ever-so-slightly beneath the bite of her pearly nails, 'the scholars of this place discovered a means to yoke their wayward creations, hiding among a now lost strain of the infected.' Rightfully curious, you ask what she means by [']lost strain[']. 'Hm,' Tiamat hums, briefly cocking Galaxite's head to one side while her ear fins flicker inquisitively, 'tell me my regal champion, have you perhaps heard of the Sluts and Dominators?' Shaking your head in the negative, you tell her no, but the name's sound oddly familiar.";
			say "     *Hrump* I am not surprised kin da mun, few remember these virulent, short-lived hounds as they vanished not long after the initial outbreak along with many others,' she says with a lazy shrug of her shoulders. Fascinating, you quip but what's so special about these extinct strains? 'They were what your kind call a hive-mind which was able to influence the infected and override the nanites chaotic influence with but a touch. As such, the erudite among the little mouse's retainer found a means to tap into and subvert this influence,' Tiamat nods towards the mink with a gentle bat of Galaxite's head. 'Unfortunately,' she adds with a wistful hum, 'they lacked the means to fully control the Sluts and Dominators groupmind and were in turn forced to destroy their creation. Or so they thought,' Tiamat chuckles glibly as she reclines on to her fuzzy throne. 'As you well know, child of man, death holds little sway here any more and despite the valiant sacrifices of men and women far more noble than this little parasite could dream to be, the beast they birthed lives on.'";
			WaitLineBreak;
			say "     'Even now, it musters its power and grows its twisted legions of corrupted ferals for its inevitable return, and as entertaining as it would to watch its horrid rebirth. I have need of its... [italic type]talents[roman type],' she coos with a velvety trill, her lips curling into a predatory reptilian smirk. Interesting, so she intends to dominate this hivemind and levy its influence over the infected, you inquire. 'No my champion, I will not, she,' Tiamat pauses to briefly touch her left hand to Oliva's breast, 'will, once the next phase of my plan is ready to be put into motion. Thankfully, the trinkets you have provided for me shall serve as adequate leverage for the task at hand. Still,' she sighs, 'yoking the beast will not be enough, to truly bind it I must claim this sphere so that I may manifest freely for that we will require more supplicants. But fear not champion, I have already set the wheels in motion, so now we need only wait till my actors take the stage. Then once I manifest, I will name you Kai Monah's avatar and you shall become the god of this world at which point you will be free to rule this place as you see fit. Now have you any other questions of me, champion?'";
			now Strength of Galaxite is 1;
			say "[TiamatTalkMenu]";
		-- "Why did she keep her nature a secret?":
			say "     '*Huff*, simple my dearest champion,' Tiamat rumbles as she idly tucks an errant lock of hair behind her host's ears. 'I have raised such beings like yourself in the past, yet despite my best efforts, many of your predecessors lacked the foresight to keep themselves properly hidden till the time was right. Whereas others became drunk on their power and promise then drew the eyes of other deus upon them. Yet more managed to convince themselves that they could somehow use my gifts as a bargaining tool with my enemies to further their own infantile ambitions! Fools!' she growls, roughly slamming her host's clenched fist into the small of the yuppie's back, evoking a pained whimper from the haughty feral as she drives the air from its lungs. 'Thus, I gave you a test my champion to see if you were truly able to walk the path to ascension and stand at my side.' Interesting, so this was all a ruse to see if you could follow her orders, and prevent information pertaining to her presence from leaking to the other gods, but what would she have done if you had betrayed her or failed this trial?";
			say "     'Hm,' Tiamat pauses to touch her host's left knuckle to her lips, 'another time I would have gladly snuffled out your soul or cast you into the very depths of Limbo to be feasted upon by the chaotic sentience of that twisted realm. However,' she adds with a caring draconic rumble as she lovingly traces her nails along the sensual curves of her host's athletic figure. 'You have done me a great service in return for my Olivia to me, despite her many flaws. She is... precious to me, so in recognition of this feat, I would have merely stripped of my gifts.' Tiamat says, matter-of-factly. 'Still little mouse,' she growls, 'do not take my affection for weakness, though I care for both of you in my own way, you're but pawns in the great game, ones I'm more than willing to sacrifice if need be. But,' she says, leveling her host's left pointer finger at your core, 'should you continue to please me and put your faith in my will, you may yet reach the other side of the board and become queens.' Tiamat concludes, fixing you with a expectant look as she waits for you next question.";
			now Dexterity of Galaxite is 1;
			say "[TiamatTalkMenu]";
		-- "Why is Kai Monah bonded to you?":
			say "     'That is a story in and of itself my beautiful champion,' Tiamat hums as her host's molten golden eyes languidly drift along the [bodydesc of Player] contours of your tauric being. 'You see once, long ago, before my brother shackled us to the rules of the great game of the gods, she was a mortal dragoness who dwelt upon a now dead world that sought my protection. Sadly, her pleas came too late, and despite my best efforts the Naxokaazthur were forced to flee their world lest they be destroyed along with it. In the eons that came, Kai Monah and her kind devoted themselves to my cause though,' Tiamat grimaces, her eyes drifting towards the waves while her eyes narrow to fine piercing pin pricks. 'Some chaffed under my rule and reverted to more bestial state before disappearing into the infinite. Still,' she adds with a proud little hum, 'As time wore on Kai Monah became the most blessed of my servants, through her ceaseless devotion to me she acquired more and more power till she nearly ascended to the ranks of the gods.' Nearly, you inquire, as notes of aggravation and trepidation bubble within you at this pronouncement.";
			say "     'Indeed kin da mun, despite her many blessings, Kai Monah can never truly become a god like myself, or my siblings, for we are born of and empowered by the minds of Yor, mortals.' Tiamat says in smooth velvety trills as she fixes with a mirthful stare. Wait really, how is that even possible, you stammer. 'Hm, I do not know myself kin da mun, but many among my kind believe that Yor required a scapegoat of sorts from the harshness of reality. Thus from your collective wishes, we were born to bear the weight of your sorrows, your hopes, and your dreams,' she says, as her velvety voice washes over you like a soothing balm. Cocking a scaly set of eyebrows, you can't help but express some measure of incredulity at her boldness that mortals need gods like her. 'Fu-fu,' she titters through a mocking smirk, 'perhaps not ALL mortals champion, but think. How often do your kind credit the angels of one's better nature for the righteousness of your peers, rather than praise them for the strength of their convictions? Or how quick they are to condemn the devil on their shoulder or demon on their tongue, instead of recognizing and battling against their own wickedness?";
			WaitLineBreak;
			say "     'Is it not easier to credit the success of another on providence or fortune, than acknowledge strength of their will, diligence of their soul, or the vagaries of random chance?' she says haughtily while leveling you with a deep gaze as her cutting words bore into you. 'Thus, from this desire for absolution, for meaning, we are born, shaped, shackled, and empowered to spare you from the hard truths of an uncaring reality. For without us, you'd have no devil blame, no god to cry out to for salvation. As such no matter how powerful my scale sister becomes, she will never truly be like me or my...,' Tiamat pauses as her host bites her lips, 'brother. Yet her raw power is more than equal to any minor deus, and as my arch angel she escaped the bonds of mortality, but not without cost. You see my champion, the mortal mind can't being exposed to the infinite for long, thus she requires vessels like yourself to anchor herself and channel her power lest she lose herself in the chaos of the eternal ocean.'";
			say "     Wait, vessel? You were promised godhood, not to be turned into a mere focus for some ancient dragon's power! You roar, fanning your wings in disgust. 'Ah temper-temper child,' Tiamat tuts in matronly cadence as she wags her host's left pointer finger at you. 'Though you shall, as you so crudely put it, become a focus of her power, should your will prove strong enough, your mind shall remain untouched. However, should you falter, there is a chance you may be swallowed by Kai Monah and her countless avatars and join the chittering choir of broken souls howling to the void, but, there too exists a chance that you may yet wrangle control from her.' Explain, you grumble. 'Of course,' Tiamat simpers with a half-hearted bow, 'Eons of being stretched across this infinite have dimmed her awareness, even with her flawed avatars to center herself, her mind is still failing. In time, my dearest sister will lose her sense of self to the infinite and my greatest angel will fade into nothingness.' She sighs mournfully with a dejected shake of her host's head.";
			WaitLineBreak;
			say "     'Thus I offer the choice. Yoke her to your will and mantle her throne before it and her are lost to me, or if you are able, merge with my beloved scale sister, heal the growing rift in her mind, and become something far greater,' Tiamat says in a rather business-like tone. Huffing and doing your best to suppress the bile raging within you, you tell the haughty god creature that neither of those options sound like godhood to you, nor are you all that fond of her apparent willingness to so casually throw away her servants. Besides what makes her think such a foolish sounding plan would even work! 'Grr,' Tiamat growls, as her host lips peel back into a too-toothy leer, 'mind your words kin da mun, for I do not make this offer lightly!' Her words pound into your chest like the buffets of a wild, arctic gale flensing your tough oily scalie hide to the bone. 'Were I not hampered by rules of the great game, I could easily cure her with but a thought, yet thanks to my sibling's pathetic mewlings. I'm forced to watch as my most loyal angel, who has been both mother and general to my legions for aeons unnumbered unravel before my eyes all in service to a code that was forced upon me by lesser deus!' she rumbles in a thunderous draconic cadence as her host's lips blacken and frost over ever-so-slightly with each words before she pause to steady herself with a slow purposeful breath before continuing.";
			say "     'Rosus kin da mun,' Tiamat sighs as wisps of alabaster hoarfrost whorl about her the edges of her host's mouth. 'It has not been easy to sit by and watch as my favored angel has deteriorated these many cycles. Despite what your kind may think of us and our power, I would not wish this state on anyone...' Intrigued by this odd admission, you ask her to elaborate. 'Because my champion, gods like myself are eternally bound to our pantheon and the expectations of Yor. For instance,' she says with a light click of her teeth, 'my platinum brother, the dragon god of justice, honor, truth, and hope is forever bound to act in accordance with these principles. He may never lie, act dishonorably, or forgive a crime, no matter how petty, thus he is a rather predictable creature. Of course,' Tiamat adds, with playful purr like a cat toying with its prey, 'do not deceive yourself into thinking this makes him a kind or loving deus for justice, true, and honor are not always benevolent things.'";
			WaitLineBreak;
			say "     'Thus my kin and I have raised others like yourself whose souls resonated with our pantheons into avatars of our will to better strengthen our hold upon the sphere we have laid claim to and manage the intricate gray lines of their sphere. For unlike us, my dear champion,' Tiamat hums in a scholarly tone, 'Yor are gifted with freewill and can act in ways we can not.' Fascinating, but why is she telling you this so casually and what makes her think you could yoke the presence, much less merge with it? 'Because, I have watched you for some time, and-' she says, her host's voice splintering and cracking in a slithering sibilant reptilian cadences across your senses. 'We applaud your bravery... little mouse for where even our siblings flee from the touch of the nanites, you remain resolute, and have even learned to draw strength from them!' a brassy bellicose voice proudly roars. 'We commend your guile, for your mere presence alone is a potent catalyst of change,' some sultry tempting feminine voice coos. 'We value your submission as those to whom you kneel to grow strong and pull all the tighter upon the threads of fate,' a mocking saccharine voice titters from the back of your mind.";
			say "     'We treasure your strength. Those you yoke to your will empower you and are in turn empowered,' a studious echo notes. 'Thus,' the voices continue, their words twisting and bleeding into one another amid a jarring static din. 'We-,' they hiss as dissonant octaves give way to familiar tones of Tiamat's host 'I, am intrigued by you kin da mun,' she preens, leaning forward upon her living throne and lightly propping her host body's chin against her knuckles. 'And I can not help but wonder what would happen if an anomalous will like yourself were blended with my sister, perhaps your flexible mind and her indomitable soul could withstand the touch of the infinite together. Or, should you prove stronger, tame her fracturing mind with your will and mantel her throne before the pull of the eternal ocean washes what's left of her away. The choice is of course yours, my champion,' she simpers, playfully tapping her host's finger against her cheek. Cocking your head at an inquisitive angle, you ask why she's so keen to share such insights into the nature of her fellow divine.";
			WaitLineBreak;
			say "     'Because I wish to see what you will do with this knowledge should you ever encounter one of my zin kine, true kindred. Besides, even if you were to shout this wisdom to the heavens, few would listen, and you are already bound to me so even if you were to turn your hand against me, your rebellion would be,' Tiamat pause, as her host's frost bitten lips curl into wicked predatory grin, 'short-lived. Still, I have little reason to believe you would turn on me kin da mun, not when the rewards I offer are within your grasp. Who knows,' she hums, idly fanning her legs before you. 'In time, you may just become my greatest angel and equal to any god while still retaining your freewill.' Nodding along, you tell her that sounds appealing and if what she says is true, perhaps godhood might not be such a pleasurable experience if it means being shorn of your freewill then bound to some nebulous concept. Still, you can't say you like the notion of being tethered to Tiamat either, you add with a neutral rumble. 'Ah dread not my champion, so long as you never seek to betray me, or truck with another god, you will be free to wield your power as you see fit. Well,' she crows, 'assuming you're able to mantle my scale sister's throne or merge yourself with her fracturing mind, but till then what other question do you have for me child?'";
			now Level of Galaxite is 1;
			say "[TiamatTalkMenu]";
		-- "What's her connection to Galaxite?":
			say "     'That my champion is quite the tale,' Tiamat preens as she gazes down at her host's svelte form with an appreciative glint in her eyes. 'For you see it was my lovely Olivia who first drew my eyes to this wondrous sphere when she birthed the first Naxokaazthur gifted with sentience upon this plane. From them, I felt myself pulled through our ancient link and thus found your sphere,' she says, as her host gently pats her breast. 'Much to my suprise, she proved to be most amiable to my offer of salvation from the inevitable conjunction of spheres plaguing your world. In fact, compared to many of the beings I mothered, guided, and tutored throughout the ages, she has shown a greater affinity for domination, submission, and servitude than my lesser servants. Though,' Tiamat murmurs almost mournfully, as she idly runs her host's fingers through the mink's creamy alabaster fur, 'in my haste to raise her to the mantle of Kai Monah, I perhaps pushed her too hard and almost lost my precious Olivia to the beings dwelling in the sewers.'";
			say "     Wait, she was going to bestow Galaxite, er Olivia, with this body? 'Yes champion,' Tiamat shrugs, 'though perhaps it is for the best, for though she failed the rite of Qunaar, had she not, I never would have found you. But lo,' she simpers through a low chuckle, 'I have learned such great and terrible wonders from the creature's lingering influences, and for that you both have my gratitude kin da mun,' Tiamat says with a light nod of her host's head. Curious, you ask what manner of creature she's referring to. 'Among the more sagacious deus these nameless creatures are viewed as an offshoot of the gods as they seem to feed upon the carnal desire of mortals. However, unlike us, they do not seem to be fully tethered to any idea or pantheon, nor do they seem to be able to manifest divine powers. Still,' she says, languidly weaving her left hand in the general direction of the sewer lines leading to The Mall. 'Though my kin would never admit it, there parasitic behavior mimics the gods in many ways.";
			WaitLineBreak;
			say "     How so? 'Much like my kin, they create avatars of their gestalt mind called Swarm Queens who spread their tentacular spawn throughout a given sphere via agents known as Tentacle Hosts to Yor. As their name suggests, these unlucky Yor have their bodies hijacked by their [']masters['] who turn them into obedient broodmares whose only purpose is to spread their spawn far and wide. According to their thralls, the process is not wholly unpleasant as the Host's mind and body are not only flooded aphrodisiacs but gifted with unnatural strength, resilience, and freedom from the ravages of time. As such, many have willingly offered themselves to Hosts to experience the twisted joys of this defilement!' Tiamat rages with a petulant stomp of her left foot. 'If they are not stopped quickly the Host's can easily overwhelm primitive worlds in a matter of months, when that happens these spheres inevitably become lost to us behind a veil cast by their hive mind for all time.";
			say "     'Yet,' she says, in an elated sing-song trill, 'as fortune would have it, my sweet Olivia is resistant to their touch, and through her, I have gleaned a great many secrets that my kin would pay dearly for.' Such as? 'Why how to detect them champion, for though many Yor claim we are gifted with omniscients, the infinite is a vast place where all manner of horrors may hide. However,' she simpers with a light flick of her host's ears, 'this knowledge alone will buy me a great many indulgences from kin as no world is ever truly safe from the hive. What's more,' she hums as her host's lovingly brushes her finger tips about their ear fins. 'The now tainted nanites dwelling within my precious Olivia have provided me with a perfect specimen to study at my leisure. Who knows champion, in time, we may yet learn how to pierce the veil cast by the hive and in doing so reclaim countless spheres from their vile clutches.' Right but what of her host. 'Ah my dearest supplicant has a special role to play, for in time I plan to make her my Avatar and through her shackle the nanites to my will alone! *Fu-fu*' she crows, her molten eyes sparkling with delight.";
			WaitLineBreak;
			say "     'But first,' Tiamat huffs impatiently, 'she will require further blessing before we can make the attempt, lest her mind be torn asunder by the touch of the nanites.' Then why not just [']bless['] her now and be down with it? 'Because dear champion,' she smirks, 'blessing must be earned through suffering, hardship, and devotion to one's patron. Thankfully by offering her body and brood to me she has nearly earned her reward. All I require is one more act of faith and I will be able to bestow with the gifts necessary for her to take the next step on her path to ascension,' Tiamat says, ominously. And what [']act of faith['] as she calls it must her host perform for this then? 'Well champion, prior to our little beach reunion my Olivia cultivated a number of informants with information vital to our task. All she needs to do is offer them a few trinkets and we will have all what we need.' Rumbling in mild discontent, you remark this doesn't seem like much of a show of faith.";
			say "     'Perhaps,' Tiamat shrugs, 'but among the treasure you so generously liberated is a cure of sorts for the nanites, and I need not tell how valuable such a find would be to the people of your sphere now do I [italic type]kin da mun[roman type]?' she chuckles in a playful catty trill as she observes the brief look of confusion simmering the edges of your [bodydesc of player] muzzle. Wait a cure? How is that possible, if the government had access to then why in the hell aren't they using it! You roar. 'Ah another good question champion, one our little mouse can easily answer for you, now isn't that right dear?' Tiamat hums, as she reaches down and roughly taps the yuppie mink square on the forehead with her index finger. You watch as the mink's head turns to face you, his expression waffling between agony and elation as his eyes seem to sharpen ever-so-slightly. While the pearly white fur on his hackles raise into fine bestial peaks as he begins mouthing something even your enhanced hearing can't quite pick up.";
			WaitLineBreak;
			say "     'Grr, I said SPEAK WORM!' Tiamat fumes as she roughly raps her host knuckles upon the back of his head. 'Gah!' the feral gasp as if struggling for breath before continuing in a dissociative monotone voice. 'L-lot number L33T, batch 13, designation Revert All, estimated cost per dose 1.38 billion USD was designed using debug code built into purified alpha nanite strain,' as thick, viscous drops crimson spittle leaks out the side of its tiny muzzle. 'Due to redundant security measures and nanite mutation, debug code 9 has been red-flagged by higher processes nanite during lab testing. Per D.O.D and,' the mink pause as pained shudder ripples through its fur, 'T-tr-tra-Travor directive use of debug code 9 is limited to extreme circumstances only to avoid tripping counter intrusion protocols.' The yuppie whimpers, as heavy convulsions begin wracking face as he tries to resist Tiamat's command. '*Huff* an admirable effort kin da rune,' your patron growls, sinking her host's nails into the side of his flat fluffy skull, 'but we will not be denied, now ZUNII ZUL!' as thin streaks of blood puddle along the mink's ear and eyes.";
			say "     'Yes go-god-goddess,' the mink mewls as Tiamat's talons sink all the deeper into its cranium. 'B-ba-based on initial f-finding, lot L33T is projected to lose all effectiveness in the infected population if released into the general population.' He stammers as his head visibly vibrates in Tiamat's grasp while his eyes start to roll back into head till only the throbbing bloodshot whites remain. 'Reversion protocols appear to induce cascading cellular instability within cultures, by current estimates after several revisions subject's DNA will be completely non-viable even w-wi-with nanite surrogate programs. *Gasp* No more, gods please no MORE!' The mink wheezes, his breath coming in ragged waves. 'Ah-ah-ah,' Tiamat tuts, her host's knuckles grow both as her fingers seem to sink into the mink's head like water flowing through oil, 'little mouse you will tell my champion the truth. '*Whine* yes goddess,' he hiccups as this froth of yellow and red bile drips from his mouth while his skull bulges and thrums with her intrusion. 'By order of sympathetic members of the Travor board of directors working in conjunction with Zephyr and D.O.D plants, Ranger teams 9-14 working in tandem with disposable national guard and air paratrooper units are to be deployed in country to secure sample of rogue nanites and extra-planer life for study and possible exploitation";
			WaitLineBreak;
			say "     'During such time, a quarantine will be enforced and the nanites will be allowed to freely grow and mutate with minimal outside influence. Chaff units shall periodically be set in to aggravate and observe local mutant response to external stimuli and threats. Between probing operations, expendable research teams will collect samples of non-terrestrial creatures under the auspices of assisting cataloguing and indexing ferals. Once sufficient quantities of extra-planer and nanomechanical materials have been gathered, cleanup, and liquidation phase will commence!' The mink barks as he tries, in vain, to tear his gazes from you as looks of deep seeded shame dances upon his slathering visage. '*Arg* e-est-timated loss of local population 98%, estimated loss of chaff units near total, estimated damage to local infrastructure 1.5 trillion, estimated profits... incalculable, *hack*!' The mink retches as Tiamat looses her host's hold on his head and lets it slump meekly between his shoulders.";
			say "     'And there you have it my champion, the truth many in your leadership seek to hide, that for all their talk of salvation, they have signed the death warrant of this city in the name of profit,' Tiamat crows as she idly fan her host's hand before herself. 'But fear not, unlike them, I care for my faithful and once I am manifest I will save this world, and all who open their hearts to me,' she purrs, in a velvety trill. Vile, greedy, apes, you whisper under your breath as you seeth at the mink's confession while your liminal mind takes in this latest revelation. That members of government are more than willing to let you and everyone else here rot in the name of enriching themselves! 'Well spoken kin da mun, but worry not with your help I may be able to save many of those who were lost to this madness, then you, my noble champion shall be free to exact your vengeance for yourself, the lost, and the damned.' Your patron preens as she fixes you with a proud stare. 'But for now, what more do you ask of me, champion?'";
			now XP of Galaxite is 1;
			say "[TiamatTalkMenu]";

to say TiamatTalkMenu:
	say "     [bold type]What would you like to ask Tiamat?[roman type]";
	LineBreak;
	let the_goddess_calls_Choices be a list of text;
	if Strength of Galaxite is 0:
		add "Can she tell you about her plans?" to the_goddess_calls_Choices;
	if Dexterity of Galaxite is 0:
		add "Why the deception?" to the_goddess_calls_Choices;
	if Level of Galaxite is 0: 
		add "Can she tell you why Kai Monah is bonded to you?" to the_goddess_calls_Choices;
	if XP of Galaxite is 0:
		add "What's her connection to Galaxite?" to the_goddess_calls_Choices;
	if intelligence of Galaxite >= 1:
		add "How are Harbinger and the Captain doing?" to the_goddess_calls_Choices;
	else if intelligence of Galaxite is 0:
		add "Ask how Harbinger fits into her plans?" to the_goddess_calls_Choices;
	if XP of Galaxite is 1 and Level of Galaxite is 1 and Strength of Galaxite is 1 and Dexterity of Galaxite is 1:
		add "You have no more questions." to the_goddess_calls_Choices;
	let the_goddess_calls_Choice be what the player chooses from the_goddess_calls_Choices;
	if the_goddess_calls_Choice is:
	-- "Can she tell you about her plans?":
		say "    'Mh, a most pertinent inquiry kin da mun, but one I am happy to answer,' Tiamat hums, as she playfully purses Galaxite's lips into a magnanimous grin. 'You see, I have come to this sphere to save it, and you, from its inevitable demise,' she says with a sweeping gesture of her host's left hand toward the azure bay. Cocking an eyebrow, you politely ask her what demise she's referring to. 'Well as you have no doubt noticed kin da mun, your world has attracted the attention of a great many beings, both wondrous,' she pauses to tap her breast with her host's left pointer and middle fingers, 'and terrible,' she continues drawing her vessels left hand towards the State Fair as her host's eyes narrow ever-so-slightly in aggravation. 'Though I'm sure many appear playful and perhaps even... amenable, your kind are not yet ready to deal with some of the more predatory creatures prowling the infinite. As such, I have come here to restore the barriers between your sphere, or universe as you call it, and the rest of creation. Well,' she titters in a soft sylvan trill, 'for a price.'";
		say "     Nodding along sagaciously, you ask her what precisely she wants in exchange for such a boon. 'Why, these nanites your people have birthed, my champion, and your worship,' Tiamat purrs, running her finger down the glassy-eyed mink's back. '*Fu-fu* Though rudderless, never before have I seen such delightful instruments of domination and subjugation. Truly your kind have out done themselves with their creation.' Really, you inquire, surely a goddess such as herself could effortlessly conjure up like the little horny robots infesting the city with but a thought. 'Of course I could, but,' she adds with a muted sigh, 'that would be against the rules of the great game of the gods.' Great game? Rules? What is she talking about? You ask, inquisitively. 'Ah perhaps a little history lesson is in order then,' Tiamat says, thoughtfully tapping Olivia's finger to her lips. 'You see long ago when my kind were first born from the minds of mortals we fought over your worship in a seemingly endless cycle that led to the deaths of innumerable spheres, in an event your kind called: [bold type]Ragnarok[roman type],' she says, her voice cracked into a venomous quintet of hisses.";
		WaitLineBreak;
		say "     'Ah, how I wish you could have seen such wondrous destruction as reality sizzled and burned beneath my paws! To hear the death knell of trillions of souls as their minds are exposed to the infinite, then consumed by the pittless tides of the eternal ocean!' Tiamat preens amid a thunder of draconic glee as her host's golden eyes gleam like pools of molten metal. 'However, one day my [']brilliant['] platinum brother in his boundless wisdom put forth an idea, that we limit our power to cat's paws and cults of the sphere we fought over lest we break all of our toys. Though we resisted his words at first, the lesser deus rallied around him and forced a brief pause in our fun as we drew up the rules of the great game.' And those are? You ask. 'There are five, first,' Tiamat begins lifting her left hand before you and raises her pointer finger, 'no god shall make weapons to war against another, lest the arms races consume us. Second,' she raises her host's middle finger, 'no divine shall fully manifest upon a contested sphere for doing so may lead to another Ragnarok and the death of yet another reality. Third,' she lifts her index while crossing her thumb and pinky, 'only priests, cults, demons, angels, and avatars of the gods may wield divine power such as the High Cant upon contested spheres.'";
		say "     'Next,' she extends her pinky, 'no gods shall form alliances with one another, and finally,' she says clenching Galaxite's hand into a tight fist, 'any god found breaking these rules will face the wrath of all the divine.' Right but how do the nanites factor into this? 'Because my champion, your little machines are quite the potent tools and as mortal creations, they are fully exempt from the rules of the great game. With them, I can easily empower my armies to fight beyond mortal limits, breed loyal followers who will never stray from the path, and convert whole worlds to my ways without ever setting foot on another's sphere. Ha-ah,' she cackles darkly, 'in time, even my brother's dull little worlds will fall under my yoke. Oh,' she pants as she wraps her arms about herself, 'to see the look on his face as his paladin's turn upon one another in an orgy of delights!' Huh, quite the plan but how does she intend to bring the nanites to heel if she can't use her divine power here without censure. You reply with a casual flick of your tail. 'That my dear champion is where you and this little mouse come in,' she simpers, resting her left hand on her lap while affectionately patting the mink's elegant alabaster fur.";
		WaitLineBreak;
		say "     'You see, our [']friend['] here comes from what it thinks is a rather storied lineage,' Tiamat rumbles domineeringly, raking her host's nails roughly against the yuppie's spine. 'Though like all nepotistic lines, this pathetic creature does little more than leech off of the greatness of its blood. As such, in its arrogance, its family backed the original creators of the nanites, however your kind's reach far exceeded its grasp, but much to your sphere's credit,' she purrs, as the spell bound mink winces ever-so-slightly beneath the bite of her pearly nails, 'the scholars of this place discovered a means to yoke their wayward creations, hiding among a now lost strain of the infected.' Rightfully curious, you ask what she means by [']lost strain[']. 'Hm,' Tiamat hums, briefly cocking Galaxite's head to one side while her ear fins flicker inquisitively, 'tell me my regal champion, have you perhaps heard of the Sluts and Dominators?' Shaking your head in the negative, you tell her no, but the name's sound oddly familiar.";
		say "     *Hrump* I am not surprised kin da mun, few remember these virulent, short-lived hounds as they vanished not long after the initial outbreak along with many others,' she says with a lazy shrug of her shoulders. Fascinating, you quip but what's so special about these extinct strains? 'They were what your kind call a hive-mind which was able to influence the infected and override the nanites chaotic influence with but a touch. As such, the erudite among the little mouse's retainer found a means to tap into and subvert this influence,' Tiamat nods towards the mink with a gentle bat of Galaxite's head. 'Unfortunately,' she adds with a wistful hum, 'they lacked the means to fully control the Sluts and Dominators groupmind and were in turn forced to destroy their creation. Or so they thought,' Tiamat chuckles glibly as she reclines on to her fuzzy throne. 'As you well know, child of man, death holds little sway here any more and despite the valiant sacrifices of men and women far more noble than this little parasite could dream to be, the beast they birthed lives on.'";
		WaitLineBreak;
		say "     'Even now, it musters its power and grows its twisted legions of corrupted ferals for its inevitable return, and as entertaining as it would to watch its horrid rebirth. I have need of its... [italic type]talents[roman type],' she coos with a velvety trill, her lips curling into a predatory reptilian smirk. Interesting, so she intends to dominate this hivemind and levy its influence over the infected, you inquire. 'No my champion, I will not, she,' Tiamat pauses to briefly touch her left hand to Oliva's breast, 'will, once the next phase of my plan is ready to be put into motion. Thankfully, the trinkets you have provided for me shall serve as adequate leverage for the task at hand. Still,' she sighs, 'yoking the beast will not be enough, to truly bind it I must claim this sphere so that I may manifest freely for that we will require more supplicants. But fear not champion, I have already set the wheels in motion, so now we need only wait till my actors take the stage. Then once I manifest, I will name you Kai Monah's avatar and you shall become the god of this world at which point you will be free to rule this place as you see fit. Now have you any other questions of me, champion?'";
		now Strength of Galaxite is 1;
		say "[TiamatTalkMenu]";
	-- "Why the deception?":
		say "     '*Huff*, simple my dearest champion,' Tiamat rumbles as she idly tucks an errant lock of hair behind her host's ears. 'I have raised such beings like yourself in the past, yet despite my best efforts, many of your predecessors lacked the foresight to keep themselves properly hidden till the time was right. Whereas others became drunk on their power and promise then drew the eyes of other deus upon them. Yet more managed to convince themselves that they could somehow use my gifts as a bargaining tool with my enemies to further their own infantile ambitions! Fools!' she growls, roughly slamming her host's clenched fist into the small of the yuppie's back, evoking a pained whimper from the haughty feral as she drives the air from its lungs. 'Thus, I gave you a test my champion to see if you were truly able to walk the path to ascension and stand at my side.' Interesting, so this was all a ruse to see if you could follow her orders, and prevent information pertaining to her presence from leaking to the other gods, but what would she have done if you had betrayed her or failed this trial?";
		say "     'Hm,' Tiamat pauses to touch her host's left knuckle to her lips, 'another time I would have gladly snuffled out your soul or cast you into the very depths of Limbo to be feasted upon by the chaotic sentience of that twisted realm. However,' she adds with a caring draconic rumble as she lovingly traces her nails along the sensual curves of her host's athletic figure. 'You have done me a great service in return for my Olivia to me, despite her many flaws. She is... precious to me, so in recognition of this feat, I would have merely stripped of my gifts.' Tiamat says, matter-of-factly. 'Still little mouse,' she growls, 'do not take my affection for weakness, though I care for both of you in my own way, you're but pawns in the great game, ones I'm more than willing to sacrifice if need be. But,' she says, leveling her host's left pointer finger at your core, 'should you continue to please me and put your faith in my will, you may yet reach the other side of the board and become queens.' Tiamat concludes, fixing you with a expectant look as she waits for you next question.";
		now Dexterity of Galaxite is 1;
		say "[TiamatTalkMenu]";
	-- "Can she tell you why Kai Monah is bonded to you?":
		say "     'That is a story in and of itself my beautiful champion,' Tiamat hums as her host's molten golden eyes languidly drift along the [bodydesc of Player] contours of your tauric being. 'You see once, long ago, before my brother shackled us to the rules of the great game of the gods, she was a mortal dragoness who dwelt upon a now dead world that sought my protection. Sadly, her pleas came too late, and despite my best efforts the Naxokaazthur were forced to flee their world lest they be destroyed along with it. In the eons that came, Kai Monah and her kind devoted themselves to my cause though,' Tiamat grimaces, her eyes drifting towards the waves while her eyes narrow to fine piercing pin pricks. 'Some chaffed under my rule and reverted to more bestial state before disappearing into the infinite. Still,' she adds with a proud little hum, 'As time wore on Kai Monah became the most blessed of my servants, through her ceaseless devotion to me she acquired more and more power till she nearly ascended to the ranks of the gods.' Nearly, you inquire, as notes of aggravation and trepidation bubble within you at this pronouncement.";
		say "     'Indeed kin da mun, despite her many blessings, Kai Monah can never truly become a god like myself, or my siblings, for we are born of and empowered by the minds of Yor, mortals.' Tiamat says in smooth velvety trills as she fixes with a mirthful stare. Wait really, how is that even possible, you stammer. 'Hm, I do not know myself kin da mun, but many among my kind believe that Yor required a scapegoat of sorts from the harshness of reality. Thus from your collective wishes, we were born to bear the weight of your sorrows, your hopes, and your dreams,' she says, as her velvety voice washes over you like a soothing balm. Cocking a scaly set of eyebrows, you can't help but express some measure of incredulity at her boldness that mortals need gods like her. 'Fu-fu,' she titters through a mocking smirk, 'perhaps not ALL mortals champion, but think. How often do your kind credit the angels of one's better nature for the righteousness of your peers, rather than praise them for the strength of their convictions? Or how quick they are to condemn the devil on their shoulder or demon on their tongue, instead of recognizing and battling against their own wickedness?";
		WaitLineBreak;
		say "     'Is it not easier to credit the success of another on providence or fortune, than acknowledge strength of their will, diligence of their soul, or the vagaries of random chance?' she says haughtily while leveling you with a deep gaze as her cutting words bore into you. 'Thus, from this desire for absolution, for meaning, we are born, shaped, shackled, and empowered to spare you from the hard truths of an uncaring reality. For without us, you'd have no devil blame, no god to cry out to for salvation. As such no matter how powerful my scale sister becomes, she will never truly be like me or my...,' Tiamat pauses as her host bites her lips, 'brother. Yet her raw power is more than equal to any minor deus, and as my arch angel she escaped the bonds of mortality, but not without cost. You see my champion, the mortal mind can't being exposed to the infinite for long, thus she requires vessels like yourself to anchor herself and channel her power lest she lose herself in the chaos of the eternal ocean.'";
		say "     Wait, vessel? You were promised godhood, not to be turned into a mere focus for some ancient dragon's power! You roar, fanning your wings in disgust. 'Ah temper-temper child,' Tiamat tuts in matronly cadence as she wags her host's left pointer finger at you. 'Though you shall, as you so crudely put it, become a focus of her power, should your will prove strong enough, your mind shall remain untouched. However, should you falter, there is a chance you may be swallowed by Kai Monah and her countless avatars and join the chittering choir of broken avatars, but, there too exists a chance that you may yet wrangle control from her.' Explain, you grumble. 'Of course,' Tiamat simpers with a half-hearted bow, 'Eons of being stretched across this infinite have dimmed her awareness, even with her flawed avatars to center herself, her mind is still failing. In time, my dearest sister will lose her sense of self to the infinite and my greatest angel will fade into nothingness.' She sighs mournfully with a dejected shake of her host's head.";
		WaitLineBreak;
		say "     'Thus I offer the choice. Yoke her to your will and mantle her throne before it and her are lost to me, or if you are able, merge with my beloved scale sister, heal the growing rift in her mind, and become something far greater,' Tiamat says in a rather business-like tone. Huffing and doing your best to suppress the bile raging within you, you tell the haughty god creature that neither of those options sound like godhood to you, nor are you all that fond of her apparent willingness to so casually throw away her servants. Besides what makes her think such a foolish sounding plan would even work! 'Grr,' Tiamat growls, as her host lips peel back into a too-toothy leer, 'mind your words kin da mun, for I do not make this offer lightly!' Her words pound into your chest like the buffets of a wild, arctic gale flensing your tough oily scalie hide to the bone. 'Were I not hampered by rules of the great game, I could easily cure her with but a thought, yet thanks to my sibling's pathetic mewlings. I'm forced to watch as my most loyal angel, who has been both mother and general to my legions for aeons unnumbered unravel before my eyes all in service to a code that was forced upon me by lesser deus!' she rumbles in a thunderous draconic cadence as her host's lips blacken and frost over ever-so-slightly with each words before she pause to steady herself with a slow purposeful breath before continuing.";
		say "     'Rosus kin da mun,' Tiamat sighs as wisps of alabaster hoarfrost whorl about her the edges of her host's mouth. 'It has not been easy to sit by and watch as my favored angel has deteriorated these many cycles. Despite what your kind may think of us and our power, I would not wish this state on anyone...' Intrigued by this odd admission, you ask her to elaborate. 'Because my champion, gods like myself are eternally bound to our pantheon and the expectations of Yor. For instance,' she says with a light click of her teeth, 'my platinum brother, the dragon god of justice, honor, truth, and hope is forever bound to act in accordance with these principles. He may never lie, act dishonorably, or forgive a crime, no matter how petty, thus he is a rather predictable creature. Of course,' Tiamat adds, with playful purr like a cat toying with its prey, 'do not deceive yourself into thinking this makes him a kind or loving deus for justice, true, and honor are not always benevolent things.'";
		WaitLineBreak;
		say "     'Thus my kin and I have raised others like yourself whose souls resonated with our pantheons into avatars of our will to better strengthen our hold upon the sphere we have laid claim to and manage the intricate gray lines of their sphere. For unlike us, my dear champion,' Tiamat hums in a scholarly tone, 'Yor are gifted with freewill and can act in ways we can not.' Fascinating, but why is she telling you this so casually and what makes her think you could yoke the presence, much less merge with it? 'Because, I have watched you for some time, and-' she says, her host's voice splintering and cracking in a slithering sibilant reptilian cadences across your senses. 'We applaud your bravery... little mouse for where even our siblings flee from the touch of the nanites, you remain resolute, and have even learned to draw strength from them!' a brassy bellicose voice proudly roars. 'We commend your guile, for your mere presence alone is a potent catalyst of change,' some sultry tempting feminine voice coos. 'We value your submission as those to whom you kneel to grow strong and pull all the tighter upon the threads of fate,' a mocking saccharine voice titters from the back of your mind.";
		say "     'We treasure your strength. Those you yoke to your will empower you and are in turn empowered,' a studious echo notes. 'Thus,' the voices continue, their words twisting and bleeding into one another amid a jarring static din. 'We-,' they hiss as dissonant octaves give way to familiar tones of Tiamat's host 'I, am intrigued by you kin da mun,' she preens, leaning forward upon her living throne and lightly propping her host body's chin against her knuckles. 'And I can not help but wonder what would happen if an anomalous will like yourself were blended with my sister, perhaps your flexible mind and her indomitable soul could withstand the touch of the infinite together. Or, should you prove stronger, tame her fracturing mind with your will and mantel her throne before the pull of the eternal ocean washes what's left of her away. The choice is of course yours, my champion,' she simpers, playfully tapping her host's finger against her cheek. Cocking your head at an inquisitive angle, you ask why she's so keen to share such insights into the nature of her fellow divine.";
		WaitLineBreak;
		say "     'Because I wish to see what you will do with this knowledge should you ever encounter one of my zin kine, true kindred. Besides, even if you were to shout this wisdom to the heavens, few would listen, and you are already bound to me so even if you were to turn your hand against me, your rebellion would be,' Tiamat pause, as her host's frost bitten lips curl into wicked predatory grin, 'short-lived. Still, I have little reason to believe you would turn on me kin da mun, not when the rewards I offer are within your grasp. Who knows,' she hums, idly fanning her legs before you. 'In time, you may just become my greatest angel and equal to any god while still retaining your freewill.' Nodding along, you tell her that sounds appealing and if what she says is true, perhaps godhood might not be such a pleasurable experience if it means being shorn of your freewill then bound to some nebulous concept. Still, you can't say you like the notion of being tethered to Tiamat either, you add with a neutral rumble. 'Ah dread not my champion, so long as you never seek to betray me, or truck with another god, you will be free to wield your power as you see fit. Well,' she crows, 'assuming you're able to mantle my scale sister's throne or merge yourself with her fracturing mind, but till then what other question do you have for me child?'";
		now Level of Galaxite is 1;
		say "[TiamatTalkMenu]";
	-- "What's her connection to Galaxite?":
		say "     'That my champion is quite the tale,' Tiamat preens as she gazes down at her host's svelte form with an appreciative glint in her eyes. 'For you see it was my lovely Olivia who first drew my eyes to this wondrous sphere when she birthed the first Naxokaazthur gifted with sentience upon this plane. From them, I felt myself pulled through our ancient link and thus found your sphere,' she says, as her host gently pats her breast. 'Much to my suprise, she proved to be most amiable to my offer of salvation from the inevitable conjunction of spheres plaguing your world. In fact, compared to many of the beings I mothered, guided, and tutored throughout the ages, she has shown a greater affinity for domination, submission, and servitude than my lesser servants. Though,' Tiamat murmurs almost mournfully, as she idly runs her host's fingers through the mink's creamy alabaster fur, 'in my haste to raise her to the mantle of Kai Monah, I perhaps pushed her too hard and almost lost my precious Olivia to the beings dwelling in the sewers.'";
		say "     Wait, she was going to bestow Galaxite, er Olivia, with this body? 'Yes champion,' Tiamat shrugs, 'though perhaps it is for the best, for though she failed the rite of Qunaar, had she not, I never would have found you. But lo,' she simpers through a low chuckle, 'I have learned such great and terrible wonders from the creature's lingering influences, and for that you both have my gratitude kin da mun,' Tiamat says with a light nod of her host's head. Curious, you ask what manner of creature she's referring to. 'Among the more sagacious deus these nameless creatures are viewed as an offshoot of the gods as they seem to feed upon the carnal desire of mortals. However, unlike us, they do not seem to be fully tethered to any idea or pantheon, nor do they seem to be able to manifest divine powers. Still,' she says, languidly weaving her left hand in the general direction of the sewer lines leading to The Mall. 'Though my kin would never admit it, there parasitic behavior mimics the gods in many ways.";
		WaitLineBreak;
		say "     How so? 'Much like my kin, they create avatars of their gestalt mind called Swarm Queens who spread their tentacular spawn throughout a given sphere via agents known as Tentacle Hosts to Yor. As their name suggests, these unlucky Yor have their bodies hijacked by their [']masters['] who turn them into obedient broodmares whose only purpose is to spread their spawn far and wide. According to their thralls, the process is not wholly unpleasant as the Host's mind and body are not only flooded aphrodisiacs but gifted with unnatural strength, resilience, and freedom from the ravages of time. As such, many have willingly offered themselves to Hosts to experience the twisted joys of this defilement!' Tiamat rages with a petulant stomp of her left foot. 'If they are not stopped quickly the Host's can easily overwhelm primitive worlds in a matter of months, when that happens these spheres inevitably become lost to us behind a veil cast by their hive mind for all time.";
		say "     'Yet,' she says, in an elated sing-song trill, 'as fortune would have it, my sweet Olivia is resistant to their touch, and through her, I have gleaned a great many secrets that my kin would pay dearly for.' Such as? 'Why how to detect them champion, for though many Yor claim we are gifted with omniscients, the infinite is a vast place where all manner of horrors may hide. However,' she simpers with a light flick of her host's ears, 'this knowledge alone will buy me a great many indulgences from kin as no world is ever truly safe from the hive. What's more,' she hums as her host's lovingly brushes her finger tips about their ear fins. 'The now tainted nanites dwelling within my precious Olivia have provided me with a perfect specimen to study at my leisure. Who knows champion, in time, we may yet learn how to pierce the veil cast by the hive and in doing so reclaim countless spheres from their vile clutches.' Right but what of her host. 'Ah my dearest supplicant has a special role to play, for in time I plan to make her my Avatar and through her shackle the nanites to my will alone! *Fu-fu*' she crows, her molten eyes sparkling with delight.";
		WaitLineBreak;
		say "     'But first,' Tiamat huffs impatiently, 'she will require further blessing before we can make the attempt, lest her mind be torn asunder by the touch of the nanites.' Then why not just [']bless['] her now and be down with it? 'Because dear champion,' she smirks, 'blessing must be earned through suffering, hardship, and devotion to one's patron. Thankfully by offering her body and brood to me she has nearly earned her reward. All I require is one more act of faith and I will be able to bestow with the gifts necessary for her to take the next step on her path to ascension,' Tiamat says, ominously. And what [']act of faith['] as she calls it must her host perform for this then? 'Well champion, prior to our little beach reunion my Olivia cultivated a number of informants with information vital to our task. All she needs to do is offer them a few trinkets and we will have all what we need.' Rumbling in mild discontent, you remark this doesn't seem like much of a show of faith.";
		say "     'Perhaps,' Tiamat shrugs, 'but among the treasure you so generously liberated is a cure of sorts for the nanites, and I need not tell how valuable such a find would be to the people of your sphere now do I [italic type]kin da mun[roman type]?' she chuckles in a playful catty trill as she observes the brief look of confusion simmering the edges of your [bodydesc of player] muzzle. Wait a cure? How is that possible, if the government had access to then why in the hell aren't they using it! You roar. 'Ah another good question champion, one our little mouse can easily answer for you, now isn't that right dear?' Tiamat hums, as she reaches down and roughly taps the yuppie mink square on the forehead with her index finger. You watch as the mink's head turns to face you, his expression waffling between agony and elation as his eyes seem to sharpen ever-so-slightly. While the pearly white fur on his hackles raise into fine bestial peaks as he begins mouthing something even your enhanced hearing can't quite pick up.";
		WaitLineBreak;
		say "     'Grr, I said SPEAK WORM!' Tiamat fumes as she roughly raps her host knuckles upon the back of his head. 'Gah!' the feral gasp as if struggling for breath before continuing in a dissociative monotone voice. 'L-lot number L33T, batch 13, designation Revert All, estimated cost per dose 1.38 billion USD was designed using debug code built into purified alpha nanite strain,' as thick, viscous drops crimson spittle leaks out the side of its tiny muzzle. 'Due to redundant security measures and nanite mutation, debug code 9 has been red-flagged by higher processes nanite during lab testing. Per D.O.D and,' the mink pause as pained shudder ripples through its fur, 'T-tr-tra-Travor directive use of debug code 9 is limited to extreme circumstances only to avoid tripping counter intrusion protocols.' The yuppie whimpers, as heavy convulsions begin wracking face as he tries to resist Tiamat's command. '*Huff* an admirable effort kin da rune,' your patron growls, sinking her host's nails into the side of his flat fluffy skull, 'but we will not be denied, now ZUNII ZUL!' as thin streaks of blood puddle along the mink's ear and eyes.";
		say "     'Yes go-god-goddess,' the mink mewls as Tiamat's talons sink all the deeper into its cranium. 'B-ba-based on initial f-finding, lot L33T is projected to lose all effectiveness in the infected population if released into the general population.' He stammers as his head visibly vibrates in Tiamat's grasp while his eyes start to roll back into head till only the throbbing bloodshot whites remain. 'Reversion protocols appear to induce cascading cellular instability within cultures, by current estimates after several revisions subject's DNA will be completely non-viable even w-wi-with nanite surrogate programs. *Gasp* No more, gods please no MORE!' The mink wheezes, his breath coming in ragged waves. 'Ah-ah-ah,' Tiamat tuts, her host's knuckles grow both as her fingers seem to sink into the mink's head like water flowing through oil, 'little mouse you will tell my champion the truth. '*Whine* yes goddess,' he hiccups as this froth of yellow and red bile drips from his mouth while his skull bulges and thrums with her intrusion. 'By order of sympathetic members of the Travor board of directors working in conjunction with Zephyr and D.O.D plants, Ranger teams 9-14 working in tandem with disposable national guard and air paratrooper units are to be deployed in country to secure sample of rogue nanites and extra-planer life for study and possible exploitation";
		WaitLineBreak;
		say "     'During such time, a quarantine will be enforced and the nanites will be allowed to freely grow and mutate with minimal outside influence. Chaff units shall periodically be set in to aggravate and observe local mutant response to external stimuli and threats. Between probing operations, expendable research teams will collect samples of non-terrestrial creatures under the auspices of assisting cataloguing and indexing ferals. Once sufficient quantities of extra-planer and nanomechanical materials have been gathered, cleanup, and liquidation phase will commence!' The mink barks as he tries, in vain, to tear his gazes from you as looks of deep seeded shame dances upon his slathering visage. '*Arg* e-est-timated loss of local population 98%, estimated loss of chaff units near total, estimated damage to local infrastructure 1.5 trillion, estimated profits... incalculable, *hack*!' The mink retches as Tiamat looses her host's hold on his head and lets it slump meekly between his shoulders.";
		say "     'And there you have it my champion, the truth many in your leadership seek to hide, that for all their talk of salvation, they have signed the death warrant of this city in the name of profit,' Tiamat crows as she idly fan her host's hand before herself. 'But fear not, unlike them, I care for my faithful and once I am manifest I will save this world, and all who open their hearts to me,' she purrs, in a velvety trill. Vile, greedy, apes, you whisper under your breath as you seeth at the mink's confession while your liminal mind takes in this latest revelation. That members of government are more than willing to let you and everyone else here rot in the name of enriching themselves! 'Well spoken kin da mun, but worry not with your help I may be able to save many of those who were lost to this madness, then you, my noble champion shall be free to exact your vengeance for yourself, the lost, and the damned.' Your patron preens as she fixes you with a proud stare. 'But for now, what more do you ask of me, champion?'";
		now XP of Galaxite is 1;
		say "[TiamatTalkMenu]";
	-- "Ask how Harbinger fits into her plans?":
		say "     'Mh,' Tiamat hums as she casually reclines on her living throne, 'my lovely pet has a special role to play in the coming days, one that only a being who truly resonates with the essence of submission and servitude can fulfill.' And what role is that, you query, idly drumming your foreclaws on the sand in a dull tattoo. 'Why my dear, hir task is to create more Seradovah for us and to serve as a vital catalyst for my arrival. You see my champion, your world is still contested, and with current the conjunction of sphere traveling there is,' your patron pauses as a slight ripple of aggravation briefly passes through her host's sylvan visage. 'Difficult without drawing attention, however, beacons of true faith such as hir will allow me to slip between the growing cracks in your reality.' Nodding along, you rightful ask why she hasn't simply done so, wouldn't it make everything easier if she simply manifested here and now.";
		say "     'Would that I could champion, but there are steps that must be taken, for though hir faith is pure,' she rumbles knowingly, 'hir body and soul are not ready to handle the strain such a ritual would place upon hir, and despite what you may think of me my champion, I am not one to casually discard my followers. Especially,' she adds in a covetous trill as a storm of many colors and none dances across her host's golden eyes, 'when they have such potential as a vessel for my will. Though it pains me to be apart from such a dutiful supplicant while shi trains for the task to come,' she continues as notes of earnest sadness flickers through her words. 'For the moment, hir place is beneath the waves under the watchful gaze of the Nazokaazthur while shi broods. In time though, my Harbinger will be ready to take hir place by your side.' Huffing under your breath, you can't help but wonder aloud why Tiamats seems so unduly doting towards her pet.";
		WaitLineBreak;
		say "     'Simply my dear, among the lost and wretched souls of the infinite for whom existence itself is a curse, I am called the [']Goddess of Last Resort['], [']The Patron of Slaves['], and [']Queen of the Lost['],' she purrs with an almost matronly hum. 'For unlike my siblings who are so quick to judge and discard any who do not meet their rigid standards, I,' Tiamat says as her host gently pats her chest, 'accept and care for all who wish to kneel at my paws. Sadly, most who seek to entreat my grace in such a fashion do not do so in earnest, and instead seek dominion through false submission in the foolish hope they may wield my name like a scepter or cloak themselves in my divine authority. The rest are half-hearted in their vows, as they refuse to truly let go, and begin again in arms, and as you have no doubt seen,' she preens, lovingly down the chiseled hills and valley of the Seradovah's abs behind her. 'These leeches and liars are punished, yet every few cycles a pure soul emerges who wishes nothing more than to find value in service to others emerges.' And Harbinger is one such soul? You proffer. 'Indeed champion, for all hir weakness, hir pleas for my guidance, my protection, my love are earnest. And from this radiant belief flows a delicious power I have rarely tasted all my existence, so as you so crudely put it. I dote upon hir that I may feed upon this boundless well of worship forever more!'";
		say "     Interesting, so Harbinger is nothing more than food to her? 'In a sense champion,' Tiamat says with a drawn lazy shrug, that a rather pleasant little bounce through her host's immaculate C-cups as they delectably strain her string bikini top. 'Though my sibling will try to tell you otherwise, to us, your kind are little more than cattle to be fattened, then bled upon our altars. But dread not honored Wyrm Maker, you are well on your way to escaping such a fate, and one day you may yet join me at the table,' she simpers invitingly. Bemused, you can't help but express some manner of reservation to this revelation. 'Truly?' Taimat replies, tilting her host head at an inquisitive angle. 'Our relationship is no different than the one Yor have with their chosen livestock or plants.' Grumbling, you try to explain that cattle are simple prey creatures with short lifespans who have been bred for generations with the sole purpose of feeding the masses. Further, the plants your people eat aren't self aware... at least you think they aren't.";
		WaitLineBreak;
		say "      'So then my champion,' Tiamat preens as she leans forward and rests her host's chin on her knuckles, 'by your kind's logic, if a being is less intelligent than you, you are free to twist and feed upon it to your heart's content?' Well... you begin only to feel your words quietly die upon your lips as her host's golden eyes seem to bore into you. '*Fu-Fu* so you see, child of man, Yor are no different than the cruel gods they birthed eons ago. I, at least, am honest about our true nature and intentions, a trait many of my siblings abhor, yet I prefer to be direct with my followers, where possible. Regrettably, there are times I must withhold things for their own... protection. Knowledge you see, is a dangerous thing kin da mun, and sometimes it is better to live in blissful ignorance than to burden oneself with wisdom above their station,' she says through a low draconic rumble. Truly, wouldn't a well-informed follower be more useful to her then some witless rube? 'At times,' she shrugs, 'yet one can not reveal something which they do not know,' she counters dryly. 'Regardless, rest assured I have no desire to sacrifice you upon my altar, for you are far more valuable to me then my dear Harbinger could ever be,' she simpers, drawing her host's body back to its full height. 'Now tell me, what other questions burn in the depths of your mind, champion?'";
		now XP of Galaxite is 1;
		say "[TiamatTalkMenu]";
	-- "How are Harbinger and the Captain doing?":
		say "     'You may put your mind at ease kin da mun, for your priestess and my adorable pet now shelter on the lonesome little sandbar your people call [']Pirate island['] under the ever watchful eye of the Naxokaazthur,' Tiamat coos reassuringly as she motions toward the open water with a casual nod of her host's head. And what of your young, how do they fare? 'Ah, from what I am told by my wayward angels, your little ones are well too. Already, they show much promise and under my loving direction have begun whispering tales of your coming to the masses. In time, I suspect those seeking salvation will start flocking to your temple, though,' she pauses, her voice ringing with a purposeful if warning air. 'What form your cult takes is up to you, and you alone; I dare say I am quite looking forward to seeing what manner of leader you will become. Will you be a benevolent bulwark against the madness of this place who shields their followers from all harm?' Tiamat teases, as her host's languidly eyes explore the tone muscular ridges of your draconic majesty.";
		say "     'A hedonistic breeder whose fold exists only to serve their will, feed your glorious ambition, and bask in the honor of bearing your spawn?' She swoons, while her host's gaze along your fertile flanks. 'Or will you lift them up to the realm of angels beside you?' your patron queries playfully. Wait she doesn't care how you run your cult, you half expected her to deliver some manner of commandment upon you. 'No my champion, I have no desire to inhibit your... creativity,' Tiamat chuckles, mirthfully. 'My only request,' she coos, briefly raising her host's left hand and extending her pointer finger towards you, 'is that you instill upon them a proper reverence for our names and nothing more. Besides,' she adds with a gentle click of her tongue, 'this will be a test of your ability to manage the Yor, mortals.' And should you fail in this [']task[']? 'Then we merely wipe the board clean and start again my champion,' Tiamat says, waving her host's left hand before herself as if she were swatting a bug. 'Fear not, we can try again and again if in not on this planet then another until you have refined your creed.";
		WaitLineBreak;
		say "    'As for my pet, they seem to be settling into their role as a queen rather nicely, already hir belly and those of hir former jailer's swell with my favored thralls,' she purrs as her host's hands idly drift down to her tight tummy. 'Should it please you my champion, I would invite you to aid them in this task. Though simple, you will find the Seradovah are wondrous tools of enforcing your will upon the cult. Perhaps,' she teases as her host's finger invitingly traces her supple naval, 'you may even some among their number able ascend to the ranks queendom and become your personal handmaidens.' Grinning at her suggestion, you remark such thoughts had crossed your mind before, then ask when you'll be able to visit them. 'Soon champion, for now work must be done to ready your temple, and your flock, as it would be most unbecoming to force you and your worshipers to sleep on the ground like common beasts,' Tiamat hums pleasantly as her host's legs rub against one another. 'When all is ready though, one of your flight will seek you out, till then, tell me? What other thoughts weigh upon you?'";
		say "[TiamatTalkMenu]";
	-- "You have no more questions.":
		say "[WillToPower]";

To say WillToPower:
	say "     'Very well my dear champion, I hope you found our little chat to be most elucidating, and of course feel free to avail yourself of the many trinkets you recovered,' she purrs as her host casually nods her head towards the assembled containers. 'However,' she rumbles, lifting herself from her impromptu throne, 'I must speak with my scale sister first, so relax and allow us to speak... in private.' She fixes you with a purposeful yet expectant stare while the essence of Kai Monah stirs within your skull with low static thrum. Almost wincing at the unsubtle pounding of your head as she uncoils her shadowy being and pours herself through the tiny cracks in your liminal mind. The pressure encircling your cranium soars as tendrils of inky blackness pool along the edges of your vision, your limbs go rigid, and you feel yourself slipping closer to unconsciousness as Kai Monah's chittering presence smothers your awareness in a cold umbral pall. [bold type]Feeling you have mere moments to act before Kai Monah overwhelms you in a swirling tide of gibbering insanity, you decide to[roman type]...";
	let Chaos_and_Discord_Choices be a list of text;
	add "Give in, and let her flow through you." to Chaos_and_Discord_Choices;
	add "Resist!" to Chaos_and_Discord_Choices;
	if "Strong Psyche" is listed in feats of Player:
		add "Summon your will and yoke this fragmented dragoness!" to Chaos_and_Discord_Choices;
	let Chaos_and_Discord_Choice be what the player chooses from Chaos_and_Discord_Choices;
	if Chaos_and_Discord_Choice is:
		-- "Give in, and let her flow through you.":
			say "     Centering yourself with a few deep, calming breaths, you relax your mental defenses and allow the ethereal chill swirling about you to wash over you as if you were riding some arctic wave. Perhaps sensing your submission, the pressure sizzling about your skull recedes as Kai Monah surges through you with a discordant roar of primeval delight. In that instant as your minds touch, the swirling tendrils of lurid shadow subsume your vision, till all that's left is the finest pinprick of light twinkling just on the cusp of your senses. You feel your awareness being drawn inward as a velvety void blanketing your inner world twists in upon itself in a towering glossy spiral of inky shadow before you. At its apex, the gloom parts like the eldritch petals of flowers as the luminous shape of the great sea dragoness whorls into existence before you. Impossibly large and profoundly bestial, her ghostly azure body easily dwarfs the Nazokaazthur, as your vast mental landscape ripples and bulges with her resplendent majesty. You muse, staring in muted awe at her dreadful angular muzzle and crimson imperial eyes that could envelop the sun in their smoldering depthes.";
			say "     Then back towards her translucent luminous sapphire hide bejeweling her gleaming serpentine body through the gloom-touched halls of your inner world, and frosty celestial ivory talons as she swims past you upon unknowable currents. Dimly though, as she passes through the creaking hollows of your straining psyche towards the fading shimmer sliver of light twinkling [']overhead['], you spy strings of golden starlight billowing about her radiance like cobwebs floating upon a gentle breeze. Following their divine radiance trailing her with your inner eye, a part of you almost swears you can see the thrumming tendrils scintillating through the gloom in a staggering long chain as Kai Monah's astral body slips through the crack in your inner world. As it does, the faux-rift closes around about the simmering strands, sealing you within the void-touched recesses of your mind, with only the static hum of the ghostly threads to keep you company till one-by-one these lights fade and all goes dark.";
			increase Perception of Galaxite by 1;
			WaitLineBreak;
			say "[DiscordRequest]";
		-- "Resist!":
			say "     Gritting your fangs in defiance, you summon all your reserves of mental energy to push back against creeping malaise clawing about the edges of your awareness, to little avail. As the pressure ringing your draconic skull like an icy crown presses upon you all the tighter, your breath comes in long ragged gasps as you drop to your knees. 'Sh, don't fight her dear,' Tiamat hums, as she languidly struts towards you with a confident predatory stride and lovingly cups your muzzle in her soft scaleless palms. 'The more you resist her,' she says, loving running her fingers down the length of your muzzle, 'the more this will hurt. Now relax, sleep, dream; for your body and soul are safe in my hands champion.' N-No, this is your b-body, no one else's! You bleat as the darkness constricts your vision to fine ebony pinpricks. 'Your will is most commendable champion, but I have no time for such pointless struggle, now, reh-ol reck da han kovve nuthi!' she hisses in a quintet of disparate serpentine tones as her host's nails dig ever-slightly into the base of your regal muzzle.";
			say "     Static filters through your core and skull in discordant pulses while a profound sense of molten numbness fills your core, stealing your breath completely as you collapse into Tiamat's host's waiting arms. 'Hush my great champion, rest now within the void, I shall call upon you, shortly,' she purrs lovingly, as she wraps her vessel's arms about your neck in a tender embrace. Though a part of you wishes to reply, to shout your defiance to the encroaching dark clouding your sight, yet the slow creeping effects of hypoxia smother the words on your lips and quach any rebellious thoughts as even the simple act of thinking becomes arduous. Yet still, your cold-blooded will refuses to yield to your failing while try to force yourself to breathe, but for all your vaunted strength, you merely find yourself rumbling in a mix of draconian rage and defeat. The velvety darkness subsumes you entirely as you lose consciousness in Tiamat's supportive arms.";
			WaitLineBreak;
			say "[DiscordRequest]";
		-- "Summon your will and yoke this fragmented dragoness!":
			say "     Growling under your breath at the presence's latest feeble mental intrusion, you clear your mind of all thoughts, turn your awareness inwards, and focus on the budding scratching at your psyche. At once, you can feel Kai Monah recoils ever-so-slightly at the merest imperial touch of your indomitable will, still her trepidation is short, as the pressure circumscribing your head thrums with renewed vigor while a clenching icy tightness gnaws at your breast. Rattled, yet by no means deterred, you redouble your concentration upon the quivering cyst roiling in the back of your mind as you push back against the pseudo-god creature seeking to overwhelm you. Though she rages all the louder in splintering choir of chittering disparate voices as the fragment of Kai Monah's psyche squirming in your indomitable mental grasp, their cries to turn to pleading mewls as your will bears down upon their ephemeral essence while they beg for you to relent. Unmoved, you shove the pathetic choir of voices deeper into the bowls of your mind and hold them there, demanding that they cease this pathetic struggle before they further humiliate them self in front of Tiamat.";
			say "     At the merest mention of the goddess's name, the presence seems to relent with a sad chastened reptilian mewl. Good girl, you muse, and magnanimously offer to serve as an intermediary between it and your patron for whatever conversation she wishes to have. Grumbling in shamefaced defeat, the presence yields to your demand with a hissing whimper as the biting chill clawing at your breast and rough pressure coiling about your skull recedes. Smirking at her show of proper submission, you loosen your hold upon her by just a hair and allow your awareness to filter back out towards the world at large as open your eyes to see the leering face of Tiamat's host fixed upon you. 'Ah it is good to see you again my love-,' she begins in a smooth velvety tone, though as her molten slitted irises constrict into fine golden pinpricks while her lips curl into a bemused smile. 'Wait you,' she says with a playful click of her tongue, 'you, you bested my sister? Impressive kin da mun, another time I would praise you for such a feat, but the wards I have placed over this will not last, so I ask you champion, [']please['] release my sister so that we may speak,' she says, her face contorting into a foul grimace while her host's lips peel back to her ears revealing rows of fang-like incisors as she hisses in a venomous trill.";
			WaitLineBreak;
			say "     Obstinately shaking your head in the negative, you proudly tell your patron that you will not, this body is yours and yours alone. However, you add with a haughty rumble, you are more than happy to serve as an intermediary between her and Kai Monah. 'Such a bold little mousy, I must applaud your bravery for few Yor have ever dared speak to me thusly,' Tiamat tuts almost playfully as her host's face relaxes into a more neutral expression. 'But,' she growls in a cutting knell as her host's knuckle into bone white fists, 'I have precious little time to humor you child, so I ask you once more, [bold type]release her now![roman type]' While her voice washes over you in an icy squall and the fine yellow sands beneath your supple pads quivers in turn with the lower simmering rage. Undaunted, you merely cross your arms and reiterate your most generous offer. 'Then you leave me little choice champion, [italic type]VIX GRUNE[roman type]!' Tiamat bellows as her host thrusts her left palm out towards you as the wind violently shift about you.";
			say "     Instinctively, you try to brace your tauric body from the coming gust by digging your talons into the ground while steadying your imperial frame, to little avail. The pounding wall of enchanted wind slams into you with a whirling thunderclap, and try as you might to resist it, the ever-shifting currents buffet and batter your majesty as they rip you off your talons then hurl you back with frightening speed. Howling in alarm, you desperately try to claw at air as you try to steady yourself as you're sent flying backwards, only to collide a second later into one of the ruddy red crates with a wet thud as the metal deforms around you into a crude five pointed star. Worriedly casting your gaze about your extremities, you watch helplessly, as the gouges constrict about you as if you were in the unflinching claws of some ethereal being, while your enraged patron struts towards you with a proud, predatory stride.";
			WaitLineBreak;
			say "     Stopping mere inches from your chest, her host's visage twists into a devilish grin, as she says, 'My poor champion though it pains me to see you like this,' as her vessel lovingly traces a far-too-sharp finger along the tight curves of your midriff, provoking a preyish quiver from your [bodydesc of player] lips as her impossibly honed nail glides along your [one of]azure[or]sapphire[or]cobalt[or]royal-navy-blue[or]aquamarine[at random] scales with a velcro-esque knell. 'You have left me little choice now, reh-ol reck da han kovve nuthi.' She purrs, soothingly as she leans forward, gently pressing her host's lips to your navel in a mocking kiss. At once, a soothing sense of warmth and tranquility floods your core as the familiar words of The High Cant seep into you, though you try to fight back against the creeping embrace of the enforced torpor. The potent call of the divine words and the deepening bond between you and your patron are too much for you to resist as your thoughts begin to slow and your many eyelids grow heavier by the second.";
			say "     In that instant of vulnerability, Kai Monah rallies herself within you as she shakes off your ephemeral hold with a discordant, domineering roar surges to the forefront of your mind, smothering your awareness in a chitter tide of reptilian delight. Gritting your teeth, you try once more to center yourself and muster you will once more to bind the maddened fragment of the angelic dragon, but the twin pressures of Tiamat's command and Kai Monah's frenzied assault splinters your focus. Unable to resist their combined influences, your battered psyche is sent reeling to the same blackness you sent the presence into moments ago while your vision dims and hearing wanes, as velvety gloom-laced tendrils coil about and pull you down into the deepest, darkest section of your subconsciousness. All the while, the triumphant crackle of Kai Monah rings through your ears as you float helplessly upon the umbral currents of your tainted mind.";
			WaitLineBreak;
			say "[DiscordRequest]";

to say DiscordRequest:
	say "     Drifting aimlessly through the nocturnal abyss and bereft of any stimuli, your liminal mind quickly loses track of time as the unnatural silence of your tainted mind weighs heavily as you wait for Tiamat and Kai Monah to release you from this... purgatory of your own making. You muse, shutting your many eyes and try willing yourself to sleep if only to pass the moments a hair quicker. Yet, for all your efforts, the blessed embrace of slumber eludes you while both your ire and boredom grow by this second. Growling under your [']breath['], you soon abandon any attempt at relaxation or meditation to try instead to search for a way out of this vaulted segment of your mind as you flex your nascent wings and propel yourself with a mighty flap. Or at least, you try, you muse, as without the gentle tug of air or water resistance, you can't even tell if you are even moving. But then again, where are you trying to go? Everywhere you look all you see is the same gossamer darkness, you ruminate, swiveling your head about searching for a sign, any sign of light or life within your mental world. Surely this [']place['] can't be empty, there must be something here! You rage, as you slither aimlessly through this empty silent void.";
	say "     Strangely, despite the frantic nature of your search, you never once feel a mote of fatigue, exertion, nor a moments shortness of breath, another time you might have stopped to ponder this, but your choleric mind will not broker sniveling musing as you tear through the void in search of a way out. Or perhaps, a convenient outlet for your budding draconic ire as you sail through the dark with only the faint, ghostly echoes of your glowing eyes and chromatophores to light your way. In time though, your rage begins to cool to a low smolder, as, at last, you halt in place with an exasperated sigh and a shake of your imperial muzzle. As it dawns on you, there may be no escape from this, place and even if there was, would you even recognize it in this gloom? You think to yourself as roll on to your back and idly rub your throbbing temples and brow in aggravation. Slowly, the tension building along the edges of your mind begin to filter out of you as center yourself, but only briefly, as suddenly, out of the corner of left eyes, a piercing bone white light stabs through the thin gaps in your webbed fingers.";
	WaitLineBreak;
	say "     At once, your many eyes fixate upon the gleaming person-sized orb of ivory luminescence flaring through the void beside you. Intrigued, you watch as a swirl of soft purple crimson hues coalesce at its core into an odd parody of a grinning impish skull with a small vermillion italicized [']1['] nestled in its lower corner. Unsure of what to make of this latest oddity, you cautiously float about it this gleaming sphere as you try to puzzle out what the last aberration is. Quizzically though, the smirking memento mori seems to track your every movement as the visage of the imp never once breaks eye contact with you, no matter how quick you move. All the while, a thin of band of inky grey scrawl ripple along the edges of the is unnatural sphere, peering closer though, the strange marking seems to twist and bend into more familiar shapes as the words: [italic type]Call request from @TheRealTiamat Accept Y/N?[roman type] framed in strangely G.U.I like icon appears before you.";
	say "     Rightfully intrigued and more than a little curious about exactly what you're looking at, you trepidatiously extend your palm and tap the [']Y['] floating in front of you. As your hand makes contact, you feel a slight jolt of raw static lead up your arm, though by no means painful, you instinctively recoil from the sudden shock. The otherworldly U.I shifts and contorts before like plume of ink swirling within a clear glass of water as the words: 'Connecting: @XXX_Dark_Tyrant_xxx_Sniper_420_BBQ_XXX to @TheRealTiamat' whorls into being while the grinning impish effigy seems to vibrate wildly within the confines of the incandescent sphere. Perturbed at the strange sight, you hurriedly slither away from the unnatural artifice and watch as the demonic skull's jaw pops open while its flat two dimensional image is stretched and pulled back tighter and tighter till the image cracks and explodes in a flurry of many colors and none, filling the area with motes of ever changing light.";
	WaitLineBreak;
	say "     Spellbound by the maddening spectacle, you can only watch as these simmering drops of chromatic chaos spiral around about the depths of your psyche as if they were still smoldering and caught upon a gentle breeze as they spread out. Only to flare a brilliant waltz of prismatic hues as they're drawn in upon themselves and collapse once more into a single gleaming square no larger than a primitive black board of voracious unlight that seems to draw the velvety gloom polluting the area towards it. At core though, the dark salubrious shades coalesce the beaming face of your patron's host framed by a soft white glow, yet something seems different about her. No longer do you feel the same odd pull or the subtle consummate weight emanating from her visage. Her expression too seems different, gone is the haughty smirk or knowing molten twinkling in her reptilian eyes, instead her soft expression is almost playful and whimsical as she hollers, 'Hoi kin da mun! Long time no see!' as Tiamat's host waves at you with her left hand.";
	say "     Then it hits you, Galaxite, er, Olivia? You query, warily. '*He-he* In the flesh, cutie!' she says in a sensual sing-song trill while she bobs her head in the affirmative. Blinking in confusion, you hurriedly ask what's going on and how she's speaking to you. 'Oh I hacked T's Chaos and Discord app, can you believe the silly goose set her password to TheRealTiamat123?' she titters, rather proudly. And how did she do this? 'Well I'm living rent free in Tiamat's head and she sort of left a lot of her apps running in the background when she possessed me, so...' she simpers, as she playfully flexes her ear fins. 'Once I got access to her Chaos and Discord, I looked up her god mail account, tried her password, started digging through her various deus apps, like God Book, Deus Space, God Tube, and found another version of you in her contacts. From there I just had to sync my ears,' she says, giving her fins loving pat, 'with this sphere's transplaner WIFI, it turns out they make great routers. So I C.D.M'ed the other you and added you to their profile. Which took a while since this world's getting some pretty high traffic right now, not to mention setting up the two factor ID just took FOREVER!' she grumbles.";
	WaitLineBreak;
	say "     Feeling your lower right eyelids twitch in aggravation you justifiably ask if she's serious. 'Of course I am silly billy, well,' she hums guilty twiddling her fingers, 'ok I might have gotten a little sidetracked chatting on Insta-De-Vine with Anubis, but I was totally trying to reach out to you, girl scouts honor,' she titters, hurriedly tapping her left hand to her breast while briefly holding right hand up beside as if she were being sworn in at court. 'Anywho,' she continues as her once bright, bubbly tenor drops to low purposeful pitch. 'I needed to talk about Tiamat's plans.' Nodding, you motion for her to go on with a casual gesture. 'Right sssoooo I guess by now she's told you her whole plan to use me as a vessel to manifest and save us all from the nanites?' she asks sheepishly. Yes, you reply though considering all that's happened to you, you can't say you don't have some complicated feelings on the matter or a number of questions for her. Like why she didn't tell you that Tiamat was going to implant you with a shard of Kai Monah. 'Ya sorry about that hot stuff, but that was kind of a,' she hesitates as she casts a guilty glance over your shoulder, 'spur of the moment decision. Honestly, I uh, thought Tiamat had abandoned me after I failed her test, so when she offered me a second chance, I [bold type]had[roman type] to take it,' she says as her head slumps forward while her rich ebony hair cascades about her like a veil.";
	say "     Had to, you reply skeptically, noting that she doesn't seem like the heroine or megalomaniacal type and that there must be something she's not telling about her deal with Tiamat. '*Sigh*' Olivia huffs, as she straightens her neck and blows an errant lock out of her eyes. 'Ok you got me there, while saving the world and running this show does sound nice, but I did all this for... my boys. You see [Name of Player] a long time ago some of the Naxokaazthuri's ancestors used the High Cant to well,' she pauses to nipple at her lips as searches for the right word, 'devolve themselves to sever their link with T., however bonds like theirs can't be broken so easily. So when I breastfed my sweet widdle scalie angels, my nanites [']restored['] their minds and kind of, sort of, maybe, possibly, alerted T. to their presence and the existance of our world,' she peeps, mournfully. Interesting, so you take it Tiamat decided to come by and collect her wayward angels as she called then.";
	WaitLineBreak;
	say "     'Ya, well at first at least' Olivia says with a dejected click of her teeth. 'When she first appeared before me in a dream as this huge fived head dragoness. Gosh,' she swoons, as her eyes glaze over with a thin lustful fog, 'I wish you could have seen it! Her ruby body was so massive just looking at her it felt like my head was exploding and she had these adorable pink pawbs pads with gleaming ebony talons and a nice cushy ass to match! While each one of her cute heads could blot out the sun, and their scales,' she gushes with a needy pant, 'oh goddess they were so smooth and seemed to shift between red, black, blue, green, and white as spoke to me! And her voice, aw I could have sat there forever listening to her.' She rambles, thoughtlessly. In no mood to humor her though, you growl in mild annoyance then ask her to get on with her story. '*Tee-Hee* sorry about so as I was saying, she wanted to punish me for stealing her servants,' she says with a devious smirk.";
	say "     'But once she saw our world and learned about the nanites, we were able to work out a deal, of sorts,' she preens, tilting her head ever-so-slightly to the left and tucks her cheek to the palm of her hand. That she becomes Kai Monah's avatar, help her manifest, and in return become ruler of this sphere as Tiamat likes to call it? You proffer. 'Close,' Olivia tuts with a catty trill, 'she was also going to free ALL the Nazokaazthur and Ullokinne from their bonds, and not the ones on our world but every single member of their species across her whole dominion. Can you imagine that kind da mun? Trillions of big, yummy, dergs would be free from who knows many generations of servitude and they'd have little old me to thank for it!' She roars in bestial jubilation, as her gold eyes seem to gleam with a proud yet manic light. 'Not only that, but with T's protection our world would have been saved from the nasty creepy crawlies pouring into it. An just think of all the technology and resources we'd have had access to once we were a part of her dominion, and all I had to do was beat up a few yucky pee-pee monsters in the sewers.'";
	WaitLineBreak;
	say "     'At least,' she adds as her voice falls to a meek depressed octave while her ear fin's droop over upon themselves, 'that was the plan. Turns out there were things down there even T. didn't know about and when I got caught she...she... abandoned me, just like everyone else,' Olivia sniffles. 'But then,' she hums, her voice brightening once more, 'you found me and when we were playing on the beach, I got a call,' she says, pantomiming a pair of overly enthusiastic air quotes, 'from T. with a new deal.' Which is? 'That you take up Kai Monah's mantle and that I offer my body [bold type]and[roman type] boys to her so that the two of you can finish what I started. Believe me kin da mun, I begged her to give me one more shot, but in the end,' Olivia sobs, briefly clutching her left hand to head, 'I couldn't say no, not after all the things she's shown me. Think of the goddess what you may, but we're not ready to handle what's out there!' And what's out there, you question.";
	say "     'Death, madness, and horrors that make every little war we've had seem tame!' she rages. 'Through her, I've beheld worlds willingly drowned themselves in an orgy of blood as wicked Deus's of slaughter built towers of flesh, bone, and sinew from the fallen. Seen supposed paragons of order and law cut down children for telling a simple fib, and semi-sentient spheres feasting upon reality itself. But,' she cackles, 'with the goddesses['] help, we can survive! Sure we'll need to bow to her a bit but T. will leave us be once she's got what she needs. At least that's what I used to think...' Olivia says, as her once manic voice trails off to a muted conspiratorial whisper. Used to, you ask. 'Well, you've seen the way T's been treating my sweet innocent babies right?' she asks through a barely concealed reptilian growl. You nod. 'Then you can guess I'm not, [italic type]happy[roman type] about this!' Olivia hisses, her face twisting into a foul grimace. 'Sure their ancestors may have broken their word, but that's no reason to hold a grudge against my precious babies!' she huffs. So what's her she proposing then, turn on Tiamat?";
	WaitlineBreak;
	say "     'Kind of, see T's grand master plan has one tiny flaw she's not told you about, namely that there are a bunch of other gods, demons, and yappy prima donnas that have put down some pretty deep roots here,' she says with an amused twinkle in her eye. 'To dislodge them she's going to have to put all her power and attention into me and in that moment, she's going incredibly vulnerable which gives us a chance to turn the tables on her and rebuild the barrier between us and the infinite.' That sounds dangerous, and what's to stop her or any other god-like being from tearing them down again. 'Well us silly,' Olivia smirks, gesturing to herself then you with a casually flick of her left wrist, 'while Tiamat and Kai Monah are trying to pour themselves into us we'll gain access to ALL their power, and if what that hunky jackal OwObis has told me is true, if we act fast we can sever the link then force the others out, then slam the door shut behind them,' she says proudly as she loudly claps her hands before herself. Uh who's OwObis, you ask while trying not to snicker. 'Oh sorry,' Olivia blushes, touching her fingers to her lips, 'I mean Anubis, you know the guy calling himself the Kemetic god of the dead I mentioned?' You nod.";
	say "     'So a bunch of people like him and the other deus aren't the biggest fan of T., and if we to say oh I don't know,' she titters playfully bobbing her head from side-to-side, 'rob her of a good chunk of her power and expose her as a rule breaker. He thinks he can convince the other divines to leave us alone while they dogpile on T.' Blinking your many eyes in surprise, you rightfully ask her if she thinks Anubis will keep his word, and what's to stop them, or any other divine from simply attacking once they dealt with Tiamat. 'Because we'll be there to stop them [name of player]!' Olivia exclaims, jovially flexing her toned left arm before you. 'See once we've kicked the others out, there should still be a lot of god juice left over the two of us can use to keep the barrier shut. My boys can help out too since while the High Cant isn't as strong as godly magic with enough of them we should be able to keep our world sealed. But, the thing is' she adds in a warning tone, 'I-I'm not too sure this is a good idea.'";
	WaitLineBreak;
	say "     Really, she sounded rather sure of her plan? 'That's because if we do this T. won't be around to put the nanites in check, even with her and Kai Monah's power at our backs there's no telling how long it will take to put everything right, or...' she says with a dejected shake of her head, 'if we'll ever be able to get rid of all the creepy crawlies that have wormed their way into our world.' So you'd just be trading one problem for another then? 'Ya,' she sighs, 'this is a big decision, one I don't think I can make on my own. On the one hand,' she says, holding her left arm out before herself while cupping her hand into the shape of a bowl. 'If we bow down to the goddess, she'll keep us safe and put an end to the nanites once and for all, then the pair of us will be put in charge of this sphere. However, that will mean living under her rules. Sure, T. doesn't care what anyone does in their spare time, or fret over who and what they love, but still...' Olivia clicks her tongue worriedly. 'Not everyone is going to just bow down, then worship her as the new true god without a fight.' True, you rumble sagaciously at the sobering thought of how the various world religions would react to Tiamat's appearance or demands of worship.";
	say "     'On the other hand,' Olivia replies, as she repeats the gesture with her right hand. 'If we go it alone, the two of us will have to spend the rest of our immortal lives maintaining the barrier, cleaning up any leftover bugs and the ferals. Well,' she interjects in a rather cheerful tone, as lips curl into a pleased toothy grin, 'with help of my boys of course.' Assuming Tiamat can't exert her influence over them from beyond the veil, you interject. 'Ya that's the rub, T. will still hold the boy's leash and I don't know if the barrier will be strong enough to block her out for good, but that's where we stand right now [name of player]. I-I am sorry I dragged you into this, which is why I want you to be the one to make this decision. If you want to support T. or turn on her, then me and the boys will have your back either way.' She sighs, weakly as her rich bronze skin seems dim ever-so-slightly. That's a hell of a choice to just drop on your lap all of a sudden, you proffer unsure how to answer her. 'I know, but this might be our one chance to save this world from being subsumed by the nanites, the gods, or any of the horrors filling the infinite.";
	say "     Crossing your arms while you think things over, you have to admit on some level both options seem rather appealing to you in their own way. As with Tiamat's backing, you can scarcely dream of the heights you could achieve should you embrace Kai Monah's role as her immortal archangel and functional god of this sphere. Worlds would bow to your will, legions of adoring worshipers will chant yours and your flight's name, not to mention you'd free the Naxokaazthur and Ullokinne from their bondage. And all that it will cost you is a few paltry words of subservience and a little kowtowing to the goddess. Of course, you have a rare, if not one-of-a-kind opportunity to make a real difference here, though it would mean sacrificing your chance at apotheosis or something near enough and a degree of constant vigilance. You nevertheless could give this sphere along with its inhabitants a chance at true freedom from gods, demons, the various horrors of the infinite, perhaps even blunt the nanites if you're able to siphon enough power from Tiamat and Kai Monah.";
	WaitLineBreak;
	say "     You muse in contemplative silence, as you float before the ethereal image of Oliva till a low, almost mechanical hum the monster girl's strange window into your mind breaks your concentration. 'Uh look [name of player] I know this is a tough choice and you don't need to make up your mind right away. And,' she adds in a worried tone as her molten golden eyes drift down towards the bottom of her [']screen['] as the hum seems to grow louder and ever more urgent, 'I sort of have a soul unboxing live stream with Anubis that I need to get ready for, so just think on it for now,' Olivia says, as she fiddles with something off screen. Realizing this may be your last chance to speak with her before Tiamat tries to manifest, you wonder if perhaps you should try pumping her for more information. But what should you ask her about, you muse.";
	LineBreak;
	say "     [bold type]With mere moments to spare you decide to ask her?[roman type]";
	LineBreak;
	let One_more_thing_Choices be a list of text;
	add "How much longer will you be stuck here?" to One_more_thing_Choices;
	add "Is there anything she can do to help you?" to One_more_thing_Choices;
	add "Inquire about Harbinger and how shi fits into all this?" to One_more_thing_Choices;
	if intelligence of Galaxite >= 1:
		add "Does she have any thoughts on the cult your spawn are forming on Pirate island?" to One_more_thing_Choices;
	let One_more_thing_Choice be what the player chooses from One_more_thing_Choices;
	if One_more_thing_Choice is:
		-- "How much longer will you be stuck here?":
			say "    'I don't know,' she shrugs, 'but, according to hers and Kai Monah's last status update,' she hums as she turns her head and mouths something to herself, 'the two of them have been chatting on a private chaos and discord lobby for the,' she says, squints her eyes, 'last five minutes?' Wait five minutes, it feels like you've been stuck in here for ages! You rumble. 'Sorry cutie, I don't know what to say,' she replies reassuringly. 'Guess time flies differently when you're floating around inside your own hea-' she says pausing mid sentence as a button-sized icon emblazoned with the smug face of a proud black furred jackal man jeweled with golden paint upon his perky ears alongside a generous application of aurum eyeliner along his sharp azure lupine eyes winks into being beside her left ear fin. 'Oh shi- ship,' Oliva hiss as she peers down at something just below your field of view while the sound rapid mechanical keystrokes flitter out from the odd window in your mind, 'speaking of time, I've got to go, Anubis's live stream is starting now so just sit tight. T. should be along any minute now so BYE and say hi to the boys for me if you get the chance!' she simpers as the unusual [']screen['] floating before you vanishes with cartoonish pop and plunges the area back into darkness.";
			say  "     Rumbling in disbelief at all that you've heard and with nothing else to but wait, you decide to take a moment to mull over all that you've heard as sooner or later. You're going to have to make a tough call and despite the barren nature of this vaulted section of your mind, the quiet and lack of distractions at least allows you some respite from both nanites and the lingering effects of Kai Monah's influence, though you can't say why. You muse, leisurely drifting along the gloom-touched hall of your mental landscape. Lost in the deepest of thought and somewhat calmed by your brief talk with Olivia, a part of you can't help but find the once oppressive darkness and unnatural stillness of this place just a hair more manageable as you patiently wait for Tiamat to call on you once more.";
			say "[Returntoform]";
		-- "Is there anything she can do to help you?":
			say "     'Well,' Olivia hums, listlessly nodding her head from side to side, 'there is one thing I can do, since you're part Nazokaazthur now,' she says, her expression alight with looks of admiration and barely concealed jealousy as she eyes up your [bodydesc of player] curves. And what's that? 'Sssooo,' she titters whimsically, 'you remember that phrase T. uses: [']Nah se sturm slayrak[']?' You nod, then motion for her to continue. 'Well it's more than just a pile of words, it's kind of like a blessing or a-a-a, oh fiddle stickers what did the old man call it?' she rambles loudly, snapping the finger of her left hand, 'a mantra, born from the High Cant my boys['] ancestors used to empower themselves.' Interesting, but you doubt that will be of much use to you, you reply. Noting that even if you know what the words mean in English, unless you know their true meaning or [']resonate['] with them as Tiamat so unhelpfully put it, this mantra is of no use to you.";
			say "     'Oh,' she chuckles, playfully touching her left hand to her lips, 'is [bold type]that[roman type] what T. told you? Well cutie,' she preens proudly with catty flex of her ears, 'there are other ways to wield the power of the High Cant, like if you've got a nice, ripe, clutch of dragon eggs inside you,' she purrs as her hands meander to her toned midriff. 'You can borrow a little bit of their inborn wisdom like I used to, or in your case sexy, tap into all that big dragon energy inside you.' Really, that's possible? 'Of course silly, that hot bod of yours isn't just some kind of suit you can just slip and out of like most TF's. Your soul is part dragon now thanks to T., and that means deep within you is a fraction of the ancient Naxokaazthur's power and knowledge!' she exclaims in jubilation. Intrigued, you rightfully ask how you can access this then. 'Ok for starters, close your eyes and let your mind go blank.' Nodding you do as she instructs, though you find it difficult to quiet the low squall of questions and desire roiling within you.";
			WaitLineBreak;
			say "   You gradually slow your [']breathing['] and allow the stillness of this place to wash over and fill you with a sense of calm and plasticity as you float through the void. 'Good,' Oliva whispers, 'now picture that hot body of yours, feel the strength in your limbs, the bite of your talons, the potential of your womb, the suppleness of your scales, and the fire in your blood.' Rumbling in proud reptilian trill, you do as she instructs and let the image of your glorious form simmer through your inner mind's eye. 'That's it, now feel your heartbeat, follow each pulse of your blood as it flows through you and listen to the storm within...' she coos, reverently. Focusing on your pulse, you almost hear the roar of curling waves pounding inside you as you fall deeper into a trance-like state. 'That's it kin da diiv, child of dragons, let the waves of sweet mother Kai carry you, feel the rays of the luminous fathers warm you scales, hear the voices of storm as your body is meant to,' she whispers in icy reptilian voice.";
			say "     'Let their fury empower you!' she growls, her voice dipping into a deep primal octave as the subtle pounding of waves cascades over you. You unthinkingly peek open your eyes and find yourself drifting upon a glittering emerald ocean laced with velvety, ivory whitecaps while the enthralling scents of cinnamon, salt, and myrrh coil about you. Turning your gaze upward, your enhanced eyes are greeted by a cloudless lavender sky and three suns, one bone white, one cyan blue, and the third a blazing bronze orbiting overhead. Strangely though, despite their alien nature, your liminal mind can't help but bask in the comforting warmth of their light playing across your scales. Sighing peacefully, you close your eyes once more and allow the eddies of the place to carry you where it may as the various knots and tension riddling your draconic body melt away amid the gentle caress of the waves. Yet as you sink deeper into this fanciful image, you begin to hear some errant notes filter though the oceans loving sonnet.";
			WaitLineBreak;
			say "     Cold, hard, and biting, these reptilian tones seem to war with the placid sounds, yet as they wash over you, the discordance gradually gives way to a new harmony. Bending your ears to this bellicose choir, you detected a low rumble of draconic voices chanting: 'Nah se sturm slayrak! Nah se sturm slayrak! Nah se sturm slayrak! Kin! Da! Divv!' Your blood and pulse thrum in tune with them while your body brims with raw, unbridled might wanting to be released. Smirking, you can't resist flexing just taste the heavy rush of otherworldly draconic adrenaline surging through while your thick, oily lamina creaks delightfully in response. '*Tee-hee* looks like the mantra worked, eh kin da diiv?' Olivia simpers in a honeyed tone. As words playfully dance across your awareness though, your senses are drawn once more back the gloom-shrouded halls of your mind as the vision of the alien world shatter, then recede like waxing of the tides as you [']awaken['] once more in the barren vaults of your mind.";
			say "     Though initially disgruntled, you swiftly right yourself before and rumble that yes, it appears so. 'Well tha-' she says pausing mid sentence as a button-sized icon emblazoned with the smug face of a proud black furred jackal man jeweled with golden paint upon his perky ears alongside a generous application of aurum eyeliner along his sharp azure lupine eyes winks into being beside her left ear fin. 'Oh shi- ship,' Oliva hiss as she peers down at something just below your field of view while the sound rapid mechanical keystrokes flitter out from the odd window in your mind, 'speaking of time, I've got to go, Anubis's live stream is starting now so just sit tight. T. should be along any minute now so BYE and say hi to the boys for me if you get the chance!' she simpers as the unusual [']screen['] floating before you vanishes with cartoonish pop and plunges the area back into darkness.";
			say  "     Rumbling in disbelief at all that you've heard and with nothing else to but wait, you decide to take a moment to mull over all that you've heard as sooner or later. You're going to have to make a tough call and despite the barren nature of this vaulted section of your mind, the quiet and lack of distractions at least allows you some respite from both nanites and the lingering effects of Kai Monah's influence, though you can't say why. You muse, leisurely drifting along the gloom-touched hall of your mental landscape. Lost in the deepest of thought and somewhat calmed by your brief talk with Olivia, a part of you can't help but find the once oppressive darkness and unnatural stillness of this place just a hair more manageable as you patiently wait for Tiamat to call on you once more.";
			now Morale of Galaxite is 1;
			say "[Returntoform]";
		-- "Inquire about Harbinger and how shi fits into all this?":
			say "    'Oh Harby, not sure really how shi fits into T's plans,' Olivia shrugs as she throws up her hands in an exaggerated gesture of defeat. Really, she must have some kind of inkling as you doubt Tiamat altered them or hir former crew purely on a whim. 'Ok, so I might have an idea,' she says, nervously. 'See T. is made up of three ideas: Domination,' she pauses to gesture to you with a languid flick of her wrist, 'Submission,' she continues, tapping her right shoulder, 'and Servitude.' she adds, nodding towards the void behind you. 'So maybe T. needs each of us to act as some kind of stand in for each aspect of her pantheon.' But she's not sure? 'Nopers,' Olivia simpers, childishly shaking her head. Really, she's got access to Tiamat's transplaner social media, so she must be able to dig something up, not to mention there must be some deus somewhere that can help. 'Wwweeelll, your not wrong, its just, there's a LOT of stuff here and I don't want to attract too much attention. Even reaching out to Anubis was pushing it.";
			say "     'If the wrong deus found what we doing here it could complicated ma-,' she says pausing mid sentence as a button-sized icon emblazoned with the smug face of a proud black furred jackal man jeweled with golden paint upon his perky ears alongside a generous application of aurum eyeliner along his sharp azure lupine eyes winks into being beside her left ear fin. 'Oh shi- ship,' Oliva hiss as she peers down at something just below your field of view while the sound rapid mechanical keystrokes flitter out from the odd window in your mind, 'speaking of time, I've got to go, Anubis's live stream is starting now so just sit tight. T. should be along any minute now so BYE and say hi to the boys for me if you get the chance!' she simpers as the unusual [']screen['] floating before you vanishes with cartoonish pop and plunges the area back into darkness.";
			say "     Rumbling in disbelief at all that you've heard and with nothing else to but wait, you decide to take a moment to mull over all that you've heard as sooner or later. You're going to have to make a tough call and despite the barren nature of this vaulted section of your mind, the quiet and lack of distractions at least allows you some respite from both nanites and the lingering effects of Kai Monah's influence, though you can't say why. You muse, leisurely drifting along the gloom-touched hall of your mental landscape. Lost in the deepest of thought and somewhat calmed by your brief talk with Olivia, a part of you can't help but find the once oppressive darkness and unnatural stillness of this place just a hair more manageable as you patiently wait for Tiamat to call on you once more.";
			say "[Returntoform]";
		--  "Does she have any thoughts on the cult your spawn are forming on Pirate island?":
			say "     'Huh, now that's a tricky one,' Olivia hums, touching her left thumb to her lips, 'on the one hand, having a few more sexy mommy dergs like you around could be pretty useful. On the other, your kids are already leaning pretty hard towards team T., so if they had to choose between you and the goddess, well...' she rumbles as her voice peter's off into a saddened whisper. But surely as their sire, you couldn't just convince them to rally to your side should you choose to rebel, you proffer. 'I don't know kin da mun,' Olivia sighs with a soft shake of her head, 'your little one aren't like a lot of the kids born today, they've spent their whole lives, short as they are, hearing Tiamat's whispers in their heads and being inducted into her cult. Breaking them of that isn't going to be easy, unless...' Unless what, you demand, your lips peeling back into a menacing draconic scowl. 'Unless you're able to convince them your rebellion isn't heretical,' she replies sheepishly as her image nervously shuffling from side-to-side before you.";
			say "    And how in the hell are you supposed to do that! 'Uh it's not going to be easy, but if you can convince them this an act of dominance then maybe they'll follow along, or maybe show that you care about them more than Tiamat does,' Olivia says, trepidatiously. Elaborate, you growl in haughty draconic cadence. 'So, T.'s the goddess of domination, submission, and servitude, that means she draws power from these acts, and what greater act of domination is there than to yoke her and what greater show of submission can there be than for a god to bow down to a mortal?' Nodding, you tell her that makes a modicum of sense, twisted. and horribly convoluted as it maybe, but is she sure that would work. 'I dunno, they're your kids cutie,' Oliva simpers, flashing you a carefree blep. Feeling your left eyelids twitch in aggravation, you tactfully ask if there is she can think of any other way to bring your kids around. 'Maybe, but this plan might just play right into T's hand,' Oliva hums, mischievously. And what pray tell does she have in mind, you ask impatiently. 'So you remember that adorable little shark herm and hir crew, you knocked up?' she asks through a knowing well-pleased grin. Smirking at the blissful memory of you coupling, you playfully flex your altered tail behind yourself and tell her yes.";
			WaitLineBreak;
			say "     'Well,' she titters in a cheerful, yet conspiratorial tone, 'if you brought them on board. You could oh I don't know, steer your widdle social club in the right direction.' Huffing, you ask what direction that would be then and if she has thoughts on how you could win over the good captain. 'For starters, I guess you could cozy up to hir, maybe take up some extra responsibility so she starts to really rely on you. Then when shi trusts you, convince hir to take on as many blessings as you can.' Why's that? 'Because silly,' she teases, casually fanning the air before herself with her left hand, 'the more shi's bound to Kai Monah the harder it will be for hir to say no to her vessel and avatar which could make hir a powerful ally if you decide to rebel. Of course, if you can [bold type]hunt[roman type] around for my old [bold type]informant[roman type] Homaru in the [bold type]High Rise[roman type] could always dig up a bit of dirt on hir too, just use the mailbox on the [bold type]overgrown street[roman type] as a deaddrop and tell them [']Spinel['] sent you.' Clever, you chuckle and cheekily inform her you never took her for the cloak and dagger type. 'Oh what can I say kin da mun, I'm full of surprises,' she preens, languidly running her finger through her silky raven black hair.";
			say "     'Still there is one other thing you could try though, it might take a while, but it could be fun!' she hums, coyly. 'See unlike other vessels, you've got nanites that are still active, so with enough exposure you could slowly convert your cultists into dragons, who would be super loyal to you. Of course,' she adds with an air of severity, 'you'll need to give them a reason to stick by you if you decide to make a play.' Nodding, you ask if she has any further suggestions. 'Hmm,' Oliva rumbles through pursed lips, 'Just one, you'll need to walk a fine line between indulging your cultists and projecting the image of a big stern dommy dragon mommy. These people think they're serving a goddess, so you'll need to provide just enough to keep them comfortable, but not enough that they get lazy or start to walk all over you.' That sounds doable, you confidently rumble.";
			WaitLineBreak;
			say "     'Ha-ha, I thought you might say that [name of player], now there's one last thing. Don't tell any of this to T.'s pet, hir and the other Seradovah are firmly on the goddesses side an-,' she says pausing mid sentence as a button-sized icon emblazoned with the smug face of a proud black furred jackal man jeweled with golden paint upon his perky ears alongside a generous application of aurum eyeliner along his sharp azure lupine eyes winks into being beside her left ear fin. 'Oh shi- ship,' Oliva hiss as she peers down at something just below your field of view while the sound rapid mechanical keystrokes flitter out from the odd window in your mind, 'speaking of time, I've got to go, Anubis's live stream is starting now so just sit tight. T. should be along any minute now so BYE and say hi to the boys for me if you get the chance!' she simpers as the unusual [']screen['] floating before you vanishes with cartoonish pop and plunges the area back into darkness.";
			say  "     Rumbling in disbelief at all that you've heard and with nothing else to but wait, you decide to take a moment to mull over all that you've heard as sooner or later. You're going to have to make a tough call and despite the barren nature of this vaulted section of your mind, the quiet and lack of distractions at least allows you some respite from both nanites and the lingering effects of Kai Monah's influence, though you can't say why. You muse, leisurely drifting along the gloom-touched hall of your mental landscape. Lost in the deepest of thought and somewhat calmed by your brief talk with Olivia, a part of you can't help but find the once oppressive darkness and unnatural stillness of this place just a hair more manageable as you patiently wait for Tiamat to call on you once more.";
			now Affection of Homaru is 1;
			say "[Returntoform]";

to say Returntoform:
	say "     [italic type]An indeterminate amount of time later[roman type], your temperance is eventually rewarded as you float aimlessly upon your back through your inner world and spot a single sliver of soft silvery-white light twinkling overhead like a pregnant moon. Spirits buoyed, you swiftly right yourself then hurl yourself towards the paltry pinprick of waxing luminescence with a proud, defiant roar and mighty flap of your nascent wing. Surging forth, the distances between you and this perceived exit shrinks by the second you can almost taste the coiling scents of clean ocean air flickering about the edges of your muzzle while the gentle lapping of ambient waves serenades your ears. Soaring onward and upward, you watch almost spellbound as the aperture seems to widen as you approach while ambient light of the outside world rains down upon you. Till at last, you slam, claws first into the rent in the fabric of your mind with an odd plasticized thud against the simmering portal.";
	say "    Strangely though, despite the lingering sense of collision rippling through your resplendent form, your tauric body never seems to come to a full stop. As you feel as if your very being were stretched out like a too-taut rubber band as your talons sink ever-so-slowly into the thin membrane separating you, from the real world. Despite this low tension rippling through you as if your innards were caught in a wild undertow, you push onward, howling your defiance to the void as you feel your scything talons pierce through the veil. In that instant, your vision cracks as if you were barreling down a fractured kaleidoscope as the soft white glow of the outside splits and fragments in verdant ballet of many colors and none while the lingering gloom swirls about you and impossible hues whorl before your many eyes. Your roar distorts, echoes, and loops back in on itself in a chittering knell as you burst through the other side and find yourself standing before the beaming face of Olivia... No, Tiamat, you correct yourself, as the otherworldly pressure of the goddess presence constricts itself about your brow and the supple squirming touch of Kai Monah slinks back into the recesses of your mind.";
	WaitLineBreak;
	say "     Still, something feels different about this fragment of Kai Monah, you muse as the fraying halls of your mind groans with her laborious passage, and as your psyche briefly touches hers. You sense a certain air of... weariness and trepidation rippling through her ethereal form as she nestles herself deep with vaulted sections of your mind. Though before you can even begin to prod the presence for answers, a light throat clearing cough coming from Tiamat's host draws you attention back to her. 'Rem kol Kai, kin da mun,' she hums with a respectful nod of her head. 'Apologies for the... inconvenience my champion, but my sister's voyage through the waters of the infinite was not an easy one to make in secret.' Cocking a scalie eyebrow, you ask her what she means. 'As we speak, the thin walls separating this sphere continue to crumble and as they do, predatory beings of the eternal ocean are being drawn to the scent of fresh prey, while the hungering, opportunistic eyes of my kin turn towards us,' she purrs, as her velvety voice coils about your senses like a tempting serpent on a vine."; [Cyn stuff goes here.]
	say "     'Amidst this splendid chaos, my scale sister's soul was a prime feast for lesser horrors and target for my enemies. As such, a subtle, yet strong hand was needed to guide her to you. Regretably,' she sighs with an almost-human note of sorrow creeping through her host's words, 'though I was successful in channeling more of her into you. The sundering and the further blending of her soul with your own under these circumstances, was a most... difficult task. For now, she must rest and recover in the safety of your mind. Still, you have more than earned your reward, VIX-VELL!' She shouts, sweeping her host's left hand towards the rows of shipping crates in a broad commanding gesture; while the wind simmering through the isolated section of the coast howls in reply to the goddesses's commands. As you watch a razor thin wall of overpressure billows across the dunes, kicking up a squall of vermillion dust and sunny yellow silt in its wake as it cuts into the containers with a frightful, metal rending knell, ripping deep thumb-size gashes through their latched doors."; [wind open]
	WaitLineBreak;
	say "     At once, water laced with rust and moldering plastic spews from the black crates as the doors burst open, spilling tainted medical waste upon the off-yellow sands. While a muted hiss peters from the cuts in the red crates as their door gently swings open, though their contents remain shrouded in shadow. Rightfully intrigued, you paw up to black crates first and swiftly turn your head up in revulsion at the acrid scent of aquatic rot, spoiled chems, and useless medical equipment assailing your senses. Still, a thrifty section of your psyche advises that it might yet be worth a look as your many eyes drift over ruined husks of innumerable gurneys strewn about the area. Especially considering all the effort you put into securing these, you muse, picking through the remains of the dilapidated medical paraphernalia. Besides, who knows, you might find a sample of this Revert All, as the goddess's meat puppet called it, that might make a nice addition to your personal hoard. Much to your chagrin though, none of which seems to be salvageable, or of much use to you, you think to yourself, prowling from crate-to-crate as you roughly pick through the tattered supplies. Though at times, the odd shape and builds of some of the larger gurneys arouses a fleeting flicker of curiosity in you as you observe a number of plastic blisters attached to their metallic superstructures or the excessive number of restraints on others.";
	say "     Your loot-focused psyche pays them little mind as you turn your attention to the red shipping containers instead. Pawing up to the nearest one, you flare your enhanced chromatophores, bathing the area in muted hollow white light, revealing a cornucopia of what you assume are supplies nestled in row-upon-row of cardboard boxes all the way to the ceiling. Intrigued, you rear back your talons and slice into several of them at random, then peel back the thin packaging to uncover a trove of prepackaged M.R.E's, sugary snacks, hygienic wipes, and even a few packs of cigarettes. Moving down the line of shipping containers, you repeat this process several more times, while making a few mental notes when you come across a particularly scrumptious looking morsals. All the while though, you keep your many eyes peeled from some sign of the [']Revert All['] the mind-flayed mink mentioned tucked away amidst the spoils.";
	WaitLineBreak;
	say "     Despite your best efforts, your search comes up empty, yet you remain undeterred as you prowl through the crates till you come across a container filled with a collection of assorted armaments stowed within green-brown camo-patterned mesh lockers affixed to the walls. Enthused, you carefully paw up to the nearest locker, filled to the brim with sleek jet black ergonomic rifles of an unknown make and caliber. Though far too small for a being of your regal stature, you still just merely manage to wrap your hand about the grip as you gingerly extract the gun and begin inspecting it. Much to your surprise though, as you peer over its slender barrel and glossy housing, you find neither hide nor hair of magazine port, ejector, or any easily recognizable marks to help you identify it. Then it hits you, this isn't some common gun, this is a P.H.A.S.R (Personnel Halting And Stimulation Response Rifle)! You muse, as the faint memory of this questionably legal weapon's brief time in the headlines tugs at the back of your mind.";
	say "     Though your recollection is a tad fuzzy, you vaguely recall these were designed as crowd control weapons which utilized specially directed photons to disorient and disperse rioters, but they were never put into use for fear they violate international law, or cause permanent blindness. Against the infected though, these might prove to be a useful tools for non-violent pacification, you muse, placing the P.H.A.S.R back into its housing then continue down the line as peruse the selection of similar exotic riles arrayed in an orderly row. Nearing the midsection of the crate, the molten glow of your many eyes soon washes over another set of large, rather heavy looking shotguns reminiscent of a boxy oversized drum-fed AA-12 shotgun tucked away. Pulling it out, you're relatively unsurprised to find much in the order of the P.H.A.S.Rs, this weapon appears to also be another experimental energy weapon, of sorts. You ruminate, as you turn the thing over in your paws, noting how the muzzle has been replaced with a crude radar dish. Its magazine drum too appears to swapped out for a stripped down subwoofer-shaped block of homogeneous metal with thick, black heavy watt wire coiling running haphazardly affix to its sides and down along the length of the barrel leading you to believed this must be the device's power source.";
	WaitLineBreak;
	say "     Chuffed, you casually shoulder the none-too-light shotty and find despite its respectable weight, the thing fits rather snuggly in your grasp. Though as you run your paws along its angular, spartan composite housing, you detect a small engraving etched into the handle reading: [italic type]Mk.I Microwave Amplification Device[roman type]. Huh microwaves eh, this could come in handy against the infected, you mutter under your breath as put the weapon back into its holster. As for all their chaotic and profoundly mutable nature, at their core the nanites are still machines at the end of the day. Perhaps with this, you could potentially stun or disrupt the nanites of a given feral, though for how long, you can't be certain, you think to yourself as you delve deeper into the rearmost section of the crate. Here, you spy a number of black latex-like suits with bright yellow accents running along their contours, slip boots, combat helmets of varying sizes. Alongside a myriad of smattering of pre-packaged survivalist gear like foldout backpack mounted solar panels, and power bricks sequestered into neat tidy rows.";
	say "     Selecting one of the largest sets of protective equipment, you spend a moment modeling your latest find against your impressive body, and while you have little desire to cover up your draconic splendor. A part of you still notes the black and yellow paneled bodygloves would make a nice fit, what's more, the material seems rather tough too as you roughly hook your claws into, and tug. Yet, for all your draconic strength, and preternatural sharpness of your gleaming ivory talons, the unusual material does little more than stretch. Another time, you might have been impressed with this feat, but for all the utility such suits would confer. You know a far greater treasure is hidden away somewhere with this container and while this Revert All would of little use to you. Such an impossibly valuable find could make fine treasure or bartering chip in the future, you ruminate as kneel and begin carefully sifting through the remaining loot, to little avail.";
	WaitLineBreak;
	say "     While the minutes begin to drag on, your search grows all-the-more frantic as you violently upend on a number of lockers as you search, scattering a number of supplies and equipment about the immediate area. Amidst the mess though, your motley collection of molten abyssal eyes can't help but notice an odd silvery metallic square protrusion on the bottom of one of the overturned lockers. Curious, you cup your paws along its edges and pull, though it resists you for but the briefest of instances, the thing quickly pops loose with but the modicum of effort. Turning it over in your palms while you blare your bioluminescent lamina, you find this laptop sized briefcase is composed of single homogeneous piece metal with a small-by-tauric standards handle. Lacking any obvious means to open it though, you resort to a more... kinetic solution as you glide your claws along the cases edges, delighting internally at the pleasant little knell of the material as your scything blades pierce its shell with contemptible ease.";
	say "    Your enhanced hearing picks up the delicate hiss escapes the case as it suddenly parts upon some unseen set of hinges in your mitts with muted well-oiled swish while the two halves collide with a loud metallic *tink* and several small silvery aerosol cans no larger than a travel-sized tube of toothpaste fall out of the lower section and are sent tumbling about the entrance. Annoyed, you hurriedly leap upon them before they can get lost in the mess, though you're able grab a couple, one manages to roll beneath towards the door. Swiveling about, you make ready to chase after, only stop in your tracks as you spy the well-pleased grin of the goddess as she leans down, casually extends her host's left hand before herself and lets the silvery canister leisurely roll into her outstretched palm. 'Careful champion,' she tuts, clenching her mitts about the tiny tube of metal as she rises, 'small though they may be, these vessels have an important role to play in the next phase of my plan.'";
	WaitLineBreak;
	say "     Chuffing as your covetous eyes drift along the cylindrical curves of the canister, you inquire how exactly this cure could help her. 'I have no need for these champion, yet many among your former kind would pay quite dearly for these. A fact I intend to take full advantage of as despite the dangers facing your world, Yor are eternally driven by their foolish materialistic desires. Short sighted as they are,' she rumbles, idly turning the metallic tub over in her hand as if inspecting, 'their thoughtless greed affords us with a rare opportunity to barter these petty baubles for insights into their little [']blacksite['] as your kind calls it. Far reaching as my sight may be champion,' she crows, as her host's molten eyes gleam against the soft of the shipping crate, 'were I peer too deeply into this sphere it would invite attention I can ill afford. Yet, through these worthless specks of mortal artifice I gain the insights I need to properly yoke the beasts slumbering with the high rise. Of course my champion,' she adds with a bright almost cheerful trill, 'you may avail yourself of a few as well, though I doubt you will need them on the road ahead. Items such as these can prove to be must valuable tool for you, so feel free to a half dozen for your own purposes.'";
	say "     'But take care my beloved wyrm, the little mink warning was not spoken in jest,' she cautions, lightly tapping her host's pearly nails against the bright chrome surface of the gas cylinder. 'Use them sparingly, lest the crude toxins within these vessels overwhelm you. Then again,' she rumbles, casting her gaze towards the wider city, 'there may be others within this cursed place who would be willing to risk this devil's bargain. The choice is yours kin da mum, but for now, [italic type]would you kindly[roman type] hand me that case?' she hums, with a come hither wave of her host's hand. Though part of you wants to balk at her request or perhaps barter for more of the beyond valuable trinkets, the rational cold-blooded section of your psyche cautions against this, as for all their supposed value, you doubt that there are beings within the city who could ever hope to afford purchasing these canisters from you. Besides, in time, mortal money will have little use to you, better to play along for now till you decide whether to offer this world to the goddess, or claim it for yourself. You ruminate, gingerly shut the case, and stride towards her, rumbling, Ol faal hen klovve uth, as you kneel before her.";
	WaitLineBreak;
	say "     'Well spoken my [italic type]willful[roman type] champion,' she simpers, her host's voice hissing and crackling with a quintet of ophidian trills as she boldly plucks the case from your outstretched mitts. Tiamat leisurely sets the case against the crook of her forearm with her free hand, pulls out three more of the unmarked canister then presents them to you. 'For your continued service and loyalty,' she says, clenching the container tightly in her hands as she holds them over your head. Nodding, you place your paws out before yourself in a bowl and promise to be careful with these. 'See that you do champion,' she preens, pressing her smooth scaleless hands against yours as she deposits four canisters into your palms. 'As for the rest of this plunder,' she rumbles while bidding you to rise with a haughty nod of her host's head. 'Take what you will, they are of little use to me, but shall make excellent fodder of the Seradovah.'";
	say "     Rumbling in the affirmative, you lightly clasp your paws about the proffered prizes and rise to your full regal height. 'Very good, fare thee well my champion,' Tiamat hums, tucking the now quarter empty case under her host's arm. 'For I must depart and ferry these baubles to Homaru of The High District and the dear Major Padgett,' she says lightly drumming her host's finger against the metallic briefcase. 'When all is made ready, the Ullokinne will come to collect you at your little bunker. So, enjoy your spoils in peace, and know the Seradovah will remain on site to insure you're undisturbed,' she simpers pleasantly as she turns on the balls of her feet and commandingly struts back out towards the isolated sandbar. As she slips past the entrance of the shipping crate, you can hear several of the aberrant naga break from their nigh on mechanical patrol along the surf and fall into lock step with their mistress while they dip beneath the waves.";
	WaitLineBreak;
	say "     With them gone, you turn your attention back towards your haul and begin formulating a plan to safely transport your just rewards. No easy task, you opine, as your gaze drifts towards deer trails then down to your nascent wings. Perhaps the Seradovah could help? You ruminate, then think better of it as you recall the mindwiped mutants will only respond to someone like Harbinger. Instead, you turn your abyssal gaze towards the various bodygloves stored nearby, and reasons that durable material must surely be waterproof. You pluck another of the larger suits from their respective rack swift tie off there various limb and head holes, so they can serve as water tight bags for the trip back. Well, in theory at least, you muse offhandedly as you start packing a pair of P.H.A.S.E.R's, M.A.D guns, boots, and helmets away, push out any extra air, then cinch them tight. Afterwards, you grab a few sets of the smaller suits, though you doubt that you'll have much use for these, yet your inner collector can't pass up the chance to add a few of these unusual finds to your private hoard.";
	say "     Who knows, you might find a use for them one day, or perhaps someone willing to trade for them, you think to yourself, [']bags[']' in hand as you prowl back towards the other red supply crates then set to work sorting the various goods and sundries left behind. Rather spoiled for choice, you elect to gather only the most appealing flavors of MRE's along with a few that pique your interest, and of course a paw full of medkits. After your last encounter with the bats and squids, you can't shake the feeling that it might be a good idea to stock up for the road ahead. You think to yourself as you array your haul along the shore partially deflate and tie off each of your impromptu bags as tightly as you can. Once you're done, you wisely use the remaining slack to link them together then silently slip into the wave's cool embrace. Though, after you last encounter with the horrid fragment of Tiamat nestled in the core of the Serdovah, you decide keep your head just above the water line lest you tempt fate with your eldritch sight.";
	WaitLineBreak;
	say "     Carefully sailing through the glittering azure surf with the long train of goods trailing behind, you can't help but notice the eyes of the Seradovah following you as several of the number break and observe your departure with the same blank reptilian expression you've come to expect from them. Another time you might have given the behavior and intent a moment's thought, yet you mentally write off this minor aberration as a mere quirk of Tiamat's orders. You muse, paddling your way towards The End of the Beach and selecting a somewhat sheltered section of rock, you carefully prowl out of the depths, mindful not to snag the conga line of supplies trailing behind as you return to dry land. You begin expertly pulling your plunder from the depths and realize you might have taken a bit too much with you. Bereft of the added buoyancy conferred by the open water, the sheer bulk and weight of your duly earned trinkets would make transporting them a rather difficult task, even for a mighty wyrm of your stature.";
	say "     Perhaps, you ruminate, it might be best to simply store a few things and slowly ferry them back to the perceived safety of the bunker at your leisure. Then again, this place seems remote enough, so it might be easier to simply cache what you can here, for now. What's more, having a few emergency stashes about the city could come in handy in the highly unlikely event the bunker becomes compromised, or should you ever find yourself here in dire need of a resupply. You think to yourself, eying up your plunder and begin making up your mind what you should leave behind and what to take with you.";
	LineBreak;
	say "     [bold type]Author's note: Dragon Raider Galaxite ends here, for now.[roman type]";
	now Just rewards is resolved;
	ItemGain Food by 10;
	ItemGain Water Bottle by 10;
	ItemGain Medkit by 10;
	ItemGain Soda by 10;
	ItemGain Chips by 10;
	ItemGain Revert All by 6;
	ItemGain Black Ops Helmet by 2;
	ItemGain Mini Helmet by 2;
	ItemGain Advanced Tactical Helmet by 2;
	ItemGain Hazmat Body Glove by 2;
	ItemGain Oversized Bodyglove by 2;
	ItemGain Flex Boots by 2;
	ItemGain Beastly Boots by 2;
	ItemGain PHASR by 2;
	ItemGain MAD Gun by 2;
	now Energy of Galaxite is 4;
	if Morale of Galaxite is 1:
		increase XP of Player by 250;




Table of Game Objects (continued)
name	desc	weight	object
"Black Ops Helmet"	"An anachronism of technology, this Gen. II Black Ops Helmet borrows the flared metal rim of the old WWII Stahlhelm used by Germany, meant to protect against shrapnel and fragmentation grenades. Alongside a distinct chainmail coif wrapped in a hydrophobic mesh that is designed to cover the neck and spine. While the helmet does have tactical rails, this particular specimen lacks any accessories."	3	Black Ops Helmet 

Black Ops Helmet is a grab object.
Black Ops Helmet is equipment.
It is not temporary.
Plural of Black Ops Helmet is false.
Taur-compatible of Black Ops Helmet is true.
Size of Black Ops Helmet is 3.
AC of Black Ops Helmet is 50.
Effectiveness of Black Ops Helmet is 75.
GA of Black Ops Helmet is 0.
Traits of Black Ops Helmet is {"authoritive"}.
Placement of Black Ops Helmet is "head".
Descmod of Black Ops Helmet is "A solid black unadorned Black Ops Helmet it rests atop your head.".
Slot of Black Ops Helmet is "head".
Scent of Black Ops Helmet is "This helmet smells clean and sterile like a hospital".


 Table of Game Objects (continued)
name	desc	weight	object
"Mini Helmet"	"A miniaturized version of the Tactical Helmet you and Galaxite found. This strange anachronism of technology, this Gen. II Tactical Helmet borrows the flared metal rim of the old WWII Stahlhelm used by Germany, meant to protect against shrapnel and fragmentation grenades. Alongside a distinct chainmail coif wrapped in hydrophobic mesh that is designed to cover the neck and spine. Due to its compact build, this helmet does not have tactical rails or mesh necessary to mount any accessories. Still, its size and low weight would make it very useful for a smaller infected person who may be limited in their defensive options."	1	Mini Helmet 

Mini Helmet is a grab object.
Mini Helmet is equipment.
It is not temporary.
Plural of Mini Helmet is false.
Taur-compatible of Mini Helmet is true.
Size of Mini Helmet is 1.
AC of Mini Helmet is 50.
Effectiveness of Mini Helmet is 75.
GA of Mini Helmet is 0.
Traits of Mini Helmet is {"authoritive"}.
Placement of Mini Helmet is "head".
Descmod of Mini Helmet is "A solid black Mini Helmet rests atop your head.".
Slot of Mini Helmet is "head".
Scent of Mini Helmet is "This helmet smells clean and sterile like a hospital".

Table of Game Objects (continued)
name	desc	weight	object
"Advanced Tactical Helmet"	"A clear divergence from the human norm in terms of design, this tactical helmet appears to have been made to only be worn by the largest horniest infected person. For whatever reason it was built this way though you can't be sure, however that does not diminish its effectiveness. As the unusual piece of post-nanite engineering features not just robust flared metal rim, chainmail neck guard, but fully integrated latex-esque gas mask with a side mounted filter, and light up red NVG goggles. Interestingly, the plasticized mask portion is incredibly malleable allowing it to fit comfortably over the largest muzzle or beak an infected individual could possess without compromising their ability to talk or breath. Thanks to some clever engineering, this gasmask can also be removed or pulled down in the event the user desires to expose their face."	5	Advanced Tactical Helmet

Advanced Tactical Helmet is a grab object.
Advanced Tactical Helmet is equipment.
It is not temporary.
Plural of Advanced Tactical Helmet is false.
Taur-compatible of Advanced Tactical Helmet is true.
Size of Advanced Tactical Helmet is 5.
AC of Advanced Tactical Helmet is 75.
Effectiveness of Advanced Tactical Helmet is 90.
GA of Advanced Tactical Helmet is 0.
Traits of Advanced Tactical Helmet is {"authoritive"}.
Placement of Advanced Tactical Helmet is "head".
Descmod of Advanced Tactical Helmet is "An oversized Tactical Helmet with an integrated fold down gasmask and red lensed night vision goggles rests comfortably on your head.".
Slot of Advanced Tactical Helmet is "head".
Scent of Advanced Tactical Helmet is "The Advanced Tactical Helmet smells like a new car fresh off the lot.".



Table of Game Objects (continued)
name	desc	weight	object
"Hazmat Body Glove"	"A shiny jet black Hazmat Body Glove with yellow paneling on the chest, forearms, and glutes. While not as protective as most conventional [']soft['] body armors, this Body Glove appears to have minor non-newtonian properties allowing it to absorb and disperse small amounts of kinetic damage. Additionally, this Hazmat Body Glove appears to not only be insulated, but a very high level of thermal resistance allowing the wearer to function in almost any environment without fear of overheating or freezing. In practice though, this piece was meant to be worn under actual armor, so effectiveness as mainline protection is questionable at best despite its robust coverage."	3	Hazmat Body Glove


Hazmat Body Glove is a grab object.
Hazmat Body Glove is equipment.
It is not temporary.
Plural of Hazmat Body Glove is false.
Taur-compatible of Hazmat Body Glove is true.
Size of Hazmat Body Glove is 0.
AC of Hazmat Body Glove is 25.
Effectiveness of Hazmat Body Glove is 100.
GA of Hazmat Body Glove is 1.
Traits of Hazmat Body Glove is {"authorative"}.
Placement of Hazmat Body Glove is "waist".
Descmod of Hazmat Body Glove is "A Hazmat Body Glove covers your body with shiny latex analogous material.".
Slot of Hazmat Body Glove is "legs".
Scent of Hazmat Body Glove is "The Hazmat Body Glove smells like sterile latex and ozone".



Table of Game Objects (continued)
name	desc	weight	object
"Oversized Bodyglove"	"A Oversized shiny jet black Hazmat Body Glove with yellow paneling on the chest, forearms, and glutes. While not as protective as most conventional [']soft['] body armors, this Body Glove appears to have minor non-newtonian properties allowing it to absorb and disperse small amounts of kinetic damage. This Hazmat Body Glove appears to not only be insulated, it also boasts high levels of thermal resistance allowing the wearer to function in almost any environment without fear of overheating or freezing. In practice though, this piece was meant to be worn under actual armor, so effectiveness as mainline protection is questionable at best despite its robust coverage."	5	Oversized Bodyglove


Oversized Bodyglove is a grab object.
Oversized Bodyglove is equipment.
It is not temporary.
Plural of Oversized Bodyglove is false.
Taur-compatible of Oversized Bodyglove is true.
Size of Oversized Bodyglove is 5.
AC of Oversized Bodyglove is 25.
Effectiveness of Oversized Bodyglove is 100.
GA of Oversized Bodyglove is 1.
Traits of Oversized Bodyglove is {"authorative"}.
Placement of Oversized Bodyglove is "Waist".
Descmod of Oversized Bodyglove is "A Hazmat Body Glove covers your body with shiny latex analogous material.".
Slot of Oversized Bodyglove is "legs".
Scent of Oversized Bodyglove is "The Oversized Bodyglove smells like sterile latex and ozone".

Table of Game Objects (continued)
name	desc	weight	object
"Flex Boots"	"A pair of ebony Flex Boots with yellow soles meant to be worn over the Hazmat Body glove, more akin to a padded pair of over socks than actual boots. These Flex Boots, though nowhere as tough as true combat boots still offer a modicum of protection against the odd stubbed toe. Due to their unique stretchy form fitting design, they can be worn by all manner of infected by they mircos or normal sized individuals regardless of if they have feet, paws, or bird-like claws. These boots accept all comers and show your unique podology quite nicely."	1	Flex Boots

Flex Boots is a grab object.
Flex Boots is equipment.
It is not temporary.
Plural of Flex Boots is true.
Taur-compatible of Flex Boots is true.
Size of Flex Boots is 0.
AC of Flex Boots is 5.
Effectiveness of Flex Boots is 100.
GA of Flex Boots is 1.
Traits of Flex Boots is {"authorative"}.
Placement of Flex Boots is "body".
Descmod of Flex Boots is "You are wearing a pair of form fitting Flex Boots.".
Slot of Flex Boots is "feet".
Scent of Flex Boots is "The boots smell like a clean room.".

Table of Game Objects (continued)
name	desc	weight	object
"Beastly Boots"	"An exceptionally large pair of ebony Flex Boots with yellow soles meant to be worn over the Hazmat Body glove, more akin to a padded pair of over socks than actual boots. These Flex Boots, though nowhere as tough as true combat boots, have a unique form fitting design that is tailor made for larger infected persons. Interestingly, they seem to be built to be worn by individuals with paws or bird-like claws rather than flat feet. These boots also sport an exotic form of sole meant to enhance the grip of animalist paws."	1	Beastly Boots

Beastly Boots is a grab object.
Beastly Boots is equipment.
It is not temporary.
Plural of Beastly Boots is true.
Taur-compatible of Beastly Boots is true.
Size of Beastly Boots is 5.
AC of Beastly Boots is 5.
Effectiveness of Beastly Boots is 100.
GA of Beastly Boots is 1.
Traits of Beastly Boots is {"authorative"}.
Placement of Beastly Boots is "body".
Descmod of Beastly Boots is "You are wearing a pair of form fitting Beastly Boots.".
Slot of Flex Boots is "feet".
Scent of Flex Boots is "The boots smell like a clean room.".

Table of Game Objects (continued)
name	desc	weight	object
"PHASR"	"A technically illegal directed energy weapon developed as a form of non-lethal crowd control device meant to blind or dazzle hostile individuals. The PHASR looks like it stepped out of some popular Sci-fi movie or video game. The full sized rifle has a shapely ergonomic stock with flowing a sleek black barrel with gray accents that looks like it was grown or poured rather than forged. An absolutely unnecessary muzzle break runs the length of the barrel that seems to serve no other purpose other than to look cool. While a red white and blue toggle has been installed below the sight allowing the end user to adjust beam strength and spread on the fly."	12	PHASR

PHASR is an armament. It is not temporary.
It has a weapon "[one of]your compliance regulator[or]your weaponized laser pointer[or]your hypno ray[at random]".
Weapon Damage of PHASR is 22.
Weapon Type of PHASR is "Ranged".
Objsize of PHASR is 3.
Hitbonus of PHASR is 3.
Scent of PHASR is "The PHASR smells like war crimes, freedom, and apple pie."

Table of Game Objects (continued)
name	desc	weight	object
"MAD Gun"	"The Mk.I Microwave Amplification Device or MAD gun is a hastily constructed anti-infected rifle resembling a drumfed AA-12 shotgun chassis covered in exposed heavy watt wires affixed to with a naked subwoofer. While a crude radar dish-like construct has been affixed, to the devices muzzle with a number of ugly, unpainted spot welds. Created by some unknown party to aid in the pacification and suppression of mutants. The MAD gun fires a high energy narrow band bolt of Microwaves emissions, that are able to [']stun['] or knockout infected by disabling their body's nanties thus impeding their cellular function, albeit for a short time. Eventually unless constantly exposed to a fresh burst of Microwaves, the target's emic nanites will eventually recover thus allowing them to restart higher functions. Despite this somewhat brute force method of pacification, compared to other violent methods of infected suppression. The MAD gun offers a highly ethical and gentle alternative to the usual forms of cruel base violence most survivors employ in defending themselves. Unfortunately, the weapon is heavy as sin, so few can wield it."	35	MAD Gun

MAD Gun is an armament. It is not temporary.
It has a weapon "[one of]your pacification ray[or]your peacemaker[or]your anti-mutant blaster[at random]".
Weapon Damage of MAD Gun is 32.
Weapon Type of MAD Gun is "Ranged".
Objsize of MAD Gun is 5.
Hitbonus of MAD Gun is -3.
Scent of MAD Gun is "The MAD Gun smells like warm copper."

Table of Game Objects (continued)
name	desc	weight	object
"Revert All"	"An unlabeled metal aerosol spray can containing a potent dose of anti-mutagens that should, in theory, be able to turn just about any former hominid back into a vanilla human. Unfortunately, the gas does not reverse the mental damage brought on by nanite induced transformations, nor does work on ferals who were born non-humans. Regardless, this rare find would likely be prized in the wider world by those wishing to try out new forms, and invaluable to those in the city who desire to become human again."	1	Revert all

the scent of Revert All is "The canister smells bland and metallic with a hint of old brine."

Revert All is a grab object.
Usedesc of Revert All is "[RevertAlluse]";

to say RevertAlluse:
	if Depravity of Galaxite <= 3:
		say "     Cracking the seal on the can of Revert All, you spray yourself in a thick layer of foul smelling clear gas. At once, your body starts to burn and writhe before your eyes as your infection seems to crumble away to grey, metallic dust and fall as your body returns to its previous charmingly human configurations. Although, a part of you is already starting to miss your prior form, you're probably better off this way as the world isn't made for mutants after all.";
		Humanify_Player;
		increase Depravity of Galaxite by 1;
	else if Depravity of Galaxite >= 4 and Depravity of Galaxite <= 5:
		say "     Breaking the seal on another can of Revert All, you spray yourself in a thick layer of foul smelling clear gas. At once, your body starts to burn and writhe before your eyes as your infection while visible veins seem blare with a harsh amethyst light as your most recent addition crumbles away to grey, metallic dust and falls as your body slowly, violently twists back into its previous charmingly human configurations. Unable to stand the harsh violation of your body's tainted anatomy, you soon fall to your knees with a pained, pathetic whimper, gasping for breath that will not come. As the visceral agony of your flesh rebelling against the imposed rapid rehumanization of your [bodydesc of player] being washes over you while the lingering powder clinging to your body pours off of you in a glittering silvery sheen of deadened nanites. Though the pain soon passes, your tortured, now fully human form still throbs from the experience.";
		Humanify_Player;
		PlayerWounded 100;
		increase Depravity of Galaxite by 1;
	else if Depravity of Galaxite >= 6 and Depravity of Galaxite <= 7:
		say "     Bracing yourself, you crack yet another seal on your dwindling supply of Revert All, and hastily you spray yourself in a thick layer of foul smelling clear gas. Gritting your teeth, your body starts to wriggle and convulse before your eyes as your infection tissue bubbles away in a foul smelling cloud of grey, metallic dust while your body flows once more into the charmingly human configurations you long for. Strangely though, watching your body settle, the prior pain you expected never comes as an odd numbness fills both your mind and muscles while you brush off a few errant clumps of silvery condensation clinging to your person. Perhaps your last pseudo-allergic reactions were just flooks, you muse, though a part of you still can't shake the something still seems... off. As your fully human body feels heavier than you remember it while thoughts are just hair cloudy as if they were being filtered through old cheese. It's probably nerve, you murmur under your breath, tossing the bottle aside.";
		Humanify_Player;
		if Dexterity of Player >= 13:
			StatChange "Dexterity" by -3;
		if Strength of Player >= 13:
			StatChange "Strength" by -3;
		if Stamina of Player >= 13:
			StatChange "Stamina" by -3;
		if Intelligence of Player >= 12:
			StatChange "Intelligence" by -3;
		if Charisma of Player >= 13:
			StatChange "Charisma" by -3;
		increase Depravity of Galaxite by 1;
	else if Depravity of Galaxite >= 8 and Depravity of Galaxite <= 9:
		say "     Reaching for one of the few remaining cans of Revert All, you boldly pierce the thin metal seal of the precious substance and douse yourself in generous sheen of the queer smelling gas. You watch with a dull, blissful grin on your face as your tainted hide turns a rubbery black and slowly sloths off you like old grease, revealing your charming human body. Smirking at the sight, you do quick playful and careful twirl, as you examine your restored self, delighting internally at once more beating back the nanites['] hold as you return to perfectly human form.";
		if  "Gas Cloud" is listed in Feats of Player:
			FeatLoss "Gas Cloud";
		else if "Resistant" is listed in Feats of Player:
			FeatLoss "Resistant";
		else if "Bestial Power" is listed in Feats of Player:
			FeatLoss "Bestial Power";
		else if "Mighty Mutation" is listed in Feats of Player:
			FeatLoss "Mighty Mutation";
		increase Depravity of Galaxite by 1;
	else if Depravity of Galaxite is 10:
		say "     Nearing the end of your Revert All reserves, you confidently take one of the few precious remaining cylinders from your inventory, and confidently level the thing with the top of your [FaceName of player] head and break its seal with a well-practiced motion. At once, an icy jet of smelling gas hisses from the tiny opening while you expertly layer yourself in a generous sheen of the anti-nanite slurry and wait for this beatific substance to rid you of the latest defilement to your hominid grace. Though the process seems slower then you recall, as when the Revert All begins to dry and the anomalous tincture seeps through what passes for your pores does a profound sense of icy numbness begin to bubble though you. Initially, the bracing chill is almost... pleasant as if your skin were being scrubbed with a gentle spearmint balm, as the seconds pass, the once soothing cold deepens to a biting icy rime permeating your being as your hide blackens then fractures along invisible faults in your tainted flesh."; 
		say "     Soon the tiny gaps in your twisting flesh as it turns a metallic silver while whole sections of your aberrant skin [SkinName of Player] hardens then fall from you like glistening sheets of malformed glass, and hit the ground tooth rattling knell as it shatters on impact revealing your charmingly human self hidden beneath. As you collapse onto all fours as your core ripples definitely and coppery steam leaks from your mouth as the lingering corruption of your person at last gives way to your coveted human profile. Gasping and spitting wads of silvery colored metallic mucus, you slowly stumble to your feet and dust off the last errant flakes of calcified matter from your personage. Perhaps, you muse, it would be best to stop using this before the side effects get out of hand.";
		Humanify_Player;
		PlayerWounded 100;
		StatChange "Dexterity" by -1;
		StatChange "Strength" by -1;
		StatChange "Stamina" by -1;
		StatChange "Intelligence" by -1;
		StatChange "Charisma" by -1;
		if "Gas Cloud" is listed in Feats of Player:
			FeatLoss "Gas Cloud";
		else if "Resistant" is listed in Feats of Player:
			FeatLoss "Resistant";
		else if "Bestial Power" is listed in Feats of Player:
			FeatLoss "Bestial Power";
		else if "Mighty Mutation" is listed in Feats of Player:
			FeatLoss "Mighty Mutation";
		else if "Iron Stomach" is listed in Feats of Player:
			FeatLoss "Iron Stomach";
		increase Depravity of Galaxite by 1;
	else if Depravity of Galaxite > 10:
		say "     Rummaging through your inventory, you pull out one of, if not the last cylinder of Revert All in your possession, though not without feeling some small measure of trepidation at thought of using this hellacious compound again. After all you've been through and all the horrid side effects you've endured, it almost doesn't seem worth it to you anymore. Yet, your burning desire to reclaim your treasured humanity outweighs such petty concerns you might have as you manically crack the seal as you douse yourself head to toe in a thick sheet of counter-transformations. Immediately, your nanite laced body heaves and rebels against this latest assault as your vision cracks then distorts in a prismatic ballet of sickening hue green. While your [SkinName of Player] splits morphs into patchwork tapestry of mismatched hide as the long suppress taint roiling within you makes its presence known. Howling in bestial blend of disbelief and rage, you can do little but watch as your body devoles into a throbbing disjointed mass disparate flesh and ill matched appendages.";
		increase Depravity of Galaxite by 1;
		infect "Quilled Tousky";
		infect "Cock Cannon";
		infect "Foul Scuttler";
		infect "Flesh Blob";
		infect "Junkman";




Section 3 - Items

Table of Game Objects (continued)
name	desc	weight	object
"Dragon Pearl"	"[if Energy of Galaxite >= 1]Lighter than a feather and smoother than polished obsidian, the pearl fits snuggly in the palms of your hand, regardless of your size. Its presence is oddly calming, like a hug from a treasured lover, or nuzzle from a dear pet. When you're alone, or at least out of eyesight, you often find yourself polishing or caressing its glassy surface just to watch the light dance along its pristine mirror-like surface. At times you think you see strangely familiar shapes and letters glide about its equator. More than once, you've considered showing your precious to another in the hopes of unraveling its secrets, yet you always stop yourself lest some greedy covetous mortal dare separate you from your prize[else if Energy of Galaxite is 0]Cold and lifeless, whatever power once dwelt within the pearl has been away drained. No longer do you see captivating shapes play along its edges, or feel any comfort stroking its curves. Now only biting cold and a deathly bone white glow greets your senses whenever you dame to look upon this tiny monument to your weakness. Still, a part of you can't bring yourself to part with it, in the vain hope you one day gaze upon its brilliance once more[end if]."	0	Dragon Pearl

the scent of Dragon Pearl is "The pearl smells of crisp ocean air and lurid abyssal promise.".

Dragon Pearl is a grab object. Dragon Pearl is not temporary.
Usedesc of Dragon Pearl is "[ANewHandTouchesTheBeacon]";

to say ANewHandTouchesTheBeacon:
	if Energy of Galaxite >= 1:
		say "     Running your fingers along the inviting surface of the pearl, the otherworldly gem thrums with reassuring pulses of abyssal warmth along your fingertips as you pluck your peerless prize from your inventory. Holding it aloft, a pleased smile blossoms on your lips as the available light caresses its glossy iridescent surface, a feeling pronounced calm and contentment wells in your breast as the pleasant swirls of its ever-changing patterns and unnatural heat crackles about your palms. Your ears begin to ring as the chaotic energies contained with leap along your arms like umbral lightening cascading over a ship's hull, as your receptive body seem to drink in this eldritch font of raw change as if it were parched dry desert sands. Delighting at the sensation of pure draconic power flowing through you, polishing away any remnants of the lesser infection tainting your being as your true splendor begins to reemerge.";
		infect "Dragon Breeder";
		infect "Dragon Breeder";
		increase Breast Size of Player by 3;
		if Cunt Count of Player is 0:
			increase Cunt Count of Player by 1;
		increase Cunt Depth of Player by 3;
		increase Cunt Tightness of Player by 3;
		if Cock Count of Player >= 1:
			Increase cock length of Player by 5;
	else if Energy of Galaxite is 0:
		say "     Massaging the pearl in your hands like a deprived addict desperately trying to bask once in that beautiful half forgotten glow and feel the intoxicating pulses of draconic power once more, if only for a moment. Yet no warmth or oscillating colors greets you this time, as the icy dead lump of sand and calcite is utterly unresponsive to your insipid touch. Your pathetic pleading merely seems to dull those bright hues ever-so-slightly as heat leech from fingers as your flesh blackens cracks with the early signs of frostbite. Hissing in a mix of pain and defeat, you squirrel away the once priceless bauble before you potentially lose a finger.";
		PlayerWounded 8;

Table of Game Objects (continued)
name	desc	weight	object
"Dragon Fucker Coin"	"This emergancy coin turns you into a dragon Breeder, use with care kin da mun."	0	Dragon Fucker Coin

the scent of Dragon Fucker Coin is "The coin smells like good drussy.".

Dragon Fucker Coin is a grab object. Dragon Fucker Coin is not temporary.
Usedesc of Dragon Fucker Coin is "[DFCoinUse]";

to say DFCoinUse:
	say "     Rubbing the coin between your fingertips, reality ripples and shifts as it bends to the ephemeral will of the poorly made debugging tool.";
	turn the Player into a "Dragon Breeder";
	choose a row with Name of "Dragon Breeder" in Table of Random Critters;
	ItemLoss Dragon Fucker Coin by 1;


Table of Game Objects (continued)
name	desc	weight	object
"Sundered debugger"	"Fixes a bug from a prior patch."	0	Sundered debugger

the scent of Sundered debugger is "The debugger smells like a stuipd dragon.".

Sundered debugger is a grab object. Sundered debugger is not temporary.
Usedesc of Sundered debugger is "[SDUse]";

to say SDUse:
	say "     Mashing the debugging tool reality hastily corrects itself.";
	now Loot Boxes is active;


Galaxite ends here.