Kathy by Sundered Dragon begins here.
[Version 1 corrupted Drake route test]
[Version 1.1 MVP Build]
[Version 1.11 Pre-Pride update]
"Adds a devious NPC to the Flexible Survival game."

[ HP of Kathy                          ]
[ 0 = not met                          ]
[ 1 = talked to	once                   ]
[ 2 = talked to twice                  ]
[ 3 = heard her full backstory         ]

[Lust of Kathy                         ]
[ 0 = pre Pride Mother TF              ]
[ 1 = post Pride mother TF             ]

[Thirst of Kathy                       ]
[ 0 = quest not discussed              ]
[ 1 = quest accepted                   ]
[ 2 = quest turn in                    ]
[ 3 = quest completed as female        ]
[ 99 = quest rejected                  ]
[ 100 = quest completed as male or herm]

[                TODO list                   ]
[ Add Pride Mother TF                        ]
[ Add fuck and breed scene for Pride Mothers ]
[ Add belly job scene for Pride Mothers      ]
[ Include Lion riding for Pride Mothers      ]
[ Finally include Kathy's kin quest line     ]


Section - 1 I've got the world on a string, sittin' on a rainbow

Table of GameCharacterIDs (continued)
object	name
Kathy	"Kathy"

Kathy is a woman.
Kathy is in Room 020.
ScaleValue of Kathy is 3. [4' 6"]
Body Weight of Kathy is 9. [scale of 1-9 for body weight, grouped into low weight (1-3), mid weight (4-6) and high weight (7-9)]
Body Definition of Kathy is 1. [scale of 1-9 for body definition, grouped into low muscle (1-3), mid muscle (4-6), high muscle (7-9)]
[Body Adjective is generated out of the body weight and body definition and can be used in scenes - one word descriptive adjective depending on weight and definition groups: low weight group: skinny/slender/lithe; mid weight group: average/fit/muscled; high weight group: pudgy/husky/jacked]
Androginity of Kathy is 9. [Gender Adjective is generated out of androginity 1-9: hypermasculine/masculine/somewhat effeminate/effeminate/androgynous/feminine butch/tomboyish/feminine/hyperfeminine]
Mouth Length of Kathy is 7. [inches deep for face fucking; maximum possible will be double this number (when deep throating)]
Mouth Circumference of Kathy is 4. [mouth circumference 1-5, "tiny, small, normal, wide, gaping"]
Tongue Length of Kathy is 6. [length in inches]
Breast Size of Kathy is 5. [cup size as number, counting Flat Pecs = 0, A = 1, B = 2, ...]
Nipple Count of Kathy is 6. [count of nipples]
Asshole Depth of Kathy is 6. [inches deep for anal fucking]
Asshole Tightness of Kathy is 2. [asshole tightness 1-5, "extremely tight, tight, receptive, open, gaping"]
Cock Count of Kathy is 0. [number of cocks]
Cock Girth of Kathy is 0. [thickness 1-5, thin/slender/average/thick/monstrous]
Cock Length of Kathy is 0. [0 Inches]
Ball Count of Kathy is 0. [allowed numbers: 1 (uniball), 2 or 4]
Ball Size of Kathy is 0. [size of balls 1-7: "acorn-sized", "dove egg-sized", "chicken egg-sized" "goose-egg sized", "ostrich-egg sized", "basketball-sized", "beachball-sized"]
Cunt Count of Kathy is 1. [number of cunts]
Cunt Depth of Kathy is 18. [penetrable length in inches; some minor stretching allowed, or more with Twisted Capacity]
Cunt Tightness of Kathy is 4. [size 1-5, generates adjectives of extremely tight/tight/receptive/open/gaping]
Clit Size of Kathy is 3. [size 1-5, very small/small/average/large/very large]
[Basic Interaction states as of game start]
PlayerMet of Kathy is false.
PlayerRomanced of Kathy is false.
PlayerFriended of Kathy is false.
PlayerControlled of Kathy is false.
PlayerFucked of Kathy is false.
OralVirgin of Kathy is false.
Virgin of Kathy is false.
AnalVirgin of Kathy is true.
PenileVirgin of Kathy is true.
SexuallyExperienced of Kathy is true.
TwistedCapacity of Kathy is true. [Twisted Characters can take any penetration, no matter the size]
Sterile of Kathy is false. [steriles can't knock people up]
MainInfection of Kathy is "Pride Mother".
Description of Kathy is "[Kathydesc]".
Conversation of Kathy is { "Nya-Nya-Na!" }.

the scent of Kathy is "Kathy smells like a needy pregnant lioness."

to say Kathydesc:
	say "     A portly anthro lioness, Kathy is barely more than four and a half feet tall. Her face is notably animalistic, with a boxy muzzle, sweet pouty chin, and the satellite dish ears of a hunting cat. Despite her bestial visage, her sweet hazel eyes are always studying and hint at the hidden depths of her true intelligence. Quite the chubby woman, Kathy boasts a cub-swollen belly almost as big as she is, and hosts a quartet of love handles stretching around her golden furry sides enveloping her in a layer of plush cuddly stuffing which pads her extremities. Vying for space around her lap filling bump are six evenly engorged DD-cup breasts blessed with cute half inch nipples that beg to be suckled upon.";
	say "     She has a mostly humanoid lower half with plantigrade legs that end in cute katty paws with adorable pink toe beans. While her waist is rather round and shapely with a plush squeezable bubble butt. Sprouting from her hind end is a long slender tawny tail, almost as lengthy as she is tall, tipped with a bushy tuft of brown fur. Largely disinterested in clothing unless sex is somehow involved, Kathy prefers to lounge around in her bare fur and see-through blue lace bathrobe. Though from the way she carries it, you suspect Kathy regards her clothes more as an accessory than anything else. Even if she were interested in clothes, her plump short stack nature would make it hard to find to fit her during the best of times.";

Section 2 - Got the string around my finger

Instead of conversing the Kathy:
	if HP of Kathy is 0:
		say "     Heading up to the second floor, you proceed to the end of the building and knock on the door of room 020. From the other side of the aperture, you hear a slight rustling of fabric followed by a sweet, matronly, female voice calling out, 'come on in, it's open.' Heading inside, you're greeted by the face of a bedridden anthro lioness wearing nothing more than a see-through blue lace bathrobe happily cuddled around her massive pregnant belly. Though the majority of her is lost beyond her heavily distended tummy that reaches down to her knees, she seems to be about four foot five feet tall with an overall lush voluptuous figure. An undeniably hefty creature, her corpulent midriff spills over to her plush snuggly sides, forming a cute pair of love handles.";
		say "     The woman's weighty arms are padded in generous amounts of fluff. Her legs have plenty of jiggle, yet her calves possess a modicum of muscle to them. Her visage is very animalistic with a fully developed muzzle, thin ebony lips, and sleek disk-shaped ears. Behind her, you spy a whip-cord tail akin those of the felines['] that you've seen in the park, though it's markedly longer. Unlike the petite park dwelling ferals, this lioness is far more endowed in the chest department being blessed with six evenly-sized double D's competing for space around her fantastically bloated bump. Her soft tawny golden pelt is immaculately combed and groomed with not a hair out of place. 'Like what you see?' she asks teasingly, running a paw shaped hand along her massive tits.";
		WaitLineBreak;
		say "     Realizing you've been gawking at her, you mutter a vague series of words that could possibly be interpreted as an apology to the lioness. 'Oh don't worry about it,' she beams in a teasing tone, 'I'm Kathy by the way, though you probably already knew that.' She says extending her paw to you. Shaking her hand, you introduce yourself explaining that Drake asked you to stop by and introduce yourself to the residents of the Last Chance. 'That's sweet of you, we don't get much in the way of polite visitors out here. So what brings you out here?' Shrugging, you reply you were looking to do some trading, maybe try to make some friends while you're at it. 'Ah well if that's the case, you came to the right place. Drake sometimes has a few bits and bobs for sale if you catch him at the right time, and he's pretty good with hands too.' Kathy smirks, drumming her clawed taut tummy fur.";
		say "     'As for friends, you should try chatting with Ava over by the garage. The nanite outbreak has been rather hard on my poor girl. It would do her some good to know the world isn't full of monsters or mean humans.' Nodding your head, you tell Kathy you'll keep that in mind.";
		now HP of Kathy is 1;
	else if HP of Kathy is 1:
		say "     Briefly chatting up Kathy, you ask her how she came to be The Last Chance. 'Well when the infection began, I was a normal lioness being kept at-.' Wait, she wasn't originally a human? Then how can she speak you interject, shocked at the improbability of it all. Sighing at your sudden interruption, Kathy rolls her eyes, saying. 'Well, I was just about to get to that, but if you must know Drake helped me learn English, among many other things.' She says rather proudly. 'Now as I was trying to say, I was a circus animal up until someone let my pride loose at the start of the outbreak. My memory is a blur on the exact circumstances of how we got out of our cages though, but I know we ended up at the park. By that time we all started walking on two legs.' Kathy says, flexing her furry padded toes.";
		say "     'You know, it was quite exhilarating being able to use my paws like a human. I was always so jealous of not having thumbs or being able to hold things properly.' Kathy says in a prideful tone as she flashes her pair of hitchhiker's thumbs. 'I guess I just got wrapped in the fun of exploring the city looking for stuff to fiddle with. I must have spent days playing with doors and taking apart stuff like phones or mp3 players looking for the thing that made the weird noises. Eventually, I found myself out in the dry plains. I can't say why, but it seems homey out here.' Kathy remarks wistfully as she stares out at the sprawling landscape outside her window. So is that how you found the Last Chance, just wandering around you ask. Kathy shakes her head.";
		WaitLineBreak;
		say "     'Yes and no,' Kathy replies in a sing-song tone, 'while I was exploring around, I was spotted by a very hungry behemoth. Being an idiot, I hissed at it like my mom taught me, rather than you know, running like I should've. *Sigh*, it was on me in a flash. Clubbing me off my feet,' Kathy pantomimes a swatting motion, 'the behemoth pinned me to the ground like it was going to eat me. I thought it was over at that point, but before it could get its mouth around me, this ear splitting knell ripped the air as Drake shot it. The behemoth died on the spot, or at least I think it did, and it almost crushed me as it fell. Luckily, Drake sprinted over in time to get out from under it. Mmhh, you should have seen my proud hunter as he hefted the creature's gargantuan paw with one hand, his rifle hefted over his shoulder. The setting sun shining through tiny gaps in Drake's rich mane as he pulled me into his arms.' Kathy coos lying back on her mattress as she recalls the memory.";
		say "     'I couldn't keep myself from throwing myself at him, mewing like a scared kitten. I felt so safe cuddled in his big strong arms. I didn't let go till long after he carried me home.' Bobbing your head, you ask Kathy what happened next. 'Not much, he cleaned my wounds and tried figuring out who I was.' How'd that go you ask. 'Oh it was rocky at first,' Kathy chuckles through a pleased Cheshire smile. 'To be fair, Drake had no way of knowing I was never human, so he treated me like an injured person. When I tried to 'thank' him my own way, he refused.' Kathy says with a lusty grin on her face. Wow he turned you down at first? You reply, eyeing up her expectant form. 'Mh-hm, he thought I wasn't thinking clearly because of the infection. He said something about how he didn't want to take advantage of someone in my position. Later, when I picked up a few more words I did my best to express myself and well,' Kathy pauses to happily pat her tummy, 'I think you can guess the rest.'";
		now HP of Kathy is 2;
	else if HP of Kathy is 2:
		say "     Buttering up Kathy with small talk, you do your best to tactically ask Kathy about her form. You haven't seen a mutant like her before. Though, you remember how she said she is related to the felines in the park, you aloud what changed. 'Well that's true I am one, or well was one. I guess my body started to change after I met Drake and I got to try real food for once. I've always been curious about human food. My jailors,' Kathy snarls, baring her fangs at you while her nose fur crinkles in aggravation. 'Oh sorry about that,' she says, briefly covering her mouth as if she were trying to block a sneeze or cough. 'I mean trainers, would keep us on the verge of starving to keep us thin and presentable as they called it, assholes.' Kathy spits, thumping her tail against the bedsheets in aggravation. 'The only ones they fed regularly were the breeders who kept out of sight. Lucky bitches got lounge all getting fucked and stuffing their faces while rest of us had to work. I don't know how many hours of my life I wasted jumping through burning hoops or getting chased by clowns to keep them fed.'";
		say "     'Lazy sluts, hardest thing they ever had to do was watch one of the cubs get sold off to a breeding program, a zoo, or some weird humans that smelled like oil, opium, and cumin. I bet none of them had to do three shows a day for years straight, or had whips cracked in their faces when they tried to fight back.' Kathy grumbles. 'Anyways, when Drake heard this he actually offered to cook for me. Anything I wanted he said, and for what felt like the first time in my life I was able to indulge my curiosity. I got to admit it was pretty fun watching him wait on me hand and foot while I tried everything I could think of. Over time my body started to change. It was small stuff at first like my butt getting a little bit rounder or my thigh getting a bit softer.' Kathy coos patting her hips. 'After a while my tummy nipples started growing into actual full breasts,' Kathy coos as she massages her lowermost bosom.'";
		WaitLineBreak;
		say "     'I am not gonna lie, figuring out how to give Drake a triple-tiered boob job was a real fun experience.' Kathy says groping her uppermost rack. 'Then my yucky old muscles slowly started to fade away as this cute layer of pudge crept over me. You probably won't believe this, but I was pretty ripped once. I had a gross six pack, these big mannish deltoids, and thin toned thighs. Bleh, can you imagine that.' Kathy jokes patting her portly body. 'It was sort of liberating to watch all my trainer's hard work wash away. Honestly, the bigger I got the more I felt like I was finally well and truly free of them for the first time since the outbreak began.' Kathy swoons, running a paw down her sides. 'Besides, who would want a tiny muscular girl when they could have a short stack like me?' Kathy asks as she flashes you a lewd cheeky grin. Ruminating on her question, a part of you wants to ask what Drake's opinion on the matter was, but something tells you though he loves her for who she is, not her looks.";
		say "     'So,' Kathy continues, resting her arm on her stomach, 'after a while, I started getting this big squishy pot-belly. At first I was a little nervous about not being able to see my paws, but after some time it kind of started to turn me on. Just feeling my tummy weighing me down, the huge blubbery mass rubbing against my cunny all the time. Not to mention it makes a convenient reading desk.' Kathy rolls on her side to give you a better view of her fecund form. 'Oh, I can't tell you how good it felt once it became obvious I was finally pregnant.' Kathy says dipping a paw under her swollen belly, hugging it close. 'It was magical watching my body swelling so full of Drake's cubs till it became hard to walk.'";
		WaitLineBreak;
		say "     'The sensation of my breasts bulging with warm, tasty cream, I never wanted it to end.' Kathy giggles to herself. 'I wish you could have seen him when he found out. He looked so cute when started fawning over me. He spends hours brushing my pelt or rubbing my paws to make sure I'm comfy. All the while, he would go on and on about how he wants to be a good father. All the things he wants to teach them. The places he wants to take us. How he's going to take care of us once we get out of here. I've never had anyone care about me like this before,' Kathy sniffles as if she were fighting back tears. 'You know, I sometimes worry I'm going to wake up one day back in my cage one day and this will have turned out to be a dream.'";
		now HP of Kathy is 3;
	else if HP of Kathy is 3:
		say "     [one of]'How are things?'[or]'I think the cubs are saying hello,' Kathy says pointing to her lively tummy.[or]'I could really go for a deep fat fried Twinkie drizzled in caramel, chocolate syrup, powdered sugar, and vanilla icing.' Kathy opines, kneading her rumbling belly, 'actually make that a dozen.'[or]'Do you like my bathrobe? Drake gave it to me along with a bunch of boring normal shirts and pants. Don't know why I'd ever wear them, my pelt is warm enough as it is.'[or]'I understand the nanite infection has hurt a lot of people, but it's still the best thing to ever happen to me.'[or]'Bet you can't do this!' Kathy exclaims bending the tips of her thumbs at one hundred twenty degree angle.[or]'I wonder what happened to my trainers. I never saw what happened to them after my pride got freed. I hate to admit but one or two of them were actually kind of nice.'[or]'I hope my pride sisters are doing ok living in the park. None of us have been in the wild before, much less hunted. Hopefully they find someone who can take care of them half as good as Drake does me.'[or]'I've been thinking about painting my claws. What do you think would look better, red, gold, or black?' Kathy asks, flashing her talons at you.[or]'Do you think the cubs will be human, feline, or somewhere in the middle?' Kathy asks, rubbing a paw over her squirming belly.[or]'I hope Drake is doing alright. The poor boy. He doesn't get more than four hours of sleep every week.'[or]'Have you talked to Ava? She could probably use the company more than me. I'm never really alone anymore.' Kathy says, petting her gravid stomach.[or]Kathy ignores your attempts at conversation, more intent on grooming herself in preparation for her lover's next visit.[or]'I hope my next litter is even bigger.' Kathy purrs, tracing a claw down her hem line.[or]'You know, I bet you'd love being knocked up with a litter of lion cubs.' Kathy says, eyeing your midriff.[at random]";


Section 3 - Life is a beautiful thing, as long as I hold the string

the fuckscene of Kathy is "[sexwithKathy]".

to say sexwithKathy:
	if Thirst of Kathy is 0:
		say "     'No thanks, I don't think Drake would appreciate the mother of his cubs sleeping around. Then again, maybe we can help each other out with something.' Kathy says as a devious twinkle flashes across her eyes. Not seeing the harm in hearing her out, you motion for her to continue. 'Right, here's the thing, I love Drake and all but he's too um, tame for my needs.' Not sure what she means exactly by [']tame,['] you ask Kathy if she could elaborate. 'Well, how do I put this, Drake is a very sensual lover. I mean he's always taking care to keep me comfortable. He's very generous with foreplay, loves to cuddle and blah blah blah.' Kathy sighs, twirling her index finger in a conical fashion. 'Sure it's one of the reasons I was first attracted to him, well that and his paw rubs feel AMAZING! But recently, it's gotten kind of boring.' Not seeing how this could be a major issue, you ask Kathy if she's talking to Drake about her needs. You note that healthy long term relationships are built on good communication after all.";
		say "     'I have but he just doesn't have it in him to be rough, right now at least. So I was thinking, maybe he might be a better mate if he transformed into a proper lion.' You ask her what Drake thinks about this. 'Oh, he says that he's not super opposed to the idea. Really, he's just worried that it would be harder for him to raise his kids as a lion than as a human. Personally, I don't see why that would be a problem. So, will you help?' Kathy asks as she tilts her head at a cute angle and flashes with an adorable catty grin.";
		LineBreak;
		say "     [bold type]Shall you assist her in transforming Drake?[roman type][line break]";
		let Drake_TF_Choices be a list of text;
		add "No, you do not want to help her TF Drake." to Drake_TF_Choices;
		add "Yes, you want to help Kathy TF Drake." to Drake_TF_Choices;
		let Drake_TF_Choice be what the player chooses from Drake_TF_Choices;
		if Drake_TF_Choice is:
			-- "No, you do not want to help her TF Drake.":
				say "     Not comfortable with the notion of transforming Drake against his will, you decline Kathy's request. 'Fine, forget I said anything,' Kathy huffs.";
				now Thirst of Kathy is 99;
			-- "Yes, you want to help Kathy TF Drake.":
				say "     'You will!' Kathy exclaims throwing her gravid body around you in an attempt at a bear hug. 'Thank you so much,' she exclaims, smothering your face in her husky bosom as she nuzzles her adorable muzzle along your cheek in a show of affection. Once she is done depriving you of your oxygen supply, and you've picked all the hair out of your mouth. You ask Kathy how precisely you can help her infect Drake. 'That's the tricky part, Drake is a bit resistant to the nanites in general. I should know, I've tried to transform him myself.' Kathy says, gesturing to her swollen tits. 'I've even seen him handle things that turn people into walking pool toys without consequence. So I think we need a concentrated dose of raw nanites to change him. Thankfully, I have an idea on how to acquire some,' Kathy grunts rolling on to her tummy like a yoga ball, opening her nightstand to fish around for something. 'Ah there it is,' Kathy says, pulling out something that looks akin to a multi-headed solid white life straw about the size of a man's hand with a clear Pyrex vial attached to the end and sits back down beside you.";
				say "     'Now, I don't really know how this thing works, but according to one of his trading partners. If you [']feed['] devices like this items that have a high concentration of nanites in them, like say cum. You can extract raw purified nanites that can overcome most forms of nanite resistance.' Kathy says, rolling the odd solid white tube over in her mitts as she gazes at all the strange openings on the head of the device. 'Supposedly, one of his old friends modified this one to create what they called a 'Prime Strain' of whatever was put into it.' Prime strain, what the heck does that mean, you inquire. 'I donna know,' Kathy shrugs and throws up her hands. 'Mx's notes weren't exactly clear on the matter, and,' Kathy briefly cups her paw-like hand to the side of her muzzle, 'don't tell Drake this, but their friends['] cursive and spelling are really bad. The little I could read said that it somehow cleaned up and optimized the nanites code.' Interesting, so in theory you improve any infection you wanted with this device, you remark. 'Well, yes you could, but this thing is almost dead.'";
				WaitLineBreak;
				say "     'Here see for yourself,' Kathy says, as she twists the bottom of the collector and briefly points the butt of the device at you. Looking at it, you spy four tiny but dim blue LEDs on the bottom, only one of which is lit up. Well that doesn't seem like much of a problem, can't she just recharge it, or replace the batteries, you ask. 'I thought the same thing, but none of the cord thingies Drake has laying around fit.' Kathy says, twirling the device around in her padded fingers as she shows you all the oddly shaped potential charging ports. None of which you recognized, leading you to guess those things are using either some weird European cords, a proprietary design developed by its makers, or this Mx person created their own plugs. 'Now before you ask, no I can't get this to open, so I have no idea what the battery or batteries look like.' Kathy says, tapping the modded extractor with her claws. 'And no I'm not letting you try. Even though he refuses to use it, this thing has a lot of, oh what do you humans call it again?'";
				say "     Kathy pouts, with a look of utter frustration on her face as she thumps her tail loudly against the mattress while she searches for the correct words. 'Um sentimental value to him?' She asks in a hopeful tone, tilting her ears at a thoughtful angle as she does. Nodding, you tell her that sounds about right. 'Ya so unless you can find Mx, our best bet is to stick with this. Drake won't care if it's dead after all, since he never turns it on.' Ok, but how about using a normal collector instead, you ask. 'I've thought about it but, well, I'd rather have the best version of a lion for a mate than a copy of a copy of whatever is running around at [bold type]The Park[roman type] right now. Speaking of which, I'd like you to get me [bold type]five bottles of felinoid cum[roman type] from some of the male lions roaming around there so I can transform Drake into a proper mate. Preferably from different sources, Mx's notes said the extractor works better that way,' she adds, squirreling away the modded extractor. Shrugging, you tell Kathy you'll see what you can do, but make no promises. 'Alright, just let me when you're ready.' She says, flashing you an appreciative grin.";
				now Thirst of Kathy is 1;
	else if Thirst of Kathy is 1:
		if carried of felinoid cum >= 5:
			ItemLoss felinoid cum by 5;
			say "     Recalling, you just so happen to be in the possession of five units of felinoid cum. You furnish the pre-request items, much to the gravid girl's glee. 'Wow, these are perfect, well almost,' She gushes snatching up the bottles of felinoid jizz. Kathy pulls out the modded extractor and runs the semi-pearlescent fluid through the device. Most of which seems to be consumed in the process, shes still left with a sizable quantity of gray nanite slurry in the end. 'You know, now that Im looking at this stuff,' Kathy pauses with a sour look on her face and swishes the Pyrex vial and its contents around. 'I bet this could use a little milk to hide it, no way Drake won't notice like this.' She says, struggling to get out of bed. Seeing her plight, you lend her your hand, aiding the thoroughly seeded woman to her feet. 'Thanks,' Kathy, her hand resting on her breeding factory huffs. After catching her breath, she waddles over the kitchen to fetch a glass pitcher from one of the cabinets built into her room. She proceeds to empty the contents of the extracts into the glassware, filling it a tenth of the way.";
			say "     She then slips off her robe trying to cup the vessel under her upper right tit. 'Darn it,' Kathy hisses, finding it impossible to simultaneously milk herself, aim, and hold the container in position. 'Uh, I don't mean to impose,' Kathy folds her arms around her six bountiful golden mounds while crossing her left leg over her right in a pleading gesture. 'But, I could use your help,' she says motioning to her bed. Having come this far, you agree to help her, and offer her a seat by you. 'You're a sweetie,' Kathy says, hoisting her doughy frame onto your lap. Though undeniably heavy, Kathy's warm pudgy body rests beautifully on your own as if she were made to snuggle with. Marveling at how welcoming her silky pelt is as you wrap your arms around the voluptuous cuddly lioness, a difficult task given her rotund nature. Though, you wonder if you maybe should take this opportunity to have a little fun with her. Surely, Drake wouldn't notice if you gave Kathy a little manual stimulation Alternatively, if you are having second thoughts about this it might be time to bail.";
			LineBreak;
			say "     [bold type]What do you want to do?[roman type][line break]";
			LineBreak;
			say "     [link](1)[as]1[end link] - Finger Kathy."; [lewd milking]
			say "     [link](2)[as]2[end link] - Just help her express."; [less lewd milking]
			say "     [link](3)[as]3[end link] - Bail."; [GTFO]
			now calcnumber is 0;
			while calcnumber < 1 or calcnumber > 3:
				say "[run paragraph on]";
				get a number;
				if calcnumber is 1 or calcnumber is 2 or calcnumber is 3:
					break;
				else:
					say "Invalid choice. Type [link]1[end link] Finger Kathy., [link]2[end link] Just help her express., [link]3[end link] Bail.";
			if calcnumber is 1:[lewd milking]
				LineBreak;
				say "     Deciding to give the tubby girl some extra attention, you gingerly massage the super taut skin of her furry cream-fountains. Attending all her sore spots, you [']pinch['] her firm erect teats between your thumb and pointer finger, kneading her sloshing chest, evoking a wild spurt of thick lioness milk from Kathy's ebony tits. 'Mmhh, that feels good, my girls can get so achy,' she mewls contentedly. Feeling her sink into your embrace, you languidly tease her velvety belly fur, eliciting a girlish squeak from the preggo lioness as you trace her cute outie belly button. You cup her hefty cream-factories with your non-dominant hand. You tenderly massage the supple orb, coaxing a thick spray of lioness cream for the expectant furry, but miss the pitcher entirely. Not that Kathy cares, as judging from the dirty look on her face, she's more than a little turned on at the sight of how much her body can produce.";
				say "     While she looks on in awe, you slip a hand beneath her heavy midriff, brushing your digits around her kissable nether lips, exalting in how blissfully succulent her thigh feels in contrast with her taunt breeder's bump against your hand. 'Wait, Drake-,' Kathy gasps but makes no effort to stop you. He doesn't need to know, you whisper, sliding one finger then two into her toasty feline muff. 'But,' she moans even as her cunt involuntarily clenches about your digits, her infection obviously getting the best of her. Sensing this, you lazily lavish the yielding walls of her plump box with your practiced tactile digits, not enough to bring her near orgasm, but enough leave craving her more. Your diligence quickly pays off as Kathy's fertile passage grows moist despite her alleged desire to stay true to her mate.";
				WaitLineBreak;
				say "     Her token resistance to your advance ebbs, the horny lioness begins panting desperately and finally yields as she murmurs, 'Please harder.' Happy to oblige, you drive your fingers vigorously into her snatch, pumping Kathy's quivering pussy and tending to the lioness' innermost depths. 'More,' Kathy pants her tongue hanging lewdly from her mouth. Grinning at her request, you pull out, forming your digits into a point. Unable to see what you're doing under her massive stomach, Kathy casts you a needy questioning glance which quickly becomes one of rapture as you plunge your fist thumb-knuckle-deep into her well-breed tunnel. Practically seeing stars at this point, Kathy has to bite her tongue in order to avoid roaring in your ear. You don't allow her to recover either, instead plowing Kathy's erogenous zone like you've got something to prove, much to her delight.";
				say "     She rocks her child bearing hips in tandem with your thrusts, trying to get more your hand into her hungry snatch. Her gyrations jostling her blubbery over-inflated bouncy house of a womb against her lap with audible thumps. Perhaps worrying about her precious kittens, Kathy immediately sets down the pitch and wraps a paw around her adorable paunch. Steadying her litter with one hand, Kathy's free hand drifts to her bosom, caressing her neglected teats. She works each one over, eliciting fresh milky streams. The pearlescent substance cascades uncontrollably down her sides, soaking her ample waist. Her fertile offering collects on the lower hemisphere of her bun, dripping (along with her fem juices) into the pitcher. Spurred on by her display, you redouble your pace, thumbing the outside of her clitoral hood between motions.";
				WaitLineBreak;
				say "     Kathy mewls in ecstasy, her tongue rolling out of her mouth while she rests her silky head against your shoulder. As your hard thrusts get too much for her, she cums hard, squirting a river of sweet water down your arm. 'Ah, I needed that more than I thought,' Kathy pants, rolling off your lap, leaving a damp streak on the sheets. 'Nothing against humans, but your poor males just have no endurance whatsoever. I mean, whoever heard of a species that can't mate thousands of times a week.' Kathy jokes waddling to her feet. 'Anyways, I better get this to Drake before it gets cold,' Kathy says, retrieving the pitcher. 'Oh, and you may want to make yourself scarce for a day or two after I give him this.' Kathy shakes the tainted pitcher. Agreeing with her, you see yourself out.";
				say "     On your way to the gate, you overhear Kathy calling to her mate. Ever the dutiful lover, Drake dashes up to Kathy's room, a rather happy grin on his face. Dropping his rifle outside the door, he heads inside room 020. Not one to pass up a free show, you sneak back up to the second floor of the Last Chance. Creeping along the balcony walkway, you silently range towards Kathy's room, hoping you haven't missed too much. Coming to the edge of her abode, you can hear a heavy guttural breathing emanating from within. Peering through the open blinds, you instantly spy Drake doubling over by Kathy's side. As you observe him, you notice his face gaining a rubber quality as his jaw expands forming a blunted muzzle with dark thin lips and a robust chin. While his ear lobes reshape into the rounded forms of a male lion's, a pelt of molten bronze blossoms around his neck creating a proper mane, then creeps down over his spine. Interestingly as his fur grows in, a light dusting of deep sanguine appears on the periphery of Drake's proud locks. Perhaps a remnant of his Manticore infection is asserting itself, you muse watching the transformation spread to his torso.";
				WaitLineBreak;
				say "     His body expands, becoming larger in more ways than one. His back rippling with the changes, Drake's muscles swell in scale, their finely wrought outlines visible through the man's T-shirt, as his new found mass rends the cotton cloth. The flesh of his arm's begin convulsing next, as Drake's hands puff out as feline pads rise up out of his palms and inch long claws erupt from the tips of his digits. The changes soon penetrate the man's lower body, causing a giant lump to uncomfortably grow upon his pelvis. Howling, Drake desperately attempts to free this fresh appendage, yet his pants have been stretched beyond skin tight and threaten to cut into him. So he's left with no choice but to shred the garment revealing an incredibly long leonine tail tipped by a tuft of blood red fur. At the same time Drake's stance alters from plantigrade to digitigrade. His legs forcibly bent into those of a large Felidae.";
				say "     His shoes strain against the transformation but likewise burst around edges as Drake's feet are reshaped by the nanites into large furry paws. His transformation winding down, Drake drops to his knees, more from shock than anything else. Clenching his sides, Drake stares up at the grinning Kathy, his expression one of sadness, confusion, rage, and barely concealed betrayal. 'Why, I thought, we, the cubs?' He croaks, not used to his scratchy feline tongue or the rows of saber-like fangs lining his maw. In response, Kathy wraps her arms around her mate whispering in his ear. Though her words are lost on you, their effect on Drake is immediate. Pushing her back, Drake draws himself up to his new full height of seven feet. His eyes clear and focused, all vestiges of sadness on his face have burned off so only indignation remains.";
				WaitLineBreak;
				say "     He grasps hold of Kathy's door-jamming rump hoisting her up to his chest, with a dark toothy expression on his face. 'Eepp,' Kathy squeals, maybe regretting her decisions. Chuffing at her, Drake roughly slams his smaller lover's back against a nearby wall. He wraps her legs around his waist with but a few instructive bats of his tail, and from this angle, at last get your first look at his impressive feline package. Hanging out from its thick furry sheath is Drake's half erect barbed member. While not the largest tool you've seen out in the city, his spiny semi-hard cock measures around nine to thirteen inches in length, which for humans would be a little impressive. Complementing his fresh endowment are a pair of grapefruit-sized testicles covered in golden hair, already quivering in anticipation for what is to pass.";
				say "     Taking his partially-erect tool in hand, Drake strokes his tapered rod, getting used to its alien shape while lining himself up with Kathy's plump pussy. Seeing what he's about to do, Kathy wraps a hand under her beach ball sized belly using the other for leverage. She somehow wrangles her colossal litter out of the way, earning her a few approving rumbles from Drake as he spears her beckoning cunny with his now towering pleasure rod. Her sex splayed wide, Kathy yowls with animalistic joy as Drake bounces her on his inhumanly long shaft, creating a bulge along the top of her tummy at the height of his thrusts; almost like he was wearing Kathy like a novelty furry condom.";
				WaitLineBreak;
				say "     Perhaps wanting a taste of her lover's virility, even if it's a vicarious one, Kathy bends her sweet little muzzle against her chest. Licking the taut flesh of her swollen bump, she massages the tip of Drake's thorny spire with her rough tongue, while her tail brushes against Drake's inner thigh. Obviously wondering what she's trying to do, Drake slows his strokes, emitting an aggravated growl. 'Shh,' Kathy whispers between licks, palming his balls in her tail as if she were weighing a pair of priceless clay marbles. The lioness jiggles his freakishly huge nuts in pace with his motions. 'Doesn't your new body feel great? Don't you want to just fill me up with that beautiful lion-cock of yours, keeping my cunny nice and stuffed with your hot cum? Just imagine the two of us whelping entire prides of big sexy cubs.' She teases giving his hand-filling baby-batter-makers the lightest of squeezes with her tail. Drake, his eyes rolling to the ceiling, mutters a barely intelligible yes in reply.";
				say "     Kathy beams even brighter at this as she caresses her mate's potent manliness, urging him on. Enthralled by her words, Drake pulls Kathy closer to himself, getting a firmer grip on her shelf-like hips. He lifts Kathy half way off his goliath wang before he buries himself balls deep inside her, while remaining in a standing position. Damn he's strong! 'Ah, that's my man,' Kathy coos, her prodigious mounds loudly thumping one another as Drake pumps his exotic pole into her again and again, stimulating the sensitive glands within. Her adorable bosom doesn't need much in the way of attention for Kathy to express herself though, a reality that you can personally attest to as sheets of her motherly fluid pour down her sides.";
				WaitLineBreak;
				say "     Enchanted by the spectacle (and perhaps a little hunger to boot), Kathy slips an arm under her remarkable breasts. Groping a pair of her leaking tits, she positions the prominent nipple between her ebony lips, heartily suckling upon her own supply. Which is no minor feat given Drake's thorough pounding, but one that Drake makes a bit easier by lowering himself onto Kathy's bed. Without even slowing his pace, Drake lies back on his lover's mattress to enjoy the show; allowing Kathy to better manage his drive while still giving her walls the vigorous fucking she so desires.";
				say "     All to the lioness's ever increasing bliss as she chuffs up a storm from the sensations of Drake's magnificent barbed cock teasing her pussy and the warmth of her fresh cream sloshing around in her tummy. The act pushes the rutting pair over the edge as Drake's massive balls churn, dousing their content into the innermost depths of Kathy's womb, his sizable load further stretching out the chubby breeder. Howling in satisfaction, Kathy collapses on Drake's carved chest, her plump assets cushioning her fall. 'Mmhh, I've never ever felt so warm and full,' she says, snuggling her milk and cum bloated tummy upon her lover's stalwart abs. 'It feels like I am going to burst.' Kathy, sounding a little aroused by the idea, hums rubbing the sides of her creaking tummy, her normally pale skin pulled so taut that her belly has turned a bright pink in some spots.";
				WaitLineBreak;
				say "     Nuzzling Drake's mane, Kathy gently rolls off her mate's brawny pectorals, but somehow still manages to keep his softening package wedged in her breeder's box. Clearly she's not in any hurry to part with her new toy just yet. As she yawns contentedly, Kathy wiggles her ponderous frame into Drake's sinuous arms while resting her head upon his mane. In turn, Drake, his regal visage free of its previous ire, hugs Kathy close in a reverse spoon position, while entwining his tail with hers. In no mood to disturbed the pair's quiet moment (lord knows how you'd react in their position), you hurriedly sneak back out the front gate, praying they don't notice any messes you may have left behind. On your way to the Grey Abbey, you make a mental note to check up on leonine couple in the next few days.";
				Move Player to Grey Abbey;
				now HP of Augustus Drake is 99;
				now Thirst of Kathy is 2;
				now Cock Girth of Augustus Drake is 4;
				now Cock Length of Augustus Drake is 13;
				now Ball Size of Augustus Drake is 5;
				now Sterile of Augustus Drake is false;
				now MainInfection of Augustus Drake is "Felinoid";
				now Angry Wateringcan is active;
				now Crawl out through that fallout is active;
			else if calcnumber is 2:[less lewd milking]
				LineBreak;
				say "     Determining it best not to further meddle in Kathy's relationship, you focus on collecting the cat girl's lactate. Adopting a rare (relatively) chaste attitude, you lightly fondle Kathy's engorged upper tits, drawing a light trickle of milk from the portly woman. 'Ah, I should get Ava to drain these more often,' Kathy says, maneuvering the pitcher into place, catching a small amount of the alabaster liquid dripping down her bosom. Settling into a comfortable pace, you softly tweak the adipose-rich furry's dark teats, between your pointer and middle fingers, mindful of how tender the poor chubby breeder's neglected mounds must be. Kneading Kathy's feline nipples, your efforts bear fruit as cream leaks down and around the mewling fatties palm-able DD-cups. Noticeable entranced by the sight of her shiny covered milk pelt, Kathy gropes her lower bosom drawing out erratic streams of her motherly fluid. Coating her belly fur in a glaze of cream that drips down her sides in a thin trickle.";
				say "     'Ah, I needed this,' she purrs, absolutely in love with the sensation as she repeats the process on her remaining breasts; literally bathing herself in milk. Kathy massages her rapacious body, extolling at the way her wondrous cream catches the light as it cascades down her golden pelt. She chuffs in delight, undoubtedly grateful to have some else help relieve her seemingly endless supply. Eventually though, you get a handle on Kathy potent milk spurts, directing her milky emissions to the glassware angled before her and quickly top off the pitcher. 'Thanks again,' Kathy says, nuzzling your face, giving you an affectionate peck on the cheek. She then places the container on the floor and rolls off your lap, padding off her fur in the process.";
				WaitLineBreak;
				say "     Sitting up she continues, 'Much as I love the chubby breeder I've grown into, it does get a little annoying having to constantly manage my engorgement. Any-who, I'm going to give this to Drake while it's still warm,' Kathy says, gathering up the pitcher. 'By the way, you should avoid the Chance for a little bit. You know, to give Drake a little time to adjust.' Deducing that would be for the best, you wish Kathy luck and let yourself out. On your way to the gate, you overhear Kathy calling to her mate. Ever the dutiful lover, Drake dashes up to Kathy's room, a rather happy grin on his face. Dropping his rifle outside the door, he heads inside room 020.";
				say "     Not one to pass up a free show, you sneak back up to the second floor of the Last chance. Creeping along the balcony walkway, you silently range towards Kathy's room, hoping you haven't missed too much. Coming to the edge of her abode, you can hear a heavy guttural breathing emanating from within. Peering through the open blinds, you instantly spy Drake doubling over by Kathy's side. As you observe him, you notice his face gaining a rubber quality as his jaw expands forming a blunted muzzle with dark, thin lips and a robust chin. While his ear lobes reshape into the rounded forms of a male lion's, a pelt of molten bronze blossoms around his neck creating a proper mane, then creeps down over his spine. Interestingly as his fur grows in, a light dusting of deep sanguine appears on the periphery of Drake's proud locks. Perhaps a remnant of his Manticore infection is asserting itself, you muse watching the transformation spread to his torso.";
				WaitLineBreak;
				say "     His body expands, becoming larger in more ways than one. His back rippling with the changes, Drake's muscles swell in scale, their finely wrought outlines visible through the man's T-shirt, as his new found mass rends the cotton cloth. The flesh of his arm's begin convulsing next, as Drake's hands puff out as feline pads rise up out of his palms and inch long claws erupt from the tips of his digits. The changes soon penetrate the man's lower body, causing a giant lump to uncomfortably grow upon his pelvis. Howling, Drake desperately attempts to free this fresh appendage, yet his pants have been stretched beyond skin tight and threaten to cut into him. So he's left with no choice but to shred the garment revealing an incredibly long leonine tail tipped by a tuft of blood red fur. At the same time Drake's stance alters from plantigrade to digitigrade. His legs forcibly bent into those of a large Felidae.";
				say "     His shoes strain against the transformation but likewise burst around edges as Drake's feet are reshaped by the nanites into large furry paws. His transformation winding down, Drake drops to his knees, more from shock than anything else. Clenching his sides, Drake stares up at the grinning Kathy, his expression one of sadness, confusion, rage, and barely concealed betrayal. 'Why, I thought, we, the cubs?' He croaks, not used to his scratchy feline tongue or the rows of saber-like fangs lining his maw. In response, Kathy wraps her arms around her mate whispering in his ear. Though her words are lost on you, their effect on Drake is immediate. Pushing her back, Drake draws himself up to his new full height of seven feet. His eyes clear and focused, all vestiges of sadness on his face have burned off so only indignation remains.";
				WaitLineBreak;
				say "     He grasps hold of Kathy's door-jamming rump hoisting her up to his chest, with a dark toothy expression on his face. 'Eepp,' Kathy squeals, maybe regretting her decisions. Chuffing at her, Drake roughly slams his smaller lover's back against a nearby wall. He wraps her legs around his waist with but a few instructive bats of his tail, and from this angle, at last get your first look at his impressive feline package. Hanging out from its thick furry sheath is Drake's half erect barbed member. While not the largest tool you've seen out in the city, his spiny semi-hard cock measures around nine to thirteen inches in length, which for humans would be a little impressive. Complementing his fresh endowment are a pair of grapefruit-sized testicles covered in golden hair, already quivering in anticipation for what is to pass.";
				say "     Taking his partially-erect tool in hand, Drake strokes his tapered rod, getting used to its alien shape while lining himself up with Kathy's plump pussy. Seeing what he's about to do, Kathy wraps a hand under her beach ball sized belly using the other for leverage. She somehow wrangles her colossal litter out of the way, earning her a few approving rumbles from Drake as he spears her beckoning cunny with his now towering pleasure rod. Her sex splayed wide, Kathy yowls with animalistic joy as Drake bounces her on his inhumanly long shaft, creating a bulge along the top of her tummy at the height of his thrusts; almost like he was wearing Kathy like a novelty furry condom.";
				WaitLineBreak;
				say "     Perhaps wanting a taste of her lover's virility, even if it's a vicarious one, Kathy bends her sweet little muzzle against her chest. Licking the taut flesh of her swollen bump, she massages the tip of Drake's thorny spire with her rough tongue, while her tail brushes against Drake's inner thigh. Obviously wondering what she's trying to do, Drake slows his strokes, emitting an aggravated growl. 'Shh,' Kathy whispers between licks, palming his balls in her tail as if she were weighing a pair of priceless clay marbles. The lioness jiggles his freakishly huge nuts in pace with his motions. 'Doesn't your new body feel great? Don't you want to just fill me up with that beautiful lion-cock of yours, keeping my cunny nice and stuffed with your hot cum? Just imagine the two of us whelping entire prides of big sexy cubs.' She teases giving his hand-filling baby-batter-makers the lightest of squeezes with her tail. Drake, his eyes rolling to the ceiling, mutters a barely intelligible yes in reply.";
				say "     Kathy beams even brighter at this as she caresses her mate's potent manliness, urging him on. Enthralled by her words, Drake pulls Kathy closer to himself, getting a firmer grip on her shelf-like hips. He lifts Kathy half way off his goliath wang before he buries himself balls deep inside her, while remaining in a standing position. Damn he's strong! 'Ah, that's my man,' Kathy coos, her prodigious mounds loudly thumping one another as Drake pumps his exotic pole into her again and again, stimulating the sensitive glands within. Her adorable bosom doesn't need much in the way of attention for Kathy to express herself though, a reality that you can personally attest to as sheets of her motherly fluid pour down her sides.";
				WaitLineBreak;
				say "     Enchanted by the spectacle (and perhaps a little hunger to boot), Kathy slips an arm under her remarkable breasts. Groping a pair of her leaking tits, she positions the prominent nipple between her ebony lips, heartily suckling upon her own supply. Which is no minor feat given Drake's thorough pounding, but one that Drake makes a bit easier by lowering himself onto Kathy's bed. Without even slowing his pace, Drake lies back on his lover's mattress to enjoy the show; allowing Kathy to better manage his drive while still giving her walls the vigorous fucking she so desires.";
				say "     All to the lioness's ever increasing bliss as she chuffs up a storm from the sensations of Drake's magnificent barbed cock teasing her pussy and the warmth of her fresh cream sloshing around in her tummy. The act pushes the rutting pair over the edge as Drake's massive balls churn, dousing their content into the innermost depths of Kathy's womb, his sizable load further stretching out the chubby breeder. Howling in satisfaction, Kathy collapses on Drake's carved chest, her plump assets cushioning her fall. 'Mmhh, I've never ever felt so warm and full,' she says, snuggling her milk and cum bloated tummy upon her lover's stalwart abs. 'It feels like I am going to burst.' Kathy, sounding a little aroused by the idea, hums rubbing the sides of her creaking tummy, her normally pale skin pulled so taut that her belly has turned a bright pink in some spots.";
				WaitLineBreak;
				say "     Nuzzling Drake's mane, Kathy gently rolls off her mate's brawny pectorals, but somehow still manages to keep his softening package wedged in her breeder's box. Clearly she's not in any hurry to part with her new toy just yet. As she yawns contentedly, Kathy wiggles her ponderous frame into Drake's sinuous arms while resting her head upon his mane. In turn, Drake, his regal visage free of its previous ire, hugs Kathy close in a reverse spoon position, while entwining his tail with hers. In no mood to disturbed the pair's quiet moment (lord knows how you'd react in their position), you hurriedly sneak back out the front gate, praying they don't notice any messes you may have left behind. On your way to the Grey Abbey, you make a mental note to check up on leonine couple in the next few days.";
				move Player to Grey Abbey;
				now HP of Augustus Drake is 99;
				now Thirst of Kathy is 2;
				now Cock Girth of Augustus Drake is 4;
				now Cock Length of Augustus Drake is 13;
				now Ball Size of Augustus Drake is 5;
				now Sterile of Augustus Drake is false;
				now MainInfection of Augustus Drake is "Felinoid";
				now Angry Wateringcan is active;
				now Crawl out through that fallout is active;
			else if calcnumber is 3:[GTFO]
				LineBreak;
				say "     Shaking your head, you realize that you maybe pushing the envelope just a little too far here. While you might be fine transforming Drake, fucking his lover feels like a recipe for disaster. So hurriedly disentangle yourself from Kathy, you tell her that you have some vague important task to take care of and beat a hasty retreat from the Last Chance and the dry plains. Only when you arrive at the perceived safety of the Grey Abbey, do you finally relax, although on some level you're not looking forward to your return trip to the plains.";
				move Player to Grey abbey;
				now HP of Augustus Drake is 99;
				now Thirst of Kathy is 2;
				now Cock Girth of Augustus Drake is 4;
				now Cock Length of Augustus Drake is 13;
				now Ball Size of Augustus Drake is 5;
				now Sterile of Augustus Drake is false;
				now MainInfection of Augustus Drake is "Felinoid";
				now Angry Wateringcan is active;
				now Crawl out through that fallout is active;
		else:
			say "     'Found enough of felinoid cum?' Kathy asks. Shaking your head, you tell her that you haven't collected five units felinoid cum, yet. 'That's too bad, have you tried going to the park though? It should be full of my old pride by now.'";
	else if Thirst of Kathy is 3:
		say "     Gazing at the matronly lioness, you muse on how you want to play with her today.";
		say "[KathySex]";
	else if Thirst of Kathy >= 99:
		say "     They don't seem interested.";


to say KathySex:
	now sextablerun is 0;
	blank out the whole of table of fucking options;
	[]
	if Player is female and BodyName of Player is listed in infections of TaurList and BodyName of Player is not listed in infections of EquineList:
		choose a blank row in table of fucking options;
		now title entry is "Taur 69";
		now sortorder entry is 1;
		now description entry is "Have some Anthro on Taur fun and ride that rocket 69.";
	[]
	if Player is female and TailName of Player is listed in infections of TailWeaponList:
		choose a blank row in table of fucking options;
		now title entry is "Mutual tail sex";
		now sortorder entry is 2;
		now description entry is "Get some mileage out your sizable tail.";
	[]
	if Player is female:
		choose a blank row in table of fucking options;
		now title entry is "Pussy play";
		now sortorder entry is 3;
		now description entry is "Service Kathy.";
	[]
	if Player is female and BodyName of Player is listed in infections of TaurList and BodyName of Player is not listed in infections of EquineList:
		choose a blank row in table of fucking options;
		now title entry is "Taur Sub";
		now sortorder entry is 1;
		now description entry is "Let Kathy have her way with your tauric half.";
	[]
	sort the table of fucking options in sortorder order;
	repeat with y running from 1 to number of filled rows in table of fucking options:
		choose row y from the table of fucking options;
		say "[link][y] - [title entry][as][y][end link][line break]";
	say "[link]0 - Nevermind[as]0[end link][line break]";
	while sextablerun is 0:
		say "Pick the corresponding number> [run paragraph on]";
		get a number;
		if calcnumber > 0 and calcnumber <= the number of filled rows in table of fucking options:
			now current menu selection is calcnumber;
			choose row calcnumber in table of fucking options;
			say "[title entry]: [description entry]?";
			if Player consents:
				let nam be title entry;
				now sextablerun is 1;
				if nam is "Taur 69":
					say "[KathySex1]";
				else if nam is "Mutual tail sex":
					say "[KathySex2]";
				else if nam is "Pussy play":
					say "[KathySex3]";
				else if nam is "Taur Sub":
					say "[KathySex4]";
				wait for any key;
		else if calcnumber is 0:
			now sextablerun is 1;
			say "     You don't feel like fucking Kathy after all.";
			wait for any key;
		else:
			say "Invalid Option. Pick between 1 and [the number of filled rows in the table of fucking options] or 0 to exit.";
	clear the screen and hyperlink list;

to say KathySex1: [Taur 69]
	say "     In the mood for a little taur on anthro action, you hop into bed with Kathy and roll onto your back, your legs submissively tucked into your bestial chest, putting your horny snatch on full display for the diminutive lioness as you offer your body to her. Boasting a hungry grin, Kathy scoots up beside your tauric sex. She unsheathes a single ivory-clawed finger and traces your nether lips with a long drawn out stroke with the flat of her talon saying, 'Aw, does mommy's good girl need their cute little pussy licked?' You nod in need, shuddering from the unique sensation of Kathy's unerring smooth nail caressing your feminine flower. 'Hm,' Kathy snickers, 'such a good girl, why don't you just sit back and let momma Kathy take good care of you then.' She says seating herself upon your lower body, draping her plump velvety legs around your side for support.";
	say "     She rests the soft, pillowy mass of her over-padded womb against your lower body, giving you a great view of her glistening ebony muff. She looms over your feral sex, batting her tail invitingly, filling your world with her soothing maternal scent. As she leans in, you can feel her nuzzle her soft furry muzzle between your hind legs. Her warm breath titillates your waiting passage while her whiskers tickle your inner thighs. Being a little top heavy though, her sextet of mountainous breast flesh threatens to pull the tiny woman off your tauric half. Thankfully, your bottom legs are there to brace the mini lioness with a tiny bit of creative positioning. Finding a proper balance on your considerably larger frame, Kathy laps at your supple labia, lavishing the sensitive area with her rough, dexterous tongue. The strokes of her alien appendage are at once pleasing, coarse, and smoother than any latex as she probes your feminine tunnel. ";
	WaitLineBreak;
	say "     You can feel Kathy circle your tauric sex with her oral muscle, teasingly slipping her feline tongue around your clitoral hood as she suckles on your bestial button. The tender gesture sends crackling waves of electrostatic rapture up your spine making you almost want to buck as Kathy slides a pair of fuzzy fingers into your maidenly passage. Gently at first, you feel her pump her paw-like digits along the damp walls of your tauric pussy. Gradually increasing her pace, Kathy alternates her thrusts and licks in near perfect sync as she massages your tauric cunny as if she had something to prove. Her delectable motions leaves your womanly folds writhing in ecstasy at her touch and sensation of her soft body rubbing against you. With each pass of her exotic fleshly barbs running roughshod over your scenes, you barely even feel Kathy's leonine tail coil about your neck like a fuzzy choker.";
	say "     With a little pull, she draws your [FaceName of player] face close like a pet on a leash, chuffing, 'Does my sweet girl want a taste of momma's yummy pussy,' as she sways her broodmother-sized hips enticingly. Ripples of gold pass through her pudgy golden tushy fur like a field of wheat swaying in the breeze as she further saturates the area with the scent of a horny yet thoroughly seeded lioness. Yes, you simper, not wanting to be ungrateful for her attention. You prop yourself up by the elbows taking hold of Kathy's enormous plush bottom with your dominant hand, while you fondling her silken belly fur with your forepaws.";
	WaitLineBreak;
	say "     Delighted at the way your paws sink into her doughy flanks, you use her colossal marshmallow-esque butt for support. You lean your anthro half forward, bringing your [FaceName of player] lips to hers. Though a part of you can't help but sneak a gaze at the cute little furrow your paws make in Kathy's six hopelessly engorged breasts resting along the soft creamy mass of her cub swollen belly. You wonder who could resist such an offer, slipping your own [FaceName of player] tongue into her glossy black-lipped cunt. Intimately licking her petite flower, a sweet almost sugary drool-inducing flavor explodes across your taste buds. Enthralled by her rich honey, you feel almost compelled to smother your [FaceName of player] face into her thong devouring ass, delving Kathy's fertile passage. Though any undeniably small woman, her molten satin walls are loose enough to take a [one of]panther-taur[or]tiger-taur[or]Minotaur[or]demon brute[or]wolf-taur[or]hermaphrodite dolphin[at random], a testament to the plump short stack's elasticity, you opine.";
	say "     But under your expert ministrations the chubby breeder's muff rapidly clamps down on your oral muscle, saddling it as if it were a cock that could somehow fill her. An unusual sensation to say the least, but it does make it easier to please your fecund partner's delectable pussy though. 'Ah, good girl, you know how to treat a momma don't you,' Kathy mews, dipping an entire hand into your tauric passage. Unrestrained by the limits of lesser forms, your tauric tunnel stretches enough to fit her arm all the way to the elbow in one loud toe curling thrust. Swooning at her touch, you feel Kathy's clawed invader worming its way down your lower body filling you in ways few humans and most mutants rarely can. Not merely content with simply fisting your inner most depths like a perverse parody of a Chinese finger trap, Kathy pistons her arm back and forth along the length of your tauric sex, as she licks the edges of your packed cunt.";
	WaitLineBreak;
	say "     She gradually hilts more of her arm into your exotic sex till her whole arm is lost inside your tauric muff. The sounds of lewd slurping noises echo throughout the room as Kathy jackhammers your hybrid body till you could swear you feel paw rifling your lowermost ribs. Panting with joy, formless motes of monochromatic light dance across your field of vision as Kathy's zealous spine-tingling efforts almost causes you to lose hold of her snuggly bottom. Her tail, however, is surprisingly adept at keeping your head buried in her beautiful midnight lily. You savor her delightful syrupy flavor and the alien rubbery texture of her breeder's box, while your snatch gets thoroughly used. You can't resist the urge to grope the heavyset lioness's lush milky teats with your forepaws.";
	say "     Almost packed to the brim with delectable cream, you can practically feel her rich bounty wallowing within her perky breast as your paws gently knead the sensitive tissue. Looks like her kittens are going to be eating well, you murmur as your antics evoke a warm light trickle of cream from the seeded cat-girl's chest. 'Ah, does my big girl want a nice milky drink? I have plenty to share,' Kathy mews happily as she leans into your touch. Her milk dribbles down your forelimb in a pearly stream of white as your paws tweak her puffy nips. Maybe later, you've got quite the meal here, and you won't want to spoil your appetite after all. You chuckle contentedly flicking your [FaceName of player] tongue along the edges off her clitty hood. 'Oh we wouldn't want the sweetie,' Kathy purrs in a pleased tone as she returns the gesture. She slips your feral joy buzzers between her thin clit pillows as if she were suckling while dexterous digits ravish your animalistic sex.";
	WaitLineBreak;
	say "     Her exotic padded fingers and unique tenor of her purr plays wonderfully with one another as Kathy's exotic biology graces your bitch button. A section of your altered psyche almost regrets that you don't have something a bit more substantial for her to pleasure as her fleshy oral barbs stimulate your feminine folds. You can only imagine how sinfully sweet it would be. Regrettably, such fanciable thinking is cut off as familiar pressure wells within you. You know you can't last much longer as you bite your lip, desperately trying to edge out just a few more moments of bliss, a sensation mirrored by Kathy. Her muzzle still buried in your groin, mews in a desperate whining tenor, 'F-f-faster.' Well if she insists, you muse, flicking your tongue along Kathy's feline button at a pace that would put at a pit viper to shame as you nuzzle her dripping fuck hole. Buckling from your loving efforts, Kathy is unable to contain herself any further as she roars in a way only a beast sated could; squirting a delightful river upon your [FaceName of player] chin in time with your own knee shaking orgasm.";
	say "     Kathy rolls off your tauric half to lay beside you saying, 'Mmhh, you know, I just love the cute look of a well-fucked tauress,' as she watches you lick last few dribble of fem cum from your lips. 'So, does my girl feel better now?' Kathy asks as you feel yourself blushing under her praise. Nodding, you crawl over to her side and take her soft body into your many limbs. You draw her close for a quick kiss. 'Good, I wouldn't want my sweet girl to suffer. Though if you're still feeling a little needy, you should pop down stairs to see Drake. Nothing cures heat like a bun in the oven,' Kathy chuffs tracing a claw along your sides.";
	NPCSexAftermath Player receives "OralPussy" from Kathy;

to say KathySex2: [Mutual tail sex]
	say "     Sauntering up to your fecund feline playmate, you coil your tail about your dominant arm as if to show it off. You ask her if she might be up for the kind of fun that only two people with tails like yours can have. 'Hm,' Kathy rumbles, eyeing up your [TailName of player] tail appreciatively, 'well now that you mention it, I haven't had hands free fun in a while. So why don't you come here sweetie. Show me what that monster of yours can do.' Kathy trills patting the bed beside her. Grinning happily, you plop down on your side next to her and worm your tail towards her groin. 'Ah hold up there eager beaver, we got to do one thing first,' Kathy tuts grabbing hold of your spare limb with her own. Curious, you ask her what. 'Lube it up silly head, I am not taking a toy raw. I learned that lesson the hard way when I was playing around with a latex vixen in the Red Light District. Don't worry, I won't take too long, you can just sit back and enjoy the show cutie.' Kathy quips with an adorable wink, nestling your extra appendage to her between her triple tiered breasts.";
	say "     'Oh its so thick and muscular,' Kathy titters, giving your [TailName of player] tail a squeeze. 'I'll bet you have a lot of fun with this thing don't you?' Kathy remarks as she presses her arms against the sides of her furry chest. 'Ah look, it's such a nice fit, don't you think?' she teases, mushing your dexterous limb between her rows of warm milky breasts. Snickering in agreement, you tell her that you're glad that she likes it, your feral partners rarely appreciate your tail. 'Tsk, silly little mutants, they don't know a good thing when they see it. It's just dick this, pussy that, blah-blah-blah tail holes, all the time,' Kathy sighs while rolling her eyes. 'I swear if it's not connected to breeding it seems like they ignore all the other fun parts of a person,' Kathy chuffs, resting her chin to her tawny chest as licks at your tail tip, while her leonine limb strokes the length of your [TailName of player] tail. 'Mh earthy,' Kathy simpers as she laps at your rear mounted limb. Though you might not have the necessary nerves to fully enjoy the sensation of barbed oral muscle titillating your [SkinName of Player] skin.";
	WaitLineBreak;
	say "     The way that she looks at you with her cute kitty eyes as she fellates your tails with exaggerated laps of her tongue, sends your heart a flutter. Flashing you a knowing look, your short catty lover seems to pick up on this as she pumps her engorged tits along the length of your tail. Her clawed finger digging deep furrows in her heavy breast flesh as milk beads from her ebony teats. God she looks so hot right now. You simper as Kathy tweaks one of her stiff teats, splattering your [SkinName of Player] hide with her pearly bounty. Using her free paw, the gravid cat girl strokes the errant cream along the length of your entwined limbs. And with bat of her eyes and a nod of her head, Kathy invites you to partake of her milky mess. Well, you were feeling a tad peckish so why not, you opine as your stomach lets out a low rumble as you arch your neck to her chest. Without any hesitation, you lick at your entangled limbs, lapping up rivulets of thick tasty cream till your limb seems to shine in the available light.";
	say "     Once their suitably coated, Kathy disentangles her tail from yours and gestures with a bob of her muzzle to her groin saying, 'Go on now sweetie, show me what you can do,' As she rolls on her back and lifts her heavily pregnant belly out of the way for ease of access. Smirking at how adorable the tiny lioness looks with her taut tubby tummy swaddled her arms and plump ebony cunt on display, you languidly tease your tail along the edges of her sweltering vulva, caressing her beautiful midnight lily with your moist tail. 'Hey s-stop teasing me there, you're gonna make me drop them.' Kathy pants, patting her belly fur as you grind your [TailName of player] tail about her feline hood. Well if she insists, you muse arching your tail into a U-bend and thrust. 'Oh dear sweet Drakey [bold type]YES[roman type],' Kathy roars as your dexterous limb surges forth and roughly splay her inviting nether lips.";
	WaitLineBreak;
	say "     A part of you marvels at how her toasty well-used sex seems to devour inch upon inch of your sizable tail. Kathy groin seems swell with its presence. 'Mff so full,' Kathy trills as she lets go of her tummy, letting it plop on her lap with a cute little thump. Without missing a beat, you piston your rear-mounted appendage with all your might. Bouncing her bountiful body on your [TailName of player] tail, you slowly pick up your pace till her whole form ripples from the force of your passionate thrusts. Her body is reduced to a sea of squirming tallow as you watch her milk-filled breasts bounce and slap each other, filling the room with the sounds of their meaty collisions. As cream spurts for her chest in lewd fountains of white, her tummy is a riot of activity.";
	say "     Entranced by the spectacle of her lush bouncing body and the wonderful feeling of Kathy's tightening passage gripping your limb, you barely notice her tail sneaking between your thighs. Though you certainly feel her moist fuzzy limb as she coils it into a knotted bulb and spears your loins. You cry out both in surprise and in rapture as the thick knotted limb penetrates your opulent depths with a sordid jab. Kathy doesn't even give you time to recover as she pounds her coils against your eager passage. Your muff throbs with her presence almost singing with elation as your body struggles to accommodate her. You're soon reduced to panting like bitch in heat as her limb innervates your sensitive nerves. Fuck she's huge, you pant flopping on your back as your tongue lolls out of your mouth as she ravages your needy passage.";
	WaitLineBreak;
	say "     '*Nya*, thanks beautiful, this little trick of mine works wonders on big girls like Ava. I thought you might like it considering all the mutants you probably run into.' Kathy mewls, tucking her arms behind her head as she watches her boisterous body jiggle before her. Cooing in agreement, you're unable to deny the appeal of her technique as your fingers drift to your stuffed cunny. You paw at the visible bulge of her tail, your digits brushing the outline of her knotted limb, the sensation emanating from your altered sex is at once so odd, yet also so right to you. Something about the way Kathy's tail shifts and squirms like a living thing that knows your body's needs almost as well as you do. Her masterful ministrations never seem to titillate the same nerve twice, so your pleasure never plateaus. It takes all your will and torn focus to keep your crude pace with her. Your pride compels you on though as you piston your [TailName of player] tail as hard as your anatomy allows.";
	say "     'Oh fuck yes, just like that sweetie, fuck momma's pussy like you mean it!' Kathy chuffs as she glances over at you with a lustful twinkle in her eye. Needing no further encouragement, you let loose knowing on some level she'll take anything that you can dish out. You push your altered anatomy harder than ever before. Slamming your pliable limb almost to the lowest vertebrae, till your tail bumps her spasming cervix. Far from bothered by the intrusion, the eager brood mother's nanite twisted sex almost seems to draw in your tail like it were cock to be serviced. You can hear her purr loudly and happily as her body stretches and conforms to you like the perfect flesh glove. Her natural warmth spreads down your dexterous limb and up the base of your spine with each thrust as Kathy looks like she's nearing climax. A good thing too, as you can barely hold on much longer yourself as heart races and sweat beads down your form. Your body struggles to endure, to ride out the waves of bliss crashing over your senses, yet you only push back so long.";
	WaitLineBreak;
	say "     Then at last, your resistance breaks as fireworks explode across your vision and you howl half in joy and half in defeat as your spasming body cums. Feminine honey mixed with perspiration gush across the bed sheets. And almost on cue, your feline lover mewls with elation as she finishes a close second, spraying her lurid lady leavings down the base tail and dirtying the covers beside you. Collapsing in a happy pile, the two of you lay there for a moment still 'tied' to each other as you pant for breath and bask warm, full feeling perforating your being. Kathy though is the first to break the silence saying. 'Mh, that was quite the performance sweetie. Have you thought about getting into show business? You've certainly got the drive.' Flashing her a grin, you tell her that the thought hadn't crossed your mind, but with a body like yours could certainly make a good money as a cam girl. 'Well if you ever do, I promise I'll be your first subscriber, or guest, if you keep this up,' Kathy replies with a wink as she disentangles herself from you.";
	PlayerEat 5;
	PlayerDrink 5;
	NPCSexAftermath Player receives "PussyDildoFuck" from Kathy;

to say KathySex3: [Pussy play]
	say "     Seating yourself beside Kathy, you teasingly give the voluptuous lioness's soft tawny tummy fur a tussle asking if what people say about pregnant pussy being the sweetest there is? As you lick your lips provocatively. 'Tee-hee, I don't know, it might be. Why do you ask, is my girl a little thirsty?' Kathy responds with a pleased purr. Well if she's offering, you wouldn't mind finding out, you tell her. 'Well my eager adventurer, I have been feeling a bit pent up lately and as much as I'd like to keep Drake's [']head['] firmly between my legs at all times, my poor boy has to keep this place safe for the cubs, so I don't think he'll mind if you fill in for a little while he's busy.' Kathy titters, scooting over the edge of the bed. She leans back, spreading her ample thighs. The lush lioness hefts her plush tawny gold tummy and collection of taut milk tanks out of the way of her shiny ebon muff.";
	say "     'Go on dear, eat up. I'm curious to see how that [FaceName of player] tongue of yours stacks up to Drake's,' Kathy coos in an encouraging trill as she fans her fecund muff with her fluffy feline tail, impregnating the air with her exotic catty scent. How could you say no, you joke, eyeing up her inviting form for a moment. You drink in the sight of her thicc and fluffy legs that could crush a man's skull between them. If they weren't smothered by her rolls of her pump furry leg first, and her dark, plush, pregnancy-plumped pussy, so hopelessly engorged giving her a cute chubby pad on her feminine folds. All of which is capped off by her massive baby maker and framed by her sextet of ample breasts. Each one cradled by her lush pudgy arms as she invitingly massages her bloated milk tanks, While her unborn brood squirms and struggles in her grip like a bowl of tawny golden jello. As you kneel down beside her, a part of you is almost curious (or perhaps jealous) of how it must feel to sink her paws into the growing turgid mass everyday.";
	WaitLineBreak;
	say "     'Enjoying the view down there sweetie, or are you just intimidated by this big milfy body of mine?' Kathy jibes proudly as she drums her finger along the taut hemline of her stomach. 'Either way, I can't say I blame you. There's just so much of me to enjoy, but do hurry up. I can't hold this pose all day. The cubs are rather heavy.' Kathy giggles as she rubs on her silky foot paws along your [BodyType of player] sides. Of course, you simper, easing yourself between her mammoth thighs. Sinking your fingers into dense love handles for support, you can't help but marvel at how soft and yielding her portly body is, almost like she's made out of dough. You nuzzle your [FaceName of player] face next to her ebony nether lips, inhaling the heady scent of seeded lioness while her lush thighs tease your cheeks invitingly. You can feel your mouth practically water with anticipation as you waste no time in giving her chubby pad a drawn out lick.";
	say "     The portly lioness's body quakes with delight as your oral muscle skims her catty button and rubbery hood. Ah, does she like that, you purr, flicking along the length of her meaty folds sampling her sugary fem honey. '*Nya*, yes, more. Momma wants more,' Kathy mewls wrapping her downy soft legs around your neck and shoulders. She pulls you in closer with her paws, trying to lock your head in place with her silken thighs. Not that you need the encouragement even as she lightly grazes her toe talons along your back. Nowhere near hard enough to harm you but enough so that you appreciate the dissonance between razor talon and her plush body. All while her tail glides across the skin of your [bodytype of player] torso teasing and groping your [breast size desc of Player] tits encouragingly. Of course, you murmur with a pleased trill as your lips kiss her plump feline slit.";
	WaitLineBreak;
	say "     Much to your pleasure, you can feel her Rubenesque body tremble at the touch of your lips meeting as you lavish her petals with affection. Each tender innervation of your oral muscles earns you a light gush of warm sugary juices. You coo delightedly as the sweet fluid flows along your tongue like rich floral balm titillating your taste buds as you suckle her slick ebony sex. 'Mh yes, just like that! Worship mommy's button like it deserves.' Kathy moans, giving your neck another tight squeeze with her thunder thighs. As her tawny fur graces your cheeks, a part of you can't help but enjoy the sensation of her soft body caressing you as your tongue probes her tender muff. Her needy plump pussy walls are so swollen and engorged with arousal. They practically milk your oral muscles like its some studs throbbing rod. This thought only encourages you more as you slide one of your arms out from under her, adding your dominant hand to the mix. You alternate between deep explorative licks and a light fingering of her welcoming passage.";
	say "     With each little lap of your tongue you slip one finger after the other into her dewy passage. Her accommodating sex almost seems to gorge on your knuckles as they brush her sodden as if your little digits quench her body's need. Not one to deny her, and perhaps a little curious how much she can take, you tuck your fingers into a spear-like point and hilt yourself to the wrist in her elastic snatch with one fanciful flourish. Your fecund friend purrs with abandon from behind her mountainous mound in adoration at this. While your tongue laps at her stretched ebony cleft as if to sooth her taut over-stretched labia, caressing her sodden hood, your inquisitive digits probe her wet needy walls. 'Ah-ah that feels amazing sweetie, It's too bad this big heavy belly of mine is in the way. I'd love to see your work down there. Oh, you should totally remind me to put up some mirrors in here one day.' Kathy murmurs.";
	WaitLineBreak;
	say "     Glancing up from her cunny to ogle the cub swollen orb swaddled in Kathy's arms you admit on some level that would be pretty hot. You'd get to see all the cute little faces she makes. Still though, there is something to be said for your current view, you add giving her pump swollen fuzzy navel a kiss. 'Oh, does my girl like having my big bouncing baby bump in her face then?' Kathy asks in a sing-song tone. Tittering, you tell her you can't say you don't enjoy her condition. Alongside all the perks that come with it as you reach around her sizable body and give her hefty tits a cheeky squeeze. 'Good, because I plan on staying like this forever, and I could use an eager pillow sister to play with.' Kathy purrs placing her paw over your free hand. She gently guides your palm over breasts and swollen furry midriff, saying. 'And something tells me that too wouldn't mind filling that role dear.'";
	say "     Giggling as your digits massage her feline clitty between your thumb and pointer finger, you reply that doesn't sound too bad. 'Ah-Ah, th-that's good to hear dear, now deeper and I want to see what those little fingers of yours have learned out there!' Kathy pants happily. Well since she asked so nicely, you muse grinning ear to ear as you form your fingers into a tip and thrust. Much to your manna, her gaping cunt swallows your arm to the elbow, engulfing your arm in warm, eager pussy flesh as her sex stretches to the most delightful proportion. Almost wearing her like a glove, you can just about see the outline of your limb expressed in her taut fur as you pump your whole arm like a living piston. The thrum of your activity fills the room with wet squelching noises that seem to echo through the quiet hotel coupled with the sweet sound of feline arousal as you lavish her innermost depths. Kathy mewls and squirms at your touch. Her nether muscles clench and writhe around arm as she cries for more like the insatiable beastess she is.";
	WaitLineBreak;
	say "     Her attitude is highly infectious as you find yourself lapping and kissing the abused box while your free hand roams her gravid body with wild abandon, tweaking her erect nip and groping her bloated breasts. But she can only hold so long as to nibble her stiff button. You can feel the lurid spasms of her fecund passage growing in ferocity till at last she finishes with an almost defeated roar. As she blasts a swift trickle of feminine along the length of your torso and soaking the bed sheet beneath her. 'Ah, I-I really needed that sweetie, thank you.' Kathy chuffs as you pull your arm out her with a moist pop. Looking at her slut stained blanket, you're inclined to agree. 'Mh although, that did work up my appetite a bit. Say would you like a drink, I don't think the kittens mind,' Kathy asks, gesturing to her heaving bosoms. Shaking your head, you turn her down for the moment. ";
	if "Touched by Madness" is listed in Feats of Player:
		say "Maybe next update. ";
	say "Oh well suit yourself. More for me I guess,' Kathy replies, bringing them to her lips. She wastes no time in suckling from her own supply and seems to forget your presence as she gluts herself, leaving you to see yourself out.";
	NPCSexAftermath Kathy receives "OralPussy" from Player;

to say KathySex4: [Taur Sub]
	say "     'Aw is my girl feeling a little pent up again?' Kathy asks with a caring look in her eyes. You nod in the affirmative. 'Well, I don't mind helping you out dear, so long as I'm on top,' she says, sizing up your larger form. 'No offense sweetie, but you, um might be a little heavy for me and the kittens,' she adds, patting the bed sheets beside her. Grinning happily, you bound up beside your leonine playmate and roll on your back exposing the length of your [bodytype of player] body to her with your forelegs tucked neatly to your chest in a cute begging pose. 'Oh, I love that look, it's so cute,' Kathy trills, as she takes in the sight of exotic form on full display. 'You know,' she smirks, tapping a clawed finger to her lip, 'I was going to use my tail on you, but I think my girl deserves a special treat instead. Would you like that dear?' Kathy says, leaning over to her nightstand. Nodding, you watch as she opens one of the draws and pulls out a pink double sided ";
	if "Touched by Madness" is listed in feats of player:
		say "sixty centimeter long ";
	else:
		say "two foot long ";
	say "dildo shaped like a comically-oversized pink canine's pecker, knot and all, alongside a clear packet of hypoallergenic water-based lube.";
	say "     '*Sigh* I still can't believe Ava never lets me use this thing on her. Poor thing,' Kathy tuts, tapping a clawed finger against her toy. 'She keeps saying it looks too much like the real one, but,' Kathy smirks, 'something tells me you don't mind now, do you sweetie?' Kathy asks, slicing open the packet of lubricant with one clean swipe of her claws. She smears the contents along the length of the thing in long drawn out practiced strokes. Flashing her a lustful grin, you inform Kathy that you're fine with this. 'Wonderful, now you just relax and let mommy take care of you,' Kathy purrs, saddling her gravid body behind you. 'Mh [Name of Player], has anyone ever told you taurs make great pillows?' Kathy queries, gently propping her heavy brood-swollen midriff on your animalistic half while she wedges her not so little toy between you two with her tail. Shaking your head as her well-lubed tapered toy brushes your sex, you tell her not often enough. 'Well,' Kathy titters, running her fuzzy padded fingers down the breadth of the inner thigh of your dominant hindleg, 'it's true. You cuties are just perfect for my needs.'";
	WaitLineBreak;
	say "     'You're soft where it counts,' Kathy teases, tracing a lazy circle in the [skinname of player] skin of your [bodytype of player] undercarriage with her pointer claw, 'and supportive where I need it.' She swoons, giving your legs a squeeze as she eases her groin next to yours. 'But, you know what I love most about taurs?' she asks, flashing you a lascivious single-fanged grin. No, you tell her. 'Why,' she pauses to lean over your rear and kiss the center of your paw, 'it's the look they make when they get fucked.' Kathy rumbles as bucks her hips forward slamming her toy home. F-f-fuck, you simper, as that dripping knotted toy penetrates your feral sex with a low wet squelching sound. 'Ah, that's the one,' Kathy mews as she works her voluptuous hips, jamming the slick toy almost to the faux knot. Her body ripples like a bowl of tawny jello with every motion. Though she's not merely content to simply pound your puddling sex.";
	say "     The busty cat girl brings her tail to bear as well as she roughly pistons the length of her toy between you, swaying her broodmare hips like a woman possessed. Your tauric body takes this all in stride, reveling in sensation of that buttery-smooth plastic knotted tool splaying your sex wide. Your eager cunny almost sings with elation as Kathy's toy massages your needy [cunt size desc of player] folds. You watch the heavy set lioness['] fecund figure bounce beautifully upon your lower half with each gesticulation. Enthralled by the sight and sensation of her taut glowing pelt caress your hide, you can't resist reaching out with your forepaws to tenderly caress her heaving collection of sweater puppies. God damn she's stacked, you tease delightedly at how her perky flush furry orbs fit so perfectly in your grasp. 'W-why th-thank dear,' Kathy stammers as she rocks her hips back and forth along the length of her toy.";
	WaitLineBreak;
	say "     Her heavy body wobbles delightfully in your eager paws. A part of you can't resist indulging in this rare tactile treat as your mitts comb her fecund figure. The sensation of her doughy form brushing your paws pairs so perfectly with the exotic shape of her toy moiling your receptive sexes as the matronly lionesses jackhammers the faux-knot between you with her tail with ever increasing vigor. With each sordid thrust, you sense the exotic knotted toy sinking deeper and deeper past your well-lubed vulva, innervating the lurid depth of your hybrid passage. Even your clit is rocked with replete rapture as that girthy buttery-smooth knot graces your taurhood. Panting with unrepressed delight as the blissful sensations of your well-used sex and the gentle touch of Kathy's fur caressing your lower half blends together in a heady emulsion that almost overcomes your senses. Your forelimbs languidly massage the gravid cat girl's flared hips and tender bubbly bottom.";
	say "     Much to her apparent pleasure as Kathy presses her form against your roving peets, saying, 'Ah your paws feels heavenly sweetie, you really know just how to treat a girl, don't you?' as she fondly strokes your inquisitive pawbs with her taloned fingers while she bounces upon your tauric form. Giggling coyly, you remark that certainly have been getting a lot more practice since the nanite outbreak, although few of the local ferals appreciate it the same way that she seems to. 'Tsk, s-silly brutes don't know a g-good thing when they s-see it,' the seeded lioness moans playfully, rubbing one of your hind paws with her free hands. 'Why, if you keep this up, I might be tempted to take you on as my own personal pillow, or maybe a cute little tauric palanquin,' Kathy mews, patting your lower half affectionately and grinding her cub-swollen middle along your lengthy body with each thrust of her hips. Blushing as much as your [SkinName of Player] hide will allow at her touch, you reply through pleasure-gritted teeth as the slick toy slides between your sodden cunt, that might you like that.";
	WaitLineBreak;
	say "     Especially if she keeps pounding your cunny like this, you swoon, feeling the faux knot brush a particularly sensitive spot, sending flares of molten toe-clenching Elysium coursing through your tauric form. 'Of course dear, I *huff* love *huff* taking care of my girls,' Kathy gasps in blissful tenor as she takes hold of your handlebar-like legs for support. You watch as she pushes herself harder and harder with every thrust of her shelf-like ass. You can tell she's nearing her limits as her tongue lolls from the side of her muzzle in a base expression of bliss and your own animalistic sex thrums with elation as your [cunt size desc of player] muff hungrily clenches around her knotted tool. You pant with unrepressed joy as your tender muscles milk the bestial lascivious curves of the toy's animalistic taper with every motion of Kathy's fecund hips. The fem honey drenched knot is almost hilted in your toasty nether lips, nearly packing your sex to the brim with her sordid tool. Your heart races, ears pound, and body thrums with jolts of ecstasy.";
	say "     As the entwining sensation of Kathy's fecund form pressing against you melds with the heady echoes of her tool ravaging your sex, waves of bestial bliss wash over you like the ripples in a still pound. You try to hold on, to crest each pulse of fresh delight, but your willpower can only out so long till you finally climax with a great bestial roar of satisfaction as you finish. In seconds, Kathy's voice mingles with yours as she eases herself into the welcoming embrace of your feral half, totally spent. 'Ah, mommy needed that, hope it was fun for you too sweetie,' Kathy mews, gently crawling over your lower half. The pleased cat girl seats herself on your anthro waist, before leaning in and nuzzling her face against your [breast size desc of Player] chest, saying, 'We should do this again sometime.'";
	WaitLineBreak;
	say "     Rumbling happily at the touch of her whiskers teasing your core, you affectionately stroke her adorable feline ears while your forepaws gently grope her sizable ass and pillowy thighs. You tell her that you just might. 'Good, just don't make me wait too long. You have no idea how frisky the cubs can make me. Ha, or maybe you do,' Kathy swoons, rolling off your upper torso with a well-pleased smirk on her catty face as she gives her tummy a loving pat. Shrugging you turn to face her, and drape your arms about her for a quick goodbye hug, replying that you'll keep that in mind.";
	NPCSexAftermath Player receives "PussyDildoFuck" from Kathy;
	NPCSexAftermath Kathy receives "PussyDildoFuck" from Player;


Section - 3 I'd be a silly so and so, if I should ever let it go

Table of GameEventIDs (continued)
Object	Name
Crawl out through that fallout	"Crawl out through that fallout"


Table of WalkInEvents (continued)
Priority	Name	EventObject	EventConditions	EventRoom	LastEncounterTurn	CoolDownTurns	EncounterPercentage
2	"Crawl out through that fallout"	Crawl out through that fallout	"[EventConditions_Crawl_out_through_that_fallout]"	Room 020	2500	2	100

to say EventConditions_Crawl_out_through_that_fallout:
	if Thirst of Kathy is 2 and HP of Augustus Drake is 99:
		now CurrentWalkinEvent_ConditionsMet is true;

Crawl out through that fallout is a situation.
ResolveFunction of Crawl out through that fallout is "[ResolveEvent Crawloutthroughthatfallout]". 
Sarea of Crawl out through that fallout is "Nowhere".
Crawl out through that fallout is inactive.

to say ResolveEvent Crawloutthroughthatfallout:
	if Player is Female:
		say "     Striding over to Kathy's bedside, you ask the luscious breeder how things have been since Drake's transformation. 'It's been better than I could have hoped ever for. Thank you, thank you so much,' she exclaims, wrapping her arms around you in a brief bear hug. So no bumpy spots, you ask, taking a seat beside her. 'Well he's still a little grouchy sometimes about the whole [']losing his human form thing,['] but that helps keep things interesting. If you wanted, you could even give him spin a little later, though you may want to um, limber up beforehand. Who knows? If you're lucky you might end up with some cute little cubs of your own,' Kathy teases as she eyes up your midriff.  'But first, I think you, my obedient little human, deserve a treat. So tell me, what can momma Kathy do for her sweet girl?' She says tracing a claw down your side.";
		now Thirst of Kathy is 3;
		now Crawl out through that fallout is Resolved;
	else:
		say "     Striding over to Kathy's bedside, you ask the luscious breeder how things have been since Drake's transformation. 'It's been better than I could have hoped ever for. Thank you, thank you so much,' she exclaims, wrapping her arms around you in a brief bear hug. So no bumpy spots, you ask, taking a seat beside her. 'Well he's still a little grouchy sometimes about losing his human form, but that helps keep things interesting. Speaking of which, I have something for you my sweet little helper boi,' Kathy says, crawling over to her nightstand. She slides open the draw and fishes out a still sealed box of Valentine's day chocolates and a few scripts of plasticized paper with QR code on them.";
		say "     Tucking them under her arm, Kathy scoots back over to you and places them on her lap saying. 'Here, your reward for helping me, you deserve every freecred.' Wait QR codes for freecred and a box of chocolate, you thought you were getting a more physical reward for your services, you query. 'Oh my dear little human, I don't remember saying anything of the sort. Why if I recall,' Kathy taunts, playfully tapping her chin. 'I never promised you anything. I merely implied we could help each other out, and here.' Kathy taps the box of snacks with her thumb, 'is my help. A little sweet treat for my sweet little monkey,' She smirks and pats you on the head like she were comforting a special needs animal, 'and a couple of freecred so you can buy something to wash it down with.' Raising a perturbed eyebrow, you argue you thought it was implied that she would. You know...";
		WaitLineBreak;
		say "     'Oh dear, my apologies,' Kathy gloats, touching her fingers to her lips in an exaggerated gesture of surprise. 'I'm still new to this whole language thing. I had no idea you would get such a wild and fanciful idea stuck in that empty monkey head of yours from a mere suggestion. But by all means,' she smirks wickedly, 'go talk to Drake if this irks you so much. Maybe the two of you can work some sort of sharing arrangement. I'm sure he'll be very amiable,' Kathy jeers, in a mocking tone with a mild undercurrent of threat. Grumbling in reply, you tell her that that won't be necessary and snatch up the pittance you are offered then stuff in your inventory. 'That's a good boi, now run along. I'm sure you have places to be and mutants to do after all.' Kathy says in a mocking tone as she waves her left paw at you in a dismissive gesture.";
		now Thirst of Kathy is 100;
		ItemGain chips by 1;
		increase freecred by 100;
		now Crawl out through that fallout is Resolved;

Kathy ends here.
