Mistress Snuggle By Sundered Dragon begins here.
[Version 1 act one set up]
"Adds a moddable vulpine infection and goopy mistress to Flexible survival."


Table of GameCharacterIDs (continued)
object	name
Mistress Snuggle	"Mistress Snuggle"

Mistress Snuggle is a woman.
Mistress Snuggle is in Nowhere.
ScaleValue of Mistress Snuggle is 5. [4' 6"]
Body Weight of Mistress Snuggle is 9. [scale of 1-9 for body weight, grouped into low weight (1-3), mid weight (4-6) and high weight (7-9)]
Body Definition of Mistress Snuggle is 3. [scale of 1-9 for body definition, grouped into low muscle (1-3), mid muscle (4-6), high muscle (7-9)]
[Body Adjective is generated out of the body weight and body definition and can be used in scenes - one word descriptive adjective depending on weight and definition groups: low weight group: skinny/slender/lithe; mid weight group: average/fit/muscled; high weight group: pudgy/husky/jacked]
Androginity of Mistress Snuggle is 9. [Gender Adjective is generated out of androginity 1-9: hypermasculine/masculine/somewhat effeminate/effeminate/androgynous/feminine butch/tomboyish/feminine/hyperfeminine]
Mouth Length of Mistress Snuggle is 7. [inches deep for face fucking; maximum possible will be double this number (when deep throating)]
Mouth Circumference of Mistress Snuggle is 4. [mouth circumference 1-5, "tiny, small, normal, wide, gaping"]
Tongue Length of Mistress Snuggle is 6. [length in inches]
Breast Size of Mistress Snuggle is 9. [cup size as number, counting Flat Pecs = 0, A = 1, B = 2, ...]
Nipple Count of Mistress Snuggle is 6. [count of nipples]
Asshole Depth of Mistress Snuggle is 6. [inches deep for anal fucking]
Asshole Tightness of Mistress Snuggle is 2. [asshole tightness 1-5, "extremely tight, tight, receptive, open, gaping"]
Cock Count of Mistress Snuggle is 0. [number of cocks]
Cock Girth of Mistress Snuggle is 0. [thickness 1-5, thin/slender/average/thick/monstrous]
Cock Length of Mistress Snuggle is 0. [0 Inches]
Ball Count of Mistress Snuggle is 0. [allowed numbers: 1 (uniball), 2 or 4]
Ball Size of Mistress Snuggle is 0. [size of balls 1-7: "acorn-sized", "dove egg-sized", "chicken egg-sized" "goose-egg sized", "ostrich-egg sized", "basketball-sized", "beachball-sized"]
Cunt Count of Mistress Snuggle is 1. [number of cunts]
Cunt Depth of Mistress Snuggle is 99. [penetrable length in inches; some minor stretching allowed, or more with Twisted Capacity]
Cunt Tightness of Mistress Snuggle is 4. [size 1-5, generates adjectives of extremely tight/tight/receptive/open/gaping]
Clit Size of Mistress Snuggle is 3. [size 1-5, very small/small/average/large/very large]
[Basic Interaction states as of game start]
PlayerMet of Mistress Snuggle is false.
PlayerRomanced of Mistress Snuggle is false.
PlayerFriended of Mistress Snuggle is false.
PlayerControlled of Mistress Snuggle is false.
PlayerFucked of Mistress Snuggle is false.
OralVirgin of Mistress Snuggle is true.
Virgin of Mistress Snuggle is true.
AnalVirgin of Mistress Snuggle is true.
PenileVirgin of Mistress Snuggle is true.
SexuallyExperienced of Mistress Snuggle is true.
TwistedCapacity of Mistress Snuggle is true. [Twisted Characters can take any penetration, no matter the size]
Sterile of Mistress Snuggle is true. [steriles can't knock people up]
MainInfection of Mistress Snuggle is "Snuggle Fox".
Description of Mistress Snuggle is "[MistressSnuggledesc]".
Conversation of Mistress Snuggle is { "YIP!" }.

the scent of Mistress Snuggle is "Mistress Snuggle smells sweet like warm honey and crisp leather."


to say MistressSnuggledesc:
	say "     WIP";

Section 1 - Gear

Table of Game Objects (continued)
name	desc	weight	object
"Fox Suit"	"Profoundly light despite its size and supremely cuddly nature, this highly elastic vulpine fursuit might have cost someone a pretty penny, at least in the days before it was possible to become a fox. Now though, the thing is little more than an idle curiosity of a bygone age, with little obvious use beyond serving as insulation during a cold evening, or perhaps blocking the odd punch from a weaker feral. Despite this, it's hard not to admire the silky texture of orange fur covering much of its surface, or the subtle opalescent quality of the creamy white splotch running down its core and inner thighs. Much less the dense layer of snuggly softness coating it, along with the oddly realistic quality of the faux digitigrade legs, plush bubble butt, and the cute girly bend of its arms. Hidden beneath a thick layer of downy smooth fur along its groin though, is a convenient little pink latex slit permitting ease of access to your more *ahem* [italic type]sensitive areas[roman type] when the need arises."	2	Fox Suit

Fox Suit is a grab object.
Fox Suit is equipment.
It is not temporary.
Plural of Fox Suit is true.
Taur-compatible of Fox Suit is false.
Size of Fox Suit is 0.
AC of Fox Suit is 15.
Effectiveness of Fox Suit is 80.
Placement of Fox Suit is "crotch".
Descmod of Fox Suit is "A snuggly, orange, foxy fur suit swaddles your body in a dense blanket of plush fur and warm cuddly padding.".
Slot of Fox Suit is "crotch".
Scent of Fox Suit is "Oddly crisp and clean despite your highly limited hygiene options, your vulpine costume gives off a subtle scent of crisp pine and earthy tangs.".
EquipFunction of Fox Suit is "[EquipFoxSuit]".
UnequipFunction of Fox Suit is "[UnequipFoxsuit]".
to say UnEquipFoxSuit:
	say "";
to say EquipFoxSuit:
	if HP of Mistress Snuggle >= 98:
		say "     Zipping up your heavily-padded prize with expectant hum, you feel your lips curling into a simple-minded grin as the lingering taint of this strange apparel sinks into your respective being. Visible goosebumps suddenly flicker across your hide in a sudden tide of welcome changes as your old comfortable pelt washes you, blanketing your eager form in plush downy softness that seems to pool around your groin. Oddly invigorating, the squall of transformative energies quickly leaves you panting like a needy bitch in heat as your sex shift into a more fruitful vulpine form befitting your increasingly foxy sensibilities.";
		infect "Snuggle Fox";
		infect "Snuggle Fox";
	else:
		say "";


Table of Game Objects (continued)
name	desc	weight	object
"Cute Tail"	"A simple cute reddish-orange foxy tail graced with a shiny white tip, and a thin elastic wrap around band on its base. Easily long enough to drag on the floor, the thing is kept slightly curled by some clever sowing and seems to sway in tune with your every step. Despite its quality, it's little more than a novelty in this day and age, yet a part of you often feels compelled to wear it regardless in the hopes you might one day grow such a lovely vulpine limb."	1	Cute Tail

Cute Tail is a grab object.
Cute Tail is equipment.
It is not temporary.
Plural of Cute Tail is false.
Taur-compatible of Cute Tail is false.
Size of Cute Tail is 0.
AC of Cute Tail is 0.
Effectiveness of Cute Tail is 0.
GA of Cute Tail is -1.
Traits of Cute Tail is {"slutty","sexy"}.
Placement of Cute Tail is "waist".
Descmod of Cute Tail is "A cute bushy tail foxy bobs behind you.".
Slot of Cute Tail is "waist".
Scent of Cute Tail is "The tail smells of plastic and stagnant ozone.".
EquipFunction of Cute Tail  is "[EquipCuteTail]".
UnequipFunction of Cute Tail is "[UnequipCuteTail]".
to say UnEquipCuteTail:
	say "";
to say EquipCuteTail:
	if HP of Mistress Snuggle >= 98:
		say "     Shimmying the elastic band of supremely stretchy fabric about your waist, you playfully snap the strange textile against your [skinname of Player] hide, and watch in rapt fascination as your tailbone bulges outward like a ball of raw pink clay behind you. Though initially bald and amorphous, the numb tissue soon smooths outward into a long billowing, if bald, tail. Utterly deadened, your new limb feels cold and heavy, as it weighs down upon you like someone tied a wet quilt about you. Though the sensation soon passes as a velvety veil of vulpine fur creeps over the globular mass while it flows outward into its more familiar shape.";
		infect "Snuggle Fox";
	else:
		say "";


Table of Game Objects (continued)
name	desc	weight	object
"Cardboard Box"	"A tattered and battered cardboard box that likely contains your much sought after paws and tail. The poor thing has clearly been put through the wringer as its surface is pitted in thin cuts, scrapes, and covered in stamps both foreign and domestic. While a [']generous['] layer of brown tape has been coiled around to keep the thing from falling apart, how long it will hold together is anyone's guess."	3	Cardboard Box

the scent of Cardboard Box is "The box smells of aging cardboard, glue, and oil.".

Cardboard Box is a grab object.
Usedesc of Cardboard Box is "[FoxyBoxesuse]";

to say FoxyBoxesuse:
	say "     Gleefully tearing into the distressed container, you quickly rip away the frayed bits of cardboard to reveal a half-popped sheet of bubble wrap coiled about your [italic type]cuddly wuggly[roman type] suit's adorable [italic type]pawbs[roman type], and long cute bushy tail secured in a clear vacuum-sealed plastic back. Ripping the paws open first, you're pleasantly surprised to find the fetching orange-furred boots and gloves are made of stretchy nylon that could accommodate all but the largest individuals. A series of noticeably soft, yet durable pads shaped like cute black hearts have been affixed to the soles and palms, though this will undoubtedly make walking on rough terrain... interesting, and make gripping things difficult, a part of you is still looking forward to trying them on. Meanwhile, the silky reddish-orange tail tipped with tapered white streak of fur on its end, seems to be a simple, if classic piece of wearable art, you muse, unfurling the fluffy floor dragger, watching it bounce and wag with the slightest provocation. Turning it over in your hands, you find a simple little band bundled along its base, much like the paws, this thin strip of fabric could easily fit most pre-outbreak persons with ease.";
	say "     Of course, whether or not these latest additions to your collection will have the same lovely transformative effects as your suit remains to be seen, some clinical side of you waxes. Perhaps you should try them out and find out before you retrieve the head? Who knows, you might enjoy the rush, or find some new exotic mix of species you might favor on the side. If not, there are still plenty of other infections and forms to explore, though you doubt any will be as pretty as your [italic type]snuggly[roman type] foxy form. You hum, stashing away your finds for later.";
	ItemLoss Cardboard Box by 1;
	ItemGain Foxy Paws by 1;
	ItemGain Cute Tail by 1;


Table of Game Objects (continued)
name	desc	weight	object
"Foxy Paws"	"Snuggly and delightfully form-fitting, your foxy gloves and matching [one of]pawbs[or]paws[at random] are a consummate pleasure to both wear and behold. As the cuddly fabric not only supports your unique form, but leaves you feeling oddly safe and protected by the gentle caress of the fabric coddling your being with the slightest movement. Although, at times you find this feature to be just as much of hindrance as an asset, for all their lovely smoothness, the lack of grip can leave you vulnerable."	2	Foxy Paws

Foxy Paws is a grab object.
Foxy Paws is equipment.
It is not temporary.
Plural of Foxy Paws is true.
Taur-compatible of Foxy Paws is false.
Size of Foxy Paws is 0.
AC of Foxy paws is 5.
Effectiveness of Foxy paws is 80.
Placement of Foxy paws is "feet".
Descmod of Foxy paws is "A pair of matching foxy footies and booties gracefully hug your extremities in a soothing blanket of supple faux-fur.".
Slot of Foxy paws  is "feet".
Scent of Foxy paws is "Sterile with subtle hits of plastic and stale air coiling about the silky faux-fur.".
EquipFunction of Foxy Paws is "[EquipFoxyPaws]".
UnequipFunction of Foxy Paws  is "[UnequipFoxyPaws]".
to say UnEquipFoxyPaws:
	StatChange "Dexterity" by 1 silently;
to say EquipFoxyPaws:
	if HP of Mistress Snuggle is 98: [Sorry if this is lazy, but I don't feel like investing much time on this route.]
		say "     Slipping on your snug little booties and nice fluffy gloves, the latent foxy nanites fused to the fabric seem to reactivate on contact with your extremities and seep into your core with sudden static thrum like someone were drawing a feather across your bare skin. Soon you find yourself yipping excitedly as the echoes of change start pouring through your being, remolding your [bodyname of Player] form into a more beautiful vulpine bend before your eyes.";
		infect "Snuggle Fox";
		StatChange "Dexterity" by -1 silently;
	else:
		StatChange "Dexterity" by -1 silently;


Table of Game Objects (continued)
name	desc	weight	object
"Vulpine Mask"	"Undeniably cute and phenomenally fluffy, your foxy mask would look just as fitting at home, at any con, or worn by some high-end corporate mascot. This fetching little costume piece seems to be modeled after the common red fox, as much of its surface is covered in reddish-orange faux-fur with an adorable streak of nacre white running down this neck. Its eyes though have striking magenta irises that seem to the movement of its observers, how though, you're not quite certain. As the now large lifeless mask appears to lack any internal mechanism to facilitate such fanciful effects, regardless, the exotic hue is rather fetching in its own right. Its ears meanwhile walk a thin line between the more classical canine shape and a broad fennec's unusual structure with noticeable tufts of black fur on their tips. Internally though, its black balaclava is covered in streaks of rich amethyst purple likely left but its former inhabitants. While safe to handle for the moment, you're under no illusion that putting this on won't transform you on the spot."	4	Vulpine Mask

Vulpine Mask is a grab object.
Vulpine Mask is equipment.
It is not temporary.
Plural of Vulpine Mask is false.
Taur-compatible of Vulpine Mask is true.
Size of Vulpine Mask is 0.
AC of Vulpine Mask is 5.
Effectiveness of Vulpine Mask is 80.
GA of Vulpine Mask is 0.
Placement of Vulpine Mask is "head".
Descmod of Vulpine Mask is "An expressive foxy mask rests comfortably on your head.".
Slot of Vulpine Mask is "head".
Scent of Vulpine Mask is "The Vulpine Mask smells just a bit floral like dried sage with the slightest undertone of mint.".
EquipFunction of Vulpine Mask is "[EquipVulpineMask]".
UnequipFunction of Vulpine Mask is "[UnequipVulpineMask]".
to say UnequipVulpineMask:
	say "     Pulling your head out of the sometimes stuffy mask, you take a moment to breathe a small sigh of relief as a welcome breeze wafts across your face. For the comfort your costume offers, the restricted vision and the occasional smell of your post-apocalyptic breath can be a touch... unpleasant. You chuff, stashing away your unique find.";
	increase Humanity of Player by 1; [IDK if this is even needed. I just added this on a whim.]

to say EquipVulpineMask:
	say "     Straightening the eye whole of your mask into place, the fabric around you seems to hum with a near mechanical whorl as latent nanites saturating its surface seeps into your skull. Far from uncomfortable, a cooling numbness creeps over you as your face is pulled, and reshaped beneath its fluffy exterior into a proper vulpine visage.";
	Infect "Snuggle Fox";



Table of Game Objects (continued)
name	desc	weight	object
"Latex Fishnet Lingerie"	"A phenomenally flexible set of regal purple lingerie born from the unusual creatures dwelling with your former fursuit, this latest addition to your post-apocalyptic wardrobe seems able to stretch or shrink to fit your malleable body. Though the dormant nanites enameled to it seems hellbent on transforming you into a milfy fox. Not that you mind, the fetching magenta apparel's stockings and gloves highlights your vulpine natural curves better than anything. More than once, you've caught yourself admiring the way the anomalous latex seems to hug your paws, or fluffs your chest. To say nothing of the wonderful support it gives to your baby bump are second to none while still advertising your sex to all comers."	1	Latex Fishnet Lingerie

Latex Fishnet Lingerie is a grab object.
Latex Fishnet Lingerie is equipment.
It is not temporary.
Plural of Latex Fishnet Lingerie is false.
Taur-compatible of Latex Fishnet Lingerie is true.
Size of Latex Fishnet Lingerie is 0.
AC of Latex Fishnet Lingerie is 1.
Effectiveness of Latex Fishnet Lingerie is 1.
Placement of Latex Fishnet Lingerie is "body".
Slot of Latex Fishnet Lingerie is "body".
Descmod of Latex Fishnet Lingerie is "A tight, yet form fitting set of magenta fishnet swaddles your [bodydesc of player] curve and accentuating your body's natural beauty.".
Scent of Latex Fishnet Lingerie is "Idly sniffing your fishnets, you're struck by the strange absence of scent, both your own lingering aroma and its. Almost as if the elastic textile were void in and of itself, shrugging, you can scarcely fathom why this is, but hey at least that should make cleaning it easier.".
EquipFunction of Latex Fishnet Lingerie is "[EquipLatexFishnet]".
UnequipFunction of Latex Fishnet Lingerie is "[UnequipLatexFishnet]".

to say UnequipLatexFishnet:
	say "";

to say EquipLatexFishnet:
	infect "Snuggle Fox";
	infect "Snuggle Fox";


Table of Game Objects (continued)
name	desc	weight	object
"Lacy Body Suit"	"Born from the ashes of your fur suit, this rather flexible set of magenta BDSM gear would look divine on doms and subs alike, as willowy bands of anomalous latex affixed to a slender collar circumscribe the wearer's neck, highlighting and complementing their physique. While still leaving more than a little bit of skin exposed to entice fresh playmates. For all its beauty and elasticity, the lingering taint of annelids that birthed it remains intact. Still, there are worse things to end up as than a buxom, muscular fox."	0	Lacy Body Suit


Lacy Body Suit is a grab object.
Lacy Body Suit is equipment.
It is not temporary.
Plural of Lacy Body Suit is false.
Taur-compatible of Lacy Body Suit is true.
Size of Lacy Body Suit is 0.
AC of Lacy Body Suit is 5.
Effectiveness of Lacy Body Suit is 5.
GA of Lacy Body Suit is 1.
Placement of Lacy Body Suit is "Body".
Descmod of Lacy Body Suit is "Dainty band of magenta latex secured by wafer then collar crisscross your body, gripping and caressing your lovely form with your every step.".
Slot of Lacy Body Suit is "Body".
Scent of Lacy Body Suit is "The Lacy Body Suit smells of ozone and warm plastic.".
EquipFunction of Lacy Body Suit is "[EquipLacyBodySuit]".
UnequipFunction of Lacy Body Suit is "[UnequipLacyBodySuit]".

to say UnequipLacyBodySuit:
	say "";

to say EquipLacyBodySuit:
	infect "Snuggle Fox";
	infect "Snuggle Fox";



Section 2 - Events


Table of GameEventIDs (continued)
Object	Name
Fur Finder	"Fur Finder"

Table of WalkInEvents (continued)
Priority	Name	EventObject	EventConditions	EventRoom	LastEncounterTurn	CoolDownTurns	EncounterPercentage
1	"Fur Finder"	Fur Finder	"[EventConditions_Fur_Finder]"	Overgrown Street	2500	2	100

to say EventConditions_Fur_Finder:
	if Cunt Count of Player >= 1 and "Sterile" is not listed in feats of Player:
		now CurrentWalkinEvent_ConditionsMet is true;

Fur Finder is a situation.
ResolveFunction of Fur Finder is "[ResolveEvent Fur_Finder]".
Sarea of Fur Finder is "Nowhere".

to say ResolveEvent Fur_Finder:
	say "     Ambling along the vine-choked market street, your eyes are drawn to a trio of massive, car-length claw marks scoring the mossy sidewalk and several smashed storefronts. Though you can't be certain of their origins, their size, alongside their odd dispersion reminds you of the wyverns populating the skies. Perturbed and maybe just a hair nervous, you quickly scan the firmament for the culprit, yet whatever creature made these vast rents in foliage and cement seems to have departed. For how long you can't be sure, nor can you ascertain what it was searching for, or perhaps, chasing after through this strange stretch of green. You muse, catching sight of several smaller still-weeping gashes in the nearby plants growing over a partially collapsed wooden doorway framed by moss-coated red brick. To your eyes, the cuts are frantic and wild as if whoever made hurriedly trying to clear a path, to little avail. You note, strolling further down the fracturing sidewalk, observing several more failed attempts where rotting root-choked boards have been haphazardly snapped, or vine-bound doors have been part way ripped off their hinges.";
	say "     Alongside a number of bent tree limbs creeping out of the walls of the adjacent building that seem to have been growing over the entrance of a large alleyway. Cracked at a near ninety degree angle, they appear to be utterly stripped of leaves, and worn slightly smooth, you can almost picture the unlucky soul who made these marks clinging to them as they were born aloft by their assailant. Or perhaps, some hopeful side of you ruminates, they were able to slip into the overgrowth filling the alleyway. Regardless, the curious survivor in you can't help but wonder if there is anything of value to be had in this newly unearthed backstreet. Who knows, you might even find a way inside one of these shops? True, you doubt the former markets or high rise boutiques had much in the way of useful supplies before the outbreak, but even the tiniest bit of non-perishable food, or salvage can have its use, if not to you, then someone else. You shrug, carefully ducking beneath them and quietly crawling between the gaps. Once through, you let out a dejected sigh as you're greeted by the sight of the ruined root and vine clogged side streets.";
	WaitLineBreak;
	say "     Everywhere you look, the buildings are beginning to buckle and belly out as opportunistic plants pour through the cracks in the mortar. New growth steadily creeps through the area, filling it with a near solid bulwark of verdant plant matter. While the few doorways you can see peeking through this green hell have already collapsed in on themselves, and in places some of the visible wood appears to have come alive as virgin shoots and velvety crimson blooms gently blow on the slight breeze wafting through the area. Casting your gaze further towards this soon-to-be green tide filling the area, you spy a glint of metal simmering in the low shadows of the alleyways. Intrigued, and in no mood to leave empty handed, you carefully paw up to it and brush aside some of the smaller runners to reveal the latch of an overturned box truck buried underneath. Nearly fused to the encroaching emerald hills, the stricken vehicle is covered with dirt, rust, and supple green runners burrowing into the metal with wild abandon.";
	say "     Rightly curious, you don't see any harm in trying the seemingly unsecured handle, you give the thing a good tug and let out an amused whistle as it turns with a plaintive metallic crack before surging up [']upwards['] revealing a shadowy void behind it. Yet, as your eyes adjust to the gloom, you note the truck seems to be empty save for a single white cardboard box, roughly the size of a large microwave flipped over near the rear of the vehicle resting atop a pile of dark loamy soil. Doing a quick double check to make sure you're not about to walk into the maw of some clever monster, or fall into an exotic trap, you confidently stride over to the parcel and hastily rip it open without a second thought. Though as the cardboard falls away you can't help, but chuckle at the sight of its fuzzy contents. A fursuit? You chuff, pulling out a partial body suit covered in bright reddish-orange faux-fox fur with a soft cream streak of white running down its core, groin, and inner thighs.";
	WaitLineBreak;
	say "     Oddly, the suit seems to be missing its head, hands, feet, and tail. However, as you fluff it out to better take in its size, a note falls out of the box, and lands on the floor with a quiet swish. Picking it up, you quickly skim through the contents to find that there seems to have been a mix up at the delivery center, and the pieces were sent to different parts of the city and are awaiting pick up. Apparently, all the owner, or whoever was going to collect it on their behalf had to do was present this bill, and the shipping company would have handed it, no questions asked. Just your luck, you can't believe you're finding something like this in the middle of a furry apocalypse, it's just too rich. You titter as you contemplate throwing it away, after all if you wanted to become a [italic type]big fluffy snuggle wuggly fox[roman type], er fox you correct yourself while shaking your head, there are plenty cute of vixens and big sexy tods that could make you one for real.";
	say "     Still, as you absentmindedly run your fingers through the rich silky fur and dense soft huggable padding, a part of you wonders if you should hang on to it. The padding alone could probably protect you from the odd punch or kick, and on the rare cold night the extra floof could come in handy. Perhaps, you could even try it on, as you doubt that it's infectious as, at least going by the dates on the shipping bill, the thing seems to have been in transit well before the outbreak so it should be safe. Even it if not, there are worse things to end as than a [italic type]big bubbly cuddly fox[roman type], you mean fox you grumble as you eye up the partial suit warily looking for any abnormalities, hidden traps, or devious mechanisms worked into the [italic type]warm cushy fur[roman type]. Yet no matter how hard you look, you can't find anything off about the fabric, do you risk putting it on, save it for later, or leave this place?";
	LineBreak;
	say "     [bold type]What would you like to do[roman type]?";
	LineBreak;
	let down_to_fox_Choices be a list of text;
	add "Put it on?" to down_to_fox_Choices;
	add "Keep it?" to down_to_fox_Choices;
	add "Leave it?" to down_to_fox_Choices;
	let down_to_fox_Choice be what the player chooses from down_to_fox_Choices;
	if down_to_fox_Choice is:
		-- "Put it on?":
			say "     Oh what the heck, there are worse things to end up as than an [italic type]adorable snuggly vulpine[roman type], besides you have no idea if this thing will even fit you till you try it on. You muse, fumbling around the suit soft creamy tummy fur and velvety rear pelt for the zipper, though it takes you a moment as the tiny thing is hidden under a generous layer of puffy hair, you find the zipper tucked beneath the collar then carefully unzip it and step inside, one [italic type]paw[roman type], you mean foot at a time. Remarkably the suit, though somewhat tight, seems to accommodate you quite nicely. ";
			if Player is impreg_now:
				say "Despite your condition, a part of you finds the sensation of thick cuddly padding stretching around your cute baby bump rather soothing in its own right. You preen, pulling the main body over yours as you zip yourself. You have to admit, the added cushion really brings out your curves and growing swell of lovely tumby, perhaps it was made for a big sexy breeder like yourself.";
				say "     You ruminate, imagining some lucky mother parading this before her adoring mate while you run your mitts though the silky fur, delighting at the dense fabric, gently hugging and supporting your well-loved middle like a down comforter. Though as your hands drift further south alone the creams contours of your fur-wrapped tum, your infatuation only grows as your curious digits brush a slit neatly placed just above your own. Slipping some fingers between the tight folds, you can't resist snicker as your digits brush a snug band of glossy latex worked into its fuzzy borders. Unnaturally warm to the touch, you could almost mistake it for real flesh, perhaps with a little lube though you could complete the illusion. Your lewd mind hums, as you withdraw fingers and turn your attention to the suit's arms.";
			else:
				say "As your legs easily slip into the fetching legging with only the tiniest bit of stretching. You then pull the main body over yours and zip yourself up, while noting the careful dispersion of padding and fine cut of the legs have been made to the effect a faux digitigrade stance. Much to the makers credit, this fanciful addition doesn't encumber you in the slightly, well at least no more than any other suit would as the dense cuddly matter is still a touch hard to move it. You shrug, turning your attention to the suit's arms."; [merge here]
			say "     Albeit simple in design, the seams impart a somewhat feminine look to your limbs, by no means displeasing to you though as the lovely curves pair well with the suit's cushy bubble butt and ample hips. You preen internally, turning around and giving your, er, you pause to once more shake your head, the suit's ass a gentle squeeze. Nice, it's like having your own portable cushion, you purr as your palms sink into the dense pillowy fabric reveling at the way the stuffing hugs your fingers and fur caresses your [skinname of Player] skin. Your tainted mind still wonders what it would be like to put this thing through its paces with some of the big sexy foxes roaming the city, or perhaps cuddling with it on some nice soft bed. You smirk, letting your elated digits roam the cute cuddly curves of your latest find as you exalt in a tender layer of verdant softness swaddling you. Keeping it clean though will surely be a chore, but that's a problem for future you, and hey what's that person ever done for you, you titter as you gather your things and head back to the Overgrown Street.";
			ItemGain Fox Suit by 1;
			Now Fur Finder is resolved;
		-- "Keep it?":
			say "     Not wanting to damage, or sully this adorable, and potentially valuable little trinket by exposing it to the muck and depraved attention of the various ferals wandering about on your inevitable return to the bunker. You carefully refold the incomplete suit into a neat square, mindful not to damage the stitch work, or impart any unnecessary creases into the fabric, before tucking the oddly-light costume away for later. Who knows, perhaps you might one day be able to reunite this thing with its owner, whoever they are. Or, you could even resell it, despite its incomplete state, there are a number of suspiciously wealthy furries out there willing to pay a decent price for something like this. If nothing else, the fetching thing could serve as a cute set of pajamas, or a fine gift to a friend. Regardless, you doubt there's anything more to find in this place, well not unless you want to start tunneling through the wall of the various buildings, yet given the state of the area. You'd most likely cause the distressed buildings to collapse long before you find anything of value. You shrug, making your way back to the Overgrown street.";
			ItemGain Fox Suit by 1;
			now Fur Finder is resolved;
		-- "Leave it?":
			say "     Unable to shake a budding sense of wariness building in your breast as you banefully eye up this seemingly innocent costume, you decide to err on the side of caution, and fold this suit back up, then slip its back into its box. Though you can't see anything out of the ordinary about it now, your time in the city has taught you that this may not remain the case for long. Who knows this could be some elaborate ruse by a particularly wily feral, infected person, or extra planar creature to lure you into if not the dawning suit, then transporting it somewhere a more gullible person will. Either way, best play it safe lest you tempt fate, well more than you usually do. You snicker, drifting back to the Overgrown Street and away from whatever fresh spore of madness you might have stumbled upon.";
			now Fur Finder is resolved;
			Increase XP of Player by 5;



Table of GameEventIDs (continued)
Object	Name
Flying Fuxis	"Flying Fuxis"

Table of WalkInEvents (continued)
Priority	Name	EventObject	EventConditions	EventRoom	LastEncounterTurn	CoolDownTurns	EncounterPercentage
1	"Flying Fuxis"	Flying Fuxis	"[EventConditions_Flying_Fuxis]"	Northern Docks	2500	2	100

to say EventConditions_Flying_Fuxis:
	if HP of Mistress Snuggle is 4 and Cunt Count of Player >= 1:
		now CurrentWalkinEvent_ConditionsMet is true;

Flying Fuxis is a situation.
ResolveFunction of Flying Fuxis is "[ResolveEvent Flying_Fuxis]".
Sarea of Flying Fuxis is "Nowhere".

to say ResolveEvent Flying_Fuxis:
	say "     Striding past the usual gaggle of exotic streetwalkers hocking themselves on the districts northern most reaches, you stop for a moment to admire, or perhaps even considered purchasing the services of some of the more interesting mutants prowling the area. As their time spent in company of countless post-human partners, and maybe even some measure of personal experimentation has left many of the local whores sporting some rather... unique forms. You opine, shuffling past a gaggle of buxom goopy pink cat girls prowling near the water's edge. Naked as they day they were born, the kitty gels stand taller than most basketball players, towering head-and-shoulders above the crowd. They seem to take a great deal of pride in their morphic nature as they shift and flex their hands into all manner of lewd toys meant to entice the passersbys. Others of a more milky persuasion gleefully knead their ponderous rows of oh-so-palmable breasts, offering any brave soul the chance to try a sample of strawberry cream. Though a curious side briefly toys with the notion of trying a bit yourself, but you think better of it, you have things to take care of first, you note picking your way through the crowd of potential johns.";
	say "     You duck into one of the many alleyways dotting the area to avoid notice. Once you're sure you are alone, you pull out the crumpled note with Flying Fuxi's address before setting off into the ratty back streets. Already a maze-like mess before the outbreak, the area has grown all the more unnavigable by the occasional collapsed building blocking some of the more direct routes and soaring piles of trash left behind by the area's current and former residents. You grumble, coming across a partially collapsed brick warehouse blocking yet another pathway in. Packed shoulder-high with mounds of shattered aggregate and rotting unidentifiable piles of brown matter, the area reeks of rot, and fouling oil that seems to clings to the back of your throat with every breath. Briefly, you consider simply mantling the rubble then picking your way through, but think better of it as the light shifts, and your eyes catch sight of the shimmering outlines of pale spider webs swaying in the salty breeze. Were you a less traveled sort, you might have paid them little mind, and simply cut your way though, but your time in the city as taught you better, as your recognize the telltale signs of the local Driders.";
	WaitLineBreak;
	say "     Instead, you dejectedly shake your head then plod on past looking for yet an alternative path, the going is slow though as you encounter more such 'traps' dotting the meandering pathways, alongside scrapes of tattered cum soaked clothing. Bypassing each takes time, and while you entertain the notion of simply barreling your way through their webs. You have no quarrel with these ferals, at least, not for the moment, nor any notion of how many are scurrying about. You ruminate, trudging down a trash strewn corridor on your less-then-scenic route to the borders of the district. Here, the webs seem to give way as the area opens up towards the borders of the Red Light District while you once more pull out the shipping bill, then count off the few visible addresses as you reorient yourself, then push on for several more blocks. Till at least, you find yourself along a tightly packed row of plain two story brutalist cement buildings, separated by only a few inches of litter packed space between, strolling down this banal lane of structures, idly reading off the names and address of each.";
	say "     Though most are simply called some variation of Warehouse 1-A, 2-B, and 9-S, a few stick out like the bright yellow and black sheet metal sign with the words South Pacific Kinetic Solutions craved into it with quick messy welding cuts, the oddly italicized crimson and black banner of North-Side Storage, or the gaudy Chibi construction worker mascot of Toha Heavy Industries. Your eyes soon light up as you catch sight of cartoonish Flying Fox sailing through a clear blue backdrop with an old timey brown mailman's satchel wrapped around it torse with the words 'Flying Fuxi's' written in a fanciful, if dated cursive scrawl. Jackpot! You exclaim, in raw jubilation as the building seems not only intact, but unguarded, though a modest metal security door still bars your entrance. While by no means impressive, the reinforced apparatus seems to have kept the ferals out for the moment, looking all the closer at the rusted steel bolts driven into the cement though. You realize the thing could be easily shorn from the with the right tools, some muscle, and a little time.";
	WaitLineBreak;
	say "     Of course, there might be a loading dock or bay out back you could try to, though that would likely mean confronting the Driders on their own turf. While by no means the most dangerous creatures, if the other streets are any indication, these ferals have had more than enough time to prepare their webs. So any intrusion will more than likely lead to a fight, one you will most assuredly be on the back foot on. Then again, the RLD isn't too far off, if worst comes to worst, it shouldn't be hard to flee the locals.";
	LineBreak;
	say "     [italic type]With all this in mind, what do you want to do?[roman type]";
	let Open_says_me_Choices be a list of text;
	add "Try the rear." to Open_says_me_Choices;
	if Crowbar is wielded or Claw Hammer is wielded:
		add "Pry open the door." to Open_says_me_Choices;
	let Open_says_me_Choice be what the player chooses from Open_says_me_Choices;
	if Open_says_me_Choice is:
		-- "Try the rear.":
			say "      Deciding to try your luck out back, you hurriedly skirt around the edges of the block and begin searching for some side street, or connected alleyway leading to Fuxi's rear. Sure enough, not more than several buildings down, you spy a cracked utility road winding behind the largely abandoned structures, pitted with potholes, broken glass, and yellowed, sun-faded cigarette butts ground into the greyish-brown dirt. Idly sniffing the air, the faint hints of fouling petrol and stale bodily fluids nip once more at your senses, beneath it all though you can smell some coiling hints of cheap oaky cologne wafting about the area. Further in, the area is clogged with the same silky grey stands of webbing you saw dotting the edges of the Northern Docks. Though many are tattered, or coated in a thick black and grey coat of building dust, others yet gleam with pale white glow as if their surfaces were bathed in a shimmering stream of prismatic pearls. Undeterred, and more than confident you can handle a Drider, even on its own turf, you boldly stride forth into the gloom, batting aside any errant webs that cross your path.";
			say "     Your progress is slow though as though stands resist you attempts to peel them back, yet through sheer bullheadedness still manage to cleave a path through the dilapidated street. All the while counting down the number of buildings you pass to keep yourself oriented with your quarry. Fixated as you are on clearing the path ahead, you hardly notice something shifting in the shadows shifting over head as a dark ash gray and lurid salubrious black shape creeps over head with deliberate slowness while the light beings to dance across the sleek back curves of this arachnid feral as it leaps down, its legs splayed outward as if to pin you. ";
			if Driver Carbine is wielded:
				say "Idiot, you chuff under your breath, lips curling into a menacing smirk, as quickly heft your carbine, and fire several volleys into the foolish feral. Though some go wide, many more hit the bastard square in its bestial core while it howls in unnatrual agony as the force of the impact sends it creaning to the side as it slams into a nearby wall with pitiable thud. Stunned and gasping for breath, the horrid hybrid struggles to rise, yets it lower-half seems deaden from the fall and simply twitches in a pained palsy-like state as the monstrous thing's humanoid half tries in vain to heft itself off the ground. In no mood to toy with them though, you quickly charge forward, and club them with the butt of your gun, then watch as it collapses with a satisfying thud.";
				say "[Fuxi's_rear]";
			else if Mad Gun is wielded:
				say "Almost chuckling at the foolishness of this vile arachnid, you hurriedly level your Mad gun at the insipid nat's core, and fire several rough volleys as it descends. Bereft any visible effects, the look of confusion on the pale-skinned creep is one you'll savor for days as its body begins wildly convulsing, then goes deathly still. As at its once haughty mug impacts the trash strewn ground with a meaty thump, sending filth and garbage spraying in all directions. Dumbass, you chuff, shouldering your heavy rifle.";
				say "[Fuxi's_rear]";
			else:
				say "Sneering and mentally prepared for such a cowardly attack, you hurl yourself to the side, though the hooked edges of its legs still manage to clip the side of your face as it with a chittering swish, before advancing up on you.";
				PlayerWounded 15;
				Challenge "Spidertaur Male";
				if fightoutcome >= 10 and fightoutcome <= 19:
					say "     Cowed by your ferocious assault, the horrid mongrel howls in defeats as sweat laced with the dust and rot pours down its all-too-human face as suddenly leaps on the sides of nearby building, then skitters off into it's webby lair. Of no mind to chase it down, much less pick your way though the tangled mess of threads dotting the area, you let the thing go, content in the knowledge that at least for the moment, it won't bother you any further. Still, it best not to rest on your laurels when other such cretins could be lurking in the rafters.";
					say "[Fuxi's_rear]";
				else if fightoutcome >= 20 and fightoutcome <= 29:
					say "     [italic type]Sometime later[roman type], you awaken near the edge of the northern docks, alive but rattled, and covered in what you dearly hope is [bold type]just[roman type] webbing. You slowly pick yourself up off the ground, and dust off what you can before sighing in defeat, resigning yourself to never return to this stupid place, no damn suit is worth this hassle!";
					now Flying Fuxis is resolved;
				else if fightoutcome >= 30:
					say "     Sensing your impending defeat, you hurriedly dart back through the utility street with the drider hot on your tail, yet for all its horrid eight-legged speed, you still manage to avoid its grasp as you thoughtlessly barrel towards the red light district. Nearing the border though, the thing soon stops in its tracks with an odd dumbfounded look on its oddly human visage as it seems to lose interest in and begins shuffling off to its foul warren. In no mood to question the feral's behavior, you merely shrug and resolve to never bother the beast, as no fanciful trinket is worth this headache!";
					now Flying Fuxis is resolved;
					move Player to Entrance to the Red Light District;
		-- "Pry open the door.":
			say "     Knew this thing would come in handy, you muse while a self satisfied smirk tugs at the edges of your [headname of Player] lips, as you brandish preferred clawed tool and proceed to pry away the crumbling bolts with a few well placed tugs. Though noisy, the area seems clear for the moment, allowing you free reign to be as wild and brutish as you need to rip the gate off its moorings. Sure enough, after several minutes of rough pulling and a couple expertly placed smacks, the metal door begins to sag to one side as you shear each bolt loose, till with one frightful metallic knell, the door slips free, and clangs against the ground. Behind it, you spy a simple green painted wood door decorated with a clear hex pattern window, alongside a graceful bronze handle. On a lark, you give the thing a gentle tug, only for it to rattle in your grasp. Locked, oh well, you shrug, as you quickly smash out the glass with butt of your tool, then reach inside, and fumble around for the interior handle. Though it takes a few tries, the door soon swings open with a well oiled swish as you hurriedly slip past, then shut the thing behind you.";
			say "[Fox_hole]";

To say Fox_hole:
	say "     Once inside, you do a quick sweep of the lobby, though dark, the place appears rather spartan as only a few blue plastic chairs arrayed near the entrance. A smattering of posters depicting the same flying fox mascot decorating much of the clean white walls. Plain black slip resistant plastic mats have been thrown over the white linoleum floor while a red analog ticket dispenser parked next to a plexiglass wall situated in front of the tellers stand sits towards the rear. Nestled behind it, is a sturdy looking metal mesh door painted a bland malilla. Beside the booth, you spy a second solid green metal door with a thin one way viewing window with a sign beneath it emblazoned with the words: 'Staff Only' upon a gleaming copper plate. Intrigued, you paw up to the thing, and give the handle an experimental tug, and are rewarded by an oddly satisfying little metallic *click* as the thing swings open without resistance.";
	WaitLineBreak;
	say "     Peering in, you find the area is almost pitch black, though small streaks of ambient light still peter from thin cracks in the walls. Thankfully, the area seems to have been deserted for some time as the omnipresent scents of sex and drying juices appear absent. Beaming at your good fortune, you slip inside and are greeted by stacks of all manner of cardboard boxes piled floor to the ceiling in a vast single story grey cement room, alongside canvas bags of stuffed full of letters and envelopes. Reasoning your quarry is likely still tucked away in one of the boxes, and just a hair curious what other spoils could be waiting for you, you select one of the rows at random, then begin tearing them open with reckless abandon. Though their recipients maybe gone, or turned, there's nothing saying you can't put whatever baubles they constrain to better use.";
	say "     [italic type]Two hours later[roman type], and you've gutted the last box, and have little to show for your efforts. True, you manage to score a few bags of exotic chips and soda, alongside some meds meant for the city hospital. Most of the fare seems to be little more than the odd ugly sweater, or personal effects of little use to your current situation. Still, the savvy scav in you is all too happy to add what you can to your personal hoard, yet the suit's paws and tail elude you nonetheless. Dejected, but undeterred, you begin searching through the packing foam strewn about the area for any boxes you might have missed, as you explore the shadowy room further though, you find an another tucked door labeled: 'Returns and Undeliverables' which seems to lead deeper into the boxy building. Reasoning, you'll have more luck in the second section, you pop on in, then find yourself in a bare grey annex packed full of bright yellow cloth mesh push carts taller than a man's waist, while its walls are lined with brown wooden cubbies. Most seem empty, or full of spam letters, yet one pops out to you as your eyes catch sight of a largely unassuming brown cardboard box covered in mail stamps and bright red seals from several other companies with a large stack of crumpled paper affixed to its side.";
	WaitLineBreak;
	say "     Recalling the previous mix up your [italic type]snuggly wuggly[roman type] suit endured before you saved it, you surmise this must be what you're looking for. Though as a curious side of you can't help but want to take a look at the extra paper work first, there could be some clues as to the whereabouts of your prize's head. You muse, thumbing through the sheet of paper, most are rather boilerplate, like logs, receipts, and even a few import labels, sorting through them with a clinical eye, you spy some (poorly) handwritten letters mixed in. Skimming them over, you realize they belong to the suits owner, and contain their inquiries about the status of '[italic type]Snuggle[roman type]'. At first, the initial missives seem rather banal, but as the volumes drone on through, their tone gets more frantic, and bordering on unhinged as they plead with the company to quote: [']find hir[']. They even go so far as to include some rather risque picture of a shapely nude reddish-orange fox herm along with a few female ones dressed in skimpy bondage gear. As the series of letters ramble on, the writer begins peppering in strange details about their characters, and adventures explore various popular franchises, looting all manner of treasures, and tales of their many children as if this would somehow aid in their discovery.";
	say "     Almost groaning, you feel your eyes start to glaze over at their laundry list of powers, which range from the overtly magic, to the eclectic ability to absorb or devour both people and animals and assimilate their traits into themselves. None of which seems to have moved the clerks assigned to this case, as the poor damned souls meant to handle such inquiries all seem to have sent the same generic response, procure the same slip you found earlier and they'll release the parcel. From the haughty replies, this went over about as well as you expected, for there all the various missives devolve into childish diatribes, and Karen-like demands that ultimately went nowhere. Shrugging, you continue flicking through the remaining notes till you run across another from a different shipping company called: Fed-Up Express. Detailing their own troubles with this client alongside a confirmation that the head is being kept at one of their off-sight storage lockers. Going by the address, the place doesn't seem all that far from the Abbey proper. Grinning at your good fortune, you debate ripping the package open, but think better of, best pack this thing somewhere with a bit more light, you muse, tucking the box under your arm, and head back the way you came towards the way you came.";
	now Flying Fuxis is resolved;
	ItemGain Cardboard Box by 1;
	ItemGain Soda by 2;
	ItemGain chips by 2;
	ItemGain Medkit by 2;
	now HP of Mistress Snuggle is 5;

To say Fuxi's_rear:
	say "     With the brute dealt with, you continue on your down the web clogged street, eyes darting between the remaining glittering threads and shadows as you close in on, what you assume to be the building's simple grey concrete loading dock protruding out into the road. Intrigued, but still reasonably cautious, you do a quick double take to make sure no more eight-legged freaks are waiting in the wings before striding over to the thing's metal rolling shutters. Unlike the front, these seem to be secured with little more than a common silver combination lock with a plain black dial. Reasoning the thing is no tougher than a basic bike lock, you scout around the area for anything you could use to bash, or pry the flimsy looking construct apart. Moments later, you find several pieces of what you surmise was a steel school chair's legs poking out the moldering heaps of refuse polluting the area. Despite their willowy nature, you reason they should be enough for the task at hand, and scoop them up, the amble back over the lock. Threading them through the its shackle, you apply a quick bit of leverage on the metal till the thing cracks with a satisfying crunch as the cheap pot iron snaps apart.";
	WaitLineBreak;
	say "     Pulling the remains loose, you dexterously prop up the shutters enough for you to slip underneath then roll under, and quietly close the thing behind you. Inside, you're met with a thick gloomy pall as the building seems to lack much in the way of windows, as a few thin bands of light peeking through the roll-up doors illuminate the area. Yet as your eyes adjust, you're greeted by stacks of all manner of cardboard boxes piled floor to the ceiling in a vast single story grey cement room, along canvas bags of letters and envelopes. Reasoning your quarry is likely still tucked away in one of the box, and just hair curious what other spoils could wait you, you select one of the rows at random, then begin tearing them open with reckless abandon for though their recipients maybe gone, there's nothing you can't put whatever baubles they constrain to better use.";
	say "     [italic type]Two hours later[roman type], and you've gutted the last box, and have little to show for your efforts. True, you manage to score a few bags of exotic chips and soda, alongside some meds meant for the city hospital. Most of the fare seems to be little more than the odd ugly sweater, or personal effects of little use to your current situation. Still, the savvy scav in you is all too happy to add what you can to your personal hoard, yet the suit's paws and tail elude you nonetheless. Dejected, but undeterred, you begin searching through the packing foam strewn about the area for any boxes you might have missed, as you explore the shadowy room further though, you find an another tucked door labeled: 'Returns and Undeliverables' which seems to lead deeper into the boxy building. Reasoning, you'll have more luck in the second section, you pop on in, then find yourself in a bare grey annex packed full of bright yellow cloth mesh push carts taller than a man's waist, while its walls are lined with brown wooden cubbies. Most seem empty, or full of spam letters, yet one pops out to you as your eyes catch sight of a largely unassuming brown cardboard box covered in mail stamps and bright red seals from several other companies with a large stack of crumpled paper affixed to its side.";
	WaitLineBreak;
	say "     Recalling the previous mix up your [italic type]snuggly wuggly[roman type] suit endured before you saved it, you surmise this must be what you're looking for. Though as a curious side of you can't help but want to take a look at the extra paper work first, there could be some clues as to the whereabouts of your prize's head. You muse, thumbing through the sheet of paper, most are rather boilerplate, like logs, receipts, and even a few import labels, sorting through them with a clinical eye, you spy some (poorly) handwritten letters mixed in. Skimming them over, you realize they belong to the suits owner, and contain their inquiries about the status of '[italic type]Snuggle[roman type]'. At first, the initial missives seem rather banal, but as the volumes drone on through, their tone gets more frantic, and bordering on unhinged as they plead with the company to quote: [']find hir[']. They even go so far as to include some rather risque picture of a shapely nude reddish-orange fox herm along with a few female ones dressed in skimpy bondage gear. As the series of letters ramble on, the writer begins peppering in strange details about their characters, and adventures explore various popular franchises, looting all manner of treasures, and tales of their many children as if this would somehow aid their discovery.";
	say "     Almost groaning, you feel your eyes start to glaze over at their laundry list of powers, which range from the overtly magic, to the eclectic ability to absorb or devour both people and animals and assimilate their traits into themselves. None of which seems to have moved the clerks assigned to this case, as the poor damned souls meant to handle such inquiries all seem to have sent the same generic response, procure the same slip you found earlier and they'll release the parcel. From the haughty replies, this went over about as well as you expected, for there all the various missives devolve into childish diatribes, and Karen-like demands that ultimately went nowhere. Shrugging, you continue flicking through the remaining notes till you run across another from a different shipping company called: Fed-Up Express. Detailing their own troubles with this client alongside a confirmation that the head is being kept at one of their off-sight storage lockers. Going by the address, the place doesn't seem all that far from the Abbey proper. Grinning at your good fortune, you debate ripping the package open, but think better of, best pack this thing somewhere with a bit more light, you muse, tucking the box under your arm, and head back the way you came towards the way you came.";
	now Flying Fuxis is resolved;
	ItemGain Cardboard Box by 1;
	ItemGain Soda by 2;
	ItemGain chips by 2;
	ItemGain Medkit by 2;
	now HP of Mistress Snuggle is 5;




Table of GameEventIDs (continued)
Object	Name
Da Final Fox Down	"Da Final Fox Down"

Table of WalkInEvents (continued)
Priority	Name	EventObject	EventConditions	EventRoom	LastEncounterTurn	CoolDownTurns	EncounterPercentage
2	"Da Final Fox Down"	Da Final Fox Down	"[EventConditions_Da_Final_Fox_Down]"	Northwest 7th Street	2500	2	100

to say EventConditions_Da_Final_Fox_Down:
	if HP of Mistress Snuggle is 7 and Foxy Paws is equipped and Cute Tail is equipped and Fox Suit is equipped and Cunt Count of Player >= 1 and "Sterile" is not listed in feats of Player:
		now CurrentWalkinEvent_ConditionsMet is true;

Da Final Fox Down is a situation.
ResolveFunction of Da Final Fox Down is "[ResolveEvent DaFinalFoxDown]".
Sarea of Da Final Fox Down is "Nowhere".

to say ResolveEvent DaFinalFoxDown:
	say "      Trekking along the dull, barren side streets leading towards the [']Store Everything['] facility, you flip out your collection of shipping bills one last time to compare the addresses with those on the various drab buildings populating the area. By some strange stroke of fortune, the ferals seem to have ignored much of this place, as most of the buildings, along with their signage, appears to be unsoiled by the usual chaos afflicting the city. Why though, you can't be certain, perhaps, due to a quirk of timing this place was largely occupied when the outbreak began, or maybe, the area was never popular to begin with? Regardless, your search is blessedly quick, as you count off the address numbers in a slow monotonous tone till you find yourself standing outside of a shuddered three story red brick building. Utterly bland and unadorned, you'd never have guessed the place was ever an active store, much less paid it any mind had you not found the directions. You think to yourself, eyeing up the rolling grey metal shutter draped over much of the first floor, facing the street.";
	say "     Above it, a thin gun metal black fireescape with a dilapidated foldout ladder snakes its way beneath several sets of recessed windows. Long since corroded beyond repair, the paint visibly bubbles in places, and rusty spikes of crystalline oxidized metal pours out from its hinges like the rotten teeth of some long dead creature protrude from it at odd angles. The few remaining bolts hanging from the cracked clay seem to sway and creak with the slightest breeze, and a part of you doubts the thing could ever be fixed, much less support the weight of even the tiniest infected. Casting your gaze towards the dark arsenic green windows, you note the blinds have been drawn closed for quite some time as the white curtains have been bleached on off-yellow boney white by the sun. Tucked about their corners, are the remains of dead flies and greyish-brown pillars of dust piled two fingers high. Strangely, the sight is oddly... comforting in its own way, as you doubt anyone has disturbed this place since the outbreak, meaning much of the spoils (if there are any) would be untouched. Perhaps, you could even use the place as a bolt hole one day, or shelter in the event the bunker were compromised. You hum, a light smirk tugging on the edges of your [FaceName of Player] lips, as you stride over to rolling metal curtain barring entrance to the bodega, lean down, then give the thing an experimental tug.";
	WaitLineBreak;
	say "     To your amazement, it easily glides upwards on well-oiled hinges, revealing a simple glass door framed with flimsy looking metal, painted a fading emerald green, with a rather worn looking handle on the left side of the building. Its waning paint worn glassy smooth, and nearly polished off in places by the touch of countless hands, or the uncaring bite of the elements. To its right, is a large scratched up, weather-beaten plastic window, pitted with keymarks, dents left by bits of gravel flung from the street, and riddled with cloudy spots of interminable origin obscuring much of the store proper. Squinting, you can barely see anything behind its milky white surface, beyond the vague outlines of empty shelves. Shrugging in mild disappointment at the lack of obvious loot, you try the door, only to find it locked, as the aperture roughly rattles on its hinges. No matter, this place seems well and truly empty of life, nanite touched or otherwise, so you opt to smash your way in, rather than dither about looking for a more covert means of entry. You ruminate, swiftly surveying the area for something you could use to break the glass, not like anyone is gonna call the cops on you aways.";
	say "     Peering through the gutters, you find a few fist sized black rocks of indeterminate provenance wedged in a nearby stormdrain's grate, popping them out. You step back, then hurl one at the door with reckless abandon as a loud, satisfying crack resounds through the area while the glass explores in a shower of sparking silicone. Clasping a second stone in hand, you knock out any dangerous looking shards that would bar your path, or threaten your precious suit, then slip through. Inside, you're assailed by the lingering scents of sage, clover, stale tobacco, and the barest hints of rotting plant matter pooling around the entrance as a light breeze nips at your heels. Despite the lack of proper lighting, your nanite-altered eyes can still make out several rows of plain beige painted shelves placed atop a sticky black-and-white checkerboard pattern linoleum floor. Its well-traveled surface is dotted with a prominent line of scuff marks, and the occasional cigarette burn snaking between the shelves. Long since picked bare by quicker survivors, or mayhaps looted by its owner, little of value remains save for some bottles of off-brand condiments, and blue bleach tablets, neither of which are much use to you in your current situation.";
	WaitLineBreak;
	say "     Letting your eyes wander along its western walls, you spot a cordoned off cash register tucked behind a thick slab of what you assume is reinforced glass. Behind which, are empty white shelves that, according to the black italicized labels affixed to them, once held (horribly overpriced) booze, cartons of imported smokes, condoms, and feminine hygiene products. Further back, is a study looking grey metal security door that seems untouched by the normal vandalism plaguing the city. Under other circumstances, you might have toyed with the notion of finding your way into the back of the building. For now though, you content yourself with locating the dropoff locker as you scan the rear of the building. Here, you spot a long row of walk-in fridges, their power long since cut, and largely barren. The few remaining food items have spoiled and congealed into an unsightly mass of multi-hued mold unfit for consumption by even the most nanite hardened creature. Adjacent to them, is a large rectangular orange and blue storage unit locker with the words: Fed-Up Express, emblazoned on its side tucked into the corner. There you are! You cheer, striding over to its side.";
	say "     By some strange miracle, the locker is still powered by either an internal battery, or other unseen source, you note, observing the pale neon-white glow of a tiny monitor affixed to its side peaking through the gloom. Flicking through the menu, you punch in the locker ID, followed by the password, and hit [bold type]ENTER[roman type]. A soft mechanical whirl echoes through the machine as a door pops open, inside is a tightly wrapped brown box, covered in duct tape, stickers, and enough stamps to make a customs agent's eyes glaze over in despair. Plucking it free, you hurriedly tear the thing apart with wild abandon, filling the air with sounds of ripping plastic and shearing cardboard as you peel the dense layers of packaging off. Little-by-little, the thing gives way, till with one satisfying *rip* as you pull your suit's plush [italic type]snuggly[roman type] mask free. Much like the rest of your costume, its generously padded, and decorated in silk reddish-orange faux fur with a cute streak of white running down its lean muzzle and [italic type]cuddly[roman type] neck.";
	WaitLineBreak;
	say "      Leveling its face with your own, it's hard not to be struck by the eerily life-like nature of its gleaming magenta eyes staring back at you expectantly, or the all too realistic quality of its thin ebony lips and teeth as they glisten in the dim light. Were you the sort given to flights of fancy, you would almost swear they look, wet? You shrug, turning it over in your gloved mitts, while its eyes seem to be tracking you. You muse, idly shifting the mask in your hand watching its pupils shift on the quarter turn, then pop back into place when you right the thing. Rolling your eyes, you merely chalk this to some clever trick on the suitmaker's part, whoever they may be. Meanwhile, its long pointy ears straddle the line between a classical vulpine and a fennec's, you ruminate, as the supple lining of your fluffy suit tightens ever-so-slightly about your back and inner thigh cinches about your joints. Far from uncomfortable, the sudden contractions nevertheless catches you off guard as the not-so-little feelers nesting within your costume burst forth from their hidey holes, and frantically coil down the length of your arms towards the head with a sudden, desperate energy. Annoyance and curiosity flare through in equal measure as they wildly tug upon your arms as if urging you to put the head on here and now.";
	say "     Hissing at their impatience, you chastise the pushy creatures, much as you might be looking forward to completing your transformation. You'll decide when and where you do, not them! Yet your words seem to fall on deaf [']ears['] as they snake their way about your wrists and hands, forcibly digging your fingers into the downy fur of your prize. While their central mass presses down on your core, as if trying to force you to take a kneel. Stop! You bellow, to little avail as the tendrils tighten about your skull, roughly craning your neck downwards as they tug all the more frantically upon your arms. Yet, for all their waning strength, you don't feel any malice from them, only a profound sense of desperation. Despite the intensity of their hold, they make no effort to constrict your airway, or put pressure on your vitals. Some even seem... apologetic as they mournfully massage your hands or back like they were trying to comfort you, yet in spite of the tenderness of their touch, they refuse to release you, while their peers remain intent on forcing you to bend.";
	WaitLineBreak;
	say "     Perhaps, some analytical side of you posits, as you lock your knees in place, whatever force is animating them is nearly spent. Even now you can feel their grasp weaken, if only slightly, as several of their now ribbon thin bodies go slack, then fall limply against the dense padding for your prized costume with a light thud. If so, they may not have the luxury for time, and are simply trying to complete your transformation before they wither away. While that doesn't excuse their forwardness, you can't fully blame them for this. Besides, you both want this, even if it's potentially for different reasons you opine, as the sweet memories of their touch and the joy your past changes brought you flood the back of your mind. So why not trust them once more, and accept this change here and now?";
	say "     Then again, you've seen more than your fair share of insidious creatures prowling the city leaving all manner of honeypot traps across the land for the unwary. Moreover, you've felt the tempting call of the nanites whispering in your ear, urging you to do things you might have once considered taboo enough to still have some reservations nipping at the back of your mind. In the end, can you truly trust that these things don't have some ulterior motive, or that your desires aren't being twisted by the horny little robots incessantly scratching at the back of your mind? Though it might mean losing out on the foxy form of your dreams, you could easily overpower these creatures if you just wait but a few moments longer. You muse, as a quartet of tendrils slithering about your skull shiver in primordial terror as if sensing your thoughts.";
	LineBreak;
	say "     [italic type]What would you like to do? Allow the suit to finish changing you, or remove it before it gets a chance to change you further?[roman type]";
	LineBreak;
	say "     [italic type]Author's Note: This choice is permanent, electing to remove the suit will lock your Snuggle Fox into its current shape, and each piece can be equipped to reinfect you. In the future, a toggle may be included into the Sundered Codex to allow you to slightly tweak this version of the Snuggle Fox TF slightly. Further, no content or special scenes will be unlocked for you if you refuse this TF[roman type].";
	let Do_da_do_do_Choices be a list of text;
	add "Let them change you?" to Do_da_do_do_Choices;
	add "Get this thing off of you!" to Do_da_do_do_Choices;
	let Do_da_do_do_Choice be what the player chooses from Do_da_do_do_Choices;
	if Do_da_do_do_Choice is:
		-- "Let them change you?":
			say "[Ihateindentingalot]";
		-- "Get this thing off of you!":
			say "     Oh fuck this! You hiss with a sad shake of your head, digging in your heels and locking yourself in place as you refuse to allow the creature to dictate when and where you change, regardless of the effect it may have on them. At once, alarm races through their tepid sinuous forms as they press what little of their strength remains, trying to bend your body to their will. Though not all, as some of their number attempt to plead with you in their own way as they worriedly stroke your [Bodydesc of Player] form, while faint images of your foxy figure in regal repose flicker across your mental landscape. Quivering at their caress flutters across you, as they encouragingly grope your lovely passage or tender [breast size desc of Player] chest. Playfully slipping their silky bodies along your blushing hood in a soft purposeful rhythm, provoking a needy vulpine yip from your lips as your knees begin to buckle.";
			say "     Unwilling to yield so such artless temptation, you bite down on your lip, letting pain laced with indignation flare through your senses as you force your hands open, allowing the head drop from your grip, it collides with the floor with an oddly wet *smack*. The tendrils coiling about your legs, suddenly surge along the [bodydesc of Player] contours of your extremities towards it with frightening urgency. In their moment of laxity, you swiftly kick the thing aside while you tear off your glove then hurl them in the other direction. Severed from their 'main body', the things begin to bubble then hiss as they boil away in a plume of odorless magenta smoke while they convulse about like a fish on a line at the loss of their fellows. Hardening yourself against the brief motes of sympathy flashing through you, you hurriedly undo the remaining binding of your costume and chuck it along with your tail to another far corner of the room, before kicking off your boots with the same brutish zeal.";
			WaitLineBreak;
			say "     Magenta fumes soon fill the store as the writhing, cracking creatures boil away by the second, though the process is blessedly quick, sharp pains of regret still plague your mind watching their flailing body decay before your eyes. Never once though do they make any attempt at retribution, or flee from you, instead those still capable of movement attempt to crawl back together, yet this too is short lived as their unnatural flesh sloths off their disintegrating forms. Leaving steaks of purple and black matter in their wakes as they inch forward, bodies stretched their limits as they blindly reached for their peers, only to collapse seconds later. While the last remnant of their slippery being crumples away like amethyst ash caught in a breeze, in their place you spy a thin dusting of silvery powder spiraling along the floor where they fell. Unsure what to make of this, you grab a large plastic bottle of ketchup bottle off the shelves, and poke the now still costume segment along with the powder to see if there is any life remaining in either.";
			say "     Despite your rough prodding, nothing stirs, leaving you wondering, if only briefly, what exactly happened to them as you've never seen a feral, let alone any infected item corrode like that. Perhaps these creatures were unstable, or as you surmised before they were on borrowed time, and simply faded away. Regardless of the truth, your suit should clean now, though whether it remains infectious is anyone's guess, you muse as you collect the various pieces off the floor. Still, this powder they left behind could have some value to the right person, perhaps some of the veteran survivors could shed some light on this? Better yet, an opportunistic side of your beams, someone might even be able to do something with it, what through, you can't be certain, but it could be worth keeping around. You preen, picking through the store for something you could use to transport them. Though precious little material remains in the store proper, you're able to repurpose some of the resealable bleach tablet packaging into a few travel bags. Then proceed to brush up as much as you can for later, and seal them up to the best of your abilities. Once sorted, you tuck your spoils away then head back with your meager haul.";
			LineBreak;
			say "     [bold type]Snuggle fox content ends here, thanks for playing and enjoy your loot... you monster.[roman type]";
			now HP of Mistress Snuggle is 98;
			Increase XP of Player by 69;
			now Morale of Mistress Snuggle is 1;
			ItemGain Vulpine Mask by 1;
			[ItemGain Silvery Powder by 3;]
			now Da final Fox Down is resolved;


to say Ihateindentingalot:
	say "     Deciding to chance it, you take a deep centering breath and calmly tell your exotic hangers on if they stop being so rough, you'll put the head here and now. But only, you add with a stern, almost canine growl, if they let you do it under your own power. At once, the tendrils go still, while a strange series of chips and clicks ripples though the padding of your suit as creatures seem to be debating amongst one another. Sighing, you tell them how you know they're waning by the moment, and much as it would pain you to harm them, or lose out on completing your changes. You can easily overpower them if you have to. You grunt, flexing your arms against their weakening grasp to better impress upon them the gravity of their situation.";
	say "     Their chirping grows all the more rancorous as the creatures squallable amongst themselves before they seem to relent and slacken their hold upon you. See we don't need to fight, you hum, nuzzling your cheeks against the shoulder of our suit, as you right yourself, then line up the suit head hole with your [facename of Player] visage and place it over your head. Though a strangely snug fit, the fabric seems to loosen and contact about your skull, as if it were molding itself to the unique structure of your mug, while the scent of ozone and warm plastic nips at your nose. Your vision shrinks to wafer thin slits as only the tiniest bands of ambient light flicker though the carefully hidden holes in its eyes. The tendrils wrapped around your neck surge upwards in a velvety tide, lovingly gliding along the contours of your face as they burrow into the soft balaclava surrounding you.";
	WaitLineBreak;
	say "     The briefest flickers of alarm course through you as some traipse about your lips and ears with reverent languidity, though this passes almost as quickly as it came. Your face and body goes oddly hot to the touch as the feeler spreads across you, along with a burst of bestial vigor coursing through your veins. You note with a self-satisfied rumble, watching your suit writhe with the countless outlines of their tepid, annelid shapes squirming along your tender form. Curious, and more than just a little enthused by the sudden thrum of actively simmering across you as they worshipfully massage your [bodydesc of Player] curves, sensually snaking their way towards your [CockName of Player] sex. You soon find yourself humming at the regal softness of their touch as you run a gloved hand over your well-padded form in simpleminded delight. The fabric strains to contain both them, and you, as your body is reforged beneath the snuggly textiles. Ah feels so *pant* good, you huff in vulpine contentment, as your foxy infection asserts its rightful place. Scourging any lingering taint blighting your form as a soft, velvety fur creeps up along your neck in blissful tide.";
	say "     Practically purring at the spreading suppleness filtering up your chin, your face flows outward into a sharp conical shape, while your swelling tongue glides over the budding fangs erupting along your shifting jaw in a curious samba. You hardly notice the pressure building along the tips of your ear as they're dragged upwards toward the top of your head. As a harsh tinnitus knell briefly rings through your skull as nerves, old and new, are rearranged by the chaotic nanites coursing through you. Amidst this wave of change, your breath comes in deep, anticipatory pants as a rush of sensation floods your mind. New impossible scents, and the clearest of sounds cascade over you as a shiny black button nose winks into being on your quasi-muzzle. Yipping excited at the subtle gleam of your snoot reflecting in the dim light of your mask, you almost miss the latest bout of change simmering across your ";
	if Perception of Mistress Snuggle >= 1:
		say "supple motherly body as your matronly curves seem to drink the motes of morphic delight flowing through you fluffy figure. Your gloved paws drift along along dough swell of your lovely tum and shapely hips with curious delight as the comfy maternal padding swaddling your ";
		increase Perception of Mistress Snuggle by 1;
		if player is impreg_now:
			say "bouncy baby bump ";
		else:
			say "snuggly tumby ";
		say "and [breast size desc of Player] chest tingles beneath your pads as your finger sinks just hair deeper into the tender flesh gracing your opulent figure. Oh feels kind of nice, you coo dreamy, pinching a gleeful pawful of cushy fluffy as the enthralling tendrils lovingly knead your cuddly body as if to encourage its growth.";
		WaitLineBreak;
		say "     So good, a girl could get used to this, you hum excitedly, adding your palms to the mix, tenderly stroking the soaring suppleness spreading across your lovely tum and pillowy ass. Another time, you might have found sound such fruitful changes off putting, yet, as you grope another eager pawful of exalted foxy floof. Relishing the strange satisfaction coursing through you at these latest alterations creeping down your plush opulent figure. Your arms and legs thrum with welcome vigor as the rising swell of cushy adipose spreading over your motherly figure, laced with a rich coating of dense, predatory muscle that belies your voluptuous disposition. You flex your digi peets against the tightening fabric of your boots, you're struck by the raw feeling of purpose and power surging through them as your thighs are slowly wedged apart by your growing splendor, while the supple warmth of your fur caressing your sex.";
		if player is herm:
			say "     Gushing at their regal kiss and inquisitive touch of the waning tendrils flickers about your [cock size desc of Player] tool with deliberate slowness as they coil your throbbing unaltered spire. Your fur gentle edges across the base of your elated tool and eager balls as both go profoundly warm to the touch. Oh fuck yes, you growl, sensing your girly dick thrum ever-so-slighty in their grasp as a silky coating of plush meaty furry flesh simmers along the base of your yummy tool. Grinning at the primal rush of foxy delight course through your thickening dick as the beginning of a cushy sheath spreads upward along the length of your cock. You can't resist briefly tracing your fingers along the downy pelt swaddling its changing form in a peerless layer of canidae padding while your growing wood presses against the tender tallow of your portly paunch. Fur and fluff cascade over your cock in equal measure, your rod is leisurely drawn into the moist, toasty confines of your silky dick wrapper. The sharp scent of vulpine need wafts about you as a tropical trickle of bestial juices trickle down its gossamer length, then down along the groaning contours of your balls. In its lewd wake, lustrous bands of satin hair blossom and spread outwards, coating your groaning orbs in a regal layer of opulent fur.";
			WaitLineBreak;
			say "     Unable to resist their siren's call of your growing foxhood rifling the silky folds of your suit's convenient vent, your fingers waltz about the supple impression of your juicy tool. As you ease yourself to the ground with a well-pleased sigh, exalting at the intoxicating little ripples passing through your billowing fluffy figure as your body softens beneath the tendrils touch. You spread your legs wide, cheerfully drawing a paw along shapely hips. Marveling at the wonderful view of your adorable tum nestled against your legs like the precious treasure it is. You slowly slip your hand beneath its luxurious hem with a needy whimper as your shifting digits brush the latex lips of your suit's convenient vent. Shit this thing is getting huge, you pant, as a heady shiver nips at the base of your spine at the ambient touch of your virile spire and flush cushy package greeting your mitts. You wrap several fingers about the growing heft of your thick foxy cock, eagerly stroking its bestial curves in base delight at the caress of your sheath. Your tainted mind reels with each enticingly throb of your foxy cum vein playing across your blossoming dick wrapper and doughy palms.";
			say "     Basking in a carnal rush of impossible sensations, your gloved mitts move of their own accord, inquisitively stroking the nice, fluffy flesh coating your cock like an exotic fleshlight. With each motion of your heart shaped pads, you can feel the immaculate taper of foxhood becoming all the more prominent as the first little hints of your crimson rod peak along the silky edges of your sheath. You loudly huff and whine in desperation at the sensual throb of your burgeoning knot teasing your lustrous dick wrapper, and lewd curve of your dick gracing your gloved mitts. All the while, the lovely feelers frolic about your balls with worshipful circular motions as if to encourage their growth. Cooing at their touch, you can almost hear them churn and thrum in tune with virile purpose with the simmering richness of the change pouring through you. Shit these little guys know how to treat a girl, you titter delightedly, as your heavy cum tanks sink into their willowly coils, as the plush weight of you cum tanks presses against the nearly stifling confines of your suit.";
			WaitLineBreak;
			say "     You jerk the lush gossamer swell of your doughy sheath, while the fabric starts tearing in some places as it struggles to contain your billowing curves and ever more regal proportions. Strangely, your tainted mind revels at the notion for your plush body breaking free of its [italic type]snuggly[roman type] cocoon. As you spy out of the restricted corner of your vision, the faux-fur along your middle splits open with an audible creak as your burgeoning belly and [breast size desc of Player] breasts slips free. Wow you little guys really aren't holding back, you moan in bestial reflief at the ambient breeze flutter across shimmer pelt as the tears spread outward as your body continues to grow by the second. Huffing excitedly, your extremities stretch outward, fresh inches of cushy tallow and dense maternal muscle ripples through your lush cuddly form. Mh, more, you swoon, drinking in the fleeting glimpses of your cute fuzzy tum and [breast size desc of Player] chest wobbling before you. Evermore of these cracks appear around your limbs as the caring feelers swaddling you burst forth through the frayed gaps in a writhing magenta tide. Till your suit at last gives way with an audible *[italic type]rip[roman type]*, showering the area in a vibrant dusting of alabaster stuffing and faux fur.";
			say "     Though a brief sense of loss tugs at the back of your mind, the invigorating kiss of the air upon your pelt, and affection caress of the shrinking tendrils stills such notions as you observe the gloves and booties wrapped snuggly about your paws start dissolve in scintillating sheen of purple ooze. While much of it seems lifeless and falls to the floor beside you with audible drip as it bubbles away in an odorless plume of metallic magenta hues. A few strands cling to your pads and are soon joined by the waning pod of tendrils roiling about your wrists and ankles. Far too horny to care about their purpose, let alone stop them as the burning need simmering through your turgid spire blankets your mind in a lewd pall. You can only watch with the dimmest of interest as they coil about your wrists and ankles in a fishnet pattern crisscrossing up your limbs. You find yourself yipping encouragingly at the oddly enthralling sensation of the thin magenta strands lightly cinching about your husky fox limbs. The lingering feelers snake their way along your plush core, coating your cushy tumby and flush breasts in buttery smoothy, yet supportive mesh of unearthly fibers.";
			WaitLineBreak;
			say "     Curiously though, they seem to avoid your sex, a feat of which the lust-addled psyche is deeply grateful for, as the epicurean changes surging through your shifting cock reaches their apex. The comfy flesh coddling your spire recedes just hair, the virgin nerves are pulled delectably tight by the hefty swell of your vulpine rod as its silky crimson glides out from the yummy confines of your dick wrapper. Shit sheaths are amazing, you preen, grinning from foxy ear-to-ear at the first velvety kiss of your pads pampering your flush tool courses through you like a lustful static charge. While you struggle to get your paws around its delicious contours as molten bands of pre dribbles down your arms. You ease yourself onto your back, letting the full weight and majesty of your fruitful form wash over you as you ravenously pump your wrist and hips like a shameless beast. Milking each blissful sensation from your oh-so-sensitive rod as your gorgeous knot pops loose with a near inaudible squelch, and leaves you howling at the changes fluttering through your blossoming figure.";
			say "     All the while, the gossamer webbing waving itself about your fecund middle inches its way across your breast, towards your neck, here the strange matter seems to hesitate. If only for a moment as the tendrils sink into the generous padding in a slither storm. Their wriggling forms soon glide along the edges of your muzzle as the fabric melts away much in the order your paws did, though most seem to settle about your neck like a bubbling collar as the rest is carried away by the breeze wafting through the store. Unbothered by the barest nips of chill caress your still reeling flesh, as subtle goosebumps play across your sensitive body. Your attention is drawn all the tighter to the artful taper of your spire peeking over the lush rim of your gorgeous middle, and the euphoric kiss of your pads hugging its slick, slender curves with every reverent piston of your wrists. Delectable images of cute hermy vixens, eager for the chance to to carry your cubs, worship your girthy spire, or fill your wondrous body with a litter of their own waltz about the edges of your mind's eye.";
			WaitLineBreak;
			say "     Yipping under your labored breath, you can almost feel the warmth of their glistening feral flowers hugging your tapered tool, or the passionate pounding of luxurious spires ravishing your needy folds. As prismatic motes of light dance across your vision as the teasing silky smoothness of your turgid tool gliding along your pads, and the heavenly spectacle of your fruitful form wobbling before your eyes pushes you all the nearer to the edges. Till with one happy roar, your balls thrum all the quicker as you cum, blasting a great ropey globs of vibrant alabaster seed skywards across the bare grey ceiling in shimmering off-white sheen of virile excess. Oh boy you REALLY needed that, you huff in a relief alloyed with the post-transformative bliss tingling through you.";
			say "     As your plush tool leisurely retracts into its new, proper home while letting your paws fall to the ground beside you. Sending a final, elated quiver through your still tender body as the soft welcoming flesh cinches about the graceful taper of your girthy hermhood. Mh, how did you ever live without one of these? You hum, idly smacking your vulpine chops in base contentment, as you snake your voluminous tail about its plush, inviting curves before giving the soft meaty flesh an appreciative little squeeze. Before hoisting yourself on your paws with a pronounced series of thumps as the shelves around rattle with the echoes of your every step while you right yourself.";
			WaitLineBreak;
		else:
			say "      Exalting at their enthralling kiss of the waning tendrils coiling along the borders of your [cunt size desc of Player] muff, coaxing the soft blanket of comforting fur creeps over your [cockname of player] pussy. You find yourself rumbling in a dissonant soft canidae trill at the sensuous sensation of your sex straining against the glossy rim of your suit's vent as virgin inches of flush fertile foxy flesh simmering into being. Thoughtlessly, you draw your gloved palms along the libidinous curves of your supple, sensitive body with simpleminded delight as your hand dips beneath the lush curves of tender tum. Fuck you're getting so soft, you purr, paws gently tracing the conveniently placed edges of your suit's elastic silt. Your needy muff blushes with the raw essence of change as your lips engorge and flow outward into a juicy triangular flower while you lovingly grope its glossy petals. Sending a fresh rush of primal satisfaction through your deepening folds as your fingers sink into the prominent puffy swell of your burgeoning foxy muff.";
			say "     Gods can't wait to use this thing, you simper at the endearing sparks of sensation coursing through you as your fingers explore its exquisite gossamer contours of your swelling cunt. Each meaty fold practically gushes with your balm honey as your prominent sex gently fills palm to the brim while your eager, hungry walls subtly tug on your inquisitive digits as you probe their angular curves. Curiously dipping your mitts into your statin depths, enthralling imaginings of your budding foxiness sat on some large snuggly cushion, gleaming ebony lips on full display as you beckon all manner of studly wolves, stacked vixens, femmy tods to your side coalesce in your mind's eye. Dimly, you can almost smell the rich spicy scent of past lay's pre teasing your petite button nose or hear the eager pants of these dreamy mates. Your muzzle curls into a proud predatory grin as these blissful phantoms of flings past and future advance upon you, eager to claim you for themselves. Panting like a shameless beastess, you shut your eyes, letting the fantasy briefly wash over you as these mnemonic shadows blend together into the strapping simulacrum of a big strong alpha wolf.";
			WaitLineBreak;
			say "     Almost carved from living onyx, his dense rippling pelt is covered in a deep tapestry of scars both old, and new coiling along his sculpted core then down his regal digitigrade legs, surges forward to claim his prized slut. Yipping like a good subby fox, you bare your throat to him in greeting as the proud alpha roughly takes hold of your plush hips with his coarse paws. Billowing wisps of vapor peters along the edges of his muzzle, shrouding his molten golden eyes behind a sea of grey mist. As he leans over you, his glossy lips peeling back into a domineering too-toothy smirk as he sniffs your vulnerable neck and tender ripe assets while easing himself atop you. Gnarring in sweet whimper, you happily coil your tail about his hefty package and plush silky sheath in your ponderous limb's eager embrace. Lovingly kneading his rod with satin strokes of your dexterous tail leisurely coaxing his shapely cock to attention, earning you a well-pleased rumble from the wolf. As his girthy spire swells within its juicy housing, the majestic brute nips his way up the soft fuzz of your neck till your eyes meet. Swooning, you can almost you see your blissful expression playing across their primal orbs as he levels his turgid tool with your folds, while you fixing you a questioning stare.";
			say "     Such a kind Alpha, you hum, nodding your consent to the seemingly savage creature. After all, ";
			if player is impreg_now:
				say "your kits could use the meal, especially if they're going to grow up to be nice slutty vixen's just like their mommy. Your dreamself hums with a bawdy quiver at the welcome tactile touch of his hardened abs gently gliding along your cushy bump. ";
			else:
				say "your tummy is the perfect place for his cubs to grow into big sexy hunters just like their daddy. Your dreamself teases, lightly tracing your tail along the soft silky curves of your lustrous tum as you arch in offering to this primeval phantom. Earning you a sharp guttural growl of approval from your ghostly lover, as he drapes his rip cord abs against you. ";
			say "Basking in the course kiss of his pelt brushing your oh-so-sensitive navel, you lightly wrap your legs about his waist, lightly squeezing his toned hips between your satin thighs as you draw him toward his prize. Not that your alpha needed the encouragement, as his sheath strains against your tail's loving grip as girthy tool slips free of its tender home amid a soft gush of toasty pre that dribbles across your treasure trail like a molten stream of shimmering alabaster.";
			WaitLineBreak;
			say "     Humming at the heady pinpricks of lurid warmth tracing their way down your pearly pelt, you work your tail about the growing length of his cock while the regal Alpha nibbles the satin fur of your neck as his girthy tool plops across your ";
			if player is impreg_now:
				say "plush cuddly fox factory, eliciting a happy little quiver from your cubs as they squirm about the heavy impression of his knot sinking into your snuggly pelt. ";
			else:
				say "cushy belly, evoking a needy yip from your lips as the subtle thrum of his turgid knot plays across your treasure trail. ";
			say " Flashing you a bawdy sideways glance, your dream wolf merely chuffs at your antic as he rears back, drawing his moist bitch breaking rob across your flush body, before leveling his tool with your dripping vulpine flower, and thrusts.";
			say "     Salubrious bliss flares across your succulent folds as the ripening angular flesh stretches delectably with the glossy weight of his knotty cock. Panting you can feel your triangular cunt molding itself to the tapered swell of his rod with each toe clench thrust sends enthrall shockwaves through your voluptuous figure as the dreamy wolf ruts you with reckless abandon. Your eyes shamelessly wander the raw primeval valleys of his tight ebony six pack and dense pecs as you thoughtless reach up and gently run your fingers through his fur in abject delight at the sensation of his hardened muscles rippling beneath your pads. Grining approving, the phantasmal lupine's paws drift to the supple swell of your blossoming milk tanks as he pampers their taut curves with his rough pads, evincing a gentle gush of rich pearly cream from your melons while sink just a hair into your groaning mounds. Gasping at heady harness of his touch as the air resounds with the resonant patter of his domineering thrusts and muted swish of palmable balls pattering against your pillowy ass, you soon find yourself crying out for more while the subtle impression of his spire flicker across the juicy rim of your muff.";
			WaitLineBreak;
			say "     Gnarring in a deep brassy voice, your beastly mate's hands drift all the further down your breedable hips as he sinks his talons into your waist, brutishly hefting your flanks against himself, while your writhe beneath him. Awash in this torrent of phantasmal bliss, you hardly notice a spreading tightness building across your downy soft body as your suit constricts about you ever-so-slightly. Dimly, you can sense subtle tears rippling along its seams as if it were shrinking by the second as a bracing breeze coils about your exposed fur. Too lost in your own little world to care though, such thoughts seem the most distant of things to your dreamself rakes her claws through his fur, leaving a fresh trail of rosy lover's marks in their wake. All the while, your plush puppy pussy cinches about his girthy tool, tightly milking those glossy tapered curves as more and more of his plump knot slips between your dripping folds. Mmhh such a big boy, you preen, as balmy beads of feminine dew drip from your ripening petals, in velvety patter, drenching your dreamy regal mate's spire in a glistening sheen of girly juices.";
			say "     You practically feel each blissful thrum of his pulse playing across his cum vein as your lips glide ";
			if "Touched by Madness" is listed in feats of Player:
				say "centimeter by sordid centimeter ";
			else:
				say "inch by blessed inch ";
			say "over the bulbous swell of his knot, till with one intoxicating pop, you feel some give deep within you as he slams his gland home. Gasping at the dreamy rush of lewd sensations coursing through your [cunt size desc of Player] passage, your mind is sent reeling in raw elysium as your petals glide along satin curves of knot, swaddling the immaculate gland in your rippling folds. Even your phantasmal partner seems impressed as a brief look of surprise tugs at the edges of his lips as your cunt tightens about his cock. 'Good slut,' he growls, with the slightest nod of respect at you as he slows his pace, just hair, letting the puffy curves of your meaty muff play clench all the tighter about his cock. Thank you, ";
			if player is impreg_now:
				say "slut's babies are so hungry for Alpha's cum. ";
			else:
				say "slut promises to take good care of Alpha's cubs. ";
			say "you whorish yip at the enthralling caress of the satin fur gracing his taut sheath blushes your cunt.";
			WaitLineBreak;
			say "     Nodding, your regal fantasy merely beams at your words, as a shard tension simmers through your tied sexes as the heady throbbing of walls and his harsh resonant thrusts coil about your senses as your dream world shudders with your impending release. Glass-like cracks form along his chiseled core as your vision waltz on a knife's edge between the tight confines of your mask and void spun world of your mind's eye. Try as you might to push back against the unbidden incursion of the banal, fleeting sensations of the real world nip at the back of your mind as the padded fabric wrapped about your shifting being gives way in places, letting your growing majesty spill outward in a rush of tender foxy flesh. Distantly some part of mourns its loss, yet the strangely reassuring caress of they coiling about your matronly figure drowns out such petty concerns as your body expands with fresh inch of downy mommy fluff and pergatory muscles."; [pergatory is a portmanteau I made up.]
			say "     Then the pendulum swings again, and the dreamy grin of the phantom Alpha Wolf greets your gaze once more, his golden orbs ablaze with pride and admiration as your thunderous thighs constrict about his waist. Briefly returning his stare, your eyes drift down to the inviting swell of your fertile mounds and yummy tum as the same rapturous growth spreads through your precious wobbling assets. Mh, babies will love these, you nod, feeling of warmth and purpose bubbling through you as your ripen body presses against the dense furry sinew of your dreamy mate. 'Pups eat well,' the hunky wolf rumbles, leaning over your plush body, the steamy wisps of his breath traipse along your milk flushed mounds as he plants the sweetest of kisses on your burgeoning nips. Shuddering, you can only murmur in agreement while the heavenly slosh of your creamy tits echoes about the area as the world ripples as if stone were cast upon some still pound.";
			WaitLineBreak;
			say "     Reality settles once more into the waking realm, and the feeling of the wolf's yummy spire recedes, while the inquisitive caress of your gloved digits dancing along your plump pussy surges forward. You watch in abject amazement as your overstretched suit fully fails as the tendrils pour from the gaps spreading across your maternal figure. Shredding what little remains of the tattered textiles, showering the store in a generous misting of white stuffing and faux fur as your body spreads out before you. All the while, the remaining tendrils, now little more than thin strings of gossamer magenta, drape themselves about your limbs in a strangely familiar fishnet pattern as they coil upward towards your throat. Blessedly, the affectionate creatures seem to avoid your glossy muff as they supportively cinch about your snuggly tum and [breast size desc of Player] tits, yet as they wriggle about your neck you feel your mask and gloves begin to dissolve in a tepid sheen of odorless purple ooze.";
			say "     Absentmindly, you can feel the this strange substance pool about your neck like a collar the tightness in you muff slowly overwhelms your bliss wracked senses while you loose a bestial howl of release as you cum. Drenching your paws in vibrant sheen of warm honey as you collapse in a sweat panting heap, spent happy, and profoundly fulfilled while you withdraw your dripping digits with a playful flourish. Before hoisting yourself on your paws with a pronounced series of thumps as the shelves around rattle with the echoes of your every step while you right yourself.";[merge here and fix indents]
			WaitLineBreak;
		say "     Oddly though, the feeling of the very ground shaking beneath your paws and gentle little jiggle of your opulent fluffy assets gliding along your fur is somewhat... enticing, you muse, gazing down at the titillating sight of your ";
		if Player is impreg_now:
			say "plush creamy cub factory and flush two toned milkers spread out before you. Generously bejeweled in a thick layer of yummy padding, your gorgeous gut and resplendent rack dominate much of your view. Not that you'd have it any other way, you titter under your breath, basking in the sight of the warm motherly glow radiating off your fur, and soft happy kicks of your lovely little vixen's playing across the ripe curves of your blossoming bump. You cup a hand along the cushy hem of your lap filling belly as you playfully rub the adorable tiny outlines of their paws fluttering along your fur in abject delight, humming. Seems you dears have done some growing too, as you admire the added heft of your cubs while lovingly tickling their pads with the tips of your glossy claws, provoking another flutter of actively form your precious kits.";
			WaitLineBreak;
			say "     Looks like you're enjoying this just as much as mommy, not that she could blame them. You hum, nuzzling your muzzle along the palatial swell of your breasts. They must feel so happy and comfy inside this nice, big, fluffy mummy tummy, why just think of all the fun we're going to have together. You tease excitedly, letting your fingers sink into the pillowly padding of your plush middle and creamy tits. at the unbidden thought of pinning some hunky wolf, of femme fox beneath this nice fat litter. Mh, and you bet their going to love being big slutty vixens just like you, you hum with an expectant trill, letting your hands drift down to ";
			if player is herm:
				say "the meaty folds of your sheath as you give your tool a cheeky squeeze. ";
			else:
				say "your velvety foxhole as you give it another tender grope. ";
			say "Why just wait till they've got a chance experience this for themselves, you hum, turning your attention the rest of your voluptuous body.";
		else:
			say " salacious fur and fertile proportions, just begging to be used. You preen, cupping an elated paw beneath the generous hem of your ample ass, relishing the satin heft of your fuzzy cheeks spilling between your fingers. Already, a part of you is already looking forward to your next vist to the Mall or bunker and the chance to show off your curves to the locals. Why just thinking the lustful stares your new found foxiness will earn you puts a delights shiver down your spine.";
		say "     After all a body like this deserves to be shared, you preen, picturing the cocksure grin of some nameless adorable canine's muzzle as you pin them beneath this gorgeous fluffy, or the effervescent warmth of their nice meaty knot stretching your yummy foxy flower devilishly wide while you ride them raw. As blissful looks of pride and desire nipping at the edges of their lips as when you present your cub flushed body to them, you muse dreamily stroking your velvety fur, before turning your attention to the rest of your voluptuous body.";
		WaitLineBreak;
		say "     Comfortably standing at a little over ";
		if "Touched by Madness" is listed in feats of Player:
			say " two and a half meters tall, ";
		else:
			say "nine feet tall, ";
		say "your cushy figure easily dwarfs most of the bipedal ferals you encountered to date, and maybe even give some of the local taurs a run for their money. You crow, briefly entertaining the notion of smothering of nice hung Panther Taur beneath your pillowy splendor, or burying some yummy fennec between the folds of your creamy milk tanks. Perhaps you might even let a big strong Alpha wolf claim your tender womb with a litter of his cubs, you muse, a delighted shiver nipping at the base of your spine at the thought of a big bad wolf sinking his claws into your juicy ass.";
		say "    As you turn your attention to your plush silky legs, at first glance your thicc regal legs would look more at home on a sheltered broodmare then a hardened survivor, yet for all the majestic adipose lovely coddling your skull crushing thighs. A deepened core of dense, powerful muscle still rests beneath their soft furry exterior, more than eager to bear your weight, the predatory sinew positively brims with energy and purpose. Doing a playful twirl, you can even catch the briefest glimpse of their edges simmering along your pelt, or the elastic fibers of your fishnet bodysuit. Your paws meanwhile appear largely unaltered, save for a modest increase in size and few fingers of welcomed padding on the balls of your feet. A feature you can't help but feel a just a hair grateful for, as your soft mushy beans are oddly comforting to balance on while providing a bit of spring to your step.";
		WaitLineBreak;
		say "     Casting your gaze toward the alluring curves of your succulent furry ass and voluminous tail, you feel your lips begin to curl at the sight of your wide, breedable hips. Replete with welcoming doughy adipose, your bestial flanks are the perfect little addtion to your vulpine curves, graced with more then a few paws of supple flesh and ripe thong devouring cheeks, your ass will make the perfect coushin of for a pretty mommy fox like yourself to while away her days on. Outside of a slight increase in size, your floor dragging tail seems sadly unchanged beyond some added volume, still your lengthy fluffy limb could make for a wonderful pillow for a mate's head, or a comforting snuggly toy for you to cuddle the nights away with. You ruminate, flexing the not-so-little thing before yourself, briefly enjoying the way the light dances off your reddish-orange pelt, before turning your attention to reflective section of refrigerator glass as you begin examining your new face and fetching attire.";
		say "     Sleek and sly, your curvy muzzle is the picture of vulpine perfection, graced with a soft conical snoot and pencil then ebony lips imparts a sensuous yet devious quality to your expression. You preen, delight at the cute look of your fangs peeking out of the edges of your maw. You carefully run your candid tongue along their shape peak and serrated valleys, before drawing its supple tip along the tactile ridges of your mouth with a light shiver at the thought of treating some lucky puppy's pecker to your new found oral affections. Meanwhile, your rich magenta eyes have just the barest hints of exotic vertical slit, reminiscent of some proud hunting cat's, you muse, observing the subtle eyeshine of your tapetum lucidum reflected on in the glass, that's sure to be all the rage with your nocturnal playmates. You crow, shifting your gaze towards the fishnet body suit coddling your shapely frame.";
		WaitLineBreak;
		say "    Profoundly form fitting, the endearingly elastic material neatly compliments and supports your generous curves without being obstructive or necessarily tight while still drawing the still highlight the plush jiggle of your asset that accompanies your every motion. You muse, drinking the heady sight of your ";
		if player is impreg_now and player is herm:
			say "ripening bump as the strange tentacle born textile comfortably hugs your adorable creamy tum into an endearing dome, providing you with a generous view of your cushy sheath and gropable balls resting against your thighs. ";
		else if player is impreg_able and player is herm:
			say "pillowy tum as the feeler forged material sinks just a hair into the welcoming contour of you sexy muffin top like a plus sized girdle, leaving you with a more than welcome glimpse of your velvety sheath and palmable cum tanks tender nesting against your legs.";
		else if player is impreg_now and player is female:
			say "burgeoning tumby as the otherworldly matter born from the feelers sacrifice hugs your resplendent middle like a glove, molding your creamy bump into a flawless dome of maternal splendor. While endowing you, and your lucky prospective mates with a generous view of your glossy ebony puppy pussy. ";
		else if player is impreg_able and player is female:
			say "scrumptious alabaster belly as the tentacular textiles mesh swaddling your swaddling your pillow middle in a tender ebony mesh in a pleasant muffin top. All the better to treat yourself and your future mates with an intoxicating view of your needy jet black foxy flower. ";
		say "You swoon in simple-minded satisfaction, eyes waltz along a pair of lacy accents snaking their way up your expanded chest as you bask in the enthralling swell of your breast while they laze along the pencil thin  material compressing them into a prominent heart. Though as your gaze meanders towards your slender two toned neck, you spy a thin unlatch choker draped around your throat, running your mitts along its velvety onyx length, you find a little nametag resting clipped to it embossed with the words: [italic type]Property of Mistress Snuggle[roman type] in flowing anarchic cursive.";
		say "     More than just a hair curious why it isn't latched, you try to right it with a gentle tug and snap the willowy thing together, if only to see how you look with it on. To no avail as the compression lock simply pops loose a second later, and falls to the floor with a muted *tink*. Confused, and strangely unwilling to leave the thing be, you hurriedly pluck it from the floor, after all always fiddle with it later. You ruminate tucking the trinket away, for now you're looking forward to putting your body through its paces, you preen, giving your plush body a wet meaty slap before heading back outside.";
		LineBreak;
		say "     [bold type]New Sundered Codex entry unlocked[roman type]: view to learn more about how to unlock the full extent of infections special properties.";
		now HP of Mistress Snuggle is 8;
		setmonster "Snuggle Fox";
		choose row MonsterID from Table of Random Critters;
		now SkinName of Player is Name entry;
		now Skin of Player is skin entry;
		now BodyName of Player is Name entry;
		now Body of Player is body entry;
		now TailName of Player is Name entry;
		now Tail of Player is tail entry;
		now CockName of Player is Name entry;
		now Cock of Player is cock entry;
		now FaceName of Player is Name entry;
		now Face of Player is face Entry;
		Increase XP of Player by 69;
		if Perception of Mistress Snuggle is 2:
			StatChange "Stamina" by 1;
			StatChange "Strength" by 1;
		else if Perception of Mistress Snuggle is 3:
			StatChange "Stamina" by 1;
			StatChange "Strength" by 1;
			StatChange "Charisma" by 1;
		[ItemGain Unlatched Lacy Choker by 1;]
		ItemGain Latex Fishnet Lingerie by 1;
		Itemloss Fox Suit by 1;
		Itemloss Cute Tail by 1;
		Itemloss Foxy Paws by 1;
		now Da final Fox Down is resolved;
	else if Dexterity of Mistress Snuggle >= 1: [Author's note: I HATE muscular fem furs, but not everyone wants to play a foxy BBW milf with a vore kink for some reason. Hence, I threw this in as a peace offering to those odd ducks.]
		say "toned foxy form in a welcome cascade of transformative rhapsody.";
		WaitLineBreak;
		if Dexterity of Mistress Snuggle is 1:
			say "     Your lean canine body thrums with a wild squall of untapped vigor as the hardened curves of your hale midriff roil and condense beneath the inquisitive caress of the tentacular creatures. Any lingering fat, or extensions flesh boils away in a billowing plume of odorless steam seeping out the joints of your suit like thin alabaster tassels. Intrigued, you inquisitively run your gloved hands along the ample padding of your precious costume, foxy lips peeling back into a wolfish grin at invigorating blend of predatory muscle and the dense athletic sinew greeting your pads. You gleefully trace a gloved talon along the splendid hills and lustrous valleys of your sculpted athletic sixpack, finding it hard not to delectate in the richness of the changes surging outwards along your waist. Your hips widen, and flanks curve inward into a more pronounced hourglass figure many a woman, or herm would die for. You swoon, gliding your palms about your waist in simple admiration of classical shape and lovely definition of your vulpine figure. Playfully, drawing a clawed finger down your sides, you could easily see yourself modeling yourself on some exotic fashion show with curves like these. Perhaps, you might even one day prancing down some red carpet event with a hunky wolf, or handsome tod's arm wrapped about your waist like the true trophy you are.";
			Increase Dexterity of Mistress Snuggle by 1;
		else if Dexterity of Mistress Snuggle is 2:
			say "     Your toned and tight vulpine body crackles like a living stormfront as your already sculpted figure soaks in the tendrils final offering with ravenous aplomb. Your chiseled sixpack tightens and expands outward into a prominent swell of raw canine muscle easily detectable through the supple padding of your precious costume. Intrigued, you draw your gloved hand along the hardened contours of your abs, exalting in the raw primordial power surging through you as your nails trace the amazonian articulation of your changing figure. Smirking, you bet you could teach an anatomy class on the eye-catching bight of your crisp statuesque flanks. True, another time, you might have found such noticeable muscles somewhat... unsightly on such a feminine vixen as yourself. Yet, as your paws glide along your divinely proportioned hourglass waist and dense, chiseled core, such sentiments are the furthest from your mind, as it's hard not to appreciate the nanites['] work.";
			increase Dexterity of Mistress Snuggle by 1;
		if Player is herm:
			say "     The intoxicating ripple of change flows downward along your treasure trail like the nails of some playful lover tracing a pair of fingers through your fur. Panting, you eagerly stroke your gloved mitts along their wake, relishing the twin fonts of desire entwining about your [cock size desc of Player] cock and needy pussy like bands of the supplest lace. As these salubrious echoes of morphic rhapsody tighten about our tool as [cockname of Player] rod seems to recede, ever-so-slightly within you. Though motes of consternation grips your mind, at the first little tug upon your shifting tool, such worry evaporates seconds later like tule fog in the morning light as a warm veil of satin sensation engulfs the base of your cock. You find yourself purring at the first wave of the soft protective flesh surging about your tender cum vein, as your paws drift of their accord along plush contours of your suit to the buttery smooth lips of its convenient slit. You dip your fingers betwixt its tight, yet elastic folds with a needy whimper as a sudden rush of carnal bliss washing over you. Your hands lovingly glide about the blossoming taper of your [cock size desc of Player] cock as the first hints of your sheath creep over your changing tool.";
			WaitLineBreak;
			say "     While by no means a stranger to the unearthly euphoria transformation brings, or the borderline mind altering effect of feeling every fiber of being resculpted by the nanite's touch. The preternatural kiss of your warm dick wrapper edging over the lustrous contours of your tool feels different almost... natural to you. You swoon, drawing your hand about the shifting heft of your lush cock, basking in the unearthly sense of rightness filling pour through you. Fuck so good, you moan, at each primal pulse of delight coursing through your cock as the heady throb of your cum vein strains against against the softy, meaty flesh griping your dick. But you need more, you growl, gripping a gloved paw about its swelling base in open admiration of its pillowy fur. As you encouragingly stroke your budding sheath along the burgeoning length of your rod like a living fleshlight. With every needy pump of your wrists, the change gripping your dick becomes all the more pronounced as your cock head thins to a fine crimson spear. While the turgid base of your rod groans nearly imperceptibly with tension as a lush canine knot surges into being, pulling the creamy white fur of your delectably tight cock wrapper all the tauter. Restricted as your vision is, it's still hard not to notice the first proud impression of your knot rippling across your sheath, you preen at the ambient warmth of your aberrant pre soaks through your gloves.";
			say "     Far too enscrolled in the radiant bliss coursing through you to care, the tender drops of fragrant vulpine seed merely excites you all the more as the lewd pater of your foxy fun echoes about. All the while, several of the doting feelers cavorting about you changing body begin creep along the sensitive curves of your ";
			if Ball Size of Player <= 3:
				say "compact cum tanks ";
			else if Ball Size of Player is 4:
				say "'heft baby batter banks ";
			else if Ball Size of Player >= 5:
				say "prodigious sperm holsters ";
			say "in a loving shoal. As their glossy tepid forms affectionately massages your devilishly sensitive orbs in their glossy coils, in their wake, small patches of the same satin fur coating your lustrous futazonian body erupts along the edges of your ball bag. Impossibly soft and luxurious to the touch, the waning section of your human mind reels at the sensual silky of your fur playing along your inner thighs. As the sordid bight of your shift orbs seem to drink the bountiful surge of morphic rapture as they grow all the plumper, and just the right kind of heavy. You crow, yipping encouragement to the worshipful tendrils, as the thin layer protective fur evenly spreads along your heft sack like ripples passing through a still pond.";
			WaitLineBreak; [Note to Prome: Gonna be 100% real here, I have no fucking idea what to a call the little line on a man's ball bag, so I'm going with the medical term here unless you got a better name my dude.]
			say "     Yet once the gossamer tide crests your scrotal raphe, the formerly subdued hairs grow dense and pronounced in visible line in a lustful mirror of your prominent treasure trail. Oddly endearing though, the titillating touch of your exotic ball hawk merely adds to the thrill of your changes. You preen, playfully petting its prominent little ridge as your ample cum tank press ever-so-slightly against your thighs. A part of you can only imagine the looks on your favored mate's faces when they see your latest alterations. Mh just think of all the messy fun you're gonna have with the bad boys, you smirk, lightly jostle your heavy cum tanks at the thought of drenching some luckily feral in an effulgent veil of pearly fox seed. Perhaps, a cheeky voice tempts, you could find a nice slutty vixen, or a cute little breeder boi to have your way with, after all this apocalypse could use more foxes in it. You chuckle, easing yourself down onto your back with a contented sigh as the cool linoleum floor and low ambient breeze play across your liminal being.";
			say "     You spread your legs wide as your gaze lazes upon the blossoming swell of your turgid tool peaking over the lewd hills of your [breast size desc of Player] tits. It's hard not swoon at the pearly glint of your foxy pre, shimmering in the light as your hand roams its regal vermillion length, urging your cock to grow into a proud rod that would put even the naughtiest Painted Wolf Herm to shame. You fantasies, picturing the gleeful look on one of the exotic canine's face as she kneels before you like a good subby beta. Her eyes alight with puppy-like wonder at the sight of your plump alabaster sheath and rosy red gleam of your cock as it slides free of its wondrous warmer. Smirking, you can almost feel the light caress of her panting breath tracing the beastly taper of your tool, and hear the happy swish of her tail as it wags behind as you cheekily plop your cock on her snoot like an erotic treat.";
			WaitLineBreak;
			say "    Go on, you mouth in the throws of your lucid day dream, while a lewd shiver runs down your spine. As the hungry herm wraps hir lips about your tapered tool with a well-pleased yip while the waning forms of the frolicking feelers coating your body spiral about your turgid tool in a salacious rhythm. *Ah-ah* that's *mmhh* a good pup, you pant, letting your hand fall besides you as the velvety tendrils hug and caress your cock in expert tattoo that leaves you gasping for more as their malleable forms shift like sentient toys into a lewd simulacrum of a ridged canine maw. Too horny to fret, or the over hows and whys, your lust-addled mind swoons at the succulent bumps gliding along your cock in beatific metronome. Briefly closing your eyes, letting the fantasy wash over, you can almost feel the supple caress of the phantasmal pup's tongue gliding along the sleek curves of your cock, and the small the exotic redolence of her hybrid arousal wafting about your mask.";
			say "     Your dreamy toy worshipful bobs her snout along the growing length of your cock. Take it girl, you whisper with a soft ophidian trill, as you gently twerk your hip in tandem with her needy dandle, relishing the sublime little catch of her rigid muzzle playing across your cock. All the while, your shifting body expands beneath the supple padding of your suit as the subtle twang of snapping fibers drawn back to the walking world. Creaking your eyes open, your sharp vulpine sight easily spots tiny tears forming in the seams of your costume as the primeval muscle gracing your athletic body bulges outward. Oddly though, the spectacle only excites you all the more as flex your growing paws, delectating in the strangely satisfying sounds of your talons hewing your boots and gloves in twain while the torn textiles falls beside you.";
			WaitLineBreak;
			say "     Evermore tears spread, and deepen along your shifting core, while innumerable tendrils spill forth from between the cracks in a writhing magenta tide. Utterly heedless of the damage they inflict upon their home, the fabric slowly gives way ";
			if "Touched by Madness" is listed in feats of Player:
				say "centimeter-by-centimeter ";
			else:
				say "inch-by-inch ";
			say "as your fur and muscle peek through the growing rents in your failing costume. A primal sense of pride enameled with a glowing anticipation grips your heart as your free hand-paws drift along the splendid patches of silky fur in utter elysium at their changes pouring through your liminal being as your legs stretch out before you. Gods you're getting huge, you moan, raking your glossy black nails along the linoleum as your leggings split along some unseen seams, revealing the scintillating shoal of amethyst tendrils clinging to your legs. Though many seem to bubble away in a brilliant plume of purple fog upon the slight breeze wafting across your shifting figure, a few still cling to your limbs. You note, hefting a sculpted leg skyward while the vibrant echos the few tendrils gripping your cock in their velvety embrace ripples through you as their buttery smooth forms wriggle and glide along your girthy tool.";
			say "     Lewd pulses of static delight crash over you as you watch in lust-addle awe the tentacles wrapped about your legs flatten, then expand outward along the cute contours of your toes and legs forming adorable 'skintight' leggings. Idly, flexing your supple toe in curious elation, the cracks spread upwards along your torso, as the textile spit apart in with violent rip, showering the area in a dusting fur and padding as your massive frame bursts free. Sighing in relief, you observe through the thin slits in your mask as you remaining feeler entwined about your core melt together into looping bands of purple latex cinching it up and around your arms. Huffing excitedly, you flex your arm for a better view, observing the snaking streams of brilliant amethyst wrap about your stocky, yet feminine arms and fingers like an exotic glove. How wondrous, you purr, clicking your tongue as the light dances upon the unusual fabric like priceless gemstones while your mask and many of the feelers clinging to your adorable dissolves about you in an odorless cloud.";
			WaitLineBreak;
			say "     Those few that remain are soon wracked by the same unusual transformation gripping their peers, as they slither down your neck, and flatten outward into a tight latex-like collar. Curious, you run your paws along its length while the little bands of unusual material woven about your torso flow towards it. Lacking a proper vantage, you glance towards one of the more reflective refrigerator doors and watch as the coiling straps wrap themselves about your core in a flattering lattice that provides just that right kind of support to your adorable [Breast size desc of Player] chest. You preen, at the exquisite caress of the strange textile cupping your creamy white tits, and perky raven black nips. Letting your eyes drift further south, it's difficult not to appreciate how the straps seem to highlight your grace figure and dense sixpack, while the roiling piston of last surviving tendrils cascade over your liminal leaves your whimpering with animalistic need at sight of your changes. Damn you're looking good, you murmur, drinking in the vibrant shimmer of your pelt and tender flex of your tight muscular ass accompanying each light buck of your hips.";
			say "     Much less the crimson gleam of your cock glittering like some mercurial sun beneath the ambient neon glow of the nearby locker panel, you swoon, indulgently drinking in the the saturnian spectacle of the tendrils sinking ever-so-slightly into the meaty taper of cock and pleasant bounce of your heaving sack. Unbidden, your paws drift once more to the tight base of your knot and plump silk balls as you run the glassy curves of your fingers about them in pure obeisance over your changes. Stars above where has this thing been all your life, you gush, fondling the peerless swell of your paw filling spunk tanks. Eagerly tracing your fingers through the satin ridges of your prominent ball hawk, imagining the awestruck expression of the local slut puppies as they take in the sight of your virile hermdom. While your other hand attentively caresses your taut bitch-breaking gland, wondrously smooth, yet impossibly sensitive, the merest brush of your claws would have sent the [italic type]old you[roman type] over the edge. Yet, your vigorous vixen body simply wallows at the heady touch of your silky sheath and glossy talons drifting along its beatific borders as you decadently massage its turgid majestic in a lewd mirror of the tendrils gliding about your tool.";
			WaitLineBreak;
			say "     For all their former vim though, you can feel their pace slacken by the moment as your shifting figure seems to pull what few scraps of [']life['] that remains in them to fuel your transformation. Undaunted and seemingly driven to send themselves off with a bang, several of the wonderly inventive creatures loop about the doughy bulge of your sheath as they slip beneath its tender padding while a surprised gasp eschewes from your foxy lips. As a sudden rush of preternatural bliss coursing through you at the frictionless kiss of their wriggling forms surging about your knot and the innermost depths of your vulpine tool. You can only murmur vague praise at their zeal as your lustrous cock is swaddling their exotic embrace while a blissful tension like a bow being drawn builds in your breast with ever intoxicating flicker of their sensual forms. Gods yes, you moan, thoughtlessly arching your back, needily working your hips in tandem with their eager touch. Till with one sharp elated cry, your knot bulges and cum vein ripples with the force of your release as your dick erupts in molten torrent of fragently foxy jism as seed the air above you in a salty cloud of excess. For a moment, the billowing blanket of taint cum seems to hang above you as riotious pounding of your heart blares in your ears while the world around goes deathly still. Then instant passes and gravity exudes its hold on your load as a molten rain of musky spunk cascades down upon you.";
			say "     Too spent and impossibly content to care, you let the balmy deluge wash over you like exotic baptism as the changes gripping your body settle, along with the last few tendrils. Though mournful motes of melancholy scratch at the back of your mind as you observe them evaporating away in an effervescent plume that seems to hug your still raw curves like a parting kiss. The lingering bliss gripping your breast quiets these notions as look on with satisfaction at the resplendent sheen of pearly cum dripping down your fluffy yum gutter and diamond hard onyx nips. Besides, these creatures seemed to know that their time was short and wanted to impart this gift to you while they still had the chance. You muse, as you lay upon the cool floor, listening to the soft breeze wafting through the store while the strength slowly returns to your limbs.";
			WaitLineBreak;
			say "     [italic type]An indeterminate amount of time later[roman type], most of your alabaster seed has dried away, you pick yourself up off the floor with a happy grin at the sight of your reflection drifting across a nearby refrigerator door. Pawing up to it, you tilt your foxy muzzle to one side, then the other, as you admire your sleek conical snout and adorable vulpine. Mh, nice, very nice, you crow, tracing a glossy black talon through the thin border of your pelt as you lean into inspect the subtle shimmer of slitted magnets eyes. Mh a girl could get used to having a body like this, you hum, letting your gaze drift southward along the stately hills of your ample tits and hardened core. Fuck it feels it like you were poured into this body, you muse, at lightly running your silky pads over your rock ads. And this fur, heavens its soft and really draws the eye to all the right places, you smirk, flowing the cute little ridge of your treasure trail snaking its way down from petite navel to the pleasant bulge of your sheath. Encouragingly plump, your pearly yum wrapper looks so inviting to the touch, you could almost see some of the smaller feral using it as a pillow.";
			say "     Not that you'd blame them, you swoon, wrapping our slender mitts about virile tools as you watch your fingers into the rich fur with a well-pleased grin. Oh and this ball hawk, stars above, you might even be one of the only person (or herm) in town with one of these. You moan gliding your floor dragger of a tail across its radiant edges while you do a few more playful stretches while you take in the full majesty of your changes. Your new amazonian body could dwarf all but the tallest anthros, and perhaps even a one or two of the smaller taurs. That is to say nothing of your muscles, under some circumstance, they might be off putting. There is just something uniquely magical about the way your pelt hugs the sleek articulation of your core, accentuating each little movement or ripple of your sculpted frame. All the while the light seems to dance along the pearly alabaster splotch running down your neck and inner thighs. Your reddish-orange fur even gleams like the prismatic facets of well-polished ruby.";
			WaitLineBreak;
			say "     Even the rich midnight black of your paws have a noticeable sheen as if they were woven from the purest jet, you titter flexing your digitigrade legs before the mirror-esque surface of the glass door. Daw and just look at these beans! You squeal, catching sight of your puffy pink paw pads twinkling in the ambient light. Your glossy peets looks they were made of polished rose quartz, and provide you with nice bit of cushion, not to mention quites your steps. True, you might still need some practice before you're taking down Alpha Huskies like some shinobi fox, but a herm can dream can't she. You titter, taking a few experimental steps on your proper paws as you adjust to your new height, before turning your attention to the latex bands wrapped around your au courant form.";
			say "     Rather pleasing to the eye, your stocking does a wonderful job of showing off your legs muscles and cute widdle toes, lacking any silly bottoms, your new glittering magenta attire provides easy access to your foxy cock. And, you smirk gently hefting your fluffy balls out of the way, your gorgeous puppy-pus. Flushed with plenty of beastly padding, your angular ebon muff is a perfect addition to your fully realized form, you hum, lovingly running your paws along its prominent borders in simpleminded elation. Already, you're looking forward to filling your folds with a yummy knot, or seven, you preen, picturing the look on some studly alpha wolf's face as you mount him. Perhaps you might even muzzle a few of those tiny fennec bois out in the plains later too, after all you doubt those puny toys could satisfy a prize huntress like yourself with just their little puppy peckers. You giggle, lewdly stroking your beastly clit at the thought.";
			WaitLineBreak;
			say "     For now though, you have other matters and mates that require your attention, you shrug, letting your hands fall to your side before collecting yourself. Then making your way back out in the wider city ready to make your mark as the new fox on the block. Who knows when this is all over, you might even find a few people on the outside willing and eager to join you in vixendom, or maybe, you hum clasping your paw about tight midriff. You might even make a few more Snuggly Fox herms like yourself while you're at it. Either the apocalypse is still young, and you've got a wonderful body just itching to be put through its paces. You titter, picking your way outside.";
			LineBreak;
			say "     [bold type]New Sundered Codex entry unlocked[roman type]: view to learn more about how to unlock the full extent of infections special properties. Snuggle Fox content ends here, additional content can still be viewed on the foxy milf path.";
			now HP of Mistress Snuggle is 98;
			setmonster "Snuggle Fox";
			choose row MonsterID from Table of Random Critters;
			now SkinName of Player is Name entry;
			now Skin of Player is skin entry;
			now BodyName of Player is Name entry;
			now Body of Player is body entry;
			now TailName of Player is Name entry;
			now Tail of Player is tail entry;
			now CockName of Player is Name entry;
			now Cock of Player is cock entry;
			now FaceName of Player is Name entry;
			now Face of Player is face Entry;
			Increase XP of Player by 69;
			Increase XP of Player by 69;
			if Dexterity of Mistress Snuggle is 2:
				StatChange "Stamina" by 1;
				StatChange "Strength" by 1;
			else if Dexterity of Mistress Snuggle is 3:
				StatChange "Stamina" by 1;
				StatChange "Strength" by 1;
				StatChange "Charisma" by 1;
			ItemGain Lacy Body Suit by 1;
			Itemloss Fox Suit by 1;
			Itemloss Cute Tail by 1;
			Itemloss Foxy Paws by 1;
			increase Breast Size of Player by 2;
			increase Cock Length of Player by 2;
			now Da final Fox Down is resolved;
		else: [Fem muscle fox version]
			say "     The euphoric pulsations of changes arc down along your treasure trail as the satin fur tracing your cute, foxy navels crackles with endearing motes of static delight as a tuft of cream white hairs swirl into being beneath the silky padding of your suit. Rather ticklish in its own right, a soft girly giggle peters from your lips as the costume born feelers seem to frolic about your chiseled middle while the prominent ridge snakes its way down along the stately bight of your rippling ads. Almost gasping at the salacious kiss of your virgin fur creeping along your plush pussy as the smooth tepid tendrils slink along your core in a soothing waltz. Your hands drift of their own accord along your statuesque midriff as the sordid wave of changes crashes over your needy cunt. Your [cunt size desc of Player] [cockname of Player] muff throbs with renewed need as its lips darken, and engorge with fresh ";
			if "Touched by Madness" is listed in feats of Player:
				say "centimeters ";
			else:
				say "inches ";
			say "of glorious foxy flesh as your blossoming vulpine petal strain, ever-so-slightly against the rubbery lips of your suit's glossy vent.";
			WaitLineBreak;
			say "     Gods this feels amazing! You moan, paws gliding along the pleasant ridges of your enviable ads as you inquisitively slip a pair of eager fingers between its elastic folds. Even gloved, your delightfully sensitive pads can still feel the rapturous changes flowing through your lustrous box as your pussy lips widen with each elated breath. You find it hard not to gush at the carnal sparks flashing across your walls as they expand outward, growing angular, and wondersly prominent like a proper vixen's pussy should be. You swoon, fondling the warm, buttery smooth lips of your fat, foxy flower as your ebony vulva seems to hug your finger with every doting dandle, like they were some cute tod's delectable cock. All the while, the wriggling forms of your tentacular hanger-ons swarm about your well-cushioned cunt in shared delight. In no mood to deny yourself their epicurean touch, you ease yourself to the cool linoleum floor with a playful giggle, purring. Mh go on everyone, you wanna see what they can do, as you spread your legs for them.";
			say "     Eager to please, or enjoy the fruits of labor, the strangely affectionate creatures require little urging as they slip about the adorable delta of your plush vulpine muff, lovingly squeezing your dewy folds into a throbbing heart. Mh, naughty monsters, you pant, at the first electric tingle of your luxurious angular walls gliding along one another as your soft, malleable muff crinkles with need. Idly flexing your growing claws along the supple padding of your boots, you thoughtlessly arch your back as if leaning into the touch of some treasured lover as a trifecta of impossibly sleek tendrils flicker along the puffy furrow of your box and beastly button. Don't stop you little teases, you moan as the burgeoning nerves gush at the first rush of stimulation washing over them. The fracturing fragments of your human mind reels at their slightly flicker or genial squeeze as your blossoming flower creeps over the silky fur coating your amazonian form.";
			WaitLineBreak;
			say "     Shit you guys really know how to treat a girl! You gasp, tongue lolling from the side of your muzzle at the barest caress of your pelt gliding along your muff as molten rivulets of feral honey drip along the glossy lips of your canidae cunt. Seemingly drawn by the lustful droplets, a trio of cheeky feelers corkscrew about your welcoming, meaty box, slathering their already hyaline forms in a generous veil of vulpine desire. Their every sordid motion sparks through your changing form like lightning dancing upon a ship's haul as they slip in frictionless unison betwixt your ravenous lips. Oh fuck ya, you whisper, in a demur reverent tone as your walls hug and cinch about their gloss forms. Each enthralling little motion of their lustrous lengths as they swell within your balmy folds like a trio of velvety knots. Panting like a bitch in heat at the notion, your feral flower is stretched vivaciously taut by their presence, you can scarcely dream what it would feel it get fucked with a cunt like this.";
			say "     As memories and fantasies of the various studly wolves, well-endowd hermy foxes, and twinkish tods wandering the city surge to the front of your mind as you imagine the sheer carnal bliss your lust-flushed muff could bring you. Just the thought of feeling the lewd little throb of their beastly tapers dicks playing across your walls, or the scrumptious hug of your supple lips tightening about their knots almost pushes you over the edge. Yet, your vigorous vixen's body hungers for more than just empty phantasmal simulacrums, as your tightening passage grips your playthings with lurid zeal, milking each thrust and delectable quiver of their glossy length. Awash in this sultry squall, your strangely perceptive '[italic type]toys[roman type]' seem to shift with toe curling thrust, growing a proud, lascivious taper like the many canines of your dreams. So full! You yip, watching the supple impressions of their malleable bodies flicker across the tightening hem of your suit.";
			WaitLineBreak;
			say "     Your dominant hands drift upwards along the stain fabric in wondrous admiration of your hardened core as you run your fingers across their lovely outlines flicking through your fur. Your elastic muscles cinch devilishly tight about them with each paw clenching piston, as subtle differences in their shape slowly shimmer to being. As the lurid curves of one deepens, becoming evermore pronounced while its taper hones to a fine point like some cute subby fennec, imparting an exotic bend to its thrusts as your cunt spasms enthralling beneath its touch. While a second expands, growing all the girthier by moment as its tender, bulbous gland enticingly strains against your walls in a libidinous tattoo as the heady impression of bereft from sail across your midriff akin to some brutish werewolf. The third tip flares and flattens outward into an animalist winged spear like some dommy alpha husky, imparting a dissonant little catch it pistons as your hungry muff quivers with the frictionless catch of its morphic form that leaves you moaning all the louder in foxy delight.";
			say "     Gods yes! You howl, utterly unconcerned about being discovered as you snake your gloved palms over the sensual outlines fluttering along your toned body. Eagerly tracing the supple impressions of your toys in delight at your body's growing elasticity and the lurid dissonant tightness of your cunt. Your changes walls ripple and conform to the intoxicating shapes of the dutiful tendril while erotic surge into being with each quivering thrust. Though oddly numb at first, lewd sensation slowly billows through you as your muff clenches delectably about their satin lengths, milking their malleable forms with soft, sublime little pulse of need that drive any lesser partner wild. You preen, sensing your control over your changing body grows by the second as your nanite altered mind adapts to your newest addition. Oddly though the rush of sensation billowing through your walls feels all too natural to you as you cinch and flex your lurid passage in a lewd mirror of your tentacular toys thrusts.";
			WaitLineBreak;
			say "     Happy, elated chirps whorl through about you as your frollicking friends encouragingly pamper your liminal figure, with endearing strokes of their soft tepid bodies along your supple [breast size desc of Player] chest. As they entwine themselves about the scrumptious swell of your two-toned furry breast, casting lewd little creases in your lovely sweater puppies while they curl about your stiffening ebony teats in loving elation at your transformation. Eliciting a rapturous gasp and a torrent of loving praises for your lips as your oh-so-sensitive blush beneath their tender caress as tweak and pamper your well-loved nips. Not to be outdone, teams of eager feelers frolic about your paws, gleefully massage your supple toes in a soft, obeisant motions that melts away any lingering tension of your shifting form.";
			say "     Amidst this intoxicating treatment, the fibers of your suit begin to give in places as the seams tear and the wriggling form of your tentacular helpers pour out. Seeming unconcerned with the damage they cause, more soon stream out of the widening gaps as your arms and legs stretch out about before. Another time, you might have bemoaned your suit's destruction, but the raw spiraling pounding for your cunt quiets these trivial concerns. As motes of transformative bliss spread out through your budding extremities as your claws burst through the dense fabric of your suit, rending them in twain. Yes, more! You roar, raking your talons through the linoleum, leaving beastly streaks in their wake as the gaps spread towards your core. Even the tendrils seem to share in your exuberance as a magenta shoal of wriggle annelids surge through the creaks in your failing costumes core, ripping the last few stands apart. Showering the area in a vibrant plume of cloud white padding and effulgent reddish-orange faux fur while you gasp in awestruck delight at the sight of your wondrous foxy figure. Damn that's hot, you rumble, voice waffling between a sweet trill and harsh vulpine bark at true majesty of your stacked, yet slender form.";
			WaitLineBreak;
			say "     Your paws move of their own accord the generous swell of your billowing [breast size desc of Player] tits as your perky mounds well-swaddled swell before your eyes to better match your growing physique. Fondling the supple fur and wriggling form of your tentacular playthings, your pads practically sing at the genial caress of stiff onyx nip gliding along their doughy surface as your lovely knead your expansive rack in primal satisfaction. The epicurean sight of the sultry feelers pounding your vulpine box and swirling about your delectable yum gutter evokes a needy mewl from your lips as you draw a taloned finger through your pristine pearly pelt. Delectating at the lewd quivers passing through their serpentine length, and the radiant gleaming blush of your foxy hide as you indulge yourself upon your amazonian body like the true wonder it is.";
			say "     A part of you swears you can feel a sympathetic throb of some studly pup's cock coursing through your toys dexterous forms at the gentle touch of your nail. Humming under your breath, you cheekily draw your hand down the alabaster tuft of fur decorating your treasure trail. Delighting in each vibrant stroke surging through your well-loved muff as you languidly wrap your paws about the warm, dripping folds of your beastly muff. Before carefully slipping fingers between the writhing forms of your playings, moaning. Shit this thing is amazing, you could fit a [one of]Wyvern[or]Behemoth[or]Shaft Beast[or]Giant[or]Wolftaur[or]Feral Sea Dragon[at random] in here, as your plump petals bulge ever-so-sightly to accommodate you. Waves of electric rhapsody cascade through you as the lurid meter of your thrusts pushes you over the edge with a room shaking howl, as you cum, squirting a scintillating gush of feminine honey."; [Any other big dick enemies I should add to the list?]
			WaitLineBreak;
			say "     Spent, and somewhat raw from your changes, lay your head back against the wriggling balaclava of your mask. While you pant in much needed release as the trio of titillating tendrils slip free of your throbbing folds with a wet toe curling '[italic type]pop[roman type]'. Unwilling to move just yet, your fingers gleefully stroke the satin fur of your breast and quivering mass of tired feeler, as you simply lay there. Listening to the audible drip of your dew, resounding through the area as the tendrils wrapped about you one last time as they go deathly still. Tilting your head for a better view, your eyes widen in surprise as many begin to bubble or boil away in billowing wisps of scentless magenta vapor, while others seem to flatten, and entwine themselves about your extremities like bands of rich purple latex. Intrigued, you lift your dominant leg skyward, watching some of the material around your adorable toe beans morph into exotic stockings, while the rest flow up along your limbs and chiseled torso. Turning your masked head towards one of the more reflective fridges, you watch as the few remaining tendrils clinging to your core, merge with their peers as coil their way like living vines up your enviable middle towards your collar. Though a rather snug fit, the thin furrows cast in your fur masterfully highlights the artful ridges of your abs and shapely swell of your now modestly larger bust.";
			say "    Smirking at the spectacle, your mask, along with your at times temperamental hangers on begins to dissolve in an odorless plume of metallic magenta vapors. A scant handful of them still lightly cling to your neck, as the familiar change grips them as well. They flatten out then entwine themselves about your throat like a sentient choker as they meld with their fellow forming a fetching yet supportive band about your collar bone. Intrigued both by the totality of your changes, and the feelers parting gift, you hoist yourself onto your now much taller legs then strut over to reflective glass to get a better look at the new you. Gazing at the alluring sight of your athletic form, you reckon your toned foxy form easily dwarfs all but the tallest anthros, and even some of the smaller taurs wandering the city. Meanwhile the lovely curves of your enhanced breast, though possibly large by puny people standards, are a nice match for your towering physique. You preen, eyes wandering along their two-toned bight as your playfully fluff your amply mounds with your billowing tail in simple admiration of their heft.";
			WaitLineBreak;
			say "     Your cute foxy muzzle and bright magenta eyes are the very picture of vulpine perfection as your thin conical snoot and adorable button seem to twinkle with mischievous light befitting a naughty vixen like yourself. You snicker, experimentally flashing your reflection a Cheshire grin that would make many a man, herm, or womans heart skip a beat as the few rays of ambient light glitter along your predatory fangs. Your ears though give you a moment of pause as they seem to straddle the line between a fennec's and the classical vulpine structure, despite their hybrid design. You do have to admit on some level they look nice on you and if nothing else will help you stand out in crow. You hum, fixing your awareness to your core and extremities as you drinking in the subtle radiance of your pelt and the regal splendor of your raised belly fur tracing its way to your juicy ebon cunt.";
			say "     Soft and plump, your glossy cunt practically begs for attention with the way its angular onyx petals gleam in the light while thin drops of fox need beads from its juicy lips. Already you can imagine the looks on the desperate feral's faces, as you strut through the city with your enthralling sex on full display looking for a nice yummy treat to indulge yourself on. You giggle, at the thought of pinning some virile alpha wolf beneath your power paws. Or perhaps, some cheeky side of you tempts, you could find some subby husky bitch to eat you out. After all their muzzles look so inviting and you bet their tongues would feel amazing lavishing your folds. You coo, idly clicking your talons along the floor as your gaze meanders southwards to your beatific digitigrade legs and paws. Bejeweled with pretty pink toe beans and adorable black 'socks', your well-padded peets are not only wonderful cushions, but muffles your steps. Well, maybe not entirely, you chuckle, listening to the ambient patter of your claws resounding on the plasticized floor, with some practice though you could see yourself becoming one of the sneakiest foxes around. For now though, the sight of them wrapped in your cute magenta stocking is more than enough of a reward, you muse, flexing paws before yourself.";
			WaitLineBreak;
			say "     Then shift your gaze to the windowed body suit circumscribing your inviting figure, it's difficult not to enjoy the way the 'fabric' hugs your curves. Highlighting your body's amazonian muscles and beastly extremities, true some facet of your twisted psyche will miss your old cuddly suit along with your tentacular playmates. But with a body like this, you crow, giving your toned ass an audible smack, you doubt you'd ever want to cover up again. For now though, you've got a whole apocalypse to enjoy and plenty of ferals and lovers in need of your attention. Perhaps one day, you might even make a few more vixen's like yourself. You opine, giving your pelt a gentle rub, before gathering up your things and slipping back outside, ready to face this crazy flexible world.";
			LineBreak;
			say "     [bold type]New Sundered Codex entry unlocked[roman type]: view to learn more about how to unlock the full extent of infections special properties. Snuggle Fox content ends here, additional content can still be viewed on the foxy milf path.";
			now HP of Mistress Snuggle is 98;
			setmonster "Snuggle Fox";
			choose row MonsterID from Table of Random Critters;
			now SkinName of Player is Name entry;
			now Skin of Player is skin entry;
			now BodyName of Player is Name entry;
			now Body of Player is body entry;
			now TailName of Player is Name entry;
			now Tail of Player is tail entry;
			now CockName of Player is Name entry;
			now Cock of Player is cock entry;
			now FaceName of Player is Name entry;
			now Face of Player is face Entry;
			Increase XP of Player by 69;
			Increase XP of Player by 69;
			if Dexterity of Mistress Snuggle is 2:
				StatChange "Stamina" by 1;
				StatChange "Strength" by 1;
			else if Dexterity of Mistress Snuggle is 3:
				StatChange "Stamina" by 1;
				StatChange "Strength" by 1;
				StatChange "Charisma" by 1;
			ItemGain Lacy Body Suit by 1;
			Itemloss Fox Suit by 1;
			Itemloss Cute Tail by 1;
			Itemloss Foxy Paws by 1;
			increase Breast Size of Player by 2;
			now Da final Fox Down is resolved;

Section 3 - Snuggle stuff


an everyturn rule:
	if Fox Suit is equipped and Cunt Count of Player >= 1 and "Sterile" is not listed in feats of Player:
		if XP of Mistress Snuggle < 8 and HP of Mistress Snuggle < 4:
			increase XP of Mistress Snuggle by 1;
		else if XP of Mistress Snuggle >= 8:
			say "[Foxy_thoughts]";

to say Foxy_thoughts:
	if XP of Mistress Snuggle >= 8 and HP of Mistress Snuggle is 0 and Cunt Count of Player >= 1:
		if player is impreg_now:
			say "     As your lovely condition advances, you find yourself becoming increasingly thankful for the elastic and at times, supportive nature of your cute little fursuit, as the stretchy fabric and dense padding seems to hug your growing tumby in just the right ways. You smile, dreamily running your fingers through the silky fur swaddling your adorable middle while the cute perky curves of your suit caress your lovely bump in a protective dome of perfect snuggly softness. Watching the synthetic fibers shimmer in the light, you can almost swear their creamy alabaster fur decorating your fecund core seems to be glowing with the same maternal light as your [skinname of Player] hide. Of course, you tell yourself that's impossible for all the insanity plagueing the city. Your fetching little trophy seems to be nothing more than a comfy, ordinary suit. You hum, giving your bountiful belly and well-padded ass a loving squeeze, delighting at the rich layer of pillowy cuddliness greeting your mitts as the fabric almost seems to hug your inquisitive digits. A strange sense of safety and security bubbles through you as the material presses down on you almost reassuringly.";
			say "     Smirking dreamily at the thought, you do a playful twirl, admiring the rest of your blossoming mom-bod. True, much of the [italic type]sweet snuggly softness[roman type] greeting your eyes is a result of the suit's plentiful stuffing and expert cut. A cheerful section of your maternal mind hopes that in time, you'll grow into a curvy vixen one day, and you won't need something as silly as a mass of synthetic fibers to affect this gorgeous profile. You muse, as pleasant images of your well-seeded foxy body reclining on a nice soft bed, your tummy ripe with countless kits and breasts laden with yummy cream spreads out before you. Briefly closing your eyes, you can almost feel the paws of some tender vulpine lover massaging your cute peets, or combing your big bushy tail like a pampered vixen deserves. For now though, this suit will do, and it's not like you can't find a nice foxy body of your own there somewhere. Although, you doubt any of the vixens slumming around the city would have the same proportions as your wonderful little fursuit, you huff internally.";
			now XP of Mistress Snuggle is 0;
			Increase HP of Mistress Snuggle by 1;
		else:
			say "     Indulging yourself on the rich silky fur of your fox suit, you find it hard not to smile at the pleasant texture of your, er, you pause to shake your head. [italic type]It's[roman type] pelt gracing your fingers as you absentmindedly smooth any errant fibers that might ruin the natural grain. You can't resist giving the well-padded thing a tender pat, despite any apprehension you might have once had when you first found it, the suit seems for all intents and purposes to be utterly inert. Sure there have been moments where the slit seems to hug your groin just a little too tightly at times, but considering its placement, you're fairly certain this was no doubt the owner's intent. Nor can you say that you're not enjoying the plush caress of the fabric hugging your curves, or the gentle kiss of the silky lining upon your hide. Even its curvy feminine nature is starting to grow on you as the sight of your cute bubble butt and the extra inch imparted to your assets are fetching in their own way. True, it would be a simple thing to seek out a pretty latex vixen, or femmy tod and get yourself a real vulpine body, yet you doubt you could find one with such divine proportions.";
			now XP of Mistress Snuggle is 0;
			Increase HP of Mistress Snuggle by 1;
	else if XP of Mistress Snuggle >= 8 and HP of Mistress Snuggle is 1 and Cunt Count of Player >= 1:
		if player is impreg_now:
			say "     Waddling through the city, hands resting comfortably on the ample swell of your cute kit laden - er, you hesitate as the suit seems to constrict ever-so-slightly about you - baby bump as you walk is quickly becoming a habit of yours. Not that you think anyone would blame you, your suit is so [italic type]snuggly wuggly soft[roman type], you doubt anyone could keep their mitts off it, or you for long, especially given how tender and warm the fabric feels as it massages your adorable little tumby, or milk-flushed breasts. Besides, your little ones seem to be enjoying the attention as they've become rather responsive to your touch and mood as the slightest doting caress is enough to provoke a gentle flurry of butterfly kisses from your sweet widdle babes. You find it hard not to smirk at the deepening bond you've come to feel with your young, as you whisper a note of thanks to this wonderful suit for bringing you closer together. True, a sobering side of you notes as you idly drum your fingering along the thicc padding swaddling your growing hem line, you know you'll miss these moments of maternal connection once they're born.";
			say "     But, you can always have more, perhaps next time you'll pay one of the local latex vixens a visit once your brood has made its debut. You can only imagine how nice it would be to bend over for one of those well-hung herms, you swoon, picturing yourself on all four in this adorable cuddly suit. Your padded ass on full display as a big, strong, dommy vixen saunters up behind you, sinking hir claws in your cute bubble as shi claims your needy pussy. Delectable images of your [cunt size desc of player] heat-kissed passage being stretched wondrously taut by hir plump latex knot while the soft borders of your suit's convenient slit massages hir rod as shi pumps you full of vitamin fox. You pant, hands drifting to the vent neatly hugging your cunt as lewd flashes of your tummy swelling blissful round with gallons of warm rubbery vixen cum fills your mind. You shamelessly grope the plush padding coddling your cunt at the thought of one day kneeling before hir as you present your bump to hir with a dopey smile. And the loving words pouring from hir lips as shi pats you on the head, praising you for being such a good mommy. All the while, hir juicy cock bobs inches away from your lips as the heady scent of vulpine pre wafts as you slowly lean in, eager to worship hir tapered spire... Only to snap out of this latest, nanite-induced day dream with a vigorous shake of your head.";
			now XP of Mistress Snuggle is 0;
			Increase HP of Mistress Snuggle by 1;
		else:
			say "     Strutting though the city, you catch sight of your properly-suited form reflecting in a nearby cast off mirror, you pause to admire your costume's lush curves, and adorable pelt as you do a few playful poses. True, your suit's fur and figure are not the real thing, but you find it hard to care as you strike a few fanciful poses, delighting in the pleasant shimmer of its fur, and the light hug of the padding caressing your body. A part of you almost wishes you never have to take the thing off as your new foxy duds have grown on you all the more in the past few days. Now if only you could find a nice fox to give a body like this... Despite the odd assortment of ferals populating the city, you've yet to meet a vulpine with your [italic type]cuddly wuggly[roman type] build. Perhaps one day though, your luck might turn and you won't need this costume anymore. Then again, with the right mixing and matching, perhaps you could find a way to affect these same adorable proportions.";
			say "     Till then, you at least have this pretty little runner up to keep you company, you muse, giving yourself a merry hug as you affectionately nuzzle your cheeks against its silky hide and absentmindedly sniff the soothing aroma wafting off it. After all, it's rather impressive your chosen apparel has stayed so clean, despite your *ahem* predilections, and lack of many of the modern comforts you've come to enjoy. Whether this is due to some quirk of its design, or your own natural savvy and survival skills allowing you to take better care of your prize, you can't be certain. Regardless you're thankful for this nonetheless, as any lesser costume would have likely fallen apart long ago. You beam giving the thing another affectionate pat before returning to your current task.";
			now XP of Mistress Snuggle is 0;
			Increase HP of Mistress Snuggle by 1;
	else if XP of Mistress Snuggle >= 8 and HP of Mistress Snuggle is 2 and Cunt Count of Player >= 1:
		if player is impreg_now:
			say "     Happily ambling through some lonely part of the city, you find yourself carrying on a pleasant, if one sided conversation with your latest litter of adorable mutants. Sure, your young ones can't talk back in the traditional sense, but as you run your fingers through the silky fur and bountiful padding coddling their slumbering forms, you can still feel not just their love and appreciation for you, but their home too as their tiny kicks ripple across your supple middle. Grinning, you can only imagine how it must feel for them to be wrapped in this nice doughy stuffing while they develop into big sexy mutants, just like their daddy. You hum, dreamily reminiscing on some of your more recent trysts. Besides, your widdle dears seem to love it when you cum almost as much as you do, you muse, recalling the pleasant feeling of shared warmth filling your body after one of your more passionate flings while you gently caress their slumbering forms. Hopefully, some twisted section of your psyche coos, your precious angels will grow up with a nice fat monster cock just like their daddy[if player is herm], although you wouldn't mind it if they took after your own [cockname of player] dick either[end if].";
			say "     Chuckling at the thought, you cheerfully ask your growing kits - er, you pause struggling for the correct word as a strange feeling of light headedness rattles through your skull. By no means discomforting, this balmy numbing pall spreads over your mind like a warm, soft downy blanket, smothering your worries. Still, some section of your nanite-touched mind tries to fight past this unbidden brain fog, yet these mental struggles are short lived. Your suit seems to writhe about your fruitful curves in a soft comforting rhythm that quiets your thoughts in a welcoming cocoon of snuggly sensations, while the plush lips of your costume's vent seem to vibrate ever-so-slightly about your sex. Panting beneath its caress, the feeling of confusion leaves just as quickly as it began, as the throbbing lancets of desire flicker across your needy cunt as your lust-plumped muff demands your attention.";
			WaitLineBreak;
			say "     Unbidden, your [italic type]paws[roman type] casually drift to the satin folds of your trophy's oh-so-convenient vent as you shamelessly dip your fingers between your pregnancy-flushed petals with deliberate slowness. Relishing the kiss of the latex walls hugging as you jill the dewy folds of your [cockname of Player] cunt while your fingers glide along the stiffening hood of your needy button. You find yourself purring at the delightfully endearing kiss of the silky latex caressing your digits as you slip one, then another of your fingers betwixt the tender lips of your [cunt size desc of Player] muff. Shamelessly lavishing your desperate sex with frantic little pistons of your dexterous fingers, your digits waltz about your lovely folds, lustrous sparks of static bliss arcing through your lust-flushed cunt as all too real images of your ripening gravid body straddling some puny fennec fox out in the plains fill your mind. A part of you swears you can actually feel his soft sandy fur caressing your inner thighs, the decadent kiss of his nice meaty knot worshipping your well-loved walls, and the heady reverberations of your cub-swollen tum upon his chest as you hungrily bounce on that cute tapered rod. Positively drunk on the fantasy, and roiling cocktail of tainted motherly hormones surging through you as your needy cunt hugs the silky curves of his foxy tool. Your far-traveled senses hardly even notices a number of strange wriggling shapes blossoming along the suit's inner lining.";
			say "     Dimly, you sense them squirming down your spine and verdant maternal curves as they slowly pool along the inviting padding of your costume's bottom while the pictures of your plush kit-laden belly wobbling atop the smol fennec dance through your mind's eye. The dreamy fox works his silky palms over your resplendent figure, in much the same pattern as the feelers combing your comely curves while he takes hold of your [bodydesc of player] ass. Another time you might have thought this odd, yet all your fuck-starved brain can think of is the bestial kiss of his fat knot brushing the quivering lips of your cunt, or the enthralling touch of his paws supporting you. Fuck you're huge, you stammer, no longer sure if he's even a product of the mind, as no mere daydream could ever mimic the raw tactile bliss of the cute vulpine's cock stretching your elated passage devilishly wide with each buck of your hips, and loving kiss of his fur caressing your matronly form. Much less his joyous expression as his tongue lolling from his lips while he watches your heaving tum and gorgeous milky mounds ripple with each commanding piston.";
			WaitLineBreak;
			say "     The tight walls of your cunt edge ";
			if "Touch by Madness" is listed in feats of Player:
				say "centimeter by centimeter ";
			else:
				say "inch by blissful inch ";
			say "over the growing swell of his adorable knot, sending vivacious waves of bestial bliss coursing through your [cunt size desc of Player] muff, as your eager sex slips along its throbbing curves with reverent languidity. Ah yes good boi, fill momma's pussy, you growl with a sharp, almost canine snap as the too-taut lips of your ravenous muff engulf his knot with a low rubbery squelch. Your dreamy toy yips and pants in a heady emulsion of tension and desire as you desperately rock your well-seeded form atop him. Delighting in the feeling of sublime fullness roiling through your core as his plump gland lavishes your quivering cunt and boyish quiver of his soft body accompanying the lewd patter of your ripe belly upon his chest. Your silky walls cinch about the artful taper of his vulpine rod like a gossamer glove, ravenously milking the subtle curves of his sleek spire and glistening cum vein in tune with the needy pistons of your hips. Moaning with primal desire, your phantom foxy lover eagerly bounces your bountiful form along his vulpine rod with surprising strength. My, my aren't you a strong boi? You tease, reveling at the sensation of his palms sinking into the rich padding of your suit while your puddling overstretched walls quiver about his cock with every spine-tingling thrust.";
			say "     'Yes, slave must be strong for Mistress Snuggle, and her cubs,' the servile fennec pants, eyes rolling skyward, giving your [TailName of player] ass a rough sensual grope while his tiny claws sink into your suit. 'Mhh such a good pet,' your dreamself purrs as your [SkinName of Player] hide tingles with static anticipation as a lovely sheen of goosebumps simmers across your elated form. 'Now cum for mommy,' the phantom you purrs, senses dancing on a crooked axis flickering between the city and your dreamscape. The image and sensation of your vulpine toy's turgid tool pampering your tender folds winks in then out of existence like a broken kineograph with every desperate tweak of your dexterous digits as the blissful tension roils through your core. Too horny to care which lovely vision is real or not, the raw elysium coiling about your tender muff numbs you to all but the burning need coursing through you and stills any such thoughts. You hardly even notice as a thin patch of soft silky red-orange fur blossoms across the borders of your cunt as the supple kiss of your dreamy plaything's thrumming spire echoes about your well-used passage.";
			WaitLineBreak;
			say "     'Mmh, Mistress Snuggle's fur is so soft,' your little fuck-meat hums, paws dancing along the small of your back. 'Mmhh, thank you pet,' the other you murmurs, exalting at the silky caress of his pads while the supple carpet of downy hair spreads across your inner thighs with each ravenous piston of your hips. You can't resist drawing your free fingers along the [bodydesc of player] contours of your [bodyname of Player] form, as if to encourage your spreading pelt. Your suit seems to tighten about your tender nips and plush tum while fresh patches of the satin fur blossom along your shifting being, blanketing your body in a regal carpet of foxy perfection as a steady tide of comforting fuzz creeps its way up your neck. Spellbound by the enchanting glimmer of your pelt reflecting in the available light, you tenderly nuzzle your chin against the welcoming voluminous hair as it almost affectionately swaddles your [FaceName of Player] face in its tender embrace.";
			say "     Cooing at its touch, you swear you can nearly see the shimmering reflection of your fur dancing in the tiny vulpine's eyes as his pulsing spire twitches with impending release. You commandingly dandle your [bodydesc of player] hips with a wild bestial abandon, reveling in the plaintive pant and eagers yips of the naughty tod as your hungry cunt grips his silky tool. Till with a cute little whimper, your dreamy plaything cums, basting your plush muff in a warm, creamy sheen of vulpine virility, as your fantasy briefly ripples and awareness shifts to your eager walls reverently spasming about your fingers. Your voice joins his in a shared howl of vulpine release as your quivering walls gush a thin trickle of foxy juice down your gossamer arm while you snap back to reality. Shaking your head as you withdraw your fingers with playful flourish, you quickly peer down at your altered hands with an invigorating mix of fear and elation as you take in the sight of the beautiful fur gracing your mitts. Strangely though, your [italic type]paws[roman type] seem largely unaltered save for your fetching pelt. Duly curious if any other part of you has changed, you hastily remove the top of your fursuit, letting your pelt-swaddled belly and [Breast size desc of Player] tits flop free of their snuggly confine and let out a minor sigh of relief.";
			WaitLineBreak;
			say "     Beyond the virgin layer of cuddly softness coddling your blushing [bodyname of Player] figure, you appear to be completely unaltered. Although as you run your hand over the dense silky padding decorating your nice ripe middle, some fracturing section of your tainted mind can't help but wish that weren't the case. You preen, enjoying the cute little opalescent shimmer of the white splotch decorating your plush core and milky tits, or satin sheen of its red-orange borders. Though it might merely be the lingering effect of these changes messing with your mind, this new addition feels rather fitting in its own right, as at long last, you have a proper foxy pelt to call your own. Perhaps in the future your suit might even change you further, some elated facet of your tainted psyche crows at the notion of blossoming into a proper vixen one day. Yet, only time will tell, you ruminate as you zip up your suit and go about your day with giddy anticipation.";
			now XP of Mistress Snuggle is 0;
			Increase HP of Mistress Snuggle by 1;
			setmonster "Snuggle Fox";
			choose row MonsterID from Table of Random Critters;
			now SkinName of Player is Name entry;
			now Skin of Player is skin entry;
		else:
			say "     Cheerfully sashaying through some vacant section of the city, you find yourself fantasising about some of the more fantastical foxes you have encountered (or dream of encountering) in your journey, though most have been little more than cartoonish latex creatures and banal fennecs. Your mind soon settles on a more... mystical kind of fox as you absentmindedly paw at the inviting curves of your lovely suit. Dreamily, you find some nice quiet spot to sit down and the blissful image of a proud yet wild kitsune herm washes over your senses as the world melts away in a lustful fog. In its place, you find yourself sitting in a secluded grove of verdant emerald grass, flanked on all sides by mighty oaks, their branches laden with thumb-sized bronze acorns that seem to sway in the low, sweet, floral breeze wafting through the glade. Though the sky overhead is largely obscured by the vast canopy, you can still catch brief glimpses of the rich azure firmament peaking though the leaves, while thin bands of light dance across the forest floor.";
			say "     Amidst this peace, you just barely hear the soft russling of the underbrush as your lover and provider slips through the gaps in this ocean of verdant green while the scent of fresh blood and vulpine sweat gently coil about you as the towering seven-foot-tall huntress steps out from foliage. Clad in naught but hir glimmering grey fur graced with an enthralling swirl of blue tattoos snaking about the shapely swell of perky C-cups capped by perky black nips, and armed only with a bloodied redwood spear, from which the freshly-dressed bundles of rabbit meat dangle. Your foxy mate cuts an imposing, primal figure, made all the more enticing by hir lustrous green eyes, thin vertical scars on hir tight toned midriff, and sculpted digitigrade legs. Each one a living record of some distant challenge bested, or foe vanquished in hir nine centuries of life, or, at least so shi claims. Proud and wild as the lands shi calls home, your dreamy mate makes no effort to cover the plush bob of hir fat juicy sheath, nor the pendulous sway of hir creamy oh-so-palmable balls as shi struts towards you. Hir nine billowing grey tails, capped with inviting cyan twitch with the lingering motes of adrenaline still coursing through hir predatory form.";
			WaitLineBreak;
			say "     Shi returns your lustful stare with a ravenous glint in hir sharp jade eyes while a pair of hir nine tails tenderly flicker about hir paws as shi jabs the tip of hir paw-carved spear into the ground. Eyes shimmering with predatory purpose, she motions to the brown cloth bundles swaying from the butt of hir wooden Yari. Then to the blushing tip of hir cushy cock cave with a haughty nod of hir regal head. Of course my lady, you purr, as a light rumble passes through your stomach while your mouth waters at the thought of serving this primal Forest Kami. 'Come,' shi trills, in a lurid sylvan hymn, hir paws drifting towards the meaty curves of hir plump dick wrapper in open invitation. Nodding, you begin to rise, but a sharp little hiss from the primeval vixen halts you in place.";
			say "     'Ah-ah-ah,' shi tuts, fixing you with a mercurial stare while cheekily waving a sleek vulpine finger at you in playful warning. You stop in your tracks as the subtle glow of hir rich green eyes weighs down upon you. 'Crawl,' shi hums, lips curling into a voracious smirk. Yes mistress, you purr, as a heady shiver like fleeting wisps of hoarfrost trace their way up your spine while you crawl towards hir on your hands and knees, ass wagging behind you like an eager pup. 'That's better,' shi simpers delightedly, watching the endearing waggle of your [bodydesc of Player] hips as you seat yourself like a doting hound before hir bestial splendor. 'Good pet, show your reverence,' shi hums, clasping hir smooth, yet pillowy paws to your face as shi gently caresses your cheeks, then draws you in with deliberate slowness. Leaning into hir touch, you can't help but swoon at the loving kiss of hir fur playing across your hide and dissonant texture of hir pads.";
			WaitLineBreak;
			say "     Worn to a glassy finish by centuries of hardship, yet still welcoming and supple, hir fingers glide across your face with an ethereal grace that makes you practically melt beneath hir touch. The sharp edges of hir claws glide across your [skinname of Player] skin like a fine obsidian blade as you press your lips about the tender curve of hir dripping sheath. Purring, you indulgently drink in the sight of hir creamy pre beading down hir fur in scintillating rivulets, and bask in the primeval scents of aromatic herbs and spicy vulpine fragrances pouring off hir virility as you fix hir with imploring stare. Please mistress, you mouth, barely able to contain your bubbling desire to worship at hir foxy paws and feel the warmer throb of hir rod gracing your tongue. 'Mh, such manners,' shi preens, at the coiling caress of your breath wafting across hir unearthly pelt as the simmering tip of hir crimson tool leisurely peeks out of its gossamer housing. You watch in ravenous awe, hir sheath blushing and bulging before your eyes as hir tool slips free amid a gush of delicious pre. 'Go on pet, give thanks for your meal,' shi purrs, losing hir hold on you. 'Itadakimasu,' your dreamself hums, drawing your lips about the graceful taper of hir half-chubbed six inch cock."; [Itadakimasu = thank you for the meal]
			say "     You elicit a regal rumble of vulpine desire from hir at the reverent kiss of your curious tongue exploring the throbbing curves of hir glossy cum vein in a soft sensual circuit as you lap at the tiny little beads of rich salty juices. Hir cock thrums with lurid purpose as the silky tip of your oral muscle gently glides along the sleek taper of hir juicy dick head with reverent slowness, while you savor each salty dollop of foxy delight beading from crimson tip of hir tool. This earns you another approving little gnar from the dreamy vixen as shi traces hir willowy paws about the curve of your jaw with the glossy razor edges of their talons. Shi languidly cups the back of the your skull in hir pads, and lovingly presses your elated lips against the taper of hir turgid spire. Nearly panting at the sumptuous sapor of hir pre gracing your eager maw, and the otherworldly glint in hir haughty, expectant stare, you begin to reach for hir throbbing rod, desperate to feel its lurid pulse playing across your palms and palate.";
			WaitLineBreak;
			say "     'Ah, no touching,' shi hisses, as hir tails shoot out, slapping your hand aside with an audible *[italic type]crack[roman type]* that splits the air. Wincing, but by no means deterred, you merely nod, then crane your neck and worshipfully wrap your lips about hir tender toasty tool, delighting at the subtle shiver passing through the stern kami as your tongue coils about hir spire. Purring, you watch in raw titillation as hir eyes drift skyward while you lovingly bob your [HeadName of Player] head along the swelling taper of hir juicy tool with lascivious slowness. With each doting pass, the fantastical fox's cock surges to life along the loving furrow of your tongue as inch-upon-lurid-inch slips free of its opulent sheath. 'Ah such a good mortal,' shi hums at the intoxicating echoes of your animalistic coo simmering along hir glossy foot-long cock as you hungrily pamper hir girly prick with skillful flicks of your tongue, gently pressing the artful taper of hir spire to the roof of your [HeadName of Player] mouth.";
			say "     The haughty vixen practically whimpers with bestial need at the heavenly interplay of your soft palate and glossy teeth playing across hir spire as you slowly work your elated maw along the regal swell of hir spire, till your lips brush the doughy folds of hir taut sheath. You fix hir with a cheeky, yet worshipful stare as the supple tip of hir rod rifles the elastic borders of your throat, your nanite-enhanced body seems mold itself to this dreamy kitsune's thrumming dick with peerless ease as you take ever more blissful inches of hir tool with ravenous aplomb. 'Ammy be praised!' your lover swoons, roughly pressing on the back of your head as your throat creaks and groans with the weight of hir vulpine prick. Dimly, you can feel your neck bulge with the lustful impression of hir tapered cock along your overstretched skin, yet you are spurred onwards by the roiling bliss of hir delectable flavor and scrumptious sight of the herm melting under your vivacious touch as shi lightly bucks hir shapely hips in tune with the loving pistons of your oral affections."; [Ammy = Amaterasu]
			WaitLineBreak;
			say "     Spellbound, your eyes drift to the lustful wobble of hir plush C-cups as the once preening vixen pants like a needy heat-filled bitch while twin wisps of steam pour from the edges of hir willowy muzzle. Hir free paw slowly drifts to the gracefully curves of hir tender tits as shi shamelessly gropes vast pawfuls of lush fluffy fur in hir mitts in a shameless display of self-indulgence. You watch hir fingers sink into the regal swell of hir succulent love pillows, casting deep, enthralling furrows into hir tattooed fur as shi tweaks the lush ebon curves of hir nips with hir silky finger in raw need. Rumbling contently at the sight, and the glossy kiss of hir yummy girl dick simmering along your duly-loved palate, you can feel your neglected cunt grow delectably hot with base bestial desire as toasty droplets of feminine dew bead down the sides of your inner thighs. Unbidden, your mitts glide along the gossamer curves of your lovely suit with near laxity as you savor every lush little wobble of the dreamy vixen's plush mounds, and tactile bliss of your faux fur brushes your digits as you slip a pair of fingers between the latex lined folds of your costume's convenient slit.";
			say "     You can't help but let out a lewd little moan as your hungry lips seem to hug your inquisitive digits with the heavenly motions of your experienced fingers. You playfully alternate between pampering your eager button and desperate folds in an endless waltz of libidinous need. While the echoes of your voice ripple about your imaginary lover's foxy cock as hir fat slut-breaking knot swells along the rim of your [italic type]muzzle[roman type], filling your senses with the raw tang of hir futa need. Chuffing betwixt the affectionate laps of your gloriously stuffed maw, you teasingly draw your tongue about the tight glassy smooth edges of hir plump gland, lovingly lapping at the exotic juices pouring from hir foxy rod with the tenderest of motions. This earns you a ravenous little rumble from the towering herm, as hir turgid cum vein thrums all the quicker, hir nails roughly digging into the back of your head as shi roughly presses you against hir lush cock.";
			WaitLineBreak;
			say "     Surrendering to hir fantastical touch, you can feel your body molding itself to hir whims as your throat relaxes and skin goes hot to the touch as your wondrous suit seems to writhe about you in a tempestuous squall. Thin patches of silky fur blossom along the borders of your [cunt size desc of Player] pussy. Too lost to your own enthralling fantasies, your tainted mind registers neither alarm, nor surprise as you sluttily shuffle your changing legs, reveling in the satin plushness caressing your fingers and the unearthly bliss of your eager maw gliding around hir glossy knot. So good, you stammer, barely able even speak as hir ripe futa dick ripples along your throat and taut knot serenades your senses as hir turgid gland is roughly forced between your lips. 'Such a wondrous mortal you are [italic type]Snuggle[roman type], you've more than earned my blessing,' the vixen coos, as the fur spreads along the [bodydesc of Player] curves of your [bodyname of Player] body like a silky tide.";
			say "     Thoughtlessly, you watch out of the corner of your eye as the orange-red pelt crawls up your cheeks, swaddling your [FaceName of Player] visage in a bountiful blanket of cuddly perfection. Swooning at the squall of delightful change washing over you, the grove begins to shudder as the vision of your dreamy mate's wild domain and the harshness of the city's environs flicker back and forth like a sputtering kinetograph. Though you rail against this unbidden intrusion, you can feel this strange lucid dream beginning to unravel by the moment as the image of your foxy friend flickers before you as if a candle were thrust into the wind. Still, you focus upon hir futa scent, delectable spectacle of hir paws roaming the fertile curves of hir sizable sweater puppies, and heady caress of hir cock ravishing your maw as you fervently jill your puddling snatch with mindless alacrity. All the while your fantastical lover's spire pulses along your ecstatic palate till with one muted cute girly yip shi cums, basting your [italic type]muzzle[roman type] in a molten sheen of vulpine seed.";
			WaitLineBreak;
			say "     Cooing in raw elysium, your tummy strains ever-so-slighty against your suit with the warm weight of hir load as you ravenously swallow each decadent drop in a desperate attempt to please this fugue-born beauty. The bawdy echoes of hir climax seem to cascade through your tender form as your quivering muff tightens about your fingers while your pulse thunders in your ears as your voice joins hirs in a primal sonnet of vulpine release. The grove shudders as the seams of this serene place begin to burn with a blue light, and you look on still tied to your fantastic foxy mate with a mix of fear and awe as the blaze consumes everything in their path. Though the vixen remains untouched, your dreamscape soon smolders away like freshly struck flashpaper as you 'awaken', fingers still pampering your cunt back in the secluded section of the wider city. Cursing under your breath, you withdraw your digits with a quick flick and make ready to call out to the otherworldly vixen, yet as the words begin to form on your lips, you stop, realizing you never even knew hir name. Shaking your head, you look down, and note, with some strange sense of pride, your new pelt remains, but is every bit as supple as it was in your dream, if not more so.";
			say "     You ruminate, lovingly running your palms along the unchanged cheeks of your [facename of Player] face as your post nut mind wonders if you should continue to wear this suit, and what the long term consequences could be. Yet as you gaze at your lovely foxy fur, basking in the heady afterglow of your oh-so-vivid fantasy, a part of you wonders if perhaps you're overthinking things. You don't feel any malice or ill intent from your costume, nor can you say you don't find these changes rather... fetching in their own right. Maybe, some tainted section of your psyche tempts, [bold type]you should keep it to see what it does next[roman type], after all who knows what manner of snuggly vixen you might become. Besides, you ruminate, it's not like you can't find another form you like should the mood take you.";
			now XP of Mistress Snuggle is 0;
			now HP of Mistress Snuggle is 3;
			setmonster "Snuggle Fox";
			choose row MonsterID from Table of Random Critters;
			now SkinName of Player is Name entry;
			now Skin of Player is skin entry;
	else if XP of Mistress Snuggle >= 8 and HP of Mistress Snuggle is 3 and Cunt Count of Player >= 1: [we stopped here]
		say "     In the many hours since your strange transformation, your suit has gone oddly still, and with its sudden calm, the vivid fantasies that once nipped at the back of your seems to have abated. Yet, for whatever reason, some part of you feels, you pause searching for the word... cheated by the preternatural torpor of your lovely little costume. You grumble, absentmindedly running your mitts through the silky faux-fuz swaddling your [bodyname of player] form. strange as it may be, you can't help but hope on some level that your fetching trophy might have at last given you a proper foxy form of your dreams. For the joy it might bring you to adopt one of the more common foxy forms filling the city, it still feels like you'd be lowering yourself to becoming one of ubiquitous latex currs wandering the city, or boring fennecs mindlessly prowling the dry plains. Then again, you opine with a disheartened shake of your head, it's not like you can expect the nanites to cater to every whim and provide with such vulpine majesty. Perhaps, some clinical section of your psyche notes, whatever unusual nanites, or unknowable energies that brought forth your latest changes were simply expended in your blissful daydream.";
		say "     Although as you think back on your excursion to the High Rise District, you recall that, according to the shipping documents, your prize was scattered between several distribution sites around the city. True, you have no way of knowing if the remaining pieces are still there, much intact, or, more pertinently, possessed with the same transformative properties as your current attire. Spoiled for time as you sometimes are though, it might be worth a look regardless, who knows what manner of supplies and materials could be left fallow at these shipping hubs. Conversely, a cautionary side of you notes, such places were surely picked over during the early days of the outbreak. What's more, considering the intense nature of your daydreams, is it truly wise to seek out the rest of this unusual costume? You think to yourself, recalling the all too real feelings, and profound sense of dissociation brought on by your fantasies. Then again, a prize such as this could be useful to the right person, so it might be worth seeking out the remaining pieces if only to sell it later.";
		LineBreak;
		say "     [italic type]With all this in mind what would you like to do? Note: choosing to abandon this quest is a permanent choice that can not be undone, and no new content will open up till you progress.[roman type]";
		LineBreak;
		let to_fox_or_not_to_fox_Choices be a list of text;
		add "Abandon this fool notion." to to_fox_or_not_to_fox_Choices;
		add "Look for the missing pieces." to to_fox_or_not_to_fox_Choices;
		let to_fox_or_not_to_fox_Choice be what the player chooses from to_fox_or_not_to_fox_Choices;
		if to_fox_or_not_to_fox_Choice is:
			-- "Abandon this fool notion.":
				say "     Mulling it over for a spell, you decide against pursuing the remaining sections of your suit, though it still gulls to turn back on what could be your only chance to cultivate this infection further. The risks far outweigh the gains, and who knows, in time you might find the vulpine body you crave somewhere out there in the wider city. Perhaps, you could even craft your own form the myriad creatures roaming the world. At least with the common strains, you know risks such changes can bring, not to mention, you'll have a modicum of control over the time and nature of your changes, which is far more than you can say for this odd fur suit. As there is no way to know what the long term effects of it could be, or what manner of creature you'll become. You reason, with a light shrug of your shoulder as you go back to your business.";
				now HP of Mistress Snuggle is 97;
			-- "Look for the missing pieces.":
				say "      Whether driven, by avarice, some deep seeded transformative desire, or raw unbridled curiosity, you decide to take your chances and seek out the last remaining pieces of your fur suit, ";
				if SkinName of Player is "Snuggle Fox" and Player is impreg_now:
					say "after all, you muse, cheekily slipping a [italic type]paw[roman type] into the well-padded folds of your treasured costume. Indulging yourself on the supple comforting warmth of greeting your mitts as you lovingly run your fingers though your silky tummy fur. You can't say you, and your little monster haven't been enjoying the extra snuggly softness your pelt imparts. Why some part of you titters, your kits seem to love their mommy's new cuddly tumby and outlook almost as much as you do. You grin, running your palms about their adorable slumbering forms, gushing at their subtle little kicks and effervescent cocktail of motherly hormones course through you. Blissful images of your future foxy litters soon fill your mind, as you picture yourself as a sexy matronly vixen with a gorgeous pelt and divine proportions lounging upon some tranquil tropical beach.";
					say "     Your body kept ripe and full of beautiful kits by your chosen mates, while you wile away your days in motherly serenity surrounded by your loved ones. Or getting to share those brief, but oh-so-precious moments with your brood when they drink their first meal and grow into comely vixens and strapping tods. True, there is no guarantee your suit is capable of such things, but the chance alone is worth the risk. Besides, even if your form is imperfect, you can mix and match other infections into your own till you achieve the splendor you, and your kits deserve. You ruminate, as you almost regretfully withdrawing your mitt from the supple swell of your cuddly tum, before waddling over to the convenient patch of open ground then sit yourself down with a content sigh and begin digging though your inventory. Though it takes a while as you often find yourself pausing to pamper the lush swell of your snuggable bump, or describe some of your more interesting finds to your lovely kits. You eventually find the folded up slip of paper detailing the drop offs for the suit's remaining pieces.";
					WaitLineBreak;
					say "     The paws and tail it seems were sent to THe Warehouse District to some minor fly-by-night company you've never heard of called: '[bold type]Flying Fuxi's[roman type]' while the head was shipped to, you pause to squint at the crease in the parchment struggling to make out the surviving letters... '[italic type]F*d-U* *xp*e**[roman type].' Darn it, how are you going to find this thing! You hiss grumply under your breath, unable to make heads or tails of the name, much less the address. Unless, Fuxi's has another copy of the shipping bill! You exclaim, in giddy delight. Of course, you'll still need to find it in the twisting maze of derelict storehouses, abandoned buildings, and unsavory establishments dotting the warehouse district, but at least it's a start you think to yourself. Already daydreaming about how nice it will be to have a nice soft set of [italic type]snuggly wuggly[roman type] shoes to strut around in. Or better yet, you hum, idly flexing your [bodyname of player] toes, perhaps gaining some cute foxy paws all your own.";
					say "     Tittering at the thought, some part of you wonders what would look nicer with your pelt, some cute widdle willowy peeties, you preen. Flexing your dominant foot into the air, imagine how adorable you'd look with some strong shapely hips and tiny little toe beans. Or maybe, a wistful part of your mind tempts, some big stompy paws and nice thicc thighs. Both would certainly help carrying the little ones around, you muse, tucking your hands under your tender bump. Cheerfully asking your kits their opinions, and greeted with the same bubbling blissful indecision as your little one's squire with equal delight at both options. Shrugging, you guess you'll just have to find out what together what manner of vixen you'll become, you coo, giving your adorable cubs a loving pat, before ambling to your feet and stashing away your slip for later.";
					now HP of Mistress Snuggle is 4;
					now XP of Mistress Snuggle is 0;
				else if SkinName of Player is "Snuggle Fox" and Player is impreg_able:
					say "considering how lovely your current pelt is, and the shapely curves of your wonderful suit, you scarcely dream how divine you'll look with a cute set of foxy pawbs and a proper tail. You ruminate, flexing your dominant hand before yourself, picturing your [bodyname of Player] fingers shifting into adorable fluffy mitts, graced with supple jelly beans and some nice shiny claws to boot. Almost preening over the blissful image, your eyes and palms wander south as you indulge yourself on the tasteful padding of your plush suit grope-able ass, while debating what manner of tail would best fit your refined sensibilities. Perhaps a nice long bushy floor dragger you could wrap yourself, or, some lucky lover in, you preen as decadent images of voluminous silky tails tease your senses. Then again, a more slender and subdued limb might do as well, you think to yourself, imagining a sleek little limb gracing your form. Neither too large to be hindrance, nor small enough to go unnoticed, such a dainty thing could make for a splendid addition to your figure.";
					WaitLineBreak;
					say "     Of course, who's to say you might end up with just one, some covetous facet of your mind crows, you could well end up with a vivid array of limbs to go with your shifting body. Smirking at the thought, you can scarcely dream how delightful it would be to parade such fetching ornaments to your chosen mate's. To say nothing of the utility they could offer in your day-to-day life, you opine, strutting over to some quiet section of the local area, and begin rifling through your inventory for the shipping document you set aside when found your precious prize. Minutes later, you find the folded up thing tucked away in the deepest parts of your inventory. Flicking it open, you hurriedly skim through all the legalese and boiler plate dribble to find your quarry's paws and tail have been sent to some obscure shipping company called: '[bold type]Flying Fuxi's[roman type]' down in the [bold type]warehouse district[roman type]. While the head was sent to, you pause to squint at the rough crease in the page: '[italic type]F*d-U* *xp*e**[roman type].'";
					say "     Fuck, now how are you going to find that thing, you growl, unable to read the crumped text or address. Though your mood soon brightens as you realize there is a chance there might be some record at the Fuxi's of where the head was sent. True, a cynical section of your psyche notes, it might be a long shot, but you've probably gone on looser leads than this. If nothing else, you might find other useful sundries and supplies on this latest excursion, you muse, mind alight with possibilities at manners of spoils await you, as you carefully stash away your lead for later. In the meantime, you'd best prepare for the trip, as all manner of unsavory sorts have made their nest down at the docks.";
					now HP of Mistress Snuggle is 4;
					now XP of Mistress Snuggle is 0;
				else:
					say "and the prospect of locating a potential untapped cache of supplies, or perhaps selling this tainted suit to some of the more affluent members of society. You hurriedly set about digging through your inventory for the shipping note you found sometime ago. Though cluttered, you soon locate the folded up thing rattling around with the rest of your more unique finds, and quickly begin skimming the boilerplate drawl for the location of the suit's missing piece. Skipping past some verbose disclaimers, you find the paws and tail are being held at some oddly named shipping company called: '[bold type]Flying Fuxi's[roman type]' down in the [bold type]Warehouse District[roman type]. While the head is... you hesitate, trying to read through the ugly crease in the parchment: [italic type]F*d-U* *xp*e**[roman type]? You mouth, unable to decipher the crumpled letters, much less the address. Fuck! You grumble, in raw disgust, briefly considering tossing the unhelpful slip aside and simply abandoning this fool's errand all together.";
					say "      Your mood soon brightens as some hopeful facet of your mind posits that perhaps Fuxi's could have a copy of the shipping bill much like the truck did. While it might be a long shot, completing this suit would merely be a pleasant little bonus compared to looting the shipping store. And who knows, considering its proximity to the docks, there could be all manner of exotic, or valuable trinkets nestled away, just waiting for a savvy scav like yourself to come by. You muse with a well-pleased grin as carefully tuck away the loose slip of paper for later. For now though, you have other matters to attend to, besides it can't hurt to make sure your stocked for the journey. The Warehouse District was always a scummy place even before the outbreak, so who can say what awaits you now.";
					now HP of Mistress Snuggle is 4;
					now XP of Mistress Snuggle is 0;



an everyturn rule:
	if Foxy Paws is equipped and Cute Tail is equipped and Fox Suit is equipped and Cunt Count of Player >= 1 and "sterile" is not listed in feats of Player:
		if XP of Mistress Snuggle < 8 and HP of Mistress Snuggle < 7:
			increase XP of Mistress Snuggle by 1;
		else if XP of Mistress Snuggle >= 8:
			say "[Fuxi_Dreams]";

to say Fuxi_Dreams:
	if HP of Mistress Snuggle is 5:
		if Player is impreg_now:
			say "     Cheerfully strolling through the wider city, it's hard not to marvel at how comfy your new shoes feel, the soft form fitting fabric almost seems to hug your [bodyname of player] feet with each step. While the dense, supportive padding laying their underside cushions and disperse the weight of your latest litter with ease, you muse, idly running your gloved mitts over the tender swell of your burgeoning bump and fruitful hips. Your [HeadName of Player] lips curl into a well-pleased grin at the kiss of its satin lining coddling your curves and eager paws-to-be as your hands wander your fecund splendor. You can't believe how natural your suit's presence has become to you, even your bubbly brood seems rather taken with their [italic type]soft snuggly home[roman type]. You hum, tracing a gloved finger along the subtle, placid outlines of their adorable forms. Not that you could blame them, they must feel wonderful, kept safe and protected inside your [italic type]big cuddly bump[roman type], with all these wonderful cushion to keep them secure in your more intimate moments.";
			say "     Even now, your belly rumbles, and mouth water at the notion of sucking off some stacked vulpine herms, or well-hung foxy tod, as the mercurial memories of the salty tang of some nameless canidae's pre dances on your lips, and glistening crimson afterimages of their yummy cocks gliding along your tongue. Panting at the thought, your horny little monsters squirm and kick with sympathetic delight as you massage your delectable curves. Mh, such active little dears, you purr in a soft bawdy trill, ";
			if Player is herm:
				say "as the lush little waves of sordid pressure cascade over your tender futa g-spot. Your gloved mitts thoughtlessly drift to the supple latex fold of your suit's convenient vent as your hermy dick slips between its smooth glossy lips. Fuck so soft, you mew, gloved fingers brushing the tender curves of your ripe [cock size desc of player] [cockname of Player] cock. Shamelessly tracing the unique contour of your cock with deliberate slowness while your mommy meat surges to life in your satin hands.";
				WaitLineBreak;
				say "     Unable to resist treating yourself to some much needed relief, you do a quick doubt take, to see if you're well and truly alone, or at least as much as you can be in this crazy burg. Finding you're free from prying eyes, you swiftly find a nice patch of clean (by post-apocalyptic standards) open ground, then gently ease yourself onto your back. Reveling in the supple weight of your brood washing over you as your incorrigible mutants wriggling in their downy home, and the pleasant little caress of your suits generous padding coddling your fertile curves. You lovingly run your gloves gossamer beans about the hardening curves of your plush, throbbing cum vein, as your gorgeous futa prick gently rifles the silky faux-fur of your growing tumby. You find yourself shivering at its satin kiss pampering your eager meat, as you cheekily press the graceful taper of your [cockname of Player] mommy cock to the ripening swell of your bump, wrapping your gloved mitts about your elated tool, in raw admiration of its [cock size desc of player] heft.";
				say "     God this feels amazing, you swoon, stroking your eager rod to full mast at a languid self-indulgent pace as your suit's downy soft fur seems to hug the unique curves of tool with lovely pass of your plushie wrapped mitts. Mh so soft, you pant, basking in the tender tickle of the faux pelt hugging your needy cock with each loving piston of your well-practiced wrists. All the while your costume seems to writhe ever-so-slightly about your sensitive [italic type]snuggly[roman type] form as the alluring outlines of innumerable tendrils dandle about your expectant majesty. Gushing at their touch and the heady memory of your past changes, a near vulpine yip peters from your lips at the supple caress of their inquisitive coils flickering about your well-loved body and tender [breast size desc of Player] chest in a reverent circuit. Kneading and massaging the lingering knots out of your lush figure, ";
				if SkinName of Player is "Snuggle Fox":
					say "or encouragingly caressing your fetching fur as their sinuous forms drift across your extremities like an affectionate pet. ";
				else:
					say "while rows of tingling goose bumps spread over your receptive being as familiar [italic type]snuggly[roman type] foxy fur once more creeps over your tender curves as the doting tendrils cascade down your extremities in worshipful tide. ";
				say "You find yourself quivering with raw anticipation as the subtle seams of your lovely suit part, the cool latex-like tips of these exotic feelers lovingly ripple about across your hands and feet.";
				WaitLineBreak;
				say "     A happy foxy yap eschews from your lips as your [italic type]paws[roman type] grow hot to the touch, your digits throb in a heady tattoo of change and palms strain against their lovely coverings as glossy doughy pads blossom along their surface. Divinely smooth, yet strangely tough and protective, their subtle ridges add an exotic, effervescent pressure to your strokes. Your spire practically sings with vulpine rapture at the innervating catch of your budding beans cinching about its lovely contours and the salubrious dandle of your furry cub-laden tum gliding along your yummy girl cock. Even your naughty [italic type]widdle[roman type] monsters seem to be enjoying themselves while they squirm with delight at the rapturous changes coursing through you. The first little hints of your claws begin to take shape, your nails flow outward into thin little nubs that impart just the right kind of tactile dissonance to the lewd pistons of your wrist as their honed edges sink ever-so-slighty into your turgid tool.";
				say "     Awash in the bubbling torrent hormonal bliss roiling through your motherly form, you hardly notice the subtle motes of change simmering across your feet. The worshipful tendrils massaging the soles of your [bodyname of player] [italic type]paws[roman type] soon begin thrumming with pinpricks of transformative anticipation coursing through your body in a coiling sonnet of contentment. You sense your peats being pulled, stretched, and molded by the doting touch of the inquisitive tendrils caress as your feet flow into an oh-so-familier foxy shape. Swooning with an eager trill at these welcome changes, you flex your budding beans in loving delight while thicc, doughy pads flicker along the surface of your elated [italic type]pawbs[roman type]. Fuck, you could get used to this kind of treatment, you purr dreamily, legs creaking and shifting by the second as they are affectionately shaped by the sensual motions of otherworld tendrils caressing your virgin pads. The welcoming warmth roiling through your extremities begins pouring upward into your core like a soothing tropical tide. Your legs start to stain against the supple padding gracing your suit as your stance edges all the nearer to a bestial digitigrade bend.";
				WaitLineBreak;
				say "     Almost humming in raw canidae bliss, you run your free hand paw along the length of plush legs, exalting in the fresh rippling muscle and protective tallow, made for ferrying and sheltering your brood creeps towards your waist. You muse, at the rapturous static caress of the suit born feelers indulgently pampering your fecund hips and cuddly tum, seemingly guiding the blossoming growth of your motherly vulpine body. You watch, in mirthful anticipation as a generous layer of maternal padding reverently pools about the tender swell of your taut little bump, pulling your suit all the tighter. Even your [italic type]kits[roman type] seem to drink in this font of blessed mutation, growing larger and stronger by the second, while your body quivers with fertile vigor as the ripening dome of excess weighs down upon you. Yet its lurid heft only excites you all the further as the pillowly curves of your [italic type]cub[roman type]-laden belly presses against your girly cock, putting pressure on all the right places as you feverishly twerk your hips in tune with the eager piston of your wrists.";
				say "     Enthralling tension bubbles along the edges of your awareness builds by the moment war for your attention with the decadent kicks of your kits and supple caress of your suit's faux-fur cascades along your spire. The lingering vestiges of morphic bliss cavorts about your arms and milky bust as they swell with snuggly tallow, perfect for holding, or providing for your cubs. Some mirthful section of your mind teases, while the oh-so-elastic fabric coddling your blossoming vulpine figure stretches to accommodate your lush body. Gushing at the impossible softness spreading over your increasingly foxy form, you can't help but nuzzle your chin along their voluptuous curves of your sloshing milk tanks, or indulgently stroke the inviting curves of your overly active figure as if to encourage these blessed changes. Mh, more, you pant, tongue lolling from the side of your fuzzy lips as the warm cocoon of foxy fluff engulfs your changing being in its cuddly embrace. Till the fruitful tension coiling within you snaps with a near imperceptible *twang* as your tender [cockname of Player] cock throbs with the force of your impending release. Unwilling to soil your prize, you hurriedly grip the base off your tool and angle it away from yourself while your cum vein bulges in your grasp as your squirt a thick spirt of futa seed along the ground beside you with a relaxed sigh.";
				WaitLineBreak;
				say "     Fuck you needed that, you murrmer, spent, but content, letting your mitts fall to yourside, while you wallow in the soothing afterglow of your much need climax. Before drawing your paws along the sensual curves of your newly changed body, idly petting the faint outlines of your suit's tendrils wriggling about your sated being. Though as the seconds stretch on, they grow still, then retreat into the hidden seams of your suit. Pawing at it, you can't find hide nor hair of them sheltering within the dense downy padding enveloping your changed form. Another time, you might have found this disquieting, or perhaps even resorted to more... destructive means of unearthing their boltholes. Yet as your fingers explore your fecundity you can only admire their handiwork, you ruminate, working yourself into a comfortable sitting position with your tummy carefully splayed between your legs. Then carefully unzip your suit to better examine your changes, your eyes widen with boundless elysium at the lurid spectacle of your fruitful majesty slipping free of its silky housing, as your simmering alabaster middle and plush tits plop out before you.";
				say "     Cheerfully running your foxy mitts over the flush tasteful coating of supple fluff swaddling your oh-so-ripe tummy fur and lush breasts, you let out low appreciative whistle at its pearlescent shimmer refracting in[if daytimer is day]brillient rays of the sun[else if daytimer is night]pale glow of the moonlight[end if]. While your pads explore the shallow little layer of motherly adipose coddling your kits, and the cute tuft of fur decorating your treasure trail. Before letting them drift upwards the tender curves of your once [breast size desc of Player] chest in animalistic admiration. You playfully trace your thin black talons along their perky swell, while little droplets of creamy bliss bead from your ebon nips as you watch their perky mass sinks into the roof of your fox factory. Mh, going to have a lot of fun with these, you purr hooking a single scintillated drop on the crook of your claw, then bring it to your lips and drawing your [facename of Player] tongue along its sleek curves as the rich sapor of your seeps across your taste buds.";
				WaitLineBreak;
				say "     Then shift your gaze down to your adorable vulpine legs, coated in a pleasant, welcoming layer of maternal adipose and dense silky reddish-orange fur, broken only by a glittering patch of gleam jet circumscribing your adorable paws like a cute [italic type]widdly[roman type] booties. Your digitigrade legs are wondrously suited for a budding voluptuous breeder herm like yourself, you hum, flexing your modest pawbs with whimsical delight while your run mitts down their silk length. Neither fat, nor fit, your devilishly thicc thighs are home to a plush coating of supple fur wrapped pudge concealing a dense layer of hard muscle that could creak a minotaur skull with a single squeeze. While still making a convenient little rest for your tum and ";
				if ball size of player <= 3:
					say "petite little ball bag ";
				else if ball size of player >= 4 and ball size of player < 6:
					say "plush cum tanks ";
				else if ball size of player >= 6:
					say "ponderous baby batter banks ";
				say "on. You preen, absentmindedly pampering the satin borders of your unaltered tool, murmuring. Gods, can't wait to see what this suit does to this beast, you hum, giving your cock a love squeeze.";
				say "     Lewd little flashes of a nice fat foxy cock and plump fuzzy cum tanks flicker around your mind's eyes, you can scarcely dream of how wonderful it will be to wrap your supple pads around a nice juicy sheath, or have some lucky fling worship your balls. You ruminate, sluttily shuffling your warm velvety thighs along the sensitive swell of your [cockname of Player] cock, before turning your attention to your arms. Much like your legs, your arms seem to have taken on a fluffy if average build, graced with the thinnest dusting of motherly softness which belies a tight core of predatory muscle. Your limbs are bejeweled in the same reddish-orange fur, capped with lustrous onyx claws, suited for the harsh task of surviving, or providing your chosen mates with a comfortable pillow should they ever prove worthy of your embrace. Meanwhile, your mitts are sculpted into an invigorating mix of vulpine and humanoid traits, you crow, admiring how your trim nimble digits maintain much of their former human articulation in addition to being blessed with cute pink heart shaped pads.";
				WaitLineBreak;
				say "     Clenching your fists, you feel vixen-like vigor laced with sense of bubbling pride coursing through your arms as you imagine how wondrous it will be to sink your claws into some delectable fuck meat's neck as your ride their unworthy forms. Or, some motherly side of you notes as your cubs continue to wriggle within your cushy tumby, to hold your kits in your maternal embrace while they take their first breaths. Tittering at the thought, you lovingly wrap your arms about your plush middle and ask your latest brood what they think of their new home and if they're looking forward to their new foxy bodies while you massage their now heavier forms. A fresh wave of effervescent bliss at the sound of your vulpine voice and kiss of your paws as your cubs affectionately grasp at your fingertips.";
				say "     Mh seems you [italic type]widdle[roman type] dears like mommy's body too, you purr, gently caressing the outlines of their paws flickering across your fur. Hopefully, you'll be able to finish your transformation into a proper vixen, after all your widdle monsters deserve the chance to be born a cute slutty foxes just like their naughty mommy. You preen, bundling your nascent form into the comforting folds of your suit once more before waddling to your paws and setting off upon your with proud dopey grin emblazoned on your face.";
				LineBreak;
				say "     [italic type]Author's Note: you can undo, remove your suit, give birth and repeat this event to gain a more hale, athletic body[roman type].";
				now HP of Mistress Snuggle is 6;
				now XP of Mistress Snuggle is 0;
				now Perception of Mistress Snuggle is 1;
				setmonster "Snuggle Fox";
				choose row MonsterID from Table of Random Critters;
				now SkinName of Player is Name entry;
				now Skin of Player is skin entry;
				now BodyName of Player is Name entry;
				now Body of Player is body entry;
				decrease gestation of child by a random number from 1 to 3;
				if gestation of child < 1, now gestation of Child is 1;
				increase Breast size of Player by 2;
				increase Cock Length of Player by 2;
				increase ball size of Player by 1;
				StatChange "Charisma" by 1;
				StatChange "Strength" by 1;
				now Scalevalue of Player is 3;
			else:
				say "as the inviting quickening of your adorable little [italic type]kits[roman type] washes over your [bodydesc of Player] figure. Your gloved hands steadily drift down along the padded curves of your lustrous as they leisurely slip past the toasty curves of your fruitful bump, to the welcoming folds of your suits latex vents as you shamelessly dip a pair of inquisitive digits between the flexible slit.";
				WaitLineBreak;
				say "     Gods this thing is so smooth, you trill, wallowing in the blissful kiss of your endearing costume's lining hugging your [bodyname of Player] fingers as they gliding along the pregnancy puffed lips of your [cunt size desc of Player] cunt with a purposeful slowness. You quickly scan the immediate area for any signs of ferals, or unwanted voyeurs, seemingly alone though, at least for the moment, you ease yourself onto your back. Mh, feels good to lay down, you purr in raw contentment at the wondrous weight of your cute little monsters washing over your fertile body. And this view, shit you look so goddamn hot like this, you hum, letting your eyes wander the creamy curves of your [breast size desc of Player] tit and big sexy bump as you needily drip a pair of fingers into the [cunt size desc of Player] lips of your [cockname of player] pussy. Flushed with motherly excess, your plump lips seem to mold themselves to the silky curves of your gloves as indulgently caress your eager muff with soft worshipful motions. Fuck you needed this, you mew, at the lurid cascades of carnal elysium coursing along through folds as your dripping walls cinch ever-so-slightly about your dexterous digits with each supple stroke. Your thumb and pointer fingers playfully glide along the elated borders of your joy buzzer, though awkward as the odd dissonance sensation of your well-padded gloves imparts a certain clumsiness to your digits.";
				say "     Such concerns are the furthest thing from your mind, as the supple kiss of the faux-fur caressing your puddling snatch soon leaves you panting for more as images of some nameless doting fennec attending your yummy pussy for you simmers across your mind's eye. Smirking at the thought, you close your eyes, letting the fantasy take hold as you picture some affectionate, if nervous, vulpine boi awkwardly pawing up behind you. Even laying the adorably smol phantom fox barely sees past the cream curves of your matronly body, and almost seems intimidated by the sight of such a gorgeous mommy fox in full repose. Tittering at their trepidation and the heady scent of animalistic need wafting off of him, you beckon the adorable boi forward with a comehither gesture, promising him you don't bite, much. Audibly gulping, the tiny fennec merely nods, nestles himself against you, loving running his hands through glowing belly fur as he eases himself into a kneeling position. Mmhh good boy, he loves mommy's tummy doesn't he? You murmur, delighting in the supple kiss of his pads gliding across your vulnerable body as you spread legs wide.";
				WaitLineBreak;
				say "     'Yes mame,' he purrs, leaning in till his nose hovers but a hair's breadth from your cream treasure trail. 'So soft and perfect, just like Mistress [italic type]Snuggle[roman type],' he adds, paws drifting along your glowing pelt as he traces his glossy claws about your fertile petals. The warm white wisps of his lustful breath waltz across your sensitive skin in like a balmy summer breeze as he kisses the tender hem of your nice cushy tum. Ah what a nice little foxy, you mumble at the skittish caress of his smooth pads brushing your clit as slips his glossy fingers between your molten petals. Gasping at the all too real caress of his fur gracing your flower with each worshipful motion of his wrists, the image of his sandy furry face and goofy grim peeking over the edge of your ripening tum grows all the clearer in your mental world. 'Thank you Mistress, slave lives to serve [italic type]Mistress Snuggle[roman type], and.' The illusory fox pauses, gentle brown eyes alight with base glee at your earnest praise as he nuzzles his snort boxy chin along the satin curves of your [italic type]kit-laden[roman type] tum, 'her pets.'";
				say "     Positively beaming at his words, you clasp your free hand to his prominent ears, fondly dandling their broad curves, murmuring vague affirmations to the sweet fennec. Chipping happily in reply, your fantastical fox loving pumps of his slender fingers all the quicker, as molten rivulets of fox dew drips down the length of his arm, and peters along the ground in a lewd tattoo. Gushing at the raw little pinpricks of delights flaring along your hungry folds as his ghostly glassly smooth pawpads and fuzzy sandy fur waltz about your needy depths. You soon find yourself thoughtlessly bucking your hips in tune with his dreamy pistons, eliciting tender quakes through your fecund middle and [breast size desc of Player] chest strain against the comforting elastic confines of your suit. Its satin lining seems to writhe about you as tiny annelid-shapes creep along your sensitive curves. Though some section of your waning human minds reels at their touch, such insipid protests are drowned beneath the vibrant torrent of desire and maternal hormones coursing through you as the tiny kicks of your [italic type]cubs[roman type] echoes through you.";
				WaitLineBreak;
				say "     The subtle internal seams of your precious costume split open along some unseen lines as a deluge of gossamer tendrils slink out from the dense padding, spill across your vulnerable form. You can only gasp in a titillating brew of surprise and elation as their silky forms unfurl along your across your [bodyname of Player] figure, massaging the lingering knots and tension from your [bodydesc of Player] body. Ah stars above, more, you coo, ";
				if SkinName of Player is "Snuggle Fox":
					say "while their affectionate forms gently stroke your foxy fur like adoring pets as they cascade across your extremities in reverent tide. ";
				else:
					say "while an endearing tide of oh-so-familiar [italic type]snuggly[roman type] foxy fur blossoms once more over your tender curves as the doting tendrils cascade down your extremities in an eager flood. ";
				say "Yipping with near vulpine anticipation, you practically melt into their embraces as they coil about your limbs like worshipful vines, wrapping you in a tepid cocoon. All the while, the smol dreamy fennec's glassy smooth pads pulse about your plump walls leaves you panting as you writhe in maternal bliss. 'Of course,' he beams, nuzzling his supple snout along the padded curve of your cushy middle, you can almost feel his ethereal breath dancing across your skin as he lovingly kisses the sensual impression of your preggy navel.";
				say "     Purring all the louder at his reverent attention, your velvety passages cinch devilishly tight about his fingers, milking his dreamy sandy digits and glossy claws in earnest need tattoo as dewy sonnet of lewd squelches echoes about you. All the while, your limbs go hot to the touch as the doting tendrils roil across your [bodyname of Player] feet and legs. Your flesh thrums with morphic in their fervent wake as motes of effervescent bliss flow through your paws-to-be as they're stretched and molded by their fond caress towards an oh-so-familier canidae form. Dense doughy pads blossom along your tender fuzzy arches, leaves you mewing at the unearthly tactile sensation as you reflexively flex your feet between the heartily pistons of your foxy phantom's wrist, marveling at the static thrum of change coursing through your toes. As they bend, then curl into adorable mirrors of your suit's sturdy pawbies while your nails curve out into fine, glossy vulpine points. Your thighs strain against the elastic confines of your leggings as a rich coating of supple motherly floof and tight ripcord muscle reshapes your legs into a more bestial digitadge stance, befitting a burgoning mommy fox like yourself. You muse, with a whimsical grin, sensing the sensation spread up along your lush body.";
				WaitLineBreak;
				say "     Your body and brood seem to drink in these the raw tide of change, growing in tune with heavy cushy protective adipose and predatory sinew fills out your lustrous curves. 'Ah you're is so soft,' the ethereal fox chirps, paws drifting the groaning swell of your plush middle as he fondly rakes his tiny talon across your fur, leaving a sensitive trail of goosebumps in their wake. Nodding, you cheerfully stroke the sandy tufts of his cheeks, exalting in the attention paid to your bountiful body as his fingers sink into your fur. The wave of blessed transformation crests your [breast size desc of Player] bust, blanketing your oh-so-productive breasts in a tranquil balm. Your milk stuffed tits slosh with fresh liters of nutritious cream as the tender orb ripens all the more, straining the elastic fabric cradling your well-loved body all the tighter about you. Before the warm motes of change peter outwards to your arms as the same welcoming heat coating your voluptuous form coils along their once [bodydesc of Player] profile. As the tender mommy pudge cut with a hidden layer of primal vulpine muscle filters along your extremities as the loving tendrils whorling along your [bodyname of Player] hands entwine themselves about your fingers like lacy gloves.";
				say "     Oddly soothing, the unearthly meter of their chaotic undulations echoes through you as your fuzzy fingers tense then flex beneath their inquisitive caress, growing lithe and slender while cute glossy talons surge forth along their tips. Meanwhile, pillowy heart shaped pads wink into being along your palms, leaving you mewling in base delight. As your awareness teeters between the vivid fantasy of your foxy toy serenading your supple sex, and the bestial caress of your shifting digits with lustrous piston of stroke of your muff. Too horny to care though, your tainted psych wallows in the discordant pleasure rippling through your dripping passage as the loving image of your ghostly vulpine lover's digits drifting across your motherly form. While your shifting gloved mitts pamper your plush passage with a fervent feverish vigor as the lurid impression of changing paws roiling along your folds sends carnal ripples through you with every pump. The regal crescendo of change seems to near its zenith as the inquisitive little feeler roiling about your fertile foxy figure's caress begins to grow languid, then worryingly still as they seem to react back into the seams with slow jerking motions.";
				WaitLineBreak;
				say "     Despite the lethergy, they reverently hug and stroke your sensitive body as an all to familiar tension wells in your breast at their quivering parting kiss lavishes your lush bump and eager peets. Mh, so good, you murmur, an all-to-familiar tension welling in your breast as you sluttily buck your hips with desperate need, trying to edge out a few more seconds of bliss from your phantom fox's touch. The dreamy vulpine looks on in lewd awe at the sensual wobble of your plush assets playing against his smol boyish body. 'You looks so happy,' he purrs, leaning over your sweltering middle, lavishing your luxurious pelt with indulgent kisses as he worships the enthralling suppleness of your changed body. Nodding in a foggy haze, you hum in agreement at the phantom caress of his breath playing across your tummy fur and nips as he works his snoot up along the graceful curve of your neck. You yip in animalistic delight at the brisk touch of his glossy fangs brushing your throat while he gropes a lush pawful of silky breast flesh.";
				say "     Naughty boi, you trill, milk steaming down his soft sandy fur in an opalescent river as adrenaline laced nanite-tainted hormones coursing through your softening figure. Grinning, your phantom lover offers no reply, as he lightly nibbles on your ears with a lewd little chirp. Swooning at his boldness and gossamer kiss of his breath playing along your fur, you wrap your legs about his waist, evoking a pleasant yet surprised peep from the tiny fennec as you pull him closer. Delighting in the spicy scent pouring off his compact form greeting your [facename of Player] nose, as you encouragingly nuzzle the silky edges of his large vulpine ears, and unsubtle jiggle of your new curves playing across your senses with every buck of your hips. Till with an adorable little yip, your cunt tightens about his fingers like a living vice, you cum with a deep seed sigh, and feverish fantasy breaks like tule fog in the morning light. Panting, spent, and the perfect kind of sticky between the knees, you at last open your eyes and gaze at the cute curve of your lush foxy tits and tum bobbing before you. Ripe with fertile purpose, your gorgeous furry bump and scrumptious milk tanks, easily dominate much of your view, not that you'd have it any other way. You preen, letting your eyes wander the heavy swell of your maternal body, before you work yourself into a sitting position with your tummy neatly nestled between your legs.";
				WaitLineBreak;
				say "    You reach behind yourself, gently unzipping your suit with a proud languidness, reveling in the heady sight of plump fuzzy mounds and cuddly bump slipping free of its wondrous furry cocoon. Bet mommy's tummy must feel so comfy now eh babies, you swoon under your breath at the picturesque little swirl of foxy hair decorating your ripening navel as you run your paws along the voluminous curves of your growing kit factory. Reveling in the strangely comforting sensation of your pads sinking into the thin layer of mommy pudge and voluminous fur swaddling your [italic type]kits[roman type] as you draw your claws across their slumbering form. Oh and just feel how big you've all gotten! You pant, at the feeling of their lush weight of your brood pressing down on your pads. Guess these changes agree with you? You hum, exalting in the lovely kick and squirms of your greeting your mitts as your now slightly larger [italic type]cubs[roman type] affectionate grasp at your claws. *Tee-Hee*, well you're glad you like them, you giggle at the intoxicating rush of maternal hormones surging through you.";
				say "     After all, you just know they'll make wonder vixens, you add, allowing your eyes to flicker along the matronly curves for vulpine mitts as you expectantly massage the lush contours off your fuzzy tum. To your far-traveled gaze, your fingers are a willowly blend canine and humanoid traits, masterfully suited for manipulation, yet still blessed with endearing pink heart-shaped pads, tipped with glossy claws almost made for subuding mate, or some bestial side of you whispers, prey. At the thought of digging your talons into the shoulder of some hapless feral as you ride them raw. While your arms are soft and motherly with just the barest hints of lush cushy adipose, concealing a hidden layer of hardened muscle breathing its cuddly exterious. You muse, eyes drifting to the plush curves of your alabaster tips and gleaming ebony nips as they lazy atop your well-padded tum, casting tiny but by no means unsightly furrows in your bump.";
				WaitLineBreak;
				say "     Even now, you hear the hearty slosh of your cream serenading your ears with the slightest provocation as you cup your paws about about their engorged majesty, impossibly full, your perky teats tiny droplets of ambrosia dribble from your ducts. Catching a few errant beads along the crook of your claw, you bring them to your unchanged lips and at the lusterous cream with a happy purr. Mh, you girls are going to love this, you preen through a soft canine rumble, at the warm rich fatty sapor of your cream basting your palate while you gently lapping at the sweet little morsel gracing your talons, before turning your attention to your altered legs. You find it hard not admire their striking bestial stance and plush shapley padding decorating your limbs as you playfully shuffle your legs along the fluffy curves of your sexy bump. By no means portly, your foxy legs straddle the line between glorious thicc and divinely toned, yet still imparting just the right amount of sensual jiggle to your every motion.";
				say "     While still maintaining a subtle layer of sculpted muscle that could crack a Wildcat's skull with a single squeeze. You think to yourself in base contentment at the intoxicating caress of your lovely bump playing across your limbs at thought of pinning some ";
				if "Vore Predator" is listed in Feats of Player:
					say "delicious prey thing beneath your nice fluffy rumbly tumby as your legs squeeze their sides. Even your voracious kits seem to enjoy the notion, while they wriggle and squirm in mutual predatory delight. Oh don't worry babies, mommy will catch a nice tasty feral for you soon, you coo reassuringly, giving your tum a well-deserved rub. After all, wonderful vixens like them need all the food they can get so they can grow into big, strong, sexy preds like their mommy. You pant, tongue briefly lolling from the side of your mouth at the thought of churning away some luckless feral, before turning your gaze towards your pawbs.";
				else:
					say "nice fuck meat beneath you as you claim yet another warm load for your insatiable body. Bet you little vixens would love that wouldn't you? You hum, imagining some buffy Alpha Husky, or ripped Wrestling Wolf squirming under the weight of your plush belly, while their bestial fur rifling yours as you milk those big juicy puppy peckers for all they're worth. All the while, your slutty cubs quicken in shared excitement as molten beads of girly drip from your [cunt size desc of Player] folds. Thought so, you widdle monsters are going to make great breeders, just like your mommy, you smirk, turning your gaze towards your pawbs.";
				WaitLineBreak;
				say "     Petie and sleek, your jet black digi petes positively brim with vixen's vigor as you give your adorable toes a well-pleased flex, exalting in the unbound rush of energy coursing through you, alongside the ambient softness of your cute pink jelly beanie pads. Your glossy ebony nail simmers with an eerily beautiful glow all their own as you tilt them into the available light. Already, a part of you is looking forward to walking your new paws, perhaps, a deviant side of you tempts, having some hunky canine give them a loving rub, or giving a subby herm a tender paw job as shi writhes beneath you like a good little bitch. Of course, you ruminate, sparing a glance at your unaltered ass and the faux tail sitting nearby, you still have more changes ahead of you before your foxy form is completed. Hopefully, it won't be too long, your kits deserve a chance to grow up as slutty vixen just like their cuddly mother, you opine, cheerfully massages your paws about the fuzzy swell of your baby bump. For now though, you simply have to wait for your costume to work its magic on you again, then you can seek out [italic type]your[roman type] head and at last become the sexy mommy fox you were meant to be. You preen, as you collect your things and zip yourself once more into the welcoming furrows of your prize, before heading off on your business once more.";
				LineBreak;
				say "    [italic type]Author's Note: you can undo, remove your suit, give birth and repeat this event to gain a more hale, athletic body[roman type]. ";
				now HP of Mistress Snuggle is 6;
				now XP of Mistress Snuggle is 0;
				now Perception of Mistress Snuggle is 1;
				setmonster "Snuggle Fox";
				choose row MonsterID from Table of Random Critters;
				now SkinName of Player is Name entry;
				now Skin of Player is skin entry;
				now BodyName of Player is Name entry;
				now Body of Player is body entry;
				decrease gestation of child by a random number from 1 to 3;
				if gestation of child < 1, now gestation of Child is 1;
				StatChange "Charisma" by 1;
				StatChange "Strength" by 1;
				now Scalevalue of Player is 3;
		else:
			say "     Trekking though the city in rare moment of peaceful solitude, you find yourself idly running your gloved mitts along the bestial curves of your prized find's digi legs. Just as smooth and pristine as the day you found it, the thing's fur comforting presence is something you've come to rely on. Though a curious side of you still can't help but wonder how long it will be till the next wave of change crashes over you. You muse, watching your gloves faux claws carve cute little furrows in your pelt-to-be as you pace about the area like a child waiting on their holiday presents. It shouldn't be long now, after all your initial changes only took a day or so to manifest, surely your next transformation is just around the corner? You hum, drumming your [bodyname of Player] toes along the satin padding of your boots in base contentment at the pleasant doughy feeling of the fake paw's supple pads supporting you as the endearing fabric seems to grip you all the tighter. More than used to such oddities, your lips curl into a blissful dreamy grin as you whisper, its happening, under your breath in raw delight.";
			say "     Your faux-pelt writhes with the uncountable impression of the lovely feelers wriggling along the cushy core of your suit. you run your gloved mitts over their strange fluidic forms, relishing the endearing sensation of their adorable lengths cascading over you. Rather squishy to the touch, these unseen tendrils seem to lean into your caress, as their [']heads['] wriggle affectionately about your fingers as they slowly peak out from the subtle seams of your chosen attire, coiling about your [breast size desc of Player] chest and midriff like doting serpents. Ha that tickles, you hum, watching them slowly spreading across outward, coating your eager form in their loving, tentacular embrace. Kneading and massaging your receptive being in a soothing tattoo all their own as they pour across your core. Mmh, feels so good, you purr, easing yourself to the ground to better enjoy their earnest attention. Now come on little guys, hurry up and change me! you pant, gently tracing a gloved mitt along their squiggly tepid bodies while they slowly work their way down around your arms and legs.";
			WaitLineBreak;
			if SkinName of Player is "Snuggle Fox":
				say "     As they pet your foxy pelt in a perplexing mix of reverent delight and curiosity, almost like they were, you pause, searching for a feeling to put to their touch, surprised to see you've managed to maintain their gift. Aw how could you sweeties really think you'd part with this lovely fur? Why, it'd be criminal to let some silly feral seperate you from this, and besides, it feels so good how could you ever go back to anything else? You tease, playfully drumming your fingers along the backs while they squirm about your fingers with tender alacrity, sending heady pulses of static delight flickering through at your show of application for their work. Well you're welcome you widdle dears, you beam gently nuzzling your cheeks against them, watching their glossy forms creep down towards your feet.";
			else:
				say "     Invigorating pinpricks of morphic desire flares across your hide like the warm rays of the noonday sun pouring over you as your fox pelt spreads outward once more. Though you can't help but notice linger notes of, you hesitate, struggling to put a word to their motions, aggravation? You muse at the growing roughness of their touch as your vulpine pelt seeps across you like oil flowing over water. Feeling oddly bashful at potentially slighting your suit's unseen passengers, you quickly mutter a simple apology to them, assuring the hard working feelers you never meant part with your fur so casually. As the nanites are, you note, rather virulent, and maintaining your form is... challenging these days. Quizzically, they seem to accept your words at face value, as the budding harshness of their touch gives way to same inquisitive glee you felt not so long ago as they creep down towards your feet.";
			say "     Your core begins to go devilishly hot to the touch, as sweet smelling steam pours from you suit as your body starts to change beneath its satin cocoon. Dimly as you observe the fleeting white wisps coiling about you, you'd almost swear you can feel the fat boiling off your body while the changes take hold. In its place, vigor like you've scarcely dreamed surges across your slimming middle as tight, shapely bestial muscle rushes into to its like tempered steel being poured into a mold. As your tum and waist shrink, then compress into a lithe feminine hourglass, graced with just the barest hints of sinew peeking through your dense fuzzy fur. You ruminate, cheerfully running your mitts along the hale contours of once [bodydesc of Player] form while the lean, dense predatory sinew filters down your leg in regal tide. As your bones creak and flesh constricts, before flowing into a proper digitigrade bend befitting a ";
			if "Vore Predator" is listed in Feats of Player:
				say "proud foxy huntress like yourself. ";
			else:
				say "spritely vixen in the making like yourself. ";
			WaitLineBreak;
			say "     Some giddy effervescent side of you quips, as your suit's cuddly padding and loving tendrils grip your shifting thighs, almost guiding their changes with their touch while they strain against the silky fabric. Ah don't stop, you yip in vulpine ecstasy at the kiss of the unseen of the feeler traipsing about your paws-to-be while the blissful heat pooling about your thighs flows further south. Coddling your tender toes in a blessedly thermocline of desire as the unearthly warmth of your transformation blends with the tepid strokes of these felicitous feelers in a lurid waltz cascading over your extremities while they grow slender and refined. Soft, supple pads flare into being along the balls of your changing feet as they steadily fill the cushy contours of your elastic boots, meanwhile your nails ripple outward hardening into curved glossy claws. Clicking them against one another as the endearing feelers massage your changing paws, you can't wait to put these though their paces, you swoon at the thought of tracing your claws into some hapless husky bitch glossy puppy pus as she squirms beneath you. Or perhaps, a deviant voice tempts, giving some strapping canine the paw job of his life, while enticing images of some hunky wolf panting at the silken kiss of your pads caressing his yummy doggy dick dances across the edges of your mind.";
			say "     Almost gushing at the notion, and blissed out expression on the dreamy lupine's face and ghostly throb of knot gracing your paws, you hardly notice the changes simmering across your arms as the change seeps along them. Though subtle at first, the same vixen's vigor that filled your legs gradually builds along them as any fat or weakness that once dared mar your nascent vulpine body evaporates under the tactile caress of your suit's inquisitive tendrils. Fresh bursts of sweet smelling steam billows through the seams of your costume as proud sculpted muscle billows down your arms, your hands begin to perspire and convolve with fresh untapped potential. Clenching them, you can feel the first wisps of your pads roiling along your palms as the your parts ever-so-slightly, revealing a fetching layer of plush silky furry padding creeping up your fingers. At their apex, your digits narrow and tiny talons burst forth, no larger than any you've seen on any of the local canines, though still glassy smooth to the touch, their addition will no doubt improve your grip. You opine, idly toying with the notion of sink your new found claws into some ";
			if "Vore Predator" is listed in Feats of Player:
				say "yummy prey things neck, ";
			else:
				say "adorable little fuck meat sides, ";
			say "while the tendrils engulfing your body grow placid, then retract with an affectionate slowness as their seemingly spent forms retract back from whence they came.";
			WaitLineBreak;
			say "     Another time, you might have considered stopping them, or perhaps resorting to more... kinetic means of asserting where they came from, such thoughts are the furthest from your mind as you giddily strip down, then bask at the sight of your shapely vixen body. Divinely curvy, yet supremely hale, your hardened core would be the envy of any model as your trim hourglass build is the very picture of feminine grace with just the barest hints of muscle coddling your midriff. Neither off putting or mannish, the added sinew is almost as inviting to the eye as it is to the touch. You think to yourself, admiring Reddish-orange fur gleaming along your flanks, while a gentle dusting of nacre white bejewels your [breast size desc of Player] chest and flat toned tum.";
			say "     Tilting your gaze south, it's hard not purr at the regal spectacle of your sculpted digi-legs and cute willowy thighs, neatly suited for survival and more... carnal endeavors, your chiseled calves can just as easily sprint a mile as crush an alpha wolf's skull between their stately length. Your jet black paws meanwhile are perfect for worship and work, you muse, exalting in the simple pleasure of rocking on your cushy pads as you lightly rake your brilliant onyx talon along the ground while urge to sprint off into distance in search of continent feral to test yourself against nips at the back of your mind. Tempting as it may be, you push back against the urge, if only for them to bring your attention to arms, much in the order of your legs, they seem built for conquest and pleasure in equal measure. As the lithe hills and tender valleys of bestial muscle adorn your ripple with potential as you flex your arm in base admiration of your foxy physique.";
			WaitLineBreak;
			say "    Your hands meanwhile are an efficient amalgam of vulpine and hominid traits, with cute protective pads, silky black fur, and strong subtle claws that maintain the same dexterity your silly little human mitts once boasted. Yet, as you drink in the wondrous sheen of your fur and talon, you can't help but look forward to what future changes await you. You muse, sparing a quick glance back at your [TailName of Player] ass, and your suit's tail sitting on the ground not too far from you. Soon enough though, the suit will finish the job, then you'll seek out [italic type]your[roman type] head and become the vixen you were always meant to be, you chuckle as you dress yourself once more then return to your day.";
			LineBreak;
			say "     [italic type]Author's Note: you can undo, remove your suit, get knocked up, and repeat this event to gain a more voluptuous maternal form[roman type]. ";
			now HP of Mistress Snuggle is 6;
			now XP of Mistress Snuggle is 0;
			now Dexterity of Mistress Snuggle is 1;
			setmonster "Snuggle Fox";
			choose row MonsterID from Table of Random Critters;
			now SkinName of Player is Name entry;
			now Skin of Player is skin entry;
			now BodyName of Player is Name entry;
			now Body of Player is body entry;
			StatChange "Dexterity" by 1;
			StatChange "Strength" by 1;
			now Scalevalue of Player is 3;
	else if HP of Mistress Snuggle is 6:
		if Player is impreg_now and bodyname of Player is "Snuggle Fox":
			say "      Blissfully strolling through a quiet section of this falling city, you find your ";
			if Perception of Mistress Snuggle is 1 and "Vore Predator" is listed in feats of Player:
				say "pawbs drifting to the cute fluffy curves of your plush kit factory as you thoughtlessly rest your arms along the welcoming swell of your cuddly tumby while you carry on another one-sided conversation with your precious cubs about who they'd like for dinner tonight. Spoiled for choice as you are, it can be quite hard to make up your mind, especially when there are so many yummy ferals running around. You muse, licking your lips as thoughts of stalking some strapping Alpha Wolf in the Urban Forest simmering through your mental landscape, as you picture yourself pinning one those big hunky brutes under the weight of your fox tum while you ride his nice fat knot. Lost to his own personal elysium, the look of simpleminded joy written on your prey face is as priceless as he laps his soft puppy tongue along at your cute little treasure trail, worshiping your glorious brood blessed body in blissful ignorance. You can almost feel the last fleeting twitch of his sculpted meat gracing your nice tight cunt as he cums, basking your hunger folds in a peerless sheen of puppy batter.";
				say "     Followed by the sumptuous look of terror on his muzzle as you lean in, vulpine maw agape as you swallow him whole, reveling in their rich phantom sapor and the raw bestial majesty of their ripped muscles core playing across your palette as you draw them in with praticed ease. All the while, your body ripples with his parting thrashes as you tummy churn him into nice nutritious goop for your cub, or warm, fatty cream for your tits. You ruminate, kits wriggling in shared delight as you massage their quickening forms. Mh, such eager preds, don't worry mommy will get us something soon you hum, giving them a loving pat, which seems to calm them, for the moment at least. But first, you add through a slight inpatient growl as you stare back at your fake tail bobbing you, she needs to get changed first. It shouldn't be long though, your suit only seems to need a day or so to 'recharge', you think to yourself, giving your [TailName of Player] flanks a cheerful shake while you watch the fetching tail dragger bob behind you.";
			else if Dexterity of Mistress Snuggle is 1 and "Vore Predator" is listed in feats of Player:
				say "paws roaming the tight curves of your toned kit-laden tum as you meander through another one-way chat with your brood as you discuss what manner of delicious feral you have for dinner. Perhaps one of those adorable blue gryphons might make a tasty multi-course meal, you tease, smacking your lips at though enjoying a creamy appetizer with your little ones. As images of stacked avian hybrids cuddled in your regal embrace dances through your head. You can almost taste the strange tang of their milk lavishing your taste buds, and feel the warmth of their fur and feathers waltzing along chiseled core as you drink. While their phantom tongue lols from the side of their mouth as you shamelessly grind the silky swell of your ravenous middle along their yummy knot dick as your kits wriggle excitedly within. Soon enough, their vapid expression turn to one of primordial horror as you loom forward, mouth stretched impossibly wide as you engulf their head, then rear back, swallowing them whole in a single motion.";
				say "     Distantly, you can already feel your budding huntresses['] squirm with mutual satisfaction at their unique hybrid sapor of your prey filters across your tongue and exotic interplay of fur and feather tricking your throat while your tummy swells with the welcome weight of your meal. All the while, your tummy fur grows taut as your belly spills over your lap in lovely dome of predatory excess, mentally gushing at the thought, you can't help but taunt your prey thing as your body's potent acid breaking it down in delectable goop for your brood and fuel for your muscles. As its every thrash and panicked screech only serves to excite you and all the further while you paw at your hungry tum. Don't little ones, mommy will find you a yummy meal once she's done changing, you purr, tracing a nail along their exuberant forms. Settling beneath your loving caress, your middle soon goes still and you turn your attention to the fake tail bobbing you. It shouldn't be long though, for your suit only seems to need a day or so to 'recharge', you think to yourself, giving your [TailName of Player] flanks a cheerful shake, watching the fetching floor dragger tail bob behind you.";
			else if bodyname of Player is "Snuggle Fox" and Dexterity of Mistress Snuggle is 1 and "Vore Predator" is not listed in feats of Player:
				say "mitts explore the tender curves of your suit swaddled tumby in eager anticipation of the changes to come as you gab away with your sleepy brood, as the lot of you debate what manner of feral you should treat yourselves to today. Perhaps you might try a nice cuddly goo girl, you ask, resting the weight of your cute little vixens in the palm of your hands. After all, it could be nice to sink into some goop plaything and let her fill your needy holes to the brim with warm, soft slime, you think to yourself. Picturing yourself floating atop some ooze's cushy body while she worships your hale figure. You can almost feel the heady kiss of her morphic body filling your folds, and the blissful squirming of your slutty kits kicking in shared delight as the phantom ooze gleefully massages your lush cunt with the unearthly touch of innumerable pseudopods cascading along your walls in unbound tide.";
				say "     Swooning at the intoxicating fantasy and lovely little wriggle of your naughty monsters playing along your mitts, you nearly consider heading off to the sewers to find yourself such a wondrous playmate, yet think better off, for the moment. After all, you'd like to maintain this form for a while longer and sooner or later, your suit should 'wake up' again, you muse, reasoning it's already been a day or so since its last bout of activity. You wouldn't want to ruin the fun by blighting yours and kits blossoming foxyness with some no-name feral's yucky nanites. You quip, loving drumming your finger padded tum. Tummy gurgling in agreement, your cubs paw at your fingers as they slowly go still. Thought so, but don't worry once mommy is done getting ready we can have the fun we want, you coo booping one of their adorable paws, before turning your attention to the fake tail bobbing you. Just a little longer and this thing should 'recharge', you think to yourself, giving your [TailName of Player] flanks a cheerful shake while you watch the fetching tail dragger bob behind you.";
			if bodyname of Player is "Snuggle Fox" and Perception of Mistress Snuggle is 1 and "Vore Predator" is not listed in feats of Player:
				say "cushy padded mitts exploring the ripe dome of cuddly tummy in quiet admiration of your changes, before resting your arms along its lovely pillowy swell as exuberantly debate with your [italic type]snuggly[roman type] kits what manner of feral you should play with today. Maybe a big fluffy Margay could make for a nice partner, you proffer tracing a gloved finger along your hidden treasure trail. You can only imagine how blissful it would feel to let your arms sink between the soft rows of kitties titties, while the warm kiss of her plush tumby presses against yours. Or share the creamy taste of her milk with your cubs as the two of you relax in each other's arms, you muse, kits squirming at the thought. Mh, glad you naughty widdle vixens approve, you preen, delighting at the rich flood of motherly hormones coursing though you as their sweet pawbs flicker across your palms.";
				say "     Perhaps we should head down to the Fair then? You tease with a playful trill, letting your fingers glide down the cushy curves for your precious suit. Why just think of all the tasty snacks they might have, you pant, thin streaks of drool beading from your lips at the thought of glutting yourself on a few bags of overpriced candy or experimenting with a deep fat frier. After all, you and your babies deserve a treat every now and then. And just think of all the, you pause at the ambient caress of the faux fur serenading your scenes as your mitts explore your [bodyname of Player] legs. Cute cuddly ferals we can play with, you swoon at the thought of riding some nice bouncy rubber tigress's muzzle, or sinking into the welcoming embrace of one of the adorable teddy bears. Of course that may have to wait just a while longer, as you wouldn't want to taint your growing foxiness with some lesser strain. At least not until your suit has a chance to finish changing you and your sweet kits have a chance bloom into proper vixens, you ruminate with cheerful anticipation at the thought of finally getting to hold your fuzzy littler in your arms.";
				WaitLineBreak;
				say "     Your mind is flooded with tender images of your kits nestled to your soft cuddly breast while they take in their first meal, while they look at you with warmth and affection suckle and grow into proper cuddle vixens just like their slutty foxy mommy. You gush, feeling your tummy rumble as faint impressions of their paws dance across its plush padded curves while your eyes drifts back towards the voluminous tail bobbing behind. It shouldn't be long be until suit has fully 'recharged', after it only seems to take a day or so for whatever strange creatures nesting within it awaken from their  exotic toper, you think to yourself, giving your [TailName of Player] flanks a cheerful shake, watching the fetching floor dragger bob behind you.";
		else:
			say "     Thoughtlessly ambling along some desolate stretch of the city, you find your attention drifting towards the soft fluffy floor dragger bobbing behind you as you walk. Wondering all the while how long it will be before your suit wakes up again, from experience, you surmise the thing seems to need just a little over a day before the unusual annelids nesting within are roused from their torpor. Why though, you can't be certain, as they don't seem to require any manner of substances or stimulation to work their magic on your blossoming foxy body. Perhaps they just like making you wait, you opine, idly running a gloved mitt over their supple padding for your precious suit, though for all you know they simply feed on the emotions of yourself and others like some kind of squiggly vampire. Whatever the case hopefully, it shouldn't be much longer now, you muse, giving your [bodyname of Player] hips a mirthful shake, watching it bob behind you as the light seems dance across its silky length like shimmering diamonds upon its fetching reddish orange surface."; [merge here]
		say "      Observing its bounces with a simply goofy grin, you begin to feel a slight, yet-oh-so familiar tingle roiling across your hide like a silky feather was being traced along your spine by some cheeky lover. Oh [']bout time, you murmur contentedly at the first fleeting caress of your costume's coiling tendrils emerging from their homes along your spine. Quizzically, they seem less, you hesitate as a mix of fright and melancholy nip at the back of your mind, exuberant than before as their once frollicking caress seems sluggish and labored as they struggle to slip free of your suit's seam. Perhaps, some analytical side of you posits, whatever force was animating them is being drained each time they change you? If so, then these sweet creatures might be giving everything they have to help you transform, you ruminate, cupping your gloved mitts about their weary forms as you give voice to these sobering thoughts.";
		WaitLineBreak;
		say "     Though unable to reply with words, you can, on some primal level, sense a tacit acknowledgement and resignation in their touch as you coil about your fingers through the lining of your suit. Saddened, you want to ask if there is something you can do to help them, yet think better of it as you can feel motes of resolve bubbling through you as they hug your fingers. These loving beings seem committed to their task of changing you, and you doubt that nothing short of sealing them away will dissuade them from the course they've chosen. Instead, you offer them a grateful smile and a few kind words in appreciation of their work, before relaxing ever-so-slightly into their touch. Wriggling happily in reply, they tenderly hug your fingers once more before encircling your [TailName of Player] flanks in a supple ball of squiggly affection as the latent foxy nanites nestled within you start to stir, "; [Note: the tentacles will not die at the end of this event if the PC chooses to 'merge' with their suit.]
		if bodyname of player is "Snuggle Fox" and Dexterity of Mistress Snuggle is 1:
			say "your lean foxy body thrums in rapturous delight as your toned body seems to drink in the feeler ardent offering.";
			say "    Fresh, toned, sculpted muscle flickers across your athletic, as core middle hardens by the moment with raw primeval sinew, you can't resist running your gloved mitts along your torso, basking in the blossoming border of the potent six packs greeting your curious digits. Smicking, you languidly draw your nails along your burgeoning yummy gutter as the vulpine spread through you, scourging the lingering taint of any lesser strains from your glorious form as the bestial prefection spreads outwards by the second. Coating your regal being in thick, yet comely muscle that's just barely noticeable through the downy padding of your suit. Amazing, you little guys really know how to treat a girl, you yip, flexing your digi legs, exalting at the pleasant creak of the elastic fabric as it stains all the more against the plush cuddly confines of your costume. A faint nascent pressure builds along your tail bone as your fur and flesh bulge outwards.";
			now Dexterity of Mistress Snuggle is 2;
			WaitLineBreak;
		else if bodyname of Player is "Snuggle Fox" and Perception of Mistress Snuggle is 1:
			say "your cuddly mummy tumby rumbles in ravenous elation as your blushing body basks in the velvety wave of change passing through you.";
			say "      As your paws drift back to the lovely swell of your cute foxy belly as the silky layer of supple protective adipose across your ripe middle deepens by the second, another you might have found the extra weight off putting. Yet groping a plush pawful of soft foxy fluff spreading across your gorgeous body like a heavy comforter, some part of you can help but enjoy the growing richness greeting your pads while your gloved mitts slip between the warm, welcoming folds of your blushing kit factory. Mh bet the cubs will love this, you hum, pinching a few silky ";
			if "Touched by Madness" is listed in feats of Player:
				say "centimeters ";
			else:
				say "inches ";
			say "of luxurious furry tallow between your fingers as tender thoughts of your adorable little kits snoozing away in pure comfort within you. You muse, picturing your flush body nestled atop a pillowy throne like some primeval fertility goddess while countless canine attendants pamper your regal form, hand feeding you finest vittles, or the sweetest drinks.";
			WaitLineBreak;
			say "     All the while, your mitts glide down the thickening curves of your doughy thighs as the rapturous blanket of cuddly fluff laced with a hidden core of potent muscle creeps down your bestial legs. Raw, heavy, and more than just a little powerful, your limbs seem to bristle with untapped energy as they strain delectably against the lush lining of your suit. You find it hard to not flex your animalist calves in base contentment, delighting at the thought of wrapping your legs around some yummy treat's muzzle while they worship your plush folds. Or feeling the enticing quiver of your velvety pelt gently rub gently rubbing against itself while the very ground beneath you trembles with every step. Swooing at the image and enthralling feeling of toasty vulpine padding simmering down your legs, you soon find yourself yipping for more. As the soothing coating of spreads across outward across your in arms, though the changes are more subdued than those coiling about your legs, the strange bliss flowing through them is no less addictive as turgid muscle cloaked in the softest pudge billows across your extremities in fetching layer of motherly padding. Gods, you guys know how to treat a girl, you moan, a faint pressure builds along your tail bone as your fur and flesh bulge outwards.";
			now Perception of Mistress Snuggle is 2;
		else:
			say "your [bodydesc of Player] body seems to ripple and convulse beneath oddly rough touch of the struggling feelers playing across your [bodytype of Player] core.";
			say "      At some other juncture, you might have chastised the otherworldly annelids for brutish pinches, or harsh gropes playing across your [TailName of Player] flanks, yet as a charitable side of your notes, the poor tired things must be upset at your lack of appreciation for their work. Though such thoughts to do little placate the mild lancets of discomfort swirling across you, while biting sweet smelling steam pours through the folds of your prize as your body slowly shifts back into the ";
			if Perception of Mistress Snuggle >= 1:
				say "sensual image of matronly mommy fox. ";
			if Dexterity of Mistress Snuggle >= 2:
				say "regal form of a proud vixen. ";
			say "Still, the biting heat of the unearthly vapor sizzle the vulnerable flesh about your vitals and sudden constriction of your costume along your extremities evokes a plaintive vulpine hiss from your [facename of Player] lips while you give voice to your unease. Though slow to respond, the feelers relent, somewhat as the change seeps down through limbs while they're reshaped into their proper foxy forms. Murmuring some vague thanks, and nebulous apology for failing to maintain your shape, you slowly turn your attention to a faint pressure builds along your tail bone as your fur and flesh bulge outwards."; [Merge here]
			setmonster "Snuggle Fox";
			choose row MonsterID from Table of Random Critters;
			now SkinName of Player is Name entry;
			now Skin of Player is skin entry;
			now BodyName of Player is Name entry;
			now Body of Player is body entry;
		say "     Your fuzzy hide parts like the petal of some crimson blossom as bestial bone and wiry sinew presses against the tepid slippery forms of the waning tendrils. Distantly, you can feel sensation filtering outwards along its nascent lengths as your tail-to-be slip edges of your [bodydesc of player] leg while itchiness coils about it. Idly flexing its length, a rich dusting of the same velvety reddish-orange fur coating your foxy figure cascades down its willowy contours you can't help but remark at how... natural it feels. True, you might have experimented with similar transformations in the past, but this feels different, as if your tail were merely asleep, and now beneath the endearing caress of these wondrous tendrils is it finally awake. You muse, slipping your paws about the ";
		if Perception of Mistress Snuggle >= 1:
			say "plump swell of your widening hips ";
		if Dexterity of Mistress Snuggle >= 1:
			say "chiseled curves of your athletic ass ";
		say "as the labored wriggles of your suit born feelers begin to slacken while their slippery surfaces begin to cool. Alarm flare through your mind as, one-by-one, stillness claims them as they go limb, dangling about your thighs akin to desiccate worms while you shout and jostle their perplexingly slender forms, desperately trying to coax some sign of life from them.";
		WaitLineBreak;
		say "     Slowly, almost agonizingly so, they start to respond, tenderly wrapping their temperate from about your foxy finger tips, concern pours out of you as you nearly plead with these kindly beings for answers about what happened to them. Silent as ever, the things seem to sense your distress while they soothingly wriggle about your core, before drawing your hand to the base of your tail like eager children begging their parent's attention. Confused, but in mood to deny them, you let them lead your mitts to your tail bone as you stroke the unsubtle impression of your nascent limb peeking through the dense padding of their home in raw admiration of their work. Before repeating your query to them once in the vein, foolhardy hope that they might assuage the unease bubbling inside you, to no avail. As you can sense, the weakness in their touch, and minute but noticeable loss of mass following your latest change, that these entities will likely not survive your final transformation.";
		say "     Though saddened by the thought, faint bubbles of resolve and pride still ripple through their touch as they fawn over their work while they await your approval. Choked for words, you simply heap praise on them, though some facet of your mind bemoans the notion that these beings seem to be burning themselves at both ends to help you, you just can't bring yourself to deny them their chosen purpose. You grumble, while an oh-so-familier torpor creeps over these spent loyal creatures forms as they retract once more into whatever downy warrens are nestled deep within your suit's lining. Curiously tracing their path with your gloved mitts, it's hard to say where they're going, much less how they seem to be able to vanish inside the down swaddling you, yet they seem to be vaguely nesting along the curves of your suit's middle and base of your spine. Not that such knowledge will do you, or them any good, still as they fade into the cushy stuffing, you nevertheless give them an appreciative pat, before whipping out the shipping records you've collected over the course of journay.";
		WaitLineBreak;
		say "      Skimming though its pointlessly dense job script, you find the address tucked away at the end of long list of lay over and hands off, from what you can gleam, there is a small delivery locker owned by Fed-Up Express on Northwest 7th street tucked within some pop up store you've never heard of. Doubling checking the remaining document to make sure you've got the right address, or haven't missed anything, you soon locate the locker's number: Seven of Nine, along with its password: tertiary adjunct zero tucked into the margins. Shrugging at the odd choice, you nevertheless pocket the pages once more as you collect yourself for the last leg of this impromptu fetch quest. Hopefully, you muse, absentmindedly stroking the faux fur swaddling you, the head will still be there by the time you arrive. After all, you seriously doubt the ferals, not to mention any fellow survivors would have much of any interest in something as frivolous as a furry fox head. Still, there is only one way to find out, you muse, resolving to check 7th street the next time you're in the area.";
		setmonster "Snuggle Fox";
		choose row MonsterID from Table of Random Critters;
		now SkinName of Player is Name entry;
		now Skin of Player is skin entry;
		now BodyName of Player is Name entry;
		now Body of Player is body entry;
		now TailName of Player is Name entry;
		now Tail of Player is Tail entry;
		now HP of Mistress Snuggle is 7;
		if Dexterity of Mistress Snuggle is 2:
			StatChange "Dexterity" by 1;
			StatChange "Strength" by 1;
		else if Perception of Mistress Snuggle is 2:
			StatChange "Stamina" by 1;
			StatChange "Strength" by 1;
		now ScaleValue of Player is 3;


Table of Game Objects (continued)
name	desc	weight	object
"Cheater rod"	"Changes your Snuggle fox infection don't use this unless you know what you're doing."	0	Cheater rod

the scent of Cheater rod is "The rod smells lazy, what you were expecting special some details here?".

Cheater rod is a grab object. Cheater rod is not temporary.
Usedesc of Cheater rod is "[CRuse]";

to say CRuse:
	say "     Debugging what would you like to set your stats to?";
	let debug_setting_Choices be a list of text;
	add "One Pr." to debug_setting_Choices;
	add "Two Pr." to debug_setting_Choices;
	add "Three Pr." to debug_setting_Choices;
	add "Dex one." to debug_setting_Choices;
	add "Take a wild guess what this does." to debug_setting_Choices;
	let debug_setting_Choice be what the player chooses from debug_setting_Choices;
	if debug_setting_Choice is:
		-- "One Pr.":
			say "Done.";
			now Perception of Mistress Snuggle is 1;
			now Dexterity of Mistress snuggle is 0;
		-- "Two Pr.":
			say "Done.";
			now Perception of Mistress Snuggle is 2;
			now Dexterity of Mistress snuggle is 0;
		-- "Three Pr.":
			say "Done.";
			now Perception of Mistress Snuggle is 3;
			now Dexterity of Mistress snuggle is 0;
		-- "Dex one.":
			say "Done.";
			now Dexterity of Mistress is 1;
			now Perception of Mistress Snuggle is 0;
		-- "Take a wild guess what this does.":
			say "Done.";
			now Dexterity of Mistress Snuggle is 2;
			now Perception of Mistress Snuggle is 0;



Table of Game Objects (continued)
name	desc	weight	object
"Skipping stone"	"A simple rock that when applied directly to the forehead allows you to skip Snuggle's story."	3	Skipping stone

the scent of Skipping stone is "The stone smells like a useful amount of brain damage.".

Skipping stone is a grab object.
Usedesc of Skipping stone is "[stoneuse]";

to say stoneuse:
	say "    Slamming the rock into your skull, you pass out, then wake up moments later with only a modest amout of cognitive decline.";
	now HP of Mistress Snuggle is 8;





Mistress Snuggle ends here.
