Version 1 of Hermaphrodite Latex Vixen For FS by TentaBear begins here.

"Adds a Hermaphrodite Latex Vixen to Flexible Survivals Wandering Monsters table, With Impreg chance"

Section 1 - Monster Responses

hermlvmeet is a number that varies.

to say hermaphrodite latex vixen desc:
	if hermlvmeet is 0:  [first time meeting Herm LV]
		say "She stands at least six feet tall, her glistening rubbery skin a bright contrast to the muted colors of this twisted city.  She has the shading of a fox, white belly and groin, darkened paws up to the elbows and knees, but the color was far more vivid than anything in nature.  The glossy skin that covers her back is a near luminous cherry red, her paws and the tip of her tail a jet black that makes them seem to disappear in the shadows.  The white that covers her from the front of her muzzle to her puckered sphincter seems impossibly clean and then you notice it appears slick, almost as if she had been recently oiled.  But her lustrous skin is a mere footnote compared to the remarkable equipment hanging off the front of her.[line break]Four massive breasts hang from her chest, and jiggle at the slightest motion.  She has a bright pink pointed cock, at least eighteen inches long, the base is covered in a glossy black sheath, inside of which you can see an already grapefruit sized knot forming.  One of her jet black paws slithers down her stomach, past her growing shaft, pushes aside her black apple sized balls and reveals her glowing pink lips.  She takes three fingers, parting her moist lips with the outer two she begins to probe her drooling sex with the middle.[line break]'Mmmmm....' she moans as she pulls her slick finger from her dripping nethers and places it in her mouth.  She withdraws her finger, smiles and says 'So your the one my babies have been telling me about.'  She turns her head to meet your gaze, you find yourself entranced by her deep emerald green eyes.  'Well then, let[apostrophe]s see if you can satisfy.'";
		now hermlvmeet is 1;
	otherwise:
		say "All four of her massive impossibly bouncy breasts jiggle as she laughs 'Back for more are we?'[line break]She stands in front of you stroking her rock hard 18 inch pink knotted shaft.  The nipples on all four of her watermelon sized breasts already leaking that delicious smelling oily lubricant.[line break]'Well alright...' she says, and with a jet black paw she lifts her left breast to her waiting muzzle. The vixen's tongue slides out of her brilliantly white mouth and licks some of the cinnamon tasting lubricant from her bright pink nipple, a shudder runs through her.  '...let[apostrophe]s play!'";

to say hermaphrodite latex vixen defeat:
	say "Defeated, your would be attacker kneel[apostrophe]s at your feet, pointing her brilliant white and red ass towards you.  She raises her bushy red tail exposing her drooling sex.  'I guess I[apostrophe]m at your mercy' she chuckles.  You get the feeling she will be able to take pretty much anything you can dish out.";
	if libido of player < 30:
		say "Managing to resist your darker urges you turn around and walk away. Leaving the Latex Vixen on the ground stroking herself while she whimper[apostrophe]s plaintively.";
	otherwise:
		if cocks of player > 0:
			say "Wasting no time you position your [if cocks of player > 1]cocks[otherwise]cock[end if] at her puckered asshole, and with one quick thrust you bury yourself fully inside her.  As you suspected the Latex Vixen[apostrophe]s ass easily stretches to accommodate your [cock size desc of player] [cock of player] shaft[if cocks of player > 1]s[end if].  You start to thrust in and out, amazed that her ass seems to be a perfect fit for your [if cocks of player > 1][cocks of player] [end if]pole[if cocks of player > 1]s[end if].  You pick up speed, fucking the bright red fox as hard as you can, enjoying the feel of your balls slapping against her own apple sized cum factories.  The Latex Vixen starts to squirm and moan under your relentless assault.[line break]The Vixen reaches back and starts to stroke her pink knotted shaft, you slap her hand away roughly.  Don[apostrophe]t want her having too much fun.  She let[apostrophe]s out a little whine, but then starts bucking against you, meeting each of your thrusts with one of her own.  You quickly succumb to her new attack, moaning loudly as you release jets of hot sperm deep into your cum dump[apostrophe]s bowels.[line break]With a loud *POP* you unceremoniously yank your [cock of player] rod[if cocks of player > 1]s[end if] out of her gleaming ass.  You get dressed and leave, the Latex Vixen still on the ground masturbating furiously trying to sate her endless lust.";
		otherwise:
			say "You reach out and roughly grab her long knotted shaft between her gleaming legs.  She yelps loudly as you twist her cock, forcing her to roll onto her back.  Stepping over her you straddle the bright pink shaft, the pointed tip brushing your clit, sending shivers up your spine.  Bending your knees you slowly lower yourself onto her twitching member.[line break]  You slide up and down, faster and faster moaning loudly and roughly rubbing your sensitive clit.  The Latex Vixen[apostrophe]s knot start slamming against your pussy, you realize she is thrusting, trying to embed her knot in you.  Lifting one leg you step on her thigh, preventing the Vixen from thrusting.  You then plant your other foot on her, entirely riding the bright red fuck toy.[line break]Increasing speed you feel your orgasm building, however while distracted by the pleasure building in your pussy, your feet lose their grip on the slick rubbery skin of your lover.  Both legs slip and you fall pussy first onto her grapefruit sized knot. The combined weight of your body, and a quickly timed thrust from the Vixen is enough to firmly lodge her knot inside of you.  'Oh Fuck Yes!' you scream, your body hit with an earth shaking orgasm.[line break]  The Latex Vixen let[apostrophe]s out a loud moan, and you realize she is filling you with her own cum.[impregchance]  Attempts to stand up and pull her knot out prove futile, every time you get close her knot seems to inflate a little more. Deciding your going to be here for a while you start to grind your hips and rub yourself into three more orgasms before her knot recedes enough to plop out of your abused pussy.  Bucketloads of hot cum spill out of your hole onto the Vixen as you get up to leave.[line break]'See you again soon honey' she says with a wink as you leave her lying in a pool of her own cum.";  
				
hermlvconsent is a number that varies.

to say hermaphrodite latex vixen victory:
	if cocks of player > 0:  [she prefers to get fucked as she likes to make more latex foxes]
		say "[if hp of player > 0]'So he want's to play with Mama?  Good boy...' the red vixen purr[apostrophe]s[otherwise]You slump to the ground, too tired and sore to keep fighting.  The fox bends over bringing her mouth right up to your ear and whisper[apostrophe]s 'Perhaps next time we can do this without all that unnecessary violence'[end if].[line break]'Now' she says, slowly removing your clothes 'let[apostrophe]s see what we have to play with today.'  Pulling your pants off reveals your [if cocks of player > 1]multiple [cock size desc of player] [cock of player] cocks[otherwise][cock size desc of player] [cock of player] cock[end if].[line break]";
		if cocks of player > 2:
			say "'Ohh those look tasty!' She says while slowly licking her lips.  She lowers her face to the first of your [cock of player] shafts, her tongue dances around the tip. 'Oooooh' she moans 'that[apostrophe]s nice, but Mama want's more.' She gently lay[apostrophe]s you on your back, your throbbing cocks sticking straight up.  Standing proud, the six foot Vixen lifts one digitigrade leg and steps over you, straddling your waist.  She leans over, the lower pair of her massive jiggling tits pressing against your  [breast size desc of player] chest and with both jet black hands she grabs all but one of your cocks and roughly shoves them up her warm squeaky pussy.  'Oh God that feels good' she squeals as her latex skin easily stretches to accommodate you multiple manhood[apostrophe]s.  She reaches back and grabs your remaining [cock size desc of player] rod and slowly starts to feed it into her puckered ass. 'Mmpf, can[apostrophe]t let a good hole go to waste now can we?' she grunts as your remaining cock slowly works its way up her tight butthole. With you fully inside her, your latex lover starts to pump up and down on your shafts.  Her pitch black balls slap against your stomach with every thrust, the apple sized orbs shuddering on impact.[line break]  She leans in pressing one of her dripping pink nipples into your mouth. 'Have some of Big Mama[apostrophe]s milk, I know you[apostrophe]ll love it' she says seductively.  The first drop touches your tongue and your mouth is immediately filled with a sensational warmth and a sweet cinnamon flavor.  You suck greedily at her teat, wanting more of the candy like elixir.  As you suck she quickens her pace, bringing you close to the edge.  Sensing your close she reach[apostrophe]s back, and being careful not to scratch you with her needle like claws, starts to squeeze your balls.  Your mouth drops open and you let out a huge moan as all [cocks of player] of your [cock of player] shafts start pumping the Latex Vixen full of your [bodyname of player] seed.[line break]  She stands up, your [cock of player] cocks dropping out of her.  You are surprised that none of you cum seems to drip out. 'See you again soon honey' she says with a wink, and then blows you a kiss and walks away.";
		if cocks of player is 2:
			say "'Ohh those look tasty!' She says while slowly licking her lips.  She lowers her face to the first of your [cock of player] shafts, her tongue dances around the tip. 'Oooooh' she moans 'that[apostrophe]s nice, but Mama want's more.' She gently lay[apostrophe]s you on your back, your throbbing cocks sticking straight up.  Standing proud, the six foot Vixen lifts one digitigrade leg and steps over you, straddling your waist.  She leans over, the lower pair of her massive jiggling tits pressing against your  [breast size desc of player] chest and with a jet black hand she grabs one of your cocks and roughly shoves it up her warm squeaky pussy.  'Oh God that feels good' she squeals as her latex skin easily stretches to accommodate your manhood.  She reaches back and grabs your remaining [cock size desc of player] rod and slowly starts to feed it into her puckered ass. 'Mmpf, can[apostrophe]t let a good hole go to waste now can we?' she grunts as your remaining cock slowly works its way up her tight butthole. With you fully inside her, your latex lover starts to pump up and down on your shafts.  Her pitch black balls slap against your stomach with every thrust, the apple sized orbs shuddering on impact.[line break]  She leans in pressing one of her dripping pink nipples into your mouth. 'Have some of Big Mama[apostrophe]s milk, I know you[apostrophe]ll love it' she says seductively.  The first drop touches your tongue and your mouth is immediately filled with a sensational warmth and a sweet cinnamon flavor.  You suck greedily at her teat, wanting more of the candy like elixir.  As you suck she quickens her pace, bringing you close to the edge.  Sensing your close she reach[apostrophe]s back, and being careful not to scratch you with her needle like claws, starts to squeeze your balls.  Your mouth drops open and you let out a huge moan as both of your [cock of player] shafts start pumping the Latex Vixen full of your [bodyname of player] seed.[line break]  She stands up, your [cock of player] cocks dropping out of her.  You are surprised that none of you cum seems to drip out. 'See you again soon honey' she says with a wink, and then blows you a kiss and walks away.";
		otherwise:
			say "'Ohh that looks tasty!' She says while slowly licking her lips.  She lowers her face to your [cock of player] shaft, her tongue dances around the tip. 'Oooooh' she moans 'that[apostrophe]s nice, but Mama want's more.' She gently lay[apostrophe]s you on your back, your throbbing cock sticking straight up.  Standing proud, the six foot Vixen lifts one digitigrade leg and steps over you, straddling your waist.  She leans over, the lower pair of her massive jiggling tits pressing against your  [breast size desc of player] chest and with a jet black hand she grabs your cock and roughly shoves it up her warm squeaky pussy.  'Oh God that feels good' she squeals as her latex skin easily stretches to accommodate your manhood.  With you fully inside her, your latex lover starts to pump up and down on your shaft.  Her pitch black balls slap against your stomach with every thrust, the apple sized orbs shuddering on impact.[line break]  She leans in pressing one of her dripping pink nipples into your mouth. 'Have some of Big Mama[apostrophe]s milk, I know you[apostrophe]ll love it' she says seductively.  The first drop touches your tongue and your mouth is immediately filled with a sensational warmth and a sweet cinnamon flavor.  You suck greedily at her teat, wanting more of the candy like elixir.  As you suck she quickens her pace, bringing you close to the edge.  Sensing your close she reach[apostrophe]s back, and being careful not to scratch you with her needle like claws, starts to squeeze your balls.  Your mouth drops open and you let out a huge moan as your [cock of player] shaft starts pumping the Latex Vixen full of your [bodyname of player] seed.[line break]  She stands up, your [cock of player] cock dropping out of her.  You are surprised that none of you cum seems to drip out. 'See you again soon honey' she says with a wink, and then blows you a kiss and walks away.";
	otherwise:
		say "[if hp of player > 0]'So she want's to play with Mama?  Good girl...' the red vixen purr[apostrophe]s[otherwise]You slump to the ground, too tired and sore to keep fighting.  The fox bends over bringing her mouth right up to your ear and whisper[apostrophe]s 'Perhaps next time we can do this without all that unnecessary violence'[end if].[line break]'Now' she says, softly rolling you on to your stomach 'as I am not a sore winner I will give you a choice.'  She hefts one of her apple sized balls and squeezes it slightly 'These boys are damn good at making babies, so if you don't want to get knocked up say so now.'[line break]Her eyes seem to stare into your soul, a pleasant cinnamon odor hits your nostrils as she gets closer. 'Willing to take the risk?";
		if the player consents:
			say "'Alright honey, whatever you want' she purr[apostrophe]s.  Positioning the tip of her eighteen inch shaft at mouth of your moistening pussy she slowly enters you, until her knot is pressing against your opening.  The latex shaft seems to adjust to fill you perfectly, stretching you to a point just before discomfort.  You moan with pleasure as your assailant starts to thrust, slowly at first but speeding up as she goes.[line break]As the Latex Vixens fucking reaches a steady rhythm, you feel her watermelon sized breasts squishing against your back with every thrust.  Every time she rams home, the pressure on her four sloshing jugs causes some of the cinnamon smelling oil to squirt out of her nipples, in only moments your entire back is slick with lube.  Her thrusting starts to become more forceful, you can tell she is trying to get that grapefruit sized knot in you.  Your mind clouded with lust you start meeting her thrusts with thrusts of your own, trying desperately to tie with your kind and loving mistress.[line break]You feel a sudden pop and feel her balls slap your thighs, you try to pull forwards but you can't move.  You are now firmly tied with your latex lover.  She lets out a loud grunt as the pressure on her knot causes her to climax, sending hot sperm flooding into your uterus[impregchance].  As she peaks her gigantic teats start spraying their bounty, causing hot oily lubricant to rain down on you.  Some of the lube drips down into your mouth,  the flavor is quite intense, tasting like a very spicy cinnamon candy.  You can't quite remember if you liked cinnamon before the world ended, but licking your lips you realize that you sure like it now![line break]She brings one leg over your body and spins around until you are ass to ass, every time her knot pulls at your stretched hole a bolt of pleasure runs up your spine.  You lay there for over half an hour, as she slowly stretches your uterus with her seed.  You feel every single squirt of hot fox cum, keeping you achingly close to orgasm the entire time.  Eventually her swollen knot starts to reduce in size and with a loud POP it falls out of your pussy.  Torrents of hot fox cum quickly follow, puddling on the ground below you. She squeezes one of your ass cheeks and lightly kisses the other one.  She rises to her feet and starts to walk away.[line break]Looking back at you she smiles and says 'That was fun, let[apostrophe]s do it again sometime.'[line break]As she leaves you roll onto your back and start to masturbate furiously, the oily aphrodisiac covering your body keeping you incredibly horny, even after your force orgasm after orgasm.  Eventually the raw animal lust subsides and you manage to get up and leave the scene of your latest degradation.";
		otherwise:
			say "'Excellent!' she squeals. 'I always prefer the back door!'[line break]You feel something large and soft pressing against your ass.  You look back to see the vixen pressing one of her massive teats into your crack, you feel a slight pinch as something small pushes through your anus. Her nipple you guess.  She begins to squeeze her breast with both of her black paws, as she squeezes you feel your bowels being filled with a numbing warmth.[line break]'All lubed up!' she says, lightly slapping your ass as she withdraws her now dripping teat from your exposed ass. She positions the pointed tip of her bright pink shaft at your asshole and slowly eases in.  You involuntarily moan with pleasure as the warming lubricant she filled you with seems to remove any pain while still allowing you to feel every inch of her smooth shaft as she slowly starts to fuck you, in and out.[line break]As the Latex Vixens fucking reaches a steady rhythm, you feel her watermelon sized breasts squishing against your back with every thrust.  Every time she rams home, the pressure on her four sloshing jugs causes some of the cinnamon smelling oil to squirt out of her nipples, in only moments your entire back is slick with lube.  Her thrusting starts to become more forceful, you can tell she is trying to get that grapefruit sized knot in you.  Your mind clouded with lust you start meeting her thrusts with thrusts of your own, trying desperately to tie with your kind and loving mistress.[line break]You feel a sudden pop and feel her balls slap your thighs, you try to pull forwards but you can't move.  You are now firmly tied with your latex lover.  She lets out a loud grunt as the pressure on her knot causes her to climax, sending hot sperm flooding through your bowels.  As she peaks her gigantic teats start spraying their bounty, causing hot oily lubricant to rain down on you.  Some of the lube drips down into your mouth,  the flavor is quite intense, tasting like a very spicy cinnamon candy.  You can't quite remember if you liked cinnamon before the world ended, but licking your lips you realize that you sure like it now![line break]She brings one leg over your body and spins around until you are ass to ass, every time her knot pulls at your stretched hole a bolt of pleasure runs up your spine.  You lay there for over half an hour, as she slowly fills every nook and cranny of your intestines with her seed. The numbing and yet sensitizing lubricant in your ass making you feel every single squirt, keeping you achingly close to orgasm the entire time.  Eventually her swollen knot starts to reduce in size and with a loud POP it falls out of your ass.  Torrents of hot fox cum quickly follow, puddling on the ground below you. She squeezes one of your ass cheeks and lightly kisses the other one.  She rises to her feet and starts to walk away.";
			say "Looking back at you she smiles and says 'That was fun, let[apostrophe]s do it again sometime.'[line break]As she leaves you roll onto your back and start to masturbate furiously, the oily aphrodisiac covering your body keeping you incredibly horny, even after your force orgasm after orgasm.  Eventually the raw animal lust subsides and you manage to get up and leave the scene of your latest degradation.";


Section 2 - Monster Insertion

Table of random critters (continued)
name	attack	defeated	victory	desc	face	body	skin	tail	cock	face change	body change	skin change	ass change	cock change	str	dex	sta	per	int	cha	sex	hp	lev	wdam	area	cocks	cock length	cock width	breasts	breast size	male breast size	cunts	cunt length	cunt width	libido	loot	lootchance
--	--	--	--	--	--	--	--	--	--	--	--	--	--	--	--	--	--	--	--	--	--	--	--	--	--

When Play begins:
	add "hermaphrodite latex vixen" to infections of hermaphrodite;
	add "hermaphrodite latex vixen" to infections of furry;
	Choose a blank row from Table of random critters;
	now name entry is "hermaphrodite latex vixen";
	now attack entry is "[one of]She swipes at you with her sharp black claws leaving trails of blood across your chest[or]You see a brilliant flash of red as the Vixen spins and whips at you with her rubber, yet still bushy, tail[or]Her head darts forward, Gleaming teeth nipping at you.[at random]";
	now defeated entry is "[hermaphrodite latex vixen defeat]";
	now victory entry is "[hermaphrodite latex vixen victory]";
	now desc entry is "[hermaphrodite latex vixen desc]";
	now face entry is "short muzzle filled with very sharp carnivorous teeth set below deep brilliant green eyes and pointed fox like ears, all giving you a slightly intimidating yet very alluring";
	now body entry is "tall and nimble, with ample curves.  You have fox like digitigrade legs that end in sharp claws.";
	now skin entry is "shiny white rubber latex skin running from just above your nose all the way down your inner thighs, just covering your stomach.  Glistening black latex covers your hands up to your elbows, and you feet up to your knees, giving you the appearance of long black gloves and boots.  The rest of your body is covered in a bright rubbery red";
	now tail entry is "You have a long red bushy fox tail. The most remarkable thing about the tail is the fur that covers it, instead of being fine strands of fur it is actually fine strands of rubber.  Even though it must weigh over 20 pounds you find it doesn't affect your balance, in fact it seems to help.";
	now cock entry is  "[one of]bright pink[or]knotted[or]black sheathed[at random]";
	now face change entry is "it starts to contort, drawing into a short muzzle.  Your ears migrate to the top of your head pointing straight up, while your eyes change to a deep green.";
	now body change entry is "you start to lose muscle definition, accentuating your curves.  You feel a tingling in your legs as you hear bone cracking and reshaping leaving you with digitigrade legs ending in sharp claws.";
	now skin change entry is "it starts to change color, a bright red spot that seemed to start on your back slowly covers your entire body. A white spot appears on your chest spreading out, and your hands and feet start to darken. As your color changes you also realize your skin is becoming shiny and very stretchy.";
	now ass change entry is "a heavy bright red bushy tail springs forth.";
	now cock change entry is "it is engulfed by a black sheath.  You are assaulted by wave after wave of pleasure as your tool starts to shift and writhe from within the sheath.  In between moans you see a bright pink pointed tip start to make its way out, and once fully erect you see the large pink knot at the base, just aching to tie with someone.";
	now str entry is 10;
	now dex entry is 16;
	now sta entry is 8;
	now per entry is 16;
	now int entry is 16;
	now cha entry is 12;
	now sex entry is "Both";
	now hp entry is 50;
	now lev entry is 9;
	now wdam entry is 14;
	now area entry is "Red";
	now cocks entry is 1;
	now cock length entry is 16;
	now cock width entry is 8;
	now breasts entry is 4;
	now breast size entry is 10;
	now male breast size entry is 0;
	now cunts entry is 1;
	now cunt length entry is 16;
	now cunt width entry is 8;
	now libido entry is 30;
	now loot entry is "cock pill";
	now lootchance entry is 10;

when play ends:
	if bodyname is "hermaphrodite latex vixen":
		if humanity of player is less than 10:
			say "The animal lust overcomes you and you spend the rest of your days working as one of the [one of]most expensive[or]dirtiest[or]sluttiest[or]most demanded[or]nastiest[at random] whores at 'Big Mama[apostrophe]s House of Desire' a brothel opened up by the Hermaphrodite Latex Vixen that infected you.  You are quite happy spending your days with your legs spread, being a cum dump for anyone who walks into the shop, especially given that if you are still not satisfied at the end of the day, Big Mama is more than happy to finish you off.";
		otherwise:
			say "Finding it difficult to satisfy your wanton lust you decide that you may as well monetize it so you start a career in the sex trade.  Spending the rest of your day's getting paid to satisfy your carnal desires is all you could have ever wished for[if intelligence of player is greater than 13] but your keen intellect makes you soon realize you can have much, much more!  With the millions of incredibly horny infected all over the country the prostitution laws have all been revoked, so displaying hidden business savvy you open a small brothel named 'Big Mama[apostrophe]s House of Desire' in tribute to the Hermaphrodite Latex Vixen that started you on your path to debauchery.  Your business grows rapidly, in both clientele and employees.  Soon you have shops all over the country catering to both infected and non-infected customers.  You eventually retire to your own island, one of the richest people in the world, with a small army of staff dedicated to satisfying your every sexual whim[otherwise]![end if]";


Hermaphrodite Latex Vixen for FS ends here.