Version 1 of Altus by Prometheus begins here.

[ HP of Altus                        ]
[ 1 - Rescued from Cavemen           ]
[ 2 - Learnt Altus's approach to sex ]


an everyturn rule:
	if HP of Altus > 1:
		increase Lust of Altus by 1;

Section 1 - NPC Declaration

Table of GameCharacterIDs (continued)
object	name
Altus	"Altus"

Altus is a man.
ScaleValue of Altus is 4. [7']
Body Weight of Altus is 6. [scale of 1-9 for body weight, grouped into low weight (1-3), mid weight (4-6) and high weight (7-9)]
Body Definition of Altus is 7. [scale of 1-9 for body definition, grouped into low muscle (1-3), mid muscle (4-6), high muscle (7-9)]
[Body Adjective is generated out of the body weight and body definition and can be used in scenes - one word descriptive adjective depending on weight and definition groups: low weight group: skinny/slender/lithe; mid weight group: average/fit/muscled; high weight group: pudgy/husky/jacked]
Androginity of Altus is 2. [Gender Adjective is generated out of androginity 1-9: hypermasculine/masculine/somewhat effeminate/effeminate/androgynous/feminine butch/tomboyish/feminine/hyperfeminine]
Mouth Length of Altus is 8. [inches deep for face fucking; maximum possible will be double this number (when deep throating)]
Mouth Circumference of Altus is 3. [mouth circumference 1-5, "tiny, small, normal, wide, gaping"]
Tongue Length of Altus is 8. [length in inches]
Breast Size of Altus is 0. [cup size as number, counting Flat Pecs = 0, A = 1, B = 2, ...]
Nipple Count of Altus is 0. [count of nipples]
Asshole Depth of Altus is 12. [inches deep for anal fucking]
Asshole Tightness of Altus is 2. [asshole tightness 1-5, "extremely tight, tight, receptive, open, gaping"]
Cock Count of Altus is 1. [number of cocks]
Cock Girth of Altus is 3. [thickness 1-5, thin/slender/average/thick/monstrous]
Cock Length of Altus is 12. [12 Inches]
Ball Count of Altus is 2. [allowed numbers: 1 (uniball), 2 or 4]
Ball Size of Altus is 4. [size of balls 1-7: "acorn-sized", "dove egg-sized", "chicken egg-sized" "goose-egg sized", "ostrich-egg sized", "basketball-sized", "beachball-sized"]
Cunt Count of Altus is 0. [number of cunts]
Cunt Depth of Altus is 0. [penetrable length in inches; some minor stretching allowed, or more with Twisted Capacity]
Cunt Tightness of Altus is 0. [size 1-5, generates adjectives of extremely tight/tight/receptive/open/gaping]
Clit Size of Altus is 0. [size 1-5, very small/small/average/large/very large]
[Basic Interaction states as of game start]
PlayerMet of Altus is false.
PlayerRomanced of Altus is false.
PlayerFriended of Altus is false.
PlayerControlled of Altus is false.
PlayerFucked of Altus is false.
OralVirgin of Altus is true.
Virgin of Altus is true.
AnalVirgin of Altus is true.
PenileVirgin of Altus is false.
SexuallyExperienced of Altus is true.
TwistedCapacity of Altus is false. [Twisted Characters can take any penetration, no matter the size]
Sterile of Altus is false. [steriles can't knock people up]
MainInfection of Altus is "Gyrwolf Gryphon".
Description of Altus is "[AltusDesc]".
Conversation of Altus is { "Grrrr! Squawk!" }.

the scent of the Altus is "The feral gryphon smells of dust and arousal despite his efforts to keep himself clean. Perhaps preening just isn't enough."

to say AltusDesc: [gyrfalcon and wolf mix]
	say "     Altus is a rather large gryphon, about seven foot at the shoulder. Instead of the typical cross between lion and eagle, he appears to be a gyrfalcon from head to just past his shoulders, including front legs and wings, before transitioning into the body of a wolf. Piercing yellow eyes gaze back at you as you admire him and he makes sure to stand in a regal pose so that you can better appreciate the mottled gray and white pattern of his feathers and the sheen of his black fur. Swaying beneath him as he moves are his sheath and scrotum, looking plump and soft to the touch, almost begging to be caressed and fondled. His fluffy tail wags every now and then but doesn't seem to be as expressive as a dog's might, Altus instead conveying most messages through facial expression, squawks, and chirps, his understanding of language far beyond his ability to actually speak.";

Instead of conversing the Altus:
	say "[AltusTalkMenu]";


to say AltusTalkMenu:
	LineBreak;
	now sextablerun is 0;
	blank out the whole of table of fucking options;
	[]
	choose a blank row in table of fucking options;
	now title entry is "Discuss Your Day";
	now sortorder entry is 1;
	now description entry is "Tell Altus about some of your exploits in the city (PLACEHOLDER)";
	[]
	choose a blank row in table of fucking options;
	now title entry is "Boop";
	now sortorder entry is 2;
	now description entry is "Boop Altus on the beak";
	[]
	repeat with y running from 1 to number of filled rows in table of fucking options:
		choose row y from the table of fucking options;
		say "[link][y] - [title entry][as][y][end link][line break]";
	say "[link]0 - Nevermind[as]0[end link][line break]";
	while sextablerun is 0:
		say "Pick the corresponding number> [run paragraph on]";
		get a number;
		if calcnumber > 0 and calcnumber <= the number of filled rows in table of fucking options:
			now current menu selection is calcnumber;
			choose row calcnumber in table of fucking options;
			say "[title entry]: [description entry]?";
			if Player consents:
				let nam be title entry;
				now sextablerun is 1;
				if (nam is "Discuss Your Day"):
					say "[AltusTalk1]";
				else if (nam is "Boop"):
					say "[AltusTalk2]";
				wait for any key;
		else if calcnumber is 0:
			now sextablerun is 1;
			say "     You step back from the feral gryphon, shaking your head slightly as he gives a questioning look.";
			wait for any key;
		else:
			say "Invalid Option. Pick between 1 and [the number of filled rows in the table of fucking options] or 0 to exit.";
	clear the screen and hyperlink list;

to say AltusTalk1:
	say "     You tell Altus about the wide open plains, the shadowy forests, and the dull expanses of concrete in the city. The gryphon nods and squawks amiably, enjoying the normal conversation.";

to say AltusTalk2:
	say "     Altus glares at you as your hand approaches his beak, obviously aware of what you have planned. You weave your hand around a bit, the predator's eyes fixed on it unwaveringly. Unfortunately for him, he fails to notice your other hand in time to prevent you booping him on the beak with it, though you are careful to withdraw your hand before he can snap at it. Altus flattens the feathers on his head sulkily, staring at you as though you have betrayed him. He really has got too much pride...";

Section 2 - Sex

instead of fucking Altus:
	if (lastfuck of Altus - turns < 6): [he got fucked in the last 18 hours = 6 turns]
		say "     Altus gives you a condescending glare and shakes his head. Come to think of it, it wasn't too long ago that the two of you last had sex.";
	else if HP of Altus is 1: [First time propositioning him]
		say "     When you ask whether Altus wants to have sex, he looks enthusiastic before stopping for a moment and tilting his head as if in thought. When you ask what is wrong, he lifts one clawed leg and places it on your shoulder, pushing you down slightly and thrusting into the air. He then releases you and nods his head. He then turns around and presents to you, standing still for only a moment before coming back to face you and shaking his head. If you had to guess, he's saying that while he is willing to mate with you, he doesn't want to be in the submissive role.";
		say "     [bold type]Do you still want to have sex with him currently?[roman type][line break]";
		LineBreak;
		say "     ([link]Y[as]y[end link]) - Yes. You don't mind him being dominant for now";
		say "     ([link]N[as]n[end link]) - No. Perhaps in future";
		if Player consents: [Yes]
			LineBreak;
			say "[AltusSexMenu]";
		else: [No]
			LineBreak;
			say "     You step back from the gryphon, shaking your head slightly as he gives a questioning look.";
		now HP of Altus is 2;
	else: [ready for sex]
		say "     Altus looks keen when you ask whether he would be interested in having sex, the tip of his cock already emerging from his sheath. As soon as he nods, you contemplate what you wish to do with the large gryphon.";
		WaitLineBreak;
		say "[AltusSexMenu]";

to say AltusSexMenu:
	LineBreak;
	now sextablerun is 0;
	blank out the whole of table of fucking options;
	[]
	choose a blank row in table of fucking options;
	now title entry is "Give Fellatio";
	now sortorder entry is 1;
	now description entry is "Have a taste of the gyrwolf gryphon's cock";
	[]
	choose a blank row in table of fucking options;
	now title entry is "Be Mounted";
	now sortorder entry is 2;
	now description entry is "Feel Altus's weight atop you";
	[]
	sort the table of fucking options in sortorder order;
	repeat with y running from 1 to number of filled rows in table of fucking options:
		choose row y from the table of fucking options;
		say "[link][y] - [title entry][as][y][end link][line break]";
	say "[link]0 - Nevermind[as]0[end link][line break]";
	while sextablerun is 0:
		say "Pick the corresponding number> [run paragraph on]";
		get a number;
		if calcnumber > 0 and calcnumber <= the number of filled rows in table of fucking options:
			now current menu selection is calcnumber;
			choose row calcnumber in table of fucking options;
			say "[title entry]: [description entry]?";
			if Player consents:
				let nam be title entry;
				now sextablerun is 1;
				if (nam is "Give Fellatio"):
					say "[AltusSex1]";
				if (nam is "Be Mounted"):
					say "[AltusSex2]";
				wait for any key;
		else if calcnumber is 0:
			now sextablerun is 1;
			say "     You step back from the gryphon, shaking your head slightly as he gives a questioning look.";
			wait for any key;
		else:
			say "Invalid Option. Pick between 1 and [the number of filled rows in the table of fucking options] or 0 to exit.";
	clear the screen and hyperlink list;

to say AltusSex1:
	say "     Altus looks at you expectantly, waiting for you to crawl beneath him and show him how talented you are with your mouth. He may be grateful for you having saved him from the hunters and given him sanctuary, but he isn't desperate enough for sex to besmirch his pride. You however knew what you were getting yourself into and squeeze under him, crinkling your nose at the strong male smell that emanates from his scrotum and only grows stronger as you begin to caress his sheath and balls. You have no doubt that he has kept himself clean, especially with how often he preens and grooms, but the musk nonetheless clings to his fur, ready to mark his mate and dissuade competition. Cupping a testicle in your hand, you heft it to test its weight, already imagining the generous helping of seed that it will provide. The gryphon lets out a squawk of appreciation and several inches of his cock slides from his sheath, bumping against your cheek and leaving a glistening trail across it.";
	say "     Continuing to stroke and cup Altus's balls, you press your face against his shaft, licking at it as it slowly emerges, occasionally slipping the tip of your tongue inside the confines of the sheath. Each time you do so, the gryphon stiffens and a squirt of pre shoots across your face or shoulder. You may have found a weak point and mentally file this away for another time as you slather his cock with your saliva, tasting him as you warm up to taking it in your mouth properly. As the bulge at the base of his shaft slides free, you realize that his cock is now fully on show, a whole twelve inches long. Leaving one hand to continue caressing his scrotum, the other slides forward to begin stroking up and down the length of his penis, while your mouth coddles the tip, your tongue circling the point and collecting all the pre that you can. Part of you wonders whether swallowing it will count us lubing your throat up, but you quickly dismiss this idea. Either you are ready, or you aren't and there's nothing more that suckling him will do to prepare you.";
	WaitLineBreak;
	say "     Altus shifts his feet impatiently, though you can hardly blame him considering how aroused you've made him with what many would consider teasing. Lining your mouth up with his shaft, you prepare to begin blowing him, but have the initiative taken from you before you can swallow more than an inch. The lupine gryphon thrusts forward, plunging his cock into your wet mouth-hole and forcing a startled gargle to escape around his invading penis, though you manage to avoid choking or getting whiplash. You slap him on the side of the leg to indicate that he shouldn't be so rough and fortunately he relents a little, though still maintains solid thrusts. You're not sure whether to be grateful that he is taking an active part in fucking your face, or whether you would have preferred to maintain some measure of control, but it's out of your hands now as Altus treats your head like the hindquarters of a particularly fertile gryphoness or studly gryphon. Either way, you can hear his pleasured vocalizations and his front claws scraping at the ground as he thrusts into your throat.";
	say "     Not content to merely be a passive partner, you resume caressing his balls, and squeeze the muscles of your throat each time he is just about to withdraw again. You are unable to breath in anything but his potent scent, it having only become stronger as his arousal has grown and you are sure that you are going to smell like his musk for the next few days, even if you take the time to shower, and by this point you're not even sure if you care. You are snapped out of these thoughts by the gryphon's knot pummeling against your lips before, with a triumphant shriek, Altus floods your stomach with his seed, his cock pulsing on your tongue while his knot quivers beneath your nose. Cupped in your hands, you can feel his balls rise and fall, sending another whoosh of cum to join the deluge down your throat as you massage them.";
	say "     The two of you stay like this while his orgasm runs its course and even as his cock begins to go soft. Eventually however, it must come to an end and Altus takes a step back to allow his shaft to slip from your mouth, followed by a sizable stream of cum that pools around your knees. As you clamber out from under the gryphon, he showers you with affectionate nibbles, unconcerned about getting his seed on his feathers as long as he shows you his gratitude. His pride really is strange...";
	NPCSexAftermath Player receives "OralCock" from Altus;
	PlayerDrink 15;

to say AltusSex2:
	if player is Female:
		say "     [bold type]How would you like to be mounted?[roman type][line break]";
		let Altus_Mounting_Decisions be a list of text;
		add "Vaginally." to Altus_Mounting_Decisions;
		add "Anally." to Altus_Mounting_Decisions;
		let Altus_Mounting_Decision be what the player chooses from Altus_Mounting_Decisions;
		if Altus_Mounting_Decision is:
			-- "Vaginally.": [Will likely be updated as the vaginal scene is largely a placeholder]
				LineBreak;
				say "     The combination of Altus's imperious appearance and alluring scent draws you in and you find the idea of presenting yourself and allowing him to mount you unresistable any longer. [if player is not naked]After stripping of your clothes, y[else]Y[end if]ou drop to all fours and display your pussy towards the gryphon invitingly, occasionally wiggling it just in case his attention has drifted. The wet, tickly sensation of his tongue grazing your cunt suggests that his focus had remained intently on you all along and that he was merely taking full advantage of the view before the sight before him became too much to remain aloof from. As his tongue slickens your vulva, Altus grasps your thigh with one of his claws, lightly pricking the skin and establishing his superior position over you, at least for this period of time. Occasionally, his beak brushes against your clitoris, it hard and jagged texture a stark contrast to the dextrous organ wriggling below.";
				say "     It doesn't take Altus too long to decide that you are ready, or at least ready enough given his growing excitement. Stepping over you, his avian front feet grip you by the shoulders, while his lupine hind legs brace against the floor, leaving his dripping shaft to slide against your back[if BodyName of Player is listed in infections of BipedalList], comfortably cradled by the dome of your buttocks[end if]. After a few test thrusts, while spurts of pre further lubricate the entrance to your pussy, he quickly finds his mark and drives his cock into the welcoming, if tight, embrace of your vagina, letting out a jubilant squawk as he feels your walls clench around him. ";
				if player is Herm:
					say "As he bottoms out, you feel his balls swing forward to collide with [if CockName of Player is listed in infections of InternalBallsList]the base of your penis[else]your own[end if], the large orbs within no doubt churning with the seed that will soon flood your womb. Each time his groin collides with you, breath is driven from your lungs, leaving you gasping even as you [if player is submissive]beg for more[else]urge him onwards[end if].";
				else:
					say "As he bottoms out, you feel his balls swing forward to collide with your clit, the large orbs within no doubt churning with the seed that will soon flood your womb. Each time his groin collides with you, breath is driven from your lungs, leaving you gasping even as you [if player is submissive]beg for more[else]urge him onwards[end if].";
				WaitLineBreak;
				say "     Altus is only too willing to comply, both speeding up and putting more force behind his thrusts to really cause you to moan and praise him. You can feel beads of pre and sweat trickling over your thighs, and the increasingly potent aroma of the gryphon's musk fills your nose and mouth each time you inhale. With how his claws are digging into the skin of your shoulders, you certainly appreciate how his pheromones seem to take the pain that this most likely causes and convert it to a form of pleasure. Perhaps this extends too to the feeling of the walls of your bowels stretching to accommodate his girthy shaft, much thicker than most wolves you've encountered, as it pummels into you, the even fatter knot battering at your vulva demanding to be allowed entrance so that you might be properly bred. Despite the contrast, the tender cooing and chirping by your ear as Altus expresses his affection only seems to heighten your emotional enjoyment to match the physical pleasure that he is giving you.";
				say "     Realizing that you've just been letting him have all the control, you begin to take a more active role, though given the increasingly urgent nature of the gryphon's thrusts, it seems unlikely that he will last much longer. Nonetheless, you resolve to be part of the reason that he can't hold himself back any longer, pushing your hips back to meet his thrusts and earning a warble of respect from Altus. This inadvertently has the effect of granting his knot just enough force to pop into the heated confines of your pussy, promptly followed by the first wave of your partner's climax. Wave after wave of cum floods your womb, the gryphon shrieking triumphantly as he fills you. Were it not for his knot plugging the escape, you are sure that his seed would be spraying out with each contraction. As it is, the pressure causes your own orgasm and your [if player is Herm]seed [else]fem-cum [end if]is sprayed onto the ground beneath you, it's unique scent mixing with that of the gryphon above you.";
				WaitLineBreak;
				say "     The two of you stay like this while Altus's orgasm runs its course, even as his cock begins to go soft and the flood that had previously been held back is allowed to gush forth. A deluge of cum surges from your cunt, pushing the gryphon's shaft completely out from your vagina and pooling on the ground by your feet. Altus steps away to allow you to regain your feet, though perhaps he also wishes to limit the amount of semen that he shall undoubtedly have to wash from his paws. As you catch your breath, he showers you with affectionate nibbles, demonstrating how much he enjoyed mating with you and likely trying to entice you to submit to him again in future. Given how much you enjoyed it too, it certainly seem a possibility.";
				NPCSexAftermath Player receives "PussyFuck" from Altus;
			-- "Anally.":
				LineBreak;
				say "     The combination of Altus's imperious appearance and alluring scent draws you in and you find the idea of presenting yourself and allowing him to mount you unresistable any longer. [if player is not naked]After stripping of your clothes, y[else]Y[end if]ou drop to all fours and display your ass towards the gryphon invitingly, occasionally wiggling it just in case his attention has drifted. The wet, tickly sensation of his tongue grazing your hole suggests that his focus had remained intently on you all along and that he was merely taking full advantage of the view before the sight before him became too much to remain aloof from. As his tongue slickens your anus, Altus grasps your thigh with one of his claws, lightly pricking the skin and establishing his superior position over you, at least for this period of time. Occasionally, his beak brushes against your sphincter, it hard and jagged texture a stark contrast to the dextrous organ wriggling within.";
				say "     It doesn't take Altus too long to decide that you are ready, or at least ready enough given his growing excitement. Stepping over you, his avian front feet grip you by the shoulders, while his lupine hind legs brace against the floor, leaving his dripping shaft to slide against your back[if BodyName of Player is listed in infections of BipedalList], comfortably cradled by the dome of your buttocks[end if]. After a few test thrusts, while spurts of pre further lubricate your anus, he quickly finds his mark and drives his cock into the welcoming, if tight, embrace of your ass, letting out a jubilant squawk as he feels your walls clench around him. ";
				if player is Herm:
					say "As he bottoms out, you feel his balls swing forward to collide with [if CockName of Player is listed in infections of InternalBallsList]your leaking vulva[else]your own as well as your leaking vulva[end if], the large orbs within no doubt churning with the seed that will soon flood your bowels. Each time his groin collides with you, breath is driven from your lungs, leaving you gasping even as you [if player is submissive]beg for more[else]urge him onwards[end if].";
				else:
					say "As he bottoms out, you feel his balls swing forward to collide with your leaking vulva, the large orbs within no doubt churning with the seed that will soon flood your bowels. Each time his groin collides with you, breath is driven from your lungs, leaving you gasping even as you [if player is submissive]beg for more[else]urge him onwards[end if].";
				WaitLineBreak;
				say "     Altus is only too willing to comply, both speeding up and putting more force behind his thrusts to really cause you to moan and praise him. You can feel beads of pre and sweat trickling over your thighs, and the increasingly potent aroma of the gryphon's musk fills your nose and mouth each time you inhale. With how his claws are digging into the skin of your shoulders, you certainly appreciate how his pheromones seem to take the pain that this most likely causes and convert it to a form of pleasure. Perhaps this extends too to the feeling of the walls of your bowels stretching to accommodate his girthy shaft, much thicker than most wolves you've encountered, as it pummels into you, the even fatter knot battering at your sphincter demanding to be allowed entrance so that you might be properly bred. Despite the contrast, the tender cooing and chirping by your ear as Altus expresses his affection only seems to heighten your emotional enjoyment to match the physical pleasure that he is giving you.";
				say "     Realizing that you've just been letting him have all the control, you begin to take a more active role, though given the increasingly urgent nature of the gryphon's thrusts, it seems unlikely that he will last much longer. Nonetheless, you resolve to be part of the reason that he can't hold himself back any longer, pushing your hips back to meet his thrusts and earning a warble of respect from Altus. This inadvertently has the effect of granting his knot just enough force to squeeze past your sphincter and pop into the heated confines of your ass, promptly followed by the first wave of your partner's climax. Wave after wave of cum floods into your bowels, the gryphon shrieking triumphantly as he fills you. Were it not for his knot plugging the escape, you are sure that his seed would be spraying out with each contraction. As it is, the pressure causes your own orgasm and your [if player is Herm]seed [else]fem-cum [end if]is sprayed onto the ground beneath you, it's unique scent mixing with that of the gryphon above you.";
				WaitLineBreak;
				say "     The two of you stay like this while Altus's orgasm runs its course, even as his cock begins to go soft and the flood that had previously been held back is allowed to gush forth. A deluge of cum surges from your anus, pushing the gryphon's shaft completely out from your hole and pooling on the ground by your feet. Altus steps away to allow you to regain your feet, though perhaps he also wishes to limit the amount of semen that he shall undoubtedly have to wash from his paws. As you catch your breath, he showers you with affectionate nibbles, demonstrating how much he enjoyed mating with you and likely trying to entice you to submit to him again in future. Given how much you enjoyed it too, it certainly seem a possibility.";
				NPCSexAftermath Player receives "AssFuck" from Altus;
	else:
		say "     The combination of Altus's imperious appearance and alluring scent draws you in and you find the idea of presenting yourself and allowing him to mount you unresistable any longer. [if player is not naked]After stripping of your clothes, y[else]Y[end if]ou drop to all fours and display your ass towards the gryphon invitingly, occasionally wiggling it just in case his attention has drifted. The wet, tickly sensation of his tongue grazing your hole suggests that his focus had remained intently on you all along and that he was merely taking full advantage of the view before the sight before him became too much to remain aloof from. As his tongue slickens your anus, Altus grasps your thigh with one of his claws, lightly pricking the skin and establishing his superior position over you, at least for this period of time. Occasionally, his beak brushes against your sphincter, it hard and jagged texture a stark contrast to the dextrous organ wriggling within.";
		say "     It doesn't take Altus too long to decide that you are ready, or at least ready enough given his growing excitement. Stepping over you, his avian front feet grip you by the shoulders, while his lupine hind legs brace against the floor, leaving his dripping shaft to slide against your back[if BodyName of Player is listed in infections of BipedalList], comfortably cradled by the dome of your buttocks[end if]. After a few test thrusts, while spurts of pre further lubricate your anus, he quickly finds his mark and drives his cock into the welcoming, if tight, embrace of your ass, letting out a jubilant squawk as he feels your walls clench around him. As he bottoms out, you feel his balls swing forward to collide with [if CockName of Player is listed in infections of InternalBallsList]the base of your penis[else]your own[end if], the large orbs within no doubt churning with the seed that will soon flood your bowels. Each time his groin collides with you, breath is driven from your lungs, leaving you gasping even as you [if player is submissive]beg for more[else]urge him onwards[end if].";
		WaitLineBreak;
		say "     Altus is only too willing to comply, both speeding up and putting more force behind his thrusts to really cause you to moan and praise him. You can feel beads of pre and sweat trickling over your thighs, and the increasingly potent aroma of the gryphon's musk fills your nose and mouth each time you inhale. With how his claws are digging into the skin of your shoulders, you certainly appreciate how his pheromones seem to take the pain that this most likely causes and convert it to a form of pleasure. Perhaps this extends too to the feeling of the walls of your bowels stretching to accommodate his girthy shaft, much thicker than most wolves you've encountered, as it pummels into you, the even fatter knot battering at your sphincter demanding to be allowed entrance so that you might be properly bred. Despite the contrast, the tender cooing and chirping by your ear as Altus expresses his affection only seems to heighten your emotional enjoyment to match the physical pleasure that he is giving you.";
		say "     Realizing that you've just been letting him have all the control, you begin to take a more active role, though given the increasingly urgent nature of the gryphon's thrusts, it seems unlikely that he will last much longer. Nonetheless, you resolve to be part of the reason that he can't hold himself back any longer, pushing your hips back to meet his thrusts and earning a warble of respect from Altus. This inadvertently has the effect of granting his knot just enough force to squeeze past your sphincter and pop into the heated confines of your ass, promptly followed by the first wave of your partner's climax. Wave after wave of cum floods into your bowels, the gryphon shrieking triumphantly as he fills you. Were it not for his knot plugging the escape, you are sure that his seed would be spraying out with each contraction. As it is, the pressure causes your own orgasm and your seed is sprayed onto the ground beneath you, it's unique scent mixing with that of the gryphon above you.";
		WaitLineBreak;
		say "     The two of you stay like this while Altus's orgasm runs its course, even as his cock begins to go soft and the flood that had previously been held back is allowed to gush forth. A deluge of cum surges from your anus, pushing the gryphon's shaft completely out from your hole and pooling on the ground by your feet. Altus steps away to allow you to regain your feet, though perhaps he also wishes to limit the amount of semen that he shall undoubtedly have to wash from his paws. As you catch your breath, he showers you with affectionate nibbles, demonstrating how much he enjoyed mating with you and likely trying to entice you to submit to him again in future. Given how much you enjoyed it too, it certainly seem a possibility.";
		NPCSexAftermath Player receives "AssFuck" from Altus;

Section 2.1 - Needy Altus Sex

instead of going to Garden View while Lust of Altus > 24:
	say "     Entering the room, your view of the garden is immediately obstructed by a very horny gryphon, Altus's knotted penis erect and dribbling beneath him. He churrs and warbles as he brushes up against you needily, flicking his tail up as he turns to show you his hole, desperate for you to sooth his lust. As he presents himself to you, you realize that his arousal has got the best of his pride and he is even willing to be submissive to you this time. With that in mind, you wonder to yourself how you're going to take advantage of this chance.";
	say "[AltusNeedySexMenu]";

to say AltusNeedySexMenu:
	LineBreak;
	now sextablerun is 0;
	blank out the whole of table of fucking options;
	[]
	if Player is Male:
		choose a blank row in table of fucking options;
		now title entry is "Be Blown";
		now sortorder entry is 1;
		now description entry is "Have the gryphon suck your cock while you jack him off";
	[]
	if Player is Female:
		choose a blank row in table of fucking options;
		now title entry is "Be Eaten Out";
		now sortorder entry is 1;
		now description entry is "Have the gryphon lick your pussy while you jack him off";
	[]
	if Player is Male:
		choose a blank row in table of fucking options;
		now title entry is "Mount Him";
		now sortorder entry is 3;
		now description entry is "Put the usually proud gryphon in his place and fuck his ass";
	[]
	choose a blank row in table of fucking options;
	now title entry is "Ride Him";
	now sortorder entry is 4;
	now description entry is "Push Altus on his back and ride his cock";
	[]
	sort the table of fucking options in sortorder order;
	repeat with y running from 1 to number of filled rows in table of fucking options:
		choose row y from the table of fucking options;
		say "[link][y] - [title entry][as][y][end link][line break]";
	say "[link]0 - Nevermind[as]0[end link][line break]";
	while sextablerun is 0:
		say "Pick the corresponding number> [run paragraph on]";
		get a number;
		if calcnumber > 0 and calcnumber <= the number of filled rows in table of fucking options:
			now current menu selection is calcnumber;
			choose row calcnumber in table of fucking options;
			say "[title entry]: [description entry]?";
			if Player consents:
				let nam be title entry;
				now sextablerun is 1;
				if (nam is "Be Blown"):
					say "[AltusNeedySex1]";
				if (nam is "Be Eaten Out"):
					say "[AltusNeedySex2]";
				if (nam is "Mount Him"):
					say "[AltusNeedySex3]";
				if (nam is "Ride Him"):
					say "[AltusNeedySex4]";
				wait for any key;
		else if calcnumber is 0:
			now sextablerun is 1;
			say "     Altus lets out a pitiful whine as you shake your head, wondering how you could be so cruel to deny him when he is so desperate to be fucked. Sullenly, the gryphon stalks into a corner and slumps to the floor, shuddering as his penis is stimulated beneath him.";
			move Player to Garden View;
			wait for any key;
		else:
			say "Invalid Option. Pick between 1 and [the number of filled rows in the table of fucking options] or 0 to exit.";
	clear the screen and hyperlink list;

to say AltusNeedySex1: [Fellatio]
	say "     You [if player is Submissive]tell [else]order [end if]Altus to lie on his back, to show you just how much he needs this by making himself vulnerable. Though the gryphon warbles a complaint, he nonetheless complies, carefully folding his wings before rolling over, the motion causing his cock to sway and disgorge a generous load of pre to drizzle across his fur. Taking a moment to observe the slutty beast, you realize that given his predatory beak, fellatio may not have been the best idea. However, your decision has been made and you plan to carry through with it, no matter the risk. You firmly seat yourself atop Altus's face, momentarily reveling in the sensation of his feathers against your balls and backside. Swans have nothing on softness compared to gryphons apparently. However, it doesn't take long for his beak to bump up against your shaft and remind you of you goal, the accompanying peril being smothered by the arousal at dominating the gyrwolf gryphon.";
	say "     After commanding Altus to begin sucking you off, and to be careful, you run a hand down his body, even repeating the transition from feathers to fur a few times for good measure. This also has the effect of coating your hand with his precum, lubing your fingers up so that they can slip up and down his starved shaft all the more easily. As you grasp the organ in question, it leaps in your palm and a fresh spurt of pre dribbles over your hand. You can't help but bring your fingers up to your face and give them a sniff, shuddering as the pheromones worm their way past your nostrils and down the back of your throat to fill your lungs with his potent scent. Part of you wishes that you were sucking him off too, but you tighten your grip around the gryphon's cock and steadily rub up and down, squeezing every now and then to further his stimulation.";
	WaitLineBreak;
	say "     Meanwhile, Altus busies himself with blowing you, curling his tongue around your cock as he makes a few shallow bobs of his head, the tip of his beak stirring your scrotum. You can feel the puff of air each time he exhales, the tickly feeling immensely arousing given the circumstances. As soon as he becomes accustomed to this, the gryphon drapes his tongue over his mandible, providing a soft, wet landing-strip for your cock to enter his mouth properly. Before he can continue, you surprise him by taking charge, thrusting down into the confines of his beak. Telling him to focus on keeping anything sharp away from your sensitive flesh, you time your thrusts with your hand movements. Each time your fingers reach the base of his penis, you hilt yourself in his mouth, and each time your digits encircle his tapered tip, you withdraw to allow him to breath unimpeded. As this continues, Altus's satisfaction becomes more obvious, both through the excited squirts of pre, and the murmurs of pleasure that increase in volume.";
	say "     Keen to make the bird sing more, you bring your other hand forward to caress his balls, the orbs heavy in your palm and the fur particularly thick with musky sweat and body-oil. A pretty trill escapes from Altus's throat as your cock withdraws, before being stifled again when you plug the hole. With a smirk, you continue, fondling, caressing, and stroking, bringing him relentlessly closer to what he so desperately needs, but with the pleasure, may not immediately want. For a moment, you wonder whether you should play with his anus for a bit, but ultimately decide against it, tracing a finger over the base of his tail to tease him before returning it to his scrotum. You've got enough to do already and you doubt that he'll be able to last too much longer, especially with how his pre seems to be ceaselessly dribbling from his cock to flow down his length and over your hands. Altus may be close, but you have no intention of letting him cum before you do. He has to earn it first.";
	WaitLineBreak;
	say "     You return your focus to thrusting into the gryphon's maw, adeptly edging him while you build towards climax. The tight ring at the top of his throat is especially pleasurable for your cock to squeeze past, deliciously clamping around you each time the avian reflexively swallows. You're impressed that he has managed to keep his beak from scratching you, a combination of his tongue and the way that he tilts his head accomplishing this impressive feat while also boosting your pleasure. Fortunately, the outside of his beak isn't as much of a threat, especially with how your balls slap against his maxilla as your orgasm creeps closer and you [']breed['] his mouth with greater passion. Eventually, you can't hold off any longer, hilting yourself with a relieved gasp, flooding his throat with your seed and leaving him no choice but to swallow it.";
	say "     Lost in your release, it takes you moment to resume jacking Altus off, though it doesn't take much to make the gryphon shoot. And shoot it does, his cock wrenching itself from your grasp to plaster you with his cum, the potent, viscous fluid splashing against your face and chest, as well as soaring past you to splatter across the floor. You can feel his balls rise and release beneath your palm, working relentlessly to produce an inordinate amount of semen for the virile male that could have been used to impregnate many mates, but is instead pooling on the ground beneath him. It takes several minutes for Altus's orgasm to ebb, giving you enough time for your own climax to finish, the gryphon surprisingly affectionate while this goes on. Eventually however, you decide that you should get on with your day and stand up, wiping yourself clean against his thick, furry pelt to get even for the hosing that you received. It's only fair after all. With a look of mild reproach, Altus begins to preen and wash himself as you walk away.";
	NPCSexAftermath Altus receives "OralCock" from Player;
	now Lust of Altus is 0;
	move Player to Garden View;

to say AltusNeedySex2: [Cunnilingus]
	say "     You [if player is Submissive]tell [else]order [end if]Altus to lie on his back, to show you just how much he needs this by making himself vulnerable. Though the gryphon warbles a complaint, he nonetheless complies, carefully folding his wings before rolling over, the motion causing his cock to sway and disgorge a generous load of pre to drizzle across his fur. Taking a moment to observe the slutty beast, you realize that given his predatory beak, cunnilingus really may not have been the best idea. However, your decision has been made and you plan to carry through with it, no matter the risk. You firmly seat yourself atop Altus's face, momentarily reveling in the sensation of his feathers against your vulva and backside. Swans have nothing on softness compared to gryphons apparently. Smearing your budding arousal across his head, it doesn't take long for the curve of his beak to press between your labia and remind you of you goal, the accompanying peril being smothered by the titillation at dominating the gyrwolf gryphon.";
	say "     Shivering with a mix of arousal and apprehension, you command to begin licking, and to be careful, as you run a hand down his body, even repeating the transition from feathers to fur a few times for good measure. This also has the effect of coating your hand with his precum, lubing your fingers up so that they can slip up and down his starved shaft all the more easily. As you grasp the organ in question, it leaps in your palm and a fresh spurt of pre dribbles over your hand. You can't help but bring your fingers up to your face and give them a sniff, shuddering as the pheromones worm their way past your nostrils and down the back of your throat to fill your lungs with his potent scent. Part of you wishes that you were sucking him off too, but you tighten your grip around the gryphon's cock and steadily rub up and down, squeezing every now and then to further his stimulation.";
	WaitLineBreak;
	say "     Meanwhile, Altus busies himself with eating you out, flicking his tongue across your clit, lapping your labia, and plunging it in as far as it will reach. It is fortunate that his tongue seems able to extend from his mouth so far as you've yet to feel the edge of his beak against such vulnerable flesh. Given his success so far, you permit him to continue at his own pace, focusing instead on his cock while occasionally letting out a gasp as he caresses a sensitive area inside of you. You flinch as you feel something hard brush against your thigh, making you clench around his tongue, but also momentarily heightening your sensitivity as you freeze. Running your nails down his length as a warning, you quickly resume pleasuring him, alternating between encircling his tip with your fingers and squeezeing the base as you rub your hand up and down. As this continues, Altus's satisfaction becomes more obvious, both through the excited squirts of pre, and the murmurs of pleasure that increase in volume.";
	say "     Keen to make the bird sing more, you bring your other hand forward to caress his balls, the orbs heavy in your palm and the fur particularly thick with musky sweat and body-oil. A pretty trill escapes from Altus's throat as he pulls his face from your cunt, before being stifled again when youinsistently press back. With a smirk, you continue, fondling, caressing, and stroking, bringing him relentlessly closer to what he so desperately needs, but with the pleasure, may not immediately want. For a moment, you wonder whether you should play with his anus for a bit, but ultimately decide against it, tracing a finger over the base of his tail to tease him before returning it to his scrotum. You've got enough to do already and you doubt that he'll be able to last too much longer, especially with how his pre seems to be ceaselessly dribbling from his cock to flow down his length and over your hands. Altus may be close, but you have no intention of letting him cum before you do. He has to earn it first.";
	WaitLineBreak;
	say "     You are, however, entirely dependant on the gryphon for this. You can't hasten it yourself without risking injury. You aren't without options though. Slowing your hand movements to a crawl, you adeptly edge the bird hybrid while egging him on to hurry up if he wants to cum. Whining in desperation, Altus flicks his tongue even faster repeating anything that elicits a moan or muscle spasm from you. Throughout this, he still keeps his beak in check, a measure of self-control that you find impressive. You begin to praise him, though throwing in mention of him being such a slutty bird with how needy he has become. Your climax comes with a rush, causing you to grip his head with your thighs as you shudder and send fem-cum drizzling across his face, the gryphon not letting up even as your nerves become more sensitive, almost paralyzing you with pleasure.";
	say "     Lost in your release, it takes you moment to resume jacking Altus off, though it doesn't take much to make the gryphon shoot. And shoot it does, his cock wrenching itself from your grasp to plaster you with his cum, the potent, viscous fluid splashing against your face and chest, as well as soaring past you to splatter across the floor. You can feel his balls rise and release beneath your palm, working relentlessly to produce an inordinate amount of semen for the virile male that could have been used to impregnate many mates, but is instead pooling on the ground beneath him. It takes several minutes for Altus's orgasm to ebb, giving you enough time for your own climax to finish, the gryphon surprisingly affectionate while this goes on. Eventually however, you decide that you should get on with your day and stand up, wiping yourself clean against his thick, furry pelt to get even for the hosing that you received. It's only fair after all. With a look of mild reproach, Altus begins to preen and wash himself as you walk away.";
	NPCSexAftermath Altus receives "OralPussy" from Player;
	now Lust of Altus is 0;
	move Player to Garden View;

to say AltusNeedySex3: [Mount Altus]
	say "     With Altus in a good position already, you step up behind him, slipping a couple of fingers into his clenching ass before leaning over the top of him and asking in a soft whisper if he'll be a good little birdy for you, or perhaps a slutty puppy. The gryphon whines a bit, though you are unsure whether it is protest at being demeaned or whether he is just that desperate, but you take it as the latter. Before withdrawing your fingers, you curl them up to brush against the gyr-wolf's prostate, earning a thick rope of pre from his shivering cock that splatters on the floor. [if Player is naked]Already naked[else]Hastily stripping off your clothes[end if], you don't see much reason to dither. Though you are aroused and erect, Altus is significantly more so, flagging his tail, winking his anus, and panting with need. Grasping his flank, you step forward and sink your cock into the welcoming embrace of his ass, only stopping when [if Cock Length of Player > 12]you feel that you can go no deeper[else]your hips are pressed into the backs of his thighs[end if].";
	say "     His fur is warm, but his bowels feel like a furnace in comparison and you briefly chuckle as you tease the gryphon that perhaps he is in heat. Altus does little to dissuade this notion, in fact seeming to contribute further to it by pressing himself back against you and wriggling to further his stimulation, copious pre drizzling from his engorged penis to be wasted on the ground. Clenching his fur in your fists, you firmly thrust in and out of the gyr-wolf gryphon, gradually increasing the pace as he loosens up. Despite the ease with which you are able to enter him, the walls of his rectum grip and caress around your shaft, massaging your flesh and urging you to go harder and faster in order to fill the bird-wolf hybrid with your seed and extinguish the flames of his lust. At least for now. Who knew that beneath the predator's pride lay such a needy slut?";
	WaitLineBreak;
	say "     His chest pressed against the floor, Altus sways forward each time you thrust into him, his foot-long cock swinging in sync and leaving a sticky, pheromone-laced trail. In a generous mood, you snake a hand down without slowing your movement and rub your thumb over the back of his balls, feeling their weight on your fingers and the bounty that promises to be released when he inevitably cums. Briefly withdrawing your hand, you give it a sniff and immediately feel your penis harden a little more within the embrace of his ass as the masculine scent fills your nose, the scent of a powerful beast that has submitted itself to you out of need and desire. A shiver passes through your body and you redouble the vigor with which you fuck the gryphon, a muffled slap bursting forth each time you collide with his haunches. Altus squawks, chirps, and almost seems to howl at times as you hammer into him, his tail, trapped between your copulating bodies, twitching and thrashing as he is filled.";
	say "     With your own pleasure mounting, you reach your hand beneath him again and encircle his steamy cock in your palm, rubbing up and down at about half the pace of your passionate rutting. The gryphon warbles appreciatively, frenetically thrusting beneath your fingers to boost his own gratification while also increasing your own as he slides on and off your turgid shaft. You can feel his knot pulsing against your wrist and the knowledge of how close he is tempts you to edge and tease him, to make him earn his orgasm, but you soon dismiss this thought. Perhaps one day you can draw it out, but today you have better things to do, especially when your pleasure is approaching boiling point too. However, in the interests of cementing just a little power over him, you hold your penis still inside of him and lean towards Altus's ear to goad him into begging. Even if he can't speak, he needs to make it clear to you just how deeply he craves release and to soothe the gnawing lust within him.";
	WaitLineBreak;
	say "     Altus turns his head to stare at you pleadingly before letting out a plaintive avian wail, clenching the walls of his rectum as he does so. Part of you wonders if you could get more from him, but the possibility of pushing him too far incites you to take mercy on the usually prideful gryphon. Who knows how long he would give you the cold shoulder if you made him utterly debase himself? Squeezing the flesh of his rump with one hand while with the other, wrapping your fingers around just below his knot, you pound Altus into the ground until, not long afterwards, he tips his head back and lets out a triumphant trill as thick pearlescent cum sprays from his cock to splash on the ground and paint his underside with the potent-smelling fluid. You aren't far behind either, the physical sensations of his bowels clamping, the aroma of his essence, and psychological fulfillment of topping the gryphon driving you to flood his passage with your semen. Gasping and sighing, you collapse on top of him, relaxing into the warm fur as your balls empty themselves inside of your partner.";
	say "     As the two of you recover from your passionate mating, Altus's behavior gradually reverts back towards his usual aloof demeanor. Where he was initially fawning over you in appreciation for sating him, his affection slowly becomes more measured; a graceful attempt to groom you rather than rubbing his face against your body. Were you not sure that it would insult him to do so, you would laugh at this transition from slutty bird, to regal falcon, though the image is slightly spoiled by the strands of cum clinging to his fur and the pool beneath him. His pride won't let him seem ungrateful, but equally, it won't permit too blatant a display of affection either, leaving him to traverse the territory between. After your cock softens and is expelled from his anus, the gryphon briefly rests his head on your shoulder, warbles, then steps away to preen and clean himself, leaving the mess to soak into the carpet, and for you to get your own affairs in order.";
	NPCSexAftermath Altus receives "AssFuck" from Player;
	now Lust of Altus is 0;
	move Player to Garden View;

to say AltusNeedySex4: [Ride Altus]
	if Player is Female:
		say "     [bold type]Do you wish Altus's penis in your pussy or your ass?[roman type][line break]";
		LineBreak;
		say "     ([link]Y[as]y[end link]) - Pussy.";
		say "     ([link]N[as]n[end link]) - Ass.";
		if Player consents: [Vaginal Penetration]
			say "     You [if Player is Submissive]tell [else]command [end if]Altus to roll over, the gryphon indignantly flapping his wings in a manner that suggests that the appendages will get in the way. Unimpressed, you remind him that you know that he is capable of it and that if he really wants to be left blue-balled rather than get to sink his cock into your pussy, then that's fine with you. The choice is his, but your patience is running thin. Altus tilts his head in thought before slumping on his side and carefully rolling over, his wings tightly pressed to his body. Clicking your tongue, you warn him that next time you might not be so accommodating to his resistance before [if player is not naked]stripping and [end if]clambering atop him, nestling his slick shaft between your labia. With how much pre streaming down the sides, you are confident that you'll be able to penetrate yourself on it without much difficulty.";
			say "     Comfortably seated, you reach a hand down, wrapping your fingers around the hot flesh of his cock and rubbing it up and down, feeling the fresh spurts of pre against your tummy as your touch excites him. You wonder if you'll be able to feel this when he is inside you, before deciding that you'll probably be too focused on other things to care. After briefly darting your hand down to caress his churning balls, you lift your hips up until the pointed tip of his penis slips into your vagina before slowly lowering yourself down again, relishing the feel of your vulva spreading and your pussy being filled. Altus coos blissfully, his tail thumping against the floor though he otherwise remains still, accepting your control of the pace. You praise him as you continue to sink down until [if Asshole Depth of Player > 11 or Player is twistcapped]only his knot remains outside[else]no more of his flesh-spire can fit inside[end if], blowing air between your lips as you appreciate the length and girth of your partner.";
			WaitLineBreak;
			say "     Savoring the sensation, you hold like this for half a minute, swaying slightly and clenching around the gryphon's penis, taking the time to feel the spurts of pre prepare your passage for the breeding ahead of you. [if Player is Herm]Your own cock bobs with each movement, a steady trickle of arousal dripping from it and your pussy [else]Your pussy clenches around the intruding appendage, a steady trickle of arousal dripping from it [end if]to fall into the musky fur of Altus's scrotum. The symbolism isn't lost on you, but you have more pressing matters to attend to. Supporting yourself against his chest, you ride the gryphon, a loud slap being sent forth each time he bottoms out and a lewd slurping noise accompanying his withdrawal, a thin layer of lubricating pre visible on his cock. Joining this symphony are the gyr-wolf hybrid's warbles and squawks, as well as your own grunts and moans as you spear yourself over and over on the tapered penis. The thought of how Altus will be tied to you as he climaxes, unable to escape until you are sated, sends another wave of heat through your body and you redouble your efforts.";
			say "     Grabbing his forelegs, you push them down and lean forward until your mouth is just inches from the gryphon's neck, Altus regarding you with a mixture of curiosity and submission as you continue to ride him, rolling your hips when he is fully inside of you. Confident that he can hear you, you whisper about what a good boy he is, now that he's got over his pride. After he manages to get you off and feels your vagina clenching around his cock, he will be able to fill you with his seed. But he has to earn it. To show you the power of the beast that you have at your mercy. Fire enters Altus's eyes and you lean back again as the gryphon begins to thrust up into you, lifting his hips off the floor to impale you as deep as he can go. The flow of juices from your pussy quickens each time his knot batters your vulva, and you feel his balls thud against your buttocks, full of the virile fluid that will soon be flooding your womb.";
			WaitLineBreak;
			say "     The excitement and primal passion of it all sends you hurtling towards climax, though given the frenzied pace of your fucking, who would be surprised? Tilting your head back, you release a long exultant moan as the euphoric numbness spreads through your loins and orgasm finally overcomes you. Gasping, you clutch Altus by his knees as your vagina contracts around his shaft[if Player is Herm] and you send generous strand after strand of your seed to splatter down over the gryphon's chest and face, taking perverse pleasure as some lands in his mouth and outstretched tongue[else], heightening his pleasure and stimulating him to inseminate you[end if]. His duty to you fulfilled, Altus rams his knot through to be locked within your pussy before following you into ecstatic rapture moments later. A deluge of cum floods your womb, causing you to gulp as the pressure in your gut suddenly increases. With the knot in sealing you up, this feeling only grows as time goes by and making you feel contentedly filled.";
			say "     As the two of you recover from your passionate mating, Altus's behavior gradually reverts back towards his usual aloof demeanor. Where he was initially fawning over you in appreciation for sating him, his affection slowly becomes more measured; a graceful attempt to groom you rather than rubbing his face against your body. Were you not sure that it would insult him to do so, you would laugh at this transition from slutty bird, to regal falcon, though the image is slightly spoilt by the [if Player is Herm]strands of cum clinging to his fur and face[else]vulnerable position that he is in[end if]. His pride won't let him seem ungrateful, but equally, it won't permit too blatant a display of affection either, leaving him to traverse the territory between. After his cock softens and slips from your vulva, the gryphon briefly rests his head on your shoulder, warbles, then steps away to preen and clean himself, leaving the mess to soak into the carpet, and for you to get your own affairs in order.";
			NPCSexAftermath Player receives "PussyFuck" from Altus;
		else: [Anal Penetration]
			say "     You [if Player is Submissive]tell [else]command [end if]Altus to roll over, the gryphon indignantly flapping his wings in a manner that suggests that the appendages will get in the way. Unimpressed, you remind him that you know that he is capable of it and that if he really wants to be left blue-balled rather than get to sink his cock into your ass, then that's fine with you. The choice is his, but your patience is running thin. Altus tilts his head in thought before slumping on his side and carefully rolling over, his wings tightly pressed to his body. Clicking your tongue, you warn him that next time you might not be so accommodating to his resistance before [if player is not naked]stripping and [end if]clambering atop him, nestling his slick shaft between your buttocks. With how much pre streaming down the sides, you are confident that you'll be able to penetrate yourself on it without much difficulty.";
			say "     Comfortably seated, you reach a hand back, wrapping your fingers around the hot flesh of his cock and rubbing it up and down, feeling the fresh spurts of pre against your back as your touch excites him. You wonder if you'll be able to feel this when he is inside you, before deciding that you'll probably be too focused on other things to care. After briefly darting your hand down to caress his churning balls, you lift your rump up until the pointed tip of his penis catches in the dip of your anus before slowly lowering yourself down again, relishing the feel of your sphincter spreading and your anus being filled. Altus coos blissfully, his tail thumping against the floor though he otherwise remains still, accepting your control of the pace. You praise him as you continue to sink down until [if Asshole Depth of Player > 11 or Player is twistcapped]only his knot remains outside[else]no more of his flesh-spire can fit inside[end if], blowing air between your lips as you appreciate the length and girth of your partner.";
			WaitLineBreak;
			say "     Savoring the sensation, you hold like this for half a minute, swaying slightly and clenching around the gryphon's penis, taking the time to feel the spurts of pre prepare your bowels for the breeding ahead of you. [if Player is Herm]Your own cock bobs with each movement, a steady trickle of arousal dripping from it and your pussy [else]Your pussy clenches in synchrony, a steady trickle of arousal dripping from it [end if]to fall into the musky fur of Altus's scrotum. The symbolism isn't lost on you, but you have more pressing matters to attend to. Supporting yourself against his chest, you ride the gryphon, a loud slap being sent forth each time he bottoms out and a lewd slurping noise accompanying his withdrawal, a thin layer of lubricating pre visible on his cock. Joining this symphony are the gyr-wolf hybrid's warbles and squawks, as well as your own grunts and moans as you spear yourself over and over on the tapered penis. The thought of how Altus will be tied to you as he climaxes, unable to escape until you are sated, sends another wave of heat through your body and you redouble your efforts.";
			say "     Grabbing his forelegs, you push them down and lean forward until your mouth is just inches from the gryphon's neck, Altus regarding you with a mixture of curiosity and submission as you continue to ride him, rolling your hips when he is fully inside of you. Confident that he can hear you, you whisper about what a good boy he is, now that he's got over his pride. After he manages to get you off, making your vagina clench around the emptiness that he could have occupied, he will be able to fill you with his seed. But he has to earn it. To show you the power of the beast that you have at your mercy. Fire enters Altus's eyes and you lean back again as the gryphon begins to thrust up into you, lifting his hips off the floor to impale you as deep as he can go. The flow of juices from your pussy quickens each time his knot batters your sphincter, and you feel his balls thud against your buttocks, full of the virile fluid that will soon be flooding your bowels.";
			WaitLineBreak;
			say "     The excitement and primal passion of it all sends you hurtling towards climax, though given the frenzied pace of your fucking, who would be surprised? Tilting your head back, you release a long exultant moan as the euphoric numbness spreads through your loins and orgasm finally overcomes you. Gasping, you clutch Altus by his knees as you send [if Player is Herm]generous strand after strand of your seed to splatter down[else]a generous splash of fem-cum[end if] over the gryphon's chest and face, taking perverse pleasure as some lands in his mouth and outstretched tongue. His duty to you fulfilled, Altus rams his knot through to be locked within your anus before following you into ecstatic rapture moments later. A deluge of cum floods your bowels, causing you to gulp as the pressure in your gut suddenly increases. With the knot in sealing you up, this feeling only grows as time goes by and making you feel contentedly filled.";
			say "     As the two of you recover from your passionate mating, Altus's behavior gradually reverts back towards his usual aloof demeanor. Where he was initially fawning over you in appreciation for sating him, his affection slowly becomes more measured; a graceful attempt to groom you rather than rubbing his face against your body. Were you not sure that it would insult him to do so, you would laugh at this transition from slutty bird, to regal falcon, though the image is slightly spoilt by the [if Player is Herm]strands of cum clinging to his [else]damp sheen on his [end if]fur and face. His pride won't let him seem ungrateful, but equally, it won't permit too blatant a display of affection either, leaving him to traverse the territory between. After his cock softens and slips from your anus, the gryphon briefly rests his head on your shoulder, warbles, then steps away to preen and clean himself, leaving the mess to soak into the carpet, and for you to get your own affairs in order.";
			NPCSexAftermath Player receives "AssFuck" from Altus;
	else:
		say "     You [if Player is Submissive]tell [else]command [end if]Altus to roll over, the gryphon indignantly flapping his wings in a manner that suggests that the appendages will get in the way. Unimpressed, you remind him that you know that he is capable of it and that if he really wants to be left blue-balled rather than get to sink his cock into your ass, then that's fine with you. The choice is his, but your patience is running thin. Altus tilts his head in thought before slumping on his side and carefully rolling over, his wings tightly pressed to his body. Clicking your tongue, you warn him that next time you might not be so accommodating to his resistance before [if player is not naked]stripping and [end if]clambering atop him, nestling his slick shaft between your buttocks. With how much pre streaming down the sides, you are confident that you'll be able to penetrate yourself on it without much difficulty.";
		say "     Comfortably seated, you reach a hand back, wrapping your fingers around the hot flesh of his cock and rubbing it up and down, feeling the fresh spurts of pre against your back as your touch excites him. You wonder if you'll be able to feel this when he is inside you, before deciding that you'll probably be too focused on other things to care. After briefly darting your hand down to caress his churning balls, you lift your rump up until the pointed tip of his penis catches in the dip of your anus before slowly lowering yourself down again, relishing the feel of your sphincter spreading and your anus being filled. Altus coos blissfully, his tail thumping against the floor though he otherwise remains still, accepting your control of the pace. You praise him as you continue to sink down until [if Asshole Depth of Player > 11 or Player is twistcapped]only his knot remains outside[else]no more of his flesh-spire can fit inside[end if], blowing air between your lips as you appreciate the length and girth of your partner.";
		WaitLineBreak;
		if Player is Male: [Anal Penetration]
			say "     Savoring the sensation, you hold like this for half a minute, swaying slightly and clenching around the gryphon's penis, taking the time to feel the spurts of pre prepare your bowels for the breeding ahead of you. Your own cock bobs with each movement, a steady trickle of arousal dripping from the end to fall into the musky fur of Altus's scrotum. The symbolism isn't lost on you, but you have more pressing matters to attend to. Supporting yourself against his chest, you ride the gryphon, a loud slap being sent forth each time he bottoms out and a lewd slurping noise accompanying his withdrawal, a thin layer of lubricating pre visible on his cock. Joining this symphony are the gyr-wolf hybrid's warbles and squawks, as well as your own grunts and moans as you spear yourself over and over on the tapered penis. The thought of how Altus will be tied to you as he climaxes, unable to escape until you are sated, sends another wave of heat through your body and you redouble your efforts.";
			say "     Grabbing his forelegs, you push them down and lean forward until your mouth is just inches from the gryphon's neck, Altus regarding you with a mixture of curiosity and submission as you continue to ride him, rolling your hips when he is fully inside of you. Confident that he can hear you, you whisper about what a good boy he is, now that he's got over his pride. After he manages to get you off, spraying your cum all over him to leave your mark, he will be able to fill you with his seed. But he has to earn it by fucking it out of you. To show you the power of the beast that you have at your mercy. Fire enters Altus's eyes and you lean back again as the gryphon begins to thrust up into you, lifting his hips off the floor to impale you as deep as he can go. Your cock jumps each time his knot batters your sphincter, and you feel his balls thud against your buttocks, full of the virile fluid that will soon be flooding your bowels.";
			WaitLineBreak;
			say "     The excitement and primal passion of it all sends you hurtling towards climax, though given the frenzied pace of your fucking, who would be surprised? Tilting your head back, you release a long exultant moan as the euphoric numbness spreads through your loins and orgasm finally overcomes you. Gasping, you clutch Altus by his knees as you send generous strand after strand of your seed to splatter down over the gryphon's chest and face, taking perverse pleasure as some lands in his mouth and outstretched tongue. His duty to you fulfilled, Altus rams his knot through to be locked within your anus before following you into ecstatic rapture moments later. A deluge of cum floods your bowels, causing you to gulp as the pressure in your gut suddenly increases. With the knot in sealing you up, this feeling only grows as time goes by and making you feel contentedly filled.";
			say "     As the two of you recover from your passionate mating, Altus's behavior gradually reverts back towards his usual aloof demeanor. Where he was initially fawning over you in appreciation for sating him, his affection slowly becomes more measured; a graceful attempt to groom you rather than rubbing his face against your body. Were you not sure that it would insult him to do so, you would laugh at this transition from slutty bird, to regal falcon, though the image is slightly spoiled by the strands of cum clinging to his fur and face. His pride won't let him seem ungrateful, but equally, it won't permit too blatant a display of affection either, leaving him to traverse the territory between. After his cock softens and slips from your anus, the gryphon briefly rests his head on your shoulder, warbles, then steps away to preen and clean himself, leaving the mess to soak into the carpet, and for you to get your own affairs in order.";
		else: [Neuter. Anal Penetration]
			say "     Savoring the sensation, you hold like this for half a minute, swaying slightly and clenching around the gryphon's penis, taking the time to feel the spurts of pre prepare your bowels for the breeding ahead of you. With no genitals of your own, you are able to focus on this, feeling the impact, the trickle, and the way that it drips from your hole. Supporting yourself against his chest, you ride the gryphon, a loud slap being sent forth each time he bottoms out and a lewd slurping noise accompanying his withdrawal, a thin layer of lubricating pre visible on his cock. Joining this symphony are the gyr-wolf hybrid's warbles and squawks, as well as your own grunts and moans as you spear yourself over and over on the tapered penis. The thought of how Altus will be tied to you as he climaxes, unable to escape until you are sated, sends another wave of heat through your body and you redouble your efforts.";
			say "     Grabbing his forelegs, you push them down and lean forward until your mouth is just inches from the gryphon's neck, Altus regarding you with a mixture of curiosity and submission as you continue to ride him, rolling your hips when he is fully inside of you. Confident that he can hear you, you whisper about what a good boy he is, now that he's got over his pride. After he manages to get you off, he will be able to fill you with his seed. But he has to earn it. To show you the power of the beast that you have at your mercy. Fire enters Altus's eyes and you lean back again as the gryphon begins to thrust up into you, lifting his hips off the floor to impale you as deep as he can go. Each time his knot batters your sphincter you feel his balls thud against your buttocks, full of the virile fluid that will soon be flooding your bowels.";
			WaitLineBreak;
			say "     The excitement and primal passion of it all sends you hurtling towards climax, though given the frenzied pace of your fucking, who would be surprised? Tilting your head back, you release a long exultant moan as the euphoric numbness spreads through your loins and orgasm finally overcomes you. Gasping, you clutch Altus by his knees as you seize and shudder, your whole body feeling the intensity of the orgasm. His duty to you fulfilled, Altus rams his knot through to be locked within your anus before following you into ecstatic rapture moments later. A deluge of cum floods your bowels, causing you to gulp as the pressure in your gut suddenly increases. With the knot in sealing you up, this feeling only grows as time goes by and making you feel contentedly filled.";
			say "     As the two of you recover from your passionate mating, Altus's behavior gradually reverts back towards his usual aloof demeanor. Where he was initially fawning over you in appreciation for sating him, his affection slowly becomes more measured; a graceful attempt to groom you rather than rubbing his face against your body. Were you not sure that it would insult him to do so, you would laugh at this transition from slutty bird, to regal falcon. His pride won't let him seem ungrateful, but equally, it won't permit too blatant a display of affection either, leaving him to traverse the territory between. After his cock softens and slips from your anus, the gryphon briefly rests his head on your shoulder, warbles, then steps away to preen and clean himself, leaving the mess to soak into the carpet, and for you to get your own affairs in order.";
		NPCSexAftermath Player receives "AssFuck" from Altus;
	now Lust of Altus is 0;
	move Player to Garden View;


Section 3 - Events

Table of GameEventIDs (continued)
Object	Name
Difficult Quarry	"Difficult Quarry"

Difficult Quarry is a situation.
ResolveFunction of Difficult Quarry is "[ResolveEvent Difficult Quarry]".
The level of Difficult Quarry is 10.
Sarea of Difficult Quarry is "Museum".
when play begins:
	add Difficult Quarry to BadSpots of MaleList;
	add Difficult Quarry to BadSpots of FemaleList;
	add Difficult Quarry to BadSpots of FurryList;

to say ResolveEvent Difficult Quarry:
	say "     The sound of whooping shouts, squawks, and yelling draws your attention and, out of curiosity, you hastily make your way down a corridor towards them, making sure to avoid attracting attention to yourself as you do so. You soon enter a spacious room with stairs leading up to a higher floor, but it is anything but empty, numerous primitive cavemen can be seen arrayed around the perimeter. Despite this, your caution seems unnecessary as their attention is fixed inwards where they are watching a small group of near-naked muscular men attempt to overpower an interesting-looking gryphon. Instead of the typical leonine body that one might expect, it has the back-half of a wolf, and instead of the head of an eagle, it's front-half is more like a gyrfalcon, though it doesn't seem any smaller, especially as it is fiercely lashing out at the humans. Though its claws occasionally slash a bicep, the cavemen usually manage to leap back at just the right time, giving the nanites a chance to heal what could otherwise be a serious wound and rousing a cheer from the onlookers.";
	say "     They seem to be treating it more as a sport than genuine hunting, merely ensuring that the gryphon doesn't get the chance to unfold its majestic wings and escape them. You doubt that it will be long until it tires and falls victim to the superior numbers of the primitive humans. It just goes to show the power of perseverance and teamwork that allowed early humans to thrive against much more physically powerful creatures, though you don't remember mention of gryphons from any school lessons. Frustrated and surrounded, the gryphon is becoming increasingly desperate, spinning around and shrieking angrily, much to the amusement of its adversaries. If you're going to do anything to help it, you're going to have to do so soon.";
	say "     [bold type]Do you wish to intervene to save the gryphon?[roman type][line break]";
	let Altus_Rescue_Choices be a list of text;
	add "Yes. The cavemen aren't playing fair." to Altus_Rescue_Choices;
	add "No. It will undoubtedly be dangerous to get involved." to Altus_Rescue_Choices;
	let Altus_Rescue_Choice be what the player chooses from Altus_Rescue_Choices;
	if Altus_Rescue_Choice is:
		-- "Yes. The cavemen aren't playing fair.":
			LineBreak;
			say "     Readying yourself, you set your jaw before stepping out of the shadows, shouting to catch the attention of the spectators. Unfortunately, as you do so, a crude net is thrown over the gryphon, tangling in its talons and wings, ending the fight and meaning that the entirety of the focus turns to you, sharp sticks and stones being brandished threateningly as they prepare to attack you en masse. 'Stop,' a voice booms out. 'Let [ObjectPro of Player] approach.' The crowd parts to reveal a very muscular and scarred woman, seemingly their leader, garbed in a leopard-skin, though it leaves [if FemaleList is Warded]much visible to the eye[else]her labia and one breast exposed[end if]. Fiery-red hair hangs freely, if rather messily, to her shoulders braided with teeth and bone. 'Who are you who so brazenly interfere with our hunt?' she addresses you as you cautiously walk towards her. You guardedly explain that you wished to saved the gryphon, or at least make it a fair fight, your response making her laugh, an action that those around join in on.";
			say "     'How courageous of you! But there is little value for nobility when you are on the hunt. You do what you must, or you starve.' Frowning, you ask whether they plan on eating the mythical creature, your question causing her to falter. 'No. But other hungers must be sated too,' she quickly replies. By now one of the hunters that fought with the gryphon is able to reach her side, glancing you up and down before snorting. '[SubjectProCap of Player] doesn't look so tough. High ideals, but without the muscles to back them up. I could take [ObjectPro of Player] alone,' he comments. ";
			if Level of Player > 30:
				say "'Really Nanoc? Look again. Even the entire tribe together might not be able to overcome [ObjectPro of Player]. Whether [SubjectPro of Player] has been blessed by the Earth Mother or serves the Destroyer, we would be wise to avoid fighting [ObjectPro of Player]. No. We give [ObjectPro of Player] the beast and find new quarry,' the woman rebuffs the hunter. Though he grumbles, he doesn't dispute her order.";
				say "     'Well, this is where we part, stranger,' the leader first addresses you before announcing to her tribe, 'Let us return home and prepare for the next hunt!' As humans begin to file from the room, the woman turns back to you. 'You are a powerful one. I wonder whether you would have been able to force me into submission had combat been necessary. Perhaps we will meet again...' She and Nanoc are the last to depart, leaving you to face the gryphon alone as it finally tears its way free from the net.";
				WaitLineBreak;
				say "     It regards you cautiously, seemingly capable of comprehending that you just saved it, but nonetheless remaining wary in case you have your own cruel plans for it. When you move, it spreads its wings at you in an intimidating manner, the rich, mottled gray and white feathers remaining elegant despite the chafing of the net. It relaxes a little when you show it your empty hands, folding its wings before slowly approaching you with its eyes firmly fixed on you in case you make any sudden movements. When it is only a couple of feet away, it halts and looks you in the eye and, after a moment, almost seems to bow. Now that the gryphon is closer, you can clearly see that it is male, sheath and scrotum swaying slightly beneath him. When you reach a hand out, it remains still, allowing you to feel its soft feathers against your your fingers as you trail them down its head to where it transitions into the body of a wolf, the fur a little more coarse, but still yielding to the touch.";
				say "     He merely chirps when you ask if he is alright after his ordeal, and you have to stifle a laugh at such an amiable response from what by all appearances is an apex predator. He certainly seems to have warmed up to you quickly, his gratitude for being saved having overcome his initial wariness. He presses his head into your hand as you pet him, carefully making sure that his sharp beak stays away from your comparatively soft flesh. In the spur of the moment, you ask whether he would be interested in coming with you back to the library. He'll be safe from hunting parties there after all, and it will allow him to stretch his wings more than being in the museum. Tilting his head thoughtfully, the gryphon eventually squawks and bumps up against your shoulder. You'll take that as an affirmative, your analysis being confirmed when he follows you back through the corridors and out into the open air of the city.";
				WaitLineBreak;
				say "     Seeing his chance, the gryphon spreads his wings and takes to the air, worrying you for a moment that he is abandoning you. But as he continues to glide and swoop above you, you come to the conclusion that he merely wanted to make the most of the space. As a side-effect, it gives you an excellent view of his junk each time he soars over you. Smiling as you shake your head, you signal for him to follow you as you begin to pick your way through the city, the looming shadow above you discouraging any attacks until you eventually get back to the library. With a gesture, you indicate that you have reached your destination and the gryphon comes in to land gracefully behind you, lifting his chin proudly as you compliment his aerial skill. As you approach the door, you curiously ask whether he has a name, raising an eyebrow when he shakes his head. You'll have to come up with something then, assuming he allows it.";
				say "     He follows you inside, looking around with interest as you make your way towards the stairs, perhaps appreciating how spacious it is as well as the lack of bloodthirsty (or cock-hungry) humans. Though you intend to give him the option of settling into the upstairs room with a view of the garden, he seems like he may spend time in the wider library too. Reaching the second floor, you suggest the name Altus, the theme of height and his ability to fly heavily on your mind, receiving a gentle bump of approval. ";
				if Denise is collected:
					say "You are greeted by Denise as you enter the intended room, the blue gryphoness seemingly impressed by the new arrival's bearing, though she remains a little shy. When you introduce the two of them to each other and explain a little of how you encountered Altus, she seems more at ease. 'That sounds rough. I hope that I can converse with you somehow. Perhaps I'll pick up on what you want over time. We're both gryphons after all.' Dipping his head to you one more time, Altus trots over to Denise's makeshift nest, the blue gryphoness already making him feel at home and explaining more about life in the library. Pleased with yourself, you turn and decide what to do next.";
				else:
					say "Entering the intended room, you explain to Altus a little about what you expect of him should he remain here, but encourage him to settle in. Dipping his head to you one more time, Altus trots over to the window, establishing that he shouldn't have too much difficulty taking flight from here should he want to explore the surrounding area. Pleased with yourself, you turn and decide what to do next.";
				now HP of Altus is 1;
				move Altus to Garden View;
				move player to Garden View;
				now Resolution of Difficult Quarry is 1; [Powerful enough to save Altus without a fight]
			else:
				say "'Perhaps. Bold words and we shall see you back them up. You shall fight this stranger alone. If you defeat them, you may have first coupling with the gryphon and I will permit you the chance to challenge me to fair combat. But should they defeat you, they shall take the beast with them and you shall remain wanting,' the woman declares. Immediately, several nearby hunters begin to protest the chance to lose their quarry, but a sharp glare from their leader makes them still their tongues. Wordlessly, the hunter turns to you and drops into a ready-stance, a ring of people forming around you as they prepare for the two of you to decide the fate of the gryphon.";
				now inasituation is true;
				challenge "Homo Sapiens";
				now inasituation is false;
				if fightoutcome < 20: [player won]
					if fightoutcome is 11: [Libido victory]
						say "     With an anguished gasp, the hunter orgasms, splattering the ground with his wasted seed. Many of the surrounding cavemen laugh, mocking him for his shame. The leader merely looks at you thoughtfully. 'I yield. You must be a trickster god in disguise,' your opponent concedes, carefully avoiding meeting anyone's eye. 'It would seem that we have a victor, though through unconventional means,' the muscular woman announces. 'Do not think ill of Nanoc for his defeat, for who among you would be bold enough to believe that they could have achieved victory over such an opponent?' The crowd falls silent, none willing to make such a claim. 'Then by the terms of our agreement, the stranger is allowed to leave with the beast. Let us return home and prepare for the next hunt!' As humans begin to file from the room, the woman turns to you. 'You are an interesting one. I wonder whether I too would have succumbed to my lust against you. Perhaps we will meet again...' She and Nanoc are the last to depart, leaving you to face the gryphon alone as it finally tears its way free from the net.";
						now Resolution of Difficult Quarry is 2; [Defeated the hunter through strength of arm]
					else: [Physical victory]
						say "     'Enough! Earth Mother, enough...' the hunter pants, slumping to the ground. Many of the surrounding cavemen watch on in shock as they witness presumably their best hunter be bested. The leader looks on with admiration as you stand over her champion. 'I yield. Whether you are blessed by the Earth Mother or the Destroyer, I am bested,' your opponent concedes, kneeling before you. 'It would seem that we have a victor,' the muscular woman announces. 'Do not think ill of Nanoc for his defeat, for who among you would be bold enough to believe that they could have achieved victory over such an opponent?' Having witnessed your prowess, the crowd nods agreement. 'Then by the terms of our agreement, the stranger is allowed to leave with the beast. Let us return home and prepare for the next hunt!' As humans begin to file from the room, the woman turns to you. 'You are a powerful one. I wonder whether you would have been able to force me into submission. Perhaps we will meet again...' She and Nanoc are the last to depart, leaving you to face the gryphon alone as it finally tears its way free from the net.";
						now Resolution of Difficult Quarry is 3; [Defeated the hunter through seduction]
					WaitLineBreak;
					say "     It regards you cautiously, seemingly capable of comprehending that you just saved it, but nonetheless remaining wary in case you have your own cruel plans for it. When you move, it spreads its wings at you in an intimidating manner, the rich, mottled gray and white feathers remaining elegant despite the chafing of the net. It relaxes a little when you show it your empty hands, folding its wings before slowly approaching you with its eyes firmly fixed on you in case you make any sudden movements. When it is only a couple of feet away, it halts and looks you in the eye and, after a moment, almost seems to bow. Now that the gryphon is closer, you can clearly see that it is male, sheath and scrotum swaying slightly beneath him. When you reach a hand out, it remains still, allowing you to feel its soft feathers against your your fingers as you trail them down its head to where it transitions into the body of a wolf, the fur a little more coarse, but still yielding to the touch.";
					say "     He merely chirps when you ask if he is alright after his ordeal, and you have to stifle a laugh at such an amiable response from what by all appearances is an apex predator. He certainly seems to have warmed up to you quickly, his gratitude for being saved having overcome his initial wariness. He presses his head into your hand as you pet him, carefully making sure that his sharp beak stays away from your comparatively soft flesh. In the spur of the moment, you ask whether he would be interested in coming with you back to the library. He'll be safe from hunting parties there after all, and it will allow him to stretch his wings more than being in the museum. Tilting his head thoughtfully, the gryphon eventually squawks and bumps up against your shoulder. You'll take that as an affirmative, your analysis being confirmed when he follows you back through the corridors and out into the open air of the city.";
					WaitLineBreak;
					say "     Seeing his chance, the gryphon spreads his wings and takes to the air, worrying you for a moment that he is abandoning you. But as he continues to glide and swoop above you, you come to the conclusion that he merely wanted to make the most of the space. As a side-effect, it gives you an excellent view of his junk each time he soars over you. Smiling as you shake your head, you signal for him to follow you as you begin to pick your way through the city, the looming shadow above you discouraging any attacks until you eventually get back to the library. With a gesture, you indicate that you have reached your destination and the gryphon comes in to land gracefully behind you, lifting his chin proudly as you compliment his aerial skill. As you approach the door, you curiously ask whether he has a name, raising an eyebrow when he shakes his head. You'll have to come up with something then, assuming he allows it.";
					say "     He follows you inside, looking around with interest as you make your way towards the stairs, perhaps appreciating how spacious it is as well as the lack of bloodthirsty (or cock-hungry) humans. Though you intend to give him the option of settling into the upstairs room with a view of the garden, he seems like he may spend time in the wider library too. Reaching the second floor, you suggest the name Altus, the theme of height and his ability to fly heavily on your mind, receiving a gentle bump of approval. ";
					if Denise is collected:
						say "You are greeted by Denise as you enter the intended room, the blue gryphoness seemingly impressed by the new arrival's bearing, though she remains a little shy. When you introduce the two of them to each other and explain a little of how you encountered Altus, she seems more at ease. 'That sounds rough. I hope that I can converse with you somehow. Perhaps I'll pick up on what you want over time. We're both gryphons after all.' Dipping his head to you one more time, Altus trots over to Denise's makeshift nest, the blue gryphoness already making him feel at home and explaining more about life in the library. Pleased with yourself, you turn and decide what to do next.";
					else:
						say "Entering the intended room, you explain to Altus a little about what you expect of him should he remain here, but encourage him to settle in. Dipping his head to you one more time, Altus trots over to the window, establishing that he shouldn't have too much difficulty taking flight from here should he want to explore the surrounding area. Pleased with yourself, you turn and decide what to do next.";
					now HP of Altus is 1;
					move Altus to Garden View;
					move player to Garden View;
				else if fightoutcome > 19 and fightoutcome < 30: [lost]
					say "     Unwilling to fight any more, you sink to your knees and signal your surrender. 'You put up a decent fight, but I was stronger. Know that there is no shame in having lost to Nanoc!' the hunter boasts as he helps you to your feet again. 'Indeed. Perhaps one day your body will be as unyielding as your will,' the leader agrees. 'Nonetheless, you were defeated and the beast is ours. Perhaps it will thank you for your attempt should we decide to release it, but I doubt it. Animals care less about intention than results. You shall be allowed to leave unharmed and Nanoc shall get his chance to fight me when we get back to our village. Farewell stranger,' the woman declares. Disappointed that you failed to save the gryphon, you stand there with your head lowered as the hunting party hauls the gryphon away, a few of them offering you some consoling words. When they are all gone, you trudge back to the museum entrance.";
					now Resolution of Difficult Quarry is 4; [Lost fair and square to the hunter]
				else if fightoutcome is 30: [fled]
					say "     Realizing that you are outmatched, you attempt to flee, but fail to notice the fist in time to prevent it smashing into your face and sending you tumbling to the ground. 'Pathetic. To think that you would try to run,' the leader addresses you with contempt, massaging her fist that just laid you out. 'Perhaps it is you that should be our pleasure-slave. What do you think, Nanoc?' The hunter shakes his head and spits beside your head. 'Not enough spirit. The beast fought until the end, but [SubjectPro of Player] showed [ReflexPro of Player] to be a coward. It doesn't even feel like a victory, so I'll have to wait to earn the chance to fight you,' he replies. Ashamed and dizzy, you curl into a ball while you recover, listening as the hunting party hurls insults towards you and drags the gryphon away. When you are sure that they are gone, you clamber to your feet and skulk away back to the entrance of the museum.";
					now Resolution of Difficult Quarry is 5; [Attempted to flee]
		-- "No. It will undoubtedly be dangerous to get involved.":
			LineBreak;
			say "     Despite any sympathy that you might have for the gryphon, you turn your back and walk back down the corridor. They may say that discretion is the better part of valor, you don't feel very noble as the creatures shrieks fade into the distance, a victim of the relentless nature of humanity and likely to become a sex toy to the tribe.";
			now Resolution of Difficult Quarry is 6; [Abandoned Altus to his fate]
	now Difficult Quarry is resolved;


Altus ends here.
