Version 5 of J'Reth by Prometheus begins here.
[ Commission for Heth Drakiel                             ]
[ Version 1 - Initial Release                             ]
[ Version 2 - Talk Menu Added                             ]
[ Version 3 - Sex Menu Added                              ]
[ Version 4 - Gendershifting Added                        ]
[ Version 4.1 - Sex Scenes for Gendershifted J'Reth Added ]
[ Version 5 - Backpack Questline added                    ]


[ HP of J'Reth                                          ]
[ 0 - Unmet                                             ]
[ 1 - Met in Storeroom                                  ]
[ 2 - Asked for Peaches                                 ]
[ 3 - Given peaches, Available for sex                  ]
[ 4 - Talked to J'Reth about the Draco-Mantis Infection ]
[ 5 - Agreed to gender-shifting                         ]

[ hunger of J'Reth                                      ]
[ 0 - Not discussed gender shifting                     ]
[ 1 - Agreed to gendershift using pills                 ]
[ 2 - Agreed to gendershift using bodily fluids         ]

[ thirst of J'Reth                                      ]
[ 0 - Done no gendershifting                            ]
[ 1 - J'Reth is Male                                    ]
[ 2 - J'Reth is Herm                                    ]
[ 3 - J'Reth is Female                                  ]

[ Charisma of J'Reth                                    ]
[ 0 -                                                   ]
[ 1 - Have been asked to find backpack                  ]
[ 2 - Returned Backpack                                 ]

J'Reth_MVialsOwned is a number that varies.[@Tag:NotSaved]
J'Reth_FVialsOwned is a number that varies.[@Tag:NotSaved]
J'Reth_HVialsOwned is a number that varies.[@Tag:NotSaved]
J'Reth_VialName is a text that varies.[@Tag:NotSaved]
J'Reth_VialName is usually "Draco-Mantis Male".

a postimport rule: [bugfixing rules for players that import savegames]
	if Invitation to Storeroom is resolved:
		change the Northwest exit of Mall West Wing to J'Reth's Room; [connecting the location to the travel room]
		change the Southeast exit of J'Reth's Room to Mall West Wing; [connecting the location to the travel room]

to Count_J'RethVials:
	now J'Reth_MVialsOwned is 0;
	now J'Reth_HVialsOwned is 0;
	now J'Reth_FVialsOwned is 0;
	repeat with z running through vials of Player:
		if z is "Draco-Mantis Male":
			increase J'Reth_MVialsOwned by 1;
		else if z is "Draco-Mantis Herm":
			increase J'Reth_HVialsOwned by 1;
		else if z is "Draco-Mantis Female":
			increase J'Reth_FVialsOwned by 1;

Section 1 - Room Declaration

Table of GameRoomIDs (continued)
Object	Name
J'Reth's Room	"J'Reth's Room"

J'Reth's Room is a room.
Description of J'Reth's Room is "[J'RethsRoomDesc]".

to say J'RethsRoomDesc:
	say "     While J'Reth seems to be living in a storage closet at the back of a gaming store that is now filled with sleeping bags and mattresses, it is large enough for a bed, a desk, and several rows of shelves. The shelves are covered in tabletop models such as trolls, dragons, and wolves, rulebooks for assorted games, and small pots of paint. Considering what you know about J'Reth, the room seems to suit [ObjectPro of J'Reth] very well. On the desk pushed into the corner against the wall is a computer but it doesn't appear to be plugged in so you doubt that the draco-mantis has used it recently. The walls are covered in promotional posters for various movies and games, colorful pins holding them in place.";

Section 2 - NPC

Table of GameCharacterIDs (continued)
object	name
J'Reth	"J'Reth"

J'Reth is a person.
ScaleValue of J'Reth is 3. [human sized]
Body Weight of J'Reth is 4. [scale of 1-9 for body weight, grouped into low weight (1-3), mid weight (4-6) and high weight (7-9)]
Body Definition of J'Reth is 4. [scale of 1-9 for body definition, grouped into low muscle (1-3), mid muscle (4-6), high muscle (7-9)]
[Body Adjective is generated out of the body weight and body definition and can be used in scenes - one word descriptive adjective depending on weight and definition groups: low weight group: skinny/slender/lithe; mid weight group: average/fit/muscled; high weight group: pudgy/husky/jacked]
Androginity of J'Reth is 4. [Gender Adjective is generated out of androginity 1-9: hypermasculine/masculine/somewhat effeminate/effeminate/androgynous/feminine butch/tomboyish/feminine/hyperfeminine]
Mouth Length of J'Reth is 6. [inches deep for face fucking; maximum possible will be double this number (when deep throating)]
Mouth Circumference of J'Reth is 3. [mouth circumference 1-5, "tiny, small, normal, wide, gaping"]
Tongue Length of J'Reth is 12. [length in inches]
Breast Size of J'Reth is 0. [cup size as number, counting Flat Pecs = 0, A = 1, B = 2, ...]
Nipple Count of J'Reth is 0. [count of nipples]
Asshole Depth of J'Reth is 8. [inches deep for anal fucking]
Asshole Tightness of J'Reth is 1. [asshole tightness 1-5, "extremely tight, tight, receptive, open, gaping"]
Cock Count of J'Reth is 1. [number of cocks]
Cock Girth of J'Reth is 2. [thickness 1-5, thin/slender/average/thick/monstrous]
Cock Length of J'Reth is 11. [length in inches]
Ball Count of J'Reth is 2. [allowed numbers: 1 (uniball), 2 or 4]
Ball Size of J'Reth is 3. [size of balls 1-7: "acorn-sized", "dove egg-sized", "chicken egg-sized" "goose-egg sized", "ostrich-egg sized", "basketball-sized", "beachball-sized"]
Cunt Count of J'Reth is 0. [number of cunts]
Cunt Depth of J'Reth is 0. [penetratable length in inches; some minor stretching allowed, or more with Twisted Capacity]
Cunt Tightness of J'Reth is 0. [size 1-5, generates adjectives of extremely tight/tight/receptive/open/gaping]
Clit Size of J'Reth is 0. [size 1-5, very small/small/average/large/very large]
[Basic Interaction states as of game start]
PlayerMet of J'Reth is false.
PlayerRomanced of J'Reth is false.
PlayerFriended of J'Reth is false.
PlayerControlled of J'Reth is false.
PlayerFucked of J'Reth is false.
OralVirgin of J'Reth is true.
Virgin of J'Reth is true.
AnalVirgin of J'Reth is true.
PenileVirgin of J'Reth is true.
SexuallyExperienced of J'Reth is false.
TwistedCapacity of J'Reth is false. [Twisted Characters can take any penetration, no matter the size]
Sterile of J'Reth is true. [steriles can't knock people up]
MainInfection of J'Reth is "Draco-Mantis Male".
Description of J'Reth is "[J'RethDesc]".
Conversation of J'Reth is { "Mantis Dragon sounds." }.
The scent of J'Reth is "     J'Reth smells of Mantis-Dragons and fairies in the woods."

to say J'RethDesc:
	if debugactive is 1:
		say "DEBUG -> HP of J'Reth: [HP of J'Reth] <- DEBUG[line break]";
	say "     J'Reth is somewhat feminine but with some slight musculature to [PosAdj of J'Reth] frame. [PosAdjCap of J'Reth] body is covered in pale green scales all around with chitinous plates of a darker green around [PosAdj of J'Reth] chest, forearms, thighs, and shins. [SubjectProCap of J'Reth] has a pair of mantis wings folded against [PosAdj of J'Reth] back. Currently [SubjectPro of J'Reth] is wearing a t-shirt with the words '[One of]Roll for Initiative[or]Just Because I Play a Bard, Does Not Make Me Spoony[or]I Seduce the Dragon. Critical Success[or]Kastles & Kobolds[or]Backpackemon. Befriend Them All[or]This [italic type]Is [roman type ]My Clean Shirt. My Other One Has Soup On It[at random]' emblazoned across the front, and trousers.";

when play begins:
	SetMalePronouns for J'Reth;

Section 3 - Talking with J'Reth

Instead of conversing the J'Reth:
	say "     You indicate to J'Reth that you would like to talk to [ObjectPro of J'Reth] and [SubjectPro of J'Reth] puts down the [one of]poster [or]model [or]comic [at random]that [SubjectPro of J'Reth] was examining and devotes [PosAdj of J'Reth] attention to you.";
	WaitLineBreak;
	say "[J'RethTalkMenu]";

to say J'RethTalkMenu:
	Count_J'RethVials;
	say "[line break]";
	say "What do you wish to discuss with J'Reth?";
	now sextablerun is 0;
	blank out the whole of table of fucking options;
	[]
	choose a blank row in table of fucking options;
	now title entry is "Hobbies";
	now sortorder entry is 1;
	now description entry is "Try to learn more about what the draco-mantis enjoys doing";
	[]
	choose a blank row in table of fucking options;
	now title entry is "Before the Outbreak";
	now sortorder entry is 2;
	now description entry is "Ask what [SubjectPro of J'Reth] did before the nanite outbreak";
	[]
	choose a blank row in table of fucking options;
	now title entry is "Small Talk";
	now sortorder entry is 3;
	now description entry is "Make general small talk";
	[]
	if HP of J'Reth is 3:
		choose a blank row in table of fucking options;
		now title entry is "Discuss His Form";
		now sortorder entry is 4;
		now description entry is "Enquire about his draco-mantis form";
	[]
	if HP of J'Reth is 4 and (scenario is "Researcher" or nanite collector is equipped):
		choose a blank row in table of fucking options;
		now title entry is "Prepare for Gender Shifting";
		now sortorder entry is 5;
		now description entry is "Further discuss and prepare for gender shifting the draco-mantis";
	[]
	if HP of J'Reth > 4 and (scenario is "Researcher" or nanite collector is equipped) and ((thirst of J'Reth < 2 and J'Reth_MVialsOwned < 14) or (thirst of J'Reth is 2 and J'Reth_HVialsOwned < 14) or (thirst of J'Reth is 3 and J'Reth_FVialsOwned < 14)):
		choose a blank row in table of fucking options;
		now title entry is "Extract Vial of Draco-mantis Nanites";
		now sortorder entry is 6;
		now description entry is "Get a vial of draco-mantis nanites for personal use or as a backup in case gendershifting doesn't go as planned";
	[]
	if hunger of J'Reth > 0 and thirst of J'Reth < 3 and carried of Estrogen Pill > 0 and (scenario is "Researcher" or nanite collector is equipped) and ("Draco-Mantis Male" is listed in vials of player or "Draco-Mantis Female" is listed in vials of player or "Draco-Mantis Herm" is listed in feats of player):
		choose a blank row in table of fucking options;
		now title entry is "Give Estrogen Pill";
		now sortorder entry is 7;
		now description entry is "Give J'Reth an estrogen pill to gender-shift them towards being female";
	[]
	if hunger of J'Reth is 2 and thirst of J'Reth < 3 and carried of Glob of Goo > 0 and (scenario is "Researcher" or nanite collector is equipped) and ("Draco-Mantis Male" is listed in vials of player or "Draco-Mantis Female" is listed in vials of player or "Draco-Mantis Herm" is listed in feats of player):
		choose a blank row in table of fucking options;
		now title entry is "Give Glob of Goo";
		now sortorder entry is 8;
		now description entry is "Give J'Reth a glob of goo to gender-shift them  towards being female";
	[]
	if hunger of J'Reth > 0 and thirst of J'Reth > 1 and carried of Testosterone pill > 0 and (scenario is "Researcher" or nanite collector is equipped) and ("Draco-Mantis Male" is listed in vials of player or "Draco-Mantis Female" is listed in vials of player or "Draco-Mantis Herm" is listed in feats of player):
		choose a blank row in table of fucking options;
		now title entry is "Give Testosterone Pill";
		now sortorder entry is 9;
		now description entry is "Give J'Reth a testosterone pill to gender-shift them towards being male";
	[]
	if hunger of J'Reth is 2 and thirst of J'Reth > 1 and carried of Fennec Semen > 0 and (scenario is "Researcher" or nanite collector is equipped) and ("Draco-Mantis Male" is listed in vials of player or "Draco-Mantis Female" is listed in vials of player or "Draco-Mantis Herm" is listed in feats of player):
		choose a blank row in table of fucking options;
		now title entry is "Give Fennec Semen";
		now sortorder entry is 10;
		now description entry is "Give J'Reth some Fennec Semen to gender-shift them towards being male";
	[]
	if hunger of J'Reth > 0 and thirst of J'Reth is 1 or thirst of J'Reth is 3 and carried of Estosterogen pill > 0 and (scenario is "Researcher" or nanite collector is equipped) and ("Draco-Mantis Male" is listed in vials of player or "Draco-Mantis Female" is listed in vials of player or "Draco-Mantis Herm" is listed in feats of player):
		choose a blank row in table of fucking options;
		now title entry is "Give Estosterogen Pill";
		now sortorder entry is 11;
		now description entry is "Give J'Reth a Estosterogen pill to gender-shift them towards being a hermaphrodite";
	[]
	if hunger of J'Reth is 2 and thirst of J'Reth > 1 and carried of Gryphon Milk > 0 and (scenario is "Researcher" or nanite collector is equipped) and ("Draco-Mantis Male" is listed in vials of player or "Draco-Mantis Female" is listed in vials of player or "Draco-Mantis Herm" is listed in feats of player):
		choose a blank row in table of fucking options;
		now title entry is "Give Gryphon Milk";
		now sortorder entry is 12;
		now description entry is "Give J'Reth some Gryphon Milk to gender-shift them towards being a hermaphrodite";
	[]
	if hp of J'Reth is 1 and Charisma of J'Reth < 1:
		choose a blank row in table of fucking options;
		now title entry is "Offer Help";
		now sortorder entry is 13;
		now description entry is "Ask J'Reth if there is anything that you can do to help him";
	[]
	if hp of J'Reth is 1 and Charisma of J'Reth is 1 and Backpack Lost & Found Stage Four is resolved:
		choose a blank row in table of fucking options;
		now title entry is "Return Backpack";
		now sortorder entry is 14;
		now description entry is "Give J'Reth his backpack";
	[]
	[if hunger of J'Reth is 1:
		choose a blank row in table of fucking options;
		now title entry is "Try to convince J'Reth to use transformatives";
		now sortorder entry is 15;
		now description entry is "Attempt to get J'Reth to reconsider not using creature transformatives to gendershift";]
	[]
	sort the table of fucking options in sortorder order;
	repeat with y running from 1 to number of filled rows in table of fucking options:
		choose row y from the table of fucking options;
		say "[link][y] - [title entry][as][y][end link][line break]";
	say "[link]0 - Nevermind[as]0[end link][line break]";
	while sextablerun is 0:
		say "Pick the corresponding number> [run paragraph on]";
		get a number;
		if calcnumber > 0 and calcnumber <= the number of filled rows in table of fucking options:
			now current menu selection is calcnumber;
			choose row calcnumber in table of fucking options;
			say "[title entry]: [description entry]?";
			if Player consents:
				let nam be title entry;
				now sextablerun is 1;
				if (nam is "Hobbies"):
					say "[J'RethTalk1]";
				else if (nam is "Before the Outbreak"):
					say "[J'RethTalk2]";
				else if (nam is "Small Talk"):
					say "[J'RethTalk3]";
				else if (nam is "Discuss His Form"):
					say "[J'RethTalk4]";
				else if (nam is "Prepare for Gender Shifting"):
					say "[J'RethTalk5]";
				else if (nam is "Extract Vial of Draco-mantis Nanites"):
					say "[J'RethTalk6]";
				else if (nam is "Give Estrogen Pill"):
					say "[J'RethTalk7]";
				else if (nam is "Give Glob of Goo"):
					say "[J'RethTalk8]";
				else if (nam is "Give Testosterone Pill"):
					say "[J'RethTalk9]";
				else if (nam is "Give Fennec Semen"):
					say "[J'RethTalk10]";
				else if (nam is "Give Estosterogen Pill"):
					say "[J'RethTalk11]";
				else if (nam is "Give Gryphon Milk"):
					say "[J'RethTalk12]";
				else if (nam is "Offer Help"):
					say "[J'RethTalk13]";
				else if (nam is "Return Backpack"):
					say "[J'RethTalk14]";
				[else if (nam is "Try to convince J'Reth to use transformatives"):
					say "[J'RethTalk15]";]
				wait for any key;
		else if calcnumber is 0:
			now sextablerun is 1;
			say "     You shake your head, stating that you simply wanted to make sure that [SubjectPro of J'Reth] was alright. [SubjectProCap of J'Reth] gives you a brief smile of appreciation before returning to what [SubjectPro of J'Reth] was doing.";
			wait for any key;
		else:
			say "Invalid Option. Pick between 1 and [the number of filled rows in the table of fucking options] or 0 to exit.";
	clear the screen and hyperlink list;

to say J'RethTalk1: [Hobbies]
	say "     You enquire about what J'Reth's hobbies are, earning a pleased smile in return. 'I'm glad that you asked. If you look around, you'll see all the miniatures from assorted tabletop role-playing games as well as my collection of rulebooks, bestiaries, tomes of lore, dice, pens, pencils... I'm going overboard, aren't I?' [SubjectProCap of J'Reth] gives a sheepish grin, but you wave your hand dismissively. You did ask, and [PosAdj of J'Reth] enthusiasm is admirable. 'I've been playing Kastles & Kobolds for a few years, so each time they release an expansion, I sort of feel like I need to get it. And I know what you're thinking, but it isn't just kobolds. There are lots of different races that you can be. Elves of various alignments, dwarves, elementals, beastfolk... there are lots. Sorry if I'm a little defensive. I was teased about it when I was younger.' You nod in understanding as you pick up a model of what looks like a troll from the shelf, angling it in the limited light to have a look at the finer details.";
	say "     'If you're looking to see if it is anatomically correct then I'm sorry that I must disappoint you. They aren't. I checked when I first got them,' J'Reth informs you, and you grin at [ObjectPro of J'Reth] as, realizing what [SubjectPro of J'Reth] has said, a blush spreads across [PosAdj of J'Reth] features. You hear [ObjectPro of J'Reth] mumble, 'I really need to learn to keep my mouth shut sometimes.' In an effort to shift the conversation from the disgraceful lack of genitals on [PosAdj of J'Reth] troll, the draco-mantis continues explaining [PosAdj of J'Reth] other hobbies. 'While the shortage of electricity in the city currently prevents it, I also liked playing video games. I wouldn't say that I was particularly amazing, but I got to the point that the people that I regularly played things with over the internet weren't always complaining and I even got a few compliments. I'm not sure whether to hope that the rest of the world is aware what is happening in the city or that the military has managed to keep it secret. On the one hand, I don't want my friends to think that I am avoiding them, but equally, I don't want them to be worried about me.'";
	WaitLineBreak;
	say "     'I doubt that the world is ignorant of what is happening here. There was a lot of time for people to call for help or warn people on the internet before we were cut off...' J'Reth falls silent for a moment, seemingly musing on [PosAdj of J'Reth] words. ' Sorry, we were talking about video games, weren't we? There were only a few multiplayer-focused games that I played. I mostly did single player RPGs like the Ancient Tomes series. The older ones were good, but the character customization in the later ones really allowed me to immerse myself. Not looking like I had a box for a head was definitely a bonus. Unfortunately, with the current power problem, I haven't been able to play since the outbreak as, you know, computers need electricity. At least I still have Kastles & Kobolds, but that is more fun with friends. I don't suppose you have any other friends that might be interested. I'd be happy to GM.' While you can't think of anyone at the moment, you agree to mention it to some of the people that you know just in case.";
	say "     'Thanks, that means a lot. Ummm what else... Oh! I don't know how I forgot, but I'm also a huge fan of Backpackemon, the creature collecting game. I know that you're meant to battle, but I found the collecting and spending time with them to be much more fulfilling. Why would anyone want to hurt such adorable little monsters? I sort of look like one of them now, my favorite to be honest, so whatever it is that has caused this does have some benefits despite all the destruction that it has wrought. I suppose that you could say that I like watching movies too, but it isn't in the same league as KnK or gaming. Why is it when someone asks you what you enjoy doing you always sound boring or like a geek?' Considering that [SubjectPro of J'Reth] has shared quite a bit about [PosAdj of J'Reth] hobbies, you reassure [ObjectPro of J'Reth] that it is enough for now and thank [ObjectPro of J'Reth] for telling you a bit about [ReflexPro of J'Reth].";

to say J'RethTalk2: [Before the Outbreak]
	say "     Curious as to what J'Reth did before the nanite apocalypse, you ask [ObjectPro of J'Reth] to tell you. 'Hmmm, yes I suppose life then was quite different to what it is now,' the draco-mantis muses. 'As you can see around you, I'm rather into video games, Kastles & Kobolds, and those sorts of geeky things, so I was going to study game design at the college here. I'd heard that the course at Tenvale was particularly good and that having a degree in it was respected by the majority of game companies so I would have better employment prospects. Unfortunately, I left the paperwork for applying perhaps a little later than I should have, and the outbreak of creatures and transformations happened before I finished it. I wouldn't be able to get it now. I was living with my parents outside the city, so beyond the military containment zone. At least they are probably alright, but they are likely concerned about me.'";
	say "     'I know that there is a stigma attached to living with your parents as you get older, but it saved costs, they genuinely cared about me, and it was convenient for being able to come into the city but avoid some of the other aspects of city life such as crowding and dark alleys from which muggers might get you. I had enough problems with bullies extorting me for money at school. I didn't want to have to deal with that any more as an adult. Though with the blades that I now have on my arms, I don't think that would be a problem anymore, not that I would be able to bring myself to hurt somebody with them. I mainly like them because they look cool. But returning to discussing my living arrangements, as long as I helped around the house by mowing the lawn, occasionally assisting Dad at weekends, and generally earning my place, I wasn't expected to pay rent. My parents weren't too demanding, primarily focused on making sure that I understood responsibility rather than expecting money from me which they knew I would want for college.'";
	WaitLineBreak;
	say "     'Which brings me to the reason I was in the city when everything went wrong. As I'm sure you are aware, college is expensive, and I needed to have money to pay for the various fees. I'd managed to get work at an automotive factory so that I could start to save up and reduce the eventual student debt that I knew I would end up with. Five days a week from nine in the morning until five in the afternoon I would take a bus from near home into the city and slave away in the factory. I suppose that it could have been worse, but when it was more of a means for me to study game design, it did feel demoralizing at times. I'm unlikely to even get into college now so all that hard work was for nothing more than the harsh life lesson of [']life isn't fair[']. Maybe I'm being pessimistic, the infected may yet be allowed to reintegrate into society and I'll be able to follow my dreams.'";
	say "     'Anyway, I was on my way to work when the driver shouted about something in the road and crashed the bus into some parked cars. I was more shocked than hurt but some of the other passengers were injured, and it didn't take long for them to start transforming. It was rather terrifying, as I'm sure you can imagine, and as I escaped from the bus, I must have cut myself on some metal or something because I started turning green. I admit that I panicked and ran, roars and growls echoing from the streets around us. For the first few days, I hid a lot of the time, but eventually I found myself outside the mall and was invited to take shelter here as long as I behaved myself. I don't seem to have become as feral as many around the city so this has been an agreeable arrangement. That's the brief explanation of me before and at the outbreak, any more questions?' Despite this offer, you get the impression that talking about this has been harder on [ObjectPro of J'Reth] than [SubjectPro of J'Reth] is likely to admit, and you shake your head, thanking [ObjectPro of J'Reth] for sharing [PosAdj of J'Reth] story with you.";

to say J'RethTalk3: [Small Talk]
	say "     [One of]'I considered being an adventurer like you, but I didn't want to take an arrow to the knee. Or, for that matter, to have some mindless beast bend me over a park bench and have their way with me[or]'I'm sorry, but your princess is in another castle. Or prince, whichever you prefer. I don't judge, especially with the current state of the city. Sexual discrimination seems diminished from what it used to be[or]'I'm surprised at how little caution people seem to have for food since the outbreak of whatever this is. Food that has been lying around for weeks could be infectious or at least spoiled and poisonous. I've even heard of infections that turn people into food-based creatures. You can never trust the cake-people. They always lie[or]'This city is inhabited by creatures of many different types. For some people, these creatures are pets. Others fight them. Myself... I try to stay where it is safe. Now tell me, are you a boy or a girl? I already know the answer, but I didn't want to miss a chance at making another game reference[at random].' [SubjectProCap of J'Reth] seems enthusiastic about what [SubjectPro of J'Reth] is talking about, even if you don't understand some of what [SubjectPro of J'Reth] is talking about. You both relax into idle discussions about the weather, shops that you used to like, and some of the creatures that you think are impressive. After a few minutes, your conversation comes to a comfortable end, and you decide what to do next while J'Reth futilely attempts to brush some magazines into a tidier pile.";

to say J'RethTalk4: [Discuss his form]
	say "     Curious about the uniqueness of J'Reth's form, you politely ask him whether he would mind telling you a bit more about it. Why haven't you seen anyone else like him? Where did he get it from? How can you get a hot body like him? He holds up a hand, an amused look on his face at the number of questions that you are asking. 'Give me some time to answer you, I wouldn't want to interrupt,' he replies before taking a breath. 'I can't remember whether I have told you before, but I'm a huge fan of Backpackemon. I collected games, cards, figurines, you name it. When the city went weird and I ended up here, I had already changed to look like this; green, armored, and with scythe-like blades sticking from my arms just like my favorite backpackemon.' He shows you one of the models from the shelf next to him and you have to admit that there is an uncanny similarity. 'I can only assume that when I was hurt at the outbreak that some part of my mind guided the nanites to change me into this form, if such a thing is possible, and I haven't changed since.'";
	say "     J'Reth pauses and takes another breath, gathering his thoughts in order to continue. 'I haven't met anyone else like me, but considering my hobbies and obsession with them, I doubt that there was anyone else in the city as enthusiastic about this backpackemon as me so that isn't too much of a surprise. I don't seem to be infectious or susceptible to casual exposure to others either. You've seen how packed the mall can be at times and I eat in the food court surrounded by so many others that if I was going to change or be changed by others that it would have happened already. As for how you can look like me, I may be able to help you with that. I've heard that some of the scientists that managed to gain entry to the city or were here from the beginning have been studying the nanites and their effects, Zephyr especially. If you impress them enough, they might give you a nanite extractor and I could give you a sample of blood for you to use to look like me. It would also give me chance of returning to this form if some infection does manage to shift me.'";
	WaitLineBreak;
	say "     'This brings me to my next topic. I've always had a curiosity about what it would have been like to be female, but due to the difficulty of gender reassignment surgery before the nanites and not actually being uncomfortable with being male, I didn't give it much thought beyond a passing wonder. Now though, people seem to be able to swap back and forth seemingly at a whim and my curiosity has an easy way of being assuaged. I want to stay looking the way I do now, but if you find a way that can safely give me a chance to experience being female I would be grateful.' He looks at you almost pleadingly and you automatically reassure him that you will keep it in mind but that he should be patient as you have your own safety to look out for as well. Nodding it acceptance he sits down on the edge of his bed and gives you a smile, hugging his knees gleefully as he revels in his chance to sate his curiosity even if he has to wait a while. Now you just have to come up with an idea of how to fulfil his wish.";
	now HP of J'Reth is 4;

to say J'RethTalk5: [Prepare for Gender Shifting]
	say "     J'Reth's face lights up when you tell him that you have had a few thoughts about how he might be able to become female, or even hermaphroditic if he wants. 'I realize that you agreed to help me, but I wasn't sure whether you would be able to get the nanite extractor or have time to give it some thought with the number of other things happening in the city. What did you come up with?' he asks. You begin to tell him that there are effectively two options available to you, one easier than the other. He could take purposely designed pills that can change him into a man, woman, or herm, which will likely be difficult to obtain from creatures around the city, or if by some slim chance you did manage to find someone who would sell them to you, they would likely cost a fair few free-creds. The other option is to use some of the transformatives that you extract, claim, or otherwise pillage from creatures around the city, which while an easier option has a higher chance of having some side-effects on the draco-mantis.";
	say "     Giving J'Reth a few minutes to think his options over, you examine some of his figurines and books, admiring some of the handiwork that it must have taken to assemble and paint them. When you turn back to the draco-mantis, some of his enthusiasm has diminished from what it was when you revealed that his desire to be able to gendershift was possible, a conflicted look across his face. Upon seeing your questioning look, he begins to explain. 'Don't get me wrong, I'm thrilled at what you've done and that you are still willing to help. Obviously I would prefer to use pills to transition, but equally I realize that that will make it more difficult for you. On top of the risk that will come with using substances infected with other creature transformations, I would likely be drinking the milk, semen, or goop of some stranger and I'm not sure that I am comfortable with that. What do think that I should do?'";
	say "     [bold type]Do you want to try to convince J'Reth to use creature transformatives or accept that he is more comfortable with pills?[roman type][line break]";
	LineBreak;
	say "     ([link]Y[as]y[end link]) - Attempt to convince J'Reth to be adventurous and use transformatives from creatures.";
	say "     ([link]N[as]n[end link]) - Reassure J'Reth that you don't mind putting in the effort to get pills.";
	if Player consents: [Attempt to convince J'Reth]
		LineBreak;
		let bonus be (( charisma of Player minus 10 ) divided by 2);
		let dice be a random number from 1 to 20;
		say "You roll 1d20([dice])+[bonus]=[dice + bonus] vs 20: ";
		if dice + bonus >= 20: [Success]
			say "     Gently grasping his hand, you explain that as long as you take a sample from him of the draco-mantis nanites before he uses any transformative that you bring him, that there shouldn't be anything to worry about. Currently you are considering [bold type]Gryphon Milk, Fennec Semen,[roman type] and [bold type]Globs of Goo[roman type] to help change him. He hasn't been transformed by anyone else, so it is highly unlikely that there will be any lasting effects besides a sex change. You feel the tension in his muscles lessen and he begins to softly nod as his mouth forms into a small smile. 'When you put it that way, I don't feel that I can really refuse. You're being pragmatic but cautious and I can at least give it a try. You may come across some pills anyway and this discussion will be moo anyway. Alright. I'm willing to trust you on this and drink of the wild beasts that roam the city,' J'Reth declares, earning a smirk from you at how dramatically he phrased it. 'Even if you don't have much success, just ask if you want to look like me. Consider it an advance reward for your help.' It sounds like J'Reth is now willing to share his draco-mantis infection with you.";
			now hunger of J'Reth is 2;
		else: [Failure]
			say "     You begin to extol the merits of drinking semen, milk, and strange goo that you can find lying about, gesturing and being overly enthusiastic. As you do so, you doubt that you are being very convincing and worry that J'Reth may not be happy with you pushing him like this. To your surprise, J'Reth starts laughing, his entire body shaking mirthfully. 'Oh my goodness. For a moment I thought you were being serious, but that is the most outlandish and awful way of trying to convince me that you're obviously making a joke of it to make me feel better. I really needed that, thank you,' he struggles to say between giggles as he holds his sides. Accepting his misunderstanding as for the best, you give him a smile and agree to keep an eye out for testosterone, estrogen, and estosterogen pills. Calming his amusement, J'Reth pats you on the shoulder. 'Even if you don't have much success, just ask if you want to look like me. Consider it an advance reward for your help.' It sounds like J'Reth is now willing to share his draco-mantis infection with you.";
			now hunger of J'Reth is 1;
	else: [Pills are fine]
		say "     Seeing the discomfort that the idea of using creature transformatives is causing J'Reth, you quickly reassure him that you don't mind keeping an eye out for pills, you just wanted to explain the choices to him. A look of relief floods across the draco-mantis['] face and he gives you a brief hug. 'Thank you. I apologize for being difficult, but I really would be happier waiting for you to get the pills than drinking cum from who-knows-what. I can be patient, I've waited this long in my life after all, so don't take any undue risks to get them or bankrupt yourself. Becoming a woman will be more difficult if you become the property of some pimp or packmaster,' he teases you, looking at you with palpable gratitude. Smiling back, you agree to keep an eye out for testosterone, estrogen, and estosterogen pills. J'Reth pats you on the shoulder. 'Even if you don't have much success, just ask if you want to look like me. Consider it an advance reward for your help.' It sounds like J'Reth is now willing to share his draco-mantis infection with you.";
		now hunger of J'Reth is 1;
	now HP of J'Reth is 5;

to say J'RethTalk6: [Take nanites for personal use or as a backup]
	say "     Bringing up the offer that J'Reth had made to you about allowing you to take a sample of [PosAdj of J'Reth] nanites, you ask the draco-mantis whether you would be able to extract some now. 'I don't see why not,' [SubjectPro of J'Reth] replies, 'I'm not exactly busy these days, and if I want to change my sex I'll want the vials as a backup anyway.' [SubjectProCap of J'Reth] sits on the edge of [PosAdj of J'Reth] bed and exposes [PosAdj of J'Reth] arm as you remove the nanite extractor from your backpack, wiping the needle with one of the seemingly limitless alcohol swabs that came with it. 'I don't know why I'm so calm about this, I'm not particularly fond of needles and I can't believe that it will be particularly easy to get through the chitin. Perhaps aim for a join so that you don't need to use as much force,' J'Reth suggests, eyeing the needle carefully as you approach. You sit down beside [ObjectPro of J'Reth]  and briefly stroke [PosAdj of J'Reth] arm comfortingly before aligning the tip of the needle with a gap in [PosAdj of J'Reth] protective plates that cover [PosAdj of J'Reth] upper arm. Giving you a nod to continue, the draco-mantis closes [PosAdj of J'Reth] eyes and waits to feel the prick of the metal going into [PosAdj of J'Reth] arm.";
	say "     The needle goes in with very little effort and you're not sure that J'Reth even felt it. Nanites is one thing, but if medical science has progressed to the point where injections can be done painlessly, then you really are impressed. You squeeze the trigger of the nanite extractor and watch as a vial begins to fill up with blood that is no doubt swimming in transformative nanomachines. You whisper to J'Reth that if [SubjectPro of J'Reth] is a good boy you might reward [PosAdj of J'Reth] later, earning a smirk in response. 'Needles aren't my fetish, but I wouldn't mind that another time, that is if that is what you are offering.' The vial now completely filled, you withdraw the needle again, a single bead of blood remaining behind to show where you stabbed the draco-mantis. J'Reth opens [PosAdj of J'Reth] eyes again and watches as you remove the vial from the extractor and load another one in, putting the full one in your case for later use. 'Is that it? Are you sure that I couldn't persuade you to stay and talk to me for a bit longer?' [SubjectPro of J'Reth] asks as you pack away your equipment and ready yourself to continue with your day.";
	let VialName be "";
	if thirst of J'Reth < 2: [male]
		now VialName is "Draco-Mantis Male";
	else if thirst of J'Reth is 2: [herm]
		now VialName is "Draco-Mantis Male";
	else if thirst of J'Reth is 3: [female]
		now VialName is "Draco-Mantis Female";
	say "     [bold type]You gain a vial of [special-style-1][VialName][roman type] nanites.[roman type][line break]";
	add Vialname to vials of Player;

to say J'RethTalk7: [Use Estrogen Pill]
	if thirst of J'Reth is 0:
		say "     Having obtained an Estrogen Pill, you inform J'Reth that should he want to become female, now he can. His eyes light up upon hearing this and he leaps off his bed and embraces you. 'Thank you,' he whispers in your ear before releasing you again, dancing from one foot to the other in anticipation as he waits for you to find the pill in your backpack. 'So, I just swallow it and wait for the changes to happen?' J'Reth asks as you finally hand him the small tablet, looking at it in wonder. You nod your head, that should be all there is to it, but suggest that perhaps he should disrobe and sit on his bed in case it makes him dizzy. Agreeing with you, the draco-mantis strips before seating himself atop his duvet before calling to you, 'Oh, you do have a vial of my blood, don't you?' You quickly check before affirming it to him. J'Reth gives one last look at the pill before opening his mouth and tossing it onto his tongue decisively, leaving no more room for second thoughts. As it dissolves and he swallows it, you both wait for the changes to begin...";
		say "     You see him gasp as a shiver runs down his spine, the initial sign that the transformation is starting. While already fairly androgynous, J'Reth's body begins to slim at the waist while widening at the hips, giving him a much more feminine silhouette. Surprisingly, his chest remains much the same, female draco-mantises seemingly as flat-chested in J'Reth's mind as the males, though his torso does become fractionally more slender, curving elegantly upwards from his waist to his shoulders. His arms and legs weren't particularly bulky before anyway, so were you not witnessing the slight thickening of his thighs and slimming of his hands, you may not have noticed at all. His erect cock emerges from his genital slit, perhaps due to all the stirring from shifting into being female, before beginning to shrink until finally shrivelling completely away. Were you to examine her genital slit, you imagine that you would find a newly developed vagina.";
		WaitLineBreak;
		say "     As J'Reth's body ceases to shift and shudder, she collapses forward, the transition having exhausted her, and you barely manage to catch her before she hits the floor. Finding her surprisingly light, you lie her on her bed again, earning a small, grateful smile. 'Thanks. That might have hurt. Maybe next time I'll listen and we can avoid me reacting to the ground's siren song,' she mutters as she recovers from the wave of fatigue with the aid of the nanites. She looks over her body, her smile widening and eyes sparkling with delight. 'I look so pretty, and there doesn't appear to have been any unintentional side effects!' she exclaims, running her fingers across her scales and chitin, feeling every dip and change more easily than your eyes seem to manage. 'Thank you. Though being female may take some getting used to.' You decide to leave her for the moment as she returns to being entirely engrossed by her changed form. Maybe you can return later.";
	else if thirst of J'reth is 1:
		say "     Having obtained an Estrogen Pill, you inform J'Reth that should he want to become female again, now he can. His eyes light up upon hearing this and he leaps off his bed and embraces you. 'Thank you,' he whispers in your ear before releasing you again, dancing from one foot to the other in anticipation as he waits for you to find the pill in your backpack. 'I hope that it feels as good as last time,' J'Reth says as you finally hand him the small tablet, looking at it with a wide grin. You smile at his enthusiasm, but remind him that perhaps he should sit on his bed so that he doesn't fall over when his body shifts. Agreeing with you, the draco-mantis seats himself atop his duvet before calling to you, 'Oh, you do have a vial of my blood, don't you?' You quickly check before affirming it to him. J'Reth gives one last look at the pill before opening his mouth and tossing it onto his tongue decisively, having no need for second thoughts. As it dissolves and he swallows it, you both wait for the changes to begin...";
		say "     Once again, you see him gasp as a shiver runs down his spine, the initial sign that the transformation is starting. While already fairly androgynous, J'Reth's body begins to slim at the waist while widening at the hips, giving him a much more feminine silhouette. Like last time, his chest remains much the same, female draco-mantises just as flat-chested in J'Reth's mind as the males, though his torso does become fractionally more slender, curving elegantly upwards from his waist to his shoulders. His arms and legs weren't particularly bulky before anyway, so were you not witnessing the slight thickening of his thighs and slimming of his hands, you may not have noticed at all. His erect cock emerges from his genital slit, perhaps due to all the stirring from shifting into being female, before beginning to shrink until finally shrivelling completely away. Were you to examine her genital slit, you imagine that you would find a newly developed vagina.";
		WaitLineBreak;
		say "     As J'Reth's body ceases to shift and shudder, she collapses forward, the transition having exhausted her once again, but this time you are prepared and manage to catch her before she hits the floor. Finding her surprisingly light, you lie her on her bed again, earning a small, grateful smile. 'Thanks. That might have hurt. I know I said it last time, but maybe next time I won't try to kiss the concrete,' she mutters as she recovers from the wave of fatigue with the aid of the nanites. She looks over her body as excitedly as last time she was gendershifted, her smile widening and eyes sparkling with delight. 'I look so pretty, and there doesn't appear to have been any unintentional side effects!' she exclaims, running her fingers across her scales and chitin, feeling every dip and change more easily than your eyes seem to manage. 'Thank you. Though being female may take some getting used to.' You decide to leave her for the moment as she returns to being entirely engrossed by her changed form. Maybe you can return later.";
	else if thirst of J'Reth is 2:
		say "     Having obtained an Estrogen Pill, you inform J'Reth that should they want to become female again, now they can. Their eyes light up upon hearing this and they leap off their bed and embrace you. 'Thank you,' they whisper in your ear before releasing you again, dancing from one foot to the other in anticipation as they waits for you to find the pill in your backpack. 'I hope that it feels as good as last time,' J'Reth says as you finally hand them the small tablet, looking at it with a wide grin. You smile at their enthusiasm, but remind them that perhaps they should sit on their bed so that they don't fall over when their body shifts. Agreeing with you, the draco-mantis seats themself atop their duvet before calling to you, 'Oh, you do have a vial of my blood, don't you?' You quickly check before affirming it to them. J'Reth gives one last look at the pill before opening their mouth and tossing it onto their tongue decisively, having no need for second thoughts. As it dissolves and they swallow it, you both wait for the changes to begin...";
		say "     Once again, you see them gasp as a shiver runs down their spine, the initial sign that the transformation is starting. Already distinctly androgynous, J'Reth's body begins to slim at the waist while widening at the hips, giving them a much more feminine silhouette. Like last time, their chest remains much the same, female draco-mantises just as flat-chested in J'Reth's mind as the herms, though their torso does become fractionally more slender, curving elegantly upwards from their waist to their shoulders. Their arms and legs weren't particularly bulky before anyway, so were you not witnessing the slight thickening of their thighs and slimming of their hands, you may not have noticed at all. Their erect cock emerges from his genital slit, perhaps due to all the stirring from shifting into being female, before beginning to shrink until finally shrivelling completely away. Were you to examine her genital slit, you imagine that you would find a only a vagina.";
		WaitLineBreak;
		say "     As J'Reth's body ceases to shift and shudder, she collapses forward, the transition having exhausted her once again, but this time you are prepared and manage to catch her before she hits the floor. Finding her surprisingly light, you lie her on her bed again, earning a small, grateful smile. 'Thanks. That might have hurt. I know I said it last time, but maybe next time I won't try to kiss the concrete,' she mutters as she recovers from the wave of fatigue with the aid of the nanites. She looks over her body as excitedly as last time she was gendershifted, her smile widening and eyes sparkling with delight. 'I look so pretty, and there doesn't appear to have been any unintentional side effects!' she exclaims, running her fingers across her scales and chitin, feeling every dip and change more easily than your eyes seem to manage. 'Thank you. Though being female may take some getting used to.' You decide to leave her for the moment as she returns to being entirely engrossed by her changed form. Maybe you can return later.";
	now thirst of J'Reth is 3;
	now Cock Count of J'Reth is 0;
	now Cock Girth of J'Reth is 0;
	now Cock Length of J'Reth is 0;
	now Ball Count of J'Reth is 0;
	now Ball Size of J'Reth is 0;
	now Cunt Count of J'Reth is 1;
	now Cunt Depth of J'Reth is 11;
	now Cunt Tightness of J'Reth is 1;
	now Clit Size of J'Reth is 2;
	SetFemalePronouns for J'Reth;

to say J'RethTalk8: [Use Glob of Goo]
	if thirst of J'Reth is 0:
		say "     Having obtained a Glob of Goo, you inform J'Reth that should he want to become female, now he can. His eyes light up upon hearing this and he leaps off his bed and embraces you. 'Thank you,' he whispers in your ear before releasing you again, dancing from one foot to the other in anticipation as he waits for you to find the goo in your backpack. 'So, I just swallow it and wait for the changes to happen?' J'Reth asks as you finally hand him the small blob of slime, looking at it in wonder and apprehension. You nod your head, that should be all there is to it, but suggest that perhaps he should sit on his bed in case it makes him dizzy. Agreeing with you, the draco-mantis strips before seating himself atop his duvet before calling to you, 'Oh, you do have a vial of my blood, don't you?' You quickly check before affirming it to him. J'Reth gives one last look at the slime before opening his mouth and tossing it in decisively, leaving no more room for second thoughts. As it dissolves and he swallows it, you both wait for the changes to begin...";
		say "     You see him gasp as a shiver runs down his spine, the initial sign that the transformation is starting. While already fairly androgynous, J'Reth's body begins to slim at the waist while widening at the hips, giving him a much more feminine silhouette. Surprisingly, his chest remains much the same, though his torso does become fractionally more slender, curving elegantly upwards from his waist to his shoulders. His arms and legs weren't particularly bulky before anyway, so were you not witnessing the slight thickening of his thighs and slimming of his hands, you may not have noticed at all. The chitin that covers his arms and chest becomes tranlucent and bright green, resembling the goo that J'Reth recently consumed. It would appear that there has been an unintended side-effect. His erect cock emerges from his genital slit, perhaps due to all the stirring from shifting into being female, before beginning to shrink until finally shrivelling completely away. Were you to examine her genital slit, you imagine that you would find a newly developed vagina.";
		WaitLineBreak;
		say "     As J'Reth's body ceases to shift and shudder, she collapses forward, the transition having exhausted her, and you barely manage to catch her before she hits the floor. Finding her surprisingly light, you lie her on her bed again, earning a small, grateful smile. 'Thanks. That might have hurt. Maybe next time I'll listen and we can avoid me reacting to the ground's siren song,' she mutters as she recovers from the wave of fatigue with the aid of the nanites. She looks over her body, her smile faltering as she notices the gelified chitin. 'Huh. Isn't that interesting? You can sort of see through my plating to the scales beneath,' she exclaims, running her fingers across her form, feeling every dip and change more easily than your eyes seem to manage. 'A shame to lose it, but I just wanted to be female, not have lime-jello for armor. Could you inject me with the vial of my blood please?' J'Reth asks you. Complying, you watch the chitin harden again and return to the same shade of green as before. 'Thanks. I'm glad that we planned ahead and that that didn't change me back into being male.' You decide to leave her for the moment as she returns to being entirely engrossed by her changed form. Maybe you can return later.";
	else if thirst of J'reth is 1:
		say "     Having obtained a Glob of Goo, you inform J'Reth that should he want to become female again, now he can. His eyes light up upon hearing this and he leaps off his bed and embraces you. 'Thank you,' he whispers in your ear before releasing you again, dancing from one foot to the other in anticipation as he waits for you to find the goo in your backpack. 'I hope that it feels as good as last time,' J'Reth says as you finally hand him the small blob of slime, looking at it with trepidation. You smile encouragingly, but remind him that perhaps he should sit on his bed so that he doesn't fall over when his body shifts. Agreeing with you, the draco-mantis seats himself atop his duvet before calling to you, 'Oh, you do have a vial of my blood, don't you?' You quickly check before affirming it to him. J'Reth gives one last look at the slime before opening his mouth and tossing it in decisively, having no need for second thoughts. As it dissolves and he swallows it, you both wait for the changes to begin...";
		say "     Once again, you see him gasp as a shiver runs down his spine, the initial sign that the transformation is starting. While already fairly androgynous, J'Reth's body begins to slim at the waist while widening at the hips, giving him a much more feminine silhouette. Like last time, his chest remains much the same, though his torso does become fractionally more slender, curving elegantly upwards from his waist to his shoulders. His arms and legs weren't particularly bulky before anyway, so were you not witnessing the slight thickening of his thighs and slimming of his hands, you may not have noticed at all. The chitin that covers his arms and chest becomes tranlucent and bright green, resembling the goo that J'Reth recently consumed. It would appear that there has been an unintended side-effect. His erect cock emerges from his genital slit, perhaps due to all the stirring from shifting into being female, before beginning to shrink until finally shrivelling completely away. Were you to examine her genital slit, you imagine that you would find a newly developed vagina.";
		WaitLineBreak;
		say "     As J'Reth's body ceases to shift and shudder, she collapses forward, the transition having exhausted her once again, but this time you are prepared and manage to catch her before she hits the floor. Finding her surprisingly light, you lie her on her bed again, earning a small, grateful smile. 'Thanks. That might have hurt. I know I said it last time, but maybe next time I won't try to kiss the concrete,' she mutters as she recovers from the wave of fatigue with the aid of the nanites. She looks over her body, her smile faltering as she notices the gelified chitin. 'Huh. Isn't that interesting? You can sort of see through my plating to the scales beneath,' she exclaims, running her fingers across her form, feeling every dip and change more easily than your eyes seem to manage. 'A shame to lose it, but I just wanted to be female, not have lime-jello for armor. Could you inject me with the vial of my blood please?' J'Reth asks you. Complying, you watch the chitin harden again and return to the same shade of green as before. 'Thanks. I'm glad that we planned ahead and that that didn't change me back into being male.' You decide to leave her for the moment as she returns to being entirely engrossed by her changed form. Maybe you can return later.";
	else if thirst of J'Reth is 2:
		say "     Having obtained a Glob of Goo, you inform J'Reth that should they want to become female again, now they can. Their eyes light up upon hearing this and they leap off their bed and embrace you. 'Thank you,' they whisper in your ear before releasing you again, dancing from one foot to the other in anticipation as they wait for you to find the goo in your backpack. 'I hope that it feels as good as last time,' J'Reth says as you finally hand them the small blob of slime, looking at it with trepidation. You smile encouragingly, but remind them that perhaps they should sit on their bed so that they don't fall over when their body shifts. Agreeing with you, the draco-mantis seats themself atop their duvet before calling to you, 'Oh, you do have a vial of my blood, don't you?' You quickly check before affirming it to them. J'Reth gives one last look at the slime before opening their mouth and tossing it in decisively, having no need for second thoughts. As it dissolves and they swallow it, you both wait for the changes to begin...";
		say "     Once again, you see them gasp as a shiver runs down their spine, the initial sign that the transformation is starting. Already distinctly androgynous, J'Reth's body begins to slim at the waist while widening at the hips, giving them a much more feminine silhouette. Like last time, their chest remains much the same, though their torso does become fractionally more slender, curving elegantly upwards from their waist to their shoulders. Their arms and legs weren't particularly bulky before anyway, so were you not witnessing the slight thickening of their thighs and slimming of their hands, you may not have noticed at all. The chitin that covers their arms and chest becomes tranlucent and bright green, resembling the goo that J'Reth recently consumed. It would appear that there has been an unintended side-effect. Their erect cock emerges from his genital slit, perhaps due to all the stirring from shifting into being female, before beginning to shrink until finally shrivelling completely away. Were you to examine her genital slit, you imagine that you would find a only a vagina.";
		WaitLineBreak;
		say "     As J'Reth's body ceases to shift and shudder, she collapses forward, the transition having exhausted her once again, but this time you are prepared and manage to catch her before she hits the floor. Finding her surprisingly light, you lie her on her bed again, earning a small, grateful smile. 'Thanks. That might have hurt. I know I said it last time, but maybe next time I won't try to kiss the concrete,' she mutters as she recovers from the wave of fatigue with the aid of the nanites. She looks over her body, her smile faltering as she notices the gelified chitin. 'Huh. Isn't that interesting? You can sort of see through my plating to the scales beneath,' she exclaims, running her fingers across her form, feeling every dip and change more easily than your eyes seem to manage. 'A shame to lose it, but I just wanted to be female, not have lime-jello for armor. Could you inject me with the vial of my blood please?' J'Reth asks you.";
		say "[bold type]Which Draco-Mantis vial do you wish to use?[roman type]";
		LineBreak;
		now sextablerun is 0;
		blank out the whole of table of fucking options;
		[]
		if "Draco-Mantis Male" is listed in vials of player:
			choose a blank row in table of fucking options;
			now title entry is "Male";
			now sortorder entry is 1;
			now description entry is "The vial with the male version of the Draco-Mantis infection";
		[]
		if "Draco-Mantis Herm" is listed in vials of player:
			choose a blank row in table of fucking options;
			now title entry is "Herm";
			now sortorder entry is 2;
			now description entry is "The vial with the herm version of the Draco-Mantis infection";
		[]
		if "Draco-Mantis Female" is listed in vials of player:
			choose a blank row in table of fucking options;
			now title entry is "Female";
			now sortorder entry is 3;
			now description entry is "The vial with the female version of the Draco-Mantis infection";
		[]
		sort the table of fucking options in sortorder order;
		repeat with y running from 1 to number of filled rows in table of fucking options:
			choose row y from the table of fucking options;
			say "[link][y] - [title entry][as][y][end link][line break]";
		say "[link]0 - Nevermind[as]0[end link][line break]";
		while sextablerun is 0:
			say "Pick the corresponding number> [run paragraph on]";
			get a number;
			if calcnumber > 0 and calcnumber <= the number of filled rows in table of fucking options:
				now current menu selection is calcnumber;
				choose row calcnumber in table of fucking options;
				say "[title entry]: [description entry]?";
				if Player consents:
					let nam be title entry;
					now sextablerun is 1;
					if (nam is "Male"):
						remove "Draco-Mantis Male" from vials of player;
					else if (nam is "Herm"):
						remove "Draco-Mantis Herm" from vials of player;
					else if (nam is "Female"):
						remove "Draco-Mantis Female" from vials of player;
					wait for any key;
			else:
				say "Invalid Option. Pick between 1 and [the number of filled rows in the table of fucking options].";
		clear the screen and hyperlink list;
		say "     Complying, you watch the chitin harden again and return to the same shade of green as before. 'Thanks. I'm glad that we planned ahead and that that didn't change me back into being male.' You decide to leave her for the moment as she returns to being entirely engrossed by her changed form. Maybe you can return later.";
	now thirst of J'Reth is 3;
	now Cock Count of J'Reth is 0;
	now Cock Girth of J'Reth is 0;
	now Cock Length of J'Reth is 0;
	now Ball Count of J'Reth is 0;
	now Ball Size of J'Reth is 0;
	now Cunt Count of J'Reth is 1;
	now Cunt Depth of J'Reth is 11;
	now Cunt Tightness of J'Reth is 1;
	now Clit Size of J'Reth is 2;
	SetFemalePronouns for J'Reth;

to say J'RethTalk9: [Use Testosterone Pill]
	if thirst of J'reth is 2:
		say "     Having obtained a Testosterone Pill, you inform J'Reth that should they want to become male again, now they can. Their eyes light up upon hearing this and they leap off their bed and embrace you. 'Thank you,' they whisper in your ear before releasing you again, dancing from one foot to the other in anticipation as they wait for you to find the pill in your backpack. 'I hope that it feels as good as last time,' J'Reth says as you finally hand them the small tablet, looking at it with a wide grin. You smile at their enthusiasm, but remind them that perhaps they should sit on their bed so that they don't fall over when their body shifts. Agreeing with you, the draco-mantis seats themself atop their duvet before calling to you, 'Oh, you do have a vial of my blood, don't you?' You quickly check before affirming it to them. J'Reth gives one last look at the pill before opening their mouth and tossing it onto their tongue decisively, having no need for second thoughts. As it dissolves and they swallow it, you both wait for the changes to begin...";
		say "     Once again, you see them gasp as a shiver runs down their spine, the initial sign that the transformation is starting. Already distinctly androgynous, J'Reth's body begins to slim at the hips while the waist remains unchanged, giving them a slightly more masculine silhouette, though still androgynous. Like last time, their chest remains much the same, male draco-mantises just as flat-chested in J'Reth's mind as the herms, though their torso does become fractionally broader, the curve from their waist to their shoulders lessening. Their arms and legs weren't particularly bulky before anyway, so were you not witnessing the slight slimming of their thighs, you may not have noticed at all. Their erect cock emerges from his genital slit, perhaps due to all the stirring from shifting into being male, spurting cum and seeming to expand slightly before retreating again. Were you to examine his genital slit, you imagine that you would find only a penis.";
		WaitLineBreak;
		say "     As J'Reth's body ceases to shift and shudder, he collapses forward, the transition having exhausted him once again, but this time you are prepared and manage to catch him before he hits the floor. Finding him surprisingly light, you lie him on his bed again, earning a small, grateful smile. 'Thanks. That might have hurt. I know I said it last time, but maybe next time I won't try to kiss the concrete,' he mutters as he recovers from the wave of fatigue with the aid of the nanites. He looks over his body as excitedly as last time he was gendershifted, his smile widening and eyes sparkling with delight. 'I look so dashing, and there doesn't appear to have been any unintentional side effects!' he exclaims, running his fingers across his scales and chitin, feeling every dip and change more easily than your eyes seem to manage. 'Thank you. I doubt that being male again will be too disconcerting, we'll wait and see.' You decide to leave him for the moment as he returns to being entirely engrossed by his changed form. Maybe you can return later.";
	else if thirst of J'reth is 3:
		say "     Having obtained a Testosterone Pill, you inform J'Reth that should she want to become male again, now she can. Her eyes light up upon hearing this and she leaps off her bed and embraces you. 'Thank you,' she whispers in your ear before releasing you again, dancing from one foot to the other in anticipation as she waits for you to find the pill in your backpack. 'I hope that it feels as good as last time,' J'Reth says as you finally hand her the small tablet, looking at it with a wide grin. You smile at her enthusiasm, but remind her that perhaps she should sit on her bed so that she doesn't fall over when her body shifts. Agreeing with you, the draco-mantis seats himself atop her duvet before calling to you, 'Oh, you do have a vial of my blood, don't you?' You quickly check before affirming it to her. J'Reth gives one last look at the pill before opening her mouth and tossing it onto her tongue decisively, having no need for second thoughts. As it dissolves and she swallows it, you both wait for the changes to begin...";
		say "     Once again, you see her gasp as a shiver runs down her spine, the initial sign that the transformation is starting. Her body quite feminine, it begins to widen at the waist and slim at the hips, giving her a slightly more masculine silhouette, though still androgynous. Like last time, her chest remains much the same, male draco-mantises seemingly as flat-chested in J'Reth's mind as the females, though her torso does become fractionally wider, the curve from her waist to her shoulders lessening. Her arms and legs weren't particularly bulky before anyway, so were you not witnessing the slight slimming of her thighs and widening of her hands, you may not have noticed at all. Fluid begins to leak from her genital slit as a tapered cock emerges, scarlet and long, before it retreats again. Were you to examine his genital slit, you imagine that you would find only a penis.";
		WaitLineBreak;
		say "     As J'Reth's body ceases to shift and shudder, he collapses forward, the transition having exhausted him once again, but this time you are prepared and manage to catch him before he hits the floor. Finding him surprisingly light, you lie him on his bed again, earning a small, grateful smile. 'Thanks. That might have hurt. I know I said it last time, but maybe next time I won't try to kiss the concrete,' he mutters as he recovers from the wave of fatigue with the aid of the nanites. He looks over his body as excitedly as last time he was gendershifted, his smile widening and eyes sparkling with delight. 'I look so dashing, and there doesn't appear to have been any unintentional side effects!' he exclaims, running his fingers across his scales and chitin, feeling every dip and change more easily than your eyes seem to manage. 'Thank you. I doubt that being male again will be too disconcerting, we'll wait and see.' You decide to leave him for the moment as he returns to being entirely engrossed by his changed form. Maybe you can return later.";
	now thirst of J'Reth is 1;
	now Cock Count of J'Reth is 1;
	now Cock Girth of J'Reth is 2;
	now Cock Length of J'Reth is 11;
	now Ball Count of J'Reth is 2;
	now Ball Size of J'Reth is 3;
	now Cunt Count of J'Reth is 0;
	now Cunt Depth of J'Reth is 0;
	now Cunt Tightness of J'Reth is 0;
	now Clit Size of J'Reth is 0;
	SetMalePronouns for J'Reth;

to say J'RethTalk10: [Use Fennec Semen]
	if thirst of J'reth is 2:
		say "     Having obtained a bottle of Fennec Semen, you inform J'Reth that should they want to become male again, now they can. Their eyes light up upon hearing this and they leap off their bed and embrace you. 'Thank you,' they whisper in your ear before releasing you again, dancing from one foot to the other in anticipation as they wait for you to find the bottle in your backpack. 'I hope that it feels as good as last time,' J'Reth says as you finally hand them the small container of semen, looking at it with trepidation. You smile encouragingly, but remind them that perhaps they should sit on their bed so that they don't fall over when their body shifts. Agreeing with you, the draco-mantis seats themself atop their duvet before calling to you, 'Oh, you do have a vial of my blood, don't you?' You quickly check before affirming it to them. J'Reth gives one last look at the cum before opening their mouth and tossing it in decisively, having no need for second thoughts. As it sloshes around and they swallow it, you both wait for the changes to begin...";
		say "     Once again, you see them gasp as a shiver runs down their spine, the initial sign that the transformation is starting. Already distinctly androgynous, J'Reth's body begins to slim at the hips while the waist remains unchanged, giving them a slightly more masculine silhouette, though still androgynous. Like last time, their chest remains much the same, male draco-mantises just as flat-chested in J'Reth's mind as the herms, though their torso does become fractionally broader, the curve from their waist to their shoulders lessening. Their arms and legs weren't particularly bulky before anyway, so were you not witnessing the slight slimming of their thighs, you may not have noticed at all. Shockingly, two large, furry ears sprout from the top of their head, rotating around at the slightest sound. It would appear that there has been an unintended side-effect from drinking the fox's semen. Their erect cock emerges from his genital slit, perhaps due to all the stirring from shifting into being male, spurting cum and seeming to expand slightly before retreating again. Were you to examine his genital slit, you imagine that you would find only a penis.";
		WaitLineBreak;
		say "     As J'Reth's body ceases to shift and shudder, he collapses forward, the transition having exhausted him once again, but this time you are prepared and manage to catch him before he hits the floor. Finding him surprisingly light, you lie him on his bed again, earning a small, grateful smile. 'Thanks. That might have hurt. I know I said it last time, but maybe next time I won't try to kiss the concrete,' he mutters as he recovers from the wave of fatigue with the aid of the nanites. He looks over his body, his smile faltering as he notices the furry appendages atop his head. 'Huh. Isn't that interesting? I can hear a lot more than usual, but I'm not sure that I want to,' he exclaims, running her fingers across her form, feeling every dip and change more easily than your eyes seem to manage. 'A shame to lose it, but I just wanted to be male again, not have radars for ears. Could you inject me with the vial of my blood please?' J'Reth asks you. Complying, you watch the feenec ears recede until his head is a smooth as before. 'Thanks. I'm glad that we planned ahead and that I was able to deal with the side effects.' You decide to leave him for the moment as he returns to being entirely engrossed by his changed form. Maybe you can return later.";
	else if thirst of J'reth is 3:
		say "     Having obtained a bottle of Fennec Semen, you inform J'Reth that should she want to become male again, now she can. Her eyes light up upon hearing this and she leaps off her bed and embraces you. 'Thank you,' she whispers in your ear before releasing you again, dancing from one foot to the other in anticipation as she waits for you to find the bottle in your backpack. 'I hope that it feels as good as last time,' J'Reth says as you finally hand her the small container of semen, looking at it with trepidation. You smile encouragingly, but remind her that perhaps she should sit on her bed so that she doesn't fall over when her body shifts. Agreeing with you, the draco-mantis seats himself atop her duvet before calling to you, 'Oh, you do have a vial of my blood, don't you?' You quickly check before affirming it to her. J'Reth gives one last look at the cum before opening her mouth and tossing it in decisively, having no need for second thoughts. As it sloshes around and she swallows it, you both wait for the changes to begin...";
		say "     Once again, you see her gasp as a shiver runs down her spine, the initial sign that the transformation is starting. Her body quite feminine, it begins to widen at the waist and slim at the hips, giving her a slightly more masculine silhouette, though still androgynous. Like last time, her chest remains much the same, male draco-mantises seemingly as flat-chested in J'Reth's mind as the females, though her torso does become fractionally wider, the curve from her waist to her shoulders lessening. Her arms and legs weren't particularly bulky before anyway, so were you not witnessing the slight slimming of her thighs and widening of her hands, you may not have noticed at all. Shockingly, two large, furry ears sprout from the top of their head, rotating around at the slightest sound. It would appear that there has been an unintended side-effect from drinking the fox's semen. Fluid begins to leak from her genital slit as a tapered cock emerges, scarlet and long, before it retreats again. Were you to examine his genital slit, you imagine that you would find only a penis.";
		WaitLineBreak;
		say "     As J'Reth's body ceases to shift and shudder, he collapses forward, the transition having exhausted him once again, but this time you are prepared and manage to catch him before he hits the floor. Finding him surprisingly light, you lie him on his bed again, earning a small, grateful smile. 'Thanks. That might have hurt. I know I said it last time, but maybe next time I won't try to kiss the concrete,' he mutters as he recovers from the wave of fatigue with the aid of the nanites. He looks over his body, his smile faltering as he notices the furry appendages atop his head. 'Huh. Isn't that interesting? I can hear a lot more than usual, but I'm not sure that I want to,' he exclaims, running her fingers across her form, feeling every dip and change more easily than your eyes seem to manage. 'A shame to lose it, but I just wanted to be male again, not have radars for ears. Could you inject me with the vial of my blood please?' J'Reth asks you.";
		say "[bold type]Which Draco-Mantis vial do you wish to use?[roman type]";
		LineBreak;
		now sextablerun is 0;
		blank out the whole of table of fucking options;
		[]
		if "Draco-Mantis Male" is listed in vials of player:
			choose a blank row in table of fucking options;
			now title entry is "Male";
			now sortorder entry is 1;
			now description entry is "The vial with the male version of the Draco-Mantis infection";
		[]
		if "Draco-Mantis Herm" is listed in vials of player:
			choose a blank row in table of fucking options;
			now title entry is "Herm";
			now sortorder entry is 2;
			now description entry is "The vial with the herm version of the Draco-Mantis infection";
		[]
		if "Draco-Mantis Female" is listed in vials of player:
			choose a blank row in table of fucking options;
			now title entry is "Female";
			now sortorder entry is 1;
			now description entry is "The vial with the female version of the Draco-Mantis infection";
		[]
		sort the table of fucking options in sortorder order;
		repeat with y running from 1 to number of filled rows in table of fucking options:
			choose row y from the table of fucking options;
			say "[link][y] - [title entry][as][y][end link][line break]";
		say "[link]0 - Nevermind[as]0[end link][line break]";
		while sextablerun is 0:
			say "Pick the corresponding number> [run paragraph on]";
			get a number;
			if calcnumber > 0 and calcnumber <= the number of filled rows in table of fucking options:
				now current menu selection is calcnumber;
				choose row calcnumber in table of fucking options;
				say "[title entry]: [description entry]?";
				if Player consents:
					let nam be title entry;
					now sextablerun is 1;
					if (nam is "Male"):
						remove "Draco-Mantis Male" from vials of player;
					else if (nam is "Herm"):
						remove "Draco-Mantis Herm" from vials of player;
					else if (nam is "Female"):
						remove "Draco-Mantis Female" from vials of player;
					wait for any key;
			else:
				say "Invalid Option. Pick between 1 and [the number of filled rows in the table of fucking options].";
		clear the screen and hyperlink list;
		say "     Complying, you watch the fennec ears recede until his head is a smooth as before. 'Thanks. I'm glad that we planned ahead and that I was able to deal with the side effects.' You decide to leave him for the moment as he returns to being entirely engrossed by his changed form. Maybe you can return later.";
	now thirst of J'Reth is 1;
	now Cock Count of J'Reth is 1;
	now Cock Girth of J'Reth is 2;
	now Cock Length of J'Reth is 11;
	now Ball Count of J'Reth is 2;
	now Ball Size of J'Reth is 3;
	now Cunt Count of J'Reth is 0;
	now Cunt Depth of J'Reth is 0;
	now Cunt Tightness of J'Reth is 0;
	now Clit Size of J'Reth is 0;
	SetMalePronouns for J'Reth;

to say J'RethTalk11: [Use Estosterogen Pill]
	if thirst of J'Reth is 0:
		say "     Having obtained an Estosterogen Pill, you inform J'Reth that should he want to become hermaphroditic, now he can. His eyes light up upon hearing this and he leaps off his bed and embraces you. 'Thank you,' he whispers in your ear before releasing you again, dancing from one foot to the other in anticipation as he waits for you to find the pill in your backpack. 'So, I just swallow it and wait for the changes to happen?' J'Reth asks as you finally hand him the small tablet, looking at it in wonder. You nod your head, that should be all there is to it, but suggest that perhaps he should sit on his bed in case it makes him dizzy. Agreeing with you, the draco-mantis seats himself atop his duvet before calling to you, 'Oh, you do have a vial of my blood, don't you?' You quickly check before affirming it to him. J'Reth gives one last look at the pill before opening his mouth and tossing it onto his tongue decisively, leaving no more room for second thoughts. As it dissolves and he swallows it, you both wait for the changes to begin...";
		say "     You see him gasp as a shiver runs down his spine, the initial sign that the transformation is starting. Already fairly androgynous, J'Reth's body begins to widen at the hips, though his waist remains unchanged, giving him a silhouette with aspects of both the male and female form. Surprisingly, his chest remains much the same, herm draco-mantises seemingly as flat-chested in J'Reth's mind as the males, though his torso does become fractionally more slender, curving elegantly upwards from his waist to his shoulders. His arms and legs weren't particularly bulky before anyway, so were you not witnessing the slight thickening of his thighs, you may not have noticed at all. His erect cock emerges from his genital slit, perhaps due to all the stirring from shifting into being hermaphroditic, spurting cum while fluid begins to leak from below it. Were you to examine their genital slit, you imagine that you would find a newly developed vagina in addition to the already present penis.";
		WaitLineBreak;
		say "     As J'Reth's body ceases to shift and shudder, they collapses forward, the transition having exhausted them, and you barely manage to catch them before they hit the floor. Finding them surprisingly light, you lie them on their bed again, earning a small, grateful smile. 'Thanks. That might have hurt. Maybe next time I'll listen and we can avoid me reacting to the ground's siren song,' they mutter as they recover from the wave of fatigue with the aid of the nanites. They look over their body, their smile widening and eyes sparkling with delight. 'I look so attractive, and there doesn't appear to have been any unintentional side effects!' they exclaim, running their fingers across their scales and chitin, feeling every dip and change more easily than your eyes seem to manage. 'Thank you. Though being a herm may take some getting used to.' You decide to leave them for the moment as they return to being entirely engrossed by their changed form. Maybe you can return later.";
	else if thirst of J'reth is 1:
		say "     Having obtained an Estosterogen Pill, you inform J'Reth that should he want to become hermaphroditic again, now he can. His eyes light up upon hearing this and he leaps off his bed and embraces you. 'Thank you,' he whispers in your ear before releasing you again, dancing from one foot to the other in anticipation as he waits for you to find the pill in your backpack. 'I hope that it feels as good as last time,' J'Reth says as you finally hand him the small tablet, looking at it with a wide grin. You smile at his enthusiasm, but remind him that perhaps he should sit on his bed so that he doesn't fall over when his body shifts. Agreeing with you, the draco-mantis seats himself atop his duvet before calling to you, 'Oh, you do have a vial of my blood, don't you?' You quickly check before affirming it to him. J'Reth gives one last look at the pill before opening his mouth and tossing it onto his tongue decisively, having no need for second thoughts. As it dissolves and he swallows it, you both wait for the changes to begin...";
		say "     Once again, you see him gasp as a shiver runs down his spine, the initial sign that the transformation is starting. Already fairly androgynous, J'Reth's body begins to widen at the hips, though his waist remains unchanged, giving him a silhouette with aspects of both the male and female form. Like last time, his chest remains much the same, herm draco-mantises seemingly as flat-chested in J'Reth's mind as the males, though his torso does become fractionally more slender, curving elegantly upwards from his waist to his shoulders. His arms and legs weren't particularly bulky before anyway, so were you not witnessing the slight thickening of his thighs, you may not have noticed at all. His erect cock emerges from his genital slit, perhaps due to all the stirring from shifting into being hermaphroditic, spurting cum while fluid begins to leak from below it. Were you to examine their genital slit, you imagine that you would find a newly developed vagina in addition to the already present penis.";
		WaitLineBreak;
		say "     As J'Reth's body ceases to shift and shudder, they collapses forward, the transition having exhausted them once again, but this time you are prepared and manage to catch them before they hit the floor. Finding them surprisingly light, you lie them on their bed again, earning a small, grateful smile. 'Thanks. That might have hurt. I know I said it last time, but maybe next time I won't try to kiss the concrete,' they mutter as they recover from the wave of fatigue with the aid of the nanites. They look over their body as excitedly as last time they were gendershifted, their smile widening and eyes sparkling with delight. 'I look so attractive, and there doesn't appear to have been any unintentional side effects!' they exclaim, running their fingers across their scales and chitin, feeling every dip and change more easily than your eyes seem to manage. 'Thank you. Though being a herm may take some getting used to.' You decide to leave them for the moment as they return to being entirely engrossed by their changed form. Maybe you can return later.";
	else if thirst of J'reth is 3:
		say "     Having obtained an Estosterogen Pill, you inform J'Reth that should she want to become hermaphroditic again, now she can. Her eyes light up upon hearing this and she leaps off her bed and embraces you. 'Thank you,' she whispers in your ear before releasing you again, dancing from one foot to the other in anticipation as she waits for you to find the pill in your backpack. 'I hope that it feels as good as last time,' J'Reth says as you finally hand her the small tablet, looking at it with a wide grin. You smile at her enthusiasm, but remind her that perhaps she should sit on her bed so that she doesn't fall over when her body shifts. Agreeing with you, the draco-mantis seats himself atop her duvet before calling to you, 'Oh, you do have a vial of my blood, don't you?' You quickly check before affirming it to her. J'Reth gives one last look at the pill before opening her mouth and tossing it onto her tongue decisively, having no need for second thoughts. As it dissolves and she swallows it, you both wait for the changes to begin...";
		say "     Once again, you see her gasp as a shiver runs down her spine, the initial sign that the transformation is starting. Her body quite feminine, it begins to widen at the waist, though her hips remains unchanged, giving her a silhouette with aspects of both the male and female form. Like last time, her chest remains much the same, herm draco-mantises seemingly as flat-chested in J'Reth's mind as the females, though her torso does become fractionally wider, but still curving elegantly upwards from her waist to her shoulders. Her arms and legs weren't particularly bulky before anyway, so were you not witnessing the slight slimming of her thighs, you may not have noticed at all. Fluid begins to leak from her genital slit as a tapered cock emerges, scarlet and long, before it retreats again. Were you to examine their genital slit, you imagine that you would find both a penis and a vagina.";
		WaitLineBreak;
		say "     As J'Reth's body ceases to shift and shudder, they collapses forward, the transition having exhausted them once again, but this time you are prepared and manage to catch them before they hit the floor. Finding them surprisingly light, you lie them on their bed again, earning a small, grateful smile. 'Thanks. That might have hurt. I know I said it last time, but maybe next time I won't try to kiss the concrete,' they mutter as they recover from the wave of fatigue with the aid of the nanites. They look over their body as excitedly as last time they were gendershifted, their smile widening and eyes sparkling with delight. 'I look so attractive, and there doesn't appear to have been any unintentional side effects!' they exclaim, running their fingers across their scales and chitin, feeling every dip and change more easily than your eyes seem to manage. 'Thank you. Though being a herm may take some getting used to.' You decide to leave them for the moment as they return to being entirely engrossed by their changed form. Maybe you can return later.";
	now thirst of J'Reth is 2;
	now Cock Count of J'Reth is 1;
	now Cock Girth of J'Reth is 2;
	now Cock Length of J'Reth is 11;
	now Ball Count of J'Reth is 2;
	now Ball Size of J'Reth is 3;
	now Cunt Count of J'Reth is 1;
	now Cunt Depth of J'Reth is 11;
	now Cunt Tightness of J'Reth is 1;
	now Clit Size of J'Reth is 2;
	SetMalePronouns for J'Reth;

to say J'RethTalk12: [Use Gryphon Milk]
	if thirst of J'Reth is 0:
		say "     Having obtained a Bottle of Gryphon Milk, you inform J'Reth that should he want to become hermaphroditic, now he can. His eyes light up upon hearing this and he leaps off his bed and embraces you. 'Thank you,' he whispers in your ear before releasing you again, dancing from one foot to the other in anticipation as he waits for you to find the bottle in your backpack. 'So, I just swallow it and wait for the changes to happen?' J'Reth asks as you finally hand him the small container of milk, looking at it in wonder and apprehension. You nod your head, that should be all there is to it, but suggest that perhaps he should sit on his bed in case it makes him dizzy. Agreeing with you, the draco-mantis seats himself atop his duvet giving one last look at the milk before opening his mouth and tossing it in decisively, leaving no more room for second thoughts. As it sloshes around and he swallows it, you both wait for the changes to begin...";
		say "     You see him gasp as a shiver runs down his spine, the initial sign that the transformation is starting. Already fairly androgynous, J'Reth's body begins to widen at the hips, though his waist remains unchanged, giving him a silhouette with aspects of both the male and female form. Surprisingly, his chest remains much the same, herm draco-mantises seemingly as flat-chested in J'Reth's mind as the males, though his torso does become fractionally more slender, curving elegantly upwards from his waist to his shoulders. His arms and legs weren't particularly bulky before anyway, so were you not witnessing the slight thickening of his thighs, you may not have noticed at all. His wings become feathery and a fine down spreads across his back, likely an unforseen side effect of the Gryphon Milk. His erect cock emerges from his genital slit, perhaps due to all the stirring from shifting into being hermaphroditic, spurting cum while fluid begins to leak from below it. Were you to examine their genital slit, you imagine that you would find a newly developed vagina in addition to the already present penis.";
		WaitLineBreak;
		say "     As J'Reth's body ceases to shift and shudder, they collapses forward, the transition having exhausted them, and you barely manage to catch them before they hit the floor. Finding them surprisingly light, you lie them on their bed again, earning a small, grateful smile. 'Thanks. That might have hurt. Maybe next time I'll listen and we can avoid me reacting to the ground's siren song,' they mutter as they recover from the wave of fatigue with the aid of the nanites. They look over her body, her smile faltering as they feel the feathery wings and down on their back. 'Huh. Isn't that interesting? I appear to be partially turned into a bird,' they exclaim, running their fingers across their form, feeling every dip and change more easily than your eyes seem to manage. 'A shame to lose it, but I just wanted to be a herm, not have a ready supply of quills growing from my back without any parchment. Could you inject me with the vial of my blood please?' J'Reth asks you. Complying, you watch their wings become thin and membranous again and their back return to being smooth and chitinous. 'Thanks. I'm glad that we planned ahead and that that didn't change me back into being male.' You decide to leave them for the moment as they return to being entirely engrossed by their changed form. Maybe you can return later.";
	else if thirst of J'reth is 1:
		say "     Having obtained a Bottle of Gryphon Milk, you inform J'Reth that should he want to become hermaphroditic again, now he can. His eyes light up upon hearing this and he leaps off his bed and embraces you. 'Thank you,' he whispers in your ear before releasing you again, dancing from one foot to the other in anticipation as he waits for you to find the bottle in your backpack. 'I hope that it feels as good as last time,' J'Reth says as you finally hand him the small container of milk, looking at it with trepidation. You smile encouragingly, but remind him that perhaps he should sit on his bed so that he doesn't fall over when his body shifts. Agreeing with you, the draco-mantis seats himself atop his duvet before calling to you, 'Oh, you do have a vial of my blood, don't you?' You quickly check before affirming it to him. J'Reth gives one last look at the milk before opening his mouth and tossing it in decisively, having no need for second thoughts. As it sloshes around and he swallows it, you both wait for the changes to begin...";
		say "     Once again, you see him gasp as a shiver runs down his spine, the initial sign that the transformation is starting. Already fairly androgynous, J'Reth's body begins to widen at the hips, though his waist remains unchanged, giving him a silhouette with aspects of both the male and female form. Like last time, his chest remains much the same, herm draco-mantises seemingly as flat-chested in J'Reth's mind as the males, though his torso does become fractionally more slender, curving elegantly upwards from his waist to his shoulders. His arms and legs weren't particularly bulky before anyway, so were you not witnessing the slight thickening of his thighs, you may not have noticed at all. His wings become feathery and a fine down spreads across his back, likely an unforseen side effect of the Gryphon Milk. His erect cock emerges from his genital slit, perhaps due to all the stirring from shifting into being hermaphroditic, spurting cum while fluid begins to leak from below it. Were you to examine their genital slit, you imagine that you would find a newly developed vagina in addition to the already present penis.";
		WaitLineBreak;
		say "     As J'Reth's body ceases to shift and shudder, they collapses forward, the transition having exhausted them, but this time you are prepared and manage to catch them before they hit the floor. Finding them surprisingly light, you lie them on their bed again, earning a small, grateful smile. 'Thanks. That might have hurt. I know I said it last time, but maybe next time I won't try to kiss the concrete,' they mutter as they recover from the wave of fatigue with the aid of the nanites. They look over her body, her smile faltering as they feel the feathery wings and down on their back. 'Huh. Isn't that interesting? I appear to be partially turned into a bird,' they exclaim, running their fingers across their form, feeling every dip and change more easily than your eyes seem to manage. 'A shame to lose it, but I just wanted to be a herm, not have a ready supply of quills growing from my back without any parchment. Could you inject me with the vial of my blood please?' J'Reth asks you. Complying, you watch their wings become thin and membranous again and their back return to being smooth and chitinous. 'Thanks. I'm glad that we planned ahead and that that didn't change me back into being male.' You decide to leave them for the moment as they return to being entirely engrossed by their changed form. Maybe you can return later.";
	else if thirst of J'reth is 3:
		say "     Having obtained a Bottle of Gryphon Milk, you inform J'Reth that should she want to become hermaphroditic again, now she can. Her eyes light up upon hearing this and she leaps off her bed and embraces you. 'Thank you,' she whispers in your ear before releasing you again, dancing from one foot to the other in anticipation as she waits for you to find the bottle in your backpack. 'I hope that it feels as good as last time,' J'Reth says as you finally hand her the small container of milk, looking at it with trepidation. You smile encouragingly, but remind her that perhaps she should sit on her bed so that she doesn't fall over when her body shifts. Agreeing with you, the draco-mantis seats himself atop her duvet before calling to you, 'Oh, you do have a vial of my blood, don't you?' You quickly check before affirming it to her. J'Reth gives one last look at the milk before opening her mouth and tossing it in decisively, having no need for second thoughts. As it sloshes around and she swallows it, you both wait for the changes to begin...";
		say "     Once again, you see her gasp as a shiver runs down her spine, the initial sign that the transformation is starting. Her body quite feminine, it begins to widen at the waist, though her hips remains unchanged, giving her a silhouette with aspects of both the male and female form. Like last time, her chest remains much the same, herm draco-mantises seemingly as flat-chested in J'Reth's mind as the females, though her torso does become fractionally wider, but still curving elegantly upwards from her waist to her shoulders. Her arms and legs weren't particularly bulky before anyway, so were you not witnessing the slight slimming of her thighs, you may not have noticed at all. Her wings become feathery and a fine down spreads across her back, likely an unforseen side effect of the Gryphon Milk. Her erect cock emerges from his genital slit, perhaps due to all the stirring from shifting into being hermaphroditic, spurting cum while fluid begins to leak from below it. Were you to examine their genital slit, you imagine that you would find both a penis and a vagina.";
		WaitLineBreak;
		say "     As J'Reth's body ceases to shift and shudder, they collapses forward, the transition having exhausted them, but this time you are prepared and manage to catch them before they hit the floor. Finding them surprisingly light, you lie them on their bed again, earning a small, grateful smile. 'Thanks. That might have hurt. I know I said it last time, but maybe next time I won't try to kiss the concrete,' they mutter as they recover from the wave of fatigue with the aid of the nanites. They look over her body, her smile faltering as they feel the feathery wings and down on their back. 'Huh. Isn't that interesting? I appear to be partially turned into a bird,' they exclaim, running their fingers across their form, feeling every dip and change more easily than your eyes seem to manage. 'A shame to lose it, but I just wanted to be a herm, not have a ready supply of quills growing from my back without any parchment. Could you inject me with the vial of my blood please?' J'Reth asks you.";
		say "[bold type]Which Draco-Mantis vial do you wish to use?[roman type]";
		LineBreak;
		now sextablerun is 0;
		blank out the whole of table of fucking options;
		[]
		if "Draco-Mantis Male" is listed in vials of player:
			choose a blank row in table of fucking options;
			now title entry is "Male";
			now sortorder entry is 1;
			now description entry is "The vial with the male version of the Draco-Mantis infection";
		[]
		if "Draco-Mantis Herm" is listed in vials of player:
			choose a blank row in table of fucking options;
			now title entry is "Herm";
			now sortorder entry is 2;
			now description entry is "The vial with the herm version of the Draco-Mantis infection";
		[]
		if "Draco-Mantis Female" is listed in vials of player:
			choose a blank row in table of fucking options;
			now title entry is "Female";
			now sortorder entry is 1;
			now description entry is "The vial with the female version of the Draco-Mantis infection";
		[]
		sort the table of fucking options in sortorder order;
		repeat with y running from 1 to number of filled rows in table of fucking options:
			choose row y from the table of fucking options;
			say "[link][y] - [title entry][as][y][end link][line break]";
		say "[link]0 - Nevermind[as]0[end link][line break]";
		while sextablerun is 0:
			say "Pick the corresponding number> [run paragraph on]";
			get a number;
			if calcnumber > 0 and calcnumber <= the number of filled rows in table of fucking options:
				now current menu selection is calcnumber;
				choose row calcnumber in table of fucking options;
				say "[title entry]: [description entry]?";
				if Player consents:
					let nam be title entry;
					now sextablerun is 1;
					if (nam is "Male"):
						remove "Draco-Mantis Male" from vials of player;
					else if (nam is "Herm"):
						remove "Draco-Mantis Herm" from vials of player;
					else if (nam is "Female"):
						remove "Draco-Mantis Female" from vials of player;
					wait for any key;
			else:
				say "Invalid Option. Pick between 1 and [the number of filled rows in the table of fucking options].";
		clear the screen and hyperlink list;
		say "     Complying, you watch their wings become thin and membranous again and their back return to being smooth and chitinous. 'Thanks. I'm glad that we planned ahead and that that didn't change me back into being male.' You decide to leave them for the moment as they return to being entirely engrossed by their changed form. Maybe you can return later.";
	now thirst of J'Reth is 2;
	now Cock Count of J'Reth is 1;
	now Cock Girth of J'Reth is 2;
	now Cock Length of J'Reth is 11;
	now Ball Count of J'Reth is 2;
	now Ball Size of J'Reth is 3;
	now Cunt Count of J'Reth is 1;
	now Cunt Depth of J'Reth is 11;
	now Cunt Tightness of J'Reth is 1;
	now Clit Size of J'Reth is 2;
	SetMalePronouns for J'Reth;

to say J'RethTalk13: [Ask if there is anything that you can do to help]
	if FemaleList is not Warded and FemaleList is not Banned:
		say "     Aware that J'Reth spends a large amount of time in his room, admittedly surrounded by the models and posters which he loves so much, you ask whether there is anything more that you can do to help him. 'I've got enough soup for now, thank you,' he replies with a grin to show that he is teasing. 'Honestly, your company is about the most helpful thing at the moment. As I'm sure you have realized, I'm not the most extroverted of people, but I've always liked spending as much time around my friends as possible. Before all this started, I used to have a weekly KnK session with some buddies in a spare room at the college, but I haven't dared leave the mall since the city descended into chaos. The worst part is that I haven't seen any of my friends since and I worry that they've gone feral or worse...' He remains silent for a few moments as he controls the quiver in his voice and takes a breath.";
		say "     You offer to have a look for his friends but J'Reth surprises you by shaking his head. 'I haven't the faintest idea what they would look like and I need more time to prepare myself should it be confirmed that something has happened to them. Perhaps another time, when I've asked some of the other people living here whether they know of them, and that's something I can do more easily than you. I would be interested in getting my character sheets back though. I ended up having to leave in a rush after the last session and I forgot my backpack with all my KnK stuff in it. I don't know how I managed to do so when it was about the only thing that I had with me, but my character is sort of who I am and I want my bag back. If you find the time I'd really appreciate it if you could ask at the [bold type]College Administration Building[roman type] if someone handed it in. It's rather distinctive,' the draco-mantis adds with a blush.";
		WaitLineBreak;
		say "     You raise an eyebrow. How distinctive can it be? Seeing your expression, J'Reth hurriedly continues. 'Don't worry, it's not anything lewd. Just perhaps... childish. It's a Felicitas bag that I was given as a birthday present when I was younger. Felicitas is a Backpackemon. A pink Backpackemon, so you can imagine how much I was bullied in school for having it, but I loved it dearly. Anyway, I doubt that there will be many people with them at the college, so if one has been handed into Lost & Found or if anyone has seen it, it should be memorable.' You can see how much it means to him, so you readily agree to find his backpack for him. 'Thank you. I'll be in your debt if you return with my Felicitas and my character sheets.'";
		now Charisma of J'Reth is 1;
	else: [Females banned or warded..]
		say "     'No, sorry. I can't think of anything that you can do for me at the moment.' (WIP. A version for if those who have banned or warded females may be completed at a later point.)'"; [Would take some adaptation of the current questline]

to say J'RethTalk14: [Return his backpack]
	say "     With a smile, you open your bag and lift J'Reth's backpack out, much to his delight. As you pass it to him he strokes a finger over one of the frills on its head. 'Thank you. You found it, you actually found it,' he says gratefully. 'I hope you didn't have too much difficulty.' Seeing the look on your face, he winces before asking, 'How bad was it?' You explain the convoluted sequence of events that you had to go through in order to finally track it down as well as sharing their wishes for him to visit them. 'Sorry. I should have gone myself. Maybe one day,' the draco-mantis apologizes. Giving him a reassuring pat on the shoulder, you tell him that he can make it up to you by telling you a bit about his friends and their game of Kastles & Kobolds. He cheers up at hearing this before launching into an enthusiastic explanation.";
	say "     'Gerald was the Game Master and he was really good at it. I don't know how he found the time to organize everything in between classes and assignments, especially when he is currently working towards a doctorate in English, but he seemed to and all the sessions seemed to run smoothly even when we diverged from the main quest objective. Between Selena trying to seduce everyone, Jasper stealing everything he could lay his scaly hands on, and Gabrielle beating up anyone who was even remotely mean or rude to the party, it's a wonder we ever got anywhere.' You teasingly ask whether he ever did anything similar that stalled the party's progress. 'What? No, of course not! I was a model player.' You decide to take his word on it for now and let him continue. 'Gabrielle was a Paladin, though I'm not sure how. She was always ready to fight anyone at the drop of a hat. Maybe she followed a deity of loyalty or something, but if anyone from peasant to arch-demon threatened us, she would interpose herself between us and the threat and either make them apologize or be bludgeoned by her shield within an inch of death. She was also really sensitive about her height, though she did still play a short feline character in game. She got pretty hurt sometimes, but she still protected us all.'";
	WaitLineBreak;
	say "     'Jasper was a kobold Rogue and we had to keep an eye on him to prevent him robbing everyone blind. However, when we needed him to, or if we dropped out guard around him, he would be able to carry out a perfect heist leaving the victim none the wiser about his presence and the amount of loot he had managed to stash in assorted pockets and bags as he snuck out. Excellent at planning, rivalling even Gerald and I sometimes wondered if he felt threatened by this similarity. I think Selena had a word to him about this and no problems had arisen so far, so I probably shouldn't worry. Selena was the party Bard, though perhaps seductress would be more apt. She put most of her points into charisma and always seemed to roll well, so you can imagine how persuasive she could be when there was something that she wanted. Jasper was, and it seems still is, her boyfriend so it was slightly surprising how much pleasure he seemed to get from her sleeping around with everyone in the party as well as a few NPCs that caught her eye. Not that any of us protested when a snake with the body of a goddess invited herself into our beds.' J'Reth blushes at your amused grin. 'She was the stereotypical bard. I'm sure dragons would have spoken of her like some sort of legend.'";
	say "     You point out that he has barely talked about his own role in the party. 'Ha. I suppose I haven't. I was a warlock,' he says, excitedly emptying the contents of the Felicitas backpack onto the table in front of you. As you can see, I had a reasonable charisma stat too, though that was mainly for spell power rather than persuasion. Selena was way better at that than me, but I also have reasonable intelligence due to being the primary caster in the group. You may also notice that my character name is J'Reth and my race is draco-mantis. Gerald allowed us to use custom races as long as they were properly balanced, so I created a race based on my favorite Backpackemon with the help of the group.' J'reth seems so engrossed in explaining this to you, that he doesn't notice a perplexed frown creeping across on your face. As he takes a breath, you ask him why there seem to be duplicates of his character sheet, except that one of them has him as being female.";
	WaitLineBreak;
	say "     The draco-mantis gulps and struggles to meet your eye before finally answering hesitantly. 'I've always had a curiosity about what it would have been like to be female, but due to the difficulty of gender reassignment surgery before the nanites and not actually being uncomfortable with being male, I didn't give it much serious thought. I'd discussed this privately with Gerald and he was surprisingly understanding compared to his usual crotchety demeanor and so in the last session before the city descended into chaos, he ensured that I ended up with a cursed artifact that transformed my character from being male into being female. Most of the group found this hilarious, though Jasper seemed like he knew that there was something beyond mere chance about this happening. It was going to give me the chance to roleplay being female and see how it made me feel, but we didn't get to continue after my transformation as the session came to an end. Jasper started questioning me about it and I got flustered and left in a hurry which may have been why I forgot my backpack.'";
	say "     J'Reth looks at you cautiously to gauge your reaction, worried that you will reject or condemn him for these feelings. You smile reassuringly and explain that you aren't one to judge over something like that and with the city the way it is, he can easily become female should he wish, or back to being male if that is what he would prefer. He could even try being a herm! Taking a deep breath, J'Reth replies, 'I want to stay looking the way I do now, but if you find a way that can safely give me a chance to experience being female I would be grateful.' You explain that you'll keep it in mind while exploring the city but that it may take you some time. 'Take all the time you need, though I would be more comfortable if you had a [bold type]nanite extractor[roman type] before you try to transform me. I want to be able to return to this form if something goes wrong and I'll even let you see of you can use the samples to change yourself to look like me.' Smiling at his enthusiasm, you now have to work out how to fulfil this wish.";
	now Charisma of J'Reth is 2;
	now HP of J'Reth is 4;

[to say J'RethTalk15: [Convince J'Reth to use Transformatives]
	say "     ";
	let bonus be (( charisma of Player minus 10 ) divided by 2);
	let dice be a random number from 1 to 20;
	say "You roll 1d20([dice])+[bonus]=[dice + bonus] vs 18: ";
	if dice + bonus >= 18:
		say "     ";]

Section 4 - Section 4 - Sex

Instead of fucking J'reth:
	if HP of J'Reth is 1:
		say "     When you bring up having sex with him, to your surprise, he declines politely with an apologetic look. 'Sorry, I'm not feeling in the mood for it at the moment. I don't know whether it is because I've partaken of the carnal pleasures too much recently, or whether the climate within the city is getting to me. Either way, I don't feel like doing anything sexual today. I don't suppose you have any peaches, do you? Even tinned will do. They're one of my favorite snacks... Don't worry about it. It would be too much to ask of you,' the draco-mantis finishes with a sigh and turns away, his usually cheerful visage decidedly glum. Resolving to cheer him up, you decide that perhaps some fresh fruit might be what the doctor ordered. Perhaps [bold type]five[roman type] or so [bold type]peaches[roman type] from the park? I think I've seen fruit bats with them too.";
		now HP of J'Reth is 2;
	else if HP of J'Reth is 2:
		if carried of tasty peach > 4:
			say "     You politely cough to catch J'Reth's attention, the morose draco-mantis slowly looking up as you search through your backpack for the peaches that you got for him. After a moment you find them and present them to the surprised young man, the several small bruises on the fruit's skin doing little to diminish the obvious pleasure spreading across his face at not merely tinned, but fresh peaches. 'Wow... um, I don't know what to say other than thank you. I didn't expect anyone to be willing to devote time to cheering me up. Especially when it likely involved searching around the city. I might have to name my firstborn after you. You know... if I ever have a firstborn... Forget I said that. Please?' J'Reth blushes deeply and attempts to distract himself by taking a bite out of a peach. Letting out a sigh, he relaxes back on his bed for a moment before stirring again as his cock begins to swell from his crotch. 'I've heard of peaches being an aphrodisiac, but that was more effective than I would have expected. I haven't felt this horny in ages. Up for some intimate touching?' It looks like J'Reth is open to your advances now.";
			now HP of J'Reth is 3;
		else:
			say "     'Sorry. I still feel down at the moment. I'm sure someone else would be willing if you're that desperate for sex.' Perhaps you should get [bold type]five peaches[roman type] from the park?";
	else if (lastfuck of J'Reth - turns < 6): [he got fucked in the last 18 hours = 6 turns]
		say "     J'Reth looks at you for a moment before laughing. 'Look, I'm enjoying the sex as much as you are, but I need breaks from time to time. I shouldn't need too much longer, so be patient.' Considering how much semen he produces, you suppose that you shouldn't be surprised that he needs time to recuperate.";
	else: [ Given Peaches ]
		say "     [J'RethSexMenu]";

to say J'RethSexMenu:
	now sextablerun is 0;
	blank out the whole of table of fucking options;
	[]
	if player is not neuter:
		choose a blank row in table of fucking options;
		now title entry is "Mutual Oral";
		now sortorder entry is 1;
		now description entry is "Suck J'Reth off while they tend to you at the same time";
	[]
	if Player is female and thirst of J'Reth < 3:
		choose a blank row in table of fucking options;
		now title entry is "Receive Vaginal";
		now sortorder entry is 2;
		now description entry is "Sit on J'Reth's lap and ride them";
	[]
	if thirst of J'Reth < 3:
		choose a blank row in table of fucking options;
		now title entry is "Catch Anal";
		now sortorder entry is 3;
		now description entry is "Bend over the edge of the bed and let J'Reth pound your ass";
	[]
	if Player is male:
		choose a blank row in table of fucking options;
		now title entry is "Pitch Anal";
		now sortorder entry is 4;
		now description entry is "Push J'Reth facedown on the bed and penetrate them anally";
	[]
	if Player is male and Virgin of J'Reth is True and thirst of J'Reth > 1:
		choose a blank row in table of fucking options;
		now title entry is "Take J'Reth's Virginity";
		now sortorder entry is 4;
		now description entry is "Take J'Reth's vaginal virginity";
	[]
	if Player is male and Virgin of J'Reth is False and thirst of J'Reth > 1:
		choose a blank row in table of fucking options;
		now title entry is "Vaginally Penetrate J'Reth";
		now sortorder entry is 4;
		now description entry is "Push J'Reth against a wall and pound their pussy";
	[]
	sort the table of fucking options in sortorder order;
	repeat with y running from 1 to number of filled rows in table of fucking options:
		choose row y from the table of fucking options;
		say "[link][y] - [title entry][as][y][end link][line break]";
	say "[link]0 - Nevermind[as]0[end link][line break]";
	while sextablerun is 0:
		say "Pick the corresponding number> [run paragraph on]";
		get a number;
		if calcnumber > 0 and calcnumber <= the number of filled rows in table of fucking options:
			now current menu selection is calcnumber;
			choose row calcnumber in table of fucking options;
			say "[title entry]: [description entry]?";
			if Player consents:
				let nam be title entry;
				now sextablerun is 1;
				if nam is "Mutual Oral":
					say "[J'RethSex1]";
				else if nam is "Receive Vaginal":
					say "[J'RethSex2]";
				else if nam is "Catch Anal":
					say "[J'RethSex3]";
				else if nam is "Pitch Anal":
					say "[J'RethSex4]";
				else if nam is "Take J'Reth's Virginity":
					say "[J'RethSex5]";
				else if nam is "Vaginally Penetrate J'Reth":
					say "[J'RethSex6]";
				wait for any key;
		else if calcnumber is 0:
			now sextablerun is 1;
			say "     You step back from the draco-mantis, shaking your head slightly as [SubjectPro of J'Reth] gives a questioning look.";
			wait for any key;
		else:
			say "Invalid Option. Pick between 1 and [the number of filled rows in the table of fucking options] or 0 to exit.";
	clear the screen and hyperlink list;

to say J'RethSex1: [Mutual Oral]
	if thirst of J'Reth < 2: [Male J'Reth]
		if player is herm: [herms]
			say "     You make the suggestion that he pleasure your cock and pussy while you do similar to him so as to maximise your mutual pleasure. J'Reth eagerly nods before rapidly removing the few clothes that he was wearing. You gaze at his chitinous form, admiring the various shades of green over his arms, chest, and groin plates, it is only after he politely coughs that you realize that you aren't giving him a good view of yourself. [if player is naked]Not quite posing, but still shifting into a more revealing posture, you allow his eyes to rove across your body while you do the same to him[else]You teasingly begin to strip, the draco-mantis's hungry eyes roving across your flesh as it is exposed[end if]. Judging from the red shaft that begins to slide from his genital slit, he approves of the image in front of him, though the blush spreading across his cheeks suggests that he is still unused to being able to unashamedly look upon someone else's naked form.";
			say "     You aren't unaffected either, your cock stirring and cunt pulsing in response to the pleasant sight before you. Without speaking, J'Reth lies on his bed face up and you clamber atop him with his impressively-sized erection in front of your mouth, the way it glistens with sweet-smelling precum making your mouth water in anticipation, and your own genitals resting on his androgynous face. You feel his long, slender tongue dexterously slither across the lips of your pussy to loop around the head of your cock, collecting the freely flowing pre before slithering back into his mouth to allow him to taste your arousal. Deciding that that is as good a cue to start as any, you lick his shaft from base to tip, your tongue slipping into his genital slit for a moment as you begin, earning you a surprised gasp from your partner, the sensory feedback from this action new to the draco-mantis. You store this knowledge for in future and continue licking his member with enthusiasm that he matches while tending to you, his tongue occasionally tickling at your balls and clit as he alternates between pleasuring your male and female genitalia.";
			WaitLineBreak;
			say "     Soon, as the tempo of mutual oral stimulation increases, licks progress into sucks and the two of you almost seem to be competing as to see who can draw the most moans, gasps, and grunts out of the other. J'Reth's hands clutch your ass, pulling your hips to put more force into your thrusts as your cock slides into his maw and [if cock length of player < 4]over his roiling tongue [else if cock length of player < 7]bumps at the back of his throat [else]into the confines of his throat [end if]each time you hilt. You treat his penis with no less fervor, swirling your tongue around as you inhale an ever increasing amount of it, your gag-reflex non-existent by this point thanks to the help of the nanites. Your hands aren't idle either, massaging the base of his length as the knot begins to swell, signaling his impending orgasm, while the draco-mantis's fingers gently stroke over the entrance to your pussy, dipping inside every few seconds to caress your inner walls. You doubt that you are too far from climax either.";
			say "     Conscious of this fact, you further devote yourself to tasting the sweet flavor that coats J'Reth's cock, audible slurps slipping from between your lips. The draco-mantis, perhaps also sensing your imminent finish, curls his tongue around your shaft and displays the extent of control he has over it by constricting the organ rhythmically. With a euphoric cry, you are sent over the edge, your partner climaxing just after you. Warm jets of sperm splash against the back of J'Reth's throat, his eager swallows squeezing around the head of your penis to goad more out of you, while the walls of your cunt pulse around his probing digits. Despite the size of your load, his is noticeably more copious, spilling out of the sides of your mouth despite your attempts to swallow at a rapid pace. Cum pools on his lap and dribbles onto the bed as it drips from your lips and some even trickles from your nose, the sheer volume of semen escaping by any means necessary as it builds up in your mouth and throat, its sweet taste bathing your taste buds and filling your nostrils.";
			WaitLineBreak;
			say "     Eventually, his orgasm subsides and you swallow the last of his cum with a gulp, its flavor likely to cling to your tongue for a while afterwards. Sperm still sticking to your lips and chin, you allow his shaft to slide from your mouth, the unused knot already deflating, and look back over your shoulder at the draco-mantis and give him a jizz-stained smile in a show of gratitude and enjoyment for what has just taken place. As J'Reth releases your own cock from the confines of his throat, the quickly softening organ slips from between his lips and drags across the delicate angles of his face, leaving behind a glistening trail. He doesn't seem to mind, gesturing with femcum-stained fingers for you to turn around and lie next to him, a request that is slightly difficult due to the size of bed but nonetheless you comply. Upon being encircled by his arms in a cuddle, you sigh contentedly and relax against him, touched that he still finds such niceties important. Unfortunately, you do not stay like this for long, and after a quick kiss you prepare to continue with your day.";
			NPCSexAftermath player receives "OralCock" from J'Reth;
			NPCSexAftermath J'Reth receives "OralCock" from player;
		else if player is male: [male]
			say "     You make the suggestion that he suck you off while you do the same to him so as to maximise your mutual pleasure. J'Reth eagerly nods before rapidly removing the few clothes that he was wearing. You gaze at his chitinous form, admiring the various shades of green over his arms, chest, and groin plates, it is only after he politely coughs that you realize that you aren't giving him a good view of yourself. [if player is naked]Not quite posing, but still shifting into a more revealing posture, you allow his eyes to rove across your body while you do the same to him[else]You teasingly begin to strip, the draco-mantis's hungry eyes roving across your flesh as it is exposed[end if]. Judging from the red shaft that begins to slide from his genital slit, he approves of the image in front of him, though the blush spreading across his cheeks suggests that he is still unused to being able to unashamedly look upon someone else's naked form.";
			say "     You aren't unaffected either, your cock stirring in response to the pleasant sight before you. Without speaking, J'Reth lies on his bed face up and you clamber atop him with his impressively-sized erection in front of your mouth, the way it glistens with sweet-smelling precum making your mouth water in anticipation, and your own penis resting on his androgynous face. You feel his long, slender tongue dexterously loop around the head of your cock, collecting the freely flowing pre before slithering back into his mouth to allow him to taste your arousal. Deciding that that is as good a cue to start as any, you lick his shaft from base to tip, your tongue slipping into his genital slit for a moment as you begin, earning you a surprised gasp from your partner, the sensory feedback from this action new to the draco-mantis. You store this knowledge for in future and continue licking his member with enthusiasm that he matches while tending to you, his tongue occasionally tickling at your balls.";
			WaitLineBreak;
			say "     Soon, as the tempo of mutual oral stimulation increases, licks progress into sucks and the two of you almost seem to be competing as to see who can draw the most moans, gasps, and grunts out of the other. J'Reth's hands clutch your ass, pulling your hips to put more force into your thrusts as your cock slides into his maw and [if cock length of player < 4]over his roiling tongue [else if cock length of player < 7]bumps at the back of his throat [else]into the confines of his throat [end if]each time you hilt. You treat his penis with no less fervor, swirling your tongue around as you inhale an ever increasing amount of it, your gag-reflex non-existent by this point thanks to the help of the nanites. Your hands aren't idle either, massaging the base of his length as the knot begins to swell, signaling his impending orgasm, while the draco-mantis's fingers gently stroke over your balls, making sure not to neglect your orbs while he focuses on your rod. You doubt that you are too far from climax either.";
			say "     Conscious of this fact, you further devote yourself to tasting the sweet flavor that coats J'Reth's cock, audible slurps slipping from between your lips. The draco-mantis, perhaps also sensing your imminent finish, curls his tongue around your shaft and displays the extent of control he has over it by constricting the organ rhythmically. With a euphoric cry, you are sent over the edge, your partner climaxing just after you. Warm jets of sperm splash against the back of J'Reth's throat, his eager swallows squeezing around the head of your penis to goad more out of you. Despite the size of your load, his is noticeably more copious, spilling out of the sides of your mouth despite your attempts to swallow at a rapid pace. Cum pools on his lap and dribbles onto the bed as it drips from your lips and some even trickles from your nose, the sheer volume of semen escaping by any means necessary as it builds up in your mouth and throat, its sweet taste bathing your taste buds and filling your nostrils.";
			WaitLineBreak;
			say "     Eventually, his orgasm subsides and you swallow the last of his cum with a gulp, its flavor likely to cling to your tongue for a while afterwards. Sperm still sticking to your lips and chin, you allow his shaft to slide from your mouth, the unused knot already deflating, and look back over your shoulder at the draco-mantis and give him a jizz-stained smile in a show of gratitude and enjoyment for what has just taken place. As J'Reth releases your own cock from the confines of his throat, the quickly softening organ slips from between his lips and drags across the delicate angles of his face, leaving behind a glistening trail. He doesn't seem to mind, gesturing for you to turn around and lie next to him, a request that is slightly difficult due to the size of bed but nonetheless you comply. Upon being encircled by his arms in a cuddle, you sigh contentedly and relax against him, touched that he still finds such niceties important. Unfortunately, you do not stay like this for long, and after a quick kiss you prepare to continue with your day.";
			NPCSexAftermath player receives "OralCock" from J'Reth;
			NPCSexAftermath J'Reth receives "OralCock" from player;
		else: [female]
			say "     You make the suggestion that he eat you out while you suck him off so as to maximise your mutual pleasure. J'Reth eagerly nods before rapidly removing the few clothes that he was wearing. You gaze at his chitinous form, admiring the various shades of green over his arms, chest, and groin plates, it is only after he politely coughs that you realize that you aren't giving him a good view of yourself. [if player is naked]Not quite posing, but still shifting into a more revealing posture, you allow his eyes to rove across your body while you do the same to him[else]You teasingly begin to strip, the draco-mantis's hungry eyes roving across your flesh as it is exposed[end if]. Judging from the red shaft that begins to slide from his genital slit, he approves of the image in front of him, though the blush spreading across his cheeks suggests that he is still unused to being able to unashamedly look upon someone else's naked form.";
			say "     You aren't unaffected either, your cunt pulsing in response to the pleasant sight before you. Without speaking, J'Reth lies on his bed face up and you clamber atop him with his impressively-sized erection in front of your mouth, the way it glistens with sweet-smelling precum making your mouth water in anticipation, and your pussy resting on his androgynous face. You feel his long, slender tongue dexterously flick at your clit before making a pass over your vulva, collecting the freely flowing wetness before slithering back into his mouth to allow him to taste your arousal. Deciding that that is as good a cue to start as any, you lick his shaft from base to tip, your tongue slipping into his genital slit for a moment as you begin, earning you a surprised gasp from your partner, the sensory feedback from this action new to the draco-mantis. You store this knowledge for in future and continue licking his member with enthusiasm that he matches while tending to you, his tongue making the occasional rapid dart in and out of you.";
			WaitLineBreak;
			say "     Soon, as the tempo of mutual oral stimulation increases, licks progress into sucks and the two of you almost seem to be competing as to see who can draw the most moans, gasps, and grunts out of the other. J'Reth's hands clutch your ass, pulling your hips against his eager maw to allow his tongue deeper passage inside the confines of your quivering pussy, the soft rush of air from his nostrils tickling at your clit as he inhales your scent. You treat his penis with no less fervor, swirling your tongue around as you inhale an ever increasing amount of it, your gag-reflex non-existent by this point thanks to the help of the nanites. Your hands aren't idle either, massaging the base of his length as the knot begins to swell, signaling his impending orgasm, while the draco-mantis's fingers tenderly stroke over the contours of your ass, the contrast between the vigorous slathering of your vaginal walls by his tongue and the soft brushing of his palms over your buttocks enhancing your arousal. You doubt that you are too far from climax either.";
			say "     Conscious of this fact, you further devote yourself to tasting the sweet flavor that coats J'Reth's cock, audible slurps slipping from between your lips. The draco-mantis, perhaps also sensing your imminent finish, flails his tongue around inside your pussy, the rapid impacts with its walls becoming too much. With a euphoric cry, you are sent over the edge, your partner orgasming just after you. Wet splashes of arousal are expelled from your quivering cunt over your partners eager maw and across his face, his tongue softly crushed within your most intimate passage. Despite the magnitude of your climax, his is noticeably more copious, spilling out of the sides of your mouth despite your attempts to swallow at a rapid pace. Cum pools on his lap and dribbles onto the bed as it drips from your lips and some even trickles from your nose, the sheer volume of semen escaping by any means necessary as it builds up in your mouth and throat, its sweet taste bathing your taste buds and filling your nostrils.";
			WaitLineBreak;
			say "     Eventually, his orgasm subsides and you swallow the last of his cum with a gulp, its flavor likely to cling to your tongue for a while afterwards. Sperm still sticking to your lips and chin, you allow his shaft to slide from your mouth, the unused knot already deflating, and look back over your shoulder at the draco-mantis and give him a jizz-stained smile in a show of gratitude and enjoyment for what has just taken place. As J'Reth retracts his tongue from your subtly shuddering vagina, he is able to redirect its efforts towards cleaning his face of your juices, an activity which it fulfils with gusto. He doesn't seem to mind the mess that has been caused, gesturing for you to turn around and lie next to him, a request that is slightly difficult due to the size of bed but nonetheless you comply. Upon being encircled by his arms in a cuddle, you sigh contentedly and relax against him, touched that he still finds such niceties important. Unfortunately, you do not stay like this for long, and after a quick kiss you prepare to continue with your day.";
			NPCSexAftermath player receives "OralCock" from J'Reth;
			NPCSexAftermath J'Reth receives "OralPussy" from player;
	else if thirst of J'Reth is 2: [herm J'Reth]
		if player is herm: [herms]
			say "     You make the suggestion that he pleasure your cock and pussy while you do similar to him so as to maximise your mutual pleasure. J'Reth eagerly nods before rapidly removing the few clothes that he was wearing. You gaze at his chitinous form, admiring the various shades of green over his arms, chest, and groin plates, it is only after he politely coughs that you realize that you aren't giving him a good view of yourself. [if player is naked]Not quite posing, but still shifting into a more revealing posture, you allow his eyes to rove across your body while you do the same to him[else]You teasingly begin to strip, the draco-mantis's hungry eyes roving across your flesh as it is exposed[end if]. Judging from the red shaft that begins to slide from his genital slit, simultaneously revealing his pussy too, he approves of the image in front of him, though the blush spreading across his cheeks suggests that he is still unused to being able to unashamedly look upon someone else's naked form.";
			say "     You aren't unaffected either, your cock stirring and cunt pulsing in response to the pleasant sight before you. Without speaking, J'Reth lies on his bed face up and you clamber atop him with his impressively-sized erection in front of your mouth, the way it glistens with sweet-smelling precum making your mouth water in anticipation, and your own genitals resting on his androgynous face. You feel his long, slender tongue dexterously slither across the lips of your pussy to loop around the head of your cock, collecting the freely flowing pre before slithering back into his mouth to allow him to taste your arousal. Deciding that that is as good a cue to start as any, you lick his shaft from base to tip, your tongue slipping into his genital slit for a moment as you begin, earning you a surprised gasp from your partner, the sensory feedback from this action new to the draco-mantis. You store this knowledge for in future and continue licking his member with enthusiasm that he matches while tending to you, his tongue occasionally tickling at your balls and clit as he alternates between pleasuring your male and female genitalia. Not wanting your partner's cunt to be unattended when he is so generously worshipping you, you occassionally break from tasting his cock to kiss his engorged vulva and thrust your tongue into the warm embrace within.";
			WaitLineBreak;
			say "     Soon, as the tempo of mutual oral stimulation increases, licks progress into sucks and the two of you almost seem to be competing as to see who can draw the most moans, gasps, and grunts out of the other. J'Reth's hands clutch your ass, pulling your hips to put more force into your thrusts as your cock slides into his maw and [if cock length of player < 4]over his roiling tongue [else if cock length of player < 7]bumps at the back of his throat [else]into the confines of his throat [end if]each time you hilt. You treat his penis with no less fervor, swirling your tongue around as you inhale an ever increasing amount of it, your gag-reflex non-existent by this point thanks to the help of the nanites. Your hands aren't idle either, swapping between stimulating his clit and pussy lips and massaging the base of his length as the knot begins to swell, signaling his impending orgasm, while the draco-mantis's fingers gently stroke over the entrance to your pussy, dipping inside every few seconds to caress your inner walls. You doubt that you are too far from climax either.";
			say "     Conscious of this fact, you further devote yourself to tasting the sweet flavor that coats J'Reth's cock, audible slurps slipping from between your lips. The draco-mantis, perhaps also sensing your imminent finish, curls his tongue around your shaft and displays the extent of control he has over it by constricting the organ rhythmically. With a euphoric cry, you are sent over the edge, your partner climaxing just after you. Warm jets of sperm splash against the back of J'Reth's throat, his eager swallows squeezing around the head of your penis to goad more out of you, while the walls of your cunt pulse around his probing digits. Despite the size of your load, his is noticeably more copious, spilling out of the sides of your mouth despite your attempts to swallow at a rapid pace. Cum pools on his lap and dribbles onto the bed as it drips from your lips and some even trickles from your nose, the sheer volume of semen escaping by any means necessary as it builds up in your mouth and throat, its sweet taste bathing your taste buds and filling your nostrils.";
			WaitLineBreak;
			say "     Eventually, his orgasm subsides and you swallow the last of his cum with a gulp, its flavor likely to cling to your tongue for a while afterwards. Sperm still sticking to your lips and chin, you allow his shaft to slide from your mouth, the unused knot already deflating, and look back over your shoulder at the draco-mantis and give him a jizz-stained smile in a show of gratitude and enjoyment for what has just taken place. As J'Reth releases your own cock from the confines of his throat, the quickly softening organ slips from between his lips and drags across the delicate angles of his face, leaving behind a glistening trail. He doesn't seem to mind, gesturing with femcum-stained fingers for you to turn around and lie next to him, a request that is slightly difficult due to the size of bed but nonetheless you comply. Upon being encircled by his arms in a cuddle, you sigh contentedly and relax against him, touched that he still finds such niceties important. Unfortunately, you do not stay like this for long, and after a quick kiss you prepare to continue with your day.";
			NPCSexAftermath player receives "OralCock" from J'Reth;
			NPCSexAftermath J'Reth receives "OralCock" from player;
		else if player is male: [male]
			say "     You make the suggestion that he suck you off while you pleasure his cock and pussy so as to maximise your mutual pleasure. J'Reth eagerly nods before rapidly removing the few clothes that he was wearing. You gaze at his chitinous form, admiring the various shades of green over his arms, chest, and groin plates, it is only after he politely coughs that you realize that you aren't giving him a good view of yourself. [if player is naked]Not quite posing, but still shifting into a more revealing posture, you allow his eyes to rove across your body while you do the same to him[else]You teasingly begin to strip, the draco-mantis's hungry eyes roving across your flesh as it is exposed[end if]. Judging from the red shaft that begins to slide from his genital slit, simultaneously revealing his pussy too, he approves of the image in front of him, though the blush spreading across his cheeks suggests that he is still unused to being able to unashamedly look upon someone else's naked form.";
			say "     You aren't unaffected either, your cock stirring in response to the pleasant sight before you. Without speaking, J'Reth lies on his bed face up and you clamber atop him with his impressively-sized erection in front of your mouth, the way it glistens with sweet-smelling precum making your mouth water in anticipation, and your own penis resting on his androgynous face. You feel his long, slender tongue dexterously loop around the head of your cock, collecting the freely flowing pre before slithering back into his mouth to allow him to taste your arousal. Deciding that that is as good a cue to start as any, you lick his shaft from base to tip, your tongue slipping into his genital slit for a moment as you begin, earning you a surprised gasp from your partner, the sensory feedback from this action new to the draco-mantis. You store this knowledge for in future and continue licking his member with enthusiasm that he matches while tending to you, his tongue occasionally tickling at your balls. Not wanting your partner's cunt to be unattended when he is so generously worshipping you, you occassionally break from tasting his cock to kiss his engorged vulva and thrust your tongue into the warm embrace within.";
			WaitLineBreak;
			say "     Soon, as the tempo of mutual oral stimulation increases, licks progress into sucks and the two of you almost seem to be competing as to see who can draw the most moans, gasps, and grunts out of the other. J'Reth's hands clutch your ass, pulling your hips to put more force into your thrusts as your cock slides into his maw and [if cock length of player < 4]over his roiling tongue [else if cock length of player < 7]bumps at the back of his throat [else]into the confines of his throat [end if]each time you hilt. You treat his penis with no less fervor, swirling your tongue around as you inhale an ever increasing amount of it, your gag-reflex non-existent by this point thanks to the help of the nanites. Your hands aren't idle either, swapping between stimulating his clit and pussy lips and massaging the base of his length as the knot begins to swell, signaling his impending orgasm, while the draco-mantis's fingers gently stroke over your balls, making sure not to neglect your orbs while he focuses on your rod. You doubt that you are too far from climax either.";
			say "     Conscious of this fact, you further devote yourself to tasting the sweet flavor that coats J'Reth's cock, audible slurps slipping from between your lips. The draco-mantis, perhaps also sensing your imminent finish, curls his tongue around your shaft and displays the extent of control he has over it by constricting the organ rhythmically. With a euphoric cry, you are sent over the edge, your partner climaxing just after you. Warm jets of sperm splash against the back of J'Reth's throat, his eager swallows squeezing around the head of your penis to goad more out of you. Despite the size of your load, his is noticeably more copious, spilling out of the sides of your mouth despite your attempts to swallow at a rapid pace. Cum pools on his lap and dribbles onto the bed as it drips from your lips and some even trickles from your nose, the sheer volume of semen escaping by any means necessary as it builds up in your mouth and throat, its sweet taste bathing your taste buds and filling your nostrils.";
			WaitLineBreak;
			say "     Eventually, his orgasm subsides and you swallow the last of his cum with a gulp, its flavor likely to cling to your tongue for a while afterwards. Sperm still sticking to your lips and chin, you allow his shaft to slide from your mouth, the unused knot already deflating, and look back over your shoulder at the draco-mantis and give him a jizz-stained smile in a show of gratitude and enjoyment for what has just taken place. As J'Reth releases your own cock from the confines of his throat, the quickly softening organ slips from between his lips and drags across the delicate angles of his face, leaving behind a glistening trail. He doesn't seem to mind, gesturing for you to turn around and lie next to him, a request that is slightly difficult due to the size of bed but nonetheless you comply. Upon being encircled by his arms in a cuddle, you sigh contentedly and relax against him, touched that he still finds such niceties important. Unfortunately, you do not stay like this for long, and after a quick kiss you prepare to continue with your day.";
			NPCSexAftermath player receives "OralCock" from J'Reth;
			NPCSexAftermath J'Reth receives "OralCock" from player;
		else: [female]
			say "     You make the suggestion that he eat you out while you pleasure his cock and pussy so as to maximise your mutual pleasure. J'Reth eagerly nods before rapidly removing the few clothes that he was wearing. You gaze at his chitinous form, admiring the various shades of green over his arms, chest, and groin plates, it is only after he politely coughs that you realize that you aren't giving him a good view of yourself. [if player is naked]Not quite posing, but still shifting into a more revealing posture, you allow his eyes to rove across your body while you do the same to him[else]You teasingly begin to strip, the draco-mantis's hungry eyes roving across your flesh as it is exposed[end if]. Judging from the red shaft that begins to slide from his genital slit, simultaneously revealing his pussy too, he approves of the image in front of him, though the blush spreading across his cheeks suggests that he is still unused to being able to unashamedly look upon someone else's naked form.";
			say "     You aren't unaffected either, your cunt pulsing in response to the pleasant sight before you. Without speaking, J'Reth lies on his bed face up and you clamber atop him with his impressively-sized erection in front of your mouth, the way it glistens with sweet-smelling precum making your mouth water in anticipation, and your pussy resting on his androgynous face. You feel his long, slender tongue dexterously flick at your clit before making a pass over your vulva, collecting the freely flowing wetness before slithering back into his mouth to allow him to taste your arousal. Deciding that that is as good a cue to start as any, you lick his shaft from base to tip, your tongue slipping into his genital slit for a moment as you begin, earning you a surprised gasp from your partner, the sensory feedback from this action new to the draco-mantis. You store this knowledge for in future and continue licking his member with enthusiasm that he matches while tending to you, his tongue making the occasional rapid dart in and out of you. Not wanting your partner's cunt to be unattended when he is so generously worshipping you, you occassionally break from tasting his cock to kiss his engorged vulva and thrust your tongue into the warm embrace within.";
			WaitLineBreak;
			say "     Soon, as the tempo of mutual oral stimulation increases, licks progress into sucks and the two of you almost seem to be competing as to see who can draw the most moans, gasps, and grunts out of the other. J'Reth's hands clutch your ass, pulling your hips against his eager maw to allow his tongue deeper passage inside the confines of your quivering pussy, the soft rush of air from his nostrils tickling at your clit as he inhales your scent. You treat his penis with no less fervor, swirling your tongue around as you inhale an ever increasing amount of it, your gag-reflex non-existent by this point thanks to the help of the nanites. Your hands aren't idle either, swapping between stimulating his clit and pussy lips and massaging the base of his length as the knot begins to swell, signaling his impending orgasm, while the draco-mantis's fingers tenderly stroke over the contours of your ass, the contrast between the vigorous slathering of your vaginal walls by his tongue and the soft brushing of his palms over your buttocks enhancing your arousal. You doubt that you are too far from climax either.";
			say "     Conscious of this fact, you further devote yourself to tasting the sweet flavor that coats J'Reth's cock, audible slurps slipping from between your lips. The draco-mantis, perhaps also sensing your imminent finish, flails his tongue around inside your pussy, the rapid impacts with its walls becoming too much. With a euphoric cry, you are sent over the edge, your partner orgasming just after you. Wet splashes of arousal are expelled from your quivering cunt over your partners eager maw and across his face, his tongue softly crushed within your most intimate passage. Despite the magnitude of your climax, his is noticeably more copious, spilling out of the sides of your mouth despite your attempts to swallow at a rapid pace. Cum pools on his lap and dribbles onto the bed as it drips from your lips and some even trickles from your nose, the sheer volume of semen escaping by any means necessary as it builds up in your mouth and throat, its sweet taste bathing your taste buds and filling your nostrils.";
			WaitLineBreak;
			say "     Eventually, his orgasm subsides and you swallow the last of his cum with a gulp, its flavor likely to cling to your tongue for a while afterwards. Sperm still sticking to your lips and chin, you allow his shaft to slide from your mouth, the unused knot already deflating, and look back over your shoulder at the draco-mantis and give him a jizz-stained smile in a show of gratitude and enjoyment for what has just taken place. As J'Reth retracts his tongue from your subtly shuddering vagina, he is able to redirect its efforts towards cleaning his face of your juices, an activity which it fulfils with gusto. He doesn't seem to mind the mess that has been caused, gesturing for you to turn around and lie next to him, a request that is slightly difficult due to the size of bed but nonetheless you comply. Upon being encircled by his arms in a cuddle, you sigh contentedly and relax against him, touched that he still finds such niceties important. Unfortunately, you do not stay like this for long, and after a quick kiss you prepare to continue with your day.";
			NPCSexAftermath player receives "OralCock" from J'Reth;
			NPCSexAftermath J'Reth receives "OralPussy" from player;
	else: [Female J'Reth]
		if player is herm: [herms]
			say "     You make the suggestion that she pleasure your cock and pussy while you eat her out so as to maximise your mutual pleasure. J'Reth eagerly nods before rapidly removing the few clothes that she was wearing. You gaze at her chitinous form, admiring the various shades of green over her arms, chest, and groin plates, it is only after she politely coughs that you realize that you aren't giving her a good view of yourself. [if player is naked]Not quite posing, but still shifting into a more revealing posture, you allow her eyes to rove across your body while you do the same to her[else]You teasingly begin to strip, the draco-mantis's hungry eyes roving across your flesh as it is exposed[end if]. Judging from the engorging of the lips of her genital slit, she approves of the image in front of her, though the blush spreading across her cheeks suggests that she is still unused to being able to unashamedly look upon someone else's naked form.";
			say "     You aren't unaffected either, your cock stirring and cunt pulsing in response to the pleasant sight before you. Without speaking, J'Reth lies on her bed face up and you clamber atop her with her quivering pussy in front of your mouth, the way it glistens with sweet-smelling juices making your mouth water in anticipation, and your own genitals resting on her feminine face. You feel her long, slender tongue dexterously slither across the lips of your pussy to loop around the head of your cock, collecting the freely flowing pre before slithering back into her mouth to allow her to taste your arousal. Deciding that that is as good a cue to start as any, you lick her slit from bottom to top, your tongue slipping deeply into her for a moment as you begin, earning you a surprised gasp from your partner, the sensory feedback from this action new to the draco-mantis. You store this knowledge for in future and continue licking her cunt with enthusiasm that she matches while tending to you, her tongue occasionally tickling at your balls and clit as she alternates between pleasuring your male and female genitalia.";
			WaitLineBreak;
			say "     Soon, as the tempo of mutual oral stimulation increases, licks progress into sucks and the two of you almost seem to be competing as to see who can draw the most moans, gasps, and grunts out of the other. J'Reth's hands clutch your ass, pulling your hips to put more force into your thrusts as your cock slides into her maw and [if cock length of player < 4]over her roiling tongue [else if cock length of player < 7]bumps at the back of her throat [else]into the confines of her throat [end if]each time you hilt. You treat her pussy with no less fervor, swirling your tongue around as you inhale the aroma of her secretions, juices spreading across your taste buds and filling your mouth with its sweet flavor. Your hands aren't idle either, massaging her clit while spreading her apart to allow your face to further press into her groin, while the draco-mantis's fingers gently stroke over the entrance to your pussy, dipping inside every few seconds to caress your inner walls. You doubt that either of you are far from climax.";
			say "     Conscious of this fact, you further devote yourself to trying to plunge your tongue as far into her tunnel as possible, audible slurps slipping from between your lips. The draco-mantis, perhaps also sensing your imminent finish, curls her tongue around your shaft and displays the extent of control she has over it by constricting the organ rhythmically. With a euphoric cry, you are sent over the edge, your partner climaxing just after you. Warm jets of sperm splash against the back of J'Reth's throat, her eager swallows squeezing around the head of your penis to goad more out of you, while the walls of your cunt pulse around her probing digits. Despite the size of your load, hers is noticeably more copious, splashing across your face and trickling into your mouth, your tongue eagerly searching out as much stray fem-cum as possible. The fluid that you fail to catch pools on her lap, dripping wetly from your lips, its sweet taste bathing your taste buds and filling your nostrils.";
			WaitLineBreak;
			say "     Eventually, her orgasm subsides and you swallow the last of her fem-cum with a gulp, its honey-like flavor likely to cling to your tongue for a while afterwards. Stickiness still present on your lips and chin, you lift your head up and look back over your shoulder at the draco-mantis and give her a smile in a show of gratitude and enjoyment for what has just taken place. As J'Reth releases your cock from the confines of her throat, the quickly softening organ slips from between her lips and drags across the delicate angles of her face, leaving behind a glistening trail. She doesn't seem to mind, gesturing with femcum-stained fingers for you to turn around and lie next to her, a request that is slightly difficult due to the size of bed but nonetheless you comply. Upon being encircled by her arms in a cuddle, you sigh contentedly and relax against her, touched that she still finds such niceties important. Unfortunately, you do not stay like this for long, and after a quick kiss you prepare to continue with your day.";
			NPCSexAftermath player receives "OralPussy" from J'Reth;
			NPCSexAftermath J'Reth receives "OralCock" from player;
		else if player is male: [male]
			say "     You make the suggestion that she suck you off while you eat her out so as to maximise your mutual pleasure. J'Reth eagerly nods before rapidly removing the few clothes that she was wearing. You gaze at her chitinous form, admiring the various shades of green over her arms, chest, and groin plates, it is only after she politely coughs that you realize that you aren't giving her a good view of yourself. [if player is naked]Not quite posing, but still shifting into a more revealing posture, you allow her eyes to rove across your body while you do the same to her[else]You teasingly begin to strip, the draco-mantis's hungry eyes roving across your flesh as it is exposed[end if]. Judging from the engorging of the lips of her genital slit, she approves of the image in front of her, though the blush spreading across her cheeks suggests that she is still unused to being able to unashamedly look upon someone else's naked form.";
			say "     You aren't unaffected either, your cock stirring in response to the pleasant sight before you. Without speaking, J'Reth lies on her bed face up and you clamber atop her with her quivering pussy in front of your mouth, the way it glistens with sweet-smelling juices making your mouth water in anticipation, and your shaft resting on her feminine face. You feel her long, slender tongue dexterously loop around the head of your cock, collecting the freely flowing pre before slithering back into her mouth to allow her to taste your arousal. Deciding that that is as good a cue to start as any, you lick her slit from bottom to top, your tongue slipping deeply into her for a moment as you begin, earning you a surprised gasp from your partner, the sensory feedback from this action new to the draco-mantis. You store this knowledge for in future and continue licking her member with enthusiasm that she matches while tending to you, her tongue occasionally tickling at your balls.";
			WaitLineBreak;
			say "     Soon, as the tempo of mutual oral stimulation increases, licks progress into sucks and the two of you almost seem to be competing as to see who can draw the most moans, gasps, and grunts out of the other. J'Reth's hands clutch your ass, pulling your hips to put more force into your thrusts as your cock slides into her maw and [if cock length of player < 4]over her roiling tongue [else if cock length of player < 7]bumps at the back of her throat [else]into the confines of her throat [end if]each time you hilt. You treat her pussy with no less fervor, swirling your tongue around as you inhale the aroma of her secretions, juices spreading across your taste buds and filling your mouth with its sweet flavor. Your hands aren't idle either, massaging her clit while spreading her apart to allow your face to further press into her groin, while the draco-mantis's fingers gently stroke over your balls, making sure not to neglect your orbs while she focuses on your rod. You doubt that either of you are far from climax.";
			say "     Conscious of this fact, you further devote yourself to trying to plunge your tongue as far into her tunnel as possible, audible slurps slipping from between your lips. The draco-mantis, perhaps also sensing your imminent finish, curls her tongue around your shaft and displays the extent of control she has over it by constricting the organ rhythmically. With a euphoric cry, you are sent over the edge, your partner climaxing just after you. Warm jets of sperm splash against the back of J'Reth's throat, her eager swallows squeezing around the head of your penis to goad more out of you. Despite the size of your load, hers is noticeably more copious, splashing across your face and trickling into your mouth, your tongue eagerly searching out as much stray fem-cum as possible. The fluid that you fail to catch pools on her lap, dripping wetly from your lips, its sweet taste bathing your taste buds and filling your nostrils.";
			WaitLineBreak;
			say "     Eventually, her orgasm subsides and you swallow the last of her fem-cum with a gulp, its honey-like flavor likely to cling to your tongue for a while afterwards. Stickiness still present on your lips and chin, you lift your head up and look back over your shoulder at the draco-mantis and give her a smile in a show of gratitude and enjoyment for what has just taken place. As J'Reth releases your cock from the confines of her throat, the quickly softening organ slips from between her lips and drags across the delicate angles of her face, leaving behind a glistening trail. She doesn't seem to mind, gesturing for you to turn around and lie next to her, a request that is slightly difficult due to the size of bed but nonetheless you comply. Upon being encircled by her arms in a cuddle, you sigh contentedly and relax against her, touched that she still finds such niceties important. Unfortunately, you do not stay like this for long, and after a quick kiss you prepare to continue with your day.";
			NPCSexAftermath player receives "OralPussy" from J'Reth;
			NPCSexAftermath J'Reth receives "OralCock" from player;
		else: [female]
			say "     You make the suggestion that she eat you out while you do the same to her so as to maximise your mutual pleasure. J'Reth eagerly nods before rapidly removing the few clothes that she was wearing. You gaze at her chitinous form, admiring the various shades of green over her arms, chest, and groin plates, it is only after she politely coughs that you realize that you aren't giving her a good view of yourself. [if player is naked]Not quite posing, but still shifting into a more revealing posture, you allow her eyes to rove across your body while you do the same to her[else]You teasingly begin to strip, the draco-mantis's hungry eyes roving across your flesh as it is exposed[end if]. Judging from the engorging of the lips of her genital slit, she approves of the image in front of her, though the blush spreading across her cheeks suggests that she is still unused to being able to unashamedly look upon someone else's naked form.";
			say "     You aren't unaffected either, your cunt pulsing in response to the pleasant sight before you. Without speaking, J'Reth lies on her bed face up and you clamber atop her with her quivering pussy in front of your mouth, the way it glistens with sweet-smelling juices making your mouth water in anticipation, and your vagina resting on her feminine face. You feel her long, slender tongue dexterously flick at your clit before making a pass over your vulva, collecting the freely flowing wetness before slithering back into her mouth to allow her to taste your arousal. Deciding that that is as good a cue to start as any, you lick her slit from bottom to top, your tongue slipping deeply into her for a moment as you begin, earning you a surprised gasp from your partner, the sensory feedback from this action new to the draco-mantis. You store this knowledge for in future and continue licking her member with enthusiasm that she matches while tending to you, her tongue making the occasional rapid dart in and out of you.";
			WaitLineBreak;
			say "     Soon, as the tempo of mutual oral stimulation increases, licks progress into sucks and the two of you almost seem to be competing as to see who can draw the most moans, gasps, and grunts out of the other. J'Reth's hands clutch your ass, pulling your hips against her eager maw to allow her tongue deeper passage inside the confines of your quivering pussy, the soft rush of air from her nostrils tickling at your clit as she inhales your scent. You treat her pussy with no less fervor, swirling your tongue around as you inhale the aroma of her secretions, juices spreading across your taste buds and filling your mouth with its sweet flavor. Your hands aren't idle either, massaging her clit while spreading her apart to allow your face to further press into her groin, while the draco-mantis's fingers tenderly stroke over the contours of your ass, the contrast between the vigorous slathering of your vaginal walls by her tongue and the soft brushing of her palms over your buttocks enhancing your arousal. You doubt that either of you are far from climax.";
			say "     Conscious of this fact, you further devote yourself to trying to plunge your tongue as far into her tunnel as possible, audible slurps slipping from between your lips. The draco-mantis, perhaps also sensing your imminent finish, flails her tongue around inside your pussy, the rapid impacts with its walls becoming too much. With a euphoric cry, you are sent over the edge, your partner orgasming just after you. Wet splashes of arousal are expelled from your quivering cunt over your partners eager maw and across her face, her tongue softly crushed within your most intimate passage. Despite the magnitude of your climax, her is noticeably more copious, splashing across your face and trickling into your mouth, your tongue eagerly searching out as much stray fem-cum as possible. The fluid that you fail to catch pools on her lap, dripping wetly from your lips, its sweet taste bathing your taste buds and filling your nostrils.";
			WaitLineBreak;
			say "     Eventually, her orgasm subsides and you swallow the last of her fem-cum with a gulp, its honey-like flavor likely to cling to your tongue for a while afterwards. Stickiness still present on your lips and chin, you lift your head up and look back over your shoulder at the draco-mantis and give her a smile in a show of gratitude and enjoyment for what has just taken place. As J'Reth retracts her tongue from your subtly shuddering vagina, she is able to redirect its efforts towards cleaning her face of your juices, an activity which it fulfils with gusto. She doesn't seem to mind the mess that has been caused, gesturing for you to turn around and lie next to her, a request that is slightly difficult due to the size of bed but nonetheless you comply. Upon being encircled by her arms in a cuddle, you sigh contentedly and relax against her, touched that she still finds such niceties important. Unfortunately, you do not stay like this for long, and after a quick kiss you prepare to continue with your day.";
			NPCSexAftermath player receives "OralPussy" from J'Reth;
			NPCSexAftermath J'Reth receives "OralPussy" from player;

to say J'RethSex2: [Vaginal]
	say "     Wordlessly, you [if player is not naked]strip [else]caress your sides [end if]before sensually swaying, J'Reth merely standing there in shock at your display, seemingly unused to such treatment. [if player is dominant]Firmly pushing him back so that he sprawls across his bed[else if player is submissive]After meekly asking him to sit on the edge of his bed, a request that he eagerly complies with[else]Gently guiding him to sit on the edge of his bed[end if], you continue your performance, seating yourself on his lap and grinding against his firm form while stroking your hands over his shoulders. You slowly begin to undress him as your hands rove across his body, caresses intermingled with firm tugs to pull the obstructing cloth from where it hides his flesh from your eyes and from contact with your loins. Eventually, after standing up again for a moment to finish stripping him, the draco-mantis is as naked as you are, a hint of red peeking from his genital slit betraying his excitement.";
	say "     Gradually, his shaft is disgorged more and more, the tapering length giving way to the soft swell of a knot near the base, and you lick your lips in anticipation. Dropping to your knees in front of him, you take the eleven inch cock into your mouth, rolling the sweet-tasting precum around on your tongue as you lube him up in preparation for penetration[if thirst of J'Reth is 2], your fingers playing over the entrance to his pussy[end if]. The honeyish fluid emits a pleasant aroma and you inhale deeply with each suck, the combination of olfactory and oral stimulation encouraging you to continue in addition to J'Reth's pleasured murmurings. Despite the incentive that this provides, you release his penis from your mouth with a pop, intent on feeling his pulsing erection plunging into you while you ride him, rolling your tongue around within your mouth as you stand up to ensure that you leave none of his delicious flavor untasted. Placing your hands on the draco-mantis's shoulders, you hover above his shaft, teasing the twitching tip with the lips of your pussy as you prepare to impale yourself.";
	WaitLineBreak;
	say "     J'Reth softly clasps your sides as you push yourself down, his cock filling your cunt and driving a euphoric moan from you[if player is herm] and a spasm from your own penis[end if]. As more and more of its length is swallowed by the cozy embrace of your vagina, your partner's grip becomes tighter until you feel his tip nudge against your cervix, halting its path. You remain still for a moment, enjoying the feel of the draco-mantis's penis throbbing against the shivering walls of your pussy, before slowly lifting your hips, now savoring the sensation of its extraction. As you near fully extracting his member, you plunge back down again, forcing a gasp from J'reth, his fingers squeezing your waist as he recovers from the jolt of pleasure that hilting yourself caused. Gazing at you with momentary infatuation, he leans in for a kiss, his lips locking with yours as you begin to repeatedly impale yourself upon his impressive length. The competing sensations of his tongue exploring your mouth, his hands caressing your backside, and his shaft slipping within you cause you to let out a deep moan that is stifled within his mouth.";
	say "     You feel J'Reth's lips move as he smiles at your response, taking a more active role in your coupling and increasing the force of his thrusts in an effort to make you emit more such sounds of pleasure, a mission with which you comply, expressing your satisfaction without shame or concern for who might hear. As you get closer to completion, he is almost lifting you up only to slam himself back into you as he lets you go, eventually sending you over the edge into climax from the excitement and vigor of your lovemaking. The constriction of your walls [if player is herm]and the splash of your load against his chest[end if] causes the draco-mantis to orgasm as well, letting out almost a roar as he knots you and begins to paint your womb white with his seed, the excess cum unable to escape past the engorged bulb at the base of his shaft, instead causing your tummy to round and bulge as it makes room for the deluge of fluid[if thirst of J'Reth is 2]. Beneath you, you can feel his pussy pulsing in time with the squirt of his semen, his inner walls no doubt aching for something to be filling him[end if].";
	WaitLineBreak;
	say "     The two of you remain locked in an embrace while you wait for his knot to deflate and the inevitable flood of cum that will follow, J'Reth making the most of the time to stroke your exposed flesh tenderly and whisper words of gratitude in your ear. Eventually, with a load slurp, a gush of white liquid spills from your pussy, most of it spilling over the side of his mattress to pool on the floor, though a considerable amount soaks into the bedding instead. Now able to escape, the semen that was previously stretching your tummy rushes out too, coating both yours and J'Reth's thighs, exiting your body and speed from the buildup of pressure and allowing your stomach to return to its normal shape. Extricating yourself off of the draco-mantis's lap, you look down at the mess and wonder who is going to clean it up. 'Don't worry, there is a cleaning crew that is used to this sort of thing,' J'Reth murmurs blissfully, as though he read your mind. 'I wouldn't mind doing that again, when you're up for it.' Tidying yourself up, you give him a smirk and tell him that you'll think about it, receiving a soft chuckle in reply.";
	NPCSexAftermath player receives "PussyFuck" from J'Reth;

to say J'RethSex3: [Catch Anal]
	say "     Deciding that you feel like letting J'Reth have a turn penetrating you anally, you inform him of your desire and wait for his reaction. He seems noticeably pleased with the suggestion and after nodding his head eagerly, if slightly tinged with shyness, and steps up behind you. With one hand he caresses your shoulder, its fingers lightly dancing across [if player is naked]your skin, while the other cups the curvature of your backside, a stray digit slipping inwards to brush over your rear entrance before retreating again[else]your back, while the other cups the curvature of your backside, a stray digit slipping inwards to brush the general area of your rear entrance through your clothes before he focuses his attention on disrobing you. Soon you are completely stripped[end if]. He doesn't seem to be in the mood for a striptease either, hastily pulling his t-shirt over his head and pulling his trousers off before pressing himself against you.";
	say "     J'Reth quickly embraces you, almost nuzzling you before lightly pushing down on your shoulders to indicate he would like you to kneel. Mildly amused that he seems to have lost the ability to speak, you nonetheless comply, watching as his tapered shaft slides from the safety of his genital slit right in front of your face, glistening and red. You can already see the slight swell of where the knot will be at the base and tentatively trace your finger down the length, a thin film of lubricating fluid coating it[if thirst of J'Reth is 2], before ypu continue down to brush across the entrance to his pussy[end if]. It would seem that you aren't going to be requiring much lube beyond a little saliva. A fine bead of pre beads on the tip of the draco-mantis's penis and you can already smell the sweet scent wafting from it, compelling you to at least give it a lick before it is lost in your bowels, a compulsion that you eagerly fulfil. You hear J'Reth sigh as you plunge his shaft into your mouth, but are surprised when he gently guides you back off again. 'I don't think that I'll last long enough for that,' he apologizes as he turns you around and presses you face down over the edge of his bed before stepping behind you and aligning his sizable cock with your anus.";
	WaitLineBreak;
	if player is herm: [herms]
		say "     Grasping a cheek of your ass in each hand, the draco-mantis pulls them apart, spreading your hole, as he pushes into you with little effort, the copious sweet-smelling lubricant that covers his penis allowing entry without any pain. As he steadily slides deeper into your bowels, a feeling of fullness unsurprisingly grows and your pussy leaks a slight trickle of arousal while your erection jumps with enough force to slap against your tummy. After completely hilting in you in one push, J'Reth releases your buttocks and grasps your shaft with one hand while the other lightly holds your shoulder to improve the force of his thrusts. Barely waiting more than a second, he begins to plunge in and out of you, masturbating you in time with his movements while the grip on your shoulder tightens with each thrust in, and relaxes as he withdraws again. Soon he has a steady rhythm, grunting into your ear each time his groin slaps against your pelvis, his breath washing across your face as he exhales with exertion.";
		say "     Seized by passion, J'Reth leans forward, his thrusts slowing, and seizes your mouth in a deep kiss, his tongue swirling with yours and playing across your teeth before he pulls back again to return his focus to plunging into you. Perhaps making up for this brief pause or maybe due to his approaching orgasm, he increases the tempo of his rutting, the change of pace causing you to enthusiastically moan loud enough that you are unsure if those outside the room will be able to hear you. Between the kiss and the draco-mantis suddenly tightening his grip on your shaft, you suddenly feel yourself cresting into climax, barely managing to gasp out a warning to your partner. Your words fall on deaf ears as, with an especially sharp thrust, J'Reth rams his knot past your squeezing sphincter and begins to ejaculate, the two of you squirting your cum in sync. While his sperm pools in your anal passage, your own splatters across his hand and upon the floor beneath his bed, juices from your female genitalia dribbling down your leg as your cunt strongly pulses[if thirst of J'Reth is 2], a trickle of J'Reth's excitement mingling with it as it escapes from his pussy freely[end if].";
		WaitLineBreak;
		say "     While your orgasm ends after several moments, the draco-mantis continues to shoot more and more semen into your bowels, the pressure beginning to cause your tummy to distend slightly as his knot prevents it escaping that way. Despite this, the feeling of just lying there being filled up while a firm body is pressed against you is surprisingly comforting and you merely relax and wait for his climax to subside. After what feels like twenty minutes, the bulge at the base of his cock deflates enough for him to pull out, the withdrawal of his tapered penis swiftly followed by a deluge of cum that flows across the floor around your knees. Looking at the spreading pool of cream, you wonder who is going to deal with it. 'I'm going to have to get the cleaning crew in here again,' J'Reth sighs, as he helps you to your feet. 'Despite the mess, I would be more than happy to have you bent over my bed again.' Tidying yourself up, you give him a quick hug and tell him that you'll have to take him up on that another time, receiving a tender kiss on your forehead as you prepare to leave.";
	else if player is male: [male]
		say "     Grasping a cheek of your ass in each hand, the draco-mantis pulls them apart, spreading your hole, as he pushes into you with little effort, the copious sweet-smelling lubricant that covers his penis allowing entry without any pain. As he steadily slides deeper into your bowels, a feeling of fullness unsurprisingly grows and your own erection jumps with enough force to slap against your tummy, your balls clenching reflexively. After completely hilting in you in one push, J'Reth releases your buttocks and grasps your shaft with one hand while the other lightly holds your shoulder to improve the force of his thrusts. Barely waiting more than a second, he begins to plunge in and out of you, masturbating you in time with his movements while the grip on your shoulder tightens with each thrust in, and relaxes as he withdraws again. Soon he has a steady rhythm, grunting into your ear each time his groin slaps against your pelvis, his breath washing across your face as he exhales with exertion.";
		say "     Seized by passion, J'Reth leans forward, his thrusts slowing, and seizes your mouth in a deep kiss, his tongue swirling with yours and playing across your teeth before he pulls back again to return his focus to plunging into you. Perhaps making up for this brief pause or maybe due to his approaching orgasm, he increases the tempo of his rutting, the change of pace causing you to enthusiastically moan loud enough that you are unsure if those outside the room will be able to hear you. Between the kiss and the draco-mantis suddenly tightening his grip on your shaft, you suddenly feel yourself cresting into climax, barely managing to gasp out a warning to your partner. Your words fall on deaf ears as, with an especially sharp thrust, J'Reth rams his knot past your squeezing sphincter and begins to ejaculate, the two of you squirting your cum in sync. While his pools in your anal passage, your own splatters across his hand and upon the floor beneath his bed[if thirst of J'Reth is 2], a trickle of juices from J'Reth's pussy trickling down the back of your thigh as his cunt pulses in time with his shaft[end if].";
		WaitLineBreak;
		say "     While your orgasm ends after several moments, the draco-mantis continues to shoot more and more semen into your bowels, the pressure beginning to cause your tummy to distend slightly as his knot prevents it escaping that way. Despite this, the feeling of just lying there being filled up while a firm body is pressed against you is surprisingly comforting and you merely relax and wait for his climax to subside. After what feels like twenty minutes, the bulge at the base of his cock deflates enough for him to pull out, the withdrawal of his tapered penis swiftly followed by a deluge of cum that flows across the floor around your knees. Looking at the spreading pool of cream, you wonder who is going to deal with it. 'I'm going to have to get the cleaning crew in here again,' J'Reth sighs, as he helps you to your feet. 'Despite the mess, I would be more than happy to have you bent over my bed again.' Tidying yourself up, you give him a quick hug and tell him that you'll have to take him up on that another time, receiving a tender kiss on your forehead as you prepare to leave.";
	else if player is female: [female]
		say "     Grasping a cheek of your ass in each hand, the draco-mantis pulls them apart, spreading your hole, as he pushes into you with little effort, the copious sweet-smelling lubricant that covers his penis allowing entry without any pain. As he steadily slides deeper into your bowels, a feeling of fullness unsurprisingly grows and your pussy leaks a slight trickle of arousal, only a thin wall separating his erection from passage to your womb. After completely hilting in you in one push, J'Reth releases your buttocks and holds your shoulder with one hand to improve the force of his thrusts while the other begins to play with your vulva, alternating between tweaking the clit and fingering you. Barely waiting a second, he begins to plunge in and out of you, masturbating you in time with his movements while the grip on your shoulder tightens with each thrust in and relaxes as he withdraws again. Soon he has a steady rhythm, grunting into your ear each time his groin slaps against your pelvis, his breath washing across your face as he exhales with exertion.";
		say "     Seized by passion, J'Reth leans forward, his thrusts slowing, and seizes your mouth in a deep kiss, his tongue swirling with yours and playing across your teeth before he pulls back again to return his focus to plunging into you. Perhaps making up for this brief pause or maybe due to his approaching orgasm, he increases the tempo of his rutting, the change of pace causing you to enthusiastically moan loud enough that you are unsure if those outside the room will be able to hear you. Between the kiss and the draco-mantis suddenly tightening his grip on your shaft, you suddenly feel yourself cresting into climax, barely managing to gasp out a warning to your partner. Your words fall on deaf ears as, with an especially sharp thrust, J'Reth rams his knot past your squeezing sphincter and begins to ejaculate, the two of you orgasming in sync. While his cum pools in your anal passage, your cunt pulses, spraying juices past his slackened fingers to splash upon the floor beneath you[if thirst of J'Reth is 2], a trickle of juices from J'Reth's pussy trickling down the back of your thigh as it contracts in time with his shaft[end if].";
		WaitLineBreak;
		say "     While your pussy settles to merely quivering after several moments, the draco-mantis continues to shoot more and more semen into your bowels, the pressure beginning to cause your tummy to distend slightly as his knot prevents it escaping that way. Despite this, the feeling of just lying there being filled up while a firm body is pressed against you is surprisingly comforting and you merely relax and wait for his climax to subside. After what feels like twenty minutes, the bulge at the base of his cock deflates enough for him to pull out, the withdrawal of his tapered penis swiftly followed by a deluge of cum that flows across the floor around your knees. Looking at the spreading pool of cream, you wonder who is going to have to deal with it. 'I'm going to have to get the cleaning crew in here again,' J'Reth sighs, as he helps you to your feet. 'Despite the mess, I would be more than happy to have you bent over my bed again.' Tidying yourself up, you give him a quick hug and tell him that you'll have to take him up on that another time, receiving a tender kiss on your forehead as you prepare to leave.";
	else: [neuter]
		say "     Grasping a cheek of your ass in each hand, the draco-mantis pulls them apart, spreading your hole, as he pushes into you with little effort, the copious sweet-smelling lubricant that covers his penis allowing entry without any pain. As he steadily slides deeper into your bowels, a feeling of fullness unsurprisingly grows and a numb feeling spreads from your featureless groin. After completely hilting in you in one push, J'Reth releases your buttocks and instead lightly holds your shoulders to improve the force of his thrusts. Barely waiting more than a second, he begins to plunge in and out of you, the grip on your shoulders tightens with each thrust in, and relaxes as he withdraws again. Soon he has a steady rhythm, grunting into your ear each time his groin slaps against your pelvis, his breath washing across your face as he exhales with exertion.";
		say "     Seized by passion, J'Reth leans forward, his thrusts slowing, and seizes your mouth in a deep kiss, his tongue swirling with yours and playing across your teeth before he pulls back again to return his focus to plunging into you. Perhaps making up for this brief pause or maybe due to his approaching orgasm, he increases the tempo of his rutting, the change of pace causing you to enthusiastically moan loud enough that you are unsure if those outside the room will be able to hear you. Between the kiss and the draco-mantis suddenly tightening his grip on your shaft, you suddenly feel yourself cresting into climax, barely managing to gasp out a warning to your partner. Your words fall on deaf ears as, with an especially sharp thrust, J'Reth rams his knot past your squeezing sphincter and begins to ejaculate, flooding your anal passage with his cum while your loins shiver despite your absence of genitals[if thirst of J'Reth is 2], a trickle of juices from J'Reth's pussy trickling down the back of your thigh as his cunt pulses in time with his shaft[end if].";
		WaitLineBreak;
		say "     While your orgasm ends after several moments, the draco-mantis continues to shoot more and more semen into your bowels, the pressure beginning to cause your tummy to distend slightly as his knot prevents it escaping that way. Despite this, the feeling of just lying there being filled up while a firm body is pressed against you is surprisingly comforting and you merely relax and wait for his climax to subside. After what feels like twenty minutes, the bulge at the base of his cock deflates enough for him to pull out, the withdrawal of his tapered penis swiftly followed by a deluge of cum that flows across the floor around your knees. Looking at the spreading pool of cream, you wonder who is going to deal with it. 'I'm going to have to get the cleaning crew in here again,' J'Reth sighs, as he helps you to your feet. 'Despite the mess, I would be more than happy to have you bent over my bed again.' Tidying yourself up, you give him a quick hug and tell him that you'll have to take him up on that another time, receiving a tender kiss on your forehead as you prepare to leave.";
	NPCSexAftermath player receives "AssFuck" from J'Reth;

to say J'RethSex4: [Pitch Anal]
	if thirst of J'Reth is 3: [female]
		say "     Eager to sink your cock into something, you [if player is dominant]tell J'Reth that she should prepare you so that you can pound her ass, the draco-mantis blushing at your authoritative tone but nonetheless complying with enthusiasm[else if player is submissive]ask whether J'Reth would mind if you penetrated her ass, the draco-mantis stepping close to you and tenderly stroking the side of your face affectionately before whispering her consent[else]make the suggestion that she lie back and allow you easy access to her ass so that you can more easily thrust into it, the draco-mantis squirming in anticipation as she happily nods her head in agreement[end if]. She strips with little ceremony though you get a chance to appreciate her body when she bends over to pull her trousers off, delicate curves and slight musculature combining across her exotic form. [if player is naked]Not having any need to disrobe, you stand there for a moment longer, allowing your eyes to roam over her scales until J'Reth shakes her ass at you teasingly, having noticed your attention[else]Realising that you should probably get ready too, you quickly disrobe in time to watch J'Reth shake her ass at you teasingly[end if], bringing a smile to your face. Now completely bare, the draco-mantis reclines on her bed, doing her best to look sexy and inviting, an effort that is improved by the almost pleading look from her blue eyes and the steady moistening of her pussy, the liquid flowing from her genital slit and trickling across her anus, preparing it for you.";
		say "     Deciding that you've waited long enough, you clamber onto the bed beside her, the mattress sinking under your combined weight. You trace a finger over J'Reth's jaw, down her neck, across the slight swell of her chest, and descending until stopping as your digit comes into contact with the base of her leaking pussy, your finger being coated in her juices. Looking her in the eye, you sensually suck the sweet-tasting fluid from your finger, making a show of using your tongue. Between your saliva and the copious flow of arousal from her genital slit, you make a passable lubricant that you gratuitously smear over her winking sphincter, slipping a finger inside to make sure that she is completely slickened in preparation for what is coming next, earning a gasp from your partner. Spreading her legs and pushing her shins up towards her stomach, you align your cock with her anus, rubbing the tip up and down teasingly while you watch her bite her lip impatiently while she waits for you to fill her.";
		WaitLineBreak;
		say "     'Just put it in. Please! Fill me with your cock!' J'Reth pleads, shaking her bottom as well as she can in this position. [if player is dominant]Grinning at her submission[else if player is submissive]Startled at your momentary dominance[else]Touched by her eagerness[end if], you lean over top of her and sink your shaft into the warm grip of her ass, causing the draco-mantis to release a relieved moan as her anal walls squeeze around your invading rod. As her anus is already slippery, you are able to thrust fairly quickly immediately without need of much warmup after having teased her. Each time your balls slap against her ass, a small gasp erupts from her mouth and a fresh stream of pussy-juice flows from her neglected vagina, smearing acros your groin. J'Reth is obviously enjoying this, the occasional request for you to go harder or exclamations of pleasure filling the room for all of her figurines to hear. You do your best to accede to her wishes in order to maximise her enjoyment as much as your own, as well as intermittently brushing her genital slit or slipping a finger inside, even managing to feel your shaft through the thin wall of flesh dividing the two passages.";
		say "     Before long, J'Reth seizes your arm in a firm grip and meets your eyes, signaling her imminent orgasm and encouraging you to focus on reaching your own. Increasing the pace of your thrusts, your behavior becomes more like that of a wild animal, breathing heavily and rutting with an almost single-minded vigor into the euphoric draco-mantis who lies there letting out a continuous low moan of ecstasy while you hammer into her. As you are about to reach climax, you lean forward and kiss your partner deeply as you[if player is knotted]force your knot past her battered sphincter to lock yourself inside as[else]press yourself one last time into her before[end if]you begin to fill her bowels with your sperm. The sensation of your semen spraying against the walls of her bowels causes J'Reth to orgasm too, her body fiercely shuddering and a honey-scented spray of fem-cum splashes against your chest and tummy, the draco-mantis lost in repeating waves of euphoria.";
		WaitLineBreak;
		say "     J'Reth continues to quiver and sigh even after your climx has come to an end, your spent shaft spasming slightly within the embrace of her anal walls. Soon her mattress is soaked in her sweet-smelling juices as she finally begins to recover from her intense extended orgasm. The scent is strangely relaxing as you lie on top of her[if player is knotted] and wait for your knot to deflate[end if], feeling the draco-mantis stir reluctnantly against your body, the interval between anal spasms extending. After several minutes it finally ends and you pull out, followed by a steady trickle of semen from her twitching anus. As you watch J'Reth almost bathing in her own emission, you pity the person who is going to clean up after her. 'Don't worry about the mess, I have an arrangement with the cleaning staff. Not a sexual arrangement, but an arrangement nonetheless,' she says as she snuggles against you, blushing as you raise an eyebrow at her response. Unfortunately, you can't stay like this for long and you reluctantly get ready to continue with your day, though J'Reth teasing her leaking ass at you doesn't make it any easier. It would seem that she enjoyed being beneath you.";
	else: [male or herm]
		say "     Eager to sink your cock into something, you [if player is dominant]tell J'Reth that he should prepare you so that you can pound his ass, the draco-mantis blushing at your authoritative tone but nonetheless complying with enthusiasm[else if player is submissive]ask J'Reth whether he would mind letting you have a turn penetrating his ass, the draco-mantis stepping close to you and tenderly stroking the side of your face affectionately before whispering his consent[else]make the suggestion that he lie back and allow you to breed his ass, the draco-mantis squirming in anticipation as he happily nods his head in agreement[end if]. He strips with little ceremony though you get a chance to appreciate his body when he bends over to pull his trousers off, delicate curves and slight musculature combining across his exotic form. [if player is naked]Not having any need to disrobe, you stand there for a moment longer, allowing your eyes to roam over his scales until J'Reth shakes his ass at you teasingly, having noticed your attention[else]Realising that you should probably get ready too, you quickly disrobe in time to watch J'Reth shake his ass at you teasingly[end if], bringing a smile to your face. Now completely bare, the draco-mantis reclines on his bed, doing his best to look sexy and inviting, an effort that is improved by the almost pleading look from his blue eyes and the growing pillar of scarlet sliding from between his legs.";
		say "     Deciding that you've waited long enough, you clamber onto the bed beside him, the mattress sinking under your combined weight. You trace a finger over J'Reth's jaw, down his neck, across his chest and descending until stopping as your digit comes into contact with his throbbing manhood, a sticky bead of pre being transferred from his tip to your finger. Looking him in the eye, you sensually suck the sweet-tasting fluid from your finger, making a show of using your tongue. With how much he seems to be leaking, you collect some on your hand before smearing it over his winking sphincter, slipping a finger inside to make sure that he is completely lubed up in preparation for what is coming next, earning a gasp from your partner. Spreading his legs and pushing his shins up towards his stomach, you align your cock with his anus, rubbing the tip up and down teasingly while you watch him bite his lip impatiently while he waits for you to fill him.";
		WaitLineBreak;
		say "     'Just put it in. Please! Fill me with your cock!' J'Reth pleads, shaking his bottom as well as he can in this position. [if player is dominant]Grinning at his submission[else if player is submissive]Startled at your momentary dominance[else]Touched by his eagerness[end if], you lean over top of him and sink your shaft into the warm grip of his ass, causing the draco-mantis to release a relieved moan as his anal walls squeeze around your invading rod. As his anus is already slippery, you are able to thrust fairly quickly immediately without need of much warmup after having teased him. Each time your balls slap against his ass, a small jet of pre spurts from his penis and splatters across his chest, soon making quite a mess on his green scales and chitin. J'Reth is obviously enjoying this, the occasional request for you to go harder or exclamations of pleasure filling the room for all of his figurines to hear. You do your best to accede to his wishes in order to maximise his enjoyment as much as your own, as well as intermittently brushing his genital slit or rubbing his cock as you see fit.";
		say "     Before long, the pre drizzling from J'Reth's cock becomes thicker and more copious, signaling his imminent orgasm and encouraging you to focus on reaching your own. Increasing the pace of your thrusts, your behavior becomes more like that of a wild animal, breathing heavily and rutting with an almost single-minded vigor into the euphoric draco-mantis who lies there letting out a continuous low moan of ecstasy while you hammer into him. As you are about to reach climax, you lean forward and kiss your partner deeply as you[if player is knotted]force your knot past his battered sphincter to lock yourself inside as[else]press yourself one last time into him before[end if]you begin to fill his bowels with your sperm. The sensation of your semen spraying against his walls causes J'Reth to orgasm too, healthy spurts of cum splattering across his chest, face, and pillows[if thirst of J'Reth is 2], as well as a healthy gush of fem-cum from his vagina[end if].";
		WaitLineBreak;
		say "     The draco-mantis continues to shoot his load even after your climax has come to an end, your spent shaft spasming slightly within the embrace of his anal walls. Soon his mattress is soaked in cum too and he seems to be lying in a veritable flood of semen, though the sweet-scent is strangely relaxing and you lie on top of him as you wait for him to finish[if player is knotted]and for your knot to deflate as well[end if], feeling the slowly weakening pulses of his cock against your tummy. After several minutes it finally ends and you pull out, followed by a steady trickle of your own semen from his twitching anus. As you watch J'Reth almost bathing in his own emission, you pity the person who is going to clean up after him. 'Don't worry about the mess, I have an arrangement with the cleaning staff. Not a sexual arrangement, but an arrangement nonetheless,' he says as he snuggles against you, blushing as you raise an eyebrow at his response. Unfortunately, you can't stay like this for long and you reluctantly get ready to continue with your day, though J'Reth teasing his leaking ass at you doesn't make it any easier. It would seem that he enjoyed being anally bred.";
	NPCSexAftermath J'Reth receives "AssFuck" from player;

to say J'RethSex5: [Take Virginity, Missionary]
	say "     Considering the unsullied state of [PosAdj of J'Reth] hymen, you hesitantly ask J'Reth whether [SubjectPro of J'Reth] would allow you to take his vaginal virginity. A blush spreads across [PosAdj of J'Reth] face as [SubjectPro of J'Reth] considers it, [PosAdj of J'Reth] claws tapping against [PosAdj of J'Reth] leg in a show of nerves. Eventually, [SubjectPro of J'Reth] seems to come to a decision and looks you in the eye before hesitantly saying, 'Ok. But I want it to be special, not just a few frantic humps against the wall. On the condition that we make love rather than merely fuck, I will gladly allow you to be [if thirst of J'Reth is 2]the one to pierce my hymen[else if thirst of J'Reth is 3]my first as a woman[end if]. Just be gentle and show that I actually mean something to you beyond being just another person in the city that you have sex with.' You quickly reassure [ObjectPro of J'Reth] that you care about [ObjectPro of J'Reth] for who [SubjectPro of J'Reth] is, not just for the potential to sexually pleasure you. [SubjectProCap of J'Reth] gives a grateful smile before lying back on the bed. 'Come. Join me, and let us make love.'";
	say "     Eager to accept this invitation, you [if player is naked]join [ObjectPro of J'Reth] on the bed without any delay, tracing a finger up [PosAdj of J'Reth] side as you settle into [PosAdj of J'Reth] embrace[else]sensually remove your clothes, making sure to give [ObjectPro of J'Reth] a show before you join [ObjectPro of J'Reth] on the bed[end if]. As [SubjectPro of J'Reth] presses you into [ObjectPro of J'Reth] side, you can feel [ObjectPro of J'Reth] quivering and [SubjectPro of J'Reth] rapid heartbeat. Despite the sincerity of [PosAdj of J'Reth] attraction to you, it would seem that [ObjectPro] is still nervous. In the hopes of remedying this, you press your lips against hers and tenderly kiss her, your tongue and hers touching only for a moment before you pull away again and gaze into hers widened eyes as you inform her of how special she is to you and that you will make sure to make sure that she remembers losing her virginity to you as enjoyable and passionate. With a determined nod, she allows her hands to begin exploring your body as your do the same to her, tender touches stoking your lust and readying you both for your intimacy to deepen.";
	WaitLineBreak;
	if thirst of J'Reth is 2:
		say "     Between J'Reth's legs, a red tapered shaft begins to emerge from his genital slit even as the lips part further to reveal the pussy inside as well, your ministrations exciting his body while your whispers do the same for his mind. Your thumb brushes over his dripping cunt while your fingers collect the copious pre that leaks from the tip of his cock, covering your digits in further lubricant to ease penetration when you decide to take his virginity. You can feel his palms pressing against your back and holding you more tightly against him, his claws scratching your skin in response to the emotions and sensations coursing through his body as the passion intensifies between the two of you. With the amount of precum slathered across your fingers, you decide that you should probably move on from foreplay or else you risk the draco-mantis climaxing before you've had a chance to make love to him properly.";
		say "     After smearing the slick fluid across the lips of J'Reth's pussy as well as slipping some inside to ensure comfortable penetration, you align the tip of your penis with the engorged entrance to his vagina. He stifles a moan by kissing you deeply again, a hand tightly gripping your shoulder, before pulling his face away again and looking you in the eye with need. 'Do it,' he whimpers, pleading for you to thrust into him. With one last glance to be sure, you slowly ease yourself into the tight embrace of the draco-mantis['] cunt, the walls twitching around you as your tip intrudes farther into the unspoilt passage of his womanhood until it eventually bumps up against a thin membrane, eliciting a hiss of discomfort from your partner. Before you have a chance to ask whether you should carry on, J'Reth gives a quick nod, eager for the initial penetration to be over so that you can commence your lovemaking with feeling rather than caution.";
		WaitLineBreak;
		say "     In the hopes that it may soothe some of the pain, you reach a hand between your bodies and take a firm hold of the herm's dribbling cock and slowly begin to rub it up and down as you prepare for the short stab that will pierce his hymen. As J'Reth lets out a pleasured moan, you thrust forward, claiming his virginity and plunging unimpeded deeper into his pussy. While you hear your partner stifle a grunt of pain, his leg pressing against your backside urges you to continue, so you gently maintain the pace of thrusts into the draco-mantis, exchanging tender kisses and caressing his body with one hand while the other plays across the slick surface of his penis to ensure that pleasure is felt throughout his body rather than being overwhelmed by the sharp sting of his virginity being claimed. Eventually, J'Reth whispers in your ear, 'Faster please. You're being kind, but I want to feel your passion.' It would seem that he wants the squeak of the bedsprings to join the chorus of flesh-slapping and moans.";
		say "     Releasing his shaft so that you can take a stronger grip on his sides with both hands, you accelerate your thrusts, trying to vary the angle of entry so that no part of the passage between you and his womb is left untouched, the draco-mantis['] cries becoming more frequent and louder. You doubt that there will be many people nearby that cannot hear him, but this moment is about your partner, not the other residents of the mall. J'Reth's legs seem to be splaying out further and further as you plunge your cock into him, the tenderness of before having given way to passion and zeal, though his shouts of encouragement suggest that he doesn't seem to have any problem at all with this development and perhaps even relishes the emotion behind your pounding into his pussy. By the increasing volume of the squelching and splashing as your groins meet, J'Reth isn't far from orgasm, though neither are you if the tightening feeling in your groin is anything to go by.";
		WaitLineBreak;
		say "     With a euphoric wail, J'Reth climaxes. Messily. The walls of his vagina shudder before clamping and releasing around your cock in rapid alternation, the firm caress causing you to cum and milking you so that your semen bathes J'Reth's womb. At the same time, prodigious jets of cum erupt from the draco-mantis['] turgid shaft, splattering across your chests, chins, and bathing his walls and bed in his sweet-smelling essence (though you doubt that this is the first time). Surprisingly, J'Reth shows little compunction for collecting his own goop, swallowing it after his tongue slithers across his face and breast, making you smirk tiredly at his innocent enthusiasm before leaning in for a kiss, unconcerned by the milky shine across his lips. In contrast to the recent passion that he displayed, the draco-mantis is distinctly gentle and loving with his kiss, a hand cupping the side of your face and stroking as you smooch. 'I'm assuming that you have to leave again?' J'Reth asks as he breaks away, his eyes shining with affection. You reluctantly affirm this but reassure him that you'll be back again when you can. He leans in and gives you a quick hug. 'Be careful out there. You mean a lot to me.' As you depart, you think to yourself how attached the draco-mantis has become to you.";
	else if thirst of J'Reth is 3:
		say "     Between J'Reth's legs the lips of her pussy begin to swell, parting her genital slit and revealing the soft pinkness within, your ministrations exciting her body while your whispers do the same for her mind. Your thumb brushes over her dripping cunt while your fingers trace the outside of her pudenda collecting the copious juices that drool from her aroused cunt to use as a lubricant so that penetration will be easier when you decide to take her virginity. You can feel her palms pressing against your back and holding you more tightly against her, her claws scratching your skin in response to the emotions and sensations coursing through her body as the passion intensifies between the two of you. With the amount of fluid slathered across your fingers, you decide that you should probably move on from foreplay or else you risk the draco-mantis climaxing before you've had a chance to make love to her properly.";
		say "     After smearing the slick fluid across the lips of J'Reth's pussy as well as slipping some inside to ensure comfortable penetration, you align the tip of your penis with the engorged entrance to her vagina. She stifles a moan by kissing you deeply again, a hand tightly gripping your shoulder, before pulling her face away again and looking you in the eye with need. 'Do it,' she whimpers, pleading for you to thrust into her. With one last glance to be sure, you slowly ease yourself into the tight embrace of the draco-mantis['] cunt, the walls twitching around you as your tip intrudes farther into the unspoilt passage of her womanhood until it eventually bumps up against a thin membrane, eliciting a hiss of discomfort from your partner. Before you have a chance to ask whether you should carry on, J'Reth gives a quick nod, eager for the initial penetration to be over so that you can commence your lovemaking with feeling rather than caution.";
		WaitLineBreak;
		say "     In the hopes that it may alleviate some of the pain, you reach a hand between your bodies and gently stroke the distended flesh above where your genitals meet, one finger brushing her clitoris while the rest soothe the stretched lips around your cock as you prepare for the short stab that will pierce her hymen. As J'Reth lets out a pleasured moan, you thrust forward, claiming her virginity and plunging unimpeded deeper into her pussy. While you hear your partner stifle a grunt of pain, her leg pressing against your backside urges you to continue, so you gently maintain the pace of thrusts into the draco-mantis, exchanging tender kisses and caressing her body with one hand while the other plays across the slick surface around where your bodies join to ensure that pleasure is felt throughout her body rather than being overwhelmed by the sharp sting of her virginity being claimed. Eventually, J'Reth whispers in your ear, 'Faster please. You're being kind, but I want to feel your passion.' It would seem that she wants the squeak of the bedsprings to join the chorus of flesh-slapping and moans.";
		say "     Withdrawing your fingers from pleasuring her clit, you take a stronger grip on her sides with both hands and accelerate your thrusts, trying to vary the angle of entry so that no part of the passage between you and her womb is left untouched, the draco-mantis['] cries becoming more frequent and louder. You doubt that there will be many people nearby that cannot hear her, but this moment is about your partner, not the other residents of the mall. J'Reth's legs seem to be splaying out further and further as you plunge your cock into her, the tenderness of before having given way to passion and zeal, though her shouts of encouragement suggest that she doesn't seem to have any problem at all with this development and perhaps even relishes the emotion behind your pounding into her pussy. By the increasing volume of the squelching and splashing as your groins meet, J'Reth isn't far from orgasm, though neither are you if the tightening feeling in your groin is anything to go by.";
		WaitLineBreak;
		say "     With a euphoric wail, J'Reth climaxes. Messily. The walls of his vagina shudder before clamping and releasing around your cock in rapid alternation, the firm caress causing you to cum and milking you so that your semen bathes J'Reth's womb. At the same time, prodigious jets of fem-cum spray out around your shaft, splashing across your hips, legs, and splattering her walls and bed with her sweet-smelling essence (though you doubt that this is the first time). Surprisingly, J'Reth shows little compunction for collecting her own juices, dragging a finger through it before licking it off with her nimble tongue, making you smirk tiredly at her innocent enthusiasm before leaning in for a kiss, unconcerned by the sticky shine across her lips. In contrast to the recent passion that she displayed, the draco-mantis is distinctly gentle and loving with her kiss, a hand cupping the side of your face and stroking as you smooch. 'I'm assuming that you have to leave again?' J'Reth asks as she breaks away, her eyes shining with affection. You reluctantly affirm this but reassure her that you'll be back again when you can. She leans in and gives you a quick hug. 'Be careful out there. You mean a lot to me.' As you depart, you think to yourself how attached the draco-mantis has become to you.";
	NPCSexAftermath J'Reth receives "PussyFuck" from player;

to say J'RethSex6: [Vaginal, Against wall]
	if thirst of J'Reth is 2: [herm]
		say "     Stepping close to J'Reth, you lean in and whisper that you want to press him against the wall and shoot your load in his pussy. Your dirty talking seems to have quite the effect on the usually soft-spoken draco-mantis, his cheeks turning scarlet even as you feel his shaft emerge from his genital slit, escaping from his trousers and into your awaiting hand, the wetness below it suggesting that his female genitals are just as excited as the rest of him even if he is embarrassed. Taking pity on him for your crude proposition, you cup the back of his head and move forward to passionately kiss him, though your other hand remains firmly around his tapered penis, softly squeezing and rubbing to make your intentions clearer, as if such a thing were necessary. J'Reth returns your kiss, his tongue wrestling with yours as he surrenders to more carnal desires, the two of you briefly separating [if player is naked]so [else]to give you a chance to strip and so [end if]that he can pull his t-shirt and trousers off to reveal his exotic form.";
		say "     As the two of you pause so that you can take a breath, you grab J'Reth's wrists and press him against the wall, holding his arms above him to hold him in a vulnerable pose. Immersed in the moment, the draco-mantis dips his head and looks up at you enticingly, spreading his legs apart to emphasize the bobbing shaft and trickling pussy that are nestled between them, his demonstration of submission to your will [if player is dominant]unsurprising to you given your domineering attitude[else if player is submissive]quite the surprise to you given your usual preference for more confident partners[else]pleasing you on a more primal level[end if]. 'I beg you, don't keep me waiting,' he pleads, pitifully writhing in order to prove his desperation for you to breed him. Not intending to keep him waiting, you step forward and align your cock with his slickened vagina, resting your tip against the entrance as you wait for his final consent for you to impale him on your pulsing shaft.";
		WaitLineBreak;
		say "     J'Reth gives you little more than a nod, his penis drizzling his pre copiously onto your cock as you sink it into his sodden pussy, ensuring that your first plunge will be smooth and reach as deep into him as possible. You  lift his feet from the ground for a moment with the force of your thrust and drive a moan from his chest as you bottom out, his limp tongue slipping from the side of his mouth as the surge of ecstasy courses through his body. His first time may have been gentle but judging from the reaction to this more primal approach, he is just as appreciative of being bred like an animal. However, you don't want him to feel like merely an object to sate your lusts, so you lock your lips with his as you continue to pound into him, conveying how much he still means to you through the intensity and sincerity of your kiss. You can feel one of his legs hooking around behind you, his heel pressed against your backside urging you to continue hammering into him, but he returns your affection with just as much fervor as you give, a hand stroking the back of your head as his tongue brushes over your lips, his grunts and moans being stifled in your kiss.";
		say "     With the knowledge that this coupling will eventually be interrupted by climax, you redouble your efforts to coax, or more accurately claim, an orgasm out of J'Reth before you flood his womb with your seed. An especially sharp thrust forces your lips apart and the draco-mantis releases a passionate cry, his claws squeezing into your shoulder barely avoiding piercing the skin. Shortening the length of your thrusts, you hammer into your partner, scarcely pulling back before driving your cock back into the tight embrace of his pussy, his vocalisations devolving into one long moan at your change of tactic. A side effect of this is that the draco-mantis's legs go limp, plunging your penis deep enough that your tip can't be more than a millimeter from his cervix and forcing you to catch him and support his weight as you continue to rapidly jackhammer in and out of his leaking cunt. All of this culminates in the sudden eruption of J'Reth's climax.";
		WaitLineBreak;
		say "     The first jet of cum that shoots from his cock splatters against the roof, droplets raining down over the two of you, subsequent strings arcing through the air to splash coat any surface that they can reach, especially your heaving bodies, puddling around your feet and showing no signs of abating. You can feel his cunt squeezing and pulsing around your member, coaxing you to fill her womb with your seed, and it doesn't take much for your own orgasm to overwhelm you. While not visible, you can feel virile blasts of semen splashing off J'Reth's cervix and the walls of his womb, sloshing around your twitching penis. With a relieved sigh, you sink to the floor firmly in the embrace of the draco-mantis, his shaft still squirting his load with gradually decreasing force as the two of you wait for his climax to end, tenderly exchanging kisses and reassurances of affection. When it finally comes to an end, you notice that J'Reth has dozed off, a contented smile on his face. Not wanting to wake him, you carefully extricate yourself and prepare to continue your fight for survival in the city.";
	else: [female]
		say "     Stepping close to J'Reth, you lean in and whisper that you want to press her against the wall and shoot your load in her pussy. Your dirty talking seems to have quite the effect on the usually soft-spoken draco-mantis, her cheeks turning scarlet even as you feel the front of her trousers dampen as her pussy demonstrates that even if the mind is shy, the body is as ready for this as any of the other residents of the city, no doubt the lips of his genital slit seperating to reveal the treasure hidden within. Taking pity on her for your crude proposition, you cup the back of her head and move forward to passionately kiss her, though your other hand sneaks down her waistband to press against the drooling gash within, softly probing and rubbing to make your intentions clearer, as if such a thing were necessary. J'Reth returns your kiss, her tongue wrestling with yours as she surrenders to more carnal desires, the two of you briefly separating [if player is naked]so [else]to give you a chance to strip and so [end if]that she can pull her t-shirt and trousers off to reveal her exotic form.";
		say "     As the two of you pause so that you can take a breath, you grab J'Reth's wrists and press her against the wall, holding her arms above her to hold her in a vulnerable pose. Immersed in the moment, the draco-mantis dips her head and looks up at you enticingly, spreading her legs apart to emphasize the trickling pussy that is nestled between them, her demonstration of submission to your will [if player is dominant]unsurprising to you given your domineering attitude[else if player is submissive]quite the surprise to you given your usual preference for more confident partners[else]pleasing you on a more primal level[end if]. 'I beg you, don't keep me waiting,' she pleads, pitifully writhing in order to prove her desperation for you to breed her. Not intending to keep her waiting, you step forward and align your cock with her slickened vagina, resting your tip against the entrance as you wait for her final consent for you to impale him on your pulsing shaft.";
		WaitLineBreak;
		say "     J'Reth gives you little more than a nod, her sodden pussy leaking copious amounts of juices over your cock as you sink it into her, ensuring that the first plunge will be smooth and reach as deep into her as possible. You  lift her feet from the ground for a moment with the force of your thrust and drive a moan from her chest as you bottom out, her limp tongue slipping from the side of her mouth as the surge of ecstasy courses through her body. Her first time may have been gentle but judging from the reaction to this more primal approach, she is just as appreciative of being bred like an animal. However, you don't want her to feel like merely an object to sate your lusts, so you lock your lips with hers as you continue to pound into her, conveying how much she still means to you through the intensity and sincerity of your kiss. You can feel one of her legs hooking around behind you, her heel pressed against your backside urging you to continue hammering into her, but she returns your affection with just as much fervor as you give, a hand stroking the back of your head as her tongue brushes over your lips, her grunts and moans being stifled in your kiss.";
		say "     With the knowledge that this coupling will eventually be interrupted by climax, you redouble your efforts to coax, or more accurately claim, an orgasm out of J'Reth before you flood her womb with your seed. An especially sharp thrust forces your lips apart and the draco-mantis releases a passionate cry, her claws squeezing into your shoulder barely avoiding piercing the skin. Shortening the length of your thrusts, you hammer into your partner, scarcely pulling back before driving your cock back into the tight embrace of her pussy, her vocalisations devolving into one long moan at your change of tactic. A side effect of this is that the draco-mantis's legs go limp, plunging your penis deep enough that your tip can't be more than a millimeter from her cervix and forcing you to catch her and support her weight as you continue to rapidly jackhammer in and out of her leaking cunt. All of this culminates in the sudden eruption of J'Reth's climax.";
		WaitLineBreak;
		say "     The first squirt of sweet-smelling juices from her pussy splashes against the flesh of your groin, the scent no doubt seeping into your pores to remind you of this coupling until you are next able to wash. Fluid continues to flood around where your bodies are joined, trickling down her legs and pooling on the floor beneath you, filling the room with its aroma. You can feel her cunt squeezing and pulsing around your member, coaxing you to fill her womb with your seed, and it doesn't take much for your own orgasm to overwhelm you. While not visible, you can feel virile blasts of semen splashing off J'Reth's cervix and the walls of her womb, sloshing around your twitching penis. With a relieved sigh, you sink to the floor firmly in the embrace of the draco-mantis, fem-cum still being expelled with gradually decreasing force as the two of you wait for her climax to end, tenderly exchanging kisses and reassurances of affection. When it finally comes to an end, you notice that J'Reth has dozed off, a contented smile on her face. Not wanting to wake her, you carefully extricate yourself and prepare to continue your fight for survival in the city.";

Section 5 - Events

Table of GameEventIDs (continued)
Object	Name
Introduction By Soup	"Introduction By Soup"

Introduction By Soup is a situation.
ResolveFunction of Introduction By Soup is "[ResolveEvent Introduction By Soup]".
The level of Introduction By Soup is 0.
Sarea of Introduction By Soup is "Nowhere".

when play begins:
	add Introduction By Soup to badspots of MaleList;

after going to Mall Foodcourt while (Introduction By Soup is not resolved and MaleList is not warded and MaleList is not banned and a random chance of 1 in 3 succeeds):
	IntroductionBySoupEvent;

to say ResolveEvent Introduction By Soup:
	IntroductionBySoupEvent;

to IntroductionBySoupEvent:
	say "     The activity inside of the mall's food court seems to be even greater than usual. Laughter, chatter, and just general hubbub shows just how normal life can still be despite the effects of the nanites. Feeling a little peckish, you begin to approach the counter but accidentally bump against someone's side, causing them to drop their tray of food. With a shout of surprise, steaming soup splatters over their clothes and on the floor, the plastic bowl clattering mockingly beside their feet. You begin to apologize, but upon seeing them, the words halt in your throat. Their appearance is unlike any you have seen before. Their frame is somewhat slight, though they are not completely devoid of muscles, making you wonder what gender they are. Through their t-shirt that is rapidly becoming transparent, you can see that the same green scales that cover their face are present on the rest of their body, while darker-green chitinous plates appear to be a form of natural armor in places around their chest, forearms, thighs, and shins. You realize just how much you aren't paying attention to your surroundings when you spot the wings sprouting from their back, similar to those on a praying mantis.";
	say "     A voice interrupts you, sarcastically commenting, 'You bumped into me, yet you seem to be the one in shock. Perhaps stop staring and finish apologizing or cleaning up your mess.' You realize that the Draco-Mantis in front of you is the one who spoke, and he's looking at you expectantly from behind some spectacles, his face just as androgynous as the rest of him, with piercing blue eyes. You bashfully continue saying sorry, offering him a hand, only to be met with a rather sharp looking blade that extends from the chitinous guards on his forearm. 'Careful. I'm sure it was only an accident, so I don't need to take a pound of flesh. Also, I don't want to risk contracting ";
	if bodyname of Player is "Human" and player is pure:
		say "any infections that you've had contact with, ";
	else:
		say "whatever you are, ";
	say "I rather like what I look like. There's no other guy out there like me.' He seems to realize what he has said and blinks firmly. 'I didn't mean it like that. I barely know you. That said, I should really get these clothes off. No, you can't come with me. You can apologize at another time. I'm usually somewhere around the mall. It's not as if there is anywhere else that is safe.' With that, he places his tray on a nearby table and hurries off, likely to a clothes shop or laundromat. You surreptitiously leave too, no longer feeling like eating here and not wanting to have a run-in with the cleaners or security.";
	now Introduction By Soup is resolved;
	now Mantis Meeting is active;

Table of GameEventIDs (continued)
Object	Name
Mantis Meeting	"Mantis Meeting"

Mantis Meeting is a situation.
ResolveFunction of Mantis Meeting is "[ResolveEvent Mantis Meeting]".
Mantis meeting is inactive.
The level of Mantis Meeting is 0.
Sarea of Mantis Meeting is "Nowhere".

after going to Mall Foodcourt while (Mantis Meeting is active and Introduction By Soup is resolved and Mantis Meeting is not resolved and a random chance of 1 in 3 succeeds):
	MantisMeetingEvent;

to say ResolveEvent Mantis Meeting:
	MantisMeetingEvent;

to MantisMeetingEvent:
	say "     Spotting a corridor off to the side that you hadn't noticed before, you decide to see where it leads, curiosity getting the better of any caution you may have had. There doesn't seem to be any lights, so you keep one hand on the wall, waiting for your eyes to acclimate to the darkness. Suddenly, your hand runs over something that doesn't seem to be the wall. 'Can I help you?' you hear a voice say. 'Give me a minute, there should be a flashlight on the ground by my feet.' You back off a few paces apologizing while whoever you touched pats the concrete for their torch. 'Hang on. I'm sure I recognize that voice.' With a click, there is light, and you are staring at the familiar form of the Mantis Dragon. He doesn't seem to be wearing his shirt, or anything for that matter, though a quick glance at his crotch only shows a small slit in his carapace. You blink at each other before he breaks the silence. 'Were you checking for burns, or do you often feel up people you find in the dark?' he asks completely straight-faced, looking at you over the top of his glasses.'";
	say "     You protest that you couldn't possibly have known it was him in the dark and that you were just exploring a corridor that you hadn't seen before. He makes a skeptical sound before speaking. 'I don't believe that I introduced myself when we last met, what with the hot soup ruining my shirt, which I had to throw away because someone had contaminated my washing powder with a vitamin-rich substance. I'm J'Reth, and you owe me some new soup, preferably from a can as I don't feel I can show my face in the food court for a bit. One of the lunch-ladies made a joke about me not needing a knife with my food, and a few people may have found it funny. Possibly more than a few.' He lifts his arms, directing your attention towards the sharp blades growing from them. 'As if I could use these for cutting food. Though she did look slightly sorry at causing so much amusement at my expense, so I don't hold it against her. Accidents happen and comments can have unintended consequences. We just have to accept the mistake and move on.'";
	WaitLineBreak;
	say "     'In the future, I would suggest not exploring strange corridors that you find lying around. I'm not even entirely sure that we are still in our world. Come on, I'll walk back with you, as long as you don't spill any more soup on me, as I can't exactly molt on command, and I don't want stains on my carapace.' You give him a dry glance as you begin to walk back the way you came, the Draco-Mantis not far behind you. 'Don't give me that look. I've met you twice, and you started today's conversation by being handsy in the dark. You're lucky that I'm flattered rather than finding it creepy. You perv.' This last comment is muttered under his breath, and you pretend not to have heard it as you break out of the dark corridor, back into the activity of the food court. Coming out behind you, he looks around for a moment before quietly mumbling to himself, 'I feel quite liberated without my clothes, and no one has taken issue with it. Something to consider in the future, J'Reth.' You raise an eyebrow at him, and he blushes slightly.";
	say "     'Stop listening to my conversations with myself, would you? It's a habit I have, and I don't plan on losing it any time soon, but some of my musings are for my ears only.' Despite this outburst, you get the impression that he is enjoying the company. Remembering that you still haven't apologized properly for spilling soup on him or feeling his firm chest in the dark and now listening to him talking to himself, you take the chance to say sorry without having to hurry. 'That's very kind of you, but just to be on the safe side, I would like you to prove that you really are sincere. You can't be too careful these days with how the city has become, and I want to be sure that you haven't got too nefarious of an ulterior motive. Bring me a tin of soup, tomato if you can, and I'll call it even. You seem nice, and I haven't got many friends at the moment, talking to myself being a prime symptom of this. When you have what I want, I'll be in the [bold type]Food Court[roman type] probably.' Giving you a hasty but hopeful farewell, J'Reth hurries through the crowd, a multitude of eyes gazing admiringly at his body. It shouldn't be too hard to find a tin of soup, and he seems nice enough you think to yourself as you decide what to do next.";
	now Mantis Meeting is resolved;
	now Soup & Sexual Gratification is active;

Table of GameEventIDs (continued)
Object	Name
Soup & Sexual Gratification	"Soup & Sexual Gratification"

Soup & Sexual Gratification is a situation.
ResolveFunction of Soup & Sexual Gratification is "[ResolveEvent Soup & Sexual Gratification]".
Soup & Sexual Gratification is inactive.
The level of Soup & Sexual Gratification is 0.
Sarea of Soup & Sexual Gratification is "Nowhere".

after going to Mall Foodcourt while (Soup & Sexual Gratification is active and Mantis Meeting is resolved and Soup & Sexual Gratification is not resolved and carried of food > 0 and a random chance of 1 in 3 succeeds):
	Soup&SexualGratificationEvent;

to say ResolveEvent Soup & Sexual Gratification:
	Soup&SexualGratificationEvent;

to Soup&SexualGratificationEvent:
	say "     The food court is, as usual, bustling with people eating and talking to one another, and [if perception of Player > 20]an eagle-eyed scan reveals that J'Reth isn't there at the moment[else]it doesn't really surprise you that you cannot see whether J'Reth is there or not[end if]. You are just considering leaving again when a tap on your shoulder makes you turn to find one of the mall rats. 'You're the one who's been hanging round with J'Reth, ain't ya? Queer one he is. Friendly enough, but seems to still be cautious around many of the refugees, or whatever it is Jenna is calling them nowadays. If I knew spilling soup down his front would help him open up, I would have suggested it to some of the people with an [']interest['] in him. He turned down getting laid so often that I thought he was celibate at one point... But I'm getting distracted. I tapped your shoulder to tell you that if you are looking for J'Reth, he's in the back rooms of what used to be the toy store. I doubt that he's expecting you, so be sure to let him know you are there. Wouldn't want him to slash your pretty face by accident.' Having imparted his advice, the rat slouches away, winking at a friend at one of the tables.";
	say "     Quickly checking a map for where to go, you set off at a brisk pace, eager to hand over the tin of soup and finally be able to apologize properly for the unfortunate events of your first meeting. It doesn't take you long to reach the former toy store, now a sleeping area for people taking shelter from the world outside. The shelves have been pushed round to give a modicum of privacy in one corner with a sign requesting that passersby be quiet so as not to disturb anyone who is currently asleep. You can see what looks like a door to the storeroom at the back, but between it and you are a sea of mattresses and sleeping bags, suggesting that there are too many refugees to house in the shelved-off area and that people will take whatever space they can get. Cautiously creeping across the room, focusing on not treading on any sleeping bodies, you finally reach the door and silently slip through, closing it behind you. You turn around with a sigh and are greeted with a novel view. 'Well. This is awkward...' J'Reth mutters, his hand clutching an impressive sized erection, seemingly in the middle of masturbating while sitting on the edge of his bed.";
	say "     [bold type]You may have caught him at an inopportune moment but he hasn't asked you to leave. Do you want to stay and see where things go, or just leave the can of soup on the floor before leaving?[roman type][line break]";
	LineBreak;
	say "     ([link]Y[as]y[end link]) - Stay. You wouldn't want your apology to be impersonal. He isn't exactly hard on the eyes either.";
	say "     ([link]N[as]n[end link]) - Time to leave. Leaving the soup should be enough. You shouldn't have to apologize any further than that.";
	if Player consents: [Stay]
		LineBreak;
		say "     You give him a smile and reassure him that he doesn't have to stop on your account. You just came to give him the tin of tomato soup that he wanted. Interrupting J'Reth's [']alone time['] would be counterintuitive to an apology after all. He gives a bashful smile and continues to lightly stroke up and down his length as you crouch to rummage in your backpack for the only-slightly-dented tin of soup. This inadvertently puts your face at crotch height, and you get a closeup view of the Draco-Mantis's erect cock. The turgid shaft is tapered from tip to base, where a slight bulb suggests that a knot may develop as he approaches orgasm. A polite cough rouses you from your thoughts, and you realize that you have stopped searching your bag and have likely been staring at his groin for longer than would be considered polite curiosity. 'Um... While you're down there, would you perhaps want to... um... suck it? I would be grateful as you would imagine, though be warned, I'm quite productive in the cum department if you catch my drift, so I would suggest not letting it leave you mouth or I'll have to clean the room. Only if you want to though, I'm not going to force you if you aren't comfortable.";
		say "     [bold type]Do you want to give J'Reth a blowjob? You're sure he'll be very grateful.[roman type][line break]";
		LineBreak;
		say "     ([link]Y[as]y[end link]) - Yes. The thought had already crossed your mind after all. You wonder what he'll taste like...";
		say "     ([link]N[as]n[end link]) - No. He seems nice, but that might be a bit too intimate for you. Time to leave.";
		if Player consents: [Messy Oral]
			say "     Tilting your head as if to say, 'why not,' you stop searching your bag and bring a hand up, clasping it around J'Reth's twitching cock. The flesh is warm and slightly damp, giving off a faintly sweet scent. He leans back a bit, supporting his weight with his hands, the blades on his forearms carefully angled away from where they can do any damage, and he releases a contented sigh as he feels your palm slide from base to tip and back again. Small spurts of pre coat your hand and aiding in lubrication as it gets smeared over all eleven inches of his length. 'This means a lot to me, so thank you,' he gasps, the sensations that you are causing him affecting his speech. J'Reth's body echoes his gratitude, his shaft throbbing in your hand, pulsing in your grasp and begging for you to continue your attentions. He did ask you to suck him off though, so you decide to up you game and eagerly bring your mouth towards the tasty-looking crimson member.";
			say "     As the tip slides over your lips and tongue, the sweet flavor of his precum fills your mouth, even as more fluid is squirted against the back of your throat. J'Reth lets out an appreciative murmur and strokes a hand over the back of your head, his hips reflexively making short thrusts into the depth of your mouth. You decide that you have teased him for long enough and begin to take a more active role in pleasuring him, bobbing your head back and forth while sealing your lips around his shaft, causing him to half-stifle a moan. Gazing up at him and meeting his eyes, you continue your treatment of him, eagerly devouring more and more of his cock with each push, the tip reaching increasingly further down your throat until you reach your limit. By now, his knot has become more pronounced, and you doubt that he will last much longer before he climaxes and fills your stomach.";
			WaitLineBreak;
			say "     'You... mmmn... really seem to... mmmn... know what you are doing,' J'Reth exclaims between moans as he braces the back of your head with his hands while thrusting with ever increasing desperation, racing towards orgasm. Who knew that splashing soup on a stranger could lead to this? While he definitely isn't going to get the knot in, that doesn't stop him from trying to slip more of his shaft into your mouth with each frantic thrust, his body beginning to shudder as it approaches the cresting moment just before climax. With a euphoric cry, the Draco-Mantis begins to shoot his cum down your throat, hilting himself as the first squirt sprays forth. His length pulses, swelling and contracting in the tight, warm walls of your esophagus and filling your stomach with his carnal fluids. It doesn't show any signs of abating, making you wonder just how efficient his balls are, especially when you can't see them.";
			say "     J'Reth begins to slowly slide his still orgasming cock from inside of you, gasping at the sensations from his tender flesh. As the tip finally slips from the confines of your throat and rests on your tongue, you get the full flavor of his semen. While his precum was merely sweet, the cum that has so convincingly filled your stomach is similar in taste to honey, lacking the sometimes bitter or salty flavors more common in humans. He allows you a chance to take advantage of this, holding his cock inside of your mouth as the jets of sperm gradually fade to a trickle. 'That was certainly an experience worth repeating,' J'Reth says between deep breaths while his shaft softens and slips from your maw, dripping excess fluid onto the floor between you. 'Though I will have to return the favor at some point. My apologies that it can't be now, but after that, I am really exhausted.'";
			WaitLineBreak;
			say "You can hardly blame him, since it feels like you have several liters of semen sloshing around inside of your stomach, so you stagger to your feet again while he smiles tiredly, but gratefully, at you. Remembering your original reason for coming here, you quickly find the tin of tomato soup in your bag and toss it onto the bed beside him. 'Shouldn't it be me paying you for that, or did you enjoy it that much?' J'Reth teases you as he stows it on a small table at the head of the bed. Lying down on his bed, the Draco-Mantis sighs, 'I'm going to have a little lie down if you don't mind. As well as draining me of cum, you also drained me of energy, and a nap seems like a good way of replenishing both. I'll see you in the food court when I can, but you can consider your apology accepted.' You wish him sweet dreams before quietly leaving the room again and making your way back to the main area of the mall.";
			now resolution of Soup & Sexual Gratification is 1; [Gave blowjob]
			PlayerDrink 10;
			NPCSexAftermath player receives "OralCock" from J'Reth;
		else: [Time to go]
			say "     You refuse slightly embarrassedly and scrabble in your backpack for the tin of tomato soup before placing it on the bed beside him. Hastily opening the door again, you hear him quietly say thank you and despite seeming unable to meet your eyes, he continues slowly stroking himself. As you shuffle out of the small room, he calls after you, 'I'm sorry that I seem to have scared you away. I thought that anyone coming in would at least knock. Please meet me here again when you have the time. I promise I'll be more presentable next time.' Giving little more than a nod, you close the door behind you and weave your way through the beds and sleeping bodies again, returning to the Food Court with a visibly red face. That could have gone better.";
			now resolution of Soup & Sexual Gratification is 2; [Refused blowjob]
	else: [Leave]
		say "     Embarrassedly apologizing for intruding on his private time, you scrabble in your backpack for the tin of tomato soup and place it on the ground before hastily opening the door again You hear him quietly say thank you and despite seeming unable to meet your eyes, he still slowly strokes himself. As you shuffle out the small room, he calls after you, 'I'm sorry that I seem to have scared you away. I thought that anyone coming in would at least knock. Please meet me here again when you have the time. I promise I'll be more presentable next time.' Giving little more than a nod, you close the door behind you and weave your way through the beds and sleeping bodies again, returning to the Food Court with a visibly red face. That could have gone better.";
		now resolution of Soup & Sexual Gratification is 3; [Just left tin on floor]
	now Soup & Sexual Gratification is resolved;
	ItemLoss food by 1;
	now HP of J'Reth is 1;

Table of GameEventIDs (continued)
Object	Name
Reciprocal Thanks	"Reciprocal Thanks"

Reciprocal Thanks is a situation.
ResolveFunction of Reciprocal Thanks is "[ResolveEvent Reciprocal Thanks]".
The level of Reciprocal Thanks is 0.
Sarea of Reciprocal Thanks is "Nowhere".

after going to Mall Foodcourt while (Reciprocal Thanks is not resolved and Soup & Sexual Gratification is resolved and HP of J'Reth is 1 and a random chance of 1 in 3 succeeds):
	AReciprocalThanksEvent;

to say ResolveEvent Reciprocal Thanks:
	AReciprocalThanksEvent;

to AReciprocalThanksEvent:
	say "     Upon reaching the food court, you realize that you haven't seen J'Reth since meeting him in the storage room, so you decide to go and see how he is. It doesn't take you long to reach the toy store again, remembering the way from last time, and you see the Draco-Mantis slouched against a wall outside. He looks up as you approach, a grin spreading across his face. 'Hey, how are you?' he asks, straightening up and walking over to meet you. 'It's good to see you again. The tin of soup you left was delicious, though I [if resolution of Soup & Sexual Gratification is 1]believe that I especially enjoyed the extra attentions beforehand. Attentions that I intend to reciprocate soon. If you have the time, p[else]wonder whether the manner in which you found me made you uncomfortable. I apologize if I did and hope you'll allow me to make it up to you. P[end if]erhaps you would like to follow me to my room again so that we can be more comfortable while we talk?'";
	say "     He makes a motion for you to follow him and weaves his way between [if daytimer is day]empty mattresses[else]sleeping forms[end if] over to the door to the backroom in which he has been living. Barely hesitating, you follow him. Having been preoccupied the last time you were in here, you hadn't taken in what his room looked like. About 6 meters long and 3 meters wide, it feels quite spacious even with the bed against one poster-covered wall and the shelves almost sagging under the weight of books and figurines of monsters. 'I take it that you didn't look around when you were delivering the soup,' J'Reth queries, looking proudly over his collection. You shake your head and continue looking at them almost in awe until the draco-mantis sits on his bed and pats the duvet for you to seat yourself beside him. The mattress is soft beneath you, and you wonder how he got his own room with the number of refugees sleeping just outside the door. 'Before I go any further, I must ask, are you happy for me to [if resolution of Soup & Sexual Gratification is 1]return the favor from last time[else]pleasure you in thanks for all that you've done[end if], or would you prefer to bask in the glory of my collection?";
	WaitLineBreak;
	say "     [bold type]Do you want J'Reth to go down on you, or express a preference for just sitting?[roman type][line break]";
	LineBreak;
	say "     ([link]Y[as]y[end link]) - You're happy for him to pleasure you. Who knows what he is capable of?";
	say "     ([link]N[as]n[end link]) - Sit beside him and look around at his figurines and posters. His company is sufficient enough for you without getting sexual.";
	if Player consents: [Stay]
		LineBreak;
		if player is male:
			say "     You eagerly express your desire for him to demonstrate how thankful he is, a smile forming on your lips as the draco-mantis slides to the floor and kneels [if legsname of player is not listed in infections of SerpentineList and legsname of player is not listed in infections of SlidingList]between your legs, his hands caressing your thighs while he carefully angles his blades safely away[else]in front of you, his hands massaging around your hips, the blades on his arms carefully angled safely away[end if]. 'I'm not sure whether to feel that I am being too forward or whether I would be considered slow,' J'Reth muses as his hands circle ever closer to your groin, your shaft[smn] responding to the tender ministrations and rising [if player is barecrotch]in front of your partner's eyes[else]beneath the fabric of you clothes before J'Reth gently frees it[end if]. 'Maybe a bit of both. Slow for in the streets, but way faster than how the world used to be. All that matters is that I care for you and that you care for me,' he says, earnestly looking you in the face, though his hands continue to roam over your body[if player is not naked], stripping you as they go[end if].";
			say "     'Give me a minute to undress. After the last time, I think that I would prefer not to have my clothes soaked in thick liquid again.' While he carefully maneuvers his wings out of his t-shirt and pulls his trousers over his feet, you gaze about the room at the posters for several popular films along with a few that you haven't heard of. As you turn back again, you are surprised when you find J'Reth locking your lips with his own and a long dexterous tongue tickling the back of your teeth. After a heated moment, he breaks the kiss, almost panting, 'Mmmmm, that's the sort of thing I could look forward to. Now if you could just scooch to the edge a bit more, I'll get to work on sucking you off. With a tongue as long as mine, I should be able to give quite the exotic experience.' An enticing offer if there ever was one, you slide to the edge of the bed and wait as the draco-mantis kneels, tongue circling his lips in anticipation.";
			WaitLineBreak;
			say "     The tip of his tongue flicks across your urethra before brushing down the side, leaving a thin trail of saliva. As your partner continues with this treatment, only lightly touching you in a teasing manner, drops of pre trickle from your cock, forming their own paths down your shaft. J'Reth's tongue seeks out the beads of your essence before he withdraws his tongue to taste your nectar. 'Mmm... I bet that you get told this all the time, but that's some good stuff. I don't suppose you would be interested in sharing another kiss, would you?' J'Reth offers, a slight shine on his top lip betraying a trace of your pre unswallowed by the draco-mantis. Before you can reply, his tongue darts out and licks it off. 'Too slow,' he says as he winks at you, returning to servicing your cock with added enthusiasm. A broken gasp bursts from your lips as he envelops your penis in one push, long tongue encircling the shaft and sending titillating sensations through your body as it slides in tandem with his bobbing head.'";
			if "Kinky" is listed in feats of player:
				say "     After several minutes of this, you catch a mischievous gleam in the draco-mantis's eye as he looks up at you. Your firm member still snug in his mouth, you can feel his tongue uncoiling from around it and slithering towards your tip. As it begins to press against you urethra, you realize what he has planned, and you are sure that you feel an electrical charge dance up your spine as you imagine the feelings yet to come. At first, his tongue's penetration stings, making you wonder whether this is a good idea, but it soon dulls, being replaced by a feeling of tightness as more and more of his tongue squeezes through the narrow entrance. Throughout all of this, J'Reth keeps a steady eye on your reactions, slowing down when he sees you wince in pain and resuming when pleasure dominates again. [if cock length of player < 3]Taking into account your limited capacity, your partner halts after an inch is buried in your cock, his lips pressed [else if cock length of player < 7]After a few inches of his tongue are buried inside of your cock, the length that isn't within your urethra loops around your girth, his lips pressing [else if cock length of player < 13]With your impressive size, your partner is able to bury a significant amount of his tongue inside of your cock, barely any remaining to loop around your girth, his lips pressing [else]Given the monstrous size of your cock, your partner is able to bury his entire tongue inside of it, his lips pressing [end if]against your groin as he gives you a moment of respite.";
				WaitLineBreak;
				say "     The walls of your urethra gently pulse around his intruding tongue. The feeling of that slick, dexterous muscle writhing within your tunnel is incredible, radiating waves of pleasure through your crotch and making you squirm beneath his oral ministrations. The tenacity of his worship is matched only by his skill, somehow managing to slip along your deepest recesses to tickle every nerve within your pliable tunnel, deftly sweeping over that sensitive cockflesh. His ravenous conquest leaves you unable to muster anything but soft, pleasured panting as he seeks out your most sensitive spots and attacks them all at once. Not content to simply lather your opening, that salivating maw continues to wetly suckle your shaft, your crown kissing the back of his throat as he services you inside and out.";
				say "     J'Reth's continued worship proves too much for your body to handle. You can feel the need in your loins threatening to boil over, and you doubt that you will last much longer, aching to release into your partner's welcoming maw. Tapping him on the back of the head to signal your impending orgasm, you are surprised when he pushes his face flush with your crotch and awaits your climax, tongue still pistoning back and forth inside of your urethra. As you crest, you grip the spikes on the sides of his head, pulling his face down while grinding up against his features. The white hot rush of your orgasm leaves you trembling and bucking erratically, your cum under pressure from the obstruction of his tongue, which only seems to prolong your climax. What isn't refluxed into your churning balls gushes out around the edges, sloppily filling his maw in strained, squirting spurts. Each blast of seed sends a shiver up your spine, leaving you arching and moaning absently as your spunk is eagerly devoured.";
				WaitLineBreak;
				say "     By the time your peak subsides, your muscles feel slack, and an overwhelming feeling of exhaustion envelops you like a warm, soft blanket. Gazing down at your skillful lover, you find him staring back at you with a smoldering expression, tongue still lazily swirling within your cum-sullied tunnel. Sensing your readiness, he begins to withdraw the limber length of muscle, a languid motion that smears his saliva over your well-stretched inner flesh. Before long, the tip flits free with a final sputter of cum, leaving your seed to trickle steadily down your pulsing mast. You can't help but reach down to trace around the opening, relishing the sensitivity that permeates your flesh while basking in the warmth of your post-orgasmic haze. J'reth seems equally sated, swirling a pool of sperm around in his mouth before swallowing, a few stray strands trickling down his chin to drip onto his lap.";
			else:
				say "     He seems to be proficient at giving head, capable of coordinating his tongue independently from the movements of his head, giving what you are sure will be a memorable experience. At times, his tongue is moving in opposition to his lips, sliding up your length as your shaft is engulfed in the wet warmth of his maw. Then at a whim, it will move in tandem instead, slithering towards the base as he swallows your cock. His oral ministrations have sighs and gasps spilling from your mouth, and your limbs occasionally twitch, seemingly unsure whether to let you relax or prepare for the next burst of stimulation. In the end, you settle for leaning back slightly, now directing your expressions of appreciation at the ceiling, slightly thrusting your hips to meet with his mouth as he plunges down.";
				WaitLineBreak;
				say "     Looking down towards the draco-mantis, his eyelids half closed and unseeing. His attention is entirely devoted to slathering and massaging your penis, and at times, you are sure you can feel the vibrations of his stifled moans resonating through your shaft, further fueling your lust. However, feeling your eyes on him, J'Reth snaps out of his cock-induced stupor and meets your gaze, attempting to give a smile while refusing to relinquish the contents of his mouth. The result of this is a skewed smirk and a steady stream of saliva drooling from the corner of his mouth to splatter on his thigh, misted by the copious precum that you seem to be producing. He hurriedly seals his mouth again, a mirthful glint in his eye as he returns to servicing you, the fluid trickling off his leg to pool on the floor. Resting a hand just above your knee, your partner increases his pace, the tip of your penis [if cock length of player < 3]being tenderly embraced by his tongue and rhythmically squeezed[else if cock length of player < 7]slipping into his throat with each forceful thrust[else]squeezing further into his throat with each consecutive push[end if].";
				say "     The constriction and pulsing of the muscles around your length draw you closer to orgasm, and wanting more influence on the rate at which you approach climax, you brace the back of J'Reth's head and grind against his face each time his lips meet your crotch, eliciting a euphoric moan from the male. Doubting that your endurance will last much longer, you begin to hammer into his maw, taking complete control over your impending completion. The draco-mantis seems content with this, merely extending his tongue over his bottom lip to ensure ease of entry and comfort. As you crest, you grip the spikes on the sides of his head, pulling his face down while grinding up against his features. The white hot rush of your orgasm leaves you trembling and bucking erratically, cum splattering the walls of his mouth and throat. What doesn't trickle towards his stomach, sloshes around in his mouth or runs over his tongue to drip onto the sheets between your thighs.";
				WaitLineBreak;
				say "     By the time your peak subsides, your muscles feel slack, and an overwhelming feeling of exhaustion envelops you like a warm, soft blanket. Gazing down at your skillful lover, you find him staring back at you with a smoldering expression, pearly liquid puddled in his maw as he displays the reward for his efforts. Sensing your readiness, he allows your length to slip from his lips, a light sheen of semen still coating it. You gently stroke the top of J'Reth's head, still recovering from your climax and wanting to show your gratitude for such a pleasurable experience. J'reth seems equally sated, swirling a pool of sperm around in his mouth before swallowing, a few stray strands trickling down his chin to drip onto his lap.";
			say "     'That was definitely an experience worth repeating, wouldn't you agree?' the draco-mantis teases, his tongue licking the last of your cum from his face. 'Was it to your liking too?' Considering the intensity of the orgasm he gave you, you have to agree, nodding your head at him before slumping back to lie on the bed, staring at the ceiling. 'If you're going to fall asleep, at least scooch over so that I can fit beside you. I don't want to miss my chance at some post-coital cuddling.' You shuffle over and feel the draco-mantis recline beside you and embrace you. 'Mmmmm. Cozy. Just a warning though. If you do nod off, I have an errand that I've been asked to do, so I may not be around when you wake up. Don't hesitate to drop by again in future though. I swear we'll be able to have a proper conversation next time. Only if you want to though. No pressure.' The two of you lie there until you fall asleep, J'Reth's firm body intimately curved around your own. You wake again to find him pulling his clothes back on and decide that you should probably be leaving too. When the both of you are ready, you leave the toy shop together before reluctantly parting to go about the rest of your day.";
		else if player is female:
			say "     You eagerly express your desire for him to demonstrate how thankful he is, a smile forming on your lips as the draco-mantis slides to the floor and kneels [if legsname of player is not listed in infections of SerpentineList and legsname of player is not listed in infections of SlidingList]between your legs, his hands caressing your thighs while he carefully angles his blades safely away[else]in front of you, his hands massaging around your hips, the blades on his arms carefully angled safely away[end if]. 'I'm not sure whether to feel that I am being too forward or whether I would be considered slow,' J'Reth muses as his hands circle ever closer to your groin, your pussy moistening [if player is barecrotch]in front of your partner's eyes[else]beneath the fabric of you clothes before J'Reth gently reveals it[end if]. 'Maybe a bit of both. Slow for in the streets, but way faster than how the world used to be. All that matters is that I care for you and that you care for me,' he says, earnestly looking you in the face, though his hands continue to roam over your body[if player is not naked], stripping you as they go[end if].";
			say "     'Give me a minute to undress. After last time, I think that I would prefer not to have my clothes soaked in warm liquid again.' While he carefully maneuvers his wings out of his t-shirt and pulls his trousers over his feet, you gaze about the room at the posters for several popular films along with a few that you haven't heard of. As you turn back again, you are surprised when you find J'Reth's lips locked against your own and a long dexterous tongue tickling the back of your mouth. After a heated moment, he breaks the kiss again, almost panting, 'Mmmmm, that's the sort of thing I could look forward to. Now if you could just scooch to the edge a bit more, I'll get to work on eating you out. With a tongue as long as mine, I should be able to give quite the exotic experience.' An enticing offer if there ever was one, you slide to the edge of the bed and wait as the draco-mantis kneels again, tongue circling his lips in anticipation.";
			WaitLineBreak;
			say "     The tip of his tongue flicks across your clit before brushing over your slit, leaving a thin trail of saliva. As your partner continues with this treatment, only lightly touching you in a teasing manner, the juice trickles from your cunt to be absorbed by the bed covers. J'Reth's tongue seeks out the beads of your essence before he withdraws his tongue to taste your nectar. 'Mmm... I bet that you get told this all the time, but that's some good stuff. I don't suppose you would be interested in sharing another kiss, would you?' J'Reth offers, a slight shine on his top lip betraying a trace of your juices that didn't make it into his mouth. Before you can reply, his tongue darts out and licks it off. 'Too slow,' he says as he winks at you, returning to lavishing your pussy with added enthusiasm. A broken gasp bursts from your lips as he smothers your loins in kisses and licks, long tongue flicking over your clitoris even as it dances through the opening to your most intimate area and sending titillating sensations through your body as it slides in tandem with his bobbing head.";
			if "Kinky" is listed in feats of player:
				say "     After several minutes of this, the draco-mantis looks up at you, a mischievous glint in his eye. Before you can question his intention, his tongue ceases slathering your gash and begins to push into you. However, instead of slithering up the passage to your womb, it snakes its way into your urethra instead, your feelings of apprehension clashing with the excitement of the unusual sensations that this evokes. At first, his tongue's penetration stings, making you wonder whether this was a good idea, but it soon dulls, being replaced by a feeling of tightness as more and more of his tongue squeezes through the narrow entrance. Throughout all of this, J'Reth keeps a steady eye on your reactions, slowing down when he sees you wince in pain and resuming when pleasure dominates again. After a few inches of his tongue are buried inside of you, your partner folds the remaining length and inserts that too, increasing your sense of fullness and causing you to elicit a moan.";
				WaitLineBreak;
				say "     With his lips pressed against your labia, J'Reth gives you a moment to become more accustomed to the pressure in your groin before continuing, the walls of your urethra gently pulsing around his intruding tongue. The feeling of that slick, dexterous muscle writhing within your tunnel is incredible, radiating waves of pleasure through your crotch and making you squirm beneath his oral ministrations. The tenacity of his worship is matched only by his skill, somehow managing to slip along your deepest recesses to tickle every nerve within your pliable tunnel, deftly sweeping over the unexplored flesh. His ravenous conquest leaves you unable to muster anything but soft, pleasured panting as he seeks out your most sensitive spots and attacks them all at once. Realising that he has been neglecting other parts of your loins, he returns to enthusiastically sucking your clit and outer lips even as he continues to penetrate your urethral passage. The result of this impressive coordination is a fair amount of slurping noises and appreciative grunts which you would laugh at were you not expressing your own pleasure in unrestrained moans.";
				say "     J'Reth's continued worship proves too much for your body to handle. You can feel the need in your loins threatening to boil over, and you doubt that you will last much longer, aching to release into your partner's welcoming maw. Upon tapping him on the back of the head to signal your impending orgasm, he pushes his face flush with your crotch and awaits your climax, tongue still pistoning back and forth inside of your urethra. As you crest, you grip the spikes on the sides of his head, pulling his face down while grinding up against his features. The rush of your orgasm leaves you trembling and bucking erratically, his tongue obstructing the rush of your fem-cum and seeming to prolong your climax. The fluid that manages to make it past his pulsing organ splashes across his face and into his mouth, your partner doubling his efforts to encourage further squirts. Each wave of orgasm sends a shiver up your spine, leaving you arching and moaning absently as your pussy is eagerly devoured.";
				WaitLineBreak;
				say "     By the time your peak subsides, your muscles feel slack, and an overwhelming feeling of exhaustion envelops you like a warm, soft blanket. Gazing down at your skillful lover, you find him staring back at you with a smoldering expression, tongue still lazily squirming inside of your shuddering passage. Sensing your readiness, he begins to withdraw the limber length of muscle, a languid motion that smears his saliva over your well-stretched inner flesh. Before long, the tip flits free, accompanied by a trickle of your juices. You can't help but reach down to trace around the opening, relishing the sensitivity that permeates your flesh while basking in the warmth of your post-orgasmic haze. J'reth seems equally sated, wiping his face and licking his fingers sensually as he gazes at you, a few glistening patches betraying areas which he has missed.";
			else:
				say "     From his proficiency at eating you out, he is either a natural or this isn't the first time that he has done this. You hope that this will be a memorable experience given his ability to move his tongue independently of where his mouth moves, the impressive length of the dextrous muscle allowing such an action. While one minute his tongue will be tickling at your clit while his lips suck at the bottom of your slit, sending tingles shooting through your body, the next moment he will cause you to emit enthusiastic moans, his tongue vigorously penetrating your intimate depths while his mouth is sealed around your cunt. You are unsure whether to relax or prepare for the next wave of titillating stimulation, eventually leaning back to direct your attention solely towards appreciative vocalization for anyone nearby to hear.";
				WaitLineBreak;
				say "     Looking down towards the draco-mantis, his eyelids half closed and unseeing. His attention is entirely devoted to slathering and massaging your pussy, and at times, you are sure you can feel the vibrations of his stifled moans resonating through your passage, further fueling your lust. However, feeling your eyes on him, J'Reth snaps out of his cunt-induced stupor and meets your gaze, attempting to give a smile while maintaining his enthusiastic ministrations. The result of this is a skewed smirk and a steady stream of saliva drooling from the corner of his mouth to splatter on his thigh, misted by the copious lubrication that you seem to be producing. He hurriedly seals his mouth again, a mirthful glint in his eye as he returns to eating you out, the fluid trickling off his leg to pool on the floor. Resting a hand just above your knee, your partner increases his pace, the tip of his tongue delving further and further inside of you.";
				say "     The writhing and pulsing of the organ inside of you draws you closer to orgasm, and wanting more influence on the rate at which you approach climax, you brace the back of J'Reth's head and grind against his face each time the tip of his tongue caresses your cervix, eliciting a euphoric moan from the male. Doubting that your endurance will last much longer, you begin to thrust against his maw, taking complete control over your impending completion. The draco-mantis seems content with this, slowing the oscillation of his tongue and instead inhaling your scent and giving himself time to taste your essence. As you crest, you grip the spikes on the sides of his head, pulling his face even more firmly into your crotch while grinding up against his features. The rush of your orgasm leaves you trembling and bucking erratically, fem-cum splattering over his face and the walls of his mouth. What doesn't drain towards his throat, trickles from his mouth or drips from his muzzle onto the sheets between your thighs.";
				WaitLineBreak;
				say "     By the time your peak subsides, your muscles feel slack, and an overwhelming feeling of exhaustion envelops you like a warm, soft blanket. Gazing down at your skillful lover, you find him staring back at you with a smoldering expression, your juices plastering his faces to display the reward for his efforts. Sensing your readiness, he allows his tongue to slip from your pussy, eliciting a sigh from you as it brushes over the sensitive flesh of your vaginal walls. You gently stroke the top of J'Reth's head, still recovering from your climax and wanting to show your gratitude for such a pleasurable experience. J'reth seems equally sated, licking some of your essence from his face before swallowing, a few drops falling from his chin onto his lap.";
			say "     'That was definitely an experience worth repeating, wouldn't you agree?' the draco-mantis teases, his tongue licking the last of your fem-cum from around his mouth. 'Was it to your liking too?' Considering the intensity of the orgasm he gave you, you have to agree, nodding your head at him before slumping back to lie on the bed, staring at the ceiling. 'If you're going to fall asleep, at least scooch over so that I can fit beside you. I don't want to miss my chance at some post-coital cuddling.' You shuffle over and feel the draco-mantis recline beside you and embrace you. 'Mmmmm. Cozy. Just a warning though. If you do nod off, I have an errand that I've been asked to do, so I may not be around when you wake up. Don't hesitate to drop by again in future though. I swear that we'll be able to have a proper conversation next time. Only if you want to though. No pressure.' The two of you lie there until you fall asleep, J'Reth's firm body intimately curved around your own. You wake again to find him pulling his clothes back on and decide that you should probably be leaving too. When the both of you are ready, you leave the toy shop together before reluctantly parting to go about the rest of your day.";
		else: [Neuter]
			say "     You eagerly express your desire for him to demonstrate how thankful he is, a smile forming on your lips as the draco-mantis slides to the floor and kneels [if legsname of player is listed in infections of SerpentineList and legsname of player is not listed in infections of SlidingList]between your legs, his hands caressing your thighs while he carefully angles his blades safely away[else]in front of you, his hands massaging around your hips, the blades on his arms carefully angled safely away[end if]. 'I'm not sure whether to feel that I am being too forward or whether I would be considered slow,' J'Reth muses as his hands circle ever closer to your featureless groin. 'Maybe a bit of both. Slow for in the streets, but way faster than how the world used to be. All that matters is that I care for you and that you care for me,' he says, earnestly looking you in the face, though his hands continue to roam over your body[if player is not naked], stripping you as they go[end if].";
			say "     'Give me a minute to undress. I want to be able to feel you against my body and also don't want to spoil my clothes should I get too excited.' While he carefully maneuvers his wings out of his t-shirt and pulls his trousers over his feet, you gaze about the room at the posters for several popular films along with a few that you haven't heard of. As you turn back again, you are surprised when you find J'Reth locking your lips with his own and a long dexterous tongue tickling the back of your teeth. After a heated moment, he breaks the kiss, almost panting, 'Mmmmm, that's the sort of thing I could look forward to. Would you mind rolling over please? I wish to cuddle with you, and with my wings, I think that I am better being the one on the edge. After that, I thought that I might explore your depths with my tongue. With a tongue as long as mine, I should be able to give quite the exotic experience. Sound good?' An enticing offer if there ever was one, you lie with your back to the wall, giving him room to settle beside you face to face.";
			WaitLineBreak;
			say "     He only gazes into your eyes for a few seconds before his lips meet with your own, and his hands start to rove across your exposed flesh, squeezing where it is soft and caressing where you are firmer. While at first you are apprehensive at the scythe-like blades jutting from his arms, J'Reth uses them with proficiency, grazing across your skin to heighten your excitement as they stimulate you in such a contrasting manner to his fingers. Not once does he draw blood, and you eventually relax against him again as you feel the sensations over your waist, back, and [if legsname of player is not listed in infections of SerpentineList and legsname of player is not listed in infections of SlidingList]thighs[else]shoulders[end if]. 'Now that I've prepared you, it's time for my wet... limber... adventurous tongue to slide its way into your ass.' J'Reth punctuates each word of his description with a kiss and a lick, on chest, tummy, and finally your crotch. He slips from the bed to kneel upon the floor, before carefully turning you around and maneuvering you to the edge.";
			say "     The first contact of his tongue against your twitching sphincter startles you, leaving a dampness as the dextrous organ slithers across your exposed flesh before returning to the waiting hole. You prepare yourself knowing what is coming, almost quivering in anticipation. A steady pressure builds before J'Reth's tongue squeezes into your anus and commences with slathering your walls with saliva, easing the passage of an increasing amount of the limber muscle as it delves deeper, folding and twirling to heighten your pleasure. Not content to only stimulate you internally, the draco-mantis presses his muzzle against your backside, the air from his nostrils tickling your skin as he inhales and exhales. Soft squelching sounds leak from where he is pleasuring you, the excess saliva dribbling from your anus and past his lips before puddling on the sheets.";
			WaitLineBreak;
			say "     You also hear a quiet slapping noise and guess that J'Reth is masturbating with one hand even as the other spreads the curve of your ass to allow unimpeded access to your hole for his greedy maw. Had he not been clear that this was in thanks for all your work and thus all about you, you might try and aid him in his gratification, but instead, you lie there and hope that your gentle moans at his skilful rimming and penetration will help goad him to a satisfactory release. The writhing and pulsing of the organ inside of you draws you closer to orgasm, and you increase the force with which you grind against his face each time his tongue stimulates a particularly sensitive bundle of nerves, drawing a groan of contentment from his busy maw. As the rush overwhelms you, you reach back and grip the spikes on the sides of his head, pulling his face even more firmly into your rear while rubbing over the contours of his face. The rush of your orgasm leaves you trembling and bucking erratically, the lack of fluid to expel not diminishing the magnitude with which you feel the waves of euphoria.";
			say "     As you climax, the sound of frantic slapping increases until you hear liquid splatter onto the floor with surprising force and a relieved sigh from your partner. By the time your shuddering subsides, your muscles feel slack, and an overwhelming feeling of exhaustion envelops you like a warm, soft blanket. J'Reth gives you a moment to rest, equally fatigued from his ministrations and orgasm, before slowly slithering his tongue from your spit-soaked anus. As the tip flicks out and back into his mouth, you roll over and give him a quick, intense kiss, tasting yourself on his breath. Gazing into his eyes, you find him staring back at you with a smoldering expression, saliva smeared around his jaw. You gently stroke the top of J'Reth's head, still recovering from your climax and still wanting to feel him against you. J'reth seems equally sated, a few errant beads of cum still clinging to the tip of his cock as it shrinks back into his crotch.";
			WaitLineBreak;
			say "     'That was definitely an experience worth repeating, wouldn't you agree?' the draco-mantis teases, circling his lips with his tongue before giving you a wink. 'Was it to your liking too?' Considering the intensity of the orgasm he gave you, you have to agree, nodding your head at him before slumping back to lie on the bed, staring at the ceiling. 'If you're going to fall asleep, at least scooch over so that I can fit beside you. I don't want to miss my chance at some post-coital cuddling.' You shuffle over and feel the draco-mantis recline beside you and embrace you. 'Mmmmm. Cozy. Just a warning though. If you do nod off, I have an errand that I've been asked to do, so I may not be around when you wake up. Don't hesitate to drop by again in future though. I swear that we'll be able to have a proper conversation next time. Only if you want to though. No pressure.' The two of you lie there until you fall asleep, J'Reth's firm body intimately curved around your own. You wake again to find him pulling his clothes back on and decide that you should probably be leaving too. When the both of you are ready, you leave the toy shop together before reluctantly parting to go about the rest of your day.";
		now resolution of Reciprocal Thanks is 1; [Received oral pleasurings from J'Reth]
	else:
		LineBreak;
		say "     Deciding that you would rather just sit and appreciate the amount of effort that must have gone into collecting so many posters, figurines, and other memorabilia, you tell J'Reth that for now you would prefer to just look around at his collection. 'I can understand that,' he laughs. 'It is quite considerable, and the size of the room makes it look all the more impressive. I realize that I'm a bit geeky, but I like what I like. Tabletop figures and scenery, posters from movies I enjoyed, collectibles from video games, and somewhere, I think that I even have some genuine movie props that my friends got me for my birthday a few years ago.' He falls silent for a few minutes, before continuing a little more reserved. 'I haven't seen them since the city fell apart. I just hope that they're alright and weren't one of the people who just dissolved. The sight of that was horrible.' He shudders, and you give him a quick reassuring hug.";
		say "     J'Reth leans against you and sighs, 'Thank you. If I can get through this, then so can they. There are good people out there as well as the ravening hordes,' he jokes, waving what looks like an orc figurine in his hand. You snort before agreeing. His collection really suits him. Wanting to return the subject to his hobby, the draco-mantis begins to show you some of the posters that he doesn't have up on the wall, instead having them rolled up in tubes. You enjoy this for about half an hour before J'Reth reluctantly comes to a stop. 'I have some errands that I have been asked to do, so I'm sorry that I'm going to have to go. I've really enjoyed being able to show off to you though, so feel free to come and see me again. Who knows, I may be able to convince you to play one of the games with me.' You decide that you should probably be leaving too, exiting the toy shop together before parting to go about the rest of your day.";
		now resolution of Reciprocal Thanks is 2; [Did not receive oral pleasurings]
	now Reciprocal Thanks is resolved;

Table of GameEventIDs (continued)
Object	Name
Invitation to Storeroom	"Invitation to Storeroom"

Invitation to Storeroom is a situation.
ResolveFunction of Invitation to Storeroom is "[ResolveEvent Invitation to Storeroom]".
The level of Invitation to Storeroom is 0.
Sarea of Invitation to Storeroom is "Nowhere".

after going to Mall Foodcourt while (Reciprocal Thanks is resolved and Invitation to Storeroom is not resolved and HP of J'Reth is 1 and a random chance of 1 in 3 succeeds):
	InvitationtoStoreroomEvent;

to say ResolveEvent Invitation to Storeroom:
	InvitationtoStoreroomEvent;

to InvitationtoStoreroomEvent:
	say "     As you pass through the food court, you see someone come rushing over to you, recognizing them as J'Reth after just a moment. 'I couldn't remember whether I had told you to come and visit me anytime that you wanted,' the draco-mantis breathlessly calls as he nears you. 'I may not always be there, but even if I'm not you can have a look at my collection while you wait for me as long as you are careful. Do you remember where I live? In the back of the toy store, just here.' he says, pointing to a conveniently placed map of the mall on a column beside the two of you. 'Sorry if I'm repeating myself, but I thought it better to tell you again just to make sure I wasn't sitting around waiting for someone who didn't know where to find me.' You have to agree with the logic and you find it cute just how much he seems to enjoys your company. 'Got to go again, I have a meeting with the representative of our area of the mall and I think I'm already going to be a couple of minutes late.' With that, he runs off again, leaving you to try and remember the directions to the toy store.";
	change the Northwest exit of Mall West Wing to J'Reth's Room; [connecting the location to the travel room]
	change the Southeast exit of J'Reth's Room to Mall West Wing; [connecting the location to the travel room]
	move J'Reth to J'reth's Room;
	now Invitation to Storeroom is resolved;

Table of GameEventIDs (continued)
Object	Name
Backpack Lost & Found Stage One	"Backpack Lost & Found Stage One"

Backpack Lost & Found Stage One is a situation.
ResolveFunction of Backpack Lost & Found Stage One is "[ResolveEvent Backpack Lost & Found Stage One]".
The level of Backpack Lost & Found Stage One is 0.
Sarea of Backpack Lost & Found Stage One is "Nowhere".

after going to College Administration Building while (Charisma of J'Reth is 1 and Backpack Lost & Found Stage One is not resolved):
	BackpackLost&FoundStageOneEvent;

to say ResolveEvent Backpack Lost & Found Stage One:
	BackpackLost&FoundStageOneEvent;

to BackpackLost&FoundStageOneEvent:
	say "     Entering the administration building, you look around for some sort of sign to direct you to [']Lost and Found['] so that you can check if J'Reth's backpack has been handed in or even if they can direct you to someone who can be of aid to you. Seeing your lost expression, a slender cheetah-woman in a knee-length black skirt and pale-blue shirt approaches you, her name tag identifying her as [']Atalanta[']. 'Hello. You look a little lost. Can I help you?' she asks brightly, shifting from one hind-paw to the other as she quickly looks you over. You smile and return her greeting before explaining the conundrum that you are in, the feline's face creasing in thought as you continue. 'You can tell your friend that he has good taste, I love the Backpackemon games, but someone collected the bag a couple of days ago, saying that they were one of his friends too. I hope that they were being honest...' the cheetah ponders, drumming her claws against her arm. You reassure her that it was probably another friend from the KnK group and ask her whether she can tell you where to find them.";
	say "     'Technically I shouldn't reveal our students' private information, but I think that it should be okay in this case. Ask for Gerald at the front desk of the [bold type]Male Dormitory. Head south-east until you reach the eastern walkway, then head north-east onto Dorm Street. The Male Dormitory is to the east.[roman type] I hope you find what you are looking for,' she confided. Thanking her, you turn to leave [if FemaleList is not Warded and FemaleList is not Banned]but you feel a paw on your shoulder. Returning your attention to the cheetah, you see her looking at you with half-lidded eyes. 'Don't forget to visit. It can get pretty lonely here...' she purrs. Taking the pickup line for what it is, and doubting that she can be that lonely surrounded by horny students, you reassure her that you will make sure to come back and tell her when you return the backpack to J'Reth, earning a wink as she releases you. Whether or not you actually do remains to be seen[else] but the cheetah draws your attention back again by calling after you, 'Get Gerald to come and see me while you're there. I would feel guilty if I didn't apologize about telling you where to find him.' You assure her that you will tell him and continue on your way[end if].";
	now Backpack Lost & Found Stage One is resolved;

Table of GameEventIDs (continued)
Object	Name
Backpack Lost & Found Stage Two	"Backpack Lost & Found Stage Two"

Backpack Lost & Found Stage Two is a situation.
ResolveFunction of Backpack Lost & Found Stage Two is "[ResolveEvent Backpack Lost & Found Stage Two]".
The level of Backpack Lost & Found Stage Two is 0.
Sarea of Backpack Lost & Found Stage Two is "Nowhere".

after going to Tenvale College Male Dorms while (Charisma of J'Reth is 1 and Backpack Lost & Found Stage Two is not resolved and BackPack Lost & Found Stage One is resolved):
	BackpackLost&FoundStageTwoEvent;

to say ResolveEvent Backpack Lost & Found Stage Two:
	BackpackLost&FoundStageTwoEvent;

to BackpackLost&FoundStageTwoEvent:
	say "     A few people give you a curious glance as you enter the male dorms, no doubt curious if you are a new resident or whether your intentions lie elsewhere. A voice calls out from an office, 'Could you come in here please. Visitors are asked to sign in. New policy.' Shrugging, you change course and enter the small office, the majority of it being taken up by the hulking form of a male water buffalo. 'Thanks. I think this policy will last about as long as all the previous attempts at maintaining order, but I don't want to end up referred to Azrael again. If there was anyone that embodied [']I'm not angry, just disappointed['] it would be the dean,' he explains, remarkably chatty for what you would assume someone of his size would be. He gives a small nod as you sign your name before engaging with you again. 'I don't think I've seen you before. Are you a straggler from the city or some piece of ass that one of the boys has taken a liking to?'";
	say "     Accustomed to the increase in crudity from many of the people that you have met, you barely bat an eyelash at such a blunt question. You inform him that you are here to see Gerald about a lost backpack, not to be someone's entertainment. At least, not this time. The water buffalo chuckles, 'I assume that Atalanta from the main office sent you. Cheetah woman. Conservatively dressed compared to most. Technically, there are a few people called Gerald here, but if she only gave you a first name, then I'm relatively sure I still know which one it is. He should be in Room 116, just down the corridor. While you're there, tell him to live a little. College is meant to be a time for fun and experimentation as well as learning.' With that, he ushers you out of his office and directs you towards your destination. Once outside room 116, you take breath before knocking, the sound of rustling paper issuing forth in response.";
	WaitLineBreak;
	say "     'It isn't locked,' a tired voice invites you in. You enter into one of the messiest rooms you have seen in a while, not including the ruins out in the city. The floor is covered in paper in various states of scrumpled-ness. 'Don't worry about stepping on anything, it's all garbage.' You look up from the disarray beneath your feet and flinch at the sight of the room's occupant, or more accurately their head which for a moment appears to be on backwards, staring fiercely at you through huge spectacles over the top of their chair while their body is seated towards the desk. After a second you realize that they are some sort of owl, complete with hooked beak and feathery tufts above where their ears might have once been. 'What do you want? Can't you see I'm busy?' he snaps impatiently, turning his chair around to face you, their head remaining still as their torso aligns properly. You explain that you are a friend of J'Reth's and that he asked you to find his backpack which he had lost, earning a derisive snort from the owl.";
	say "     'Ha. Well at least you're probably telling the truth. That name's rather unique and [']J'Reth['] seldom broke character so I suppose it makes sense that he has taken this chance to reinvent who he is. Still, I can't just give you the backpack when I don't even know who you are. First, you must complete several tasks for me to prove that you are trustworthy. To begin, you must-' You cut the owl off before he can get any further, firmly stating that you are here to collect the bag for J'Reth, unless he'd like to make the journey through the city himself. He chokes on his words, coughing as he recovers. 'No. I think that's fine. If J'Reth didn't want to come here, I don't want to go wherever he is either. It's a moot point anyway as Gabrielle took it off me anyway. Something about it being at risk of being lost to the paper sea. You'd think for someone who played a paladin she would have been nicer about it, but short on stature, short on manners.'";
	WaitLineBreak;
	say "     Gerald devolves into muttering grouchily to himself, only stopping for a moment when you ask where you can find her. 'Somewhere in the [bold type]Female Dormitory[roman type] I would imagine. [bold type]Head north from Dorm street[roman type]. Now if you don't mind, I have a dissertation on the use of multicultural myth in modern entertainment to finish. Unlike apparently everyone else, I don't want to be behind in my work when the military sort all of this out,' he fumes. Not wanting to deal with his rudeness any further at the moment, you leave him in peace and return to the entrance hall, the water buffalo giving you a nod as you return[if FemaleList is Banned or FemaleList is Warded]. It is at this point that you realize that you forgot to tell Gerald to go and see Atalanta. Oh well, he seemed too busy anyway[end if]. You seem to be getting to see quite a bit of the college, you just hope that Gabrielle still has the backpack. It almost feels like you're on a quest yourself.";
	now Backpack Lost & Found Stage Two is resolved;

Table of GameEventIDs (continued)
Object	Name
Backpack Lost & Found Stage Three	"Backpack Lost & Found Stage Three"

Backpack Lost & Found Stage Three is a situation.
ResolveFunction of Backpack Lost & Found Stage Three is "[ResolveEvent Backpack Lost & Found Stage Three]".
The level of Backpack Lost & Found Stage Three is 0.
Sarea of Backpack Lost & Found Stage Three is "Nowhere".

after going to Tenvale College Female Dorms while (Charisma of J'Reth is 1 and Backpack Lost & Found Stage Three is not resolved and BackPack Lost & Found Stage Two is resolved):
	BackpackLost&FoundStageThreeEvent;

to say ResolveEvent Backpack Lost & Found Stage Three:
	BackpackLost&FoundStageThreeEvent;

to BackpackLost&FoundStageThreeEvent: [St Trinians]
	say "     You find the entrance to the female dorms to be in a state of anarchy. A line of Spartans approach the entrance while under bombardment from flour and water bombs resulting in them being covered in a white slime though they do their best to deflect these missiles with their shields. You doubt that you'll be getting through this any time soon but decide to stay and watch for a while beside several other spectators. Quietly asking what has caused this, a shrew answers, 'A disagreement between the president of the Naturist Club and Campus Security over punishments. Victoria threw one of the guards in the fountain after he tried to make a student suck him off for littering. Now they want to punish her and the majority of the female dorm has rallied behind her and you can see the result.' Just as the Spartans are about to reach the front steps, a matching shield wall, albeit improvised with garbage can lids, emerges from the entrance led by a remarkably short anthro lynx.";
	say "     'Squad! Do not let them gain the high ground. We have the might of the Naturist, Drama, and LARP clubs behind us. They are but men, and men are inherently weak. Aim where it hurts them most and victory is assured,' the leader shouts to rousing cheers from the windows of the dorm. Some of the Spartans pale at hearing what likely breaches the rules of war, but none want to be the first to flee. 'She's barely taller than a child, if that. Don't tell me you're scared of a little girl!' sneers their commanding officer, stepping out of the line. You watch as the feline's features twist in abject rage and, before anyone can stop her, she hurtles down the steps and rams her shoulder into the startled Spartan commander's groin before he can protect himself. He crumples backwards and lies writhing on the ground and for several whole seconds everyone remains still. Then... the lull breaks.";
	WaitLineBreak;
	say "     One of the other members of the female shield wall breaks ranks and [if hp of Sylvia > 4]to your surprise, you recognize Sylvia, the border collie zoologist, as [end if]she snatches the lynx by the arm and drags her back just as some of the Spartans recover and attempt to make a grab for her themselves. 'Time to withdraw again Gabrielle. We can't let our commander get captured for an excess of boldness. The feline doesn't seem to appreciate this interference. 'Let me go! I can take them! I'll teach them to make fun of my height!' she howls futilely, though doing little to actually resist as she is pulled behind the defensive shield wall as the Spartans advance. 'Stop this instant!' a firm voice shouts and everyone turns to see [if PericlesRelationship > 1]Pericles [else]a Spartan in full armor [end if]storming over, a very smug-looking naked dragon-woman following after him.";
	say "     'Imagine my surprise to learn that some men, [italic type]my men[roman type], were attempting to force their way into the female dormitory. I did not authorise such an action and it shames me immeasurably that the reputation of College Security should be stained by such an action. Nikandros! You are relieved of command and your Helot privileges are suspended. Men! Fall in. You will all face proper discipline at headquarters. Perhaps I'll even assign you to aid the janitorial squad clean up this mess,' [if PericlesRelationship > 1]Pericles [else]their commander [end if]shouts, everyone nearby having fallen into a stunned silence. Shockingly, the Spartans react instantly, turning on their heels and marching past their leader, two of them supporting their injured comrade. 'I'll see that the right people are punished for this. You have my deepest apologies Victoria,' the Spartan commander promises before following determinedly after his soldiers.";
	WaitLineBreak;
	say "     Now that the spectacle is over, the crowd begins to disperse and the shield wall disbands, allowing Gabrielle to shake [if hp of Sylvia > 4]Sylvia's [else]the collie's [end if] grip and run out to talk to the dragon-woman. [if hp of Sylvia > 4]Sylvia merely shrugs and beams as Julian [else]The collie merely shrugs and beams as a wolf [end if]steps from the crowd and embraces her before the two of them slip inside, paw in paw. 'We sure showed them, didn't we Vicky?' the lynx excitedly says, looking up at the much taller woman with admiration. 'You did indeed, but perhaps in future lay off the sexist rallying speeches. It doesn't reflect well on us,' Victoria replies, ruffling the fur on the cat's head, much to her apparent annoyance. 'Everyone knows that I don't actually believe in male-inferiority, but when all of the Spartans are male, it seemed a good way of steadying the shield wall against them.' The dragon merely sighs and shakes their head ruefully before moving on to chat with a other people vying for her attention.";
	say "     Deciding that this is as good a moment as any to see if this is the Gabrielle involved with J'Reth's KnK group, you hastily walk over to her just as she is turning to return inside, catching her attention. She regards you warily for a moment as you approach, but decides that your body language doesn't exhibit anything overtly hostile and patiently waits for you to reach her. 'You look [if player is herm or player is neuter]to be [else if player is male]like a man [else if player is female]like a woman [end if]on a mission. What can I help you with? Just remember what happened to Nikandros if you make fun of my height,' she greets you. Assuring her that you have no intention of mocking her, you explain that you are came to collect J'Reth's backpack for him and that Gerald sent you her way.";
	WaitLineBreak;
	say "     'So he's going by his character name now? Good for him. I'm sure your encounter with Gerald was a treat though. Best gamemaster I've had, but his people skills are atrocious. I assume that you saw his room? Some are rejected pages from his dissertation, others are ideas for games which he has deemed flawed in one way or another. I took the bag so that it wouldn't get buried and forgotten, but I've since given it to Selena and Jasper. They were going to take it to J'Reth themselves, but I assume that if you're here that they still haven't got around to doing it then. They should be in the library then. They're the last two that were in our KnK group so the bag should be with them or in one of their rooms. You seem in a rush, so I won't keep you any longer. If you have any problems you can ask for me at the front desk. Say hi to J'Reth from me and try to persuade him to visit. Our party hasn't dared continue without our trusty warlock,' Gabrielle purrs. With a sigh, you thank her for her help. 'No problem. Do you know how to get to the library? [bold type]From the Eastern Walkway, head north-west, then north-east.[roman type]' Seeing you nod your understanding, she gives you a quick smile before returning to celebrate with her colleagues, quite the different person from the ball of fluffy fury that shoulder-charging the Spartan lines.";
	now Backpack Lost & Found Stage Three is resolved;

Table of GameEventIDs (continued)
Object	Name
Backpack Lost & Found Stage Four	"Backpack Lost & Found Stage Four"

Backpack Lost & Found Stage Four is a situation.
ResolveFunction of Backpack Lost & Found Stage Four is "[ResolveEvent Backpack Lost & Found Stage Four]".
The level of Backpack Lost & Found Stage Four is 0.
Sarea of Backpack Lost & Found Stage Four is "Nowhere".

after going to Tenvale College Library while (Charisma of J'Reth is 1 and Backpack Lost & Found Stage Four is not resolved and BackPack Lost & Found Stage Three is resolved):
	BackpackLost&FoundStageFourEvent;

to say ResolveEvent Backpack Lost & Found Stage Four:
	BackpackLost&FoundStageFourEvent;

to BackpackLost&FoundStageFourEvent:
	say "     The library is remarkably quiet considering the general enthusiasm and boisterousness that the majority of students seem to have these days, though perhaps the purpose of the library still remains the same; a place to quietly study and learn. You're not sure exactly how to go about finding two students in particular, as you doubt that the library staff will be expected to know the movements of everyone who comes in here. Nonetheless, you resolve to try anyway, walking up to the front desk and in a hushed tone ask the vulture-woman overseeing it whether they could tell you where you might find Selena and Jasper. She gives you a disapproving glare. 'This isn't a place for socializing and even so, I don't know the names of the majority of the people who come in here. Either quietly find the relevant book for whatever you are studying or get out,' she tersely replies.";
	say "     Surprised at such a hostile reaction to an innocent request for guidance, you are about to further plead your case when you feel something get pressed into your hands, turning around, you see a shark-man retreating between the shelves, briefly turning to gesture with his head for you to follow him. Considering your luck so far, this may be Jasper so you follow after him, leaving the sour-faced librarian to mutter under her breath. Opening the note as you walk, you see that it simply says, [']Don't talk to her. She doesn't help anyone['], a statement which you can believe. Between the many lights and the shark's size, it isn't difficult to follow him until he eventually stops at a cluster of comfortable-looking chairs and turns to face you. 'Mmm. You look delicious. I could just eat you up. When I saw you talking to that old vulture, I knew that I had to intervene,' he says, casting his eyes all over your body hungrily. You cautiously ask whether he is Jasper, a question which confuses him. 'No. I take it then that you aren't Alex from art class?' the shark responds, beginning to look a little embarrassed.";
	WaitLineBreak;
	say "     You confirm that you are indeed not Alex from art class, patting him awkwardly on the arm as he blushes. 'Sorry. You look exactly like [if player is Male]him[else]her[end if]. I'd sent a note asking [if player is Male]him [else]her [end if]to meet me here and I automatically assumed that you were them. I was too shy to talk to them after class, you see.' He's quite adorable with how flustered he is considering his size. 'You said you were looking for someone called Jasper. Do you know their surname?' the shark asks, attempting to recover from his embarrassment. Shaking your head, you reply that you only know that you're looking for Jasper and Selena. He brightens at hearing this, 'The naga and kobold couple? Last I saw them they were in one of the study rooms. Follow me and I'll show you,' he says, walking away before you have a chance to agree and leaving you to stumble after him.";
	say "     As you are crossing through the entrance again under the piercing gaze of the vulture librarian, you see someone who bears a striking resemblance to you looking around as though searching for someone. Your guide seems to notice them too and looks between the two of you awkwardly, unsure what to do. Seeing the conundrum, and wondering what the chances were of someone looking exactly like you, you quietly tell him that he should go and meet them, but perhaps not to greet them in the same way as he did you. It might be a little too forward. Giving a rueful chuckle, the shark quickly gives you instructions on how to get to the study rooms before haltingly approaching your apparent doppelganger. Their face lights up upon seeing him and you get the impression that the two of them will do just fine.";
	WaitLineBreak;
	say "     It doesn't take you long to find your way to your destination and the appearances of the occupants inside the glass room reassure you that you are in the right place. Knocking gently on the door, the kobold gives you a curious look and walks over to open it for you. 'I'm relatively sure we have the room booked for a couple more hours. Was there something that you needed from us?' he asks, the naga giving you a wink from behind him. Without turning around, the kobold growls, 'Selena, either you're pulling faces at them or winking. Have some restraint. I do not want to be reported to the librarian again, is that clear?' Looking suitably chastened, the naga nods, wilting slightly. 'I apologize for my girlfriend's behavior. Usually I wouldn't mind, but the vulture at the front desk gave us a warning about public indecency earlier today after Selena made eyes at another student. While their boyfriend was with them. It's our first year at college and I don't want to make an enemy of the library staff. Wait, why am I telling you this when I haven't the faintest idea who you are or why you are here?'";
	say "     You reassure them that you have no intent of reporting them to anyone and that you are trying to retrieve J'Reth's backpack for him having already talked to both Gerald and Gabrielle. 'It seems like you are quite accustomed to questing yourself, I don't suppose you are a fan of KnK,' the kobold chortles. 'I'm Jasper and this shameless serpent is Selena. We were having a look at maps to work out the safest way through the city. We had come to the conclusion that the sewers might be best, but if you are happy to take the backpack to J'Reth on our behalf then that would definitely be safer for us,' he explains. The naga grabs something from behind the desk and slithers over, passing you a cute pink backpack shaped like a Backpackemon, her fingers lingering against yours, earning her another exasperated sigh from her boyfriend. 'This will come as no surprise I'm sure, but Selena is the Bard of the party and she was no less [']inviting['] in game. I was the Rogue, but that is hopefully less apparent. Kleptomania can cause problems.'";
	WaitLineBreak;
	say "     'Don't get me wrong. I love Selena and all her quirks, but there are times when seduction is not the best path forward,' Jasper explains, Selena muttering, 'So says you,' under her breath. Once again, the kobold picks up on this. 'Sometimes a little more subtlety is required. This may come as a shock, but not everyone is attracted to you,' he fires back, elbowing her in the ribs. The naga lets out a dramatic sigh and returns to her chair. 'I suppose I should let you get back to J'Reth with his belongings, and we had better return these schematics to the archive before we end up with a late penalty. We'll gladly talk should we meet again, but perhaps not in the library. Selena might even show off her singing,' Jasper offers, his girlfriend hissing at him in response. 'Perhaps, perhaps not,' he laughs as you wave farewell to each other and you leave the study room again, the Felicitas backpack safely stowed within your own. You're sure that J'Reth will be appreciative of the effort that you have gone through to get it, though meeting his friends has been sort of fun in itself.";
	now Backpack Lost & Found Stage Four is resolved;

J'Reth ends here.
