Version 3 of Lindsey by Prometheus begins here.
[ Originally by Sarokcat]
[ Version 2.3 - Lindsey WS scene ]
[ Version 3 - Beta path for player - By Prometheus]


"Adds an NPC to Flexible Survival with a variety of responses and goals."


[ Hp of Lindsey                            ]
[   0 = not met                            ]
[   1 = talked                             ]
[   2 = Player is Lindsey's Beta           ]

[ level of Lindsey                         ]
[ 4+ = player claimed  (Lindsey's Beta)    ]

LindseyMPregDetected is a truth state that varies. LindseyMPregDetected is usually false.
lindseyws is a truth state that varies. lindseyws is usually false.

Section 1 - Lindsey the Wolftaur

Table of GameCharacterIDs (continued)
object	name
Lindsey	"Lindsey"

Lindsey is a man.
[Physical details as of game start]
ScaleValue of Lindsey is 4. [6' 10"]
Body Weight of Lindsey is 5. [scale of 1-9 for body weight, grouped into low weight (1-3), mid weight (4-6) and high weight (7-9)]
Body Definition of Lindsey is 6. [scale of 1-9 for body definition, grouped into low muscle (1-3), mid muscle (4-6), high muscle (7-9)]
Androginity of Lindsey is 2. [Gender Adjective is generated out of androginity 1-9: hypermasculine/masculine/somewhat effeminate/effeminate/androgynous/feminine butch/tomboyish/feminine/hyperfeminine]
SleepRhythm of Lindsey is 0. [0 - awake at all times, 1 - day active, 2 - night active]
Mouth Length of Lindsey is 7. [inches deep for face fucking; maximum possible will be double this number (when deep throating)]
Mouth Circumference of Lindsey is 3. [mouth circumference 1-5, "tiny, small, normal, wide, gaping"]
Tongue Length of Lindsey is 7. [length in inches]
Cock Count of Lindsey is 1. [number of cocks]
Cock Girth of Lindsey is 4. [thickness 1-5, thin/slender/average/thick/monstrous]
Cock Length of Lindsey is 10. [length in inches]
Ball Size of Lindsey is 4. [size of balls 1-7: "acorn-sized", "dove egg-sized", "chicken egg-sized" "goose-egg sized", "ostrich-egg sized", "basketball-sized", "beachball-sized"]
Ball Count of Lindsey is 2. [allowed numbers: 1 (uniball), 2 or 4]
Cunt Count of Lindsey is 0. [number of cunts]
Cunt Depth of Lindsey is 0. [penetrable length in inches; some minor stretching allowed, or more with Twisted Capacity]
Cunt Tightness of Lindsey is 0. [size 1-5, generates adjectives of extremely tight/tight/receptive/open/gaping]
Clit Size of Lindsey is 0. [size 1-5, very small/small/average/large/very large]
Asshole Depth of Lindsey is 12. [inches deep for anal fucking]
Asshole Tightness of Lindsey is 2. [asshole tightness 1-5, "extremely tight, tight, receptive, open, gaping"]
Nipple Count of Lindsey is 6. [count of nipples]
Breast Size of Lindsey is 0. [cup size as number, counting Flat Pecs = 0, A = 1, B = 2, ...]
[Basic Interaction states as of game start]
TwistedCapacity of Lindsey is false. [can not take oversized members without pain]
Sterile of Lindsey is false.
PlayerMet of Lindsey is false.
PlayerRomanced of Lindsey is false.
PlayerFriended of Lindsey is false.
PlayerControlled of Lindsey is false.
PlayerFucked of Lindsey is false.
OralVirgin of Lindsey is false.
Virgin of Lindsey is false.
AnalVirgin of Lindsey is true.
PenileVirgin of Lindsey is false.
SexuallyExperienced of Lindsey is true.
MainInfection of Lindsey is "Wolftaur".
Description of Lindsey is "[LindseyDesc]".
Conversation of Lindsey is { "Suck it!" }.
Lindsey is in Zoo Restrooms.

to say LindseyDesc:
	project the Figure of Lindsey_soft_icon;
	say "     There is a large wolftaur examining itself in the mirror. Its large, canine lower body stretches behind it, and its tail is wagging slightly as it obviously approves of what it sees. The body of the beast is covered in soft black fur, and the face is definitely more lupine than human. The sharp claws on its human hands look capable of doing a great deal of damage. As the wolftaur shifts its body around and turns its green canine eyes to you, you are given a good look between its legs, the large canine organ hanging half-erect there leaving no doubt as to the beast's maleness.";

the scent of Lindsey is "Lindsey has a strong, masculine scent. It is powerful and arousing, making you long to submit to this beast[if hp of Lindsey is 2] as is his right as alpha[else if level of Lindsey > 5]. As you should, for you are his bitch to use[end if].".

instead of conversing the Lindsey:
	project the Figure of Lindsey_soft_icon;
	if HP of Lindsey is 0:[first time you encounter the NPC text]
		say "     'Well, hey there,' the large beast says with a small smile tugging at his muzzle. 'Fancy seeing someone like you here in the zoo. Must just be my good luck, I guess,' the creature says with a lupine grin as he moves his gaze up and down your body. 'Oh, I suppose I haven't introduced myself yet. The name is Lindsey, a few friends and I decided to have some fun breaking into the zoo when all the crazy stuff started going down,' the male wolf with a female name says, a look of fond remembrance seeming to cross his lupine face as he thinks about the events. 'Let's just say it was a wonderful night to remember.'";
		say "     He pads towards you slowly, the musky smell in the room seeming to intensify as he draws close to you. 'I actually come by here occasionally just for the lovely memories. I had such a lovely time here that night with the wolftaur that used to be my boyfriend... He makes such a lovely bitch now,' the beast says with a grin. He reaches out and strokes your face with one of his clawed fingers, his strong masculine musk flooding your nose and making you feel slightly weak at the knees. 'Hmmm, I think you could make a fine little bitch too, all you need to do is ask, and I can help you with that...' the beast says with a lupine grin before lowering its face to yours to give your cheek a lick. 'Just say the word, and you could be enjoying yourself as much as I am,' Lindsey says in a teasing tone of voice as he saunters back over to the mirrors, his tail wagging happily for some reason as you stand there and try to recover your wits.";
		increase HP of Lindsey by 1;
	else if HP of Lindsey > 0:[Normal short messages the NPC will say each time you talk to them]
		say "[one of]'So are you ready to be my bitch?'[or]'My former boyfriend is back at the den. I could take you to meet her sometime, if you were a proper bitch...'[or]'I am so glad we came to the zoo that night.'[or]'The whole wolf thing was a bit scary at first, but now it is downright amazing.'[or]'It would be nice to have a pack, don't you think?'[or]'I think you would make a fine addition to my pack.'[or]'I wish I knew who caused whatever this is to happen, so I could thank them!'[or]'Have you seen those Tigertaurs out there? If they weren't so feline they could be fun to fuck...'[or]'I love having a cock. I never realized how much fun they were before.'[or]'Don't you want to pet my soft fur?' Lindsey says with a teasing look in his eyes.[or]The wolftaur just stares at you with his bright green eyes as you try to talk to him. Unable to meet that intent gaze, you quickly find yourself lowering your eyes. The wolftaur chuckles, his dominance established.[or]'Wolves have all the fun. I should know.'[or]'Wouldn't you feel better on all four paws?'[or]'It's good to be the alpha.'[at random]";

Section 2 - Sex

the fuckscene of Lindsey is "[sexwithLindsey]".

to say sexwithLindsey:
	project the Figure of Lindsey_hard_icon;
	setmonster "Wolftaur";
	if lastfuck of Lindsey - turns < 6:
		say "     'Sorry there my horny little bitch,' Lindsey says with a soft chuckle, 'but I have to check on my other bitch and make sure she is properly taken care of too, so I need to save a bit of energy for that. Why don't you come back in a little bit and I can make you even more into a proper little bitch, just like you want,' the masculine wolftaur says with lupine grin, the mingled musk of male wolftaur and your recent sex filling the air.";
	else if Player is neuter:
		say "     You are ill-equipped to play with the alluring and masculine wolftaur before you.";
	else if level of Lindsey > 3:
		if BodyName of Player is "Wolftaur":
			if wslevel is 3 and a random chance of 1 in 4 succeeds:
				say "     'Well well, what have we here?' Lindsey says with an amused look on her canine muzzle as he examines your wolftaur form. 'Are you back for another lesson on your proper place? That's easy,' he growls before pouncing against your side, knocking you to the floor on your side. 'Your place is beneath me,' he states, striding confidently over you and grinds his crotch into your face. Confronted by the smell of the dominant wolf's erect manhood right in your face, you give a soft moan as the musky scent arouses you. You have your lips around that throbbing cock before you even know what you're doing.";
				say "     'That's right, my little bitch. Suck that cock and you'll get your treat,' he chuckles. You moan softly around his meat, your increasingly cloudy mind wanting nothing more than to suck the alpha wolf and get your tasty reward. The feel of it pulsing and throbbing in your mouth is wonderful. The taste of that musky rod and the copious precum leaking from it coats your tongue. As you keep sucking, Lindsey goes on to tell you what an eager cocksucker you are and how your place has always meant to be under him. And in your lust-addled have, the wolf's words ring true - [if Player is male]a weak male like yourself is nowhere near as strong and virile as[else]a wolf-bitch like yourself is meant to be mounted by[end if] an alpha stud like him.";
				WaitLineBreak;
				say "     Lindsey places a paw possessively on your ass, rubbing it as you continue to suck him off. You fondle the wolftaur's plump ballsack while licking and sucking all the harder on his rod. He pushes his hips down and forward hard, popping his thick knot past your lips before cumming with a loud howl. Blast after blast of gooey wolf semen shoots into your mouth and pours down your throat. As you struggle to swallow it all, he gives your rear another pat. 'Be a good bitch and take everything I give you,' he pants as he continues to cum. Wanting to please the virile stud, you try all the harder like a good and obedient slut.";
				say "     The wolftaur keeps his spent shaft in your mouth after he's finished, leaving you to lick and suck it clean. During that, a fresh flow starts up and pours down your throat as the wolf gives a soft sigh of relief. You've already obediently swallowed down several mouthfuls of the acrid liquid before realizing that it is his piss. ";
				NPCSexAftermath Player receives "OralCock" from Lindsey;
				if lindseyws is false:
					say "You cough and sputter, pulling your mouth away only to get a faceful of urine. Lindsey growls and continues to piss across your body. 'I told you to take everything I give you, bitch,' he snaps at you, digging his claws into your flank as a painful reminder to obey him in the future. Worn and humiliated, you flop down onto the wet floor, the alpha's mark soaking into your body.";
					infect "Wolftaur";
					infect "Wolftaur";
					now lindseyws is true;
					now lastfuck of Lindsey is turns;
					increase level of Lindsey by 2;
					decrease humanity of Player by 3;
				else:
					say "You resist the momentary urge to pull away, reminding yourself to obey your alpha and take your reward. You continue to drink down his sharp tasting urine, feeling it warm your belly alongside the semen pooled in there. Only when he's spent does the satisfied wolf step back. Worn and satisfied, you flop down onto the messy floor, your confused mind trying for some time to recall what it is like to be more than just a submissive wolftaur.";
					infect "Wolftaur";
					infect "Wolftaur";
					now lastfuck of Lindsey is turns;
					increase level of Lindsey by 1;
					SanLoss 6;
			else if Player is male:
				if Player is female:
					say "     'Well well, what have we here?' Lindsey says with an amused look on his canine muzzle as he examines your own wolftaur-like body. 'A bit of a gender-confused wolftaur I see,' the strong male wolftaur says with a chuckle. 'I see your body can't decide if it should be male or female there or a bit of both. Maybe I can help you out there by showing you what it's like to be a proper little bitch,' he says in a low, teasing tone, his dominant words making your body shudder and grow hot with arousal. At the same time, his powerful alpha musk surrounds you, making your body respond instinctively, your pussy dampening while your rear legs shift further apart and your tail lifts up in anticipation. You only have a moment for your lust-fogged mind to realize the implications of your body's new stance before the strong male beast is climbing atop you, his forepaws gripping your canine sides while his arms reach around your humanoid torso to clutch you close against his own upper body. His canine chin comes to rest against your shoulder as a moan of pleasure slips through your lips.";
					say "     Your mind is still reeling even as your body responds eagerly to his soft touch and the weight of him on your back, instinctively bracing itself underneath him, your pussy beginning to burn with primal need while your cock feels limp and useless as you rub your body up against the strong alpha wolftaur. Your canine ass wiggles as it rubs up against his own firm, powerful hindquarters, teasing and begging for his dominant rod to fill you up. You can feel yourself panting in need as your own hands reach down to tangle with the more dominant male's as he strokes your chest and reaches up to tease and rub your soft nipples.";
					WaitLineBreak;
					say "     Lindsey wastes no time in accepting your body's encouragement, his cock beginning to rub against your canine pussy, the intense smell of his musk making you feel like a bitch in season as you whine underneath him. Then, with one powerful thrust, the male sheathes himself in you, and your mind shuts down as the pleasure of his hot thick canine meat pressing into your body fills you, instincts fully taking over as you yip and whine in pleasure underneath him while he pistons that amazing wolf cock in and out of your wet pussy. 'Feel that wonderful sensation of my cock inside you? Splitting you open and making you feel so good?' Lindsey whispers in your ears, your mind barely able to comprehend the meaning of his words as his knot presses up against your body, pushing in more and more with each powerful thrust as it seeks to lock the two of you together in a purely animal embrace.";
					say "     'Feel that cock inside you my little bitch, and let yourself realize that my cock is the only cock a proper bitch like you needs,' he growls into your ear as his hands roam your body. 'After all, what need does a submissive little bitch like you have for a [Cock of Player] cock. It just hangs there uselessly while the stronger males mount your slutty little bitch pussy, doesn't it? I can't even imagine what use a bitch like you would have for such a thing,' the male says as you groan in pleasure at his thick knot sliding into your body, your pussy clenching it tight as he ties with you.";
					WaitLineBreak;
					say "     You groan submissively underneath him as you realize he is right. Submissive little bitches like you don't need cocks, and yours isn't even erect despite how horny your body is; in fact, with his wonderful wolf cock inside you, you can't even imagine yourself in any male role anymore. The final realization of your body's total eager submission to the powerful male makes you groan and shudder with orgasm underneath your dominant mate, your body accepting its role as a bitch as your vagina grips his bestial cock tight. Feeling your orgasm underneath him, Lindsey howls in triumph as he gives into his own orgasm, his cock twitching as it paints your willing womb with your alpha's healthy seed.";
					say "     You pant in pleasure at the feel of your mate's seed filling your womb, even as he relaxes and begins to stroke you with his claw-tipped hands. 'You feel that lovely wolf sperm sinking into your body?' the alpha male says with a lupine grin as he relaxes on top of you. 'That is what being a proper bitch is about, letting your mate fill you full of his seed so you can carry his pups, not having a useless little cock of your own,' Lindsey says with a satisfied air of triumph as you pant and nod eagerly in agreement, your mind still awash in pleasure. Eventually his large knot shrinks to the point where he can pull himself out of you, and your handsome mate saunters over to the bathroom counter while you stand there in the middle of the room, his seed leaking down your hind legs as you vaguely try to recall what it is like to be more than just a wolftaur bitch.";
					NPCSexAftermath Player receives "PussyFuck" from Lindsey;
					infect "Wolftaur";
					infect "Wolftaur";
					now lastfuck of Lindsey is turns;
					increase level of Lindsey by 1;
					SanLoss 5;
				else if Player is mpreg_ok:
					if LindseyMPregDetected is false:
						say "     'Another male wolftaur?' Lindsay says with an amused look on his canine face as he examines your own wolftaur body. 'Well, since you obviously want to be my bitch so badly even as a male, who am I to say no?' the strong wolftaur says as he stalks around you in a predatory manner. His hands slowly stroke across your skin as his powerful dominant musk fills the small space and makes your head swim. 'And I can tell you're proper bitch deep down, like you should be, so I can still enjoy using you like one,' the dominant beast says, rubbing a paw over your lower belly in a way that fills it with a warm, aching need.";
						say "     Your head spins with lust as you try to grasp his meaning, only to feel his weight settle onto your back. You gasp as you brace your lower legs to support the larger wolf's weight while he positions himself on you, his powerful arms wrapping around your upper body as his cock begins to rub up against your own canine rear. You moan as your head begins to cloud over with pleasure, and he settles his canine chin on your shoulder, unable to even think about resistance with his powerful male body on top of your own. He licks your ear and whispers, 'That's right, I can smell that womb of yours, even over the stink of this place. I'm going to enjoy putting my pups in you.'";
						now LindseyMPregDetected is true;
					else:
						say "     'Still a male wolftaur?' Lindsay asks with an amused look on his canine face as he examines your own wolftaur body. 'But we both know you're just as capable of being my breeding bitch even as a male, so who am I to say no?' the strong wolftaur says as he stalks around you in a predatory manner. His hands slowly stroke across your skin as his powerful dominant musk fills the small space and makes your head swim. 'And I can tell that's just what you need - to be that proper bitch you are deep down,' the dominant beast says, rubbing a paw over your lower belly in a way that fills it with a warm, aching need. Your head spins with lust as you try to grasp his meaning, only to feel his weight settle onto your back. You gasp as you brace your lower legs to support the larger wolf's weight while he positions himself on you, his powerful arms wrapping around your upper body as his cock begins to rub up against your own canine rear. You moan as your head begins to cloud over with pleasure, and he settles his canine chin on your shoulder, unable to even think about resistance with his powerful male body on top of your own. He licks your ear and whispers, 'That's right, I've got just what a wolftaur womb needs, even for a male like you. I'm going to enjoy putting my pups in you.'";
						WaitLineBreak;
					say "     You find yourself panting in need as his canine member rubs up against your hole, the tip pushing in slightly as he shifts his hips in order to get the best position before thrusting himself into you in one swift, sure movement. You shudder underneath him as you feel his cock filling your ass, a strong wave of submissive pleasure coming over you as his knot rubs against the base of your tailhole. Lindsey groans in pleasure as he whispers into your ear, 'Just let go of all that male aggression.' He traces his tongue along your ear as he begins to move his hips, driving his amazing cock into you further with each thrust. 'We both know you're meant to be a breeder, so just let it all go and embrace those submissive, bitch-like tendencies we both know you love so much,' the male pants into your ears. His words send a rush of heated need into your hidden womb, filling your lust-fogged mind with an increasing sense of their rightness. 'Just submit and let your alpha take care of breeding you from now on...' he says as he grunts, his knot pressing up against your rear as it seeks to lock the two of you together.";
					WaitLineBreak;
					say "     'Feel that big large wolf knot as it rubs up against you,' he growls into your ear as his hands roam your body. 'Soon you will have that knot inside you, locking me inside you and ensuring that none of my seed escapes you, my little breeding bitch,' the male says confidently as he licks and nibbles at your ear. You groan in pleasure as his thick knot finally slides fully into your body a few hard thrusts later. Your ass clenches that meaty bulb tight after it's popped into you, ensuring a good, solid tie. You groan submissively underneath him as you realize he is right; you are just a submissive little breeding he-bitch for your big strong alpha. In fact, with his wonderful wolf cock inside, you can't even imagine how you could have ever wanted to be anything but the slutty bitch of this strong, powerful male. The final realization of your body's total eager submission to the powerful male makes you groan and shudder with orgasm underneath your dominant mate, your body accepting its role as a bitch as your anus squeezes his bestial cock needfully. Feeling your orgasm underneath him, Lindsey howls in triumph as he gives into his own orgasm, his cock twitching as it paints your willing womb with your alpha's healthy seed.";
					WaitLineBreak;
					say "     You pant in pleasure at the feel of your mate's seed filling your womb, even as he relaxes and begins to stroke you with his claw-tipped hands. 'You feel that lovely wolf sperm sinking into your body?' the alpha male says with a lupine grin as he relaxes on top of you. 'Just give in to what you know you want, become a submissive little bitch for me to use and fill full of my seed whenever I want. Doesn't your body feel so good, nice and full of my lovely little pup batter? Such strong and virile alpha cum that it'll put pups even in your male belly. Just imagine how much better you would feel with your submissive he-bitch belly round and swollen with a litter of puppies instead of just my seed,' Lindsey says with a satisfied air of triumph. You pant and nod eagerly in agreement, your hands rubbing your sides as you imagine the feel of your alpha's pups growing in your body, your mind still completely awash in pleasure. Eventually his large knot shrinks to the point where he can pull himself out of you, and your handsome mate saunters over to the bathroom counter while you stand there in the middle of the room, his seed leaking down your hind legs as you vaguely try to recall what it is like to be more than just a wolftaur bitch.";
					NPCSexAftermath Player receives "AssFuck" from Lindsey;
					infect "Wolftaur";
					infect "Wolftaur";
					now lastfuck of Lindsey is turns;
					increase level of Lindsey by 1;
					SanLoss 5;
				else:
					say "     'Another male wolftaur?' Lindsey says with an amused look on his canine face as he examines your own wolftaur body. 'Well, since you obviously want to be my bitch so badly even as a male, who am I to say no?' the strong wolftaur says as he stalks around you in a predatory manner. His hands slowly stroke your [Skin of Player] skin as his powerful dominant musk fills the small space and makes your head swim. 'Even though you aren't a proper bitch like you should be, I can still enjoy using you like one,' the dominant beast says, your head spinning with lust as you try to grasp his meaning, only to feel his weight settle onto your back. You gasp as you brace your lower legs to support the larger wolf's weight as he positions himself on you, his powerful arms wrapping around your upper body as his cock begins to rub up against your own canine rear. You moan as your head begins to cloud over with pleasure, and he settles his canine chin on your shoulder, unable to even think about resistance with his powerful male body on top of your own.";
					say "     You find yourself panting in need as his canine member rubs up against your hole, the tip pushing in slightly as he shifts his hips to get the best position before thrusting himself into you in one swift, sure movement. You shudder underneath him as you feel his cock filling your ass, a strong wave of submissive pleasure coming over you as his knot rubs against the base of your tail hole. Lindsey groans in pleasure as he whispers into your ear, 'Just let go of all that male aggression.' He traces his tongue along your ear as he begins to move his hips, driving his amazing cock into you further with each thrust. 'You can't handle being a dominant male wolf now, and you know it, so just let it all go and embrace those submissive, bitch-like tendencies we both know you love so much,' the male pants into your ears, his words filling your lust-fogged mind with an increasing sense of their rightness. 'Just submit and let your alpha take care of you now...' he says as he grunts, his knot pressing up against your rear as it seeks to lock the two of you together.";
					WaitLineBreak;
					say "     You aren't sure what it is about the situation: the strong male on your back with his cock in your ass as he uses you like a bitch, his soft words of encouragement, or the feel of his powerful male arms wrapped around you as he presses himself up against your body, but you find yourself feeling even more submissive and weaker than ever, happy to moan under the stronger, more dominant male as his knot enters your body and seals you together. Groaning underneath the more powerful wolf, you find yourself realizing that inside you are nothing more than his slutty canine bitch, even though your outside is male. The realization makes your body shudder in pleasure underneath your alpha male as you feel your old aggressive tendencies slipping away, happy to embrace your bestial side and let your nice strong alpha take care of you.";
					say "     The feel of his seed spurting into your ass makes you howl in pleasure, your voice joining your alpha's as you both shudder in orgasm as he fills your insides up with his sperm, marking you forever as his submissive pack member. The two of you stay locked together for a time, his seed churning inside your bowels as his knot slowly begins to shrink, your alpha stroking and petting you with his hands and paws even as he tells you what a good bitch you will be for his pack. Eventually, Lindsey's knot has shrunk enough he can pull it out of you, making you shudder at the sudden feeling of emptiness as he stalks happily over to the bathroom sinks, leaving you to slowly come to terms with all that has happened.";
					NPCSexAftermath Player receives "AssFuck" from Lindsey;
					infect "Wolftaur";
					infect "Wolftaur";
					now lastfuck of Lindsey is turns;
					increase level of Lindsey by 1;
					SanLoss 5;
			else:
				say "     'Well well, what have we here?' Lindsey says with an amused look on his canine muzzle as he examines your own wolftaur-like body. 'A nice proper little wolftaur bitch for me to enjoy,' the strong male wolftaur says with a chuckle, 'and obviously ready and eager for a real wolftaur to take you into his pack and show you just what life is like for needy little wolftaur bitches,' he says in a low, teasing tone, his dominant words making your body shudder and grow hot with arousal, even as his powerful alpha musk surrounds you, making your body respond instinctively, your pussy dampening while your rear legs shift further apart and your tail lifts up in anticipation. You only have a moment for your lust-fogged mind to realize the implications of your body's new stance before the strong male beast is climbing atop you, his forepaws gripping your canine sides even as his arms reach around your humanoid torso to clutch you close against his own upper body, his canine chin coming to rest against your shoulder as a moan of pleasure slips through your lips.";
				WaitLineBreak;
				say "     Your mind is still reeling even as your body responds eagerly to his soft touch and the weight of him on your back, instinctively bracing itself underneath him, your pussy beginning to burn with primal need, strong feelings of submissive bliss washing through your mind as your canine ass rubs up against his own strong, powerful hindquarters in need, teasing and begging for his dominant rod to fill you up. You can feel yourself panting in bestial need as your own hands reach down to tangle with the more dominant male's as he strokes your chest and reaches up to tease and rub your soft nipples. Lindsey wastes no time in accepting your body's encouragement and obvious submission, as his cock begins to rub against your canine pussy, the intense smell of his musk making you feel like nothing more than a bitch in season as you whine underneath him.";
				say "     Then, with one powerful thrust, the male sheathes himself in you, and your mind shuts down as the pleasure of his hot thick canine meat pressing into your body fills you, instincts fully taking over as you yip and whine in pleasure underneath him as he pistons that amazing wolf cock in and out of your wet pussy. 'Feel that wonderful sensation of my cock inside you? Splitting you open and making you feel so good?' Lindsey whispers in your ears, your mind barely able to comprehend the meaning of his words as his knot presses up against your body, pushing in more and more with each powerful thrust as it seeks to lock the two of you together in a purely animal embrace.";
				WaitLineBreak;
				say "     'Feel that big large wolf knot as it rubs up against you,?' he growls into your ear as his hands roam your body. 'Soon you will have that knot inside you, locking me inside you and ensuring that none of my seed escapes my little breeding bitch,' the male says as he licks and nibbles at your ear even as you groan in pleasure at his thick knot finally sliding fully into your body, your pussy clenching it tightly as he ties with you. You groan submissively underneath him as you realize he is right, you are just a submissive little breeding bitch for your big strong alpha, in fact with his wonderful wolf cock inside you can't even imagine how you could have ever wanted to be anything but the slutty bitch of this strong, powerful male. The final realization of your body's total eager submission to the powerful male makes you groan and shudder with orgasm underneath your dominant mate, your body accepting its role as a bitch as your vagina grips his bestial cock tight. Feeling your orgasm underneath him, Lindsey howls in triumph as he gives into his own orgasm, his cock twitching as it paints your willing womb with your alpha's healthy seed. You pant in pleasure at the feel of your mate's seed filling your womb";
				WaitLineBreak;
				say "     As he relaxes and begins to stroke you with his claw-tipped hands. 'You feel that lovely wolf sperm sinking into your body?' the alpha male says with a lupine grin as he relaxes on top of you. 'Just give in to what you know you want, become a submissive little bitch for me to use and fill full of my seed whenever I want. Doesn't your body feel so good, nice and full of my lovely little pup batter? Just imagine how much better you would feel with your submissive little bitches belly round and swollen with a litter of puppies instead of just my seed,' Lindsey says with a satisfied air of triumph as you pant and nod eagerly in agreement, your hands rubbing your sides eagerly as you imagine the feel of your alpha's pups growing in your body, your mind still completely awash in pleasure. Eventually his large knot shrinks to the point where he can pull himself out of you, and your handsome mate saunters over to the bathroom counter while you stand there in the middle of the room, his seed leaking down your hind legs as you vaguely try to recall what it is like to be more than just a wolftaur bitch.";
				NPCSexAftermath Player receives "PussyFuck" from Lindsey;
				infect "Wolftaur";
				infect "Wolftaur";
				now lastfuck of Lindsey is turns;
				increase level of Lindsey by 1;
				SanLoss 5;
		else if BodyName of Player is listed in infections of taurlist:
			if Player is herm:
				say "     'Well, look at you?' Lindsey says with an amused look on his canine muzzle as he examines your [bodytype of Player] body. 'A bit of a gender-confused taur. But just as needy, I can tell,' he adds with a chuckle while running a paw across your rear. 'I see your body can't decide if it should be male or female there or a bit of both. Maybe I can help you out there by showing you what it's like to be a proper little bitch,' he says in a low, teasing tone. His dominant words make your body shudder and grow hot with arousal, even as his powerful alpha musk surrounds you. Your body starts to respond instinctively, your pussy dampening while your rear legs shift further apart in anticipation. You only have a moment for your lust-fogged mind to realize the implications of your body's new stance before the strong male beast is climbing atop you. His forepaws grip your tauric sides even as his arms reach around your humanoid torso to clutch you close against his own upper body, his canine chin coming to rest against your shoulder as a moan of pleasure slips through your lips.";
				say "     Your mind is still reeling even as your body responds eagerly to his soft touch and the weight of him on your back, instinctively bracing itself underneath him. Your pussy begins to burn with primal need as you rub your body up against the strong alpha wolftaur, your hindquarters wiggling as it rubs up against his erection, teasing and begging for his dominant rod to fill you up. You can feel yourself panting in need as your own hands reach down to tangle with the more dominant male's as he strokes your chest and reaches up to tease and rub your soft nipples. Lindsey wastes no time in accepting your body's encouragement as his cock begins to rub against your dripping pussy, the intense smell of his musk making you need the powerful taur inside you all the more.";
				WaitLineBreak;
				say "     With one powerful thrust, the male sheathes himself in you, and your mind shuts down as the pleasure of his hot thick canine meat pressing into your body fills you, instincts fully taking over as you yip and whine in pleasure underneath him as he pistons that amazing wolf cock in and out of your wet pussy. 'Doesn't that big, lupine cock feel wonderful inside you? Splitting you open and making you feel so good?' Lindsey whispers in your ears, your mind barely able to comprehend the meaning of his words as his knot presses up against your body. It pushes in more and more with each powerful thrust as it seeks to lock the two of you together in a purely animal embrace.";
				say "     'Feel that cock inside you. Doesn't it just make you want to be my little bitch, and let yourself realize that my cock is the only cock a proper bitch like you needs,' he growls into your ear as his hands roam your body. 'After all, what need does a submissive little bitch like you have for a [Cock of Player] cock. All the cock you really need is mine stuffed hard and deep into you, isn't that right?' he rumbles in your ear, thrusting all the harder, making you moan and nod in response, loving the feel of the wolftaur's throbbing meat buried deep inside you.";
				WaitLineBreak;
				say "     You groan in pleasure at his thick knot slides into your body, your pussy clenching it tight as he ties with you. You groan submissively underneath him as you realize he is right, submissive little bitches like you don't need cocks. Yours isn't even erect despite how horny your body is. In fact, with his wonderful wolf cock inside, you can't even imagine yourself in any male role anymore. The final realization of your body's total eager submission to the powerful male makes you groan and shudder with orgasm underneath your dominant mate, your body eager to accept its new role as the wolftaur's bitch as your vagina grips his bestial cock tight. Feeling your orgasm underneath him, Lindsey howls in triumph as he gives into his own orgasm, his cock twitching as it paints your willing womb with his healthy seed.";
				say "     You pant in pleasure at the feel of your lover's seed filling your womb, even as he relaxes and begins to stroke you with his claw-tipped hands. 'You feel that lovely wolf sperm sinking into your body?' the alpha male says with a lupine grin as he relaxes on top of you. 'That is what being a proper bitch is about and what you'll have to look forward to soon,' he says, reaching back to stroke across your flank, now a little more rounded with her hot load and large cock filling you. Lindsey grins and nibbles along your neck as you pant and nod eagerly in agreement, your mind still awash in pleasure. Eventually his large knot shrinks to the point where he can pull himself out of you, and the handsome wolftaur saunters over to the bathroom counter while you stand there in the middle of the room, his seed leaking down your hind legs as you imagine what it'll be like to be a wolftaur bitch.";
				NPCSexAftermath Player receives "PussyFuck" from Lindsey;
				infect "Wolftaur";
				infect "Wolftaur";
				now lastfuck of Lindsey is turns;
				increase level of Lindsey by 1;
				decrease humanity of Player by 3;
			else if Player is female:
				say "     'Well, look at you?' Lindsey says with an amused look on his canine muzzle as he examines your [bodytype of Player] body. 'You may not be a wolftaur yet, but you certainly look like a horny, needy taur nonetheless. I can tell,' he adds with a chuckle while running a paw across your rear. 'Ready and eager to have a strong, male taur atop you and teach you what it's like to be a proper bitch,' he says in a low, teasing tone. His dominant words make your body shudder and grow hot with arousal, even as his powerful alpha musk surrounds you. Your body starts to respond instinctively, your pussy dampening while your rear legs shift further apart in anticipation. You only have a moment for your lust-fogged mind to realize the implications of your body's new stance before the strong male beast is climbing atop you. His forepaws grip your tauric sides even as his arms reach around your humanoid torso to clutch you close against his own upper body, his canine chin coming to rest against your shoulder as a moan of pleasure slips through your lips.";
				say "     Your mind is still reeling even as your body responds eagerly to his soft touch and the weight of him on your back, instinctively bracing itself underneath him. Your pussy begins to burn with primal need as you rub your body up against the strong alpha wolftaur, your hindquarters wiggling as it rubs up against his erection, teasing and begging for his dominant rod to fill you up. You can feel yourself panting in need as your own hands reach down to tangle with the more dominant male's as he strokes your chest and reaches up to tease and rub your soft nipples. Lindsey wastes no time in accepting your body's encouragement as his cock begins to rub against your dripping pussy, the intense smell of his musk making you need the powerful taur inside you all the more.";
				WaitLineBreak;
				say "     With one powerful thrust, the male sheathes himself in you, and your mind shuts down as the pleasure of his hot thick canine meat pressing into your body fills you, instincts fully taking over as you yip and whine in pleasure underneath him as he pistons that amazing wolf cock in and out of your wet pussy. 'Doesn't that big, lupine cock feel wonderful inside you? Splitting you open and making you feel so good?' Lindsey whispers in your ears, your mind barely able to comprehend the meaning of his words as his knot presses up against your body. It pushes in more and more with each powerful thrust as it seeks to lock the two of you together in a purely animal embrace.";
				say "     'Feel that cock inside you. Doesn't it just make you want to be my little bitch, and let yourself realize that my cock is the only cock a proper bitch like you needs?' he growls into your ear as his hands roam your body. 'Soon you will have that knot inside you, locking me inside you and ensuring you'll be knocked up like my little breeding bitch. Doesn't that sound divine, you needy slut?' he rumbles in your ear, thrusting all the harder, making you moan and nod in response, loving the feel of the wolftaur's throbbing meat buried deep inside you. You groan in pleasure at his thick knot slides into your body, your pussy clenching it tight as he ties with you.";
				WaitLineBreak;
				say "     You groan submissively underneath him as you realize he is right, you're meant to be a submissive little breeding bitch for your big, strong alpha. In fact, with his wonderful wolf cock inside you, you can't even imagine how you could have ever wanted to be anything but the slutty bitch of this strong, powerful male. Feeling your orgasm underneath him, Lindsey howls in triumph as he gives into his own orgasm, his cock twitching as it paints your willing womb with his healthy seed.";
				say "     You pant in pleasure at the feel of your lover's seed filling your womb, even as he relaxes and begins to stroke you with his claw-tipped hands. 'You feel that lovely wolf sperm sinking into your body?' the alpha male says with a lupine grin as he relaxes on top of you. 'That is what being a proper bitch is about and what you'll have to look forward to soon,' he says, reaching back to stroke across your flank, now a little more rounded with her hot load and large cock filling you. Lindsey grins and nibbles along your neck as you pant and nod eagerly in agreement, your mind still awash in pleasure. Eventually his large knot shrinks to the point where he can pull himself out of you, and the handsome wolftaur saunters over to the bathroom counter while you stand there in the middle of the room, his seed leaking down your hind legs as you imagine what it'll be like to be a wolftaur bitch.";
				NPCSexAftermath Player receives "PussyFuck" from Lindsey;
				infect "Wolftaur";
				infect "Wolftaur";
				now lastfuck of Lindsey is turns;
				increase level of Lindsey by 1;
				decrease humanity of Player by 3;
			else if Player is mpreg_ok:
				if LindseyMPregDetected is false:
					say "     'Another male taur?' Lindsey says with an amused look on his canine face, as he examines your own [bodydesc of Player] body. 'And I can tell you're proper bitch deep-down, like you should be, so I can still enjoy using you like one,' the dominant beast says, rubbing a paw over your lower belly in a way that fills it with a warm, aching need. Your head spins with lust as you try to grasp his meaning, only to feel his weight settle onto your back. You gasp as you brace your lower legs to support the larger wolf's weight as he positions himself on you, his powerful arms wrapping around your upper body as his cock begins to rub up against your hindquarters. You moan as your head begins to cloud over with pleasure, and he settles his canine chin on your shoulder, unable to even think about resistance with his powerful male body on top of your own. He licks your ear and whispers 'That's right, I can smell that womb of yours, even over the stink of this place. I'm going to enjoy putting my pups in you.'";
					now LindseyMPregDetected is true;
				else:
					say "     'Well, look at you?' Lindsey says with an amused look on his canine muzzle as he examines your [bodytype of Player] body. 'You may not be a wolftaur yet, but we both know you're certainly capable of being my breeding bitch even as a male taur,' the strong wolftaur says as he stalks around you in a predatory manner. His hands slowly stroke across your skin as his powerful dominant musk fills the small space and makes your head swim. 'And I can tell that's just what you need - to be that proper bitch you are deep-down,' the dominant beast says, rubbing a paw over your lower belly in a way that fills it with a warm, aching need.";
					say "     Your head spins with lust as you try to grasp his meaning, only to feel his weight settle onto your back. You gasp as you brace your lower legs to support the larger wolf's weight as he positions himself on you, his powerful arms wrapping around your upper body as his cock begins to rub up against your own canine rear. You moan as your head begins to cloud over with pleasure, and he settles his canine chin on your shoulder, unable to even think about resistance with his powerful male body on top of your own. He licks your ear and whispers 'That's right, I've got just what a bitch's womb needs, even for a male like you. I'm going to enjoy making that taur belly of yours round with my pups.'";
					WaitLineBreak;
					say "     You find yourself panting in need as his canine member rubs up against your hole, the tip pushing in slightly as he shifts his hips in order to get the best position before thrusting himself into you in one swift, sure movement. You shudder underneath him as you feel his cock filling your ass, a strong wave of submissive pleasure coming over you as his knot rubs against the base of your tailhole. Lindsey groans in pleasure as he whispers into your ear, 'Just let go of all that male aggression.' He traces his tongue along your ear as he begins to move his hips, driving his amazing cock into you further with each thrust. 'You can't compare to a sexy and strong wolf like me and you know it. There's no point in resisting it, we both know you're meant to be a breeder. So just let it all go and embrace those submissive, bitch-like tendencies we both know you love so much,' the male pants into your ears. His words fills your lust-fogged mind with an increasing sense of their rightness even as they send a rush of heated need into your hidden womb. 'Just submit and let the big wolf take care of breeding you from now on...' he says as he grunts, his knot pressing up against your rear as it seeks to lock the two of you together.";
					WaitLineBreak;
					say "     'Feel that big large wolf knot as it rubs up against you,' he growls into your ear as his hands roam your body. 'Doesn't it just make you want to be my little bitch, and let yourself realize that my cock is the only cock a proper bitch like you needs?' he growls into your ear as his hands roam your body. 'Soon you will have that knot inside you, locking me inside you and ensuring you'll be knocked up like my little breeding bitch. Doesn't that sound divine, you needy slut?' he rumbles in your ear, thrusting all the harder, making you moan and nod in response, loving the feel of the wolftaur's throbbing meat buried deep inside you.";
					say "     You groan in pleasure as his thick knot finally sliding fully into your [bodydesc of Player] body a few hard thrusts later. Your ass clenches that meaty bulb tight after it's popped into you, ensuring a good, solid tie. You groan submissively underneath him as you realize he is right; you're meant to be a submissive breeding he-bitch for your big, strong alpha. In fact, with his wonderful wolf cock inside you, you can't even imagine how you could have ever wanted to be anything but the slutty bitch of this strong, powerful male. The final realization of your body's total eager submission to the powerful male makes you groan and shudder with orgasm underneath your dominant mate, your body accepting its role as a bitch as your anus squeezes his bestial cock needfully. Feeling your orgasm underneath him, Lindsey howls in triumph as he gives into his own orgasm, his cock twitching as it paints your willing womb with your alpha's healthy seed.";
					WaitLineBreak;
					say "     'Feel that wolf cock inside you. Doesn't it just make you want to be my little bitch, and let yourself realize that my cock is the only cock a proper bitch like you needs,' he growls into your ear as his hands roam your body. 'Soon you will have that knot inside you, locking me inside you and ensuring you'll be knocked up like my little breeding bitch. Doesn't that sound divine, you needy slut?' he rumbles in your ear, thrusting all the harder, making you moan and nod in response, loving the feel of the wolftaur's throbbing meat buried deep inside you. You groan in pleasure at his thick knot slides into your body, your pussy clenching it tight as he ties with you.";
					say "     You groan submissively underneath him as you realize he is right, you're meant to be a submissive little breeding bitch for your big, strong alpha. In fact, with his wonderful wolf cock inside you, you can't even imagine how you could have ever wanted to be anything but the slutty bitch of this strong, powerful male. Feeling your orgasm underneath him, Lindsey howls in triumph as he gives into his own orgasm, his cock twitching as it paints your willing womb with his healthy seed.";
					WaitLineBreak;
					say "     You pant in pleasure at the feel of your lover's seed filling your womb, even as he relaxes and begins to stroke you with his claw-tipped hands. 'You feel that lovely wolf sperm sinking into your body?' the alpha male says with a lupine grin as he relaxes on top of you. 'That is what being a proper bitch is about and what you'll have to look forward to soon,' he says, reaching back to stroke across your flank, now a little more rounded with her hot load and large cock filling you. 'Even as the needy he-bitch your body wants to be,' he adds. Lindsey grins and nibbles along your neck as you pant and nod eagerly in agreement, your mind still awash in pleasure. Eventually his large knot shrinks to the point where he can pull himself out of you, and the handsome wolftaur saunters over to the bathroom counter while you stand there in the middle of the room, his seed leaking down your hind legs as you imagine what it'll be like to be a wolftaur bitch.";
					NPCSexAftermath Player receives "AssFuck" from Lindsey;
					infect "Wolftaur";
					infect "Wolftaur";
					now lastfuck of Lindsey is turns;
					increase level of Lindsey by 1;
					decrease humanity of Player by 3;
			else:
				say "     'Another male taur?' Lindsey says with an amused look on his canine face, as he examines your own [bodydesc of Player] body. 'Well, since you obviously know you can't compare with a big, strong wolf like myself, you must want to be my bitch so badly even as a male,' the strong wolftaur says as he stalks around you in a predatory manner. His hands slowly stroke your sides as his powerful dominant musk fills the small space and makes your head swim. 'Even though you aren't a proper bitch, like you should be, I can still enjoy using you like one,' the dominant beast says, your head spinning with lust as you try to grasp his meaning, only to feel his weight settle onto your back. You gasp as you brace your lower legs to support the large wolf's weight as he positions himself on you, his powerful arms wrapping around your upper body as his cock begins to rub up against your hindquarters. You moan as your head begins to cloud over with pleasure, and he settles his canine chin on your shoulder, unable to even think about resistance with his powerful male body on top of your own.";
				say "     You find yourself panting in need as his canine member rubs up against your hole, the tip pushing in slightly as he shifts his hips in order to get the best position before thrusting himself into you in one swift, sure movement. You shudder underneath him as you feel his cock filling your ass, a strong wave of submissive pleasure coming over you as his knot rubs against the base of your tailhole. Lindsey groans in pleasure as he whispers into your ear, 'Just let go of all that male aggression.' He traces his tongue along your ear as he begins to move his hips, driving his amazing cock into you further with each thrust. 'You can't compare to a sexy and strong wolf like me and you know it. There's no point in resisting it, so just let it all go and embrace those submissive, bitch-like tendencies we both know you love so much,' the male pants into your ears, his words filling your lust-fogged mind with an increasing sense of their rightness. 'Just submit and let the big wolf take care of you now,' he says as he grunts, his knot pressing up against your rear as it seeks to lock the two of you together.";
				WaitLineBreak;
				say "     You aren't sure what it is about the situation, but the overload of sensation from being mounted by the virile male while his heavy musk suffuses your senses leaves you moaning and panting beneath him. Between having the strong, male wolf on your back, with his cock in your ass as he uses you like a bitch, listening to his soft words of encouragement and the feel of his powerful male arms wrapped around you as he presses himself up against your body, you can't help but feel like his inferior and want to be used as such. You find yourself feeling even more submissive and weaker than ever, happy to moan under the more dominant wolf as his knot enters your body and seals you together. Groaning underneath the more powerful wolf, you find yourself realizing that you want nothing more than his slutty canine bitch, even though your outside is male.";
				say "     The realization makes your body shudder in pleasure underneath your alpha male as you feel your old aggressive tendencies slipping away, happy to embrace your bestial side and let the strong, virile wolf take you as he pleases. The feel of his seed spurting into your ass makes you cry out in pleasure, your voice joining your alphas as you both shudder in orgasm as he fills your insides up with his sperm, marking you forever as his submissive plaything. The two of you stay locked together for a time, his seed churning inside your bowels as his knot slowly begins to shrink, the wolftaur stroking and petting you with his hands and paws even as he tells you what a good bitch you will be for his pack. Eventually Lindsey's knot has shrunk enough he can pull it out of you, making you shudder at the sudden feeling of emptiness as he stalks happily over to the bathroom sinks, leaving you to slowly come to terms with all that has happened.";
				NPCSexAftermath Player receives "AssFuck" from Lindsey;
				infect "Wolftaur";
				infect "Wolftaur";
				now lastfuck of Lindsey is turns;
				increase level of Lindsey by 1;
				decrease humanity of Player by 3;
		else if Player is female:
			say "     'Well well, look what I have here,' Lindsey says with amusement as you approach the male wolftaur. 'It looks like my newest bitch couldn't stay away from her alpha, now could she?' the male taur says in a teasing tone of voice as he begins to slowly stalk towards you, his powerful male musk filling the enclosed bathroom with its strongly arousing scent. 'I knew you had the making of a proper bitch inside you,' the male says as he slowly moves around your body, his furred flank rubbing up against your side and making you moan in pleasure. 'Such a shame the outside doesn't match the inside though...' he says mournfully as his clawed hands pet and stroke your head, the combination of his musk, his soft touches, and his strangely soothing dominant tone, cause your body to respond to him even as your mind fogs over with lust. 'Aren't you lucky that your alpha is here to help you out with that? To help show you how to be a proper bitch inside and out?' Lindsey says teasingly, his lupine muzzle pulling back in a grin as you nod in agreement with the dominant alpha before his words can even fully register.";
			say "     'Well to start with, proper bitches walk around on all four paws,' the wolftaur says in amusement as he pushes your upper body down to the ground, and you find yourself dropping down to all fours on the dirty cum stained floor eagerly. The situation seems wrong for a minute, as you breathe in his musky scent as you crawl around on the floor, but somehow being on all fours like this in the presence of such a wonderful alpha male is making your body feel even hornier than ever, your pussy feeling warm and empty as it aches for a thick canine cock to fill it. 'Now that's better,' you can hear the alpha male say with amusement as he watches you move around on the floor. 'Now that we have you positioned and acting like a proper bitch, it's time for your reward,' he says, his words making you shudder in anticipation even as his furred side rubs up against your skin.";
			WaitLineBreak;
			say "     'For your reward, I think you need a hefty helping of fertile wolf seed, don't you?' Lindsey says, even as he lifts his paw up over your body, and crawls on top of you. 'A nice helping of your alpha's seed should help make you into a proper little wolftaur bitch for me just like we both want,' he says, as you find yourself whimpering in need underneath him, his front paws just in front of your shoulders, as his thick cock rubs up against your upturned rear. The feeling of the tip of his cock rubbing up against your swollen lips makes you pant desperately as you try to grind your hips back against his strong canine hindquarters, your mouth hanging open as his masculine musk fills your mind with lustful thoughts of being a proper bitch for your alpha. You groan in submissive need as he shifts his weight forward slightly, and pushes his thick rod into you in one swift stroke, his knot pressed up against your body seeking to lock the two of you together, even as he begins to thrust his cock in and out of you with bestial abandon.";
			say "     You can feel your body relax underneath him, as you lower your face even closer to the ground, giving in by instinct to the strong dominant male, your lips stretching wide to allow his knot to lock the two of you together. He yips in pleasure above you, the sound filling your musk fogged mind with happy pleasure at the evidence of your alpha's approval, his large bulb swelling within your body and making you feel even more like a proper submissive bitch with every minute. With his knot locked into you, he begins to make even faster short hard thrusts into your body, his pointed canine shaft rubbing within you and making you moan in pleasure as every thrust brings you closer to having his thick seed make you into that much more of a proper bitch. Your body spasms underneath him in pleasure as you feel the first heavy spurt of his wolf-like cum shooting into your needy womb, the feel of your alpha's seed settling into your body and marking you as his own triggering your own overpowering orgasm.";
			WaitLineBreak;
			say "     Lindsey pants above you as his knot ties the two of you together, ensuring his seed fills you all the way to the brim, the sensation of being trapped and tied underneath such a powerful beast filling your head with images of him making you his bitch, keeping you as his own, and making you a proper wolftaur just like him... Eventually his knot slowly shrinks, and he pulls out of you with a soft popping noise, and you slump to the ground bonelessly, lost in submissive bliss as the male grins down at you for a minute, before patting you on the head and saying 'I'm sure you will make a good bitch,' before padding back over to the bathroom counter. You aren't sure how long you lie there on the cum stained floor, with his seed swirling inside you, and a happy smile on your face at being told you will be a good bitch. Eventually, you begin to recover your wits, and gather yourself and your equipment back up and prepare to try to face the world again... though you would almost rather just stay here and be a happy bitch...";
			NPCSexAftermath Player receives "PussyFuck" from Lindsey;
			infect "Wolftaur";
			increase level of Lindsey by 1;
			now lastfuck of Lindsey is turns;
		else:
			say "     'After all our fun together you don't have a proper little bitch cunt yet?' Lindsey asks you as he shakes his head sadly. 'Well I guess we will have to work with what we have now then, won't we?' the large male wolftaur says as he guides you back over to the wall where his seed still stains the floor from your earlier fun. 'Let's see if another coating of wolftaur seed will help matters,' he says as he pushes you down flat onto the floor, your back resting in his partially dried seed from earlier, as he steps over your prone body, bringing his hindlegs and cock up to your chest. 'Now why don't you be a good little submissive and help me cover you in my seed again hmm?' the male beast says as he thrusts his hips slightly in the air for emphasis, his sexual musk overwhelming you with lustful thoughts of submission as you reach up and begin to stroke his pointed canine tool. The feel of his strong, powerful cock under your hands, the thick canine member feeling so much better under your hands than your own cock could ever be, his dominant musk fills your head even as you lie under him rubbing and stroking his cock and balls for all you are worth.";
			say "     You can feel your own cock hanging limply between your legs, a totally useless and weak organ compared to the handsome wolftaur's, even as your body surges with arousal and need, and his own masterful cock swells with power, its knot slowly growing ever bigger as the alpha canine groans and yips with pleasure above you. Soon your efforts are rewarded, as Lindsey lets out a loud howling noise, his voice filling the bathroom as he shoots his canine seed all over your chest and face. The feel of his cum on your body, and the increased scent of his fertile musk in your nose, makes you writhe on the ground in pleasure, your hands reaching up to rub that powerful dominant seed all over your skin, even as it slowly drips down your body to mingle with the puddles of seed you are already lying in. You hardly notice when the more dominant canine backs off, staring down at you for a minute with an amused look on his lupine face, before heading back over to the bathroom counters, leaving you lying there basking in his male gift until you finally begin to be able to think clearly again.";
			infect "Wolftaur";
			infect "Wolftaur";
			increase level of Lindsey by 1;
			now lastfuck of Lindsey is turns;
			stop the action;
	else:
		if Player is male:
			if Player is female:
				say "     'I knew you would come to see things my way,' the large male wolftaur says with a grin, as he stalks forward, the strong musk of aroused canine filling the air. 'And you are definitely looking nice and eager there, but you definitely have some equipment there that a proper bitch doesn't need. Still, we can fix that with some proper bitch training, I'm sure,' Lindsey says with an amused tone in his voice as he backs you up against the wall, his muzzle stretched wide in a lupine grin. 'Don't worry though, I'm sure once I have you properly trained you won't miss that useless little cock of yours at all,' the male wolf says as he reaches out and pushes your back up against the wall, before pushing you down into a kneeling position. Lindsey then grins as he grips the top of the nearby stall with his hands, and uses it to help him lift his front paws up onto the wall as well. His paws land on each side of your head as he braces himself on the wall, his long canine body stretching above you as his erect canine cock comes to rest right in front of your face.";
				say "     The strong musk of a dominant wolf redoubles and wipes out any thoughts of protest you might have, as he begins to thrust his canine hips forward, his cock bouncing in the air in front of you lewdly. 'Why don't you give a wolf a hand, my little wannabe bitch, or better yet, your mouth?' the male beast asks in a teasing tone, his voice seeming to invade your lust-filled thoughts, as his suggestion fills your mind. You find yourself happily reaching up to rub your hands along his canine shaft, one hand rubbing at the beasts amazing rod, while the other caresses the large canine's sac, the soft pouch full of the wonderful beast's dominant, bitch-breeding seed, making your mouth water.";
				WaitLineBreak;
				say "     You find yourself panting like a bitch as you stroke the canine creature, knowing your own pathetic cock could never match this beast's glorious rod, as the dominant wolf makes happy noises of pleasure above you while your hands tease his bestial rod, the knot on the cock in front of you growing ever larger under your hands as he yips in pleasure. Staring at the thick pink cock in front of your face, you find yourself leaning forward, needing to feel the taste of that lovely canine cock on your tongue. As your tongue traces across Lindsey's stiff organ, he groans above you in pleasure, the sound encouraging some animal part of your brain as you begin to lick and suck on his wonderful lupine rod, loving the submission and the taste of the wolftaur's dominant cock. Without any real warning, the powerful taur's cock shudders and begins to shoot its long jets of seed out onto your hands and face, Positioned in front of his canine cock as you are, your face is quickly covered with the soft strings of his seed, and your hands are soaked in his amazing smelling essence.";
				say "     You pant happily as the large wolftaur backs off down the wall, licking your lips and tasting his strong dominant gift with a smile on your face, your mind empty of everything but the dominant wolf's lovely musk, and the taste of his pleasure. Lindsey looks down at you with a canine grin, and reaches down one of his hands to pet you on the head. 'Good bitch,' the wolftaur says before he saunters back over to the counter, the words of praise making you happy as you sit there against the wall, glad to have been such a good bitch for the handsome male taur.";
				WaitLineBreak;
				say "     Your pussy clenching in lustful need as you imagine being an even better and more submissive bitch for the strong beast next time you come this way and beg him to show you what it is like to be a proper bitch. Thinking of that you realize that even though the recent encounter has your body amazingly aroused, your cock is still lying there limply, and you can hardly even bring yourself to think of using it instead of being used after your encounter with such a desirable male. Blinking dazedly several times, you find yourself trying to figure out if there isn't something wrong with that way of thinking. With your head still wrapped in his strong musk though, you shrug and merely lie there for a while against the wall, happily licking up his seed as you try to regain some semblance of normal thought...";
				NPCSexAftermath Player receives "OralCock" from Lindsey;
				infect "Wolftaur";
				increase level of Lindsey by 1;
				now lastfuck of Lindsey is turns;
			else:
				say "     'I knew you would come to see things my way,' the large male wolftaur says with a grin, as he stalks forward, the strong musk of aroused canine filling the air. 'But you certainly aren't properly equipped to be a good little bitch yet,' Lindsey says in an amused tone as he backs you up against the wall. 'Don't worry though, I'm sure we can fix that soon enough,' the wolf says as he reaches out and pushes you up against the wall, before pushing you down into a kneeling position. Lindsey then grins as he grips the top of the nearby stall with his hands, and uses it to help him lift his front paws up onto the wall as well. His paws land on each side of your head as he braces himself on the wall, his long canine body stretching above you as his erect canine cock comes to rest right in front of your face.";
				say "     The strong musk of a dominant wolf redoubles and wipes out any thoughts of protest you might have, as he begins to thrust his canine hips forward, his cock bouncing in the air in front of you lewdly. 'Why don't you give a wolf a hand, little wannabe bitch?' the male beast asks, his voice seeming to invade your lust-filled thoughts, as his suggestion fills your mind. Happily you find yourself reaching up to rub your hands along his canine shaft, one hand rubbing at the beasts amazing rod, while the other caresses the large canine's sac, the soft pouch full of the wonderful beast's dominant, bitch-breeding seed. You find yourself panting like a bitch as you stroke the canine creature, the dominant wolf making happy noises of pleasure above you as your hands tease his bestial rod, the knot on the cock in front of you growing ever larger under your hands as he yips in pleasure.";
				WaitLineBreak;
				say "     Without any real warning, the powerful taur's cock shudders and begins to shoot its long jets of seed out onto your hands and body. Positioned in front of his canine cock as you are, you are quickly covered in soft strings of his seed, and your hands are soaked in his amazing smelling essence. You pant happily as the large wolftaur backs off down the wall, licking your lips and tasting his strong dominant gift with a smile on your face, your mind empty of everything but the dominant wolf's lovely musk, and the taste of his pleasure. Lindsey looks down at you with a canine grin, and reaches down one of his hands to pet you on the head. 'Good bitch,' the wolftaur says before he saunters back over to the counter, the words of praise making you happy as you sit there against the wall, glad to have been such a good bitch for the handsome male, even without the proper equipment. Thinking of that you realize that even though the recent encounter has your body amazingly aroused, your cock is still lying there limply, and you can hardly even bring yourself to think of using it instead of being used after your encounter with such a desirable male.";
				infect "Wolftaur";
				increase level of Lindsey by 1;
				now lastfuck of Lindsey is turns;
		else:
			say "     'I knew you would come to see things my way,' the large male wolftaur says with a grin, as he stalks forward, the strong musk of aroused canine filling the air. 'And you are definitely looking nice and eager there, but you definitely still need some proper training in how to be a good little bitch for me,' Lindsey says with an amused tone in his voice as he backs you up against the wall. 'Don't worry though, I'm sure we can take care of that problem soon enough,' the male wolf says as he reaches out and pushes your back up against the wall, before pushing you down into a kneeling position. Lindsey then grins as he grips the top of the nearby stall with his hands, and uses it to help him lift his front paws up onto the wall as well. His paws land on each side of your head as he braces himself on the wall, his long canine body stretching above you as his erect canine cock comes to rest right in front of your face.";
			say "     The strong musk of a dominant wolf redoubles and wipes out any thoughts of protest you might have, as he begins to thrust his canine hips forward, his cock bouncing in the air in front of you lewdly. 'Why don't you give a wolf a hand, my little wannabe bitch, or better yet, your mouth?' the male beast asks in a teasing tone, his voice seeming to invade your lust-filled thoughts, as his suggestion fills your mind. You find yourself happily reaching up to rub your hands along his canine shaft, one hand rubbing at the beasts amazing rod, while the other caresses the large canine's sac, the soft pouch full of the wonderful beast's dominant, bitch-breeding seed, making your mouth water. You find yourself panting like a bitch as you stroke the canine creature, the dominant wolf making happy noises of pleasure above you as your hands tease his bestial rod, the knot on the cock in front of you growing ever larger under your hands as he yips in pleasure.";
			WaitLineBreak;
			say "     Staring at the thick pink cock in front of your face, you find yourself leaning forward, needing to feel the taste of that lovely canine cock on your tongue. As your tongue traces across Lindsey's stiff organ, he groans above you in pleasure, the sound encouraging some animal part of your brain as you begin to lick and suck on his wonderful lupine rod, loving the submission and the taste of the wolftaur's dominant cock. Without any real warning, the powerful taur's cock shudders and begins to shoot its long jets of seed out onto your hands and face, Positioned in front of his canine cock as you are, your face is quickly covered with the soft strings of his seed, and your hands are soaked in his amazing smelling essence.";
			say "     You pant happily as the large wolftaur backs off down the wall, licking your lips and tasting his strong dominant gift with a smile on your face, your mind empty of everything but the dominant wolf's lovely musk, and the taste of his pleasure. Lindsey looks down at you with a canine grin, and reaches down one of his hands to pet you on the head. 'Good bitch,' the wolftaur says before he saunters back over to the counter, the words of praise making you happy as you sit there against the wall, glad to have been such a good bitch for the handsome male taur. Your pussy clenching in lustful need as you imagine being an even better and more submissive bitch for the strong beast next time you come this way and beg him to show you what it is like to be a proper bitch. Blinking dazedly several times, you find yourself trying to think about that, and wondering if there isn't something wrong with that way of thinking. With your head wrapped in his strong musk though, you shrug and merely lie there for a while against the wall, happily licking up his seed as you try to regain some semblance of normal thought...";
			NPCSexAftermath Player receives "OralCock" from Lindsey;
			infect "Wolftaur";
			increase level of Lindsey by 1;
			now lastfuck of Lindsey is turns;

Section 3 - Interactions as Beta

Table of GameEventIDs (continued)
Object	Name
Becoming the Wolftaur's Beta	"Becoming the Wolftaur's Beta"

Becoming the Wolftaur's Beta is a situation.
The level of Becoming the Wolftaur's Beta is 0.
The sarea of Becoming the Wolftaur's Beta is "Nowhere".

instead of going to Zoo Restrooms while Becoming the Wolftaur's Beta is unresolved and level of Lindsey > 9 and a random chance of 1 in 2 succeeds:
	move player to Zoo Restrooms;
	BecomingtheWolftaur'sBetaEvent;

to BecomingtheWolftaur'sBetaEvent:
	say "     Entering the restrooms, you are surprised to find Lindsey not in his usual position admiring himself in the mirror. You are about to turn around when a deep voice growls, 'Stay where you are and show me your [if Player is female]holes[else]hole[end if].' You are mildly concerned for a moment that some stranger has ambushed you until they start chuckling. 'You should have seen how your body tensed up, you looked like you were about to shit yourself,' Lindsey laughs, reverting to their usual voice. Turning around to [if player is dominant]give the wolftaur a piece of your mind[else]express your relief[end if], you are halted by a firm hand to the side of the head. 'I gave you an order bitch, get to it.' The authority in his voice sends shivers through your body and you obediently take a few steps backwards before [if Player is not naked]undressing and[end if]leaning over one of the basins and spreading your ass for your superior to gaze upon your behind. 'That's a good bitch. Good behavior gets rewarded, something my other bitch sometimes forgets at times. I'm going to shoot my load in you. then, as if that wasn't reward enough in itself, we'll discuss some further perks to being such a well-behaved slut for me,' Lindsey roughly croons in your ear as he shuffles up behind you and aligns himself with your anus for penetration.";
	if BodyName of Player is "Wolftaur" and player is pure:
		say "     'I gotta say, I'm really loving the way in which you've taken to being my wolftaur bitch. It really makes an alpha proud. But listen to me letting my head do the talking when I could be fucking my willing slut-puppy. Brace yourself, I haven't blown a load in several hours and my balls need emptying.' With that, Lindsey heaves his body atop you, his weight barely a concern given that your form was designed for this. Though his shaft finds its mark without any difficulty, he nonetheless firmly pulls you back against his thrust, his claws digging sharply into your sides and making you quiver in delightful submission to the strong male. He immediately begins to piston in and out of you in a lust-driven frenzy, the sting of his groin colliding with your butt-cheeks causing you to release gasps and hisses, though you urge him to take you harder and show his bitch [PosAdj of Player] place, a plea which he enthusiastically complies with, animalistic growls bursting from his throat as he further establishes his claim over you.";
		WaitLineBreak;
		say "     'Your insides are going to be painted white with my seed and you'll be so full that it'll be leaking down your legs showing what a good little wolftaur bitch you are,' Lindsey growls in your ear. 'My scent will be all over you and every other male that you meet will be jealous that you are mine. And you [italic type]are[roman type] mine, even if you take pity on them and let them mount you.' He emphasizes this by gripping the back of your neck tightly in his jaws, barely drawing blood and making you let out a blissful gasp, arching your back and pressing his lengthy cock deeper into your bowels. 'You'll even spread my scent to the women that you come into contact with, leaving them lusting after me.' You're not sure how you feel about Lindsey talking about other people while mating with you, but this gets pushed to the back of your mind by the passion and fierceness of his rutting into you. The slapping, squelching, and grunting as the wolftaur breeds you reverberates around in the restroom and likely can be heard by others in the zoo through the open door, any who wish to watch free to do so.";
		say "     You can feel his forelegs tightening against your sides, betraying his approaching orgasm, as does the flagging of his rhythmic thrusts. [if Player is submissive]Regrettably, you aren't close to climax yourself, but the pride that you feel in pleasing Lindsey more than makes up for this[else if player is dominant]Unfortunately, you aren't any where near climax yourself, but you hope that given how much pleasure Lindsey seems to have got from this that you might reap a reward later[else]Unfortunately, you aren't likely to climax any time soon, but you feel a strange satisfaction at how much Lindsey seems to have been enjoying himself and accept that your pleasure may be taken care of next time[end if]. 'Such a good bitch. Soon you'll be swollen with my pups,' he crooned in your ear before giving it an affectionate lick. His swollen knot batters at the entrance to your bowels, denied entrance by your sphincter until suddenly, it isn't. With a sharp increase of pressure, the engorged organ squeezes past your tight ring and locks inside you not a moment too soon, torrents of thick cum flooding into you, the both of you letting out a sigh as the sensation overwhelms your minds, leaving your body helpless to post-coital euphoria.";
		WaitLineBreak;
		say "     Though it doesn't take you long to recover from the orgasm-induced stupor, Lindsey remains tied with you for several minutes, the steady throb of his semen flowing into you strangely relaxing. 'Look at you. My sweet wolftaur bitch,' he gently comments, unusually tender compared to his usual brash self. 'I'll deny it if you or anyone else asks, but you're very special to me. My top bitch. My best slut. Telling you to stay with me would take the fun out of it, but should you grow tired of struggling around in the city, there is a place for you beneath or beside me depending on how I feel at the time. Don't forget that.' You moan out an acknowledgment, the wolftaur pulling his knot from your gaping ass and impeding any attempt at a composed reply. With your legs numb and nothing keeping you upright anymore, you slump over on your side, a rapidly growing puddle of semen spilling past your sphincter and across the floor, coating your skin and filling the room with the scent of the strong male that has claimed you.";
	else: [Not pure wolftaur]
		say "     'Still refusing to completely surrender to becoming my wolftaur bitch? See if I care. It will only make it all the sweeter when you eventually succumb. Let me show you what awaits you as my willing slut-puppy and fuck some much-needed obedience into you. Brace yourself, I haven't blown a load in several hours and my balls need emptying.' You desperately scramble to support Lindsey's weight as he heaves his body atop you, your chest being pressed against the cold steel of the basin, causing your nipples to stiffen. Though his shaft finds its mark without any difficulty, he nonetheless firmly pulls you back against his thrust, his claws digging sharply into your shoulder and making you quiver in delightful submission to the strong male. He immediately begins to piston in and out of you in a lust-driven frenzy, the sting of his groin colliding with your butt-cheeks causing you to release gasps and hisses, though you urge him to take you harder and show you your place as his bitch, a plea which he enthusiastically complies with, animalistic growls bursting from his throat as he further establishes his claim over you.";
		WaitLineBreak;
		say "     'I'm going to bloat you with my cum until it's running down your legs. Then maybe you'll understand that you would be better as my wolftaur bitch rather than just my slut,' Lindsey growls in your ear. 'You'll never completely get rid of my scent and every male that you meet will want to make you theirs, but you'll always be mine, won't you? Even if you spread your legs to every horny monster in the city, you'll still be mine.' He grips the back of your neck between his teeth to emphasize his point, barely drawing blood, and making you release a passionate moan as his girthy shaft drives deeper into your bowels. 'You'll make women envious of you for having such a virile male to breed with, and who knows, some of them might find their way to me too.' You're not sure how you feel about Lindsey talking about other people while mating with you, but this gets pushed to the back of your mind by the passion and fierceness of his rutting into you. The slapping, squelching, and grunting as the wolftaur breeds you reverberates around in the restroom and likely can be heard by others in the zoo through the open door, any who wish to watch free to do so.";
		say "     His forelegs tightening against the sides of your ribs along with the flagging of his rhythmic thrusts betray his approaching orgasm. [if Player is submissive]Regrettably, you aren't close to climax yourself, but the pride that you feel in pleasing Lindsey more than makes up for this[else if player is dominant]Unfortunately, you aren't any where near climax yourself, but you hope that given how much pleasure Lindsey seems to have got from this that you might reap a reward later[else]Unfortunately, you aren't likely to climax any time soon, but you feel a strange satisfaction at how much Lindsey seems to have been enjoying himself and accept that your pleasure may be taken care of next time[end if]. 'Such a good slut. I'm going to make you swollen with my pups but don't you think that it would feel better if you were my wolftaur bitch?' he sensually whispers in your ear. His swollen knot batters at the entrance to your bowels, denied entrance by your sphincter until suddenly, it isn't. With a sharp increase of pressure, the engorged organ squeezes past your tight ring and locks inside you not a moment too soon, torrents of thick cum flooding into you, the both of you letting out a sigh as the sensation overwhelms your minds, leaving your body helpless to post-coital euphoria.";
		WaitLineBreak;
		say "     Though it doesn't take you long to recover from the orgasm-induced stupor, Lindsey remains tied with you for several minutes, the steady throb of his semen flowing into you strangely relaxing. 'Look at you. Bent over beneath me like a wolftaur bitch,' he gently comments, unusually tender compared to his usual brash self. 'I'll deny it if you or anyone else asks, but you're very special to me. My top bitch. My best slut. Telling you to stay with me would take the fun out of it, but should you grow tired of struggling around in the city, there is a place for you beneath or beside me depending on how I feel at the time. Don't forget that. Even if you stubbornly refuse to become a wolftaur.' You moan out an acknowledgment, the wolftaur pulling his knot from your gaping ass and impeding any attempt at a composed reply. With your legs numb and nothing keeping you upright anymore, you crumple to the floor, a rapidly growing puddle of semen spilling past your sphincter and coating your skin, filling the room with the scent of the strong male that has claimed you.";
	say "     The cold concrete of the floor slowly warms as you lie there, the heat of your body as well as the oozing pools of potent cum reducing the chill. Lindsey looms over you, his crimson cock shrinking back into the plump sheath beneath him, the occasional trickle of semen dripping from it over your prostrate form. 'Nothing like a satisfying fuck to clear the head. When you've recovered enough, come and talk to me outside. I know that I'm the perfect specimen of masculinity, but there are limits to how much I want to smell my sweat and musk. You release a groan of acknowledgement and begin to roll over in preparation of regaining your feet, the clack of the wolftaur's claws against concrete passing by your ears as he retreats out the door. As you sit up you feel his load shift in your bowels and you stroke a hand over your tummy contentedly, momentarily reliving your recent rutting with Lindsey and anticipating more in future, before struggling to your feet to follow him outside, the occasional splotch of cum being left behind you as you walk.";
	WaitLineBreak;
	say "     You find Lindsey leaning up against a wall, his eyes following you as you walk over to him and the hint of a smirk at the corner of his mouth as he watches his seed drip from your backside. 'I really filled you didn't I?' the wolftaur chuckles 'You're definitely my top slut, or beta if you prefer. That's what I wanted to talk to you about. My old boyfriend wouldn't stand much chance wandering around the city and she'd probably shack up with anyone with a decent amount of meat between their legs, but you... you keep coming back and have been around the city. You know what you want and aren't going to be mesmerized by every erection that you see. You'd make a great beta for me, [if Player is submissive]even with how much of a subby slut you are. Just make sure you're most subby to me and not some common wolf[else if player is dominant]especially with your dommy attitude. Just remember that I'm in charge[else]you're the perfect balance of submissiveness and confidence. Mine to mould, but headstrong enough to give me some surprises I hope[end if]. I am giving you a choice though, just this once. Do you accept your place below me as my beta, or do you want remain the same slut as you've always been?'";
	say "     [bold type]How do you reply? You get the impression that he won't make this offer again.[roman type][line break]";
	LineBreak;
	say "     ([link]Y[as]y[end link]) - Accept your place as Lindsey's Beta.";
	say "     ([link]N[as]n[end link]) - Refuse to further tie yourself to Lindsey's whims than you already are.";
	if Player consents:
		say "     You give Lindsey a smile and press yourself up against his side, saying that of course you'll be his beta. He returns your affection with a grin before replying, 'Good choice. I'll have to show you my other bitches at some point, but for now, have some pride at being below only me. It's where you belong and if the rest of the city don't like it, they can suck it. [if Player is male]Literally, in your case[else]Or at least suck mine[end if]. Once I mark you as mine, if anyone tries to take you from me I'll hunt them down and make them into my bitch too. I'm not stupid enough to think that everyone in the world will be mine, but I don't have a problem beating the shit out of anyone who crosses me or those that I claim as mine. And now that you're my beta, you can count on me to back you up, just as I expect you to do the same for me. We're bonded now and only death will break that.' That was a lot more serious and soul-bearing than you are used to hearing from Lindsey, but you feel that you made the right decision in trusting yourself to Lindsey.";
		say "     'Now hold still and I'll leave a more visible mark for those too stupid to smell my scent all over you.' Lindsey's hands firmly grasp you by the shoulders and gently pulls your head to the side to expose your neck. 'This feels like one of those trashy vampire books, but this way no-one will be able to say they didn't see you were claimed,' the wolftaur growls before closing his jaws around the side of your neck. You can feel your pulse racing, the realization that should he want to, Lindsey could likely end your life here and now, [if Player is submissive]sending shiver throughout your body at being reminded of your place in society, to be below those of such determination and willpower, to be protected and to submit yourself to them in turn[else if player is dominant]making you feel simultaneously disgusted and exhilarated as you reconcile this show of submission with your usual determination to be in control[else]causing a mixture of feelings to surface within you. Fear. Relief. Happiness. And strangely, safety[end if]. You feel your skin break as his fangs press through, remaining for a few short moments and allowing a trickle of blood to run across your throat before the grip on your flesh is released and you allow your head to slump forward, almost panting from the rush of emotion and adrenaline.";
		WaitLineBreak;
		say "     'There. Now you are mine for all to see,' Lindsey rumbles in your ear. 'I'd offer you a mirror to admire my mark, but trust me when I tell you that I claimed you long before this and that the scar was to show others that you are mine. But for now you should be going. I'm feeling tired and raw after all of this so I just want to find somewhere comfortable and quiet to sleep for a few hours. I don't want to be disturbed, even by you, so consider this your first order from your alpha.' He dismisses you with a gesture of his hand and walks away through the zoo, other creatures giving him a wide berth. After you spend a few minutes tidying yourself up, you trudge towards the entrance while deciding what to do next.";
		move Player to Zoo Entrance;
		now hp of Lindsey is 2;
		now resolution of Becoming the Wolftaur's Beta is 1; [Became Lindsey's Beta]
		now Becoming the Wolftaur's Beta is resolved;
	else:
		say "     You watch Lindsey's face fall before curling in mild disgust. 'Fine then,' he spits. 'I seemed to have misjudged you. I can still make use of you as a cum-dumpster if nothing else.' He seems very annoyed with you but you give him a few moments to gather himself before he continues to talk again. 'I did say that I would give you a choice and I meant it, but you aren't going to rise very high in the city if you don't ever want more.' The wolftaur reverts back to grumbling under their breath again while you stand around awkwardly. Eventually Lindsey looks up at you, 'What? You're still here? Fuck off why don't you. Lurking like a lost puppy is just pissing me off,' he snarls, plainly dismissing you. With a roll of your eyes that he can't see, you walk back to the entrance of the zoo, the sound of the wolftaur swearing to themselves fading into the distance.";
		move Player to Zoo Entrance;
		now resolution of Becoming the Wolftaur's Beta is 2; [Refused Lindsey's offer]
		now Becoming the Wolftaur's Beta is resolved;

Table of GameEventIDs (continued)
Object	Name
Lindsey's Harem	"Lindsey's Harem"

Lindsey's Harem is a situation.
The level of Lindsey's Harem is 0.
The sarea of Lindsey's Harem is "Nowhere".

instead of going to Zoo Restrooms while Becoming the Wolftaur's Beta is resolved and Lindsey's Harem is not resolved and Player is not neuter and scalevalue of Player > 2 and a random chance of 1 in 2 succeeds:
	move player to Zoo Restrooms;
	LindseysHaremEvent;

to LindseysHaremEvent:
	say "     Just as you are about to go in, you encounter Lindsey coming out, the headstrong wolftaur leaving you no option but to leap out of his way. 'What up bitch?' he asks with a grin, nodding his head when you reply, a little to your surprise. 'I'm in a good mood today. I got a couple of new bitches at my den. They're good for a fuck, but I still need to properly break them in, so I'm on my way there now. Hey, you should come with me. It'll give you a chance to meet my former boyfriend, see how I started out. [if hp of Lindsey is 2]Being my number one bitch has its perks after all[else]Perhaps it'll persuade you to reconsider being my top bitch[end if]!' He doesn't give you a chance to disagree, setting off at a brisk pace before you can formulate a reply. 'Hurry the fuck up, I have better things to do than pissing around waiting for you to move your tight ass,' he calls without bothering to turn his head. His orders clear, you hastily follow after your alpha. 'Good bitch,' he praises you smugly.";
	say "     He takes you out the front gates of the zoo and towards the fractured shell of the city. 'You're gonna love my den. It used to be my boyfriend's house, but I claimed it when I made him my bitch. She doesn't seem to mind, more worried about next time she's gonna get dicked. She moans really loud when I'm rough with her, but she's actually damn sweet when she ain't too horny. Being a girl seems to suit her. If it weren't for me, she'd no doubt have ended up as someone else's slut anyway. Instead she's my little wolftaur slut and I get to fuck her when I want, or leave her needy and listen to her beg for my cock. [if hp of Lindsey is 2]You may be my top bitch, but she was my first[else]Perhaps if you're a good bitch, you surpass her one day[end if]. If you tell her this I'll turn you into a cock-hungry whore, but she's special to me, so I hope you know how lucky you are to get to see my den,' Lindsey growls, fixing a stern eye on you. You hastily nod, making the wolftaur grin again. 'Good bitch. That's the correct answer.'";
	WaitLineBreak;
	say "     The two of you soon come to a moderately unscathed two-story home, Lindsey's musk decidedly strong as you enter the building. No doubt it keeps away any opportunistic looters. 'Your alpha's home! Where are my sexy sluts? I've brought someone new for you to meet,' the wolftaur announces as you go into what you assume to be the living area, the couch and floor covered in cum-stains. On the wall hangs a lifeless flat-screen television, evidence of past comforts before sex became the go-to form of entertainment. A sleek female wolftaur, noticeably smaller than Lindsey, comes trotting in through a doorway across from you, the view of a microwave and fridge behind her revealing it to be the kitchen. 'Alpha,' she excitedly greets him, nuzzling up against him, receiving a quick lick in return, before casting a curious eye over you. Before she can speak, the thud of multiple feet coming down the stairs heralds the imminent arrival of more people, two figures rushing into the room behind you, a slender male cheetah and a slightly chubby zebra.";
	if ((BodyName of Player is "Wolftaur" and player is pure) and hp of Lindsey is 2): [Player is a wolftaur and Lindsey's Beta]
		say "     'Master. You have returned,' the cheetah says brightly, rubbing up against the wolftaur. 'You address me as alpha unless I tell you otherwise. Understand?' Lindsey replies tersely, firmly grasping him by the scruff of his neck. 'Yes alpha. Sorry alpha,' the feline apologizes, though you notice the tip of his cock slipping from his sheath. It would seem that he enjoys the wolftaur's assertiveness. Meanwhile, the zebra-woman eyes you intently before turning to Lindsey. 'Alpha, who is this?' she asks, dipping her head when Lindsey turns to her. '[SubjectProCap of Player] is my beta, and as you can see, [SubjectPro of Player] also had the sense to become a wolftaur like me. [SubjectProCap of Player] has earnt [PosAdj of Player] position so you will respect [ObjectPro of Player]. Is that understood?' he explains, the question rhetorical. The female wolftaur has an expression that you can't read, but you wouldn't be surprised if she is upset that you seem to be in a higher position than her.";
		WaitLineBreak;
		say "     'I'd tell them to introduce themselves to you, but I don't have time for that,' Lindsey says, turning back to you. 'The wolftaur is my former boyfriend, Shea. You may be my top bitch, but she's got history with me. The cheetah is Jace and the zebra is Elodie. They haven't had time to properly learn their place or to become wolftaurs, but it shouldn't take me long to fuck them into shape. Now, I think that you should familiarize yourself with my pack. I think that I can even trust you to give Shea a good time, would you like that?' he says, glancing between the two of you. The female wolftaur looks at you eagerly, wagging her tail and playing with her breasts while huffing needily. 'Otherwise you can get it on with one of the new bitches. Properly establish your place over them. Think of the choice as my welcome gift to you.' Lindsey looks at you expectantly, waiting for your answer, three more sets of eyes on you too.";
		say "     [bold type]Do you want to have a go with Shea?[roman type][line break]";
		LineBreak;
		say "     ([link]Y[as]y[end link]) - Yes.";
		say "     ([link]N[as]n[end link]) - No.";
		if Player consents:
			LineBreak;
			say "     You tell Lindsey that the offer of time with Shea is too good a chance to miss, earning a bark of laughter from the male wolftaur, while his girlfriend beams. 'Good choice. She's quite the loud one so you'll know if she's feeling it,' Lindsey informs you, nodding for her to approach you. 'While you fuck her, I'm gonna take Jace and Elodie into the bedroom and try to pound some more obedience into them. Perhaps when we come out, they'll both be wolftaurs.' With a firm swat to their backsides, your alpha herds the cheetah and zebra back up the stairs, following close behind them and leaving you and Shea alone with each other. The sleek wolftaur nudges up against you a little shyly, [if player is naked]tenderly tracing a hand over your exposed body[else]gently slipping your clothes off you[end if]. Upon seeing your [if Player is male]cock, her eyes light up and she crouches down beneath you, rubbing it all over her face and staining her fur with your pre[else]cunt, she looks a little disappointed for a moment, before curiosity takes hold and she crouches down behind you, pressing her nose into your slit and inhaling deeply[end if].";
			if Player is male:
				say "     'Fuck me. Please. I don't care about foreplay, just breed me with your pups if you can,' she pleads as she turns around and presents her swollen vulva to you, her tail flagged to the side. Seeing little reason to refuse, to step up behind her before mounting her and wrapping your fore-paws around her hips. From upstairs you hear creaking and moans. 'I don't want to hear them. I want to hear your balls slapping me in the ass between my own shouts of ecstasy. Fuck me now. Do it. Fuck me. Fill me with puppies!' Gone is the sweet affectionate wolftaur, replaced by the cock-hungry slut beneath you. Spurred on by her words, you aim [if Player is submissive]to not disappoint her. If she wants a dominant stud, you shall play the role[else]to sate her. You are quite capable of making her forget about her boyfriend[end if], even if it is just for now. Tightening your grip, you thrust into her with a growl, hilting yourself in one motion and causing her to howl. As her head tips back, you grasp it with one hand, holding her there as you stare into her eyes while rutting into her.";
				WaitLineBreak;
				say "     Shea gazes at you with lust, her mouth wide open as she pants with need. Each time you hilt into her, another whine bursts from her throat and the muscles of her pussy clench around your length, desperately trying to pull you even deeper into her. She twists her upper body around so that the two of you can more easily caress each other, your tauric bodies continuing their rutting uninterrupted. 'I doubt that I'll be able to last long,' the wolftaur apologizes, briefly pulling away from kissing you. 'But you can keep fucking me until you cum. Even if I can't stand, I want you to pound me full of your cock until you fill me with your delicious cum. I'm sure that Jace or Elodie won't mind eating it out of me. Or I could do it myself. I bet we'd bond really well...' Her words trigger something feral inside of you and you redouble your efforts to pump her full of your seed. The ferocity with which you mate with her causes her to climax, her cunt squeezing rhythmically around you as she ecstatically wails in your arms.";
				say "     You don't know whether she is repeatedly orgasming or whether it is still the first one being indefinitely prolonged, but Shea's front legs soon collapse from under her, her upper body sliding from your grasp to crumple in a euphoric daze to the floor. Somehow her hind-legs seem to remain braced, keeping her ass raised for you to breed. Considering her words earlier, you continue to relentlessly thrust and withdraw, determined to fill her and show to Lindsey and his herem what a strong beta you are. You even go as far as to push one of your front paws down on the small of Shea's back, reinforcing her position beneath you, both physically and symbolically. However, with the rush of dominance going to your head, coupled with the constant stimulation of her quivering pussy, it isn't long before you ram your knot into her just before orgasm overwhelms you. As you fill the pretty wolftaur with your cum, she moans encouragement to you, praising your appearance, the size of your cock, and the volume of the semen that you are pumping into her.";
				WaitLineBreak;
				say "     Neither of you talk as you wait for your knot to go down, the high from sex leaving you both in a sort of stupor, Shea especially. 'Still locked together? Must have been quite the fuck,' Lindsey comments as he, Jace and Elodie appear through the door again, cum dripping from between the cheetah and zebra's legs. 'I didn't knot either of these two today. I have better things to do than lie around being stuck, but I suppose you didn't think of that, did you? Oh well. Just think of it as another reward for being my top bitch. Sometimes I think I really am too generous.' Eventually, your shaft softens enough for you to be able to pull it from the wolftaur's pussy. Surprisingly, Shea manages to prevent the majority of your cum from gushing out, a few stray dribbles all that escapes her clenched cunt. 'Ah. There's nothing like a good fuck. You are going to let him stay, aren't you?' Shea pleads with Lindsey, smiling when he nods his head. 'Of course. As long as you don't forget who your alpha is. The new bitches impressed me too, though they still seem resistant to change,' he grumbles. Jace and Elodie both look at the floor shame-faced.";
				say "     Lindsey turns to you. 'But for now, I think that I should escort you back to the zoo. I wouldn't want you attracting attention to my den and it'll give the bitches a chance to clean each other.' He gestures with an arm, brooking no argument as he follows you outside, his shaft still slowly retreating back into his sheath. 'Jace. If you do anything more than lick Shea or Elodie clean, I'll hand you over to the giants. They're still looking for you.' Eyes wide, the cheetah gulps and nods his head. 'I'm glad that we have an understanding.' The walk back to the zoo is equally uneventful as the trip to the den, and soon you find yourself back at the gates. 'Well, I hope you appreciated that, but I should be getting back. Shea may come on to Jace even with my threats to him. He's only human,' Lindsey snickers at his own words before turning away. 'Be sure to keep coming to see me. A bitch like you is hard to replace.'";
			else:
				say "     'You smell very different to Lindsey,' she comments as she leans back again, before blushing. 'I guess that was a silly thing to say. Sorry. I haven't been with a girl since changing. Lindsey has kept Jace and Elodie to himself. It's a little flattering that you're interested in me.' You reassure her that she should just go at her own pace and not to worry about feeling self-conscious. You're meant to be getting to know each other after all. 'Easier said than done, but I can try. Would you mind if I licked you for a bit?' You turn around and lift your tail, flashing her a smile to signal your consent. She kneels down behind you and gently begins to lick at your vulva, her nose tickling the thin fur between it and your anus. 'Lindsey's a lot more forceful with taking what he wants. He was like that when he was a girl too. There's something so thrilling about letting someone else show you what turns them on, but at the same time, calm moments like this really get me going too.'";
				WaitLineBreak;
				say "     'I know that my fingers and tongue aren't as satisfying as a thick cock. I'm not that good. Yet. But I know that masturbation is difficult when your body is like this, so I hope that I can at least make you feel good,' Shea says, her voice slightly muffled. You feel her thumbs spread your lips apart before her tongue dances across the exposed flesh within, making you clench your pussy at the unexpected sensation that courses through you. It is entirely likely that Lindsey had her doing this when they were still human. With her tongue burying itself farther and farther into you, she is able to move her hands, allowing them to play across your thighs, buttocks, and the base of your tail, tenderly stroking and squeezing. The combination of the sensations from within your body with those on the outside arouses you more than you would expect, though perhaps it has been too long since you were with someone who was this gentle with you.";
				say "     You ask whether Shea would like you to return the favor, either at the same time or after she has brought you to orgasm, but she shakes her head. 'Lindsey prefers that I only be pleasured as a reward. It can be difficult at times, especially when I feel that he finds some made up reason to deny it to me, but it certainly makes me look forward to it all the more, especially when he's ramming into me so hard that I think he'll pierce my womb,' she replies, a look of intense lust clouding her eyes. Interesting. She seems happy enough to eat you out, but perhaps her passion would be more intense if you had a penis. Such thoughts become more difficult to formulate as your climax creeps up on you, and become nearly impossible when she squeezes the base of your tail and pulls just as she shoves her tongue as far into you as she can. With lights dancing at the edge of your vision, you violently cum, shuddering and thrusting your hips while Shea keeps her tongue wriggling inside of you.";
				WaitLineBreak;
				say "     'That's my girl, you still haven't lost your touch,' Lindsey compliments her upon walking through the door while you twitch and quiver, Jace and Elodie appearring a moment later, cum dripping from between their legs. 'I didn't knot either of these two today. I have better things to do than lie around being stuck, and I'm so glad that I did. I haven't seen this from this perspective before. It used to be me where you are,' the alpha wolftaur informs you. Eventually, your body calms down and you are able to take a more dignified position. Shea giggles as she feels how drenched her face is. 'Ah. I think that my new tongue may be better at that than it used to. Tastes better too. You are going to let her stay, aren't you?' Shea pleads with Lindsey, smiling when he nods his head. 'Of course. As long as you don't spend too much time muff-munching. The new bitches impressed me too, though they still seem resistant to change,' he grumbles. Jace and Elodie both look at the floor shame-faced.";
				say "     Lindsey turns to you. 'But for now, I think that I should escort you back to the zoo. I wouldn't want you attracting attention to my den and it'll give the bitches a chance to clean each other.' He gestures with an arm, brooking no argument as he follows you outside, his shaft still slowly retreating back into his sheath. 'Jace. If you do anything more than lick Shea or Elodie clean, I'll hand you over to the giants. They're still looking for you.' Eyes wide, the cheetah gulps and nods his head. 'I'm glad that we have an understanding.' The walk back to the zoo is equally uneventful as the trip to the den, and soon you find yourself back at the gates. 'Well, I hope you appreciated that, but I should be getting back. Shea may come on to Jace even with my threats to him. He's only human,' Lindsey snickers at his own words before turning away. 'Be sure to keep coming to see me. A bitch like you is hard to replace.'";
			now resolution of Lindsey's Harem is 1;
		else:
			LineBreak;
			say "     'Fine. Suit yourself. Which of the sluts did you want? Or were you looking for a chance to see me in action and want to watch me fuck one of them?'";
			say "     [bold type]Do you want to have a have sex with Jace, Elodie, or just watch?[roman type][line break]";
			LineBreak;
			say "     ([link](1)[as]1[end link]) - Jace.";
			say "     ([link](2)[as]2[end link]) - Elodie.";
			say "     ([link](3)[as]3[end link]) - Just Watch.";
			now calcnumber is 0;
			while calcnumber < 1 or calcnumber > 3:
				say "Choice? (1-3)>[run paragraph on]";
				get a number;
				if calcnumber is 1 or calcnumber is 2 or calcnumber is 3:
					break;
				else:
					say "Invalid choice. Type [link]1[end link] for Jace, [link]2[end link] for Elodie, or [link]3[end link] for Watch.";
			if calcnumber is 1: [CHEETAH]
				LineBreak;
				say "     Allowing your eyes to roam over the cheetah, you tell Lindsey that you would like to spend some time with Jace. 'Sure, but don't let him be the one fucking you. He's got to earn it,' the wolftaur replies, fixing the feline with a stern look. 'While you fuck him, I'm gonna take Shea and Elodie into the bedroom and remind them why I'm alpha. Perhaps when we come out, the zebra will be a wolftaur.' With a firm swat to their backsides, your alpha herds his girlfriend and the zebra up the stairs, following close behind them and leaving you and Jace alone with each other. Jace looks down at his feet shyly, occasionally sneaking a quick glance up at you. 'Sorry. I should be doing better than this. How may I please you?' he asks, [if player is naked]tenderly tracing a hand over your exposed body[else]gently slipping your clothes off you[end if]. Upon seeing your [if Player is male]cock, he stares for a moment, unconsciously licking his lips before, unable to help himself, he crouches down beneath you, rubbing it all over his face and staining his fur with your pre[else]cunt, he reaches a hand forward, nearly touching your damp lips before he snatches it back again. He eyes it lustfully, licking his lips[end if].";
				if Player is male:
					say "     'You smell good. Really good,' Jace moans, purring as he continues to nuzzle against your penis and getting your scent all over his face. As he does so, his own shaft slips out of his sheath, the softly-barbed head bobbing as he moves. Eventually, he reluctantly crawls back before turning around and lifting his tail. 'I could do that all day, but the alpha expects you to fuck me and I don't want to disappoint. Mount me and show me why you are his top bitch. Don't worry about lube, I've had quite a bit of experience, and whatever it is that changed me seems to have made me stretchier and wetter.' Given how needy he seems to be, you don't argue, stepping over him and making a few light thrusts until you find your mark and push yourself past the accommodating ring of his sphincter. The cheetah seems to have a good understanding of what his body can take, as her is able to take a sizable portion of your cock without any difficulty, excited yowls and moans suggesting that he is enjoying this immensely.";
					WaitLineBreak;
					say "     'Ah. Yeah... Fuck me. Show me who's boss. Make me your bitch,' you hear him muttering under his breath as he pushes his ass back to meet your thrusts, his hands firmly braced against your front legs. Despite how easily he seems to have taken you, his back passage squeezes around your length each time you bury it in him, clinging to you as you try to withdraw but welcoming you when you thrust back in. 'Have I been a good kitty, or a bad kitty? Will I get a creamy reward or be left denied moments before release?' Jace asks, peering up at you pleadingly. You can't be sure which he would prefer as he seems excited by the prospect of both. That said, he seems to be being well-behaved so far, and the muscle control that he is exhibiting with his ass as you pound into him certainly impresses you, so you tell him that he can look forward to a creamy reward, as long as he promises to clean up any spillage. 'I look forward to it, sir,' he replies with adoration.";
					say "     You can feel Jace's tail whipping around beneath you and it is only when you feel his bowels rhythmically squeezing around your cock that you realize that it was a sign of his impending orgasm. You hear the splash each time his cum splatters on the floor, the cheetah releasing a pleasured sigh with each clench of his ass and the accompanying rise and fall of his balls as another spurt is wasted on the floor. Ultimately, this leads to you climaxing too, the combined physical and auditory sensations sending you over the edge as you ram your knot past the ring of his tail hole and into the scorching grip within, causing him to squeak. As Jace feels your cum fill him up, he begins to purr, rubbing his head against your lower body's chest even as his own climax is stimulated into being prolonged. 'I can feel your yummy cum filling my ass,' he moans euphorically. 'I can't wait to lick it up and taste just how strong you are.'";
					WaitLineBreak;
					say "     'Is that so?' Lindsey barks as he enters the room, Shea and Elodie appearing a moment later, cum dripping from between their legs. 'Don't forget who the alpha is, bitch,' he growls at Jace, making the cheetah shrink away, unable to escape. 'I didn't knot either of these two today. I have better things to do than lie around being stuck, and I'm so glad that I did. It looks like you've impressed your bitch, but I think that I'll have to discipline him later,' the alpha wolftaur informs you. Eventually, your shaft softens enough for you to be able to pull it from Jace's ass. Surprisingly, or not, the cheetah manages to clench his anus to prevent the majority of your cum from gushing out, a few stray dribbles all that escapes his tail-hole. 'I didn't realize just how pent up I was. You are going to let him stay, aren't you?' Jace pleads with Lindsey. 'Of course. You on the other hand still need to know your place. You can start by licking up that mess on the floor,' the wolftaur grumbles, indicating the pool of the feline's cum. Jace meekly nods his acceptance.";
					say "     Lindsey turns to you. 'But for now, I think that I should escort you back to the zoo. I wouldn't want you attracting attention to my den and it'll give the bitches a chance to clean each other.' He gestures with an arm, brooking no argument as he follows you outside, his shaft still slowly retreating back into his sheath. 'Jace. That floor better be spotless by the time I get back or I'll hand you over to the giants. They're still looking for you.' Eyes wide, the cheetah gulps and nods his head. 'I'm glad that we have an understanding.' The walk back to the zoo is equally uneventful as the trip to the den, and soon you find yourself back at the gates. 'Well, I hope you appreciated that, but I should be getting back. I still have to punish the cheetah bitch for disrespecting my place as alpha. You're guiltless, I'm sure,' Lindsey snickers at his own words before turning away. 'Be sure to keep coming to see me. A bitch like you is hard to replace.'";
				else if Player is female:
					say "     'Would you mind if I...' Jace asks, gesturing towards your pussy, saliva collecting behind his lips before he swallows. With a smirk, you direct him to lie on the floor, an order which he quickly complies with. No sooner has he done this, then you sit on his face, forcing the only-too-willing cheetah to get a taste of your snatch. As his eager licking spreads your juices and your scent across his face, you gaze down at his emerging shaft, its head covered in soft-looking barbs. Despite his enthusiasm, you quickly tire of this with the prospect of something more substantial than his tongue to penetrate the depths of your cunt, and you drag your hind-quarters down his body, leaving a thin trail of your arousal over his chest and tummy. Having reached your objective, you turn around to meet his eyes, lift your rump, then plunge it down on his rampant erection. 'Show me why you are his top bitch,' Jace half suggests, half begs, looking up at you from his vulnerable position.";
					WaitLineBreak;
					say "     Seeing no reason not to permit his request, you place one paw on his chest to reinforce that you are in control, before slowly lifting your pussy up his shaft again. Hovering with just his tip kissing the entrance to your depths, you slam back down again, delighting in the raw moan of pleasure that is dragged from the cheetah's throat. 'Ah. Yeah... Fuck me. Show me who's boss. Make me your bitch,' you hear him muttering under his breath as he thrusts up to meet you. 'Have I been a good kitty, or a bad kitty? Will I get to share my cream with you or will I be left denied moments before release?' Jace asks, peering up at you pleadingly. You can't be sure which he would prefer as he seems excited by the prospect of both. You decide that you'll allow him to cum, but that he won't get to do it inside you. You tell him so, but add that it is on the condition of him promising to clean up his mess afterwards. 'Whatever pleases you,' he replies with adoration.";
					say "     You can feel Jace's tail whipping around beneath you and it is only when he desperately pats you on the leg that you realize that it is a sign of his impending orgasm. Quickly shifting backwards, pulling his penis from your depths, you watch as his shaft throbs and shoots his load to splatter across his chest and face, the cheetah releasing a pleasured sigh with each clench of his loins and the accompanying rise and fall of his balls as another spurt joins the sticky mess matting his fur. The sight of his debasement causes you to climax too, there being something special about the way he looks up at you almost worshipfully as he covers himself in his own seed. As you quiver and shudder before him, Jace begins to purr, rubbing an unsullied ear against one of your front paws as his climax begins to ebb. 'I wish my cum had been deep inside you, but it feels so good on me too,' he moans euphorically. 'Are you sure that I can't be yours?'";
					WaitLineBreak;
					say "     'Naughty kitty,' Lindsey barks as he enters the room, Shea and Elodie appearing a moment later, cum dripping from between their legs. 'Don't forget who the alpha is, bitch,' he growls at Jace, making the cheetah shrink away, unable to escape. 'I didn't knot either of these two today. I have better things to do than lie around being stuck, and I'm so glad that I did. It looks like you've impressed your bitch, but I think that I'll have to discipline him later,' the alpha wolftaur informs you. Eventually, your body calms down and you are able to take a more dignified position. 'I'm sorry alpha. I promise that I wasn't betraying you. It was just so good...' Jace pleads with Lindsey. 'Of course it was, but you still need to know your place. You can start by licking up your own mess and any that got on the floor,' the wolftaur grumbles, giving you a wink when the cheetah isn't looking. Jace meekly nods his acceptance.";
					say "     Lindsey turns to you. 'But for now, I think that I should escort you back to the zoo. I wouldn't want you attracting attention to my den and it'll give the bitches a chance to clean each other.' He gestures with an arm, brooking no argument as he follows you outside, his shaft still slowly retreating back into his sheath. 'Jace. That floor better be spotless by the time I get back or I'll hand you over to the giants. They're still looking for you.' Eyes wide, the cheetah gulps and nods his head. 'I'm glad that we have an understanding.' The walk back to the zoo is equally uneventful as the trip to the den, and soon you find yourself back at the gates. 'Well, I hope you appreciated that, but I should be getting back. I still have to punish the cheetah bitch for disrespecting my place as alpha. You're guiltless, I'm sure,' Lindsey snickers at his own words before turning away. 'Be sure to keep coming to see me. A bitch like you is hard to replace.'";
				now resolution of Lindsey's Harem is 2;
			else if calcnumber is 2: [ZEBRA]
				LineBreak;
				say "     Allowing your eyes to roam over the zebra, you tell Lindsey that you would like to spend some time with Elodie. 'Sure. With a body like hers, I'm not surprised that you want to pound her,' the wolftaur replies, eye banging the equine as he does so. 'While you fuck her, I'm gonna take Shea and Jace into the bedroom and remind them why I'm alpha. Perhaps when we come out, the cheetah will be a wolftaur.' With a firm swat to their backsides, your alpha herds his girlfriend and the cheetah up the stairs, following close behind them and leaving you and Elodie alone with each other. Elodie looks over your body appreciatively, thye she lowers her gaze when she thinks that she is about to meet your eyes. 'You're really sexy, if you don't mind my forwardness. I'm looking forward to this. How may I please you? ' she asks, [if player is naked]enthusiastically running a hand over your exposed body[else]deftly slipping your clothes off you[end if]. Upon seeing your [if Player is male]cock, she stares at it hungrily, licking his lips and cupping your balls in her hand[else]cunt, reaches a hand forward and gently strokes the outer lips before bringing a finger to her mouth and sucking it while looking up at you[end if].";
				if Player is male:
					say "     'I can't wait for this to be inside me. You can fuck me as hard as you want, I've got plenty of padding,' Elodie croons, patting her ass to emphasize her point. 'But first, I want a quick taste. The smell is divine.' You thought that it was Shea who was meant to be the cock-whore. The zebra grasps your length in one hand then leans forward before running her broad tongue from base to tip. 'Oh yeah... Nearly as good as alpha's. Okay. I'm ready. Mount me and show me why you are top bitch,' Elodie pleads as she waits on all fours, her rump raised and her pussy winking. Given how aroused she seems to be, you don't argue, stepping over her and making a few light thrusts until you find your mark and push yourself past the puffy lips of her vulva. The way her thighs and buttocks ripple when you bottom out in her, and the cute gasp that accompanies this, spurs you on to pound in to her in the effort to get the best reaction from the zebra, adjusting angle or depth accordingly.";
					WaitLineBreak;
					say "     'Mmmm... Just like that. I want to feel just how strong a male you are. To know that I can take whatever is necessary of me as your bitch,' Elodie cries out, her hands slipping on the floor with each thrust. Between the satisfying cushioning of her ass, the tight embrace of her cunt, and her increasingly present intoxicating scent, you doubt that you'll be able to last long, especially as the needy way in which she urges you on inflames your lust. 'Just don't cum inside. The alpha hasn't given me permission for others to fill me with their hot... virile... copious loads.' You can tell that she is only half-denying you, the temptation still there in the way that she emphasizes the last few words. Nonetheless, it wouldn't be wise to betray Lindsey's trust, so you tell Elodie that you'll just have to cover her with it instead. 'Oh yeah. Make me smell like your cum. Maybe the alpha will have to mark me too,' she excitedly replies, one of her hands disappearing from view, to rub where your cock is entering her cunt.";
					say "     As the pitch of the zebra's moans increases, she meets your thrusts with growing desperation until finally she lets out a strangled groan and her pussy begins to rhythmically squeeze and release around your cock. Elodie struggles to plead with you to cum, her orgasm making speech difficult, and you feel your climax beginning to crest and hurriedly pull out of her just in time to send the first jet of essence soaring over her back to splatter between her shoulder-blades. Growling under your breath, you reflexively thrust with each spurt of cum, giving the zebra vertical off-white stripes up her back and across the plump globes of her ass. Feeling your essence seeping into her thin fuzz of fur, Elodie writhes beneath you, moaning contentedly as she is bathed in your scent. 'Alpha is going to have to fuck me too if he wants to get your scent off me. Maybe you can compete for ownership,' she moans hopefully. 'Or maybe you can share.'";
					WaitLineBreak;
					say "     'Don't get ahead of yourself, bitch,' Lindsey barks as he enters the room, Shea and Jace appearing a moment later, cum dripping from between their legs. 'I expect this sort of brattiness from the kitty, but I expected better obedience from you,' he growls at Elodie, making the zebra look away shame-faced, caught in her insubordination. 'I didn't knot either of these two today. I have better things to do than lie around being stuck, and I'm so glad that I did. It looks like you've impressed your bitch, perhaps a little too much, but at least you remembered to pull out,' the alpha wolftaur informs you. 'I'm sorry alpha. I got caught up in the fantasy. It won't happen again,' Elodie pleads with Lindsey. 'Perhaps, perhaps not. But I'm sure I can find a suitable punishment if it does. Maybe I'll make you have a shower rather than letting you lick it up,' the wolftaur grumbles, Jace looking disappointed at this. 'But it's the first time that this has happened, and I am a forgiving master, so I'll let the the three of you clean each other while I escort my top bitch back to the zoo.'";
					say "     Lindsey turns to you. 'Ready? I wouldn't want you attracting attention to my den and it'll give the bitches a chance to clean each other.' He gestures with an arm, brooking no argument as he follows you outside, his shaft still slowly retreating back into his sheath. 'Jace. Cleaning only. If you fuck anyone while I'm out, I'll hand you over to the giants. They're still looking for you.' Eyes wide, the cheetah gulps and nods his head. 'I'm glad that we have an understanding.' The walk back to the zoo is equally uneventful as the trip to the den, and soon you find yourself back at the gates. 'Well, I hope you appreciated that, but I should be getting back. I still have to punish the zebra bitch somehow for disrespecting my place as alpha. You're guiltless, I'm sure,' Lindsey snickers at his own words before turning away. 'Be sure to keep coming to see me. A bitch like you is hard to replace.'";
				else if Player is female:
					say "     'I haven't been with another woman in ages. Alpha won't let me and Shea fool around,' Elodie laments. 'It's a shame that you don't have a cock to fuck me as hard as you want, but eating you out sounds fun too.' You don't doubt her words, especially as she seems to be so eager to taste you. Spreading your hind-legs a bit, you direct her to start licking. 'Um. Please forgive me, but... would you mind sitting on my face instead? I kind of have a predator-prey kink, so vulnerability sort of gets me going,' the zebra interjects, pleadingly looking at you. As you nod, she hurriedly lies on her back and waits, gasping excitedly when your rump descends on her face and smothers her nose and mouth. When she doesn't struggle, instead licking your pussy eagerly, you assume that she can still breath and relax, focusing on the jolts of pleasure that the equine sends through you with each passage of her broad tongue against the sensitive walls of your cunt.";
					WaitLineBreak;
					say "     You wouldn't say that she is particularly skilled, but her enthusiasm more than makes up for it, hands playing across your rump, caressing, fingering, and squeezing, displaying her subservience and desire to please. 'I hope I'm doing this right. I was never sure if my friends were just being nice when we used to experiment,' Elodie says, her voice slightly muffled. You respond by wriggling your ass atop her and complimenting the fervor with which she is pleasuring you. At one point, she seems to try to stick her tongue as far into you as possible, making you clench your pussy at the unexpected sensation that courses through you, especially with how deep it seems to go. With enough time and patience, you're sure that she could get to be quite good at cunnilingus, though you're not sure how willing Lindsey will be to let Shea help her with this. The sensations from her tongue burying itself in to you, combined with those of her hands stroking your flanks arouses you more than you would expect, though perhaps it has been too long since you were with someone who was this eager yet inexperienced.";
					say "     Moved by this, you ask Elodie whether she would like you to lick her too, either at the same time or after she has brought you to orgasm, but, to your surprise, she pulls her face from beneath you and replies in the negative. 'I'm edging enough as it is. Trapped beneath a predator, my only way out is to satisfy her sexual hunger...,' she replies, a look of intense lust on her face. Interesting. You wonder whether Lindsey knows the extent to her kink or whether he hasn't explored that side of her. Such thoughts become more difficult to formulate as your climax creeps up on you, and become nearly impossible when Elodie pulls the base of your tail and shoves her tongue as far into you as she can. With lights dancing at the edge of your vision, you violently cum, shuddering and thrusting your hips while she keeps her tongue plunging in and out of you.";
					WaitLineBreak;
					say "     'My my. The two of you seem to be getting on well,' Lindsey comments as he walks through the door, watching intently while you twitch and quiver, Shea and Jace appearing a moment later, cum dripping from between their legs. 'I didn't knot either of these two today. I have better things to do than lie around being stuck, and I'm so glad that I did. I haven't seen this from this perspective before. I remember when Shea used to do that to me,' the alpha wolftaur informs you. Eventually, your body calms down and you are able to take a more dignified position. As you shift, you inadvertently brush against the zebra's pussy, the soft touch against the puffy lips triggering a very messy orgasm. Though it doesn't last very long, it leaves Elodie panting and a very fragrant stain on the floor. 'Ah. I don't think that I've ever cum like that, not even for alpha,' she mumbles without thinking, before her eyes shoot wide when she realizes what she just said in front of Lindsey. 'Is that so? Perhaps you don't need cock any more. If muff-munching is what really moistens your oyster,' he growls, relenting when she violently shakes her head and pleads forgiveness.";
					say "     Lindsey turns to you. 'I think that I should escort you back to the zoo. I wouldn't want you attracting attention to my den and it'll give the bitches a chance to clean each other and for the stripey bitch to think on why she should watch her mouth.' He gestures with an arm, brooking no argument as he follows you outside, his shaft still slowly retreating back into his sheath. 'Jace. If you do anything more than lick Shea or Elodie clean, I'll hand you over to the giants. They're still looking for you.' Eyes wide, the cheetah gulps and nods his head. 'I'm glad that we have an understanding.' The walk back to the zoo is equally uneventful as the trip to the den, and soon you find yourself back at the gates. 'Well, I hope you appreciated that, but I should be getting back. I need to remind Elodie why she should be more careful what she says to an apex predator,' Lindsey snickers before turning away. 'Be sure to keep coming to see me. A bitch like you is hard to replace.'";
				now resolution of Lindsey's Harem is 3;
			else: [Watch]
				LineBreak;
				say "     'Bit of a voyeur are you? Or perhaps a cuck? I don't give a shit. All the more pussy for me!' Lindsey laughs. 'Well, I guess I can fuck them right here. Usually do.' The wolftaur trots over to an open bit of floor before calling his miniature harem over. 'Shea, you're the best at it, so you can suck my cock while I decide which of the two bitches I fuck this time.' Lindsey's girlfriend looks hungrily at her master's bobbing shaft as she kneels down and shuffles beneath him. Cradling his balls in one hand, she immediately begins to slather the length with her tongue, letting out contented moans as she does so, her other hand playing with her breasts. 'Now... which of you is going to be the lucky one?' Lindsey muses, casting an eye over the cheetah and zebra. Honestly, you would have to say that the big male wolftaur will be the lucky one, no matter which of them he chooses.";
				say "     'I think that I'm in the mood for some prey, and Elodie's got a real juicy ass. Tough luck Jace, but I'll let you get her pussy ready for me. Just use your mouth and fingers though. You have to earn the right to use your cock if you're staying here,' Lindsey growls, lightly thrusting into Shea's greedy mouth as she blows him. Elodie looks thrilled to have been chosen, the zebra grinning widely as she lies back on the couch and spreads her legs, her labia slightly stuck together with arousal. Jace's shoulders slump a little as he kneels down in front of her, his slim frame quite the contrast to her more generous proportions as he prepares to service her, shuddering slightly as he takes a breath of her heady scent. 'She doesn't look like she needs any preparation at all,' Lindsey barks with laughter, making the zebra blush and close her legs in embarrassment. 'It was a compliment bitch. Now spread [']em. Before you suffocate the cat with your thighs.'";
				WaitLineBreak;
				say "     Gasping at the realization of what she's done, Elodie quickly opens her legs again. You expected Jace to need to gulp in some air, but the feline only buries himself deeper in her snatch, quite effectively so given the way the zebra whinnies and grasps the cheetah by the back of his head. 'Well well. Looks like the kitty liked it. It's a shame that he won't be the one getting the cream today,' Lindsey chuckles, stepping forward and pulling his spit-soaked cock from his girlfriend's muzzle. 'She should be ready enough. Move over Jace.' When the cheetah doesn't respond, continuing to eat the zebra out, Lindsey grabs him by the shoulder and pushes him to the floor. 'I said move, bitch,' he snarls, stepping over Jace's prostrate form and mounting the woman, his front paws resting over the back of the couch. The feline has a close-up view as Elodie is speared by the wolftaur's thick cock, Lindsey's balls bumping his face as he sits up and scrabbles to get out of the way.";
				say "     'I'm gonna fill your belly with my pups,' Lindsey snarls in Elodie's ear as he pounds into her, grasping her by the jaw and pushing her against the back of the couch. 'Maybe you'll even turn into a wolftaur this time. Become a proper bitch for me.' The zebra can only moan and call for him to fuck her harder, her capability of conscious thought severely impeded. Jace begins to reach towards his erection, but Shea lightly grasps him by the wrist and shakes her head, replacing his hand with one of her own, though you get the impression that she would prefer something more involved than giving a handjob. Lindsey merely grins upon seeing this before he turns to you. 'Regretting not being a part of this yet? You could have been fucking Shea right now, but instead all she gets to do is give a boy-bitch a handy. She must be so frustrated. But she won't do more. Not without my permission,' he growls possessively, punctuating each of the last few words with especially sharp thrusts into the zebra.";
				WaitLineBreak;
				say "     Elodie's mind seems to be gone at the moment, eyes rolled up and mouth hanging open as she is roughly bred. With each slap of Lindsey's knot into her labia, a wave of force rolls through her body, making her heavy breasts heave and causing her to let out an enthusiastic moan or grunt. Jace and Shea look on enviously, their own interaction seeming rather inadequate in comparison. Nonetheless, as they continue, you would assume that they still find a modicum of enjoyment in it. 'Are you ready for my cum?' Lindsey asks Elodie, grinning when she is only able to muster a desperate whine. She attempts to pull her vulva wider to make it easier for the wolftaur to knot her, her fingers slipping on the copious juices from their rutting. All eyes fall on the pair of them as Lindsey slams into her a few more times with a snarl until finally his knot batters its way into the embrace of her cunt.";
				say "     The zebra's delirious squeal is almost drowned out by Lindsey's roar as they both orgasm, both of them shuddering violently, and you watch the wolftaur's balls rise and fall as they pump her full of his seed. Behind them, Jace also climaxes, Shea's hands on his penis being helped along by the sight of Elodie being filled in front of him. The female wolftaur quickly cups her palm in front of his cock as it pulses, catching his semen, before she brings it to her mouth and laps it up, her eyes locked with his. The cheetah watches her drink it with a look of infatuation, his lips slightly parted. 'You're such a slut, Shea,' Lindsey teases her as he turns his upper body to observe them both. 'Don't get any ideas, pussy-bitch. I let her jack you off, but she's still mine' he growls at Jace. The cheetah nods reflexively, but he still sneaks a glance at the female wolftaur who winks at him when Lindsey turns away again.";
				WaitLineBreak;
				say "     Everyone is rather silent as they wait for Lindsey's knot to go down, the high from sex leaving them in a sort of stupor. Eventually, the alpha wolftaur's shaft softens enough for him to be able to pull it from the zebra's pussy. Surprisingly, Elodie manages to prevent the majority of his cum from gushing out, a few stray dribbles all that escapes her clenched cunt. 'Ah. There's nothing like a good fuck. You're definitely staying with me here, prey,' Lindsey informs her. 'And I think that Jace could have his uses once he learns to follow orders without hesitation.' The cheetah obediently lets his gaze fall to the floor. 'And you, my voyeuristic beta, surprised me. I was sure you'd want to fuck someone, but I guess you couldn't give up the chance to see me in action. Next time perhaps you can get to know them, rather than hear about how good my cock is,' Lindsey jokes.";
				say "     'But for now, I think that I should escort you back to the zoo. I wouldn't want you attracting attention to my den and it'll give the bitches a chance to get to know each other.' He gestures with an arm, brooking no argument as he follows you outside, his shaft still slowly retreating back into his sheath. 'Jace. If you touch Shea while I'm out, I'll hand you over to the giants. They're still looking for you.' Eyes wide, the cheetah gulps and nods his head. 'I'm glad that we have an understanding.' The walk back to the zoo is equally uneventful as the trip to the den, and soon you find yourself back at the gates. 'Well, I hope you appreciated that, but I should be getting back. Shea may come on to Jace even with my threats to him. He's only human,' Lindsey snickers at his own words before turning away. 'Be sure to keep coming to see me. A bitch like you is hard to replace.'";
				now resolution of Lindsey's Harem is 4;
	else if hp of Lindsey is 2: [Player is Lindsey's Beta but not a wolftaur]
		say "     'Master. You have returned,' the cheetah says brightly, rubbing up against the wolftaur. 'You address me as alpha unless I tell you otherwise. Understand?' Lindsey replies tersely, firmly grasping him by the scruff of his neck. 'Yes, alpha. Sorry, alpha,' the feline apologizes, though you notice the tip of his cock slipping from his sheath. It would seem that he enjoys the wolftaur's assertiveness. Meanwhile, the zebra-woman eyes you intently before turning to Lindsey. 'Alpha, who is this?' she asks, dipping her head when Lindsey turns to her. '[SubjectProCap of Player] is my beta, though, like you, they seem resistant to becoming a proper wolftaur. Despite this, [SubjectPro of Player] has earnt [PosAdj of Player] position so you will respect [ObjectPro of Player]. Is that understood?' he explains, the question rhetorical. The female wolftaur has an expression that you can't read, but you wouldn't be surprised if she is upset that you seem to be in a higher position than her.";
		WaitLineBreak;
		say "     'I'd tell them to introduce themselves to you, but I don't have time for that,' Lindsey says, turning back to you. 'The wolftaur is my former boyfriend, Shea. You may be my top bitch, but she's got history with me. The cheetah is Jace and the zebra is Elodie. They haven't had time to properly learn their place or to become wolftaurs, but it shouldn't take me long to fuck them into shape. Now, I think that you should familiarize yourself with my pack. I'll be the one breeding Shea today, you haven't yet earned that privilege' he says, glancing lustfully at his former boyfriend. The female wolftaur looks at him eagerly, wagging her tail and playing with her breasts while huffing needily. 'But feel free to get it on with one of the new bitches. Properly establish your place over them. Otherwise you can just watch me fuck one of them. I ain't got a problem with that. Think of the choice as my welcome gift to you.' Lindsey looks at you expectantly, waiting for your answer, the cheetah and the zebra looking toward you too.";
		say "     [bold type]Do you want to have a have sex with Jace, Elodie, or just watch?[roman type][line break]";
		LineBreak;
		say "     ([link](1)[as]1[end link]) - Jace.";
		say "     ([link](2)[as]2[end link]) - Elodie.";
		say "     ([link](3)[as]3[end link]) - Just Watch.";
		now calcnumber is 0;
		while calcnumber < 1 or calcnumber > 3:
			say "Choice? (1-3)>[run paragraph on]";
			get a number;
			if calcnumber is 1 or calcnumber is 2 or calcnumber is 3:
				break;
			else:
				say "Invalid choice. Type [link]1[end link] for Jace, [link]2[end link] for Elodie, or [link]3[end link] for Watch.";
		if calcnumber is 1: [CHEETAH]
			LineBreak;
			say "     Allowing your eyes to roam over the cheetah, you tell Lindsey that you would like to spend some time with Jace. 'Sure, but don't let him be the one fucking you. He's got to earn it,' the wolftaur replies, fixing the feline with a stern look. 'While you fuck him, I'm gonna take Shea and Elodie into the bedroom and remind them why I'm alpha. Perhaps when we come out, the zebra will be a wolftaur.' With a firm swat to their backsides, your alpha herds his girlfriend and the zebra up the stairs, following close behind them and leaving you and Jace alone with each other. Jace looks down at his feet shyly, occasionally sneaking a quick glance up at you. 'Sorry. I should be doing better than this. How may I please you?' he asks, [if player is naked]tenderly tracing a hand over your exposed body[else]gently slipping your clothes off you[end if]. Upon seeing your [if Player is male]cock, he stares for a moment, unconsciously licking his lips before, unable to help himself, he crouches down beneath you, rubbing it all over his face and staining his fur with your pre[else]cunt, he reaches a hand forward, nearly touching your damp lips before he snatches it back again. He eyes it lustfully, licking his lips[end if].";
			if Player is male:
				say "     'You smell good. Really good,' Jace moans, purring as he continues to nuzzle against your penis and getting your scent all over his face. As he does so, his own shaft slips out of his sheath, the softly-barbed head bobbing as he moves. Eventually, he reluctantly crawls back before turning around and lifting his tail. 'I could do that all day, but the alpha expects you to fuck me and I don't want to disappoint. Mount me and show me why you are his top bitch. Don't worry about lube, I've had quite a bit of experience, and whatever it is that changed me seems to have made me stretchier and wetter.' Given how needy he seems to be, you don't argue, hunching over him and making a few light thrusts until you find your mark and push yourself past the accommodating ring of his sphincter. The cheetah seems to have a good understanding of what his body can take, as her is able to take a sizable portion of your cock without any difficulty, excited yowls and moans suggesting that he is enjoying this immensely.";
				WaitLineBreak;
				say "     'Ah. Yeah... Fuck me. Show me who's boss. Make me your bitch,' you hear him muttering under his breath as he pushes his ass back to meet your thrusts, his hands firmly braced against the floor. Despite how easily he seems to have taken you, his back passage squeezes around your length each time you bury it in him, clinging to you as you try to withdraw but welcoming you when you thrust back in. 'Have I been a good kitty, or a bad kitty? Will I get a creamy reward or be left denied moments before release?' Jace asks, peering up at you pleadingly. You can't be sure which he would prefer as he seems excited by the prospect of both. That said, he seems to be being well-behaved so far, and the muscle control that he is exhibiting with his ass as you pound into him certainly impresses you, so you tell him that he can look forward to a creamy reward, as long as he promises to clean up any spillage. 'I look forward to it, sir,' he replies with adoration.";
				say "     You can feel Jace's tail whipping around beneath you and it is only when you feel his bowels rhythmically squeezing around your cock that you realize that it was a sign of his impending orgasm. You watch as his cum splatters on the floor, the cheetah releasing a pleasured sigh with each clench of his ass and the accompanying rise and fall of his balls as another spurt is wasted on the floor. Ultimately, this leads to you climaxing too, the combined physical and auditory sensations sending you over the edge as you ram your cock as far into the scorching grip of his tail-hole, causing him to squeak. As Jace feels your cum fill him up, he begins to purr, rubbing his head against your chest even as his own climax is stimulated into being prolonged. 'I can feel your yummy cum filling my ass,' he moans euphorically. 'I can't wait to lick it up and taste just how strong you are.'";
				WaitLineBreak;
				say "     'Is that so?' Lindsey barks as he enters the room, Shea and Elodie appearing a moment later, cum dripping from between their legs. 'Don't forget who the alpha is, bitch,' he growls at Jace, making the cheetah shrink away, unable to escape. 'I didn't knot either of these two today. I have better things to do than lie around being stuck, and I'm so glad that I did. It looks like you've impressed your bitch, but I think that I'll have to discipline him later,' the alpha wolftaur informs you. Eventually, your shaft begins to soften and you pull it from Jace's ass. Surprisingly, or not, the cheetah manages to clench his anus to prevent the majority of your cum from gushing out, a few stray dribbles all that escapes his tail-hole. 'I didn't realize just how pent up I was. You are going to let him stay, aren't you?' Jace pleads with Lindsey. 'Of course. You on the other hand still need to know your place. You can start by licking up that mess on the floor,' the wolftaur grumbles, indicating the pool of the feline's cum. Jace meekly nods his acceptance.";
				say "     Lindsey turns to you. 'But for now, I think that I should escort you back to the zoo. I wouldn't want you attracting attention to my den and it'll give the bitches a chance to clean each other.' He gestures with an arm, brooking no argument as he follows you outside, his shaft still slowly retreating back into his sheath. 'Jace. That floor better be spotless by the time I get back or I'll hand you over to the giants. They're still looking for you.' Eyes wide, the cheetah gulps and nods his head. 'I'm glad that we have an understanding.' The walk back to the zoo is equally uneventful as the trip to the den, and soon you find yourself back at the gates. 'Well, I hope you appreciated that, but I should be getting back. I still have to punish the cheetah bitch for disrespecting my place as alpha. You're guiltless, I'm sure,' Lindsey snickers at his own words before turning away. 'Be sure to keep coming to see me. A bitch like you is hard to replace.'";
			else if Player is female:
				say "     'Would you mind if I...' Jace asks, gesturing towards your pussy, saliva collecting behind his lips before he swallows. With a smirk, you direct him to lie on the floor, an order which he quickly complies with. No sooner has he done this, then you sit on his face, forcing the only-too-willing cheetah to get a taste of your snatch. As his eager licking spreads your juices and your scent across his face, you gaze down at his emerging shaft, its head covered in soft-looking barbs. Despite his enthusiasm, you quickly tire of this with the prospect of something more substantial than his tongue to penetrate the depths of your cunt, and you drag your groin down his body, leaving a thin trail of your arousal over his chest and tummy. Having reached your objective, you turn around to meet his eyes, lift your rump, then plunge it down on his rampant erection. 'Show me why you are his top bitch,' Jace half suggests, half begs, looking up at you from his vulnerable position.";
				WaitLineBreak;
				say "     Seeing no reason not to permit his request, you place one hand on his chest to reinforce that you are in control, before slowly lifting your pussy up his shaft again. Hovering with just his tip kissing the entrance to your depths, you slam back down again, delighting in the raw moan of pleasure that is dragged from the cheetah's throat. 'Ah. Yeah... Fuck me. Show me who's boss. Make me your bitch,' you hear him muttering under his breath as he thrusts up to meet you. 'Have I been a good kitty, or a bad kitty? Will I get to share my cream with you or will I be left denied moments before release?' Jace asks, peering up at you pleadingly. You can't be sure which he would prefer as he seems excited by the prospect of both. You decide that you'll allow him to cum, but that he won't get to do it inside you. You tell him so, but add that it is on the condition of him promising to clean up his mess afterwards. 'Whatever pleases you,' he replies with adoration.";
				say "     You can feel Jace's tail whipping around behind you and it is only when he desperately pats you on the leg that you realize that it is a sign of his impending orgasm. Quickly shifting backwards, pulling his penis from your depths, you watch as his shaft throbs and shoots his load to splatter across his chest and face, the cheetah releasing a pleasured sigh with each clench of his loins and the accompanying rise and fall of his balls as another spurt joins the sticky mess matting his fur. The sight of his debasement causes you to climax too, there being something special about the way he looks up at you almost worshipfully as he covers himself in his own seed. As you quiver and shudder before him, Jace begins to purr, rubbing an unsullied ear against your arm as his climax begins to ebb. 'I wish my cum had been deep inside you, but it feels so good on me too,' he moans euphorically. 'Are you sure that I can't be yours?'";
				WaitLineBreak;
				say "     'Naughty kitty,' Lindsey barks as he enters the room, Shea and Elodie appearing a moment later, cum dripping from between their legs. 'Don't forget who the alpha is, bitch,' he growls at Jace, making the cheetah shrink away, unable to escape. 'I didn't knot either of these two today. I have better things to do than lie around being stuck, and I'm so glad that I did. It looks like you've impressed your bitch, but I think that I'll have to discipline him later,' the alpha wolftaur informs you. Eventually, your body calms down and you are able to take a more dignified position. 'I'm sorry alpha. I promise that I wasn't betraying you. It was just so good...' Jace pleads with Lindsey. 'Of course it was, but you still need to know your place. You can start by licking up your own mess and any that got on the floor,' the wolftaur grumbles, giving you a wink when the cheetah isn't looking. Jace meekly nods his acceptance.";
				say "     Lindsey turns to you. 'But for now, I think that I should escort you back to the zoo. I wouldn't want you attracting attention to my den and it'll give the bitches a chance to clean each other.' He gestures with an arm, brooking no argument as he follows you outside, his shaft still slowly retreating back into his sheath. 'Jace. That floor better be spotless by the time I get back or I'll hand you over to the giants. They're still looking for you.' Eyes wide, the cheetah gulps and nods his head. 'I'm glad that we have an understanding.' The walk back to the zoo is equally uneventful as the trip to the den, and soon you find yourself back at the gates. 'Well, I hope you appreciated that, but I should be getting back. I still have to punish the cheetah bitch for disrespecting my place as alpha. You're guiltless, I'm sure,' Lindsey snickers at his own words before turning away. 'Be sure to keep coming to see me. A bitch like you is hard to replace.'";
			now resolution of Lindsey's Harem is 2;
		else if calcnumber is 2: [ZEBRA]
			LineBreak;
			say "     Allowing your eyes to roam over the zebra, you tell Lindsey that you would like to spend some time with Elodie. 'Sure. With a body like hers, I'm not surprised that you want to pound her,' the wolftaur replies, eye banging the equine as he does so. 'While you fuck her, I'm gonna take Shea and Jace into the bedroom and remind them why I'm alpha. Perhaps when we come out, the cheetah will be a wolftaur.' With a firm swat to their backsides, your alpha herds his girlfriend and the cheetah up the stairs, following close behind them and leaving you and Elodie alone with each other. The zebra looks over your body appreciatively, though she lowers her gaze when she thinks that she is about to meet your eyes. 'You're really sexy, if you don't mind my forwardness. I'm looking forward to this. How may I please you? ' she asks, [if player is naked]enthusiastically running a hand over your exposed body[else]deftly slipping your clothes off you[end if]. Upon seeing your [if Player is male]cock, she stares at it hungrily, licking his lips and cupping your balls in her hand[else]cunt, reaches a hand forward and gently strokes the outer lips before bringing a finger to her mouth and sucking it while looking up at you[end if].";
			if Player is male:
				say "     'I can't wait for this to be inside me. You can fuck me as hard as you want, I've got plenty of padding,' Elodie croons, patting her ass to emphasize her point. 'But first, I want a quick taste. The smell is divine.' You thought that it was Shea who was meant to be the cock-whore. The zebra grasps your length in one hand then leans forward before running her broad tongue from base to tip. 'Oh yeah... Nearly as good as alpha's. Okay. I'm ready. Mount me and show me why you are top bitch,' Elodie pleads as she waits on all fours, her rump raised and her pussy winking. Given how aroused she seems to be, you don't argue, hunching over her and making a few light thrusts until you find your mark and push yourself past the puffy lips of her vulva. The way her thighs and buttocks ripple when you bottom out in her, and the cute gasp that accompanies this, spurs you on to pound in to her in the effort to get the best reaction from the zebra, adjusting angle or depth accordingly.";
				WaitLineBreak;
				say "     'Mmmm... Just like that. I want to feel just how strong a male you are. To know that I can take whatever is necessary of me as your bitch,' Elodie cries out, her hands slipping on the floor with each thrust. Between the satisfying cushioning of her ass, the tight embrace of her cunt, and her increasingly present intoxicating scent, you doubt that you'll be able to last long, especially as the needy way in which she urges you on inflames your lust. 'Just don't cum inside. The alpha hasn't given me permission for others to fill me with their hot... virile... copious loads.' You can tell that she is only half-denying you, the temptation still there in the way that she emphasizes the last few words. Nonetheless, it wouldn't be wise to betray Lindsey's trust, so you tell Elodie that you'll just have to cover her with it instead. 'Oh yeah. Make me smell like your cum. Maybe the alpha will have to mark me too,' she excitedly replies, one of her hands disappearing from view, to rub where your cock is entering her cunt.";
				say "     As the pitch of the zebra's moans increases, she meets your thrusts with growing desperation until finally she lets out a strangled groan and her pussy begins to rhythmically squeeze and release around your cock. Elodie struggles to plead with you to cum, her orgasm making speech difficult, and you feel your climax beginning to crest and hurriedly pull out of her just in time to send the first jet of essence soaring over her back to splatter between her shoulder-blades. Groaning under your breath, you reflexively thrust with each spurt of cum, giving the zebra vertical off-white stripes up her back and across the plump globes of her ass. Feeling your essence seeping into her thin fuzz of fur, Elodie writhes beneath you, moaning contentedly as she is bathed in your scent. 'Alpha is going to have to fuck me too if he wants to get your scent off me. Maybe you can compete for ownership,' she moans hopefully. 'Or maybe you can share.'";
				WaitLineBreak;
				say "     'Don't get ahead of yourself, bitch,' Lindsey barks as he enters the room, Shea and Jace appearing a moment later, cum dripping from between their legs. 'I expect this sort of brattiness from the kitty, but I expected better obedience from you,' he growls at Elodie, making the zebra look away shame-faced, caught in her insubordination. 'I didn't knot either of these two today. I have better things to do than lie around being stuck, and I'm so glad that I did. It looks like you've impressed your bitch, perhaps a little too much, but at least you remembered to pull out,' the alpha wolftaur informs you. 'I'm sorry alpha. I got caught up in the fantasy. It won't happen again,' Elodie pleads with Lindsey. 'Perhaps, perhaps not. But I'm sure I can find a suitable punishment if it does. Maybe I'll make you have a shower rather than letting you lick it up,' the wolftaur grumbles, Jace looking strangely disappointed at this suggestion. 'But it's the first time that this has happened, and I am a forgiving master, so I'll let the the three of you clean each other while I escort my top bitch back to the zoo.'";
				say "     Lindsey turns to you. 'Ready? I wouldn't want you attracting attention to my den and it'll give the bitches a chance to clean each other.' He gestures with an arm, brooking no argument as he follows you outside, his shaft still slowly retreating back into his sheath. 'Jace. Cleaning only. If you fuck anyone while I'm out, I'll hand you over to the giants. They're still looking for you.' Eyes wide, the cheetah gulps and nods his head. 'I'm glad that we have an understanding.' The walk back to the zoo is equally uneventful as the trip to the den, and soon you find yourself back at the gates. 'Well, I hope you appreciated that, but I should be getting back. I still have to punish the zebra bitch somehow for disrespecting my place as alpha. You're guiltless, I'm sure,' Lindsey snickers at his own words before turning away. 'Be sure to keep coming to see me. A bitch like you is hard to replace.'";
			else if Player is female:
				say "     'I haven't been with another woman in ages. Alpha won't let me and Shea fool around,' Elodie laments. 'It's a shame that you don't have a cock to fuck me as hard as you want, but eating you out sounds fun too.' You don't doubt her words, especially as she seems to be so eager to taste you. Spreading your legs, you direct her to start licking. 'Um. Please forgive me, but... would you mind sitting on my face instead? I kind of have a predator-prey kink, so vulnerability sort of gets me going,' the zebra interjects, pleadingly looking at you. As you nod, she hurriedly lies on her back and waits, gasping excitedly when your rump descends on her face and smothers her nose and mouth. When she doesn't struggle, instead licking your pussy eagerly, you assume that she can still breath and relax, focusing on the jolts of pleasure that the equine sends through you with each passage of her broad tongue against the sensitive walls of your cunt.";
				WaitLineBreak;
				say "     You wouldn't say that she is particularly skilled, but her enthusiasm more than makes up for it, hands playing across your rump, caressing, fingering, and squeezing, displaying her subservience and desire to please. 'I hope I'm doing this right. I was never sure if my friends were just being nice when we used to experiment,' Elodie says, her voice slightly muffled. You respond by wriggling your ass atop her and complimenting the fervor with which she is pleasuring you. At one point, she seems to try to stick her tongue as far into you as possible, making you clench your pussy at the unexpected sensation that courses through you, especially with how deep it seems to go. With enough time and patience, you're sure that she could get to be quite good at cunnilingus, though you're not sure how willing Lindsey will be to let Shea help her with this. The sensations from her tongue burying itself in to you, combined with those of her hands stroking your flanks arouses you more than you would expect, though perhaps it has been too long since you were with someone who was this eager yet inexperienced.";
				say "     Moved by this, you ask Elodie whether she would like you to lick her too, either at the same time or after she has brought you to orgasm, but, to your surprise, she pulls her face from beneath you and replies in the negative. 'I'm edging enough as it is. Trapped beneath a predator, my only way out is to satisfy her sexual hunger...,' she replies, a look of intense lust on her face. Interesting. You wonder whether Lindsey knows the extent to her kink or whether he hasn't explored that side of her. Such thoughts become more difficult to formulate as your climax creeps up on you, and become nearly impossible when Elodie thumbs your clit and shoves her tongue as far into you as she can. With lights dancing at the edge of your vision, you violently cum, shuddering and thrusting your hips while she keeps her tongue plunging in and out of you.";
				WaitLineBreak;
				say "     'My my. The two of you seem to be getting on well,' Lindsey comments as he walks through the door, watching intently while you twitch and quiver, Shea and Jace appearing a moment later, cum dripping from between their legs. 'I didn't knot either of these two today. I have better things to do than lie around being stuck, and I'm so glad that I did. I haven't seen this from this perspective before. I remember when Shea used to do that to me,' the alpha wolftaur informs you. Eventually, your body calms down and you are able to take a more dignified position. As you shift, you inadvertently brush against the zebra's pussy, the soft touch against the puffy lips triggering a very messy orgasm. Though it doesn't last very long, it leaves Elodie panting and a very fragrant stain on the floor. 'Ah. I don't think that I've ever cum like that, not even for alpha,' she mumbles without thinking, before her eyes shoot wide when she realizes what she just said in front of Lindsey. 'Is that so? Perhaps you don't need cock any more. If muff-munching is what really moistens your oyster,' he growls, relenting when she violently shakes her head and pleads forgiveness.";
				say "     Lindsey turns to you. 'I think that I should escort you back to the zoo. I wouldn't want you attracting attention to my den and it'll give the bitches a chance to clean each other and for the stripey bitch to think on why she should watch her mouth.' He gestures with an arm, brooking no argument as he follows you outside, his shaft still slowly retreating back into his sheath. 'Jace. If you do anything more than lick Shea or Elodie clean, I'll hand you over to the giants. They're still looking for you.' Eyes wide, the cheetah gulps and nods his head. 'I'm glad that we have an understanding.' The walk back to the zoo is equally uneventful as the trip to the den, and soon you find yourself back at the gates. 'Well, I hope you appreciated that, but I should be getting back. I need to remind Elodie why she should be more careful what she says to an apex predator,' Lindsey snickers before turning away. 'Be sure to keep coming to see me. A bitch like you is hard to replace.'";
			now resolution of Lindsey's Harem is 3;
		else: [Watch]
			LineBreak;
			say "     'Bit of a voyeur are you? Or perhaps a cuck? I don't give a shit. All the more pussy for me!' Lindsey laughs. 'Well, I guess I can fuck them right here. Usually do.' The wolftaur trots over to an open bit of floor before calling his miniature harem over. 'Shea, you're the best at it, so you can suck my cock while I decide which of the two bitches I fuck this time.' Lindsey's girlfriend looks hungrily at her master's bobbing shaft as she kneels down and shuffles beneath him. Cradling his balls in one hand, she immediately begins to slather the length with her tongue, letting out contented moans as she does so, her other hand playing with her breasts. 'Now... which of you is going to be the lucky one?' Lindsey muses, casting an eye over the cheetah and zebra. Honestly, you would have to say that the big male wolftaur will be the lucky one, no matter which of them he chooses.";
			say "     'I think that I'm in the mood for some prey, and Elodie's got a real juicy ass. Tough luck Jace, but I'll let you get her pussy ready for me. Nothing more than your mouth though. You have to earn the right to use your cock if you're staying here,' Lindsey growls, lightly thrusting into Shea's greedy mouth as she blows him. Elodie looks thrilled to have been chosen, the zebra grinning widely as she lies back on the couch and spreads her legs, her labia slightly stuck together with arousal. Jace's shoulders slump a little as he kneels down in front of her, his slim frame quite the contrast to her more generous proportions as he prepares to service her, shuddering slightly as he takes a breath of her heady scent. 'She doesn't look like she needs any preparation at all,' Lindsey barks with laughter, making the zebra blush and close her legs in embarrassment. 'It was a compliment bitch. Now spread [']em. Before you suffocate the cat with your thighs.'";
			WaitLineBreak;
			say "     Gasping at the realization of what she's done, Elodie quickly opens her legs again. You expected Jace to need to gulp in some air, but the feline only buries himself deeper in her snatch, quite effectively so given the way the zebra whinnies and grasps the cheetah by the back of his head. 'Well well. Looks like the kitty liked it. It's a shame that he won't be the one getting the cream today,' Lindsey chuckles, stepping forward and pulling his spit-soaked cock from his girlfriend's muzzle. 'She should be ready enough. Move over Jace.' When the cheetah doesn't respond, continuing to eat the zebra out, Lindsey grabs him by the shoulder and pushes him to the floor. 'I said move, bitch,' he snarls, stepping over Jace's prostrate form and mounting the woman, his front paws resting over the back of the couch. The feline has a close-up view as Elodie is speared by the wolftaur's thick cock, Lindsey's balls bumping his face as he sits up and scrabbles to get out of the way.";
			say "     'I'm gonna fill your belly with my pups,' Lindsey snarls in Elodie's ear as he pounds into her, grasping her by the jaw and pushing her against the back of the couch. 'Maybe you'll even turn into a wolftaur this time. Become a proper bitch for me.' The zebra can only moan and call for him to fuck her harder, her capability of conscious thought severely impeded. Jace begins to reach towards his erection, but Shea lightly grasps him by the wrist and shakes her head, replacing his hand with one of her own, though you get the impression that she would prefer something more involved than giving a handjob. Lindsey merely grins upon seeing this before he turns to you. 'Regretting not being a part of this yet? You could have been fucking one of the new bitches right now, but instead all Shea is giving the boy-bitch a handy and Elodie's being given the best fuck of her life. Perhaps it's better this way. You wouldn't have given her the same experience,' he growls possessively, punctuating each of the last few words with especially sharp thrusts into the zebra.";
			WaitLineBreak;
			say "     Elodie's mind seems to be gone at the moment, eyes rolled up and mouth hanging open as she is roughly bred. With each slap of Lindsey's knot into her labia, a wave of force rolls through her body, making her heavy breasts heave and causing her to let out an enthusiastic moan or grunt. Jace and Shea look on enviously, their own interaction seeming rather inadequate in comparison. Nonetheless, as they continue, you would assume that they still find a modicum of enjoyment in it. 'Are you ready for my cum?' Lindsey asks Elodie, grinning when she is only able to muster a desperate whine. She attempts to pull her vulva wider to make it easier for the wolftaur to knot her, her fingers slipping on the copious juices from their rutting. All eyes fall on the pair of them as Lindsey slams into her a few more times with a snarl until finally his knot batters its way into the embrace of her cunt.";
			say "     The zebra's delirious squeal is almost drowned out by Lindsey's roar as they both orgasm, both of them shuddering violently, and you watch the wolftaur's balls rise and fall as they pump her full of his seed. Behind them, Jace also climaxes, Shea's hands on his penis being helped along by the sight of Elodie being filled in front of him. The female wolftaur quickly cups her palm in front of his cock as it pulses, catching his semen, before she brings it to her mouth and laps it up, her eyes locked with his. The cheetah watches her drink it with a look of infatuation, his lips slightly parted. 'You're such a slut, Shea,' Lindsey teases her as he turns his upper body to observe them both. 'Don't get any ideas, pussy-bitch. I let her jack you off, but she's still mine' he growls at Jace. The cheetah nods reflexively, but he still sneaks a glance at the female wolftaur who winks at him when Lindsey turns away again.";
			WaitLineBreak;
			say "     Everyone is rather silent as they wait for Lindsey's knot to go down, the high from sex leaving them in a sort of stupor. Eventually, the alpha wolftaur's shaft softens enough for him to be able to pull it from the zebra's pussy. Surprisingly, Elodie manages to prevent the majority of his cum from gushing out, a few stray dribbles all that escapes her clenched cunt. 'Ah. There's nothing like a good fuck. You're definitely staying with me here, prey,' Lindsey informs her. 'And I think that Jace could have his uses once he learns to follow orders without hesitation.' The cheetah obediently lets his gaze fall to the floor. 'And you, my voyeuristic bitch, surprised me. I was sure you'd want to fuck someone, but I guess you couldn't give up the chance to see me in action. Next time perhaps you can get to know them, rather than hear about how good my cock is,' Lindsey jokes.";
			say "     'But for now, I think that I should escort you back to the zoo. I wouldn't want you attracting attention to my den and it'll give the bitches a chance to get to know each other.' He gestures with an arm, brooking no argument as he follows you outside, his shaft still slowly retreating back into his sheath. 'Jace. If you touch Shea while I'm out, I'll hand you over to the giants. They're still looking for you.' Eyes wide, the cheetah gulps and nods his head. 'I'm glad that we have an understanding.' The walk back to the zoo is equally uneventful as the trip to the den, and soon you find yourself back at the gates. 'Well, I hope you appreciated that, but I should be getting back. Shea may come on to Jace even with my threats to him. He's only human,' Lindsey snickers at his own words before turning away. 'Be sure to keep coming to see me. A bitch like you is hard to replace.'";
			now resolution of Lindsey's Harem is 4;
	else if BodyName of Player is "Wolftaur" and player is pure: [Player is a wolftaur but not Lindsey's Beta]
		say "     'Master. You have returned,' the cheetah says brightly, rubbing up against the wolftaur. 'You address me as alpha unless I tell you otherwise. Understand?' Lindsey replies tersely, firmly grasping him by the scruff of his neck. 'Yes alpha. Sorry alpha,' the feline apologizes, though you notice the tip of his cock slipping from his sheath. It would seem that he enjoys the wolftaur's assertiveness. Meanwhile, the zebra-woman eyes you intently before turning to Lindsey. 'Alpha, who is this?' she asks, dipping her head when Lindsey turns to her. '[SubjectProCap of Player] is bitch that likes my cock, but won't accept that [SubjectPro of Player] wants to belong to me more. That said, [SubjectPro of Player] still had the sense to become a wolftaur like me, so [SubjectPro of Player] isn't a lost cause yet. If you embarrass me in front of [ObjectPro of Player], you will be punished. Is that understood?' he explains, the question rhetorical. The female wolftaur looks at you with an expression of confusion, likely not understanding why you won't fully submit to the alpha.";
		WaitLineBreak;
		say "     'I'd tell them to introduce themselves to you, but I don't have time for that,' Lindsey says, turning back to you. 'The wolftaur is my former boyfriend, Shea. You may be my top bitch, but she's got history with me. The cheetah is Jace and the zebra is Elodie. They haven't had time to properly learn their place or to become wolftaurs, but it shouldn't take me long to fuck them into shape. Now, given that you are a wolftaur, I'm willing to give you another chance. Become my beta and I might let you fuck one of the new bitches. Refuse me again, and all you'll be doing is watching. So, what's it going to be? Beta or slut?'";
		say "     [bold type]Do you want to accept Lindsey's offer to become his Beta?[roman type][line break]";
		LineBreak;
		say "     ([link]Y[as]y[end link]) - Yes.";
		say "     ([link]N[as]n[end link]) - No.";
		if Player consents:
			LineBreak;
			say "     You give Lindsey a smile and press yourself up against his side, thanking him for giving you a second chance and saying that you are ready to be his beta. He returns your affection with a grin before replying, 'Good choice. You can have some pride in being below only me. It's where you belong and if the rest of the city don't like it, they can suck it. [if Player is male]Literally, in your case[else]Or at least suck mine[end if]. Once I mark you as mine, if anyone tries to take you from me I'll hunt them down and make them into my bitch too. I'm not stupid enough to think that everyone in the world will be mine, but I don't have a problem beating the shit out of anyone who crosses me or those that I claim as mine. And now that you're my beta, you can count on me to back you up, just as I expect you to do the same for me. We're bonded now and only death will break that.' That was a lot more serious and soul-bearing than you are used to hearing from Lindsey, but you feel that you made the right decision in trusting yourself to Lindsey.";
			say "     'Now hold still and I'll leave a more visible mark for those too stupid to smell my scent all over you.' Lindsey's hands firmly grasp you by the shoulders and gently pull your head to the side to expose your neck. 'This feels like one of those trashy vampire books, but this way no-one will be able to say they didn't see you were claimed,' the wolftaur growls before closing his jaws around the side of your neck. You can feel your pulse racing, the realization that should he want to, Lindsey could likely end your life here and now, [if Player is submissive]sending shiver throughout your body at being reminded of your place in society, to be below those of such determination and willpower, to be protected and to submit yourself to them in turn[else if player is dominant]making you feel simultaneously disgusted and exhilarated as you reconcile this show of submission with your usual determination to be in control[else]causing a mixture of feelings to surface within you. Fear. Relief. Happiness. And strangely, safety[end if]. You feel your skin break as his fangs press through, remaining for a few short moments and allowing a trickle of blood to run across your throat before the grip on your flesh is released and you allow your head to slump forward, almost panting from the rush of emotion and adrenaline.";
			WaitLineBreak;
			say "     'There. Now you are mine for all to see,' Lindsey rumbles in your ear. 'I'd offer you a mirror to admire my mark, but trust me when I tell you that I claimed you long before this and that the scar was to show others that you are mine. But for now, I think that you should familiarize yourself with my pack. I'll be the one breeding Shea today, you haven't yet earned that privilege' he says, glancing lustfully at his former boyfriend. The female wolftaur looks at him eagerly, wagging her tail and playing with her breasts while huffing needily. 'But feel free to get it on with one of the new bitches. Properly establish your place over them. Otherwise you can just watch me fuck someone. I ain't got a problem with that. Think of the choice as my welcome gift to you.' Lindsey looks at you expectantly, waiting for your answer, the cheetah and the zebra looking toward you too.";
			say "     [bold type]Do you want to have a have sex with Jace, Elodie, or just watch?[roman type][line break]";
			LineBreak;
			say "     ([link](1)[as]1[end link]) - Jace.";
			say "     ([link](2)[as]2[end link]) - Elodie.";
			say "     ([link](3)[as]3[end link]) - Just Watch.";
			now calcnumber is 0;
			while calcnumber < 1 or calcnumber > 3:
				say "Choice? (1-3)>[run paragraph on]";
				get a number;
				if calcnumber is 1 or calcnumber is 2 or calcnumber is 3:
					break;
				else:
					say "Invalid choice. Type [link]1[end link] for Jace, [link]2[end link] for Elodie, or [link]3[end link] for Watch.";
			if calcnumber is 1: [CHEETAH]
				say "     Allowing your eyes to roam over the cheetah, you tell Lindsey that you would like to spend some time with Jace. 'Sure, but don't let him be the one fucking you. He's got to earn it,' the wolftaur replies, fixing the feline with a stern look. 'While you fuck him, I'm gonna take Shea and Elodie into the bedroom and remind them why I'm alpha. Perhaps when we come out, the zebra will be a wolftaur.' With a firm swat to their backsides, your alpha herds his girlfriend and the zebra up the stairs, following close behind them and leaving you and Jace alone with each other. Jace looks down at his feet shyly, occasionally sneaking a quick glance up at you. 'Sorry. I should be doing better than this. How may I please you?' he asks, [if player is naked]tenderly tracing a hand over your exposed body[else]gently slipping your clothes off you[end if]. Upon seeing your [if Player is male]cock, he stares for a moment, unconsciously licking his lips before, unable to help himself, he crouches down beneath you, rubbing it all over his face and staining his fur with your pre[else]cunt, he reaches a hand forward, nearly touching your damp lips before he snatches it back again. He eyes it lustfully, licking his lips[end if].";
				if Player is male:
					say "     'You smell good. Really good,' Jace moans, purring as he continues to nuzzle against your penis and getting your scent all over his face. As he does so, his own shaft slips out of his sheath, the softly-barbed head bobbing as he moves. Eventually, he reluctantly crawls back before turning around and lifting his tail. 'I could do that all day, but the alpha expects you to fuck me and I don't want to disappoint. Mount me and show me why you are his top bitch. Don't worry about lube, I've had quite a bit of experience, and whatever it is that changed me seems to have made me stretchier and wetter.' Given how needy he seems to be, you don't argue, stepping over him and making a few light thrusts until you find your mark and push yourself past the accommodating ring of his sphincter. The cheetah seems to have a good understanding of what his body can take, as her is able to take a sizable portion of your cock without any difficulty, excited yowls and moans suggesting that he is enjoying this immensely.";
					WaitLineBreak;
					say "     'Ah. Yeah... Fuck me. Show me who's boss. Make me your bitch,' you hear him muttering under his breath as he pushes his ass back to meet your thrusts, his hands firmly braced against your front legs. Despite how easily he seems to have taken you, his back passage squeezes around your length each time you bury it in him, clinging to you as you try to withdraw but welcoming you when you thrust back in. 'Have I been a good kitty, or a bad kitty? Will I get a creamy reward or be left denied moments before release?' Jace asks, peering up at you pleadingly. You can't be sure which he would prefer as he seems excited by the prospect of both. That said, he seems to be being well-behaved so far, and the muscle control that he is exhibiting with his ass as you pound into him certainly impresses you, so you tell him that he can look forward to a creamy reward, as long as he promises to clean up any spillage. 'I look forward to it, sir,' he replies with adoration.";
					say "     You can feel Jace's tail whipping around beneath you and it is only when you feel his bowels rhythmically squeezing around your cock that you realize that it was a sign of his impending orgasm. You hear the splash each time his cum splatters on the floor, the cheetah releasing a pleasured sigh with each clench of his ass and the accompanying rise and fall of his balls as another spurt is wasted on the floor. Ultimately, this leads to you climaxing too, the combined physical and auditory sensations sending you over the edge as you ram your knot past the ring of his tail holes and into the scorching grip within, causing him to squeak. As Jace feels your cum fill him up, he begins to purr, rubbing his head against your lower body's chest even as his own climax is stimulated into being prolonged. 'I can feel your yummy cum filling my ass,' he moans euphorically. 'I can't wait to lick it up and taste just how strong you are.'";
					WaitLineBreak;
					say "     'Is that so?' Lindsey barks as he enters the room, Shea and Elodie appearing a moment later, cum dripping from between their legs. 'Don't forget who the alpha is, bitch,' he growls at Jace, making the cheetah shrink away, unable to escape. 'I didn't knot either of these two today. I have better things to do than lie around being stuck, and I'm so glad that I did. It looks like you've impressed your bitch, but I think that I'll have to discipline him later,' the alpha wolftaur informs you. Eventually, your shaft softens enough for you to be able to pull it from Jace's ass. Surprisingly, or not, the cheetah manages to clench his anus to prevent the majority of your cum from gushing out, a few stray dribbles all that escapes his tail-hole. 'I didn't realize just how pent up I was. You are going to let him stay, aren't you?' Jace pleads with Lindsey. 'Of course. You on the other hand still need to know your place. You can start by licking up that mess on the floor,' the wolftaur grumbles, indicating the pool of the feline's cum. Jace meekly nods his acceptance.";
					say "     Lindsey turns to you. 'But for now, I think that I should escort you back to the zoo. I wouldn't want you attracting attention to my den and it'll give the bitches a chance to clean each other.' He gestures with an arm, brooking no argument as he follows you outside, his shaft still slowly retreating back into his sheath. 'Jace. That floor better be spotless by the time I get back or I'll hand you over to the giants. They're still looking for you.' Eyes wide, the cheetah gulps and nods his head. 'I'm glad that we have an understanding.' The walk back to the zoo is equally uneventful as the trip to the den, and soon you find yourself back at the gates. 'Well, I hope you appreciated that, but I should be getting back. I still have to punish the cheetah bitch for disrespecting my place as alpha. You're guiltless, I'm sure,' Lindsey snickers at his own words before turning away. 'Be sure to keep coming to see me. A bitch like you is hard to replace.'";
				else if Player is female:
					say "     'Would you mind if I...' Jace asks, gesturing towards your pussy, saliva collecting behind his lips before he swallows. With a smirk, you direct him to lie on the floor, an order which he quickly complies with. No sooner has he done this, then you sit on his face, forcing the only-too-willing cheetah to get a taste of your snatch. As his eager licking spreads your juices and your scent across his face, you gaze down at his emerging shaft, its head covered in soft-looking barbs. Despite his enthusiasm, you quickly tire of this with the prospect of something more substantial than his tongue to penetrate the depths of your cunt, and you drag your hind-quarters down his body, leaving a thin trail of your arousal over his chest and tummy. Having reached your objective, you turn around to meet his eyes, lift your rump, then plunge it down on his rampant erection. 'Show me why you are his top bitch,' Jace half suggests, half begs, looking up at you from his vulnerable position.";
					WaitLineBreak;
					say "     Seeing no reason not to permit his request, you place one paw on his chest to reinforce that you are in control, before slowly lifting your pussy up his shaft again. Hovering with just his tip kissing the entrance to your depths, you slam back down again, delighting in the raw moan of pleasure that is dragged from the cheetah's throat. 'Ah. Yeah... Fuck me. Show me who's boss. Make me your bitch,' you hear him muttering under his breath as he thrusts up to meet you. 'Have I been a good kitty, or a bad kitty? Will I get to share my cream with you or will I be left denied moments before release?' Jace asks, peering up at you pleadingly. You can't be sure which he would prefer as he seems excited by the prospect of both. You decide that you'll allow him to cum, but that he won't get to do it inside you. You tell him so, but add that it is on the condition of him promising to clean up his mess afterwards. 'Whatever pleases you,' he replies with adoration.";
					say "     You can feel Jace's tail whipping around beneath you and it is only when he desperately pats you on the leg that you realize that it is a sign of his impending orgasm. Quickly shifting backwards, pulling his penis from your depths, you watch as his shaft throbs and shoots his load to splatter across his chest and face, the cheetah releasing a pleasured sigh with each clench of his loins and the accompanying rise and fall of his balls as another spurt joins the sticky mess matting his fur. The sight of his debasement causes you to climax too, there being something special about the way he looks up at you almost worshipfully as he covers himself in his own seed. As you quiver and shudder before him, Jace begins to purr, rubbing an unsullied ear against one of your front paws as his climax begins to ebb. 'I wish my cum had been deep inside you, but it feels so good on me too,' he moans euphorically. 'Are you sure that I can't be yours?'";
					WaitLineBreak;
					say "     'Naughty kitty,' Lindsey barks as he enters the room, Shea and Elodie appear a moment later, cum dripping from between their legs. 'Don't forget who the alpha is, bitch,' he growls at Jace, making the cheetah shrink away, unable to escape. 'I didn't knot either of these two today. I have better things to do than lie around being stuck, and I'm so glad that I did. It looks like you've impressed your bitch, but I think that I'll have to discipline him later,' the alpha wolftaur informs you. Eventually, your body calms down and you are able to take a more dignified position. 'I'm sorry alpha. I promise that I wasn't betraying you. It was just so good...' Jace pleads with Lindsey. 'Of course it was, but you still need to know your place. You can start by licking up your own mess and any that got on the floor,' the wolftaur grumbles, giving you a wink when the cheetah isn't looking. Jace meekly nods his acceptance.";
					say "     Lindsey turns to you. 'But for now, I think that I should escort you back to the zoo. I wouldn't want you attracting attention to my den and it'll give the bitches a chance to clean each other.' He gestures with an arm, brooking no argument as he follows you outside, his shaft still slowly retreating back into his sheath. 'Jace. That floor better be spotless by the time I get back or I'll hand you over to the giants. They're still looking for you.' Eyes wide, the cheetah gulps and nods his head. 'I'm glad that we have an understanding.' The walk back to the zoo is equally uneventful as the trip to the den, and soon you find yourself back at the gates. 'Well, I hope you appreciated that, but I should be getting back. I still have to punish the cheetah bitch for disrespecting my place as alpha. You're guiltless, I'm sure,' Lindsey snickers at his own words before turning away. 'Be sure to keep coming to see me. A bitch like you is hard to replace.'";
				now resolution of Lindsey's Harem is 2;
			else if calcnumber is 2: [ZEBRA]
				LineBreak;
				say "     Allowing your eyes to roam over the zebra, you tell Lindsey that you would like to spend some time with Elodie. 'Sure. With a body like hers, I'm not surprised that you want to pound her,' the wolftaur replies, eye banging the equine as he does so. 'While you fuck her, I'm gonna take Shea and Jace into the bedroom and remind them why I'm alpha. Perhaps when we come out, the cheetah will be a wolftaur.' With a firm swat to their backsides, your alpha herds his girlfriend and the cheetah up the stairs, following close behind them and leaving you and Elodie alone with each other. Elodie looks over your body appreciatively, thye she lowers her gaze when she thinks that she is about to meet your eyes. 'You're really sexy, if you don't mind my forwardness. I'm looking forward to this. How may I please you? ' she asks, [if player is naked]enthusiastically running a hand over your exposed body[else]deftly slipping your clothes off you[end if]. Upon seeing your [if Player is male]cock, she stares at it hungrily, licking his lips and cupping your balls in her hand[else]cunt, reaches a hand forward and gently strokes the outer lips before bringing a finger to her mouth and sucking it while looking up at you[end if].";
				if Player is male:
					say "     'I can't wait for this to be inside me. You can fuck me as hard as you want, I've got plenty of padding,' Elodie croons, patting her ass to emphasize her point. 'But first, I want a quick taste. The smell is divine.' You thought that it was Shea who was meant to be the cock-whore. The zebra grasps your length in one hand then leans forward before running her broad tongue from base to tip. 'Oh yeah... Nearly as good as alpha's. Okay. I'm ready. Mount me and show me why you are top bitch,' Elodie pleads as she waits on all fours, her rump raised and her pussy winking. Given how aroused she seems to be, you don't argue, stepping over her and making a few light thrusts until you find your mark and push yourself past the puffy lips of her vulva. The way her thighs and buttocks ripple when you bottom out in her, and the cute gasp that accompanies this, spurs you on to pound in to her in the effort to get the best reaction from the zebra, adjusting angle or depth accordingly.";
					WaitLineBreak;
					say "     'Mmmm... Just like that. I want to feel just how strong a male you are. To know that I can take whatever is necessary of me as your bitch,' Elodie cries out, her hands slipping on the floor with each thrust. Between the satisfying cushioning of her ass, the tight embrace of her cunt, and her increasingly present intoxicating scent, you doubt that you'll be able to last long, especially as the needy way in which she urges you on inflames your lust. 'Just don't cum inside. The alpha hasn't given me permission for others to fill me with their hot... virile... copious loads.' You can tell that she is only half-denying you, the temptation still there in the way that she emphasizes the last few words. Nonetheless, it wouldn't be wise to betray Lindsey's trust, so you tell Elodie that you'll just have to cover her with it instead. 'Oh yeah. Make me smell like your cum. Maybe the alpha will have to mark me too,' she excitedly replies, one of her hands disappearing from view, to rub where your cock is entering her cunt.";
					say "     As the pitch of the zebra's moans increases, she meets your thrusts with growing desperation until finally she lets out a strangled groan and her pussy begins to rhythmically squeeze and release around your cock. Elodie struggles to plead with you to cum, her orgasm making speech difficult, and you feel your climax beginning to crest and hurriedly pull out of her just in time to send the first jet of essence soaring over her back to splatter between her shoulder-blades. Growling under your breath, you reflexively thrust with each spurt of cum, giving the zebra vertical off-white stripes up her back and across the plump globes of her ass. Feeling your essence seeping into her thin fuzz of fur, Elodie writhes beneath you, moaning contentedly as she is bathed in your scent. 'Alpha is going to have to fuck me too if he wants to get your scent off me. Maybe you can compete for ownership,' she moans hopefully. 'Or maybe you can share.'";
					WaitLineBreak;
					say "     'Don't get ahead of yourself, bitch,' Lindsey barks as he enters the room, Shea and Jace appearing a moment later, cum dripping from between their legs. 'I expect this sort of brattiness from the kitty, but I expected better obedience from you,' he growls at Elodie, making the zebra look away shame-faced, caught in her insubordination. 'I didn't knot either of these two today. I have better things to do than lie around being stuck, and I'm so glad that I did. It looks like you've impressed your bitch, perhaps a little too much, but at least you remembered to pull out,' the alpha wolftaur informs you. 'I'm sorry alpha. I got caught up in the fantasy. It won't happen again,' Elodie pleads with Lindsey. 'Perhaps, perhaps not. But I'm sure I can find a suitable punishment if it does. Maybe I'll make you have a shower rather than letting you lick it up,' the wolftaur grumbles, Jace looking disappointed at this. 'But it's the first time that this has happened, and I am a forgiving master, so I'll let the the three of you clean each other while I escort my top bitch back to the zoo.'";
					say "     Lindsey turns to you. 'Ready? I wouldn't want you attracting attention to my den and it'll give the bitches a chance to clean each other.' He gestures with an arm, brooking no argument as he follows you outside, his shaft still slowly retreating back into his sheath. 'Jace. Cleaning only. If you fuck anyone while I'm out, I'll hand you over to the giants. They're still looking for you.' Eyes wide, the cheetah gulps and nods his head. 'I'm glad that we have an understanding.' The walk back to the zoo is equally uneventful as the trip to the den, and soon you find yourself back at the gates. 'Well, I hope you appreciated that, but I should be getting back. I still have to punish the zebra bitch somehow for disrespecting my place as alpha. You're guiltless, I'm sure,' Lindsey snickers at his own words before turning away. 'Be sure to keep coming to see me. A bitch like you is hard to replace.'";
				else if Player is female:
					say "     'I haven't been with another woman in ages. Alpha won't let me and Shea fool around,' Elodie laments. 'It's a shame that you don't have a cock to fuck me as hard as you want, but eating you out sounds fun too.' You don't doubt her words, especially as she seems to be so eager to taste you. Spreading your hind-legs a bit, you direct her to start licking. 'Um. Please forgive me, but... would you mind sitting on my face instead? I kind of have a predator-prey kink, so vulnerability sort of gets me going,' the zebra interjects, pleadingly looking at you. As you nod, she hurriedly lies on her back and waits, gasping excitedly when your rump descends on her face and smothers her nose and mouth. When she doesn't struggle, instead licking your pussy eagerly, you assume that she can still breath and relax, focusing on the jolts of pleasure that the equine sends through you with each passage of her broad tongue against the sensitive walls of your cunt.";
					WaitLineBreak;
					say "     You wouldn't say that she is particularly skilled, but her enthusiasm more than makes up for it, hands playing across your rump, caressing, fingering, and squeezing, displaying her subservience and desire to please. 'I hope I'm doing this right. I was never sure if my friends were just being nice when we used to experiment,' Elodie says, her voice slightly muffled. You respond by wriggling your ass atop her and complimenting the fervor with which she is pleasuring you. At one point, she seems to try to stick her tongue as far into you as possible, making you clench your pussy at the unexpected sensation that courses through you, especially with how deep it seems to go. With enough time and patience, you're sure that she could get to be quite good at cunnilingus, though you're not sure how willing Lindsey will be to let Shea help her with this. The sensations from her tongue burying itself in to you, combined with those of her hands stroking your flanks arouses you more than you would expect, though perhaps it has been too long since you were with someone who was this eager yet inexperienced.";
					say "     Moved by this, you ask Elodie whether she would like you to lick her too, either at the same time or after she has brought you to orgasm, but, to your surprise, she pulls her face from beneath you and replies in the negative. 'I'm edging enough as it is. Trapped beneath a predator, my only way out is to satisfy her sexual hunger...,' she replies, a look of intense lust on her face. Interesting. You wonder whether Lindsey knows the extent to her kink or whether he hasn't explored that side of her. Such thoughts become more difficult to formulate as your climax creeps up on you, and become nearly impossible when Elodie pulls the base of your tail and shoves her tongue as far into you as she can. With lights dancing at the edge of your vision, you violently cum, shuddering and thrusting your hips while she keeps her tongue plunging in and out of you.";
					WaitLineBreak;
					say "     'My my. The two of you seem to be getting on well,' Lindsey comments as he walks through the door, watching intently while you twitch and quiver, Shea and Jace appearing a moment later, cum dripping from between their legs. 'I didn't knot either of these two today. I have better things to do than lie around being stuck, and I'm so glad that I did. I haven't seen this from this perspective before. I remember when Shea used to do that to me,' the alpha wolftaur informs you. Eventually, your body calms down and you are able to take a more dignified position. As you shift, you inadvertently brush against the zebra's pussy, the soft touch against the puffy lips triggering a very messy orgasm. Though it doesn't last very long, it leaves Elodie panting and a very fragrant stain on the floor. 'Ah. I don't think that I've ever cum like that, not even for alpha,' she mumbles without thinking, before her eyes shoot wide when she realizes what she just said in front of Lindsey. 'Is that so? Perhaps you don't need cock any more. If muff-munching is what really moistens your oyster,' he growls, relenting when she violently shakes her head and pleads forgiveness.";
					say "     Lindsey turns to you. 'I think that I should escort you back to the zoo. I wouldn't want you attracting attention to my den and it'll give the bitches a chance to clean each other and for the stripey bitch to think on why she should watch her mouth.' He gestures with an arm, brooking no argument as he follows you outside, his shaft still slowly retreating back into his sheath. 'Jace. If you do anything more than lick Shea or Elodie clean, I'll hand you over to the giants. They're still looking for you.' Eyes wide, the cheetah gulps and nods his head. 'I'm glad that we have an understanding.' The walk back to the zoo is equally uneventful as the trip to the den, and soon you find yourself back at the gates. 'Well, I hope you appreciated that, but I should be getting back. I need to remind Elodie why she should be more careful what she says to an apex predator,' Lindsey snickers before turning away. 'Be sure to keep coming to see me. A bitch like you is hard to replace.'";
			else: [Watch]
				LineBreak;
				say "     'Bit of a voyeur are you? Or perhaps a cuck? I don't give a shit. All the more pussy for me!' Lindsey laughs. 'Well, I guess I can fuck them right here. Usually do.' The wolftaur trots over to an open bit of floor before calling his miniature harem over. 'Shea, you're the best at it, so you can suck my cock while I decide which of the two bitches I fuck this time.' Lindsey's girlfriend looks hungrily at her master's bobbing shaft as she kneels down and shuffles beneath him. Cradling his balls in one hand, she immediately begins to slather the length with her tongue, letting out contented moans as she does so, her other hand playing with her breasts. 'Now... which of you is going to be the lucky one?' Lindsey muses, casting an eye over the cheetah and zebra. Honestly, you would have to say that the big male wolftaur will be the lucky one, no matter which of them he chooses.";
				say "     'I think that I'm in the mood for some prey, and Elodie's got a real juicy ass. Tough luck Jace, but I'll let you get her pussy ready for me. Just use your mouth and fingers though. You have to earn the right to use your cock if you're staying here,' Lindsey growls, lightly thrusting into Shea's greedy mouth as she blows him. Elodie looks thrilled to have been chosen, the zebra grinning widely as she lies back on the couch and spreads her legs, her labia slightly stuck together with arousal. Jace's shoulders slump a little as he kneels down in front of her, his slim frame quite the contrast to her more generous proportions as he prepares to service her, shuddering slightly as he takes a breath of her heady scent. 'She doesn't look like she needs any preparation at all,' Lindsey barks with laughter, making the zebra blush and close her legs in embarrassment. 'It was a compliment bitch. Now spread [']em. Before you suffocate the cat with your thighs.'";
				WaitLineBreak;
				say "     Gasping at the realization of what she's done, Elodie quickly opens her legs again. You expected Jace to need to gulp in some air, but the feline only buries himself deeper in her snatch, quite effectively so given the way the zebra whinnies and grasps the cheetah by the back of his head. 'Well well. Looks like the kitty liked it. It's a shame that he won't be the one getting the cream today,' Lindsey chuckles, stepping forward and pulling his spit-soaked cock from his girlfriend's muzzle. 'She should be ready enough. Move over Jace.' When the cheetah doesn't respond, continuing to eat the zebra out, Lindsey grabs him by the shoulder and pushes him to the floor. 'I said move, bitch,' he snarls, stepping over Jace's prostrate form and mounting the woman, his front paws resting over the back of the couch. The feline has a close-up view as Elodie is speared by the wolftaur's thick cock, Lindsey's balls bumping his face as he sits up and scrabbles to get out of the way.";
				say "     'I'm gonna fill your belly with my pups,' Lindsey snarls in Elodie's ear as he pounds into her, grasping her by the jaw and pushing her against the back of the couch. 'Maybe you'll even turn into a wolftaur this time. Become a proper bitch for me.' The zebra can only moan and call for him to fuck her harder, her capability of conscious thought severely impeded. Jace begins to reach towards his erection, but Shea lightly grasps him by the wrist and shakes her head, replacing his hand with one of her own, though you get the impression that she would prefer something more involved than giving a handjob. Lindsey merely grins upon seeing this before he turns to you. 'Regretting not being a part of this yet? You could have been fucking Shea right now, but instead all she gets to do is give a boy-bitch a handy. She must be so frustrated. But she won't do more. Not without my permission,' he growls possessively, punctuating each of the last few words with especially sharp thrusts into the zebra.";
				WaitLineBreak;
				say "     Elodie's mind seems to be gone at the moment, eyes rolled up and mouth hanging open as she is roughly bred. With each slap of Lindsey's knot into her labia, a wave of force rolls through her body, making her heavy breasts heave and causing her to let out an enthusiastic moan or grunt. Jace and Shea look on enviously, their own interaction seeming rather inadequate in comparison. Nonetheless, as they continue, you would assume that they still find a modicum of enjoyment in it. 'Are you ready for my cum?' Lindsey asks Elodie, grinning when she is only able to muster a desperate whine. She attempts to pull her vulva wider to make it easier for the wolftaur to knot her, her fingers slipping on the copious juices from their rutting. All eyes fall on the pair of them as Lindsey slams into her a few more times with a snarl until finally his knot batters its way into the embrace of her cunt.";
				say "     The zebra's delirious squeal is almost drowned out by Lindsey's roar as they both orgasm, both of them shuddering violently, and you watch the wolftaur's balls rise and fall as they pump her full of his seed. Behind them, Jace also climaxes, Shea's hands on his penis being helped along by the sight of Elodie being filled in front of him. The female wolftaur quickly cups her palm in front of his cock as it pulses, catching his semen, before she brings it to her mouth and laps it up, her eyes locked with his. The cheetah watches her drink it with a look of infatuation, his lips slightly parted. 'You're such a slut, Shea,' Lindsey teases her as he turns his upper body to observe them both. 'Don't get any ideas, pussy-bitch. I let her jack you off, but she's still mine' he growls at Jace. The cheetah nods reflexively, but he still sneaks a glance at the female wolftaur who winks at him when Lindsey turns away again.";
				WaitLineBreak;
				say "     Everyone is rather silent as they wait for Lindsey's knot to go down, the high from sex leaving them in a sort of stupor. Eventually, the alpha wolftaur's shaft softens enough for him to be able to pull it from the zebra's pussy. Surprisingly, Elodie manages to prevent the majority of his cum from gushing out, a few stray dribbles all that escapes her clenched cunt. 'Ah. There's nothing like a good fuck. You're definitely staying with me here, prey,' Lindsey informs her. 'And I think that Jace could have his uses once he learns to follow orders without hesitation.' The cheetah obediently lets his gaze fall to the floor. 'And you, my voyeuristic beta, surprised me. I was sure you'd want to fuck someone, but I guess you couldn't give up the chance to see me in action. Next time perhaps you can get to know them, rather than hear about how good my cock is,' Lindsey jokes.";
				say "     'But for now, I think that I should escort you back to the zoo. I wouldn't want you attracting attention to my den and it'll give the bitches a chance to get to know each other.' He gestures with an arm, brooking no argument as he follows you outside, his shaft still slowly retreating back into his sheath. 'Jace. If you touch Shea while I'm out, I'll hand you over to the giants. They're still looking for you.' Eyes wide, the cheetah gulps and nods his head. 'I'm glad that we have an understanding.' The walk back to the zoo is equally uneventful as the trip to the den, and soon you find yourself back at the gates. 'Well, I hope you appreciated that, but I should be getting back. Shea may come on to Jace even with my threats to him. He's only human,' Lindsey snickers at his own words before turning away. 'Be sure to keep coming to see me. A bitch like you is hard to replace.'";
				now resolution of Lindsey's Harem is 4;
			now hp of Lindsey is 2;
		else:
			LineBreak;
			say "     'You're really beginning to piss me off, but perhaps you're a cuck? I shouldn't judge. All the more pussy for me!' Lindsey laughs. 'Well, I guess I can fuck them right here. Usually do.' The wolftaur trots over to an open bit of floor before calling his miniature harem over. 'Shea, you're the best at it, so you can suck my cock while I decide which of the two bitches I fuck this time.' Lindsey's girlfriend looks hungrily at her master's bobbing shaft as she kneels down and shuffles beneath him. Cradling his balls in one hand, she immediately begins to slather the length with her tongue, letting out contented moans as she does so, her other hand playing with her breasts. 'Now... which of you is going to be the lucky one?' Lindsey muses, casting an eye over the cheetah and zebra. Honestly, you would have to say that the big male wolftaur will be the lucky one, no matter which of them he chooses.";
			say "     'I think that I'm in the mood for some prey, and Elodie's got a real juicy ass. Tough luck Jace, but I'll let you get her pussy ready for me. Nothing more than your mouth though. You have to earn the right to use your cock if you're staying here,' Lindsey growls, lightly thrusting into Shea's greedy mouth as she blows him. Elodie looks thrilled to have been chosen, the zebra grinning widely as she lies back on the couch and spreads her legs, her labia slightly stuck together with arousal. Jace's shoulders slump a little as he kneels down in front of her, his slim frame quite the contrast to her more generous proportions as he prepares to service her, shuddering slightly as he takes a breath of her heady scent. 'She doesn't look like she needs any preparation at all,' Lindsey barks with laughter, making the zebra blush and close her legs in embarrassment. 'It was a compliment bitch. Now spread [']em. Before you suffocate the cat with your thighs.'";
			WaitLineBreak;
			say "     Gasping at the realization of what she's done, Elodie quickly opens her legs again. You expected Jace to need to gulp in some air, but the feline only buries himself deeper in her snatch, quite effectively so given the way the zebra whinnies and grasps the cheetah by the back of his head. 'Well well. Looks like the kitty liked it. It's a shame that he won't be the one getting the cream today,' Lindsey chuckles, stepping forward and pulling his spit-soaked cock from his girlfriend's muzzle. 'She should be ready enough. Move over Jace.' When the cheetah doesn't respond, continuing to eat the zebra out, Lindsey grabs him by the shoulder and pushes him to the floor. 'I said move, bitch,' he snarls, stepping over Jace's prostrate form and mounting the woman, his front paws resting over the back of the couch. The feline has a close-up view as Elodie is speared by the wolftaur's thick cock, Lindsey's balls bumping his face as he sits up and scrabbles to get out of the way.";
			say "     'I'm gonna fill your belly with my pups,' Lindsey snarls in Elodie's ear as he pounds into her, grasping her by the jaw and pushing her against the back of the couch. 'Maybe you'll even turn into a wolftaur this time. Become a proper bitch for me.' The zebra can only moan and call for him to fuck her harder, her capability of conscious thought severely impeded. Jace begins to reach towards his erection, but Shea lightly grasps him by the wrist and shakes her head, replacing his hand with one of her own, though you get the impression that she would prefer something more involved than giving a handjob. Lindsey merely grins upon seeing this before he turns to you. 'Regretting not being a part of this yet? You could have been fucking one of the new bitches right now, but instead all Shea is giving the boy-bitch a handy and Elodie's being given the best fuck of her life. Perhaps it's better this way. You wouldn't have given her the same experience,' he growls possessively, punctuating each of the last few words with especially sharp thrusts into the zebra.";
			WaitLineBreak;
			say "     Elodie's mind seems to be gone at the moment, eyes rolled up and mouth hanging open as she is roughly bred. With each slap of Lindsey's knot into her labia, a wave of force rolls through her body, making her heavy breasts heave and causing her to let out an enthusiastic moan or grunt. Jace and Shea look on enviously, their own interaction seeming rather inadequate in comparison. Nonetheless, as they continue, you would assume that they still find a modicum of enjoyment in it. 'Are you ready for my cum?' Lindsey asks Elodie, grinning when she is only able to muster a desperate whine. She attempts to pull her vulva wider to make it easier for the wolftaur to knot her, her fingers slipping on the copious juices from their rutting. All eyes fall on the pair of them as Lindsey slams into her a few more times with a snarl until finally his knot batters its way into the embrace of her cunt.";
			say "     The zebra's delirious squeal is almost drowned out by Lindsey's roar as they both orgasm, both of them shuddering violently, and you watch the wolftaur's balls rise and fall as they pump her full of his seed. Behind them, Jace also climaxes, Shea's hands on his penis being helped along by the sight of Elodie being filled in front of him. The female wolftaur quickly cups her palm in front of his cock as it pulses, catching his semen, before she brings it to her mouth and laps it up, her eyes locked with his. The cheetah watches her drink it with a look of infatuation, his lips slightly parted. 'You're such a slut, Shea,' Lindsey teases her as he turns his upper body to observe them both. 'Don't get any ideas, pussy-bitch. I let her jack you off, but she's still mine' he growls at Jace. The cheetah nods reflexively, but he still sneaks a glance at the female wolftaur who winks at him when Lindsey turns away again.";
			WaitLineBreak;
			say "     Everyone is rather silent as they wait for Lindsey's knot to go down, the high from sex leaving them in a sort of stupor. Eventually, the alpha wolftaur's shaft softens enough for him to be able to pull it from the zebra's pussy. Surprisingly, Elodie manages to prevent the majority of his cum from gushing out, a few stray dribbles all that escapes her clenched cunt. 'Ah. There's nothing like a good fuck. You're definitely staying with me here, prey,' Lindsey informs her. 'And I think that Jace could have his uses once he learns to follow orders without hesitation.' The cheetah obediently lets his gaze fall to the floor. 'And you, my voyeuristic bitch, surprised me. I was sure you'd want to fuck someone, but I guess you couldn't give up the chance to see me in action. Next time perhaps you can get to know them, rather than hear about how good my cock is,' Lindsey jokes.";
			say "     'But for now, I think that I should escort you back to the zoo. I wouldn't want you attracting attention to my den and it'll give the bitches a chance to get to know each other.' He gestures with an arm, brooking no argument as he follows you outside, his shaft still slowly retreating back into his sheath. 'Jace. If you touch Shea while I'm out, I'll hand you over to the giants. They're still looking for you.' Eyes wide, the cheetah gulps and nods his head. 'I'm glad that we have an understanding.' The walk back to the zoo is equally uneventful as the trip to the den, and soon you find yourself back at the gates. 'Well, I hope you appreciated that, but I should be getting back. Shea may come on to Jace even with my threats to him. He's only human,' Lindsey snickers at his own words before turning away. 'Be sure to keep coming to see me. A bitch like you is hard to replace.'";
			now resolution of Lindsey's Harem is 4;
	else: [Neither a wolftaur not Lindsey's Beta]
		say "     'Master. You have returned,' the cheetah says brightly, rubbing up against the wolftaur. 'You address me as alpha unless I tell you otherwise. Understand?' Lindsey replies tersely, firmly grasping him by the scruff of his neck. 'Yes alpha. Sorry alpha,' the feline apologizes, though you notice the tip of his cock slipping from his sheath. It would seem that he enjoys the wolftaur's assertiveness. Meanwhile, the zebra-woman eyes you intently before turning to Lindsey. 'Alpha, who is this?' she asks, dipping her head when Lindsey turns to her. '[SubjectProCap of Player] is bitch that likes my cock, but won't accept that [SubjectPro of Player] wants to belong to me more. If you embarrass me in front of [ObjectPro of Player], you will be punished. Is that understood?' he explains, the question rhetorical. The female wolftaur looks at you with an expression of confusion, likely not understanding why you won't fully submit to the alpha.";
		WaitLineBreak;
		say "     'I'd tell them to introduce themselves to you, but I don't have time for that,' Lindsey says, turning back to you. 'The wolftaur is my former boyfriend, Shea. You should learn to be more like her. The cheetah is Jace and the zebra is Elodie. They haven't had time to properly learn their place or to become wolftaurs, but it shouldn't take me long to fuck them into shape. Now, I think that you should familiarize yourself with my pack. I think that I can only trust you to watch as I breed the three of them. You haven't earnt the right to fuck any of them, and I'm not giving you the chance to take advantage of my hospitality. Be grateful that I even brought you here.' Lindsey looks at you with more than a little disdain, three further sets of eyes looking at you with similar condescension.";
		say "     'Let's hope, for your sake, that you're a voyeur. Or a cuck. I don't give a shit. It'll teach you to know your place!' Lindsey laughs. 'Well, I guess I can fuck them right here. Usually do.' The wolftaur trots over to an open bit of floor before calling his miniature harem over. 'Shea, you're the best at it, so you can suck my cock while I decide which of the two bitches I fuck this time.' Lindsey's girlfriend looks hungrily at her master's bobbing shaft as she kneels down and shuffles beneath him. Cradling his balls in one hand, she immediately begins to slather the length with her tongue, letting out contented moans as she does so, her other hand playing with her breasts. 'Now... which of you is going to be the lucky one?' Lindsey muses, casting an eye over the cheetah and zebra. Honestly, you would have to say that the big male wolftaur will be the lucky one, no matter which of them he chooses.";
		say "     'I think that I'm in the mood for some prey, and Elodie's got a real juicy ass. Tough luck Jace, but I'll let you get her pussy ready for me. Nothing more than your mouth though. You have to earn the right to use your cock if you're staying here,' Lindsey growls, lightly thrusting into Shea's greedy mouth as she blows him. Elodie looks thrilled to have been chosen, the zebra grinning widely as she lies back on the couch and spreads her legs, her labia slightly stuck together with arousal. Jace's shoulders slump a little as he kneels down in front of her, his slim frame quite the contrast to her more generous proportions as he prepares to service her, shuddering slightly as he takes a breath of her heady scent. 'She doesn't look like she needs any preparation at all,' Lindsey barks with laughter, making the zebra blush and close her legs in embarrassment. 'It was a compliment bitch. Now spread [']em. Before you suffocate the cat with your thighs.'";
		WaitLineBreak;
		say "     Gasping at the realization of what she's done, Elodie quickly opens her legs again. You expected Jace to need to gulp in some air, but the feline only buries himself deeper in her snatch, quite effectively so given the way the zebra whinnies and grasps the cheetah by the back of his head. 'Well well. Looks like the kitty liked it. It's a shame that he won't be the one getting the cream today,' Lindsey chuckles, stepping forward and pulling his spit-soaked cock from his girlfriend's muzzle. 'She should be ready enough. Move over Jace.' When the cheetah doesn't respond, continuing to eat the zebra out, Lindsey grabs him by the shoulder and pushes him to the floor. 'I said move, bitch,' he snarls, stepping over Jace's prostrate form and mounting the woman, his front paws resting over the back of the couch. The feline has a close-up view as Elodie is speared by the wolftaur's thick cock, Lindsey's balls bumping his face as he sits up and scrabbles to get out of the way.";
		say "     'I'm gonna fill your belly with my pups,' Lindsey snarls in Elodie's ear as he pounds into her, grasping her by the jaw and pushing her against the back of the couch. 'Maybe you'll even turn into a wolftaur this time. Become a proper bitch for me.' The zebra can only moan and call for him to fuck her harder, her capability of conscious thought severely impeded. Jace begins to reach towards his erection, but Shea lightly grasps him by the wrist and shakes her head, replacing his hand with one of her own, though you get the impression that she would prefer something more involved than giving a handjob. Lindsey merely grins upon seeing this before he turns to you. 'Regretting not being a part of this yet? You could have been fucking one of the new bitches right now, but instead all Shea is giving the boy-bitch a handy and Elodie's being given the best fuck of her life. Perhaps it's better this way. You wouldn't have given her the same experience,' he growls possessively, punctuating each of the last few words with especially sharp thrusts into the zebra.";
		WaitLineBreak;
		say "     Elodie's mind seems to be gone at the moment, eyes rolled up and mouth hanging open as she is roughly bred. With each slap of Lindsey's knot into her labia, a wave of force rolls through her body, making her heavy breasts heave and causing her to let out an enthusiastic moan or grunt. Jace and Shea look on enviously, their own interaction seeming rather inadequate in comparison. Nonetheless, as they continue, you would assume that they still find a modicum of enjoyment in it. 'Are you ready for my cum?' Lindsey asks Elodie, grinning when she is only able to muster a desperate whine. She attempts to pull her vulva wider to make it easier for the wolftaur to knot her, her fingers slipping on the copious juices from their rutting. All eyes fall on the pair of them as Lindsey slams into her a few more times with a snarl until finally his knot batters its way into the embrace of her cunt.";
		say "     The zebra's delirious squeal is almost drowned out by Lindsey's roar as they both orgasm, both of them shuddering violently, and you watch the wolftaur's balls rise and fall as they pump her full of his seed. Behind them, Jace also climaxes, Shea's hands on his penis being helped along by the sight of Elodie being filled in front of him. The female wolftaur quickly cups her palm in front of his cock as it pulses, catching his semen, before she brings it to her mouth and laps it up, her eyes locked with his. The cheetah watches her drink it with a look of infatuation, his lips slightly parted. 'You're such a slut, Shea,' Lindsey teases her as he turns his upper body to observe them both. 'Don't get any ideas, pussy-bitch. I let her jack you off, but she's still mine' he growls at Jace. The cheetah nods reflexively, but he still sneaks a glance at the female wolftaur who winks at him when Lindsey turns away again.";
		WaitLineBreak;
		say "     Everyone is rather silent as they wait for Lindsey's knot to go down, the high from sex leaving them in a sort of stupor. Eventually, the alpha wolftaur's shaft softens enough for him to be able to pull it from the zebra's pussy. Surprisingly, Elodie manages to prevent the majority of his cum from gushing out, a few stray dribbles all that escapes her clenched cunt. 'Ah. There's nothing like a good fuck. You're definitely staying with me here, prey,' Lindsey informs her. 'And I think that Jace could have his uses once he learns to follow orders without hesitation.' The cheetah obediently lets his gaze fall to the floor. 'And you, my voyeuristic bitch, surprised me. I was sure you'd try to fuck someone, but I guess you couldn't give up the chance to see me in action. Next time perhaps you can get to know them, rather than hear about how good my cock is,' Lindsey jokes.";
		say "     'But for now, I think that I should escort you back to the zoo. I wouldn't want you attracting attention to my den and it'll give the bitches a chance to get to know each other.' He gestures with an arm, brooking no argument as he follows you outside, his shaft still slowly retreating back into his sheath. 'Jace. If you touch Shea while I'm out, I'll hand you over to the giants. They're still looking for you.' Eyes wide, the cheetah gulps and nods his head. 'I'm glad that we have an understanding.' The walk back to the zoo is equally uneventful as the trip to the den, and soon you find yourself back at the gates. 'Well, I hope you appreciated that, but I should be getting back. Shea may come on to Jace even with my threats to him. He's only human,' Lindsey snickers at his own words before turning away. 'Be sure to keep coming to see me. A bitch like you is hard to replace.'";
		now resolution of Lindsey's Harem is 4;
	now Lindsey's Harem is resolved;

Lindsey ends here.
