Wave of Change v1.1, Based On Flexible Infection v3 by Shrimpy
An Interactive Fiction by Nuku Valente
Release 1 / Serial number 120916 / Inform 7 build 6G60 (I6/v6.32 lib 6/12N) SD

Welcome to Flexible Infection!  At any time type "help" for a list of help commands.  First off, how evasive would you like people to be?  Pick a number from 1 to 10 to decide it - the lower the number, the easier it will be for them to be hit.

>5
Thank you!  And how resistant would you like them to be to changes?  This time, pick a number from 1 to 10.  This will decide how quickly they succumb once they've been infected - the lower it is, the quicker they change.

>5
Great!  Now there's just one last question: how would you like to distribute your stats?  You have 20 points to distribute as you choose between two stats: Reflex, which allows you to avoid attacks, and Willpower, which allows you to resist further changes.  How many of the 20 points would you like for Reflex (minimum 1, maximum 19)?

>10
With a Reflex score of 10, you will have a Willpower of 10!  Enjoy the game!
Oh, one more question, do you want random transformation by item? If not, items will never force people to use them. Enter 1 for forced, 0 for manual.

>0
Ok, items will not tempt people.
I lied, one more question. Do you want graphics? Type 1 for yes and 0 for no.

>0
Ok, graphics will be turned off.

Apartment 1A
Your apartment.

There is a rope here.

You can also see Wooden door, a Dresser (closed) and a pentagram here.

You can go: southeast.

>se
(first opening Wooden door)

First Floor Hallway
The main exit is down the stairs.

You can see Wooden door here.

You can go: north, northwest, west and down.

Greg arrives from the west.

You are carrying: 

You are uninfected, 100% human, and male.

* * *

>10
With a Reflex score of 10, you will have a Willpower of 10!  Enjoy the game!
Oh, one more question, do you want random transformation by item? If not, items will never force people to use them. Enter 1 for forced, 0 for manual.

>1
Ok, items will tempt people towards them.
I lied, two more questions. Do you want graphics? Type 1 for yes and 0 for no.

>1
Ok, graphics will remain on.
Do you want items to be randomized? 1 for yes, 0 for no.

>0
Perhaps you'd like to have more choice?
Allowed Infection Items: Dog Treat, Chakona Tails, Hawk Milk, Mephit Perfume, catnip mouse, Stomach Pouch, Feather Necklace, easter egg, Bottle of milk, Cat Ear Band, Fresh Apple, Tuna Fish, Feathered Mask, Interesting Lipstick, Fox Soda can, pack of nuts, Wyvern Water can, Aviator Goggles, Baby Bottle, Tobasco Sauce, Echo'N Brand Mayonaise, Longbow, Glamour Magazine, Fennec Ear Hat, Pair of latex wolf paws, Stag Antlers and Coyote Tail
Disallowed Infection Items: nothing
(q to quit)

>longbow
Comparing Dog Treat to longbow No Match.
Comparing Chakona Tails to longbow No Match.
Comparing Hawk Milk to longbow No Match.
Comparing Mephit Perfume to longbow No Match.
Comparing catnip mouse to longbow No Match.
Comparing Stomach Pouch to longbow No Match.
Comparing Feather Necklace to longbow No Match.
Comparing easter egg to longbow No Match.
Comparing Bottle of milk to longbow No Match.
Comparing Cat Ear Band to longbow No Match.
Comparing Fresh Apple to longbow No Match.
Comparing Tuna Fish to longbow No Match.
Comparing Feathered Mask to longbow No Match.
Comparing Interesting Lipstick to longbow No Match.
Comparing Fox Soda can to longbow No Match.
Comparing pack of nuts to longbow No Match.
Comparing Wyvern Water can to longbow No Match.
Comparing Aviator Goggles to longbow No Match.
Comparing Baby Bottle to longbow No Match.
Comparing Tobasco Sauce to longbow No Match.
Comparing Echo'N Brand Mayonaise to longbow No Match.
Comparing Longbow to longbow Match.
Comparing Glamour Magazine to longbow No Match.
Comparing Fennec Ear Hat to longbow No Match.
Comparing Pair of latex wolf paws to longbow No Match.
Comparing Stag Antlers to longbow No Match.
Comparing Coyote Tail to longbow No Match.
Comparing easter egg to longbow No Match.
Comparing easter egg to longbow No Match.
Comparing easter egg to longbow No Match.
Comparing easter egg to longbow No Match.
Comparing easter egg to longbow No Match.
Comparing easter egg to longbow No Match.
Comparing easter egg to longbow No Match.
Comparing easter egg to longbow No Match.
Comparing easter egg to longbow No Match.
Comparing easter egg to longbow No Match.
Comparing easter egg to longbow No Match.
Comparing easter egg to longbow No Match.
Comparing easter egg to longbow No Match.
Comparing easter egg to longbow No Match.
Comparing easter egg to longbow No Match.
Comparing easter egg to longbow No Match.
Comparing easter egg to longbow No Match.
Comparing easter egg to longbow No Match.
Comparing easter egg to longbow No Match.
Comparing easter egg to longbow No Match.
Allowed Infection Items: Dog Treat, Chakona Tails, Hawk Milk, Mephit Perfume, catnip mouse, Stomach Pouch, Feather Necklace, easter egg, Bottle of milk, Cat Ear Band, Fresh Apple, Tuna Fish, Feathered Mask, Interesting Lipstick, Fox Soda can, pack of nuts, Wyvern Water can, Aviator Goggles, Baby Bottle, Tobasco Sauce, Echo'N Brand Mayonaise, Glamour Magazine, Fennec Ear Hat, Pair of latex wolf paws, Stag Antlers and Coyote Tail
Disallowed Infection Items: Longbow
(q to quit)

>q
Apartment 1A
Your apartment. You've had better, you've had worse. At least this one has a window with a nice view, and you've only been mugged once all year! You got the place at a steal, and if you graduate on time, you'll be on to bigger and better soon. The pentagram you drew on a dare is still visible. Hope the land lord doesn't come and see that, oh well. Your dresser rests under your mirror, both cheap emergency buys from the local Ikea.

There is a rope here.

You can also see Wooden door, a Dresser (closed) and a pentagram here.

You can go: southeast.

* * *

Wave of Change v1.1, Based On Flexible Infection v3 by Shrimpy
An Interactive Fiction by Nuku Valente
Release 1 / Serial number 120916 / Inform 7 build 6G60 (I6/v6.32 lib 6/12N) SD

Welcome to Flexible Infection!  At any time type "help" for a list of help commands.  First off, how evasive would you like people to be?  Pick a number from 1 to 10 to decide it - the lower the number, the easier it will be for them to be hit.

>12
That's not a valid number.  Try again.

>1
Thank you!  And how resistant would you like them to be to changes?  This time, pick a number from 1 to 10.  This will decide how quickly they succumb once they've been infected - the lower it is, the quicker they change.

>1
Great!  Now there's just one last question: how would you like to distribute your stats?  You have 20 points to distribute as you choose between two stats: Reflex, which allows you to avoid attacks, and Willpower, which allows you to resist further changes.  How many of the 20 points would you like for Reflex (minimum 1, maximum 19)?

>10
With a Reflex score of 10, you will have a Willpower of 10!  Enjoy the game!
Oh, one more question, do you want random transformation by item? If not, items will never force people to use them. Enter 1 for forced, 0 for manual.

* * *

>0
Ok, items will not tempt people.
I lied, one more question. Do you want graphics? Type 1 for yes and 0 for no.

>0
Ok, graphics will be turned off.

Apartment 1A
Your apartment. You've had better, you've had worse. At least this one has a window with a nice view, and you've only been mugged once all year! You got the place at a steal, and if you graduate on time, you'll be on to bigger and better soon. The pentagram you drew on a dare is still visible. Hope the land lord doesn't come and see that, oh well. Your dresser rests under your mirror, both cheap emergency buys from the local Ikea.

There is a rope here.

You can also see Wooden door, a Dresser (closed) and a pentagram here.

You can go: southeast.

>se
(first opening Wooden door)

First Floor Hallway
Just outside your apartment on the first floor. Whoever designed this apartment building was a little paranoid. Every floor has its own key, so you can't get to the other floors, just this one. The stairs lead down to the street at the end of the hallway, or you could go up to the roof. No key is needed up there. Two other apartments are visible from here as well.

You can see Wooden door here.

You can go: north, northwest, west, up and down.

You are carrying: 
  nothing

You are uninfected, 100% human, and male.

>n
Apartment 1B
Home of Bob and Susan. You know them from school, since they go to college with you. You're pretty sure they're an item, but they admit to nothing. The most prominent feature of the room is the huge fridge they got for Christmas last year. The thing is gargantuan, chrome, and has one of those built in water/ice dispensers. You are so jealous.

Someone left a strange hair band laying around, it has cat ears on it.

You can also see a Refridgerator (closed), Bob and Susan here.

You can go: south.

You are carrying: 
  nothing

You are uninfected, 100% human, and male.

>get band
Taken.

Susan goes south.

You are carrying: 
  a Cat Ear Band

You are uninfected, 100% human, and male.

>l band
A band of white plastic with big fake white cat ears on it. Cute.

You are carrying: 
  a Cat Ear Band

You are uninfected, 100% human, and male.

>wear band
You put on a hat and feel safer with your head protected.
Something brushes down your back, a carpet of bright blue hair that flows out like a cape. Before you can consider it for long, your ears begin to tingle fiercely, expanding to huge feline triangles on top of your head.

Bob runs south, away from yourself!

Bob goes south.

You are carrying: 
  nothing

You are partially infected, 5% neko, 94% human, and male.

* * *

Wave of Change v1.1, Based On Flexible Infection v3 by Shrimpy
An Interactive Fiction by Nuku Valente
Release 1 / Serial number 120916 / Inform 7 build 6G60 (I6/v6.32 lib 6/12N) SD

Welcome to Flexible Infection!  At any time type "help" for a list of help commands.  First off, how evasive would you like people to be?  Pick a number from 1 to 10 to decide it - the lower the number, the easier it will be for them to be hit.

>1
Thank you!  And how resistant would you like them to be to changes?  This time, pick a number from 1 to 10.  This will decide how quickly they succumb once they've been infected - the lower it is, the quicker they change.

* * *

>10
With a Reflex score of 10, you will have a Willpower of 10!  Enjoy the game!
Oh, one more question, do you want random transformation by item? If not, items will never force people to use them. Enter 1 for forced, 0 for manual.

>0
Ok, items will not tempt people.
I lied, two more questions. Do you want graphics? Type 1 for yes and 0 for no.

>0
Ok, graphics will be turned off.
Do you want items to be randomized? 1 for yes, 0 for no.

>se
(first opening Wooden door)

First Floor Hallway
Just outside your apartment on the first floor. Whoever designed this apartment building was a little paranoid. Every floor has its own key, so you can't get to the other floors, just this one. The stairs lead down to the street at the end of the hallway, or you could go up to the roof. No key is needed up there. Two other apartments are visible from here as well.

You can see Wooden door here.

You can go: north, northwest, west, up and down.

Greg arrives from the west.

Bob arrives from the north.

Susan arrives from the north.

You are carrying: 
  nothing

You are uninfected, 100% human, and male.

>zap bob to huge dragoness
You zap Bob with your nano tuner and they begin changing rapidly!
Bob the Huge Dragoness shimmers with a layer of cum as they begin to grow and expand. A moan comes out muffedly as huge breasts and huge shaft grows longer and longer, tail stretching backwards as they become a Huge Dragoness!

Greg runs down, away from Roberta the Huge Dragoness!

Greg goes down.

Susan runs down, away from Roberta the Huge Dragoness!

Susan goes down.

You are carrying: 
  nothing

You are uninfected, 100% human, and male.

>l
First Floor Hallway
Just outside your apartment on the first floor. Whoever designed this apartment building was a little paranoid. Every floor has its own key, so you can't get to the other floors, just this one. The stairs lead down to the street at the end of the hallway, or you could go up to the roof. No key is needed up there. Two other apartments are visible from here as well.

You can see Susan, Roberta the Huge Dragoness, Greg and Wooden door here.

You can go: north, northwest, west, up and down.

You are carrying: 
  nothing

You are uninfected, 100% human, and male.

>zap greg to huge dragoness
You zap Greg with your nano tuner and they begin changing rapidly!
Greg the Huge Dragoness shimmers with a layer of cum as they begin to grow and expand. A moan comes out muffedly as huge breasts and huge shaft grows longer and longer, tail stretching backwards as they become a Huge Dragoness!

You are carrying: 
  nothing

You are uninfected, 100% human, and male.

>nw
Apartment 1A
Your apartment. You've had better, you've had worse. At least this one has a window with a nice view, and you've only been mugged once all year! You got the place at a steal, and if you graduate on time, you'll be on to bigger and better soon. The pentagram you drew on a dare is still visible. Hope the land lord doesn't come and see that, oh well. Your dresser rests under your mirror, both cheap emergency buys from the local Ikea.

There is a rope here.

You can also see Wooden door, a Dresser (closed) and a pentagram here.

You can go: southeast.

You are carrying: 
  nothing

You are uninfected, 100% human, and male.

>z
Time passes.

You are carrying: 
  nothing

You are uninfected, 100% human, and male.

>z
Time passes.

You are carrying: 
  nothing

You are uninfected, 100% human, and male.

>who
--- Number of people by TF type ---
There are 21 humans in the game, 80% of the total.
There are 2 huge dragonesss in the game, 7% of the total.
There is 1 centaur in the game, 3% of the total.
There are 2 otters in the game, 7% of the total.
There are 21 people in the game, 0 infected.
There are 5 monsters in the game.
--- People and their locations ---
uninfected David, located in Second Street North.
Georgina the Huge Dragoness, located in Second Street North.
Roberta the Huge Dragoness, located in First Street Center.
uninfected Susan, located in Miller Avenue.
uninfected Paula, located in Second Street South.
uninfected Trixia, located in Davis Street.
uninfected Shaquia, located in Commercial District.
uninfected Tony, located in Town Border.
uninfected Thomas, located in First Street Center.
uninfected Joe, located in Commercial District.
uninfected Larry, located in Second Street South.
prometheus the centaur, located in Stables.
uninfected Timothy, located in First Street South.
uninfected Sammy, located in Davis Street.
uninfected Henrietta, located in First Street Center.
uninfected Sasha, located in First Street South.
uninfected Lisa, located in First Street Center.
uninfected Juan, located in First Street Center.
uninfected Mark, located in Davis Street.
uninfected Darrell, located in Dirt Road.
Petey the Otter, located in Dirt Road.
Longtail the Otter, located in Lewis Pond.
uninfected Jazmine, located in First Street Center.
uninfected Christopher, located in Miller Avenue.
uninfected John, located in First Street South.
--- Infection items and their locations ---
Dog Treat, located in apartment 1E.
Chakona Tails, located in apartment 1E.
Mephit Perfume, located in Johnson State Park.
catnip mouse, located in Ranch Office.
Stomach Pouch, located in Apartment 1A.
Feather Necklace, located in Apartment 1A.
easter egg, located in Apartment 1B.
Bottle of milk, located in Apartment 1B.
Cat Ear Band, located in Apartment 1B.
Tuna Fish, located in Forest Glade.
Feathered Mask, located in Davis Street.
Fox Soda can, located in Johnson Park Entrance.
pack of nuts, located in Johnson Park Entrance.
Wyvern Water can, located in Johnson Park Entrance.
Aviator Goggles, located in Radioshack.
Tobasco Sauce, located in Food Court.
Glamour Magazine, located in Al's Hunting Emporium.
Fennec Ear Hat, located in Al's Hunting Emporium.
Pair of latex wolf paws, located in Fantastic Furs.
Stag Antlers, located in Fantastic Furs.
Coyote Tail, located in Fantastic Furs.

You are carrying: 
  nothing

You are uninfected, 100% human, and male.

>z
Time passes.

You are carrying: 
  nothing

You are uninfected, 100% human, and male.

>zap me to huge dragoness
You zap yourself with your nano tuner and they begin changing rapidly!
Your head changes.
Your chest changes..
Your beer belly changes.
You once more have a human penis.
Your rear changes..
Your left upper arm changes..
Your left forearm changes..
Your left hand changes..
Your right upper arm changes..
Your right forearm changes..
Your right hand changes..
Your left shin changes..
Your left thigh changes..
Your left foot changes..
Your right shin changes..
Your right thigh changes..
Your right foot changes..

With a triumphant roar, Georgina the Huge Dragoness snatches up Paula and squats. The cries of Paula become muffled as they are stuffed up into the waiting snatch of the huge dragon, fem juices splattering across the ground as the hapless victim vanishes from sight.
With a triumphant roar, Roberta the Huge Dragoness snatches up Sasha and squats. The cries of Sasha become muffled as they are stuffed up into the waiting snatch of the huge dragon, fem juices splattering across the ground as the hapless victim vanishes from sight.

You are carrying: 
  nothing

You are fully infected, 100% huge dragoness, and herm.

>z
Time passes.

You are carrying: 
  nothing

You are fully infected, 100% huge dragoness, and herm.

>z
Time passes.

You are carrying: 
  nothing

You are fully infected, 100% huge dragoness, and herm.

I beg your pardon?

You are carrying: 
  nothing

You are fully infected, 100% huge dragoness, and herm.

I beg your pardon?

You are carrying: 
  nothing

You are fully infected, 100% huge dragoness, and herm.

>z
Time passes.

You are carrying: 
  nothing

You are fully infected, 100% huge dragoness, and herm.

>who
--- Number of people by TF type ---
There are 19 humans in the game, 79% of the total.
There are 2 huge dragonesss in the game, 8% of the total.
There is 1 centaur in the game, 4% of the total.
There are 2 otters in the game, 8% of the total.
There are 19 people in the game, 0 infected.
There are 5 monsters in the game.
--- People and their locations ---
uninfected David, located in Uptown.
pregnant Georgina the Huge Dragoness, located in Second Street South.
pregnant Roberta the Huge Dragoness, located in First Street Center.
uninfected Susan, located in Second Street South.
uninfected Trixia, located in Small Alley.
uninfected Shaquia, located in Davis Street.
uninfected Tony, located in First Street North.
uninfected Thomas, located in Davis Street.
uninfected Joe, located in First Street South.
uninfected Larry, located in First Street South.
prometheus the centaur, located in Stables.
uninfected Timothy, located in Dirt Road.
uninfected Sammy, located in Town Border.
uninfected Henrietta, located in First Street Center.
uninfected Lisa, located in Second Street South.
uninfected Juan, located in Small Alley.
uninfected Mark, located in Downtown.
uninfected Darrell, located in Second Street South.
Petey the Otter, located in Dirt Road.
Longtail the Otter, located in Dirt Road.
uninfected Jazmine, located in Second Street South.
uninfected Christopher, located in Davis Street.
uninfected John, located in Small Alley.
--- Infection items and their locations ---
Dog Treat, located in apartment 1E.
Chakona Tails, located in apartment 1E.
Mephit Perfume, located in Johnson State Park.
catnip mouse, located in Ranch Office.
Stomach Pouch, located in Apartment 1A.
Feather Necklace, located in Apartment 1A.
easter egg, located in Apartment 1B.
Bottle of milk, located in Apartment 1B.
Cat Ear Band, located in Apartment 1B.
Tuna Fish, located in Forest Glade.
Feathered Mask, located in Davis Street.
Fox Soda can, located in Johnson Park Entrance.
pack of nuts, located in Johnson Park Entrance.
Wyvern Water can, located in Johnson Park Entrance.
Aviator Goggles, located in Radioshack.
Tobasco Sauce, located in Food Court.
Glamour Magazine, located in Al's Hunting Emporium.
Fennec Ear Hat, located in Al's Hunting Emporium.
Pair of latex wolf paws, located in Fantastic Furs.
Stag Antlers, located in Fantastic Furs.
Coyote Tail, located in Fantastic Furs.

You are carrying: 
  nothing

You are fully infected, 100% huge dragoness, and herm.

>z
Time passes.

You are carrying: 
  nothing

You are fully infected, 100% huge dragoness, and herm.

>who
--- Number of people by TF type ---
There are 19 humans in the game, 79% of the total.
There are 2 huge dragonesss in the game, 8% of the total.
There is 1 centaur in the game, 4% of the total.
There are 2 otters in the game, 8% of the total.
There are 19 people in the game, 0 infected.
There are 5 monsters in the game.
--- People and their locations ---
uninfected David, located in Small Alley.
pregnant Georgina the Huge Dragoness, located in Second Street South.
pregnant Roberta the Huge Dragoness, located in First Street Center.
uninfected Susan, located in Davis Street.
uninfected Trixia, located in Small Alley.
uninfected Shaquia, located in Second Street South.
uninfected Tony, located in Uptown.
uninfected Thomas, located in Second Street North.
uninfected Joe, located in First Street South.
uninfected Larry, located in Davis Street.
prometheus the centaur, located in Stables.
uninfected Timothy, located in Second Street South.
uninfected Sammy, located in Downtown.
uninfected Henrietta, located in Davis Street.
uninfected Lisa, located in Second Street South.
uninfected Juan, located in Davis Street.
uninfected Mark, located in Town Border.
uninfected Darrell, located in First Street North.
Petey the Otter, located in Lewis Pond.
Longtail the Otter, located in Dirt Road.
uninfected Jazmine, located in Downtown.
uninfected Christopher, located in First Street South.
uninfected John, located in First Street Center.
--- Infection items and their locations ---
Dog Treat, located in apartment 1E.
Chakona Tails, located in apartment 1E.
Mephit Perfume, located in Johnson State Park.
catnip mouse, located in Ranch Office.
Stomach Pouch, located in Apartment 1A.
Feather Necklace, located in Apartment 1A.
easter egg, located in Apartment 1B.
Bottle of milk, located in Apartment 1B.
Cat Ear Band, located in Apartment 1B.
Tuna Fish, located in Forest Glade.
Feathered Mask, located in Davis Street.
Fox Soda can, located in Johnson Park Entrance.
pack of nuts, located in Johnson Park Entrance.
Wyvern Water can, located in Johnson Park Entrance.
Aviator Goggles, located in Radioshack.
Tobasco Sauce, located in Food Court.
Glamour Magazine, located in Al's Hunting Emporium.
Fennec Ear Hat, located in Al's Hunting Emporium.
Pair of latex wolf paws, located in Fantastic Furs.
Stag Antlers, located in Fantastic Furs.
Coyote Tail, located in Fantastic Furs.

You are carrying: 
  nothing

You are fully infected, 100% huge dragoness, and herm.

>z
Time passes.

You are carrying: 
  nothing

You are fully infected, 100% huge dragoness, and herm.

>se
First Floor Hallway
Just outside your apartment on the first floor. Whoever designed this apartment building was a little paranoid. Every floor has its own key, so you can't get to the other floors, just this one. The stairs lead down to the street at the end of the hallway, or you could go up to the roof. No key is needed up there. Two other apartments are visible from here as well.

You can see Wooden door here.

You can go: north, northwest, west, up and down.

You are carrying: 
  nothing

You are fully infected, 100% huge dragoness, and herm.

>d
Uptown
You can see your house from here! Of course you're just standing outside of it, so that's not really a big accomplishment. Uptown is usually a busy place, but it seems oddly subdued this morning, as if something was about to happen, or is already happening? Nah, you're just being paranoid. You can see the stairs heading back up to your apartment, or you can head into the city along the main road of "second street" just south, or a smaller winding street to the southwest.

You can see Tony here.

You can go: south, southwest and up.

Tony goes south.

Darrell arrives from the southwest.

You are carrying: 
  nothing

You are fully infected, 100% huge dragoness, and herm.

>sw
First Street North
You're not that far from your apartment, which is Northeast of here. The street bends off to the west, narrowing into a small alley, making this part of the road somewhat unpopular, if it wasn't for that hotdog stand on the side of the road. Best dogs in the city.

You can see Trixia here.

You can go: northeast and west.

Trixia goes northeast.

You are carrying: 
  nothing

You are fully infected, 100% huge dragoness, and herm.

>w
Small Alley
A narrow little road that leads south into the center of the city. Watch out, though, you hear rumors of bikers and pedestrians being whalloped by cars in this place at least once a month.

You can go: south and east.

You are carrying: 
  nothing

You are fully infected, 100% huge dragoness, and herm.

>s
First Street Center
Ah, one of the centers of the city. South of here, you can see the mall and commercial district, where you are often headed. From here, you could head west out to the pond. That's a good place to pick up chicks, or just hang out if you have no money.

You can see Juan and pregnant Roberta the Huge Dragoness here.

You can go: north, south, east and west.

Henrietta arrives from the west.

You are carrying: 
  nothing

You are fully infected, 100% huge dragoness, and herm.

>zap juan to huge dragoness
You zap Juan with your nano tuner and they begin changing rapidly!
Juan the Huge Dragoness shimmers with a layer of cum as they begin to grow and expand. A moan comes out muffedly as huge breasts and huge shaft grows longer and longer, tail stretching backwards as they become a Huge Dragoness!

David arrives from the west.

Christopher arrives from the east.

You are carrying: 
  nothing

You are fully infected, 100% huge dragoness, and herm.

>z
Time passes.

With a triumphant roar, Jaquette the Huge Dragoness snatches up Christopher and squats. The cries of Christopher become muffled as they are stuffed up into the waiting snatch of the huge dragon, fem juices splattering across the ground as the hapless victim vanishes from sight.

David goes east.

You are carrying: 
  nothing

You are fully infected, 100% huge dragoness, and herm.

>z
Time passes.

You are carrying: 
  nothing

You are fully infected, 100% huge dragoness, and herm.

>z
Time passes.

John arrives from the east.

You are carrying: 
  nothing

You are fully infected, 100% huge dragoness, and herm.

>z
Time passes.

You are carrying: 
  nothing

You are fully infected, 100% huge dragoness, and herm.

>z
Time passes.

David arrives from the east.

Henrietta goes north.

Darrell arrives from the north.

You are carrying: 
  nothing

You are fully infected, 100% huge dragoness, and herm.

>z
Time passes.

Henrietta arrives from the north.

Darrell goes east.

You are carrying: 
  nothing

You are fully infected, 100% huge dragoness, and herm.

>z
Time passes.

David goes east.

Trixia arrives from the north.

Henrietta goes south.

Lisa arrives from the east.

John goes east.

You are carrying: 
  nothing

You are fully infected, 100% huge dragoness, and herm.

>z
Time passes.

David arrives from the east.

Trixia goes north.

Lisa goes east.

John arrives from the east.

You are carrying: 
  nothing

You are fully infected, 100% huge dragoness, and herm.

>z
Time passes.

David goes east.

John goes north.

You are carrying: 
  nothing

You are fully infected, 100% huge dragoness, and herm.

>l
First Street Center
Ah, one of the centers of the city. South of here, you can see the mall and commercial district, where you are often headed. From here, you could head west out to the pond. That's a good place to pick up chicks, or just hang out if you have no money.

You can see pregnant Jaquette the Huge Dragoness and pregnant Roberta the Huge Dragoness here.

You can go: north, south, east and west.

You are carrying: 
  nothing

You are fully infected, 100% huge dragoness, and herm.

>z
Time passes.

pregnant Bob the Huge Dragoness goes north.

John arrives from the north.

John arrives, running south away from pregnant Roberta the Huge Dragoness!

You are carrying: 
  nothing

You are fully infected, 100% huge dragoness, and herm.

>z
Time passes.

You are carrying: 
  nothing

You are fully infected, 100% huge dragoness, and herm.

>z
Time passes.

David arrives from the east.

Joe arrives from the south.

You are carrying: 
  nothing

You are fully infected, 100% huge dragoness, and herm.

>z
Time passes.

David runs east, away from pregnant Jaquette the Huge Dragoness!

David goes east.

Joe goes east.

You are carrying: 
  nothing

You are fully infected, 100% huge dragoness, and herm.

>z
Time passes.

pregnant Bob the Huge Dragoness arrives from the north.

Henrietta arrives from the south.

Mark arrives from the east.

You are carrying: 
  nothing

You are fully infected, 100% huge dragoness, and herm.

>z
Time passes.

David arrives from the east.

Joe arrives from the east.

Timothy arrives from the east.

You are carrying: 
  nothing

You are fully infected, 100% huge dragoness, and herm.

>z
Time passes.

Timothy goes east.

Henrietta goes east.

You are carrying: 
  nothing

You are fully infected, 100% huge dragoness, and herm.

>z
Time passes.

Joe goes north.

Larry arrives from the east.

John goes north.

You are carrying: 
  nothing

You are fully infected, 100% huge dragoness, and herm.

I beg your pardon?

You are carrying: 
  nothing

You are fully infected, 100% huge dragoness, and herm.