Behemoth by Kaleem mcintyre begins here.

Section 1 - Monster Responses

when play begins:
[These flags indicate which monster groups your creature belongs to, should someone want to remove any given type.]
[Delete the lines with unneeded flags and replace 'Behemoth' with your creature's name entry. Case sensitive.]
	add { "Behemoth" } to infections of hermaphrodite;
	add { "Behemoth" } to infections of furry;
	add { "Behemoth" } to infections of tailweapon;

to say BehemothDesc:
	setmongender 5; [creature is herm]
	if inasituation is true:
		say ""; [dealt with at the event source]
	else:
		say "     Charging straight for you on all fours is a beast straight out of legends. With teeth like razors, a forest green and blue hide covering its massive sixteen foot long frame, a mane of pure white trailing around its monstrous head, twin onyx horns jutting from its scalp and four clawed paws scraping at the ground beneath its gigantic form the mutant in front of you is definitely not something you would have ever hoped to come cross. The fact that this behemoth of a creature has a massive nine foot tail covered in spikes and fur that lashes through the air behind it is nothing compared to the four and a half foot long cock and the pair of medicine ball sized testes dangling up under its body.";

to say LoseToBehemoth:
	if inasituation is true:
		say ""; [dealt with at the event source]
	else:
		say "     Having been knocked into the air by the Behemoth you find yourself spinning around like a top before plummeting back to the ground.";
		if a random chance of 1 in 2 succeeds:
			say "     Falling as you are you can only scream as you watch the Behemoth below you flip itself onto its backside and then spread its legs wide in preparation of something. You are not ready to see it lift its massive balls out of the way to present to you a gaping and oozing black cunt, looking like some kind of bizarre Venus flytrap. The fleshy lips part slightly right as you are about to enter into them, and then quickly move to swallow you whole once your [facename of player in lower case] head comes into contact with the feminine folds. Hot, wet, dark, and slightly uncomfortable you find yourself struggling on instinct as you realize that you are actually trapped into the cunt of the mutant you had fought and lost against. The situation only gets worse at that point as you are then treated to a very...unusual...happening when one of the Behemoth's paws force the lower part of your body further into itself.";
			say "     When the paw-like hand is removed you aren't ready for the creature to rub at the outer edge of its pussy, forcing the tight nethers to seal perfectly around you when your feet slip into its bestial depths. Now fully trapped inside of the darkened snatch of the Behemoth you can barely even struggle as the warm dampness of the mutant's fleshy walls melds themselves into your skin, causing your form to change and your mind to shift respective gears alter as the creature's infectious honeyed fluids seep on down into the core of your being. Yelling for help doesn't do you much good as you can barely even get a word in around from the tight folds suffocating the air out from your lungs. However, rationality has little precedence over being asphyxiated and sadly when you try to do so you end up swallowing much of the Behemoth's juices in the process which consequently sends your head reeling as the infectious strain within the creature overwhelms your senses.";
			decrease humanity of player by 10;
			if a random chance of 1 in 2 succeeds:
				say "     You're not sure how much time passes as you slip in and out of consciousness after the overload your mind has gone through. However, you are roused from your somewhat restless haze when something hard and steady pushes at your body forcing you deeper into your living prison. Not sure what's going on you quickly come to put two and two together when the thing that had knocked itself into you smacks itself up against you once again, this time just a bit harder than before. Because of your current placement, the scent surrounding you, the fluttering folds gripping and massaging at your body like mad, you realize that the object hitting you can only be a cock. Thinking on the beast you've fought and lost against, you can take a guess that the maleness rubbing and grinding against your prone body must belong to another Behemoth.";
				say "     Struggling as much as you can against the invasive phallus stroking itself across your body while soaking pre into your chest you find yourself trying to pull back as far as you can to get away from the unrelenting organ. However, being as you are, where you are, you only end up being jammed packed against the cock fucking the pussy housing you as your movements open the cervix of the Behemoth your inside more. This, consequently, give the second Behemoth more room and leverage to fuck the other with.";
				WaitLineBreak;
				say "     The Behemoth who has captured you seems not to mind this fact in the least as the walls of its cunt contour around both you and then creature continuously hammering its way inside of it. Oddly enough, as more time goes on, you find this entire process somewhat erotic as you squirm around without meaning to while trying to get around the cock plunging itself back and forth onside of you with growing intensity. All your efforts end with you stuffed further into the cunt of the Behemoth holding onto you though, so you can only grunt and begrudgingly wait for the thing to finish before trying to make your way out. This sadly ends up with you panting and gasping minutes later as the head of the mutant cock rocking forward at your chest sinks you deeper and deeper into your warm home, almost up into the womb of the Behemoth you're trapped in.";
				say "     The moment when everything comes to an end though comes when the Behemoth dominating the one imprisoning you hilts within the submissive beast and then freezes into place before roaring loud enough for you to hear it from inside of the cunt your stuffed up into. When a small flood of warm male nectar floods over you, you have to hold your breath to keep from drowning as you are literally washed in the mutant's cum. To make matters even more complicated you find the vaginal walls of Behemoth holding you flexing around your body and then contracting, hugging you almost impossibly tight. When another bellowing roar sounds off around you, you only have a minute to curse you luck before you find a deluge of feminine honey mixing in with the male seed pooled all around you.";
				WaitLineBreak;
				say "     If you weren't holding your breath you might have been slightly taken aback by the scent of both male and female musk cloying at your nose. You probably would have even passed out from the almost suffocating mix of sexual odors wafting around you, however, because you are trying to stop yourself from breathing you miss out on this little wonder of wonders. Yet you cannot miss out on the dominant Behemoth pulling itself out of your submissive captor, thereby opening a small passageway for you slip free through. Flowing out of your subjugator and onto hard earth you find yourself getting drenched in the twin juices of the two Behemoths as the cum from the dominant mutant and the fluids from the other rain down over you from where you are laid flat out across the earth. Neither mutant seems to notice you presence, both are currently nuzzling and purring at one another while their respective sexes drip their sexual liquids onto the ground, and because of this - just as soon as you regain your breathe and see around the milky film covering your eyes - you shakily crawl your way out of the large cavern area you have been brought into and then out into the world.";
				decrease humanity of player by 10;
			else:
				say "     Trapped inside of the hot folds of the Behemoth you don't know how long you are kept prisoner inside of the lustful mutant, however, what you do know is that the other has no problems using you for its pleasure as its nethers flutter around your [bodyname of player in lower case] body while its cervix draws you deeper into itself. When two clawed [']fingers['] make their way inside of the heated cunt of the beast you don't try to fight as you are rolled around side to side and then pushed back and forth inside of the Behemoth as it incessantly rubs your form across its vaginal walls. Thick honeyed fluid leaks out over you, but you can do nothing to enjoy this as the beast maneuvers you harder and faster inside of itself as it works its hardest at trying to get off. The heavy scent of female musk makes you feel somewhat dizzy as your grow lightheaded from the smell, but again, there isn't much you can do about this situation.";
				say "     Minutes of using your smaller form as a sex toy finally ends when the Behemoth's cunt squeezes vice tight around you signaling the beast's oncoming climax. The bellowing roar of the other sounds off the Behemoth's orgasm and soon you are a washed in the feminine juices of the mutant. The molten hot liquid feels as though it could almost scald, but not quite as the Behemoth cums and cums, leaking enough juice out of itself that you can actually swim in it. Forcing your way up the creature's pussy, once those annoying fingers remove themselves from the only opening leading out, you aren't ready for the Behemoth to suddenly turn itself over and then dump you out onto the ground when it stands itself up.";
				say "     Getting discarded out onto the hard ground is not anything like what you would call pleasant, but it pales in comparison to the Behemoth spreading itself legs wide and then letting itself go right on top of your head with a savage grunt of pleasure. The sticky shower that covers you is just degrading enough for you to find erotic as you stick your tongue out while rolling around in the slime now covering your body. It doesn't take long for the Behemoth to finish its orgasm and once it is done it lumbers away from you off to someplace else, leaving you to deal with the mess it just made. Strangely enough you find yourself okay with this.";
				decrease humanity of player by 10;
		else:
			say "     Batted into the air like a toy you are not ready for the Behemoth to flip itself over and then raise its four foot long cock directly up at you. When the split at the head of black monolith of flesh gapes open slightly you find yourself yelling out loud as your [facename of player in lower case] face meets the fleshy hole of the Behemoth's dick. Half of you is instantly drawn into the mutant's cock and just when you think that the situation can't get anymore degrading you find yourself being proven wrong when a firm and unyielding set of fingers grabs you by the legs and then forcibly stuffs you into the Behemoth's urethra. With the pulsing tunnel constricting around your body and literally pulling you into the beast, you can do little to calm your racing mind as you find yourself being drawn deeper and deeper into the Behemoth's cock.";
			say "     When the slimy constrictor holding you begins to move up and down you take a guess that the Behemoth is pumping at itself as the rocking motions going on around you pull you further into your new prison. Not helping any are the fingers that are stuffing you on down into the head of the creature's cock. When the digits working at your lower half pull back you have only a second or two to wonder why before you come to realize that you are now fully inside of the beast's cock. Pinned down as you are from all sides things only get worse for you as the slime of the Behemoth's precum well up around you, slicking your [bodyname of player in lower case] body enough so that your transition into the mutant's long fleshy length become smoother as you slip deeper down into the tight tunnel. So much so that when your head presses up next to something firm and unforgiving, yet fleshy and smooth you find yourself not ready to be sucked into a whole other dimension of the Behemoth.";
			say "     Being drawn into the right testicle of the mutant is an experience like no other as your body is quickly swallowed up into the musky orb of flesh and then churned around like butter as the Behemoth continues to pump at itself. Not knowing what to do or what to think you find yourself somewhat in shock as you float inside of the slowly filling ball of flesh holding you securely into place. The fact that it's pitch black and you are currently getting horny is not helping matters at all.";
			WaitLineBreak;
			if a random chance of 1 in 2 succeeds:
				say "     When the rocking motions stop you think that everything is about to come to an end, but instead you find yourself very wrong. So very wrong. Had you known what was now happening outside you might have wished that the Behemoth simply just jacked itself off and then, hopefully, shot you back out of it with the rest of its cum. Instead, because you don't know, you have no idea about how another Behemoth has come from the backside of the one imprisoning you and now is rubbing itself steadily against the greenish-blue hide of the beast now stinking with lust. All you know is that, minutes later of being trapped in here, your world is suddenly shifted around as vertigo takes over.";
				say "     The heavy bout of rocking and shifting and moving that comes later does nothing to help you out of your situation as soon you find yourself being bounced around like a ping-pong ball as your fleshy home is slapped against the underside of the Behemoth that has enticed your captor. Being knocked around and having the Behemoth's cum sloshing around your body your entire form ends up becoming drenched in the mutant's seed. This doesn't seem to do much at first but it does make your form a little more gooey feeling and there more soluble as more and more minutes pass by. Again, this is proves to be nothing that either helps or hinders your situation, or so you think, until almost twenty minutes afterwards when something different happens. All motion suddenly ceasing causing you to sigh in relief as you think that the [']ride['] is now over with, however, when a bone jarring roar echoes throughout the body of the Behemoth right down into the testicle housing you, you find yourself shuddering and shivering without control as the cum around you suddenly begins to churn like crazy.";
				say "     As an upward series of movements begin, you're not sure what is happening until you are suddenly pulled from where you are, through the seminal track of the Behemoth, and then shot out of its cock into the other Behemoth. Going from one place to another is a somewhat surreal trip for you, but not as surreal as finding yourself stuck inside of the anus of another Behemoth. Hot, musky, and uncomfortably tight you find yourself trapped inside of the cum soaked depths of the other beast as the one who had been holding you continues to flood its companion with several long and creamy blasts of hot seed. Everything stops almost three minutes later, though by this time you are so unaware of what's happening that you feel as though you have been lost in a daze.";
				say "     When the two beasts finish their mutual sexual tangent you end up spending another couple of minutes being painfully squeezed by the thoroughly used anal muscles of the submissive Behemoth as the creature shivers in delight from its sexual high. You can only guess that the other has cum as well. Once the moment is over though the new Behemoth you are trapped in relaxes its muscles allowing you to drip out of its used tailhole down onto the hard ground beneath the mutant's muscular body. Falling with a slight splatter you don't take mind to the cum flowing out of the beast raining over you as your thoughts are too far gone in twisted sexual bliss to notice anything happening around you.";
				say "     The two Behemoths pay little mind to you either as the one who had just been fucking the other leans down to clean its seed out from the tailhole of its receptive partner. Your eyes faintly notice how the large and prehensile tongue of the dominant male licks the other clean, but you pass out before you can get a good look at what's happening above you. FYI - it takes your body almost an hour to regenerate itself back into full solidity after having gone through such an experience.";
				decrease humanity of player by 20;
			else:
				say "     Inside of the darkened sphere of flesh you find yourself becoming somewhat stickier as the gooey cum of the Behemoth works to break you down against your will. Fearing that you may indeed become nothing more than mutant cum you struggle to try and get out of your prison by kicking and punching at the walls of the pitch ball orb. Your efforts only serves to make the Behemoth thrust its hips up into its paw-like hand as the sensations of you going crazy inside of its sensitive testicle sends the beast's mind into a lustful haze. Stroking and pumping at its cock with hard and fast strokes the Behemoth's balls clench up towards its body, thereby revealing itself feminine sex to the world, taking you with it by proxy. The heat and scent and feel of yourself becoming more and more like cum has your mind losing focus of its original goal and soon you are simply struggling just from the heat stifling your breath as the musky scent air cloys inside of your lungs making your head feel very light all of a sudden.";
				say "     It takes another minute before things come to an end, but thankfully when it does the Behemoth roars and then pump its hands down onto its long length once more before driving its hips upwards into the air and then cumming hard. With you as somewhat viscous and slimy as you are now you easily slip up through the beast's seminal duct out of its urethra and then over the top of the Behemoth's head. Several sloping arches of cum follow after you and thankfully help to cushion your fall onto the ground as you end up slamming into the grass just hard enough that the wind is knocked out of your lungs. Thankfully enough these important organs, as well any of the other integral parts of you inner system that you would need later, have yet to jellify.";
				say "     Having gone through such a massive ordeal you find yourself collapsing just as the Behemoth in front of you finishes with its orgasm. The beast takes only a few minutes to shiver and then purr in pleasure from the intense orgasm you just helped it out with, but once the beast has gotten control over itself again it pulls its paw-like hands away from its still spurting cock, rolls itself over onto its hands and feet and then gets up to go about its way as if nothing had happened. The Behemoth takes very little interest in you as it pads off about its business, and a good thing to because it takes an hour before your body can solidify itself back together again.";
				decrease humanity of player by 10;

to say BeatTheBehemoth:
	if inasituation is true:
		say "     "; [dealt with at the event source]
	else:
		say "     Knocking the Behemoth down with an impressive attack you watch as the mighty titan falls onto its side and then lets out a rumble of a roar as it sounds off its defeat.";
		if libido of player > 40:
			say "     Because you have subdued the Behemoth you could take this chance to reveal in your victory over it, but because of the difference in its size compared to yours there's not a lot you can do to sexually [']tame['] the beast. But then again, if you want, you could fondle it some and maybe tease it into orgasm. Do you want to?";
			if the player consents:
				say "     Making the decision to have some fun with the big brute you go over to the quietly panting beast to see tease it. Should you play with its balls and cock or its cunt? (Y=cock, N=cunt)";
				if player consents:
					say "     Noting the full testicles of the Behemoth you find yourself walking over to the fleshy orbs of the beast and then reaching out to hug them and thereby caress them with the front of your [bodyname of player in lower case] chest. Hugging against the massive orbs you run your tongue over the two foot wide spheres while sniffing over the musk laden sac of flesh housing them. Grinding yourself against the massive cum factories you listen as the Behemoth moans and purrs in bliss while keeping a careful eye out for any suspicious movements or gestures that may come from the beast. Seeing none forthcoming you continue you motions, squeezing and dancing yourself against the Behemoth's low hanging orbs before moving on up to where its cock is extended out from between its legs.";
					say "     Watch as the low hanging piece of flesh literally sprays the ground with precum, and suddenly feeling dreadfully thirsty at the moment, you go over to have a drink of the beast. Running your tongue along the deluge of clear liquid you find that the taste of the Behemoth is thick, but tasty enough to quench your thirst as you dig your tongue into the head of the four foot long cock. Pulling your face back just moments after your stomach has said [']enough['] you reach forward with your arm to run it through the gaping slit of the Behemoth's pulsing dick.";
					WaitLineBreak;
					say "     Hot and flowing like water from a hydrant you wiggle your fingers around inside of the mutant's urethra while pumping your arm back and forth in order to [']sound['] the other in way that it has never been before. Up above the beast moans and churrs as your efforts stimulate it to the point where it slowly rocks its hips back and forth into you in order to bring itself to full orgasm. Twisting your arm around you try to look for just the right spot necessary to send the other off into a spectacular climax, but sadly don't seem to locate it. The Behemoth seems not to mind this though!";
					say "     Grunting and bringing up your second hand to slide it into the tip of the beast's girth you roll your arms around, sliding them side by side and then up and down throughout the Behemoth's cock, until finally, with an earth shaking roar, the mutant jerks and then throws its head back to roar loudly at the sky. The force of the first shot of Behemoth cum sends you flying back as the white bullet slams you dead center into the chest. Grunting as your back meets the ground you find yourself coughing and then sputtering as your body is polished down with the next dozen or so shots of the Behemoth's cum. The mutant begins to move his hips after the second shot and soon the beast is all but rutting against the ground as it pumps itself at you like a dog in heat.";
					say "     When the Behemoth's orgasm finishes up you find yourself drenched in its white musky cum, but you come to realize that you are not all that mad about this as you roll the hot and gooey mess around all over your face, chest and neck. Down between your thighs your [if player is male]cock[else]cunt[end if] throbs with need and quickly you stick a hand into your pants and then tease yourself into orgasm along with the Behemoth. Letting out a bestial roar you cum and cum and cum until there's nothing inside of you left to give. Because of your stamina though you keep from passing out, ironically this also keeps you from missing the sight of a massive tongue coming at you. It would seem that the Behemoth wants to thank you for your efforts and benignly you allow the other to do as it wishes, but you make very sure to be careful in case that the other's intentions change. Thankfully, they don't.";
					infect "Behemoth";
				else:
					say "     Smelling the scent of the other's feminine sex you walk over around to the backside of the beast in order to get at the tantalizing pussy of the other. The Behemoth, slightly dazed from you having literally beaten sense out of it, is somewhat confused by your actions, but that only lasts until the beast realizes where you're about to go. When it whips its massive maned head around to have a look at you, you don't bother to hide you intentions as you press yourself face first into the gaping cunt of the sixteen foot mutant. Moist and warm and oozing with juice, these are the truths you reveal in as you nuzzle your [facename of player in lower case] face into the winking nethers of the Behemoth's pussy.";
					say "     Stinking of musky male sex from the twin testicles keeping it from hidden from view you shove those fat orbs to the side before diving your face into the folds of the Behemoth's vaginal lips. The mutant you are sexually teasing seems not to have a problem with what you are doing, especially when you run your face along the length of the larger beast's inner walls. Slick with honey and fragrant with a tantalizing odor of feminine juice you suck at the fleshy walls while bringing your hands up to roll your [bodyname of player in lower case] fingers up and around the outer walls of the Behemoth's pussy. Your actions get a pair of grunting groans from the mutant as the inner folds of the beast's flutter around your head, trapping you somewhat. Not minding this in the least, since you are in a safe enough place to get out if need be, you continue to masturbate the creature with liberal pleasure.";
					WaitLineBreak;
					say "     Minutes of teasing the beast later finds your face literally sloshing around in the muck of the Behemoth's fluids as your sense of smells and taste have all but become embellished in the rapture that is eating the bestial mutant from the inside out. When a pair of fingers cross your back and push you in just a little closer you don't fight them, not even when your head pops fully into the other, not even when the upper part of your chest sinks into the feminine folds of the mutant. You don't even bother to struggle when your entire body is treated to the paradise that is the Behemoth's cunt as all of you slips into the beast.";
					say "     Because of its fatigue, or maybe because you are pleasuring it so well, the Behemoth doesn't try to do anything more once you are full inside of it, save for roll its hips around as it allows you to do as you please. Moving around arbitrarily while spreading your arms wide and thrusting your hips into the flesh walls surrounding you, you find yourself coming into orgasm just as the Behemoth is about ready to reach its own. Both you and the beast end up climaxing together though as you, with a teasing hand, reach outside of the mutant to tease at its clit sending raw waves of pleasure coursing throughout the Behemoth's body.";
					say "     When the other cums its honey slick fluids literally ooze around you, slowly forcing you out of the creature, as it creams itself all over you. You in turn gasp and drink down as much of the beast's nectar as you can while cumming yourself as you [if player is male]cock shoot cum inside of your pants[else]cunt clenches and then gushes juice down between your legs[end if]. After such an extreme climax your legs wobble and then finally give out seconds after sending you careening onto the ground in a dull thump. A playful tongue slips and slides across your body at that point, and upon looking up you find your Behemoth playmate licking across your soaked [bodyname of player in lower case] form in an attempt to clean you off. Perhaps you should play with the other again when you have some extra time. If you're strong enough that is.";
					infect "Behemoth";
			else:
				say "     Having bested the great giant you turn away from it to go about your way.";


Section 2 - Monster Insertion

Table of random critters (continued)
name	attack	defeated	victory	desc	face	body	skin	tail	cock	face change	body change	skin change	ass change	cock change	str	dex	sta	per	int	cha	sex	HP	lev	wdam	area	cocks	cock length	cock width	breasts	breast size	male breast size	cunts	cunt length	cunt width	libido	loot	lootchance
--	--	--	--	--	--	--	--	--	--	--	--	--	--	--	--	--	--	--	--	--	--	--	--	--	--	--	--	--	-- 	--	--	--	--	--	--	--	--;

When Play begins:
	Choose a blank row from Table of random critters;
	now name entry is "Behemoth"; [ Infection/Creature name. Capitalized. ]
	now attack entry is "[one of]The Behemoth attacks with a bellowing roar, all but destroying your eardrums![or]The Behemoth sweeps its massive clawed forepaw into you sending you corkscrewing across the ground![or]The Behemoth batters with a mighty charge, knocking you across the ground![or]The Behemoth spins around to strike at you with its gargantuan tail![or]The Behemoth slams it forepaws into the ground causing and earthquake to upset your balance. It then flies into you to knock you into the ground![or]The Behemoth charges at you, hitting you directly into the chest with its toughened skull![at random]"; [ Successful attack message ]
	now defeated entry is "[BeatTheBehemoth]"; [ Text when monster loses. Change 'Behemoth' as above. ]
	now victory entry is "[LoseToBehemoth]"; [ Text when monster wins. Change 'Behemoth' as above. ]
	now desc entry is "[BehemothDesc]"; [ Description of the creature when you encounter it. ]
	now face entry is " lightly tinted with a greenish-blue hue with a long and angular muzzle, filled with twin rows of jagged fangs, protruding from the end of your face. With two sixteen inch onyx curved horns jutting out from your scalp, a shaggy white mane extending around your face and down to your back, fierce golden-orange almond shaped irises centered into your pitch black eyes and a pair of furry tri-pointed ears flicking back and forth beside both of your horns you are a fearsome-looking beast indeed"; [ Face. Format as Your face is [face of player]. ]
	now body entry is "stacked on with massive muscles and thickly corded sinew. Because of your body's new physique you have acquired a slightly hunched over posture, symbolizing a better aptitude for you to walk and run on all fours instead of on two feet. Yet because of the density of your newly thickened bones you are able to walk without lumbering...too much. With your bestial eight foot frame there is no denying your ferocity as you now boast sharpened claws at the end of your four fingered hands and at the tips of your three toed feet. To complete your new body you now have two pure white fin-like wings, complete with greenish-blue membranes, fluttering at your backside"; [ Body. Format as "Your body is [body of player]." ]
	now skin entry is "a toughed hide of light greenish-blue"; [ Skin. Format as "Looking at yourself, your body is covered in [skin of player] skin." ]
	now tail entry is "Your rump is dense with muscle, but strangely enough very shapely with the six foot long, two foot thick tail waving around in back of you. Lightly coated with white fur, your restless extension supports several thick spikes running from the base of your fifth appendage up to the point where your extended spinal column meets your lower back."; [ Ass/Tail. Write as a full sentence (with period) or leave blank for none. ]
	now cock entry is "monstrous"; [ Cock. Format as "You have a 'size' [cock of player] cock." ]
	now face change entry is "your head shifts outwards gaining both depth and added dimension as your skull and facial muscles painfully rearranges themselves. The onset of two long nubs, the beginning of horns, protruding out of your scalp doesn't help anything as your skin breaks apart to allow the new growths to come in. When an irritatingly itchy sensation runs throughout your face and neck things seem to be about to get much worse, but before they can the feelings turn rather ticklish as fur begins to grow out from your head down the side of your back and then around your face and neck"; [ Face TF text. Format as "Your face tingles as [face change entry]." ]
	now body change entry is "the contents of your stomach twist and turn as whatever fat you have stored inside of your body gets burned away with the inception of your growing musculature. Dropping to the ground you bellow out a wail as your arms thicken, your legs bloat, your calves swell and your back arches and pops from every single bone under your neck extending and thickening while muscles over muscles harden and balloon outwards across your expanding form. Your hands and feet aren't spared from this uncomfortable change as your fingers meld into one another, giving you a pair of four fingered hands, while your toes mold into each other until you have a pair of three toed feet"; [ Body TF text, format as "Your body tingles as [body change entry]. ]
	now skin change entry is "your flesh tightens and then thickens while turning greenish-blue in coloration. It's only after your new hide has finished its contraction that your skin lightens to an almost translucent looking greenish-blue color"; [ Skin TF text, format as "Your skin tingles as [skin change entry]. ]
	now ass change entry is "the weight within your glutes shifts and then bulks while your spine spears outwards with the beginnings of your new tail. When your new addition begins to grow thick and heavy with extra weight you find that you have to angle yourself at a slightly sloped over position in order to dispense the heaviness your tail presents as it sways peacefully behind you. It doesn't help matters when white fur starts to grow out from the tip of the tapered end only to be followed by a single row of spikes breaking out from the skin of your fifth appendage trailing down from your lower back to the tip of your tail"; [ Ass/Tail TF text, format as "Your ass tingles as [tail change entry]." ]
	now cock change entry is "it engorges with new bulk while rounding at the head to give you an almost bulbous tip. When the veins on the length of flesh begin to darken to an almost black color you worry slightly, but then calm down once you watch your entire shaft become pitch black."; [ Cock TF text, format as "Your groin tingles as [cock change entry]." ]
	now str entry is 32; [ These are now the creature's stats... ]
	now dex entry is 25; [ ...and are only altered onto the player via Shifting or the Mighty Mutation feat ]
	now sta entry is 30; [ These values may be used as part of alternate combat.]
	now per entry is 20;
	now int entry is 22;
	now cha entry is 10;
	now sex entry is "Both"; [ Infection will move the player towards this gender. Current: 'Male' 'Female' 'Both' ]
	now HP entry is 240; [ The monster's starting HP. ]
	now lev entry is 20; [ Monster level. (Level x 2) XP for victory. (Level / 2) XP for losing. ]
	now wdam entry is 35; [ Monster's average damage when attacking. ]
	now area entry is "Plains"; [ "Outside" "Mall" "Park" "Beach" etc... Check an existing creature in the area. ]
	now cocks entry is 1; [ Number of cocks the infection will try to cause if sex entry is 'Male' or 'Both'. ]
	now cock length entry is 18; [ Length infection will make cock grow to if cocks. ]
	now cock width entry is 10; [ Cock width, more commonly used for ball size. ]
	now breasts entry is 0; [ Number of nipples the infection will give a player. ]
	now breast size entry is 0; [ Size of breasts the infection will try to attain. ]
	now male breast size entry is 0; [ Breast size for if Sex="Male", usually zero. ]
	now cunts entry is 1; [ The number of cunts the infection will try to cause if sex entry is 'Female' or 'Both'. ]
	now cunt length entry is 16; [ Depth of female sex the infection will attempt to give a player. ]
	now cunt width entry is 10; [ Width of female sex the infection will try to give a player. ]
	now libido entry is 90; [ Target libido the infection will rise towards. ]
	now loot entry is "behemoth horn"; [ Dropped item, blank for none. Case sensitive. ]
	now lootchance entry is 25; [ Percentage chance of dropping loot, from 0-100. ]
	now scale entry is 5; [ Number 1-5, approx size/height of infected PC body: 1=tiny, 3=avg, 5=huge ]
	now body descriptor entry is "[one of]indomitable[or]ginormous[or]monstrous[at random]"; [ Ex: "plump" "fat" "muscled" "strong" "slimy" "gelatinous" "slender". Use [one of] to vary ]
	now type entry is "bestial"; [ one-word creature type. Ex: feline, canine, lupine, robotic, human... Use [one of] to vary ]
	now magic entry is false;
	now resbypass entry is false;
	now non-infectious entry is false;
	blank out the nocturnal entry; [ True=Nocturnal (night encounters only), False=Diurnal (day encounters only), blank for both. ]
	now altcombat entry is "default"; [ Row used to designate any special combat features, "default" for standard combat. ]

[A sample structure for succumbing/surviving messages at the end of the game.]
[Numerous other examples can be found in existing creature files.]

Table of Game Objects (continued)
name	desc	weight	object
"behemoth horn"	"A large piece of a behemoth's horn that was knocked off during battle."	1	  behemoth horn

behemoth horn is a grab object. It is part of the player. Understand "horn" as behemoth horn. behemoth horn is infectious. The strain of behemoth horn is "Behemoth".

instead of sniffing behemoth horn:
	say "     The scent coming from the behemoth horn is heavy with musk, both male and female, and some filled with pride.";

The usedesc of behemoth horn is "Taking the behemoth horn and rolling it around inside of your hand you find you have the sudden strange urge to place the onyx piece of bone up against your skull. Not seeing any reason why you shouldn't, you place the horn on top of your head, right between your scalp and forehead. When nothing immediately happens you shrug and think nothing more of it, but when you remove your hand and then horn continues to stay in place realize that something is about to happen to you. The onset of a throbbing in your skull and at your backside are definitely clues towards this assumption as you find yourself grunting somewhat in discomfort as your body goes to shifting around on its own.";


when play ends:
	if bodyname of player is "Behemoth":
		if humanity of player < 10:
			say "     With your mind becoming lost to the infection strain of the Behemoth running throughout your body you find yourself growling and roaring without knowing why before taking off towards the plains. By the time you get there any other infection has ran its course out of you and now you are another sixteen foot long behemoth like the rest of your brethren.";
			if player is male:
				say "     However, after finding a large brood of other Behemoths you find yourself quickly getting challenged by the lot so as to you decide your place within the ranks of their disheveled pecking order[if strength of player > 20]. With your strength you are able to suppress them all and thereby force them to accept you as their sovereign, after rutting each other them in turn that is[else]. Since you prove to be so much weaker than them you are made into a lower brother who is thereby taken by the rest both forcibly and painstakingly for days to months on end[end if].";
			else if player is female and cocks of player < 0:
				say "     Being that you are a pure female the Behemoths find you to be almost irresistible to them and go to working quickly and efficiently trying to draw your attention towards them so that you will lift your tail for them. This proves to lead to a lot of fights, but because you are female you stop the fighting by knocking each of the silly males aside and then forcibly mounting each one of them in turn once they are subdued underneath you.";
		else:
			say "     Having survived the [italic type]pandemic[roman type] that had spread throughout the metropolis you find yourself being picked up by the military after one of their sweeps throughout the city. At first, the uniformed men and women don't know what to make of you, given your size, build and overall terrifying nature - smiling and reassuring the others with the assurance that you are only scary [']looking['] does not help you any as your gleaming fangs make most hearts go to shuddering. However, upon going through the tests for the scientist employed by the unknown faction trying to get a handle on things, you come to be considered non-lethal, though not exactly noncontagious, to all of the people around the bunkers the military has setup into place around the city. Non-lethal turns to beneficial after you take on several out of control mutants for the soldiers after a strange wave of assaults begin to upset the order of things within the military's ranks.";
			say "     Because of your body build you end up handling most of the trouble that the military can't. This makes the officials commanding the operations desperate to gain your aid for their side, but after thinking things over you decide not to stick around to help, especially after hearing what goes on behind closed doors within the bunkers. Apparently, the reason behind the attacks set forth by the other mutants happens to be that numerous mutants had been taken from their respective [']homes['] in order to be tested on - it goes without saying that none of these people had given their consent to being guinea pigs and lab rats. Having found this out you work to counter you previous efforts for the good of the military as you rescue the mutants being kept against their will - with the help of some new friends on both sides of the field that is.";
			say "     This does not make you too popular with the military in the least, but as the uniformed soldiers come to find out, most bullets don't work on your toughed body too well. Though that one bazooka did slow you down, but after getting up and wiping the soot from your greenish-blue form you showed your attackers why using things like that on you is nothing to you, save a big mistake on their part. Bowling the armed men and women around like pins, swatting at the other's with your very flexible tail, and all out destroying several bunkers after charging through them like a raging oxen you free nine-tenths of the captured mutants before the commanders offer a cease-fire between you and their troops.";
			say "     After that, well you become something of a hero to the mutants still living within the city. From them on you work for the betterment of the rest of those still residing within the infesting metropolis along with the military, though with the latter being kept under heavily supervision by you and those not completely lost to their infections. This only last for about three weeks though as, out of the blue, several people from the [']Promethean['] organization comes to relieve you of the burden of duty. Once you see how these newcomer blokes are able to handle things here you decide to move after that as the world outside calls to you as never before. With your newfound body and instincts leading you it doesn't take you long to gather those who call you friend/lover/master up and then usher everyone away from the place of your [italic type]rebirth[roman type].";
			if player is male:							[MALE/HERM]
				say "     Sadly though, with you monstrous form not many people want to hire you for much of anything other than guard duty/construction jobs. This puts a slight damper on your hopes for the future in the days to come after departing the city, but before you can find yourself wondering over thoughts best kept in the dark, you come across another behemoth who offers you the chance to work for an organization not affiliated with either the Prometheans or the new governing body looking to rule the changed world. Skeptical at first, you find yourself coming to see what this newline of [']work['] is all about, particularly after the other Behemoth greases your palm with several million credits. When doing so though, you end up getting tangled in a web of conspiracy and insanity, the likes of something out of a bad B movie, as you find several of your kind being used as fodder for a super-soldier project.";
				say "     Least to say, this line of [']work['] doesn't go over to well with you, chiefly when the unnamed group tries to strap you down to a table and then [italic type]milk[roman type] you of your cum via tubes, wires, probes and a two foot long dildo machine. Breaking free and then breaking the bones of those who try and stop you, you show the people in charge the true fury of a Behemoth - the likes of which could almost be considered biblical - as you wreck everything and everyone in your way before making your way out of the newly destroyed facility. As the fates would have it though, you don't leave without taking a couple of [']souvenirs['] along with you.";
				LineBreak;
				say "     Apparently, this super-soldier project was creating artificial constructs/mutants from gathered genetic material of those who had willingly, or else, been roped into the scheme set into place back there. Having wrecked the megalomaniacal dreams of whoever was behind everything, plus beaten the tar out of the Behemoth that had tricked you into the entire situation, you end up finding a young Behemoth boy and several teenage Behemoth herms locked together inside of a white room on your way out. It was only natural for you to rescue them, but apparently it was even more natural for them to see you as their new [']master['] and follow you out without question. Despite the alarms, chaos, other madness happening as you bulldozed you way out of the hidden facility, you ended up getting out of the place relatively safely with your new brood. Taking the genetically constructed behemoths back to your home you hastily prepare yourself and your roommates to haul tail out of the new metropolis you had currently been residing in after a bad feeling has your teeth set on edge.";
				say "     Finding a new place to live turns out to be not a problem, considering the very lucrative remuneration you received from the Behemoth who had tried you rope you into the whole debacle in the first place. Yet, dealing with physically, mentally, and sexually enhanced teenagers does turn out to be something of a challenge as you come to realize that the Behemoths you rescued need a lot more [']care['] than what a normal youth might require when going through puberty. Fucking the lot of them turns out to be a moral conundrum that only lasts for about a week after you find each of them rutting each other outside of the large villa you ended up purchasing, hand over fist, from a less than honest landowner. It probably helps things along that many of your roommates have come to adore your [italic type]sons[roman type] and became sexual with them sometime when you weren't watching.";
				LineBreak;
				say "     Taking and being taken by the powerful behemoths become something of a workout that you can appreciate as the brawny mutants are able to take your massive girth into their respective holes with little trouble, something previous lovers have complained about in the past. The Behemoth boy you found, who you've come to name Samuel, the only non-herm of the lot, becomes something of a protegee to you as the other soaks up your attention and wisdom while teaching you things and showing you how to deal with problems in ways you hadn't thought of before. How the other bought and setup that gym equipment he had [']bought['] without you giving him any money is something you know better than to ask about.";
				say "     Working out, fucking, and just being [italic type]alive[roman type] dominants the rest of your life from them on. Yet, as many creatures do, your herm [']boys['] eventually grow wise enough to leave you to go off and see the world with their own eyes. This leaves you with something of an empty heart, though not for long though since Samuel decides to remain by your side. A fact made even more wonderful since Samuel always proves himself to be an excellent lover for you, despite you having [']raised['] him. However, as you come to find out later on, the rest of your brood doesn't happen to stray too far from home as the rumors of more and more behemoths mutants taking over the countryside you live in does reach your ears months afterwards your troupes departure.";
				say "     What's that old saying about sons again...";
			else if "Sterile" is not listed in feats of player:	[F-BREEDABLE]
				say "     Going out into the world you find that the nightlife of adult entertainment doesn't suit you as well as you thought it would, despite having tried and failed at getting a job working almost any other place, only to be turned down because of your bestial nature and appearance. Yet with the bills needing to be paid stripping and prostitution become something of a job to you, yet sadly enough, it's a boring one at that as you find most of your clientele too small to satisfy your almost depthless pussy. Even the stallions and elephants can't fill you up the way you want to be, something you idly chuckle over after they try their hardest to fuck you both good and proper. However, one night after finishing up work at the club you had been haunting, the Motif, as it were, you find yourself getting struck down as something runs against the back of the head hard enough to make you see stars.";
				say "     Because of your toughened skull you shake off the blow with ease and prepare yourself to turn on your would-be attacker, but when your pants are ripped down across your waist and your hips are taken into firm hands you stop and then wait to see what will happen next. When your unknown assailant stuffs a long and drooling piece of meat into the upper depths of your cunt you moan and then arch as your body sparks with sensual electricity, the likes of which you had been missing out on in the time during your working nights at the Motif. Grunting chuffs pour out from the other above you, and though you cannot see them, you can tell that they have met their match with your cunt as they drive your hips forward into the air while slapping very heavy balls against your taint.";
				LineBreak;
				say "     As time passes the thick and unyielding girth slamming into your pussy over and over works at making your body hot with desire and you end up panting without realizing before moaning as you fill your unnamed rapist filling you up with a massive load of cum, drenching down your legs and thighs in a veritable deluge of sticky male sap. When your assaulter thinks that they have finished, via them rapidly moving to pull out you, you show them else as you snap your prehensile tail around their legs and then toss them into the wall back behind you, knocking them out cold. Getting up and then popping your neck and shoulders you remove your coiled tail from around the unknown individual and then walk over to them to find you who/what you are dealing with. When you do you can't help but purr in awe at the figure you see before you.";
				say "     Young, by your standards, but deliciously gifted in the crotch department, you end up making a decision that changes the life of both you and your attacker, after debating the morality of your thoughts and feelings.";
				LineBreak;
				say "     Since you are already wet and ready it doesn't take much for you to grab the unconscious form of the other, strip [italic type]him[roman type] out of his clothes, and then press the head of your would-be rapist into your leaking cunt. Because of your counterattack the other doesn't wake up as you slide his head into your cervix, on up into your very empty womb. Pushing the other further and further up into you, you curl your assailant's arms into his black chest, his knees up into his stomach and then casually slip the rest of him into your body until only his tail is left outside. Toying with the other's appendage you wonder how it will look with horns on it, since it currently has none, before you shrug and then [']swallow['] it into your still gaping cunt.";
				say "     The weight of the other is great, but you don't have anything to worry about since walking on all fours is a technique you had long since mastered. Getting home proves to be no challenge to you as no one else comes along to try and bother you. Considering that you are a giant behemoth who in their right mind would... You smile as you think over this while feeling your insides churn around the contents inside of your womb. Arriving home your roommates are a bit surprised to see you with a full belly and try to question you like mad about the who, why and where of the situation however, being tired from the day and not wanting to get into too many details you give them the overview and then go to your room to rest. The stunned looks on the other's faces, you decide, will have to wait until tomorrow to deal with.";
				say "     Rubbing over your belly and playfully squishing at the heavy form getting [']rearranged['] inside of your body you smirk deviously as you wonder what you're new behemoth slave will look like. Even better, you wonder how big of a cock they will have once they've suckled from your tits and then grown into their full potential. After all, if what you had stuffed inside of your unwilling pussy just hours ago was any indication of things then your new pet is definitely going to be an enjoyable addition for you to have around in the days to come. A grunt purses free from your lips as the changing creature inside of your body gives you a swift kick. How adorable!";
			else:									[F-STERILE]
				say "     Going out into the world you find that the nightlife of adult entertainment doesn't suit you as well as you thought it would, despite having tried and failed at getting a job working almost any other place, only to be turned down because of your bestial nature and appearance. Yet with the bills needing to be paid stripping and prostitution become something of a job to you, though sadly, a boring one at that as you find most of your clientele too small to satisfy your almost depthless pussy. Even the stallions and elephants can't fill you up the way you want to be, something you idly chuckle over after they try their hardest to fuck you both good and proper. However, one night after finishing up work at the club you had been haunting, the Motif, as it were, you find yourself getting struck down as something runs against the back of the head hard enough to make you see stars.";
				say "     Because of your toughened skull you shake off the blow with ease and prepare yourself to turn on your would-be attacker, but when your pants are ripped down across your waist and your hips are taken into firm hands you stop and then wait to see what will happen next. When your unknown assailant stuffs a long and drooling piece of meat into the upper depths of your cunt you moan and then arch as your body sparks with sensual electricity, the likes of which you had been missing out on in the time during your working nights at the Motif. Grunting chuffs pour out from the other above you, and though you cannot see them, you can tell that they have met their match with your cunt as they drive your hips forward into the air while slapping very heavy balls against your taint.";
				LineBreak;
				say "     As time passes the thick and unyielding girth slamming into your pussy over and over works at making your body hot with desire and you end up panting without realizing before moaning as you fill your unnamed rapist filling you up with a massive load of cum, drenching down your legs and thighs in a veritable deluge of sticky male sap. When your assaulter thinks that they have finished, via them rapidly moving to pull out you, you show them else as you snap your prehensile tail around their legs and then toss them into the wall back behind you, knocking them out cold. Getting up and then popping your neck and shoulders you remove your coiled tail from around the unknown individual and then walk over to them to find you who/what you are dealing with. When you do you can't help but purr in awe at the figure you see before you.";
				say "     Young, by your standards, but deliciously gifted in the crotch department, you end up making a decision that changes the life of both you and your attacker, after debating the morality of your thoughts and feelings.";
				LineBreak;
				say "     By the time the other wakes up you already have him in chains and handcuffs while tied to your bed. Your roommate's strange looks will probably play in your mind for days to come, but you simply put those thoughts back behind you as you watch your [']rapist['] wake up from his inopportune nap. When he starts to bellow and roar at you to let him free you kindly tell him to shut up. When he doesn't and tries to struggle his way free of the binds you have over him you twist yourself around and slap him hard with the end of your tail. Having his head snapped around makes him shut up and calm down very quickly after that and soon you lay out the ground rules for him. Most of which consist of telling him that he is now your slave/pet for the rest of his life.";
				say "     When he tries to say speak up against this again you whip him with your tail, this time across his naked groin, which gets a keening wail out of the other. Eyes wide with fear the other has no idea of what kind of situation he has brought about, but you make sure to remind him. Again and again and again...as you spend the coming days thinking up sexy and fun ways to punish him for his transgressions. Least to say, having a twelve inch butt plug stuffed into his naked rump and then being made to go and get groceries with your roommates while naked and in a chastity belt proves to be just some of the [']fun['] ways you work at torturing your little pet. Let's not even talk about the time when you made him cross-dress and then sell himself out on the street corner near the Motif to a bunch of elephants and hippos that had once been a part of your clientele while you watched.";
				say "     The other never did really recover from that night and still shakes whenever you talk about that week you pimped him out. Of course you couldn't have just let him work out for one night alone, right? Of course you couldn't have!";


Behemoth ends here.
