Manticore by Kaleem mcintyre begins here.

"Adds a Manticore to Flexible Survival's Wandering Monsters table, With Impreg chance"

Section 1 - Monster Responses

when play begins:
	add { "Manticore" } to infections of guy;
	add { "Manticore" } to infections of furry;
	add { "Manticore" } to infections of tailweapon;


to say Manticore attack:
	if player is female:
		say "The lion-like beast lets out a roar loud enough to shake the surrounding world as he stands over your defeated form. Not believing that you could have lost to the beast, you are not ready for what happens next as the winged lion lowers his head to look down at you and then smile predatorily into your direction. Taking a thick gulp, you wonder just how bad this is going to be as you watch the mutant with the scorpion tail slowly pad his way over to you. Rust red fur puffing out because of his victory, you have about three seconds to think how much the other looks like an arrogant prick as he lets his black mane sway around him proudly before the manticore is pushing you back onto your back with a firm paw. Grunting as your back hits the ground, for a second time no less, you don't have the energy to struggle as the mythic creature tears you out of your clothing to reveal your nude body to the winged feline's lustful gaze. Clenching your legs together, you try and hide your leaking pussy as the manticore's blazing yellow eyes look you up and down. Growling at you with a savage rumble from deep within its throat, you can hardly stop yourself from growing more damp as the maned beast smirks at you again with a knowing look.";
		WaitLineBreak;
		say "Feeling the heated breath of the black maned beast blowing over and across your naked body, you aren't ready for the manticore's long scorpion tail to encircle around your waist and then lift you up. Blushing as the hardness of the manticore's tail scrapes somewhat pleasurably against your nude form, you can only moan when the big beast brings the both of your groins together and then thrusts his pelvis down into your feminine folds. The heavy sheath of the other, not to mention the winged lion-like creature's fat balls, press down into your crotch to show you just what you are about to deal with. You find yourself biting your lip when the barbs of the manticore's growing cock scrape over your cunt, the mythic animal beginning to slowly thrust himself against your juice box. The little nubs turn out to be much harder than you thought as the manticore ruts his hips along your lower body in an effort to get himself fully aroused. Once he is ready however, you find out just how thick and tough the nubs on the beast's cock are as the manticore buries himself into your pussy in one single unrelenting thrust. The pain of being spread open by a cock that belongs on a Great Dane rather than a feline makes you yowl like a cat in heat as you get taken by lion-like mutant without any regard for your well-being.";
		WaitLineBreak;
		say "Not giving you any time to adjust to his length, the manticore busies himself with thrusting inside of you long and hard as he slaps his fat orbs against your spread thighs. Grunting and purring into your face, you find yourself looking into the darkly glowing amber eyes of the other and seeing your fate as one of the creature's harem as he slips his cock back and forth inside of you with gaining fervor. Already you can feel your cervix starting to go numb as the barbs raking against the inside of your cunt make everything below your belly feel like jelly with every second the beast fucks you. The fact that your nethers are fluttering around the manticore's hard dick means little to the monster; he enjoys your suffering cries as you yelp and yowl while he pumps inside of you with almost bruising force. Like the true sadistic that the creature is, you feel him lean down to bite around your neck, rather than see him do it as your eyes are clenched so tight that stars dot your blackened vision. With wickedly sharp fangs clamping down onto your throat, the manticore grunts and then clenches down harder as he really starts to pile drive into you.";
		WaitLineBreak;
		say "Tail still holding you firmly up into him, the winged lion creature pushes as deeply into you as he can, not in the least worried over the fact that your insides are turning to gel as he spreads your cunt open into a greater width. Yelling out loud now, you can no longer deny both the pain and pleasure of this twisted moment, not like you could have done so before, as your legs spread out while resignedly accepting the manticore's ministrations. The lion-like mythical beast smiles knowingly into your neck as he pulls his teeth back from your throat, leaving small holes in his wake, and then punches his raspy tongue into your throat. Forcing you to choke on his wet and roving organ, the manticore grounds his balls into your body as hard as he can in the only sign that he is about ready to cum. You're completely unaware of this as you are currently trying to fight for breath; however, when the warm feel of feline cum surges into your pussy, you swallow around the manticore's tongue without thinking as your cunt clamps down on the beast. The liquid heat of the other's seed flooding into you makes you cum as well without meaning to, and in doing this the manticore smirks at you while [']kissing['] with all the passion a wild animal can muster as he dominates your mouth.[impregchance]";
		WaitLineBreak;
		say "Both fully screwed and tainted by the mutant, you don't think when your own orgasm hits just as the manticore's hips go motionless against your body. Screaming your climax into the other's muzzle, you have a second to see the mythic lion-like creature's eyes laughing down at you cruelly just before you feel the other's hips starting to dance wildly against yours again. Like a true lion, the manticore is able to have multiple orgasms before he tires, and in realizing this you know that it's going to be a long while before you are released from the beast's affectionless embrace. Had you been more conscious of the fact that the lion could have multiple orgasms, you might have worried over if you could get pregnant or not. Too little too late to worry about that now.[impregchance]";
	else:
		say "Making his way over to you with the quadrupedal stance that it's been holding all this time, the manticore moves with quiet grace in your direction. You feel yourself curse slightly as you know that the next moments to come are not going to be pleasant for you. The beast walks over to you and then buries his blunted nose down into the spread of your legs to smell you. Being that you are on your back from having taken too much damage in the previous fight, you don't have the strength to shoo the other away from your groin, and it's a sad thing too because when the manticore looks back up at you, you can tell he is not pleased. Sadly, it would seem that the rust red furred lion-like beast has a thing for pussy, ironic, and your lack of one has made him slightly annoyed with you. Not seeing what you can do about this situation at the moment, not that you would do anything to please the other if you [']could['] have done so, you are not prepared to be flipped over onto your front by the mutant's scorpion tail.";
		WaitLineBreak;
		say "When the feline creature takes a swipe at your clothes to reveal your naked rump to the world, you can only spare the second to blush before grunting when the lion presses his warm nose into your ass to sniff you over. Feeling the beast breathing in your less than feminine scent you wonder what the manticore will do next. You vehemently hope that the creature will just grow bored with you and run off somewhere. However, your wish doesn't come true when the manticore dips his flat, but broad tongue into your ass and then shoots the organ deep up inside of you. Hissing from the feel of the restless muscle roving through you, you blush somewhat as you think how hot this would be if you were doing this on equal terms. You have less than a second to feel embarrassed over this before the manticore starts to drill you with his tongue good and proper. Scooping up and down inside of your rectum you moan aloud as your prostate gets the kind of massage that you didn't think was possible as the small gland is poked, pressed and rubbed in ways that have you shivering and shuddering. The feeling of elation at the manticore eating you out doesn't last long because just as soon as it begins it ends.";
		WaitLineBreak;
		say "However, this doesn't mean that things end for you as the lion-like beast pulls out of your now-moistened rump and then hops up over your back with the aid of his ruby colored wings. When the full weight of the other crashes down on top of you, you don't fight the grunt that comes from your mouth at having to hold both yourself and the creature up. Silently you wonder if purposely collapsing would make the other decide you aren't worth the trouble of mounting. You find that your thoughts must have been heard, because the manticore quickly loops its long scorpion tail around your waist. Shuffling forward into you until you both are ass to groin with each other, the winged lion doesn't waste any time with foreplay as he presses his dark sheath and overly full nuts into the cleft of your rump. Not wanting this to happen, you try and clench yourself as best you can to make yourself tight, but a sharp set of fangs pinching around your neck let you know to relax... or else. Shivering and loosening your anterior muscles, you groan and then gasp when the manticore pumps himself to begin breeding you. At first you can't feel much because of the creature not being unsheathed from his furry pouch; however, that all changes as the mythic lion-like beast gets more and more into wanting to fuck you.";
		WaitLineBreak;
		say "Your pucker is not ready to feel the blunt wet tip of the manticore's cock trying to force its way into you with all the grace of a battering ram, and your rectum definitely isn't up for the challenge of bearing the blunt of the mutant's barbs snaking their way up through your tender tunnel as the beast's cock continues to harden to its full length. Yet the manticore doesn't really care. Being the victor, he is in his right to claim his spoils... namely you, and being the proud creature that he is, the creature wastes little time before he's rampantly thrusting into you, breaking your backside open wide as his massive girth fills you to the brim. Hissing when all of the lion-like monster's cock has entered you, you try and grip the other tight enough to stop his forceful thrusting into you, but only succeed in making him growl wantonly into your throat as he drives back and forth through your ass with building force. Fat balls slapping into your taint, the beast's tail coils just a little more tightly around you as the manticore pummels your rump with the kind of strength that you know is going to leave you with bruises later. The feel of the manticore's hard and spiked fur against your backside isn't helping to make this experience any better. You can only suffer in silence while trying to grip your hands into the ground hard enough to will your pain away as you are taken like a lioness.";
		WaitLineBreak;
		say "Grunting and purring into the side of your throat, you feel the lion-like creature's tongue slipping around your throat to tease you, and like a charm your body relaxes against your wishes. Not feeling any resistance now, the manticore thrusts inside of you hard enough that you actually fall face forward onto the ground. His fangs still on your neck as he follows you down, you almost swear that you can hear the other chuckling as he watches your despair dance freely inside of your eyes. Stifling a whimper, because you know that's what the monster wants to hear, you simply lay there with your ass in the air while rust red furry haunches buck wildly back and forth inside of your rump. The wet sounds of the manticore driving back and forth inside of you are the only sounds to fill your ears for several minutes as the winged lion takes you as one of his females. However, thankfully, the moment doesn't last longer than it needs to as the lion hilts and then pulls his muzzle away from your neck to roar loudly into the sky. You groan as your stomach becomes filled with the dregs of the beast's essence. Grunting to yourself, you feel your stomach slowly start to bloat as the manticore's load surges inside of you like a rushing river. You try your best not to move in hopes that the beast will finish as quickly as possible and then go about his business.[mimpregchance]";
		WaitLineBreak;
		say "Sadly for you, the manticore does finish within the next few seconds, but just as you think the mutant is going to go off somewhere to sleep off having fucked you, the lion-like creature leans himself back down over you and then nuzzles his snout into your neck. Not really thinking that it suddenly wants to be friends, you whimper and then cry when wicked fangs place themselves back into your neck right as the manticore goes at starting another round of fucking you again. Looks like it's going to be a long one before the winged feline is done with you.[mimpregchance]";
	infect "Manticore";

To say Manticore loss:
	say "In the confusion, the manticore ends up lying flat on his side as your last attack sends the other sprawling back to the ground. Growling in both pain and defeat, the leonine beast slowly gets up on shaky legs and then turns to regard you with something akin to disbelief on its impressively regal face. Rust red fur gleaming with sweat the beast shakes himself off before coming up over to you and then rubbing himself against your legs. Like a cat wanting its master's attention, it would see that the manticore has accepted your dominance over it... at the moment anyway.";
	say "     [bold type]The fight having both tired you as well as excited you, do you use the other for your sexual relief?[roman type][line break]";
	LineBreak;
	say "     ([link]Y[as]y[end link]) - Yes.";
	say "     ([link]N[as]n[end link]) - No.";
	if player consents:
		LineBreak;
		let pick be 0;
		if player is herm:
			say "Deciding that you want to know just how virile this lion-like creature is, you nibble on your lower lip while looking over its majestic form hungrily.";
			say "     [bold type] Which part of you should do you want satisfied by the beast?[roman type][line break]";
			LineBreak;
			say "     ([link]Y[as]y[end link]) - Cunt.";
			say "     ([link]N[as]n[end link]) - Cock.";
			if the player consents:
				LineBreak;
				now pick is 1;
			else:
				LineBreak;
				now pick is 2;
		else if player is female:
			now pick is 1;
		else if player is male:
			now pick is 2;
		if pick is 1:
			say "Shuffling out of your clothes you quickly kick your gear over to your side and then reach down to caress your wet snatch before looking down at the submissive beast. The manticore, looking at your gaping folds slowly dripping with juice, moves his head over to you to nudge his massive black maned head into your groin. Getting the idea you ease yourself down onto the ground and then spread your legs open, fully intent to enjoy everything this creature can sexually offer you. The glowing eyes of the other narrow before the manticore chuffs and then walks over to dip his muzzle down in between your thighs. The lion-like creature, just like his normal cousins, uses his raspy tongue to spread you open quickly and effectively as the roving organ moves up and down into you, seeking your hidden pleasure spots, thoroughly caressing your most intimate region as he does so. Hissing and then lying back fully onto the ground you slowly begin to buck your thighs into the other's chin, drenching the beast's chin with your leaking honey at the same time suffocating the manticore in the scent of your wet sex.";
			say "The manticore seems to take this in good stride though, after all you did defeat it in honorable combat. Licking and then drilling its tongue into your pussy, the winged lion reaches his scorpion tail around and then pricks you lightly onto the end of your thigh with the tip of his tail, making you eep slightly. Lifting your head up to glare at the other, you watch as the mythic lion-like creature backs himself away from you to smile, a surprising thing since his face really isn't built for it by human terms, with his wickedly sharp fangs just in time for you to suddenly feel as though you are on fire. Grunting and then groaning as your body ignites with the venom now coursing through you, you want to curse as your snatch suddenly starts to ooze with more juice than you thought was possible down the length of your legs. Feeling as though you could mate with a hundred and one lions at one time, you arch up onto the ground and then drop down to land in a heavy thump. Legs open wide like a yawning chasm, you don't have to wait long to be filled as the manticore walks over to you and then dips his hips down to spread your feminine folds open with his feline masculinity.";
			WaitLineBreak;
			say "The leverage is somewhat awkward for him since his body is so much higher onto the ground because of his quadrupedal stance. The manticore soon fixes the height discrepancy as he gently curls his scorpion tail around you and then brings your sweating body up to embrace his in an eternal dance. Rust red hips pushing into your [bodyname of player] body with unbelievably smooth and caring motions the manticore begins to mate you in an almost tender fashion as he stuffs his hard barbed cock into your body. Quietly the other leans down to lick you over the face, your eyes are partly shut so you can just barely make out the beast, before licking underneath your chin to show his acceptance of you. Thrusting heavy hips into your cunt the manticore jerks slightly when your legs come up to wrap around him, the monster hadn't been expecting such an action out of you in your current state. Huffing against your body almost breathlessly the beast continues to gently hammer his way inside of you with gaining force as you and he fulfill one another there on the ground. Shuddering from the feeling of them slapping against your taint, you have to marvel at how full the manticore's balls are as they grind heavily into your lower body.";
			say "For you, there is nothing but utter ecstasy at being filled so deeply by this beast's charging cock and for the manticore, the winged lion knows nothing but unbridled bliss as your nethers squeeze and massage along his feline length like a wet glove. Hissing between his teeth the monster speeds himself up and then starts to really have at you, though keeping in mind that you are not to be taken as forcefully as he could really fuck you. Bucking and thrusting against the lion-like creature you unconsciously reach your hands out to hold your lover around his thick black mane while continuing to ride him like a bucking bronco in order to bring the other's muzzle closer to you. The two of you become lost in each other as pure rapture of the moment courses its way up and down both of your spines. The rust red fur along the beast's backside fluffs up as he nears close to his completion and in wanting to share this with you the manticore growls loudly into your face, waking you from your slight daze. The venom singing through your veins can't hold you in intoxicated euphoria as you swim up the sea of pleasure to blink unfocused eyes at the manticore. Feeling him, in both your body and next to your face, you groan and then shudder as the barbs along his cock stroke you in just the right way to send you into climax, almost exactly that the same time the winged lion stills his hips and then roars up to the sky.";
			WaitLineBreak;
			say "Both of you shout your joy as you cum together, him into your belly with the silent hope that he can seed you, and you over and along his cock as your juicy honey splatters out and around the girth of his thick lion cock. When you both come down from your respective zeniths the manticore lowers you back down onto the ground, after commanding his tail to uncoil from out your waist. Feeling the other slip out of you as the mythic beast pulls his hips away from you completely you have a second to feel the monster lowering his head to lick out over your face before he turns and then darts away. Lying back on the ground, your snatch covered in manticore cum, you reach down to stroke a finger over your folds, and then down deep into them as you chuckle heartily while wondering if you'll get pregnant from this experience...[impregchance]";
			infect "Manticore";
		else if pick is 2:
			say "Seeing the docile monster in front of you, you stroke the other along the length of its black mane before running your hands down onto the sides of the lion-like mutant's rust red fur. Listening to the other grunt you smile predatorily right before you remove your hand to undress yourself. To the victor go the spoils, as you heard someone say once and in feeling your hard cock growing eager for the manticore you make yourself ready to take the mythic creature's tailhole as you stroke yourself with eager fingers. The manticore does not look pleased as he watches your [cockname of player] cock growing hard between your legs, but since it had been defeated in an honorable battle the lion wastes little time in griping inside of its head before it walks forward and then bends down to present its ass to you. Long scorpion tail moving out of the way the feline turns to look around his shoulder at you and then gives you a sultry growl before wagging its rump in your direction. Obviously someone has a strong subservient nature, you think before chuckling and stepping over to claim your prize.";
			say "Reaching out to stick several fingers up into the beast's black puckered tailhole you find that the manticore has an almost unforgiving tightness about his rump as you wiggle your fingers into the other's pucker. Hearing a rowl of pain from the other you pull your fingers out to spit on them before stuffing them back into your conquered foe. This time the manticore simply purrs around at you while looking at you with heated golden eyes. Seeing that the other is getting into the swing of things more you reach around inside of the lion-like creature to try and find its prostate. When you do however, the lion-like creature lets out a booming roar as you stroke over several small bundles inside of the manticore. Chuckling at the strange body design of the other you pump your hands back and forth over and across the other's multiple prostates, driving the winged lion somewhat insane as it scratches at the ground with its impossibly thick claws from the indescribable pleasure you're giving it.";
			WaitLineBreak;
			say "Taking several more seconds to play with your captive you listen to the beast yowl and purr and growl at you while shaking its black maned head around wildly before you decide that you've tortured the other creature enough. Pulling your hand out of the manticore's rump you look to find that your hand is covered in clear musky smelling fluid and you bring your hand up to sniff at your fingers. The first hit of the scent so close to your nose makes your head spin and then you begin to swoon slightly as your body feels as though its catching on fire. Like being given a shot of liquor and downing in one gulp you find your insides clenching up, your eyes watering and your cock growing impossibly hard as inhale the manticore's liquid pheromones. Licking your fingers and then shivering from the taste sizzling onto your taste buds you find yourself licking up the slimy clear fluid until nothing is left on your hand. Wanting another taste when there isn't any more you lower your hand to attempt to stick it into the manticore's rump, but before you can get a single finger inside of the other the winged lion's scorpion tail is pushing you forward into him. Seems like someone is eager to be fucked, you chuckle into the back of your lust clouded head.";
			say "Deciding that you can always defeat the beast again to get another taste you grab at the manticore's hips, shuffle your own thighs up into the lion-like creature's rump and then press the head of your cock into the other's tailhole. A hiss comes from the both of you when you pop yourself into the manticore with a somewhat unsteady thrust. The next few shoves of your groin into the beast's own are somewhat easier as the manticore eases up on the tension gripping at your shaft. When you are pressed flush against the other you find your breaths coming out in quick pants as you huff while holding tightly onto the spiky rust red fur of the winged lion's flanks. Grunting and then leaning down some to lay over the manticore's backside you find yourself pulling back until half of your cock has withdrawn from inside of the manticore, before pushing back inside of the other with a quick snap of your hips. The head of your cock manages to find two of the manticore's prostates on that single thrust and the beast nearly shakes the earth with his roar as he sounds out his pleasure to the heavens above. Knowing that you've now dominant the [']supposed['] king of beasts you really show the manticore what it means to experience unbridled pleasure as you fuck the monster like only a male could.";
			WaitLineBreak;
			say "Strong and furious are the words that define your thrusts as you pump your hips into the manticore's ass with growing force and speed. The fluids of the beast's pheromones coat your dick in a sticky film making things easier on you as you stuff your hips into the other over and over while grunting above the mutant. Not seeing it in your halfway dazed state you don't notice the winged lion curl his scorpion tail around the side of your shoulder and then prick your side with the tip of his appendage until it's too late. However, being already zoned out on his pheromones you barely notice when his venom starts to course into your already flush body. Sweat growing thicker with beads of moisture you growl between your teeth as you feel the heavy and thick nuts of the manticore tap into the end of your body. Without even having to look down you know that the feline's cock is probably just as rock hard as yours is and wanting to hear the other cry out in ecstasy for you, you thrust harder and more quickly into the mythic mutant.";
			say "The moment of passion between you both doesn't last long as you grip the manticore's flanks harder and then grunt as the telltale signs of incoming orgasm fly up your spine. Knowing that you won't be long in coming you bit down onto the lion's neck as best you can given the other's course rust red fur to stimulate a mating bite. Upon feeling your teeth buried into his back the lion-like creature raises its head and then booms out a roar so loud that both of your bodies vibrate as his cum shoots down onto the ground between both of your feet. The clenching vice of the winged lion's ass sends you careening into the arms of climax seconds later as you stuff the other full with your potent cum. Still jerking your hips around, even while spilling your own load, you release the manticore's back to roar your own shout of praise. When you both come down from your orgasmic highs you are the first to make a move as you pull back out of the manticore and then flop down onto the ground in exhaustion.";
			WaitLineBreak;
			say "Mouth panting hard from the exertion of your efforts you are almost caught unawares as the feline pulls himself up and around you to lick you across the face. If you could see it you would have noted how your cream is now liberally leaking out of the other, however, as it is now you are too busy patting the docile male on the head to really pay attention to this little fact. When the manticore leaves you behind you watch as the winged creature turns to wink at you before going off about its business.";
			infect "Manticore";
		else:
			say "Looking over the beast, you recall that you have sadly been stripped of gender and cannot properly enjoy the mythical creature's strangely alluring body. You run a hand across its tail and give its ass a swat, ending it on its way. It releases a soft growl at this, but does end up leaving.";
	else:
		LineBreak;
		say "Laughing in triumph for having defeated the winged feline you proudly stand over the other to puff out your chest while looking down at the manticore sitting before you in defeat. The rust red lion doesn't look all that pleased to have been defeated by you, however, it does bow its head to you before turning to leave to return to wherever it had come from. Probably to lick its wounds in preparation for next time, you think somewhat guardedly. Next time may be different, but you're sure that you'll be ready.";

Section 2 - Monster Insertion

Table of random critters (continued)
name	attack	defeated	victory	desc	face	body	skin	tail	cock	face change	body change	skin change	ass change	cock change	str	dex	sta	per	int	cha	sex	HP	lev	wdam	area	cocks	cock length	cock width	breasts	breast size	male breast size	cunts	cunt length	cunt width	libido	loot	lootchance	scale (number)	body descriptor (text)	type (text)	magic (truth state)	resbypass (truth state)	non-infectious (truth state)	nocturnal (truth state)	altcombat (text)
--	--	--	--	--	--	--	--	--	--	--	--	--	--	--	--	--	--	--	--	--	--	--	--	--	--	--	--	--	--	--	--	--	--	--	--	--	--	--	--	--	--	--	--	--	--;

When Play begins:
	Choose a blank row from Table of random critters;
	now name entry is "Manticore";
	now attack entry is "[one of]A quick strike of a clawed hand sends you reeling back![or]The manticore charges into you in an attempt to headbutt you![or]Roaring loudly the manticore makes you freeze for a split second![or]Using his powerful tail the manticore deflects you incoming attack and the counters with his own![or]Pouncing on you the winged lion savagely strikes you twice before moving off of you![or]Flying up into the air the manticore dive-bombs at you![at random]";
	now defeated entry is "[Manticore loss]";
	now victory entry is "[Manticore attack]";
	now desc entry is "[mongendernum 3]The beat of red wings has you looking around and then up for danger. However, nothing can prepare you for what you find as a large black maned lion with rust red fur and a long scorpion tail drops down onto the ground in front of you. Larger than a normal lion and covered in a spiky crimson pelt, the creature glares at you hotly while folding its large wings behind its back and then roars a challenge at you.";
	now face entry is "strong and angular, the likes of which you can be proud of as it shows off your leonine features. Rounded furry ears twitching curiously up above on your head, you possess a jet black mane framing the outer edges of your face to hide said ears from being seen by most. Narrow golden eyes look out to the world around you as your feline features jut out almost arrogantly at all those who would look upon your face"; [You have a (your text) face."]
	now body entry is "thrums with ancient power as the blood of the legendary manticore sings throughout your veins. With the quadrupedal frame of a normal lion, you stand almost half a foot taller than the average king of beasts as thick muscular legs hold up your powerfully built, if not slightly bulky frame. A pair of red, bat-like wings flap slightly against your back"; [ Body Description, format as "Your Body (your text)"]
	now skin entry is "[one of]rust red furred[or]spiky furred[or]a dense and course pelt covers your[at random]"; [ skin Description, format as "You have (your text) skin"]
	now tail entry is "Like the ancient manticores from ages past, you have a scorpion tail framing your backside, coiling tightly around your left leg. Stronger than the insect who is known for the appendage, your tail possesses a strange, mutated form of the normal manticore venom. Instead of normal poison, your tail tip can insert a strong aphrodisiac into your victims to make them susceptible to your advances, whether they want it or not."; [ Tail description, write a whole Sentence or leave blank. ]
	now cock entry is "[one of]leonine[or]barbed[or]lion-like[at random]"; [ Cock Description, format as you have a 'size' (your text) cock]
	now face change entry is "your features morph and reform into that of a lion-like muzzle. Course red fur covers your features from head to neck as your ears round until they are shaped like those of a lion's. An itchy feeling goes up and down your neck as more and more fur pushes out, but this time much darker than blood read as black fur surrounds your throat to become a new mane. Eyes darkening into a deep golden color your nose pushes out and then spreads until soon you have a manticore's face"; [ face change text. format as "Your face feels funny as (your text)." ]
	now body change entry is "your spine pops, distends and then reforms with the expanse of two red wings tearing free from your back. Over and around the course of your body your form expands, shrinks, twists and then grows as your legs no longer can support your newly quadruped stance and now must receive aid from your front paws. Shaking yourself as a light dew of rust red fur prickles up and out of your pores you give a roaring yowl of a cry as your body expands and then contracts with extra added padding of tissue, bones and muscle as your inner organs go to shifting around. By the time it stops you now have a leonine-like form, though much more densely packed with strength as well as untapped power"; [ body change text. format as "Your body feels funny as (your text)." ]
	now skin change entry is "a heavy cropping of rust red fur spills out and around your body to give you a dense pelt of armor-like fur that weapons would have a hard time breaching through"; [ skin change text. format as "Your skin feels funny as (your text)." ]
	now ass change entry is "your backside shifts with the incoming of new muscles, not to mention the lengthening growth of your scorpion tail pushing out from your spine. Gasping as the new appendage finally grows to its full length of some four and a half feet you moan as you feel something new being added inside of your body that wasn't there before. A new sac full of potent pheromones wafts out from your rear, the telltale sign of your readiness to mate as your scorpion tail wags behind your something embarrassedly"; [ ass/tail change text. format as "Your ass feels funny as (your text)." ]
	now cock change entry is "your shaft twitches and then flexes while thickening and then narrowing to become leonine in context. Small barbs push out along the head of your shaft, the proof of your heritage to the dominant feline clans in the world, while a thick pouch of flesh and fur bunches and the spreads to house your transformed maleness"; [ cock change text. format as "Your cock feels funny as (your text)." ]
	now str entry is 20;
	now dex entry is 19;
	now sta entry is 12;
	now per entry is 16;
	now int entry is 15;
	now cha entry is 16;
	now sex entry is "Both"; [ Defines which sex the infection will try and make you. current options are 'Male' 'Female' 'Both']
	now HP entry is 66;
	now lev entry is 10; [ Level of the Monster, you get this much HP if you win, or this much HP halved if you loose ]
	now wdam entry is 13; [ Amount of Damage monster Does when attacking. ]
	now area entry is "Plains";
	now cocks entry is 1; [ How many cocks will the infection try and cause if sex is 'Male' or 'Both']
	now cock length entry is 12; [ Length infection will make cock grow to if cocks]
	now cock width entry is 6; [ Size of balls ]
	now breasts entry is 2; [ Number of Breasts infection will give you. ]
	now breast size entry is 2; [Size of breasts infection will try to attain ]
	now male breast size entry is 0; [ Breast size for if Sex="Male", usually zero. ]
	now cunts entry is 1; [ if sex = "Female or both", indicates the number of female sexes infection will grant you.]
	now cunt length entry is 15;
	now cunt width entry is 10;
	now libido entry is 75; [ Amount player Libido will go up if defeated ]
	now loot entry is "";
	now lootchance entry is 0; [ Chance of loot dropping 0-100 ]
	now scale entry is 4; [ Number 1-5, approx size/height of infected PC body: 1=tiny, 3=avg, 5=huge ]
	now body descriptor entry is "[one of]winged[or]quadrupedal[or]strong[or]powerful[at random]";
	now type entry is "[one of]leonine[or]feline[or]mythological[as decreasingly likely outcomes]";
	now magic entry is false;
	now resbypass entry is false;
	now non-infectious entry is false;
	blank out the nocturnal entry; [ True=Nocturnal (night encounters only), False=Diurnal (day encounters only), blank for both. ]
	now altcombat entry is "manticore";


Table of Critter Combat (continued)
name	combat (rule)	preattack (rule)	postattack (rule)	altattack1 (rule)	alt1chance (number)	altattack2 (rule)	alt2chance (number)	monmiss (rule)	continuous (rule)	altstrike (rule)
"manticore"	retaliation rule	--	--	tailstinger rule	20	--	--	--	--	--

this is the tailstinger rule:
	choose row monster from the table of random critters;
	let rangenum be ( 80 - ( peppereyes * 4 ) );
	let dam be ( ( wdam entry times a random number from rangenum to 120 ) / 66 ); [+50% damage]
	if hardmode is true and a random chance of 1 in ( 10 + peppereyes ) succeeds:
		now dam is (dam * 150) divided by 100;
	if playerpoison is 0:
		increase playerpoison by 4 + ( lev entry / 5 );
		decrease plhitbonus by 2;
	else:
		increase playerpoison by 2 + ( lev entry / 10 );
		if playerpoison < ( 2 + ( lev entry / 5 ) ), now playerpoison is 2 + ( lev entry / 5 );
	say "The [one of]manticore[or]mythological monstrosity[or]hybrid monster[or]leonine creature[at random] lashes out at you with its powerful tail. The large stinger drives into your [one of]thigh[or]arm[or]shoulder[or]chest[or]side[or]hip[at random] and releases its toxic venom. As the poison courses through your system, the wound continues to hurt and you find yourself getting dizzy from its toxic effects. Already, your nanites are attempting to clear it from your body, but it continues to harm you for the moment. You take [special-style-2][dam][roman type] damage!";
	now damagein is dam;
	say "[bodyabsorbancy]"; [attack directed to body of player]
	if absorb > dam:
		now absorb is dam;
	if absorb > 0:
		say "You prevent [special-style-1][absorb][roman type] damage!";
	decrease HP of the player by dam;
	increase HP of player by absorb;
	follow the player injury rule;
	say "You are [descr].";
	choose row monstercom from the table of critter combat;


when play ends:
	if bodyname of player is "Manticore":
		if humanity of player < 10:
			if player is male:
				say "Feeling your mind going and subsequently taking you to someplace with far off sand dunes and towering mountains you allow your humanity to slip like water from between your paws as the rest of your body succumbs to mythic beast infection running through you. Now no longer feeling either remorse or fear you flap your wings and take off into the air, the need for a great challenge making your blood literally sing inside of your ears. You find this challenge partially in taking on other mutants that seem to be of equal strength to yourself, however, most if not all of these challenges turn out to be nothing more than idle wastes of your time as you dominate most of the anthros and other creatures with your unwavering strength and fierce battle prowess. Not feeling that any of them were worth of your attentions after defeating them you move on to other challenges. Yet the ones that you are able to be bested by you quickly find yourself sexually trying to tease and copulate with these few strong opponents in order to spread your seed around. Some of antics end up bearing fruit, most didn't, but such is the life for a manticore like yourself. It's only when you meet a certain [']person['] that things change.";
				WaitLineBreak;
				say "Human, at least for the most part, you wander across a slowly transforming male that seems to have the right kind of strength needed to keep you on your toes day in and out. Taking the person as your lord/master you end up staying with him even as he slowly yields to his transformations to become... something else. Not wanting this male to become nothing more than a droll sexual deviant, you sting him with your tail one night while he's sleeping in one of the motels that you and he had come across while on the road. The effect of your potent venom coursing through the other sets the transforming male off and then he shows you a side to himself that you would never have believed real. Growling and lifting his rump for you, you mount the changing man with your pointed feline cock and spend the rest of the night filling him with your cum. Over and over you take the other, breeding out whatever he was trying to transform into until you end up rewriting his genetic code so that the other becomes a manticore.";
				WaitLineBreak;
				say "Sadly though the process does not go exactly according to plan as when morning comes you find that the other is a lanky bipedal manticore that stands on two legs instead of four. It takes you a while to get over this, about as long as it takes the new mutant to get over having been fucked raw by you – something like two hours – and then both of you happily settle into the new changes that have come over your newly remade partner/rival/lover. Flying with the other, once his wings have grown in, turns out to be a marvelous pastime, but it's nothing compared to having the other underneath you as the bipedal manticore offers his puckered black tailhole to you whenever you and he aren't journeying to some remote location. Finding that taking your mate, as you come to call the other years later, is almost as divine as being taken by him, you don't see any reason to spread your seed any more as you now have a passionate lover to fuck both night in and out. However, that doesn't stop the cubs you had left behind, in the wombs of those you have now long forgotten, from coming to find you and then starting what will later become a strong pride of manticores.";
			else:
				say "Losing yourself to the pleasures of being a manticore you end up flying off somewhere one day, leaving the city of your rebirth behind, for greater horizons. You end up crossing several other strong opponents, all of whom you swiftly defeat the all in an attempt to find a strong male to breed you. At the end of your long search what you find is, not a male, but a herm defeating you one day with a long, magical trident. Bested by the imposing beast of a bipedal sea dragon, you find yourself submitting to the herm and then offering it your tail whenever the other wishes for it. The sea dragon is happy to take you as its mate/subordinate as you both you and it wander the land in an effort to seek out whatever greater challenges that this newly changed world might have to offer. Many times you both find yourselves having to lick each other's wounds as the battles you charge into prove to be just enough not to overwhelm the two of you, however, this always leads to restless nights filled with passion that nearly drive the both of you dizzy with madness. And yet, in your feral mind this is how it is supposed to be as the weak are claimed by the strong and then strong govern the weak to a greater experience than any they could have found on their own. What more could one ask for?";
		else:
			if player is male:
				say "When the military lockdown of the city is lifted, you have to all but fight your way out to your freedom as the scientists try to chain you down to look you over and poke and prod at you in the name of science. The scientists are eager to keep you for study and don't try to hide this fact in any way as they fill you with drug after drug while drawing blood and other substances out of you. Having so many mystical creatures pop up in the middle of this epidemic has thrust open the doors of both alchemy and science to new and unprecedented measures, however, that means little to you. Once you have had enough you rocket off into the skies and then wing your way into the outside world to look for a place to call home. Having a lion-like body as you do now you find yourself not welcomed in too many places, but that works for you as the need to be [']out['] sings through your veins like the song of a siren making you too restless to be in once place for too long. A strange scent calls out to you on the wind one day and following it you end up stumbling across a small town filled with other mythics and oddly assorted mutants who have fled from the outside world's prying eyes. Moving yourself and those who you have brought along from the city into an empty den just close enough to the small township, but far enough away so that your presence isn't seen as cumbersome to the rest of the town, you prove that you won't case any trouble after you start making a habit out of frightening off any snoopy humans that look to try and find the small band of mythics and their cohorts.";
				LineBreak;
				say "Though because of your slightly feral nature you do end up getting into it with many of the dragons when you pass through the main area of the town to try and barter for provisions. Yet, strangely enough, your temper ends up being the reason that a large and imposing unicorn male challenges you to a one-on-one battle to see if you are more than just snarls and growls. The fight between you both becomes something of a legend as you and the horned one fight for almost a full day and night without rest before the unicorn ends up taking you down with a move you are still unsure about to this day. However, a loss is a loss and you submit to the other on the same morning he bests you. The unicorn accepts your defeat and then proceeds to sit himself on top of your cock, after lying you down on your back to ride you in front of the entire village. Taking the other up the rear you have no problem humbling yourself in this manner, especially when the dominant male coats your face with his hot and milky cum. Many a nights are spent with him under you or over you, both of which you never complain about and yet, when you start to grow two long white horns on top of your head you do let the unicorn known how displeased you are about this by mounting him hard and fast one night. A couple stings of your tail has him compliant to your [']aggressive['] advances and you can't help but feel satisfied with your revenge when you see his body becoming coated in a bright red coloring of fur as days go past. The [']insane duo['] is what many in the village still call you both to this day almost a hundred years later. Mythics do live a long time after all.";
				stop the action;
			else:
				say "By the time the military comes you have long since adapted to how to handle yourself and they are quick to give you a clean bill of health. However, the outside world all but bores you and you end up finding yourself just drifting before coming across a broken down ranch where you, and those you brought along with you from the city, settle down to make a new home for yourselves. Turning the surrounding area into your new hunting grounds, after making sure that your new [']family['] will be alright after fixing up the place, you go about bothering the local townspeople in the village closest to your home. Nothing too serious of course, maybe some cattle stolen once every couple of months or a village youth kidnapped and brought to your home to toy with whenever you're bored, you always return the youth, unharmed, though slightly changed in one way or another. Yet as your antics continue to become a slight bane to the villagers, just like in the days of legend, they start to ask roaming mutants to go to try and make you leave them alone. Most of the so-called [']warriors['] are merely chumps that don't know what they're doing, you're quick to amuse yourself with these fools, nothing serious of course, just some random fun. However, when a hulking amazon of a mare comes to challenge you, you find yourself quickly outmatched by the female.";
				LineBreak;
				say "Accepting defeat at her hand and then bowing before the other you find out that the [']amazon['] is really a hermaphrodite that was looking for a good companion for her journey. The mare, or rather stallion-mare as shi liked to be called, quickly takes you with hir on hir journey when shi realizes that your antics are mostly the result of boredom with the world around you. You agree to go with her, but only after you tell the dragoness, whose name happens to be Olivia, that you'll always return home for a week to check over your [']family['] as not everyone wants to go off on a journey with you[if Fang is in the Grey Abbey Library]. Fang enjoys the chance for adventure though and turns out to be a longtime companion whom the stallion-mare reluctantly comes to find pleasant enough to follow after the two of you on your journeys[else if felinoid is tamed]. Your felinoid pet is a good tracker/hunter on the days when both your and the stallion-mare are scavenging for food. The creature's quiet nature makes it easy to get along with so that's always a plus for Olivia[end if].Quickly you and the Olivia make a name for each other as bounty hunters and renegade heroes handling out of control mutants for the Prometheans and new government trying to clean up the world. The money that comes in is a small reward for you as the real prize you both look forward to is rutting with each other after a long day of fighting/scouting as your pheromone sacs ooze your excitement out to the [']fe-male['] when wanting hir to mount you. Shi is always happy to do so as her foot long cocks, of which she has three, are always in need to be stroked by your tender insides. Long nights are spent in each other's arms as even longer says are spent on the road with both of you seeking glory.";

Manticore ends here.
