Version 2 of Tyr's Club by Kaleem mcintyre begins here.
[ Version 2 - Upgrade to link menu system ]

Section 1 - Tyr's Club

Tyr's Club is a room.  It is private. It is fasttravel.

The description of Tyr's Club is "Inside of the underground room hidden underneath an unused cabin inside of the park Tyr has made a large gym/fighting arena where several dozen mutants are busy training, exercising or else practicing some form of physical training. Over by the side you can see Tyr watching the collective with a wary eye. The Doberman is standing as strong and powerful as he usual is, but instead of being draped in his usual jeans and t-shirt he's only wearing a pair of cut-off camouflage shorts. Said shorts happen to be showing the Dobie's more than plentiful crotch off, and from the large bulge hiding within it would seem that Tyr is not lacking in the cock department."
Tyr is in Tyr's Club.
West of Tyr's Club is FightPit.
North of Tyr's Club is Club Lockerroom.

Instead of sniffing Tyr's Club:
	say "The club smells heavily of sweat, tension, concentrated focus and lots of testosterone/estrogen.";


Section 2 - Tyr

Part 1 - Setup and Dialog

Tyrtalk is a number that varies.
tyrdefeated is a number that varies.
tyrtraining is a truth state that varies.  tyrtraining is usually false.

Tyr is a man.
The description of Tyr is "Standing roughly at about seven feet, three inches tall with floppy brown ears and a long, but thin curled tail is the Doberman you met at the dog show arena back at the warehouse district. With only a pair of camouflage shorts on the black and brown furred canine's muscular frame regally stands out as he leans across an undecorated wall while watching the proceedings going on inside of his club. That is, until he turns to notice you walking up to him. The other canine doesn't seem to be specifically trying, but there is an intimidating aura coming from off of him as he stares pointedly at you with his piercing green eyes. Holding you fast into place you don't feel as if you can take a step forward or backwards as the Doberman narrows his jade orbs at you. However, this feeling soon passes when Tyr smiles and waves you over. His perfectly straight fangs give you pause for a second though as the sharpened incisors look ready to rend both flesh and bone. Why does he suddenly seem so much scarier than he had before back at the arena???".
The conversation of Tyr is { "Battle is the Key to Success!" }.
Tyr is in Tyr's Club.

Instead of sniffing Tyr:
	Say "Tyr smells like a hardworking Dobie who has a couple of secrets he's not willing to share. Oh, and he also smells like a good fight!";

Instead of conversing the Tyr:
	if Tyrtalk is 0:
		say "'Hey, it's good to see you!' Tyr walks over and then hugs you before giving you a noogie across your [facename of player] head. 'Welcome to my club, by the way. Sorry I didn't tell you everything when we met up before,' Tyr says after pulling back. 'I... well, let's not worry about it, but anyway. This is my place. A little hideaway for those who are looking to try and build up their muscles and skills so that they'll be able to survive the chaos going on upstairs.'[line break]";
		say "'You're more than welcome to have a look around and to do whatever, just remember I've got three rules here,' the Doberman says in all seriousness. 'One, if you want to fight, do it in the pit. I catch you trying to start some shit in here then you deal with me, and believe me I'm hell in a hand basket on a good day.' You nod when the Dobie starts to growl at you and then smirks with all teeth.[line break]";
		say "'Two, I don't mind if you want to have sex in the place. Hell, I almost expect it, but please, if you're going to do the dirty, clean up afterwards. I don't have a maid around here and I like cleaning up about as much as the next bachelor.' Tyr gives a long-suffering sigh at this before reaching up to pinch the bridge of his nose. He mutters something under his breath, but whatever the Doberman says it's not English. 'There's a mop, bucket and broom over by the other side of the cage. Feel free to use them.' Again you nod at Tyr, though trying not to chuckle as you do while he looks wearily around the club.[line break]";
		say "'Last thing, if you've got a grudge against someone bury it at the door. This place is made for people who are looking to workout, get off and maybe release some pent up aggression. I don't care about your personal business. So do leave it behind when you come. Again, you start some trouble, I'll start worse trouble.' Tyr growls at you while lowering his eyes slightly. 'You got me?' Again you can only nod while swallowing thickly. 'Ok, well other than that welcome to the club.' Tyr pats you on the shoulder hard enough to make you wince.[line break]";
		say "'I'll be here for a while, but I may disappear from time to time, so if you don't see me.' The Doberman shrugs at this. 'Anyway, I think that's everything... oh! One thing before I let you go,' Tyr points to the arena. 'There are some Great Dane's in there who are looking for someone to fight. If you do up against them, be extra careful because they are almost as vicious as me when they want to be! And that's something.' Turning to look at the fighting pit you watch as two of the Danes are fighting with each other. From what you can see the battle is almost sickening to watch as the two bitches hit each other with enough force to make blood splatter out the sides of their muzzles. The sad part about this is, they seem to like it when they hit each other like that as when one wipes blood from the side of their muzzles the injured one barks and then bares fangs in a manic smile at her opponent.[line break]";
		say "'Like I said, do not fuck with them lightly. I think they were all abused women at one time or another, or something, and now they've become something like fury incarnated because any [']male['] or female that steps to them wrong in there gets an extra helping of asswhooping when fighting them. Make sure that if you step in there that you are ready for a tail beating the likes of which will leave you with more than a couple of bruises. 'Oh, and if you are too pregnant, don't bother going in there. The rep I have watching over the place will [bold type]NOT[roman type] let you fight.' Tyr looks down to your belly and then sniffs you lightly.'[line break]";
		say "Well, I think that's everything. I'm going to just be here for a while looking over the place so if you need anything just let me know and I'll see what I can work out.' Tyr reaches around to tap you lightly on the ass and then snarls in your face deviously. 'Also, if you want me to tap this ass then you'll have to fight me in the arena. I don't like messing around with weaklings so if you're coming to take me on be prepared for a serious fight.' Tyr rubs across your rump and then licks you across the side of your neck while running his fangs across your [skin of player] skin.[line break]";
		say "'On the odd chance that you beat me, I can accept that I might lose, I'll give you my ass in return. Ugh... one thing though,' Tyr rubs the back of his head while lifting his muzzle up to grumble in vexation. 'This virus has made me a tad overly infectious so if you're looking to fight me be prepared to get infected after I win and fuck you or you win and fuck me. Though, then again, you'd look kinda good as a Dobie.' Tyr rumbles a heated growl in front of your face as he says this and you chuckle apprehensively at the other.[line break]";
		say "'Anyway, that's about it. Come, fight, fuck, have fun, but respect and obey my rules.' At that the Doberman turns away from you to go back looking around inside of his club.";
		increase libido of player by 15;
		if libido of player > 100, now libido of player is 100;
		now Tyrtalk is 1;
	else if Tyrtalk is 1:
		say "[one of]'Good to see you today. You looking to train?'[or]Tyr nods to you before turning to survey his club again.[or]Barking at two Danes going at it too ferociously Tyr runs over into the Pit to break them up.[or]'I wonder what that scallywag Homaru is up to? Maybe I should go by and ruffle his feathers.' Tyr chuckles while rubbing a hand underneath his chin.[or]What's you name again? I keep forgetting.'[or]'I hope those military assholes get off their tails do something about this place.'[or]Tyr seems to be contemplating something and isn't paying you much attention.[or]Tyr busies himself with looking up at the ceiling, seemingly deep in thought.[or]'Do you think that you ever might want to join up with the military after this? You'd make a pretty good leader in my opinion.'[or]'That Omio chick, is she still working on her [italic type]research[roman type] out in the plains? I thought she'd have given up by now.'[or]'I so want to get up out of here and get back to Asg... ugh... never mind.'[or]'I wonder if the others have desce... ugh... come down this way yet.' Tyr chuckles while turning his head to the side.[or]'Just who are you?' Tyr looks to you with a curious glare covering his toughened features. 'You do not have the feeling of being a normal m...person.'[or]'I wish I had some honeyed wine right about now.' Tyr grunts as he rubs across his belly.[at random]";


Part 2 - Sex Match with Tyr

Instead of fucking the Tyr:
	setmonster "Doberman";
	choose row monster from the table of random critters;
	If lastfuck of Tyr - turns < 6:
		say "'Sorry, I'm not ready to go another round with you yet. Maybe come back in a little while?' Tyr rolls his shoulders and you can hear his spine pop slightly.";
		stop the action;
	else:
		say "'Alright then, lets head to the pit and do this!' The Doberman seems especially excited as his long, curled tail wags behind him at a breakneck pace as the two of you walk over to the fighting area. 'I hope you're ready!' Tyr growls as his eyes narrow dangerously at you from across his shoulder.'";
	if tyrdefeated > 2:	[3 player wins in a row]
		tyrsexmenu;
	else:
		let bonus be (( the Strength of the player minus 5 ) divided by 2);
		let diceroll be a random number from 1 to 20;
		say "You roll 1d20([diceroll])+[bonus]: [diceroll + bonus], ";
		increase diceroll by bonus;
		if diceroll > 18:
			increase tyrdefeated by 1;
			say "Tyr falls back hard onto his tail after you last assault. Defeated, the Doberman takes a minute to revel in his loss before he grunts and then flips himself up onto his feet. Just when you think the other is about ready to renew the fight you find yourself cocking your head in confusion as he waves a hand at you. 'Well won warrior. I didn't expect to have my tail handed to me, but I suppose that I still have extra training to do. No matter though, to the victor goes the spoils.' Tyr lowers his head to chuckle about something, what you're not sure, before lifting his face to stare at you with glowing green orbs.[line break]";
			say "'So how would you like to have me pleasure you?'";
			if cocks of player > 0:
				if cunts of player > 0:
					say "Having defeated Tyr you find yourself looking over the handsome, if not slightly bleeding form of the other and growing almost painfully aroused. At his words you wonder how best to slake your lusts with the beast of a Doberman? (Y=Cunt, N=Ass)[line break]";
					if the player consents:
						say "[TyrLost_Vaginal]";
					else:
						say "[TyrLost_Anal]";
				else:
					say "Because you don't have any physical feminine aspects you go ahead and decide that taking Tyr's tail would be the best thing to do for today's grand prize.";
				say "[TyrLost_Anal]";
			else:
				if cunts of player > 0:
					say "Feeling a bit needy inside of your aching cunt you don't bother to hide this fact from Tyr as you roll your hips at him wantonly.";
					say "[TyrLost_Vaginal]";
				else:
					say "[TyrLost_Neuter]";
		else:
			now tyrdefeated is 0;
			if a random chance of 2 in 6 succeeds and cunts of player > 0:
				say "[TyrWon_Cunnilingus]";
			else if a random chance of 1 in 6 succeeds and cunts of player > 0:
				say "[TyrWon_Training]";
			else if cunts of player > 0:
				say "[TyrWon_Vaginal]";
			else if cocks of player > 0 and cunts of player is 0 and ( a random chance of 2 in 5 succeeds or ( "More Anal" is listed in feats of player and a random chance of 1 in 3 succeeds ) ):
				say "[TyrWon_AnalPlay]";
			else:
				say "[TyrWon_NoSex]";
	now non-infectious entry is false;
	infect "Doberman";
	infect "Doberman";
	now non-infectious entry is true;
	now lastfuck of Tyr is turns;

to tyrsexmenu:
	say "Having beaten Tyr consistently, you've learned his technique and are able to beat him... if you want.  Will you put the Doberman down and take your prize again, or will you ease up and let him pin you down?";
	now sextablerun is 0;
	blank out the whole of table of fucking options;
	choose a blank row in table of fucking options;
	now title entry is "Win: Receive Anal";
	now sortorder entry is 3;
	now description entry is "beat him and take it in the ass.";
	choose a blank row in table of fucking options;
	now title entry is "Win: Give Fellatio";
	now sortorder entry is 6;
	now description entry is "beat him and suck him off.";
	if cocks of player > 0:
		choose a blank row in table of fucking options;
		now title entry is "Win: Fuck him";
		now sortorder entry is 1;
		now description entry is "beat him and fuck his ass.";
		choose a blank row in table of fucking options;
		now title entry is "Win: Receive Fellatio";
		now sortorder entry is 4;
		now description entry is "beat him and get a blow job.";
		if lust of Tyr >= 3 and libido of Tyr >= 3:
			choose a blank row in table of fucking options;
			now title entry is "Lose: Fuck him";
			now sortorder entry is 13;
			now description entry is "lose and fuck his ass.";
	if cunts of player > 0:
		choose a blank row in table of fucking options;
		now title entry is "Win: Vaginal";
		now sortorder entry is 2;
		now description entry is "beat him and ask to get fucked.";
		choose a blank row in table of fucking options;
		now title entry is "Win: Receive Cunnilingus";
		now sortorder entry is 5;
		now description entry is "beat him and have him eat you out.";
		choose a blank row in table of fucking options;
		now title entry is "Lose: Vaginal";
		now sortorder entry is 11;
		now description entry is "let him win and fuck you.";
		choose a blank row in table of fucking options;
		now title entry is "Lose: Cunnilingus";
		now sortorder entry is 14;
		now description entry is "let him win and eat you out.";
		choose a blank row in table of fucking options;
		now title entry is "Lose: Training massage";
		now sortorder entry is 15;
		now description entry is "let him win and do some training.";
	if cocks of player > 0 and cunts of player is 0:
		if anallevel is 3:
			choose a blank row in table of fucking options;
			now title entry is "Lose: Anal play + hand job";
			now sortorder entry is 16;
			now description entry is "let him win and jerk you off.";
	if cocks of player is 0 and cunts of player is 0:
		choose a blank row in table of fucking options;
		now title entry is "Win: Neuter player";
		now sortorder entry is 10;
		now description entry is "beat him and leave it at that.";
	if cunts of player is 0:
		if lust of Tyr >= 3 and libido of Tyr >= 3:
			choose a blank row in table of fucking options;
			now title entry is "Lose: Receive Anal";
			now sortorder entry is 12;
			now description entry is "lose and get fucked in the ass.";
		choose a blank row in table of fucking options;
		now title entry is "Lose: no sex";
		now sortorder entry is 18;
		now description entry is "let him win and leave it at that.";
	sort the table of fucking options in sortorder order;
	repeat with y running from 1 to number of filled rows in table of fucking options:
		choose row y from the table of fucking options;
		say "[link][y] - [title entry][as][y][end link][line break]";
	say "[link]100 - Nevermind[as]100[end link][line break]";
	while sextablerun is 0:
		say "Pick the corresponding number> [run paragraph on]";
		get a number;
		if calcnumber > 0 and calcnumber <= the number of filled rows in table of fucking options:
			now current menu selection is calcnumber;
			choose row calcnumber in table of fucking options;
			say "[title entry]: [description entry]?";
			if player consents:
				let nam be title entry;
				now sextablerun is 1;
				if nam is "Win: Fuck him":
					say "Tyr falls back hard onto his tail after you last assault. Defeated, the Doberman takes a minute to revel in his loss before he grunts and then flips himself up onto his feet. Just when you think the other is about ready to renew the fight you find yourself cocking your head in confusion as he waves a hand at you. 'Well won warrior. I didn't expect to have my tail handed to me, but I suppose that I still have extra training to do. No matter though, to the victor goes the spoils.' Tyr lowers his head to chuckle about something, what you're not sure, before lifting his face to stare at you with glowing green orbs.[line break]";
					say "[TyrLost_Anal]";
				else if nam is "Win: Vaginal":
					say "Tyr falls back hard onto his tail after you last assault. Defeated, the Doberman takes a minute to revel in his loss before he grunts and then flips himself up onto his feet. Just when you think the other is about ready to renew the fight you find yourself cocking your head in confusion as he waves a hand at you. 'Well won warrior. I didn't expect to have my tail handed to me, but I suppose that I still have extra training to do. No matter though, to the victor goes the spoils.' Tyr lowers his head to chuckle about something, what you're not sure, before lifting his face to stare at you with glowing green orbs.[line break]";
					say "[TyrLost_Vaginal]";
				else if nam is "Win: Neuter player":
					say "Tyr falls back hard onto his tail after you last assault. Defeated, the Doberman takes a minute to revel in his loss before he grunts and then flips himself up onto his feet. Just when you think the other is about ready to renew the fight you find yourself cocking your head in confusion as he waves a hand at you. 'Well won warrior. I didn't expect to have my tail handed to me, but I suppose that I still have extra training to do. No matter though, to the victor goes the spoils.' Tyr lowers his head to chuckle about something, what you're not sure, before lifting his face to stare at you with glowing green orbs.[line break]";
					say "[TyrLost_Neuter]";
				else if nam is "Win: Receive Anal":
					say "[TyrLost_GetAnal]";
				else if nam is "Win: Give Fellatio":
					say "[TyrLost_GiveOral]";
				else if nam is "Win: Receive Fellatio":
					say "[TyrLost_GetFellatio]";
				else if nam is "Win: Receive Cunnilingus":
					say "[TyrLost_GetCunnilingus]";
				else if nam is "Lose: Vaginal":
					say "[TyrWon_Vaginal]";
				else if nam is "Lose: Receive Anal":
					say "[TyrWon_GetAnal]";
				else if nam is "Lose: Fuck him":
					say "[TyrWon_GiveAnal]";
				else if nam is "Lose: Cunnilingus":
					say "[TyrWon_Cunnilingus]";
				else if nam is "Lose: Training massage":
					say "[TyrWon_Training]";
				else if nam is "Lose: Anal play + hand job":
					say "[TyrWon_AnalPlay]";
				else if nam is "Lose: no sex":
					say "[TyrWon_NoSex]";
		else if calcnumber is 100:
			say "Break off the conversation?";
			LineBreak;
			say "     ([link]Y[as]y[end link]) - Yes.";
			say "     ([link]N[as]n[end link]) - No.";
			if the player consents:
				now sextablerun is 1;
				say "     You step back from the Tyr, shaking your head as he gives you a questioning look.";
				wait for any key;
		else:
			say "Pick between 1 and [the number of filled rows in the table of fucking options] or 100 to exit.";
	wait for any key;
	clear the screen and hyperlink list;


Part 3 - Player Win Scenes

to say TyrLost_Vaginal:
	choose row monster from the table of random critters;
	say "Letting the other know that you'd like to have a thick piece of Doberman meat stuffed up into your cunt you have no time to prepare before Tyr is knocking you down to the ground in a massive glomp of a hug. 'I was so hoping you'd ask for that!' The Dobie doesn't make a pretense of things as he pulls you out of your clothes and then slips his own shorts down off of his impressive black and brown furred frame. In the time it takes a sparrow to flap its wings Tyr is hiking your hips up onto his shoulders and running his sheath along the length of your [bodyname of player] cunt.[line break]";
	say "The Dobie's impressive piece of meat wastes no time in pushing free from its warm home as the rocking and grinding motions coming from Tyr excites both his body and yours. Once his cock is about half way engorged and with very little ceremony, Tyr tilts his hips down and then spears you along the length of his tapered shaft. A grunting hiss is your reply to the Dobie's slightly rough entry, but soon you find your body growing accustomed to the thick mass of male meat digging deep inside of your hidden depths as Tyr pushes his hips further up inside of you. 'Don't worry, I'll make sure you feel nothing but pleasure once I'm done with you.' A heavy slurp of tongue across your cheek is the only proof of Tyr promise as he continues to join the two of you together.[line break]";
	say "Once heavy furred balls are pressed flush up against your honeyed hole Tyr whuffs a heavy pant of air across your [facename of player] face and then dips his muzzle down to kiss you. Paying no never mind to how the other man seems to be taking the dominant role of things, despite the fact that [italic type]you[roman type] won your little bout with him, you reach up to press the Doberman's head into you just as you feel him pull back from out of your sucking nadir. Once he has pulled about half of his shaft free the Dobie proves to be gentle, but forceful as he plunges back into you.[line break]";
	say "The first thrust makes you grunt into the swap of tongue you share with Tyr, even as the Doberman nibbles across your tongue with his sharpened fangs. The second pump of his hips makes you moan and on the third you spread your legs wider for him as he sets the rhythm for the fucking he's about to do. When heavy furred balls tap against the outer edges of your labia you can do nothing to stop the shivers that rack through your body as you tighten your legs around Tyr's straining form.[line break]";
	say "Pounding into you with almost merciless thrusts Tyr pulls back from his kiss just as the edge of his knot threatens to pop inside of your leaking pussy. When firm arms pull you up just a little further off of the ground you yelp when Tyr's bulb slips into you and then locks tight. A growling gasp from Doberman a minute later and soon his fucking motions grow much quicker, though much more shallow by proxy, as he humps you like a true canine.[line break]";
	say "Feeling your cervix getting a serious workout as it contours around the growing bulge of Tyr's knot you yelp and then wail as your pussy is force to widen around the Dobie meat drilling you. Stars slowly filling your vision and your body bucking in time with Tyr's frantic movements you don't think or breathe for a minute as you feel your climax about to hit. When a warm and demanding tongue strokes itself across the edge of your throat you find yourself screaming out to the ceiling as all your vaginal muscles lockup tight around Tyr.[line break]";
	say "When the Doberman cums he does so with little fanfare as he thrusts into you once more and then suddenly goes immobile. When the first shot of Dobie cum surges up inside of you, you yowl like a cat in heat as your snatch gets baptized by Tyr's warm spooge. When the second, third on up to the fifth shot hit home up into your womb you roll yourself against Tyr as a fire snakes its way through your spine. The sensation of being filled by the Doberman is almost like being branded and seconds into your stud's orgasm you cum in due course as your flapping nethers wrap around the Dobie like a glove.[line break]";
	say "'Ohh, good girl.' Tyr chuckles, [if cocks of player > 0]but then stops when you remind him of your other unnoticed piece of anatomy. 'R-right, sorry, [italic type]sir[roman type].' The snicker from Tyr makes you want to hurt him for some reason[else]until you give him a pointed look. At that the Doberman grunts nervously down at you[end if]. It takes maybe thirty minutes for the Dobie to finish inseminating you and when he does he gently pulls his deflated knot out of you and then lowers your legs back down onto the ground.[line break]";
	say "'Well, as I said before, to the victor, the spoils, but now it's time for you to clean up!' And at that you blink as Tyr picks up his shorts and then makes a fast pace out of the pit. You can only blink as you watch him leave.";

to say TyrLost_Anal:
	if lust of Tyr is 0:
		say "Telling the other that you want his ass Tyr gives you a scowl, but then sighs when you return his disapproving look. A sigh of '[italic type]Fine[roman type] as second later and the Doberman grumbles under his breath before he moves over to undo his shorts. At seeing the big and muscular canine looking so... despondent... about giving up his tail you move over to hug yourself up next to the Doberman just as he's about to take off his shorts. 'What are you...?' You don't give him time to wonder as soon you are running a hand across his black and brown fur and then rubbing your fingers along the crack of his rump.[line break]";
		say "A yip of surprise from the other makes you smile and you lean over to tell Tyr that you'll be gentle... ish. 'I'm starting to think that...' You cut the Dobie off from whatever he was about to say as you shuck his shorts down off of his bubble shaped rump and then go to smack him across his brown furred rear. A yelp has you laughing, right up until Tyr growls warningly.[line break]";
		say "Seeing that the other is only going to allow you so much leeway with his pride, you prepare the Doberman's tailhole by slipping a few of your [bodyname of player] fingers into him, after getting them wet with your [facename of player] tongue, while reaching down to unzip yourself to stroke your [cock of player] cock to full hardness. Once you've satisfactorily opened Tyr up, pressing on the pleasure button hiding inside of his rectum to make the other moan and push back onto your slick digits to help with this effort, you pull your fingers out of the Dobie and then line your cock up with his tailstar. A whimper from Tyr has you pausing and then sighing before flexing your arms up around his chest to hug him more tightly into you.[line break]";
		say "Having not expected this Tyr blushes and then turns back to look at you. When your [facename of player] eyes meet the Dobie's own jade orbs the two of your share a silent understanding before you press your dick into his opened tailhole. The tightness of the other man makes a hiss stream out from between your teeth.[line break]";
		say "Obviously, the Doberman doesn't take it up the rump too often. Not if the feeling of being gripped in almost too tight pressure can tell you anything about Tyr's subbing days. Another whine from him and you nip the Dobie onto his floppy ears to tell him to keep quiet. Continuing to move your cock inside of him you take care to move slowly so as to give Tyr ample time to adjust.[line break]";
		say "Once you're in to the hilt you give the Doberman another moment to relax and grow comfortable to your girth before making your move to pull out of him. Two-thirds of the ways free you wait for another few seconds to let the Dobie get settled before pushing forward into him. Watching the Doberman's reaction you find Tyr shivering from being speared onto you the way he is and think to yourself that maybe ending this would be for the best. That is, right until the other pushes himself back onto you out of the blue.[line break]";
		say "'Fuck me already before I lose my nerve!' Tyr says and you happily oblige the other by pulling back from out of him again and then slowly pushing forward so as to fuck him in a slow and even pace. Your balls knocking into those of the Dobie's you can tell that this is going to be a good fuck by the way Tyr spreads his legs just a little wider for you.[line break]";
		say "Your thrusts are sharp, but focused as you hump Tyr's butt in a way that make both of you groan in rapture. Everyone else around watches with a pleased eye to see you giving the tough-as-nails Doberman his due, and from the panting going in your ears some of them must be really getting into things.[line break]";
		say "Moving your hips just a little faster as you feel Tyr's insides accommodate around you even better you bite down onto the side of the Doberman's shoulder and raise up over him just a little more in an effort to plow even harder along his sweet spot. A thankful moan purses free from Tyr's lips as the Dobie leans over further while hiking his tail up further against his back. Hugging the defeated Doberman tight while grinding, thrusting and bucking into him like a wild animal you feel your balls tighten and lift up in between your legs as your orgasm hurriedly approaches.[line break]";
		say "Fleetingly wondering if Tyr is getting off on this you sneak a hand down to feel the Dobie's neglected cock. Feeling the weight of Tyr's leaking manhood inside of your palm you pump at the hard length of Doberman meat to bring your lover off in time with you.[line break]";
		say "When Tyr cums its with a yowl as you, in turn, fill his newly used hole with great globs of your seed. Not really minding the fact that you're getting Doberman spooge onto your hand you hum blissfully into Tyr's ear, after you pull your [facename of player] teeth from off of his shoulder. When you've filled up your mate of the hour to the brim you hold yourself steady to make sure none of your cum will run out of the other before wrapping your hand around the bulb of Tyr's knot to give it a teasing squeeze.[line break]";
		say "'Cheeky bastard,' Tyr mumbles good-naturedly and you give him another firm squeeze before kissing him along the back of his neck. 'Thanks for this though, it's been a while since I've been [italic type]humbled[roman type] in this way. I... guess I have some more training to do.' Tyr sighs before rolling his eyes.[line break]";
		say "'You know that since you won, you'll have to clean up the mess, right?'";
		increase lust of Tyr by 1;
	else if lust of Tyr is 1:
		say "Telling Tyr that you want another go at his ass, he grumbles a little, but certainly gets out of his shorts quickly enough.  Perhaps he's becoming a little more accepting of your advances.  To help him feel more comfortable, you give him a strong hug that leads to you groping the Doberman's firm butt as he moves onto all fours and raises his tail.";
		say "The sight of the sexy doggy gets you quite excited and you grind your cock between those meaty cheeks of his, letting your precum dribble over his tight hole.  Eager to keep encouraging him, you let your pre get him slick before sliding a finger into his rump to further open him up.  You tell him to relax and that you'll make him feel good.  He grumbles that you'd better since he doesn't give it up for just anyone, to which you chuckle and reach around to grab his stiff cock with your other hand.  You say nothing, just stroking it slowly and enjoying the blush in his ears.  After some stroking and fingering to help him get more relaxed and turned on, you slide your fingers free and replace them with something meatier.";
		say "     You take it easy at first, sinking [if cock length of player > 3]a few inches [end if]into him slowly to start before picking up the pace.  Tyr responds by pushing back onto your [cock of player] cock as you speed up, panting and moaning as his arousal grows.  From the feel of his throbbing, pulsing manhood in your hand, you can tell the Doberman's gotten quite turned on.  He's delightfully tight around your shaft, making fucking him very enjoyable for you as well.  Soon enough, you're leaking more pre into his anus, acting as additional lube and easing your passage inside his sexy rump.";
		WaitLineBreak;
		say "     After fucking him for a good, long time, you can feel his cock throbbing and twitching, clearly on the edge of blowing.  Sensing this, you pick up the pace, firmly pressing at the horny dog's buried prostate while pumping his manhood until he cums.  As he cries out and sprays his load onto the ground, you nibble his ear and ask him if getting fucked felt good.  Awash in the excitement of orgasm, he moans that it feels great and you grin.  A few more thrusts has you cumming as well, filling the studly dog with your virile load, causing a resurgence in his climax to add to the mess he's making.";
		say "     When you've both drained your balls, you give him a few minutes to pant and bask in the afterglow before easing your shaft from his sticky rear.  He rolls onto his side away from the mess of Doberman cum you've pumped out of him, clenching his asshole tight to keep your own load inside him.  He doesn't seem to be aware that he's done it, but it makes you smile to see him enjoying getting fucked a little more.";
		say "     'Cheeky bastard,' Tyr mumbles good-naturedly when you rub a hand across his rear and lean in to give the canine a kiss right on the muzzle.  'It looks like you got me again.  I'm definitely going to have to keep training,' he says before getting up and heading off.  'Don't forget, that's your mess to clean up,' he teases.  You watch him go, enjoying the sight of his cum-stained bottom and wagging tail.";
		increase lust of Tyr by 1;
	else if lust of Tyr is 2:
		say "     Telling Tyr that you want another go at his ass, he grumbles a little, but again gets out of his shorts quite quickly.  Despite the grumble, his tail wags quickly and raises itself in anticipation.  Licking your lips at the thought of having another go at him, you press him up against the chain link fence and tell him to spread 'em.  With him in such a position, you give him a quick kiss on the side of his muzzle before lowering yourself to your knees and nuzzling at his rear.  Nuzzling between those strong, meaty glutes, you [if anallevel is 3]give his asshole a thorough licking, diving your tongue into it until he's nice and opened up[else]give his asshole a few quick licks to prep it[end if], enjoying his soft moans as you do.";
		say "     After that quick prep, you move in behind him, guiding your cock to his wet pucker and hug him tightly.  You nuzzle his shoulder and reassure him that you'll make him feel real good like last time.  He smiles at this and nods, pushing his ass back onto your cock.  You nibble his ear, saying 'Good doggy' to him.  He playfully growls at this and warns you not to push your luck.  You both laugh and you reach around to stroke his throbbing manhood as you continue to penetrate him.";
		say "     You take it easy at first, sinking [if cock length of player > 3]a few inches [end if]into him slowly before picking up the pace and starting to hump him in earnest.  Tyr responds by gripping the fencing tightly and pushing back into your thrusts, panting in growing arousal.  From the feel of his stiff, leaking shaft in your hand, you can tell the Doberman's really getting into it.  He's delightfully tight around your shaft, making fucking him very enjoyable for you as well.  Soon enough, you're leaking more pre into his anus, acting as additional lube and easing your passage inside his sexy rump.";
		WaitLineBreak;
		say "     After fucking him for a good, long time, you can feel his cock throbbing and twitching, clearly on the edge of blowing.  Sensing this, you slow your pace and lighten your touch this time.  He whimpers with need as the sensations fade.  You nibble his ear and trace your fingertip across his glans, asking him if he'd like you to finish fucking him.  'Mmm... do it... fuck me... fuck me hard...' he barks, too aroused to keep himself from begging for it.  Hearing this, you resume pounding his ass while pumping at his cock, getting him to howl in orgasmic release.  With his cock spurting in your hand and his tailhole clenching down around you, you can't hold out any longer and cum in him, seeding his ass with your [cum load size of player] load.";
		say "     As your orgasms wane, you release his softening shaft and hug him tightly, nuzzling his neck and kissing along it.  He turns around and leans back against the fence wall when you slide your cock free.  He puts his strong arms around you, pulling you into a tight hug and a tongue-filled doggy-kiss that is almost enough to get you ready for another go all on its own.  During the kiss, you give his well-fucked ass a squeeze, enjoying the soft moan of pleasure he gives at your touch now.";
		say "     After breaking the kiss, he heads off to get back to his own affairs, leaving you to eye that sexy, cum-stained rear of his before you deal with the clean-up.";
		increase lust of Tyr by 1;
	else:
		say "     Telling Tyr that you want another go at his ass, he nods and gives a little grin, showing no reluctance as he shucks his shorts.  He moves onto all fours and even his rear a little wave towards you, tail raised and wagging in anticipation.  Smiling at how he's turned around on the prospect of anal sex, you move into position behind him and [one of]allow your dribbling cock to lube his asshole with your precum[or]lick a finger and tease him loose with some fingering[or]work your tongue at his pucker to get him lubed up[cycling].  After this playful preparation, which has him panting and eager to get started, you climb atop him and ease your cock into his rump.";
		say "     Putting your arms around him, you run your hands over his muscled form as you thrust into his tight, clenching asshole.  You take it easy at first, sinking [if cock length of player > 3]a few inches [end if]into him slowly before picking up the pace and starting to hump him in earnest.  Tyr responds by pushing back into these thrusts while panting in growing arousal.  When you slide a hand down to grip his shaft, you find it stiff and dribbling precum.  Nuzzling at his back, you moan how sexy he is like this and grind your glans against his prostate, eliciting a delightful whimper of pleasure from him.  As always, he's delightfully tight around your shaft, making fucking him very enjoyable for you as well.  Soon enough, you're leaking more pre into his anus, acting as additional lube and easing your passage inside his sexy rump.";
		WaitLineBreak;
		say "     After fucking him for a good, long time, you can feel his climax approach, as is yours.  Sensing this, you adjust your pace and how vigourously you're working his dribbling penis to get you both to climax almost simultaneously.  In the rush of your mutual orgasms, it's difficult to tell if his orgasmic clenching prompted or was prompted by your own pulsing blasts of cum shooting against his prostate.  Regardless, you are both reduced to moaning, panting cries of ecstasy as you fill his rump and he marks the ground with his load.  With an arm around his muscled body and your other hand pumping at his cock, you hump away at him, shooting your [cum load size of player] load into his bowels.";
		say "     After your orgasms end, you pull out slowly, watching with a smile as his anus clenches down to keep your [cum load size of player] output inside him.  You lick the mess of Doberman cum from your hand, sharing a sloppy, cum-filled kiss with Tyr before letting him get up and head off to check on the rest of the club.";


to say TyrLost_Neuter:
	say "Without either masculine or feminine bits you let Tyr know that you just came to test his strength out against yours. At this the Doberman thrown back his head and then laughs himself into an uproar. 'Well, I didn't think that you'd be so interested in me. Perhaps, you're the kind of person I'm in need of to help straighten those [']slackers['].' Going over to wrap his arm around you, you take a moment to try and figure out who those slackers are before gasping when Tyr's fangs dig deep into your shoulder. Gasping from the sudden pain you find yourself shivering as your body suddenly becomes electrified with new pleasure as Tyr's saliva flows into your bloodstream.";
	say "'Sorry about that, but I didn't want to take a chance that you'd refuse my offer to become a Doberman.' The Dobie shrugs at you somewhat helplessly before licking his fangs free of your metallic tasting life fluids. 'Don't worry though, I know you'll come around and make an excellent Doberman. But hey, if you chose not to, then that's fine by me.' Tyr nods to you and then watches as the bite he inflicted hastily begins to seal itself.";

to say TyrLost_GetAnal:	[only available through multiple victory menu]
	choose row monster from the table of random critters;
	say "     Tyr falls back hard onto his tail after you last assault. Defeated, the Doberman takes a minute to revel in his loss before he grunts and then flips himself up onto his feet. Just when you think the other is about ready to renew the fight you find yourself cocking your head in confusion as he waves a hand at you. 'Well won warrior. I didn't expect to have my tail handed to me, but I suppose that I still have extra training to do. No matter though, to the victor goes the spoils.' Tyr lowers his head to chuckle about something, what you're not sure, before lifting his face to stare at you with glowing green orbs.";
	LineBreak;
	if libido of Tyr is 0:
		say "     Telling him that you want his cock in your ass, he seems somewhat surprised and put off, but then sighs when you return his disapproving look.  '[if cunts of player > 0]But you've got a perfectly fine pu... [end if]Fine, whatever you want I guess.  It's not my thing, but a bet's a bet.'  And with that said, he stretches slowly, showing off his muscular, black and brown furred body before moving his paws to slip down his shorts.  He rubs a paw over his impressively large sheath and rising piece of meat.  Despite his reluctance for the act, he certainly seems to be rising to the occasion quickly.  The sight of that Doberman cock which will be soon stuffed inside you sends a rush of excitement through you.";
		say "     Moving onto all fours, you raise your ass to the muscled Doberman and give it a little wave.  He tries to act like he's not enticed, but you can see his cock pulsing and dribbling with precum at the sight of your tight hole.  [if anallevel is 3]Licking his muzzle, he moves in behind you and presses his cool nose between your cheeks.  His canine tongue slathers across your pucker several times before it presses further, burying itself inside your rectum as Tyr rims you.  The slick motion of the doggy's tongue gets you wet and ready, as well as all the more turned on.  After a couple of minutes, he pulls it free with a wet slurp[else]Taking a small bottle of lube from his shorts, he smears a hefty amount onto his large rod before spreading the rest between your cheeks and into your asshole.  With that preparation done, he slips his slick digit free and gives your ass a playful spank[end if].";
		WaitLineBreak;
		say "     The Doberman's muscled form moves atop you, his thick canine rod finding its way quickly to your back entrance.  After taking a moment to get a deep breath, he pushes his manhood forward, spreading your anal ring open and letting the first couple of inches slide into you slowly.  He takes his time at first, letting you adjust to accepting the massive intrusion.  Despite the discomfort, the feel of that hot, pulsing, dribbling meat inside you is wonderfully exciting and you start panting and moaning for more.  And Tyr, getting more turned on, quickly loses his reluctance and starts humping away at you at a rapidly increasing pace.";
		say "     By the time he's going at you hard and heavy, your [if cocks of player > 0]prostate[else][bodytype of player] body[end if] feels awash in pleasure even as the buff dog's knot is knocking at your back door, seeking entrance into you.  He licks and nips at your shoulder and neck as he puts a muscular arm around your [bodydesc of player] body and holds you tightly as he grinds that meaty bulb hard against your anus, forcing it to spread even further.  A few hard grinds like that and your back door opens enough to accommodate the added thickness long enough for him to tie with you before locking tight around it.  The Doberman gives a growling gasp as your rectal walls clamp down hard around his knot, milking his cock all the more.  This sends him into a wild frenzy of humping like a true canine, each shallow thrust accompanied by a burst of near-orgasmic pleasure from your [if cocks of player > 0]prostate and [end if]well-stuffed ass until you can hold back no longer.";
		WaitLineBreak;
		say "     When your orgasm hits and [if cocks of player > 0]your hot seed splatters across the ground in white streaks[else if cunts of player > 0]your pussy soaks your thighs with its juices[else]shivers of unfocused delight rush through your genderless body[end if], Tyr soon follows.  Your asshole squeezes and milks his cock well past the point of orgasm and he releases a canine growl as he unleashes his first blast of cum.  Shot after thick shot of canine cum shoots into you, flooding your bowels with his virile load[if scalevalue of player < 3] to the point that it causes visible swelling[end if].  You can feel the hot stud's load and pulsing cock buried inside you, stuffing you so well as you both enjoy the tie.[mimpregchance]";
		say "     Once his cock's done seeding you and his knot's gone down perhaps a half-hour later, he pulls free of your asshole.  This sends a gush of creamy cum pouring out of you and onto the floor.  Feeling weak in the knees, you collapse into it with a happy moan.  After wiping his canine shaft off on your rear, he reminds you that it's the winner who has to clean up the mess.  You consider [one of]growling at him that it's mostly his mess[or]getting up and dealing with it[or]asking for another go[at random], but decide to just lay there longer, content for now in the growing pool of dog cum leaking from your well-fucked ass.";
		increase libido of Tyr by 1;
	else if libido of Tyr is 1:
		say "     Telling him that you want his cock in your ass again, he seems a little disappointed, but nods and starts slipping down his shorts.  '[if cunts of player > 0]Are you sure you don't want it in that juicy cunt of yours?  [end if]Well, winner's choice, I guess,' he says, acceding readily enough.  And with that said, he stretches slowly, showing off his muscular, black and brown furred body before running his paws over your offered up ass.  His cock is already quite hard and the sight of you waving your rump at him gets him even harder.  Perhaps he's becoming more easily enticed by your offer.  The sight of that Doberman cock which will be soon stuffed inside you sends a rush of excitement through you.";
		say "     Tyr moves in overtop you, pressing his muscled form to yours while his cock dribbles and leaks precum readily.  Choosing to use that to lube you up this time, he grinds his glans against your pucker, soaking it thoroughly before slowly easing into you and letting his pre dribble into your opening hole.  By the time he's properly sliding it into you, you're both panting with obvious lust and eager to get to the fucking.  He sinks a few more inches into you and starts thrusting, working his cock steadily deeper with every strong push of his powerful hips.";
		WaitLineBreak;
		say "     His reluctance is forgotten in the heat of the moment and he nuzzles and licks at the back of your neck while fucking you.  As you adjust to the massive intrusion, the initial discomfort fades, leaving you to savour that hot, pulsing, dribbling meat buried inside you.  The feel of it thrusting into you is wonderfully exciting and you start panting and moaning for more.  And Tyr, getting more turned on, humps away at you at a rapidly increasing pace as his lust for your tight ass grows.";
		say "     By the time he's going at you hard and heavy, your [if cocks of player > 0]prostate[else][bodytype of player] body[end if] feels awash in pleasure even as the buff dog's knot is knocking at your back door, seeking to be buried inside you once more.  He licks and nips at your shoulder and neck as he puts a muscular arm around your [bodydesc of player] body and holds you tightly as he grinds that meaty bulb hard against your anus, forcing it to spread open for it once again.  A few hard pushes like that and your back door opens enough to accommodate the added thickness long enough for him to tie with you before locking tight around it.  The Doberman gives a growling gasp as your rectal walls clamp down hard around his knot, milking his cock all the more.  The last of his restraint momentarily lost, this sends him into a wild frenzy of humping like a true canine, each shallow thrust accompanied by a burst of near-orgasmic pleasure from your [if cocks of player > 0]prostate and [end if]well-stuffed ass until you can hold back no longer.";
		WaitLineBreak;
		say "     When you feel yourself getting close, you clench down around him all the harder and push back into his thrusts, panting and moaning for him to fuck that ass of yours.  This heavy humping erodes what's left of your endurance and [if cocks of player > 0]your [cum load size of player] load sprays onto the ground in white streaks[else if cunts of player > 0]your pussy soaks your thighs with its juices[else]shivers of unfocused delight rush through your genderless body[end if], but also has Tyr cumming right after you.  He releases a canine growl as he unleashes the first of many blasts of cum while your asshole squeezes and milks his cock to orgasm.  Shot after thick shot of canine cum shoots into you, flooding your bowels with his virile load[if scalevalue of player < 3] to the point that it causes visible swelling[end if].  You can feel the hot stud's load and pulsing cock buried inside you, stuffing you so well as you both enjoy the tie.";
		say "     He nuzzles at your neck and licks your cheek, even sharing a kiss with you as he stays atop you for the half-hour or so before his knot goes down.  Only then does he pull free of your creamy asshole.  Unblocked, a gush of his creamy cum pours out of you before you're able to clench down and keep the rest of it inside you this time.  You flop down onto the messy floor with a happy moan, smiling up at him.  He again wipes his canine shaft off on your rear, kissing you as he does this time.  After that, he gets up and heads off, leaving you to lie contentedly in the pool of cum for a while before finally getting up and cleaning the mess so the room can be used again.";
		increase libido of Tyr by 1;
	else if libido of Tyr is 2:
		say "     When you tell the Doberman you want him to mount you again, he arches his brow and grumbles a little, but from the big bulge in his shorts and his rapidly wagging tail, you can tell he's excited by the prospect of being buried inside you again.  Certainly he's out of his shorts quickly and his pillar of meat is hard and ready.  [if cunts of player > 0]He glances briefly at your pussy before shrugging and teasing his thumb against your pucker.  [else]He runs his head across your ass before guiding his thumb to your pucker.  [end if]'Well, a hole's a hole.  And what a fine hole it is,' he says with a grin, rubbing his thick digit against your back door.  Smiling at his improved attitude about your sexual desires for anal sex, you grind back against his touch and move onto all fours, eager to have the big canine's bone buried inside you again.";
		say "     This time he starts by applying some lube to your anal ring and his fingers, then uses them to work your tight hole open.  He starts with one digit, but moves up to two and then three rather quickly.  While a little quick, you grin at his eagerness to get started and do your best to relax your rear portal.  Once he's working those three fingers into you, he reaches around and [if cocks of player > 0]strokes your throbbing cock[else if cunts of player > 0]runs his fingertips over your juicy folds[else]runs his paw over your sexless body[end if], adding to your enjoyment.  Once he's gotten you slick with lube, he spreads some onto his shaft and moves in to mount you.";
		WaitLineBreak;
		say "     The buff dog presses his body down over yours as his thick canine rod finding its way quickly to your back entrance.  As he sinks it into you, he licks and nibbles along your neck and shoulders.  The pointed tip of his canine cock spreads your anal ring open before he eases the first couple of inches into you slowly. His tongue hangs out of his muzzle and he pants with growing excitement, clearly enjoying another opportunity to fuck your sexy bottom.  As he drives more and more of his large, throbbing manhood into you, you start to pant and moan as well, asking for more.  And Tyr, eager to pound your ass, complies with even deeper thrusts.";
		say "     By the time he's going at you hard and heavy, your [if cocks of player > 0]prostate[else][bodytype of player] body[end if] feels awash in pleasure even as the buff dog's knot is knocking at your back door once again, seeking entrance into you.  He licks and nips at your shoulder and neck as he puts a muscular arm around your [bodydesc of player] body and holds you tightly as he grinds that meaty bulb firmly against your anus, coaxing it to spread even further.  A few hard pushes like that and your back door opens enough to accommodate the added thickness long enough for him to tie with you before locking tight around it.  The Doberman gives a growling gasp as your rectal walls clamp down hard around his knot, milking his cock all the more.  This sends him into a wild frenzy of humping like a true canine, each shallow thrust accompanied by a burst of near-orgasmic pleasure from your [if cocks of player > 0]prostate and [end if]well-stuffed ass until you feel like you're about to pop.";
		WaitLineBreak;
		say "     Knowing he must be close as well, you moaningly ask him how that ass of your feels.  Panting with lust and an almost feral need to cum, he growls that it's fucking great and adds that he's going to fill you up real soon.  Smiling at this, you clench down around him all the harder and push back into his thrusts, panting and moaning for him to give it to you.  This heavy humping sends him over the edge into orgasmic bliss, blasting his heavy load of dobie cum into you.  The feel of that thick, creamy spooge pooling inside your bowels and feeling you with its heat is too much and you [if cocks of player > 0 or cunts of player > 0]cum[else]are overcome with a rush of physical delight[end if] moments later.  The quivering and clenching of your anus around his spurting shaft cause him to howl in ecstasy and hump you all the harder with another big rush of seed into you.  His semen is kept locked inside you by his thick knot, ensuring you are [if scalevalue of player < 3]stuffed to the point of your tummy visibly swelling[else]stuffed full of his virile load[end if].[mimpregchance]";
		say "     He nuzzles at your neck and licks your cheek, even sharing a kiss with you as he stays atop you for the half-hour or so before his knot goes down.  Only then does he pull free of your creamy asshole.  Unblocked, a gush of his creamy cum pours out of you before you're able to clench down and keep the rest of it inside you this time.  You flop down onto the messy floor with a happy moan, smiling up at him.  He again wipes his canine shaft off on your rear, kissing you as he does this time.  As he's heading out, he teasingly points to a mop and bucket for you to use once you've recovered.  Too content to get up quite yet, you growl and flip him off.  At this, he chuckles and says 'Maybe next time.'";
		increase libido of Tyr by 1;
	else:
		say "     Telling Tyr that you want him in your ass again, he nods and gives a little grin, showing no reluctance as he shucks his shorts.  He gives your ass a grab as you move onto all fours.  His cock is already fully erect at the prospect of filling your back door again.  You can't help but smile at his eagerness and grind your rear back against his pulsing manhood.  The feel of it rubbing between your cheeks, knowing it'll soon be stuffed inside you, is very exciting.  And from the way it's throbbing and drooling onto your ass, you can tell the Doberman's excited as well.";
		say "     Tyr takes a few sensual moments to help you prepare before taking his large cock inside you again, [one of]allowing his dribbling cock to lube your asshole.  He smears his sexual fluids across your crinkled hole, lightly pressing at it from time to time to further tease and excite you for the main event[or]smearing some lube onto your crinkled hole.  As he slides an initial finger into your anus, he spreads a generous amount of lube onto his cock.  Eying that glistening pole, you lick your lips and want it inside you all the more.  He continues the fingering, adding a second finger and then a third to work you open[or]pressing his muzzle between your ass cheeks and giving your pucker a slow lick[if anallevel is 3].  He continues licking at your crinkled hole, pressing and probing at it and eventually delving his tongue into your rectum and slathering it with his saliva.  The feel of that doggy tongue squirming around inside you makes your insides quiver with delight and long for even more[else].  He gives several more long, slow licks, getting you nice and slick[end if][cycling].  Only once he's gotten you to the point of moaning and whimpering with need does he relent and move on to mounting you with that lovely pillar of doghood of his.";
		WaitLineBreak;
		say "     The muscular male grabs your ass with both paws and kneads it even as he pushes gently forwards, opening your well-prepared back entrance for him.  As he sinks it into you, he pants and grins.  '[one of]Oh, that's the stuff[or]Mmmm, baby[or]I'm gonna enjoy this[or]Just like that[in random order],' he moans.  You can't help but smile at this, glad to see him enjoying himself, and push yourself back onto his rod, pushing a few more inches into your needy hole.  Having partially mounted you, he releases your ass and drops to all fours overtop of you so he can take your doggy-style, like his canine side would prefer as he starts humping you.";
		say "     By the time he's going at you hard and heavy, your [if cocks of player > 0]prostate[else][bodytype of player] body[end if] feels awash in pleasure even as the buff dog's knot returns to knock at your back door once again, seeking entrance into you.  He licks and nips at your shoulder and neck as he puts a muscular arm around your [bodydesc of player] body and holds you tightly as he grinds that meaty bulb firmly against your anus, coaxing it to spread even further.  A few hard pushes like that and your anus opens enough to accommodate the added thickness long enough for him to tie with you before locking tight around it.  The Doberman gives a growling gasp as your rectal walls clamp down hard around his knot, milking his cock all the more.  Tied with you once again, he goes into a wild frenzy of humping like a true canine, each shallow thrust accompanied by a burst of near-orgasmic pleasure from your [if cocks of player > 0]prostate and [end if]well-stuffed ass that has you moaning and panting with lust.";
		WaitLineBreak;
		say "     As your climax approaches, you squirm and wiggle your rear as best you can while tied to the sexy muscle-dog.  This added stimulation [one of]puts you over the edge, crying out in lustful release moments before Tyr's hot load starts to fill you[or]sends Tyr over the edge, pumping his hot load into you moments before your own lustful release[purely at random][if cocks of player > 0].  Your [cum load size of player] load splatters onto the floor beneath you as your [cock of player] penis[esmn] pulse[smv] with every hard push of dog meat against your prostate[else if cunts of player > 0].  Your [cunt size desc of player] cunt[sfn] quiver[sfv] and clench[esfv] as your honeyed juices run down your thighs as your other hole gets stuffed[else].  Your genderless [bodydesc of player] body is overcome with a rush of unfocused physical delight as your ass is stuffed by the virile male[end if].  Having his thick, creamy semen pooling inside you, trapped behind that knot and filling you more and more[if scalevalue of player < 3] until your belly is bulged by it all[end if], has you both panting and moaning loudly.";
		say "     He shares several kisses with you, his paws groping your sexy body and kneading your ass while you're tied to him.  It's about a half-hour or so before his knot's gone down enough for him to pop his cock free with a deliciously messy slurp that sends his trapped sperm pouring out of your hole.  You keep as much as you can in, though end up with a thoroughly creamed ass before you're able to stem the flow.  Tyr smiles at the sight of your messy bottom and gives your rear a playful pinch before heading off to attend to other matters around the club.";


to say TyrLost_GiveOral:	[only available through multiple victory menu]
	say "     Tyr falls back hard onto his tail after you last assault. Defeated, the Doberman takes a minute to revel in his loss before he grunts and then flips himself up onto his feet. Just when you think the other is about ready to renew the fight you find yourself cocking your head in confusion as he waves a hand at you. 'Well won warrior. I didn't expect to have my tail handed to me, but I suppose that I still have extra training to do. No matter though, to the victor goes the spoils.' Tyr lowers his head to chuckle about something, what you're not sure, before lifting his face to stare at you with glowing green orbs.";
	say "     Having decided what you want, you stride over to Tyr and pull the muscular stud into a hug.  He runs his strong hands over your [bodydesc of player] form as you kiss one another, tongue diving into his mouth.  After some playful tongue-fencing, you break the kiss and drop to your knees in front of him, pulling down his shorts as you do.  Finding him already half-hard after the kiss, you put a hand around his stiffening shaft and pop his cock directly into your mouth.  He releases a deep moan and looks down at you with surprise on his muzzled face.  'I'd have thought you'd want to... ahhh... take something... ohh...' he groans as you suck down on his swelling rod.  Pulling your mouth free momentarily, you reply that that is exactly what you intend to do, rubbing his hefty, cum-filled balls with your free hand.  That said, you plunge your mouth right back onto his shaft before it can grow any further and becomes more difficult to stuff into your hungry maw.";
	say "     Tyr rubs his paws over your head and shoulders, panting loudly as his excitement builds.  His canine rod pulses and throbs in your mouth and throat, dribbling copious amounts of musky pre.  As his rod swells to its full size, your mouth is stretched wide around it, squeezing tightly around that throbbing meat.  Your tongue, palate and throat work over the manly spire while your hands knead at his large orbs, eager for their contents.  The muscular dog-man rocks his hips slowly, thrusting into your mouth as you suck him off.";
	say "     [bold type]As the Doberman's excitement nears its peak, you consider whether to keep blowing him and swallow down that load or pull off and let him coat you in it.[roman type][line break]";
	LineBreak;
	say "     ([link]Y[as]y[end link]) - Keep blowing him.";
	say "     ([link]N[as]n[end link]) - Pull off.";
	if the player consents:
		LineBreak;
		say "     Gripping his knot firmly in one hand, you rub and squeeze it while sucking down firmly on his manhood.  His canine instincts, feeling the [']tie['], drive him to hump your face in short, fast thrusts.  He cums with a howl of pleasure soon after, the first of several powerful blasts of cum shooting down your throat and into your belly.  As he continues to cum, your belly is filled with his seed and his semen overflows from your mouth as you can't swallow it down fast enough.  The taste is strong, musky and distinctly canine - and quite delicious to your sex-addled mind.  Wanting more and more of it, you keep nursing at his cock and rubbing his ballsac until the last dribbles of cum finally end.";
		say "     Once his cock's done feeding you its seed, you ease it from your lips.  You lick and kiss along that impressive rod, getting the last dregs of that tasty load from it.  With his cock cleaned, Tyr chuckles and rubs your head, thanking you for remembering to do the clean-up.  You get back on your feet, wipe the overflowed cum from your face and suck it from your fingers in a teasing show, grinning at the lustful look the big dog gives you.";
	else:
		LineBreak;
		say "     You ease your mouth from his throat-stuffing cock with some effort, licking over every inch as you do.  When you pull the last of it free, you squeeze down firmly on his knot in imitation of a tie with a bitch.  This is enough to push to muscular canine over the edge and his cock throbs in your hand, blasting large globs of thick, creamy seed onto your face.  Opening your mouth, you catch several mouthfuls to swallow down before aiming his shaft lower and letting his semen splatter across your [bodytype of player] body.  Soon much of your front is covered in the virile male's load, flooding your nose with his scent as you are covered in his essence.";
		say "     When the cum flow slows to a trickle, you return his penis to your mouth, licking and sucking on the glans until his flow finally ends.  Sticky with his seed, you flop down on the ground, running your hands over your [bodydesc of player] body, enjoying the feel of it clinging to you.  You'll eventually need to clean up the mess you've made, but you're quite happy to stay and wallow in it for some time before doing so.";

to say TyrLost_GetFellatio:	[only available through multiple victory menu]
	say "     Tyr falls back hard onto his tail after you last assault. Defeated, the Doberman takes a minute to revel in his loss before he grunts and then flips himself up onto his feet. Just when you think the other is about ready to renew the fight you find yourself cocking your head in confusion as he waves a hand at you. 'Well won warrior. I didn't expect to have my tail handed to me, but I suppose that I still have extra training to do. No matter though, to the victor goes the spoils.' Tyr lowers his head to chuckle about something, what you're not sure, before lifting his face to stare at you with glowing green orbs.";
	say "     Taking your cock in hand, you give it a firm stroke and tell him to start sucking.  He grunts and nods, getting onto his knees and taking it in hand[if cunts of player > 0].  'Wouldn't you rather I...' he starts to ask, eying your puss[yfn], but then shrugs and smiles[end if].  He gives your [cock size desc of player] [cock of player] penis a slow lick.  'Still, I should be happy you're only looking to get blown, I guess,' he says with a meaningful waggle of his rump even as he slides his canine muzzle down over your cock.";
	WaitLineBreak;
	say "     Despite his earlier reluctance, his muzzle and tongue work over your throbbing manhood with skill.  The long, doggy tongue plays across your shaft and glans as he bobs his head over it.  You teasingly compliment him on what a fine job he's doing of sucking that cock, but he only grins and sucks you all the harder, drawing a groan of pleasure out of you.  You place your hands on his head and stroke it, scritching the canine's ears[if cock length of player < 5].  He lavishes attention upon your small shaft, letting his tongue play all over it[else if cock length of player < 9].  He lavishes attention upon your shaft, letting his tongue play over his meaty mouthful[else if cock length of player < 20].  He lavishes attention upon your shaft, letting it slide over his tongue and down his throat as he pushes to take it all in[else].  He does his best to lavish attention upon the whole of your shaft, taking as much as he can of your [cock size desc of player] cock down his throat[end if].";
	say "     Seeing the big, manly stud down on his knees with your [cock of player] cock stuffed in his muzzle is quite arousing.  As you thrust faster into his muzzle, he slurps and sucks at your cock, swallowing down your precum with soft moans.  As your climax approaches, you warn him that you're about to cum should he want to pull off, but he keeps going at it past the point you start to cum.  He sucks down your seed, letting the warm, gooey spooge slide down his throat, tail wagging as he does.  As your cock is spurting out the last few shots, he pulls his muzzle back so only your glans rests between his lips, letting the final globs coat his tongue before he swallows them down as well.  That done, he gives your wang a parting lick before getting up and patting you on the back and congratulating you again on your win.";

to say TyrLost_GetCunnilingus:	[only available through multiple victory menu]
	say "     Tyr falls back hard onto his tail after you last assault. Defeated, the Doberman takes a minute to revel in his loss before he grunts and then flips himself up onto his feet. Just when you think the other is about ready to renew the fight you find yourself cocking your head in confusion as he waves a hand at you. 'Well won warrior. I didn't expect to have my tail handed to me, but I suppose that I still have extra training to do. No matter though, to the victor goes the spoils.' Tyr lowers his head to chuckle about something, what you're not sure, before lifting his face to stare at you with glowing green orbs.";
	say "     Spreading your legs, you run a fingertip slowly across your [cunt size desc of player] pussy and tell him to get licking.  He grins at the prospect and licks his muzzle.  'Hot damn.  My pleasure, baby,' he says, getting onto all fours and sniffing up your leg to your juicy muff.  After a few teasing brushes of his tonguetip that barely touch your folds, you grab his head and pull his muzzle firmly to your snatch, telling him that you want to be eaten the fuck out, not daintily tasted.  He nods and slathers his tongue across your labia, then dives it into you.";
	WaitLineBreak;
	say "     You groan in satisfaction as he starts eating you out like a proper dog, long tongue lapping inside you as your pussy quivers in delight.  You run your hands over his head and scritch his ears, occasionally moaning in pleasure as he finds a particularly pleasurable spot to lick deep inside you.  Your vaginal fluids leak down his muzzle as the eager doggy laps up as much as he can get.  His technique shows considerable skill, probably having lots of experience at this before his transformation and making the most of his longer tongue to improve them.  Under the lingual assault of the canine, you are not able to hold out for long, especially when his tongue finds it way to your clit.  You cry out in orgasmic delight, fresh juices running down your legs and his muzzle as you climax twice in quick succession.  Overstimulated and flush from cumming so hard, you stumble back and support yourself with a hand gripping the chain link fence.  Tyr grins smugly and licks his muzzle long and slowly to clean the last of your tasty fluids from of chops.";


Part 4 - Player Loss Scenes

to say TyrWon_Vaginal:
	choose row monster from the table of random critters;
	say "Falling down onto your back in defeat Tyr doesn't bother to brag about his victory as he looks to you with focused jade eyes. 'Good fight warrior. Needs some improvement here and there, but I commend you for your effort. As he walks over to give you a hand up you chuckle at the [']compliment['] before gasping as you find yourself being bodily brought into the Doberman's hold. Looking up at Tyr in confusion you are suddenly reminded of his rules of your fight as he grumbles lustfully into the side of your neck.";
	say "Tyr kisses, or rather voraciously licks you across your face and then backs you against the end of the cage wall. Not having the energy to fight him after you little stint at trying to knock his head in, you simply give in to the Doberman as he shucks you out of your pants and then proceeds to rub his plump groin against your cunt. 'I'm so going to enjoy this. Do you know how often I get to fuck a willing [']anything['] in this place, wait, never mind, that didn't come out.' Tyr chuckles abashedly after breaking his lips from the connection they share with yours.[line break]";
	say "Not knowing what to say, as your mind is a little tripped out from that previous lip lock, you just let Tyr do as he pleases while you watch. When the Doberman moves a hand down to reach for the clasp of his shorts your lips pull up into a lecherous smirk as you watch the impressive sheath of the other pulling back from around eight hard inches of Dobie dick. 'Don't worry,' Your eyes snap up to look into the chuckling face of the other canine. 'I promise that you won't feel anything but a minor discomfort from me burying my lance into your sheath.' You dubiously look to the other before getting another lick across the face.[line break]";
	say "'Worry not, as I'll nay hurt a valiant warrior such as you,' Tyr promises just as the last few inches of his cock slip free from his furry pouch. When he dips the tapered head of his cock inside of you, you think the other a liar, that is, up until Tyr holds himself steady outside of your fluttering pussy and then looks you dead in the eye. You almost balk at the intensity within those orbs, but finally nod your consent when the other continues to remain firmly outside of you.[line break]";
	say "At your behest, Tyr thrusts his hips forward to bury the first few inches of his cock inside of your nethers. A hiss is your reply to this and the Dobie is quick to soothe your pain away with loving licks across the throat. Only when your [bodyname of player] body loosens itself from the tension coiling throughout does Tyr continue driving his forward inside of you. Feeling the Doberman moving further and deeper inside of you, you hiss and keen up to the other man as both pain and pleasure melt together inside of your head. Yet, it's only after the other is buried up to the tip of his knot that the Doberman stops to allow you the time to adjust.[line break]";
	say "[bold type]BIG[roman type] is the word that pops into your head as you wiggle your hips against Tyr's own muscular thighs. Feeling the Dobie fat balls hanging between his legs and brushing up against your taint you moan as your cervix locks up tight around Tyr in an attempt to hold him steadfast into you. 'There we go, now just enjoy the ride.' And with that Tyr is pulling back to begin thrusting inside of you.[line break]";
	say "Unlike a true Doberman Tyr doesn't jack hammer himself inside of your cunt in an effort to get off. Instead the other man works to find your most sensitive places in an effort to bring you unrestrained pleasure as he works his tapered tip further up into your cervix. As his waist rocks back and forth with slow, almost leisurely humps, for a moment, you forget yourself as you look into the jade green eyes shining back at you with unrelenting passion. With weighty orbs tapping at the underside of your body you are reminded of the finger dancing along the rim of your anus, threatening to push up inside of you.[line break]";
	say "However, Tyr makes no move to do so. Instead the Dobie is content with massaging your backside while stretching your pussy further and further around his cock. The knot at the base of his shaft has to be almost half full and you don't fight the wince that follows as it pops into you. A tender tease of fangs across your throat pulls your mind away from what's happening downstairs. When you next look down into Tyr's smiling face you find that the other laughing up at you.[line break]";
	say "Something about his smirk makes you want to belt the Dobie, but you have little time to think on this because soon the Tyr's bulb has inflated fully to tie the two of you together. A few more thrusts, these much more shallow than the first, and then Tyr freezes into place as he bites down onto the side of your neck in a claiming hold. When the first jet of warm seed rushes up into you, you find yourself screaming up to the top of the cage as climax sings throughout your body. You cum seconds after Tyr and quickly your belly fills and then threatens to explode from the wash of fluids going up inside of you.[impregchance][line break]";
	say "Pulling his fangs away from you the Doberman laves several apologetic licks across your neck as he continues to fill you up. 'I hope that if you have any of my brood that you'll help them to grow into strong pups just like you.' The declaration makes you blush as you think about how romantic that sounds, though quite out of place, given the circumstances. When the both of you drop back down from your mutual climaxes Tyr holds you tight into him as he lets his knot rest inside of you.[line break]";
	say "It takes almost half an hour for the Dobie to deflate, but when he does he refuses to let you go as he runs his tongue across your face lovingly.";


to say TyrWon_GetAnal:	[only available once acclimatized to anal]
	say "     Falling down onto your back in defeat Tyr doesn't bother to brag about his victory as he looks to you with focused jade eyes.  'Good fight warrior.  Needs some improvement here and there, but I commend you for your effort.  As he walks over to give you a hand up you chuckle at the [']compliment['] before gasping as you find yourself being bodily brought into the Doberman's hold.  Looking up at Tyr in confusion you are suddenly reminded of his rules of your fight as he grumbles lustfully into the side of your neck.";
	if libido of Tyr is 3:
		say "     Tyr gives you a tongue-filled kiss while reaching down to grope your ass.  Worn out and aroused by the fight, you can only moan into the long kiss.  'I think I'm in the mood for something I know you'll enjoy,' he says with a grin, his paw slipping between your ass cheeks to tease at your back entrance.  You can't help but smile at his new eagerness for taking you up the ass and don't resist as he pushes you against the cage wall.  You grip the chain link fencing tightly and grind back against his crotch.  'Eager for it, aren't you?' he chuckles before pulling down his shorts and freeing his large, canine rod.";
		increase libido of Tyr by 1;
	else:
		say "     Tyr gives you a tongue-filled kiss while reaching down to grope your ass.  Worn out and aroused by the fight, you can only moan into the long kiss.  'I think I'll be taking that fine ass of yours again as my prize.  I know how much you love that,' says with a grin, his paw slipping between your ass cheeks to tease at your back entrance.  You turn to face the cage wall as he presses you up against it, his paws groping you as he does.  You grip the chain link fencing tightly and grind back against his crotch.  'Eager for it, aren't you?' he chuckles before pulling down his shorts and freeing his large, canine rod.";
	WaitLineBreak;
	say "     Giving you a lecherous grin, Tyr grinds his cock against your tight pucker a few times before pulling back and applying some lube to both.  Some quick fingering later and you're hot and ready to go, much to the Doberman's delight.  Licking and nibbling at the back of your neck, he thrusts forward and pushes his doggy bone into you, burying it steadily inch by inch in your backside.  You pant and quiver in delight at the feel of it driving into you, filling your aching, needy asshole.  Having it inside you again feels great, just what you need to unwind after the wrestling match with him.";
	say "     As Tyr fucks you, he runs his hands over your [bodydesc of player] body, seeking out pleasure points.  Between the pounding thrusts of his canine rod and those teasing touches, your body quivers with pleasure and you have to grip the fencing all the tighter[if cocks of player > 0].  One of Tyr's paws eventually finds its way to your cock and wraps around it, stroking and pumping at your manhood in time to the motions of his penis into your needy body[else].  One of Tyr's paws eventually finds its way to your bare groin and rubs across it, resulting in a pleasant (if unfocused) sensation.  He licks your cheek and nibbles your ear, whispering that he hopes you'll find a cure for that soon so he can have even more fun with you next time[end if].  Feeling the effects of this, you start moaning for him to fuck you harder, which is a request he's more than happy to comply with.";
	WaitLineBreak;
	say "     The muscular Doberman picks up the pace, driving his cock harder and deeper into you[if cocks of player > 0], sending shivers of delight through your prostate[end if].  As his own excitement grows, you can feel more precum leaking into you, making you long for the even thicker treat to come.  He pants in your ear and nips at your neck, eventually gripping it in his teeth as he tries to bury his knot inside you.  That thick bulb pushes and grinds at your back door, slowly easing it open enough for him to pop in, tying you together in canine lust.  Locked in your tight passage now, he pounds you with feral abandon in short, frantic thrusts that have you clutching at the fence wall for support.";
	say "     As your climax approaches, you do your best to squirm and wiggle your well-stuffed ass while tied to the lustful dobie.  It's not long before [one of]you are sent over the edge with ecstasy and cry out[if cocks of player > 0] as you cum messily[end if].  Your orgasm is soon followed by Tyr's, the buff dog pumping his virile load into your ass[or]Tyr bites down harder and growls as he cums into you, pumping his virile load into your ass.  The feel of this sends you over the edge with ecstasy and you cry out[if cocks of player > 0] as you cum messily[end if][at random][if cocks of player > 0].  Your [cum load size of player] load stains the fence and the floor on both sides of it even as the Doberman's load fills your bowels again with his heat[else].  The Doberman's load fills your bowels again with his heat as he fucks you hard[end if][if scalevalue of player < 3].  His prolific output is enough to make your tummy bulge somewhat as his knot ensures it all stays locked inside you[else].  His prolific output splashes and spurts inside you while his knot ensures it all stays locked inside you[end if].";
	WaitLineBreak;
	say "     Once he's spent, his muzzle releases you and he gives you sore neck some tender kisses and licking while you both enjoy the feeling of him being tied inside your cum-filled bottom.  After about a half-hour, he's ready to pull out and his softening penis exits you with a wet, slurping pop that is followed by his creamy load running down your legs[one of].  You clench down and try to hold onto as much as you can, wanting to savour the feel of it inside you a while longer[or].  You let it all pour out in a large puddle beneath you, leaving you sticky with and reeking of the virile male's cum for quite some time[at random].  Tyr gives that messy bottom of yours a playful swat and you finally release the fence, dropping to the messy floor to recover while he goes back to his duties.";


to say TyrWon_GiveAnal:	[only available once acclimatized to anal]
	say "     Falling down onto your back in defeat Tyr doesn't bother to brag about his victory as he looks to you with focused jade eyes. 'Good fight warrior.  Needs some improvement here and there, but I commend you for your effort.  As he walks over to give you a hand up you chuckle at the [']compliment['] before gasping as you find yourself being bodily brought into the Doberman's hold.  Looking up at Tyr in confusion you are suddenly reminded of his rules of your fight as he grumbles lustfully into the side of your neck.";
	if lust of Tyr is 3:
		say "     Tyr looks you over for a moment, eyes lingering on your crotch.  He seems to come to a decision and pulls you into a tongue-filled kiss while groping your manhood.  Worn out and aroused by the fight, you can only moan into the long kiss.  After the kiss, he surprises you again by turning around and dropping to all fours, raising his tail in the air and grinning back at you.  'Come on before I change my mind.  I know you want another go at my ass,' he says with a waggle of his rear.  You can't help but smile at his new eagerness for taking it up the ass and quickly move into position.  'I knew you'd be up for it,' he chuckles, grinding back against your [cock size desc of player] [cock of player] erection.";
		increase lust of Tyr by 1;
	else:
		say "     Tyr looks you over for a moment, eyes lingering on your crotch before pulling you into a tongue-filled kiss while groping your manhood.  Worn out and aroused by the fight, you can only moan into the long kiss.  After the kiss, he turns around and dropping to all fours, raising his tail in the air and grinning back at you.  'I think I'll claim my prize right here,' he says, spreading his ass cheeks and putting his crinkled hole on display for you.  You smile at the sight and quickly move into position.  'I knew you'd be up for it,' he chuckles, grinding back against your [cock size desc of player] [cock of player] erection.";
	WaitLineBreak;
	say "     Tyr gives a soft moan that he tries to muffle as you slip a couple of saliva-slick fingers into his backside to help ready him[if anallevel is 3].  You pump them in and out while stroking his stiff cock.  Teasing and pressing at his prostate gets him to dribble more precum, which you then use to lube his asshole even further.  Once your teasing's gotten him panting heavily, you move on to the main event[else].  You stroke his stiff cock until he's panting heavily before moving on to the main event[end if] and guiding your [cock of player] cock to his glistening ring.  You grip his firm glutes as you push your [cock size desc of player] shaft into him, taking him once again, enjoying his lustful moans as he's penetrated.";
	say "     As you fuck Tyr doggy-style, you run your hands over his muscular body, teasing his nipples and squeezing those strong muscles of his.  Eventually a hand finds its way back to his cock, even harder now and dripping with precum.  You stroke along it and rub his hefty balls, adding to your enjoyment and his.  With your growing arousal, you start to pound into him faster and harder while panting in his ear, all the while [one of]telling him how sexy he is right now[or]moaning how delightfully tight his ass is[or]moaning about how much more fun it is now that he wants it in the ass too[or]whispering how nice it'll feel when you fill him with your cum[cycling].  He pants and nods in agreement, clenching his ass down and pushing harder into your thrusts.";
	WaitLineBreak;
	say "     As your climax approaches, you focus all your attention on stroking that dribbling cock of his while you thrust firmly into him.  The feel of his sexy ass gripping you tightly while you grind your meat against his prostate is wonderful and it's not long before [one of]you groan in orgasmic release.  This has Tyr follow shortly after, his anus clenching tightly followed by his shaft pulsing in your hand as splatters of doggy cum spray onto the floor beneath him[or]Tyr howls.  As his anus clenches down tightly around you and his shaft pulses in your hand, splatters of his doggy cum spray onto the floor beneath him.  His quivering asshole soon sets you off and you cum with a groan of orgasmic release[at random].  You bang away at him through your orgasm, pumping your [cum load size of player] load into him even as his own balls drain their virile load.";
	say "     You keep going, thrusting and stroking, until you're both left panting and satisfied, at least for the moment.  Afterwards, you rest atop his strong body, caressing those hard muscles as he supports you.  When you eventually pull out, he gives a soft, needy whimper that makes you smile.  You stroke his messy rear and tease a finger at his tailhole, telling him that you'd be happy to fill his needy ass again next time.  He smiles at this and gives you a playful poke, warning that next time it might be your turn.";


to say TyrWon_Cunnilingus:
	say "Falling down onto your back in defeat Tyr doesn't bother to brag about his victory as he looks to you with focused jade eyes. 'Good fight warrior. Needs some improvement here and there, but I commend you for your effort. As he walks over to give you a hand up you chuckle at the [']compliment['] before gasping as you find yourself being bodily brought into the Doberman's hold. Looking up at Tyr in confusion you are suddenly reminded of his rules of your fight as he grumbles lustfully into the side of your neck.";
	say "'I think I smell something I like so I'm going to have some fun with my well won prize.' Tyr sneers sexually at you before turning the both of you around and then pushing you bodily into the wall of the cage. A grunt surges free from your lips as your [bodyname of player] body hits the unforgiving barrier, but you have little time to be discomforted by this move because soon the Doberman has your pants unzipped and his nose buried into the outer folds of your pussy. When a cold nose brushes up against your clitoris you shiver as rapt pleasure runs across your spine, but when a warm tongue rolls across the inside of your labia you can only gasp as your hands reach down to caress the top of Tyr's floppy-eared head.[line break]";
	say "You think you hear the other say something about [italic type]naughty bitch[roman type], but you're not sure because when next the Dobie's tongue moves the organ heads up to caresses into the inside of your cervix. At that point you momentarily go deaf. When Tyr pushes you back further into the cage you vision whites out as the Doberman nibbles across the outer folds of your nether lips and then scoops his tongue	throughout the depths of your cunt. A hand reaching up to play across the line of your rump makes another shudder run throughout your spine.[line break]";
	say "Tyr lifts you up by your legs soon after he's widened the inner sanctum of your pussy, something that catches you by mild surprise, and then slowly begins to bob his head back and forth as though fucking you with his tongue. Not knowing how to handle the mind-blowing feel of the Dobie's fur tickling your crotch while his tongue washes your insides down with his warm drool you howl up to the sky as your nethers flex around the Doberman's nose. From the slow rocking motions to the firm and unrelenting hands holding you in a controlled grasp you find yourself getting the oral of a lifetime as Tyr savors the taste of your cunt across his tongue.[line break]";
	say "With this kind of stimulation it doesn't take long for your back to arch and then your mind to explode as something reminiscent of a elephant's trumpet goes off throughout your head. A howl and tightening of your pussy a second later and Tyr is drinking down your warm nectar as you liberally flood the Dobie maw with your warmth. Tyr doesn't seem to mind, actually he seems to enjoy your climax the same as you as he buries his tongue further up into your drooling nethers while lavishing the outer edges of your cunt in unrestrained adulation. It takes some time, maybe about five minutes, but when you come down from off of your impressive sexual high you find that your pants have been corrected back onto your waist and Tyr is nowhere in sight.";

to say TyrWon_Training:
	say "Falling down onto your back in defeat Tyr doesn't bother to brag about his victory as he looks to you with focused jade eyes. 'Good fight warrior. Needs some improvement here and there, but I commend you for your effort. As he walks over to give you a hand up you chuckle at the [']compliment['] before gasping as you find yourself being bodily brought into the Doberman's hold. Looking up at Tyr in confusion you are suddenly reminded of his rules of your fight as he grumbles lustfully into the side of your neck.";
	say "'Believe it or not, but I'm not really that horny right about now.' Tyr seems a little miffed about this and looks up at the sky almost evilly before shaking his head. 'So instead of sex, how about some training?' Looking over the other to see if he's serious you find yourself nodding when Tyr looks pointedly at you. 'Alright,' Walking the two of you over to the center of the pit area you had been fighting in Tyr gets himself into position and then begins to show you some forms that you could stand to learn. The other is rough with his teaching, and given your weakened state you find yourself stumbling more often than not and getting fussed at because of it, however, you have to admit that Tyr is a good trainer and you learn a couple of things you didn't know before.[line break]";
	say "When the two of you are done you find the Doberman taking you out of the arena and then into one of the rooms here in the club to give you a massage. 'This is to help you muscles relax so they won't be so achy later on.' Is what the Dobie says, but for some reason Tyr seems to find your crotch area the most interesting part of you to massage after he strips you out of your clothes and then begins running his hands over your sweating [bodyname of player] form. However, you don't say anything to the other about this. Instead you simply smile and relax as the Dobie goes over your arms, chest, thighs and legs. When he dips some of his fingers into your cunt to begin rolling them around inside of you, you pass out on the table minutes afterwards as Tyr presses along your g-spot causing you to orgasm.[line break]";
	say "When next you return to consciousness you find that Tyr is gone, but your [bodyname of player] is charged with a strange kind of energy. Though oddly enough, even though you find yourself dressed, you note that your crotch has a slightly sticky feel to it. Looking down you realize that it's because your pants are half open and something warm is covering over the crux of your thighs. Reaching and hand down and then bringing it up to your nose to take a whiff, you find yourself chuckling in amusement.";
	if tyrtraining is false:
		increase XP of the player by 25;
		now tyrtraining is true;


to say TyrWon_AnalPlay:
	say "Falling down onto your back in defeat Tyr doesn't bother to brag about his victory as he looks to you with focused jade eyes. 'Good fight warrior. Needs some improvement here and there, but I commend you for your effort. As he walks over to give you a hand up you chuckle at the [']compliment['] before gasping as you find yourself being bodily brought into the Doberman's hold. Looking up at Tyr in confusion you are suddenly reminded of his rules of your fight as he grumbles lustfully into the side of your neck.";
	say "'Uhm, don't take this the wrong way but I'm really not into guys. That is, fucking guys. However, I will compensate for today.' Not sure what the other means you have about two seconds to try and figure Tyr's cryptic words out before you are spun around and then pressed bodily into the chain link wall surrounding the cage. When your pants are ripped down off of your [bodyname of player] rear you find yourself mildly surprise when a cool and moistened nose is stuffed up inside of your ass.";
	WaitLineBreak;
	say "Not having been what you were expecting you are definitely not prepared to have a warm tongue bury itself inside of your rectum as Tyr begins to rim you. Once your brain has processed all of what is happening it doesn't take you long to get into the act, especially with the Doberman slobbery licking over and across the end of the star in between your rump. When the Dobie pushes his roving, wet organ up into your rectum and then ghosts his tongue along your prostate you hiss and then curl your fingers into the metal of the wall in front of you.";
	say "Minutes of this turn into almost half an hour and in that time your [cock of player] cock has become so hard that it's literally raining pre in a small shower against your belly. Grinding and rubbing up against the metal growing hotter because of being so close to your sweating form you pump your hips in time with Tyr's restless licking in hopes to get off soon. A firm hand reaching underneath you to caress your nuts makes you yip like a wounded hound. Back behind you, you can almost swear that you can feel the Doberman chuckling.";
	WaitLineBreak;
	say "Paying no never mind to this you arch forward and then moan as Tyr caresses the end of your [cock of player] cock with his firm and unforgiving hand. The licking at your behind and then fist now pumping at your cock threaten to send you into a spectacular orgasm, but you're just missing [italic type]something[roman type] to get you all the way over the edge. Seeing this Tyr adds that [']something['] when he pulls back from you with a wet and slightly sticky pop and then shoves three fingers into your loosened ass.";
	say "It only takes the Doberman three hard shoves back and forth inside of you to make you cum with explosive force. Yelling out to the world around you, you cream the wall of the pit with a dozen or so ribbons before slumping down onto your knees. Thankfully Tyr removed his fingers from inside of you before his claws could do damage, but you fail to notice this as your legs have currently given out on you.[line break]";
	LineBreak;
	say "'Not bad,' the Dobie praises, but for what you're not sure for what. 'Maybe next time I'll give you some pointers instead of just playing with you. Though then again, I do think you'd make a good chew toy.' The Doberman laughs and then hauls you up by your shoulder to help you to stand. When he places a cloth into your palm you tilt your head in confusion as to why he would do this.";
	say "'House rules. You made a mess, so you clean it up.' And at that Tyr leaves to go about his way. Mildly you wonder if there is a rule against spoiling the post-orgasm mood that you could charge the other with because right about now you are now so not feeling that warm and fluffy tingling feeling anymore.";

to say TyrWon_NoSex:
	say "Falling down onto your back in defeat Tyr doesn't bother to brag about his victory as he looks to you with focused jade eyes. 'Good fight warrior. Needs some improvement here and there, but I commend you for your effort. As he walks over to give you a hand up you chuckle at the [']compliment['] before gasping as you find yourself being bodily brought into the Doberman's hold. Looking up at Tyr in confusion you are suddenly reminded of his rules of your fight as he grumbles lustfully into the side of your neck.";
	say "Having lost to Tyr the Doberman grunts playfully at you before wiping both sweat and blood down from off of his face. Getting up to your feet you find yourself mildly curious as to what's about to happen next, that is, right before Tyr moves over to you and then opens his muzzle to speak. 'Not bad warrior. A little rough around the edges, but I'm pleased to see that you're worked hard enough to actually put up a decent fight. Maybe you'd like some pointers for next time?'";
	WaitLineBreak;
	say "Tyr's words spur you in a way you're not sure you know how to describe, but it matters little because soon the two of you are moving inside of the pit to an out of the way area to start training. Since your body is healing at an increased pace you find yourself really getting into the workout the Doberman's putting you through, especially when he comes up next to you to physically change the position of your body to show you a new form. You also find yourself not minding in the least when Tyr rubs his groin up the side of your [bodyname of player] rump to grind up against your ass.";
	say "If you had a cunt then I'd be happy show you how much of a warrior I am in the sack, as well as on the combat floor.' Tyr's words make you shiver, but you tell the other than next time, [italic type]when you win[roman type], then the other will be giving up his tail to you, male or no. 'Oh really? Then I'll have to train even harder so that I can beat you when next we fight.' Challenge set, both you and the Dobie continue to work out for several more minutes before Tyr calls it a day. When he brings you over and buries his fangs into your neck you hiss, but keep from crying out as you take this strange action as a sign of defeat from the other.";
	say "'Until next time warrior.' And with that the Doberman is gone about his way, leaving you to rub along the side of your now bleeding neck.";


[lust of Tyr]
[Tyr receiving anal]
[ 0 = not fucked yet, somewhat reluctant]
[ 1 = fucked once, reluctant]
[ 2 = fucked twice, barely hesitant]
[ 3 = fucked 3+, willing]
[ 4 = fucked at Tyr's victory]

[libido of Tyr]
[Tyr giving anal]
[ 0 = not fucked yet, somewhat reluctant]
[ 1 = fucked once, reluctant]
[ 2 = fucked twice, barely hesitant]
[ 3 = fucked at Tyr's victory]


Section 3 - Fight Pit

FightPit is a room.

Instead of sniffing FightPit:
	Say "The fighting pit smells of blood, sweat, exertion mixed in with canine musk, spooge and female honey.";

The description of FightPit is "The fighting is a giant cage area with a chain link fence surrounding it. The large arena has several different spaces where different fighter are either sparring or working out together to practice their different forms and the like. A small boy seems to be looking over the area from atop a desk off to the side of the entryway of the arena. Should he be here? Walking inside of the pit several you find several mutants looking at you with differentiating masks of emotions covering their faces. Some seem really eager to see you, others... well they look happy, but in the same way a dog does when looking at a new chew bone. Be careful, it looks like trouble may start here!".
Receptionist is in FightPit.




Section 4 - Receptionist

Receptionisttalk is a number that varies.

Receptionist is a man.
The description of Receptionist is "Off to the side out of the way a young boy is busy scribbling down on some documents with a feathered pen. With grey fur, wire framed lens, red ball cap on and slightly chubby puppy face looking up at you with bright golden eyes you wonder if Tyr knows the other is here. Staring somewhat transfixed by the other's cute pointed ears, button nose, and, from what you can see by peeking over the desk, a chubby black-furred body you wonder if the Doberman has lost him mind by having the other in this kind of place. That is, right before you notice the sign that says [bold type]Receptionist[roman type] hanging down from off of the side of his desk with a giant arrow pointed upwards. For real?".
The conversation of Receptionist is { "Everyone Have Fun Today!" }.
Receptionist is in FightPit.

Instead of linkactioning Receptionist:
	say "Possible Actions: [link]talk[as]talk Receptionist[end link], [link]smell[as]smell Receptionist[end link], [link]fuck[as]fuck Receptionist[end link], [link]battle[as]duel[end link][line break]";

Instead of sniffing the Receptionist:
	say "The young pup smells like a cute young boy who's got a big secret! Oh and cookies!";

instead of fucking the Receptionist:
	say "[one of]'Are you serious?! I'm just a puppy!?'[or]'Try it and I'll call Tyr on you!'[or]'No.'[or]With all the creatures out here you want to try and do [bold type]THAT[roman type] with me???'[or]Kris whimpers a bit and suddenly you feel ashamed of yourself.[or]Kris backs away from you and then starts to sob.[at random]";

Instead of conversing the Receptionist:
	If Receptionisttalk is 0:
		say "'Oh hey! Nice to meet you! My name's Kris, but most people around here call me the Receptionist.' The pup giggles at you and suddenly you feel as though you want to squeeze him into your chest in an impossibly tight hug. Is anything allowed to be this cute in this world anymore?[line break]";
		say "Anyway, welcome to the FightPit. Tyr's own little glorified haven for those people looking to battle their hearts away. If you want to participate in any of the fights happening here then just let me know and I'll call someone over to fight against you. Also, if you want to fight one of the Great Dane's you can only fight there here in the Pit as they don't venture away from the Club too often. They're kinda a mean bunch and don't like to take on weak people so be careful if you go up against them.' Kris lowers his ears onto his head as he says this.[line break]";
		say "'Also, if you're too far along in your pregnancy then you won't be allowed to fight. That's the rule of the FightPit set up by Tyr and I will enforce it as need be.' You wonder if the pup is serious, but looking into his golden eyes shimmering up at you, you find yourself feeling a vague sense of danger coming from off of the young one. But that can't be right. He's only four and a half feet tall![line break]";
		say "Nevertheless you nod to the other which gets a smile out of him. Dawww! Now you suddenly wish you had some cookies to give him";
		now Receptionisttalk is 1;
		decrease libido of player by 25;
		if libido of player < 0, now libido of player is 0;
	if Receptionisttalk is 1:
		say "[one of]'Hello, are you looking to fight today?'[or]'I hope you find today more joyous than yesterday!' Kris giggles at you.[or]'May your days be bright, young one.' Kris pops a hand over his muzzle after saying this and then giggles shyly.[or]'I wonder how the others are doing?'[or]'I hope Vis is getting alone well 'Va.'[or]'I miss Shimi's songs.'[or]Kris is drawing in a colouring book and barely notices you.[or]Kris is playing with a yo-yo.[or]Kris is watching the fights with rapt attention.[or]Kris looks sleepy.[or]Kris seems to be thinking up something important.[or]Kris is so cute you just want to hug him![or]'If you need to get some problems off of your chest try and talk with Tyr, he's surprisingly good at mediating conflicts.'[or]Kris yawns and then yips cutely.[at random]";



Section 6 - Fighting Arena

arenabattlecounter is a number that varies.
PitBattle is an action applying to nothing.

Understand "battle" as PitBattle.
Understand "duel" as PitBattle.
Understand "fight" as PitBattle.

Check PitBattle:
	if Receptionist is not visible, say "If you're feeling randy enough for a fight go out and find a random mutant to take on." instead;

Carry out PitBattle:
	if arenabattlecounter >= 16:
		say "     I'm sorry, but you've been fighting in the arena a lot.  The other competitors want to use the arena and the crowd's getting tired of seeing you.  We've got to keep it exciting for them, too.  Give it a break for a while before you come back.";
	else if gestation of child > 0 or larvaegg is 2:		[preggers or parasite eggs]
		say "I'm sorry, but I'm afraid that you'll have to withdraw any thoughts of fighting in the arena for now, with you being pregnant and all.' Kris shakes his head sadly at you before blinking bright gold eyes up into your [facename of player] face. 'In consolation, want me to tell you about my day?' At the heart-melting smile the pup shines up at you, you find yourself nodding, though not because you really want to.";
		Say "'Ok, so where to start?! [one of]Oh yeah, did you know that Tyr likes to[or]I usually start my day of by[or]I have the most fun when I[or]All of the pit fighters seem to like me, but[or]When I grow up I'm going to[or]I really wish Va and Bra would get along better[or]I hope that Shimi is doing well. She usually[at random]...' An hour later Kris has just finished his tale and you suddenly feel as though you've learned a lot about how to handle puppies. Maybe this will make you a better parent?";
		Decrease libido of player by 10;
		If libido of player < 0, now libido of player is 0;
		follow the turnpass rule;
	else:
		say "'Ok, so you want to fight? Well we have several candidates for you,' Kris says while looking over a document on top of his desk. 'Most of them are canines, so I hope that's not a problem!' You shake your head at Kris to let him know that you'll be fine with that. A nod of the pup's head and then he is passing a list over to you. 'Chose one and have fun!'[line break]";
		say "[arenafightcheck]";


to say arenafightcheck:
	now sextablerun is 0;
	blank out the whole of table of fucking options;
	if furry is not banned and guy is not banned:
		choose a blank row in table of fucking options;
		now title entry is "Wolftaur";
		now sortorder entry is 1;
		now description entry is "a lupine taur";
		choose a blank row in table of fucking options;
		now title entry is "Alpha Wolf";
		now sortorder entry is 2;
		now description entry is "a dominant wolf";
		choose a blank row in table of fucking options;
		now title entry is "Alpha Husky";
		now sortorder entry is 5;
		now description entry is "a dominant canine";
	if guy is not banned:
		choose a blank row in table of fucking options;
		now title entry is "Minotaur";
		now sortorder entry is 3;
		now description entry is "a mythological monstrocity";
	if furry is not banned and girl is not banned:
		choose a blank row in table of fucking options;
		now title entry is "Great Dane Rouge";
		now sortorder entry is 4;
		now description entry is "a female canine fighter";
	if furry is not banned and hermaphrodite is not banned:
		choose a blank row in table of fucking options;
		now title entry is "Wildcat";
		now sortorder entry is 6;
		now description entry is "an armoured herm feline";
	sort the table of fucking options in sortorder order;
	repeat with y running from 1 to number of filled rows in table of fucking options:
		choose row y from the table of fucking options;
		say "[link][y] - [title entry][as][y][end link][line break]";
	say "[link]100 - Nevermind[as]100[end link][line break]";
	while sextablerun is 0:
		say "Pick the corresponding number> [run paragraph on]";
		get a number;
		if calcnumber > 0 and calcnumber <= the number of filled rows in table of fucking options:
			now current menu selection is calcnumber;
			choose row calcnumber in table of fucking options;
			say "Fight the [title entry]: [description entry]?";
			if player consents:
				let nam be title entry;
				now sextablerun is 1;
				now inasituation is true;
				if nam is "Wolftaur":
					say "A burly looking wolftaur looks ready to fight you as it punches a fist into one of its massive clawed hands.";
					challenge "Wolftaur";
				else if nam is "Alpha Wolf":
					say "An alpha wolf growls at you while standing up onto its hind legs in preparation to battle.";
					challenge "Alpha Wolf";
				else if nam is "Minotaur":
					say "The beefy minotaur standing off to the side with his arms cross snorts as he turns to look decisively at you.";
					challenge "Minotaur";
				else if nam is "Great Dane Rouge":
					say "The unfamiliar Dane mutant growls at you while popping her neck from side to side. When she lifts up her lips to show you an impressive display of canines you gulp as you wonder what the hell have you gotten yourself into.";
					challenge "Great Dane Rouge";
				else if nam is "Alpha Husky":
					say "The alpha husky growls playfully as he looks over you with expectant eyes. He seems to think you're going to outright submit to him... but he's about to be proven wrong.";
					challenge "Alpha Husky";
				else if nam is "Wildcat":
					say "The wildcat seems to be living up to its name as the feline jumps around inside of the cage arena before coming to a land onto her twin feet right in front of you. Seems she really wants to fight by the feral smirk lining across her face.";
					challenge "Wildcat";
				now inasituation is false;
				say "Your battle over, you need to take a short break to recover.";
				increase arenabattlecounter by 8;
				follow the turnpass rule;
		else if calcnumber is 100:
			say "[bold type]Exit the fighting menu?[roman type]";
			LineBreak;
			say "     ([link]Y[as]y[end link]) - Yes.";
			say "     ([link]N[as]n[end link]) - No.";
			if the player consents:
				now sextablerun is 1;
			else:
				say "Pick between 1 and [the number of filled rows in the table of fucking options] or 0 to exit.";
		else:
			say "Invalid Option.  Pick between 1 and [the number of filled rows in the table of fucking options].";
	wait for any key;
	clear the screen and hyperlink list;

an everyturn rule:
	if arenabattlecounter > 0, decrease arenabattlecounter by 1;


Section 7 - LockerRoom

Club Lockerroom is a room.

The description of Club Lockerroom is "The room where the lockers are kept is rather comfy as the white walls surrounding the area offset the silver metal containers standing in two separate rows from one another. Inside of here you can both see and smell several different mutants all walking around. Some are conversing with each other while others are storing things inside of their respective lockers, but strangely none of them seem especially hostile or lustful towards one another. Maybe releasing some excess aggression in the pit has calmed down their raging hormones?".

Instead of sniffing Club Lockerroom:
	say "The locker room smells of fresh polish, multiple mutants, sweat, testosterone, estrogen, and other varying scents. Though strangely, no trace of cum or female juice can be found within here.";



Tyr's Club ends here.
