Version 1 of Frost Drake by CrimsonAsh begins here.

"Adds a Frost Drake creature to Flexible Survival's Wandering Monsters table"

Section 1 - Creature Responses

to say FrostDrakeDesc:
	setmongender 3;
	say "     Walking along the forest landscape, you hear an aggressive, reptilian-like bark. Turning around, you manage to quickly move to the side as a large figure shoots past you until it slows to a stop and turns to face you. The creature before you is a quadrupedal drake that moves with wicked sharp claws. It stands nearly six feet off the ground and is about ten feet in length, including another six feet of tail. It has silver-white scales, glowing yellow eyes, and is definitely a [']he['] if his slowly hardening, foot-long dragon cock is anything to go off of. He lets out another bark and a low growl before pouncing forward toward you.";

to say LoseToFrostDrake:
	if HP of Player > 0: 								  [DID THE PLAYER SUBMIT? - YES]
		if Player is herm: 			  [Yes = HERM Identified!]
			say "     You back down and drop your weapon, raising your hands in surrender and hoping that the creature understands the concept. The large drake leaps toward you, tackling and pinning you to the ground. With strong claws on either side of your shoulders, the drake stares down at you with two burning eyes, brimming with both ferocity and intelligence, as well as an intense, wanting lust. The drake above you slides his tongue out of his toothy maw and across your face, down your cheek and over your lips, briefly flicking into your mouth before trailing down your chin and neck. Covering your face in warm saliva, the drake then moves down your body, letting free your sore shoulders. You briefly consider fleeing, but then the drake grips your lower clothes in his teeth, yanking them down before thrusting his long, thin, reptilian tongue into your now-exposed sex.";
			say "     You throw your head back and grip the small, pointed horns on the drake's smooth, scaly head and stare down into the lust-burning yellow eyes piercing back at you. The drake thrusts nearly a foot of tongue into your spit-slicked quim while his sharp teeth poke and scrape pleasurably against your tender skin and hard clit. His oral muscle radiates intense heat and you feel his tongue moving inside you like a tendril of burning pleasure. The drake's long, wet tongue twists and squeezes at your shaft and sack causing you to moan out and grip tighter to your drake's head. More skillful than his feral looks would suggest, the drake then redoubles his efforts and nips at your clit while his front claws move to grip your lower half and lift you up slightly as the drake furiously eats you out, all the while staring intensely back at you. You don't last, the frost drake brings you to a swift orgasm, and you clench around his warm, wet muscle. He draws out your orgasm before you come down from the sexual high, panting and gasping in pleasure.";
			WaitLineBreak;
			say "     You stare up at his burning yellow eyes and give a slightly dazed smile, spreading your legs and wrapping them around his scaly hips before giving him a nod. Taking that as invitation enough, the drake moves his hips and drooling dragon cock to the entrance of your nether lips. Wasting no more time, the drake thrusts into you, burying his large, foot-long length into your slick pussy. You let out a loud moan at the penetration and throw your head back, giving the drake an opportunity to run his tongue predatorily down your neck. It's not long before the drake's more feral nature takes over, his thrusts speeding up and his movements becoming more erratic and wild. Soon you're much the same, panting and yelping at every thrust, a servant to pleasure, letting instinct take over as you hold onto your drake for dear life. He moves back and forth, slowly building up both your climaxes. His heavy claws lie nearby in the dirt, digging deeply into the earth as he fucks you raw.";
			say "     The drake hammers into your cunt, your womanhood spasming around his rod as your own member bounces back and forth in between your two bodies. It comes to an eventual end and the drake thrusts deep into you, bottoming out inside you and then cums explosively with you. You clamp down around his member as it shoots thick loads of drake cum into your womb, painting it white. Your cunt sucks his seed of its own accord, hugging and caressing the dragon's cock and welcoming every drop of his virile cum into you. You shoot your load over your chest and moan out as you cover yourself in your own ejaculate. You come to from your orgasm just in time to feel the drake drag his member from your thoroughly fucked quim. You let out a loud moan as he slips it from you, and flowing out of your abused yet satisfied lips is a torrent of cum that oozes out and runs down your leg. Licking across your parted, gasping lips affectionately, the drake backs up, his softening length slowly receding before he takes off into the snowy landscape, leaving you to recover from your sexual bliss.[fovichance]";
			CreatureSexAftermath "Player" receives "PussyFuck" from "Frost Drake";
		else if Player is female: 	  [Yes = FEMALE Identified!]
			say "     You back down and drop your weapon, raising your hands in surrender and hoping that the creature understands the concept. The large drake leaps toward you, tackling and pinning you to the ground. With strong claws on either side of your shoulders, the drake stares down at you with two burning eyes, brimming with both ferocity and intelligence, as well as an intense, wanting lust. The drake above you slides his tongue out of his toothy maw and across your face, down your cheek and over your lips, briefly flicking into your mouth before trailing down your chin and neck. Covering your face in warm saliva, the drake then moves down your body, letting free your sore shoulders. You briefly consider fleeing, but then the drake grips your lower clothes in his teeth, yanking them down before thrusting his long, thin, reptilian tongue into your now-exposed sex.";
			say "     You throw your head back and grip the small, pointed horns on the drake's scaly smooth head and stare down into the lust-burning yellow eyes piercing back at you. The drake thrusts nearly a foot of tongue into your spit-slicked quim while his sharp teeth poke and scrape pleasurably against your tender skin and hard clit. His oral muscle radiates intense heat and you feel his tongue moving inside you like a tendril of burning pleasure. More skillful than his feral looks would suggest, the drake redoubles his efforts and nips at your clit while his front claws move to grip your lower half and lift you up slightly as the drake furiously eats you out, all the while staring intensely back at you. You don't last, the frost drake brings you to a swift orgasm and you clench around his warm, wet muscle. He draws out your orgasm before you come down from the sexual high, panting and gasping in pleasure.";
			WaitLineBreak;
			say "     You stare up at his burning yellow eyes and give a slightly dazed smile, spreading your legs and wrapping them around his scaly hips before giving him a nod. Taking that as invitation enough, the drake moves his hips and drooling dragon cock to the entrance of your nether lips. Wasting no more time, the drake thrusts into you, burying his large, foot-long length into your slick pussy. You let out a loud moan at the penetration and throw your head back, giving the drake an opportunity to run his tongue predatorily down your neck. It's not long before the drake's more feral nature takes over, his thrusts speeding up and his movements becoming more erratic and wild. Soon you're much the same, panting and yelping at every thrust, a servant to pleasure, letting instinct take over as you hold onto your drake for dear life. He moves back and forth, slowly building up both your climaxes. His heavy claws lie nearby in the dirt, digging deeply into the earth as he fucks you raw.";
			say "     The drake hammers into your cunt, your womanhood spasming around his rod. It comes to an eventual end and the drake thrusts deep into you, bottoming out inside you and then cums explosively with you. You clamp down around his member as it shoots thick loads of drake cum into your womb, painting it white. Your cunt sucks his seed of its own accord, hugging and caressing the dragon's cock and welcoming every drop of his virile cum into you. You come to from your orgasm just in time to feel the drake drag his member from your thoroughly fucked quim. You let out a loud moan as he slips it from you, and flowing out of your abused yet satisfied lips is a torrent of cum that oozes out and runs down your leg. Licking across your parted, gasping lips affectionately, the drake backs up, his softening length slowly receding before he takes off into the snowy landscape, leaving you to recover from your sexual bliss.[fovichance]";
			CreatureSexAftermath "Player" receives "PussyFuck" from "Frost Drake";
		else if Player is male: [Yes = MALE Identified!]
			say "     You back down and drop your weapon, raising your hands in surrender and hoping that the creature understands the concept. The large drake leaps toward you, tackling and pinning you to the ground. With strong claws on either side of your shoulders, the drake stares down at you with two burning eyes, brimming with both ferocity and intelligence, as well as an intense, wanting lust. The drake above you slides his tongue out of his toothy maw and across your face, down your cheek and over your lips, briefly flicking into your mouth before trailing down your chin and neck. Covering your face in warm saliva, the drake then moves down your body, letting free your sore shoulders. You briefly consider fleeing, but then the drake grips your lower clothes in his teeth, yanking them down before running his tongue across your shaft and around your testicles. You worry about his sharp fangs, but he seems more interested in molesting you rather than eating or maiming you. You only have a moment of thought before the drake twists his tongue around your shaft and pulls tight.";
			say "     You throw your head back and grip the small, pointed horns on the drake's smooth, scaly head and stare down into the lust-burning yellow eyes piercing back at you. The drake's long, wet tongue twists and squeezes at your shaft and sack, causing you to moan out and grip tighter to your drake's head. You don't last as the tongue flicks across your tip once more, shooting your load onto and around his squirming tongue. Your seed coats his maw and his tongue lashes out to catch your shooting spunk. You collapse back onto the icy ground huffing and puffing as you slowly recover. You stare up at his burning yellow eyes and give a slightly dazed smile, spreading your legs and wrapping them around his scaly hips and giving him a nod. Taking that as invitation enough, the drake moves his hips and drooling dragon cock to the entrance of your winking anal ring.";
			WaitLineBreak;
			say "     Wasting no more time, the drake thrusts into you, burying his large, foot-long length into your grasping ass. You let out a loud moan at the penetration and throw your head back, giving the drake an opportunity to run his tongue predatorily down your neck. It's not long before the drake's more feral nature takes over, his thrusts speeding up and his movements becoming more erratic and wild. Soon you're much the same, panting and yelping at every thrust, a servant to pleasure, letting instinct take over as you hold onto your drake for dear life. He moves back and forth, slowly building up both your climaxes. His heavy claws lie nearby in the dirt, digging deeply into the earth as he fucks you raw. The drake hammers into your ass, your anal walls spasming around his rod as your own member bounces back and forth in between your two bodies.";
			say "     It comes to an eventual end and the drake thrusts deep into you, bottoming out inside you and then cums explosively with you. You clamp down around his member as it shoots thick loads of drake cum into your body cavity, painting it white. Your ass sucks his seed of its own accord, hugging and caressing the dragon's cock and welcoming every drop of his virile cum into you. You shoot your load over your chest and moan out as you cover yourself in your own ejaculate. You come to from your orgasm just in time to feel the drake drag his member from your thoroughly fucked ass. You let out a loud moan as he slips it from you, and flowing out of your abused yet satisfied asshole is a torrent of cum that oozes out and runs down your leg. Licking across your parted, gasping lips affectionately, the drake backs up, his softening length slowly receding before he takes off into the snowy landscape, leaving you to recover from your sexual bliss.[movichance]";
			CreatureSexAftermath "Player" receives "AssFuck" from "Frost Drake";
	else: 										  [PLAYER LOST THE FIGHT!]
		if a random chance of 1 in 2 succeeds:
			say "[FrostDrakeFuck]";
		else:
			say "[FrostDrakeFaceFuck]";

to say FrostDrakeFuck:
	if Player is herm: 			  [Yes = HERM Identified!]
		say "     Shoved down to all fours, the large drake leaps onto your exposed back, fully pinning you to the ground below. With his hind legs, he yanks down any obstructions as you feel his heavy malehood rest on your lower back. You're soon surrounded by his warm, leathery scales as the drake drapes his large form over yours. His pointed tip pokes and prods at your ass cheeks before grazing your pussy lips and thrusting in. You nearly fall forward at the power of the movement. Bottoming out in you after the first thrust, the drake lets out a high-pitched roar of dominance and pulls out before hammering back into your vulnerable cunt.";
		say "     The drake's claws dig deeply into the dirt below, right near where you've dug your own fingers into the earth. You look down between your legs to where the draconic beast and yourself are joined. His reddish-pink member speeds up, smashing back and forth into your abused lips when a sudden rush of warmth fills your womb. You shriek as a sudden orgasm shoots through you and you clamp down around the cock filling you up. Despite the circumstances, you feel yourself shooting your hot load onto the earth below. You can feel hot dragon seed splatter your walls and flow out of your thoroughly creamed quim as the drake lets out another bark of victory. Suddenly yanking his meat from your oozing cunt, you let out a soft moan as the drake climbs off you. You find yourself missing his warm leathery hide as he gets up, shakes himself off and leans down to sniff you once before bounding off into the tree line, disappearing from sight.[fovichance]";
		CreatureSexAftermath "Player" receives "PussyFuck" from "Frost Drake";
	else if Player is female: 	  [Yes = FEMALE Identified!]
		say "     Shoved down to all fours, the large drake leaps onto your exposed back, fully pinning you to the ground below. With his hind legs, he yanks down any obstructions as you feel his heavy malehood rest on your lower back. You're soon surrounded by his warm, leathery scales as the drake drapes his large form over yours. His pointed tip pokes and prods at your ass cheeks before grazing your pussy lips and thrusting in. You nearly fall forward at the power of the movement. Bottoming out in you after the first thrust, the drake lets out a high-pitched roar of dominance and pulls out before hammering back into your vulnerable cunt.";
		say "     The drake's claws dig deeply into the dirt below, right near where you've dug your own fingers into the earth. You look down between your legs to where the draconic beast and yourself are joined. His reddish-pink member speeds up, smashing back and forth into your abused lips when a sudden rush of warmth fills your womb. You shriek as a sudden orgasm shoots through you and you clamp down around the cock filling you up. You can feel hot dragon seed splatter your walls and flow out of your thoroughly creamed quim as the drake lets out another bark of victory. Suddenly yanking his meat from your oozing cunt, you let out a soft moan as the drake climbs off you. You find yourself missing his warm leathery hide as he gets up, shakes himself off and leans down to sniff you once before bounding off into the tree line, disappearing from sight.[fovichance]";
		CreatureSexAftermath "Player" receives "PussyFuck" from "Frost Drake";
	else if Player is male: [Yes = MALE Identified!]
		say "     Shoved down to all fours, the large drake leaps onto your exposed back, fully pinning you to the ground below. With his hind legs, he yanks down any obstructions as you feel his heavy malehood rest on your lower back. You're soon surrounded by his warm, leathery scales as the drake drapes his large form over yours. His pointed tip pokes and prods at your ass cheeks before grazing your puckering asshole and thrusting in. You nearly fall forward at the power of the movement. Bottoming out in you after the first thrust, the drake lets out a high-pitched roar of dominance and pulls out before hammering back into your vulnerable ass.";
		say "     The drake's claws dig deeply into the dirt below, right near where you've dug your own fingers into the earth. You look down between your legs to where the draconic beast and yourself are joined. His reddish-pink member speeds up, smashing back and forth into your abused lips when a sudden rush of warmth fills your inner tunnel. You shriek as a sudden orgasm shoots through you and you clamp down around the cock filling you up. Despite the circumstances, you feel yourself shooting your hot load onto the earth below. You can feel hot dragon seed splatter your walls and flow out of your thoroughly creamed anus as the drake lets out another bark of victory. Suddenly yanking his meat from your oozing ass, you let out a soft moan as the drake climbs off you. You find yourself missing his warm leathery hide as he gets up, shakes himself off and leans down to sniff you once before bounding off into the tree line, disappearing from sight.[movichance]";
		CreatureSexAftermath "Player" receives "AssFuck" from "Frost Drake";

to say FrostDrakeFaceFuck:
	say "     You're shoved violently onto your back, the drake landing on your torso, his weight nearly crushing your chest. You struggle against his large body, but realize he's more trying to pin you rather than suffocate you. Both his legs wrapped tightly around your body, you look up to see the groin of a frost drake, a slowly hardening red draconic member oozing liquid from its tip. You're surrounded by the potent yet pleasant musk of the creature and you feel your body beginning to react, feeling yourself grow hot, and the foot long cock pressing against your face seems very tasty all of a sudden. You lick your lips and crane your neck up a bit to lick the tip of the dragon cock. Feeling your tongue against his member, the drake above you begins to react, pushing his thick muscled legs forward and shoving half his cock down your mouth. You gag slightly at the sudden deep penetration and bring your hand up to stroke the base of his shaft.";
	say "     You suckle his tip and stroke down his member for a while before the drake dragon moves his hips again and starts to thrust down your throat. Nearly choking you with each thrust, you're now completely at his mercy as he begins to speed up, throatfucking you roughly as he takes what he wants from you. You gurgle and suck loudly at his cock while pulling your neck up to get more of his member down your throat. With one final thrust, complete with a loud growl, the beast shoves all twelve inches of his draconic cock into your wanting mouth and cums. He empties his full sack into your stomach, only a few drops rising up to coat your mouth, all the while the member still continues plunging into it. The drake leaves his cock buried in your throat for a little while, just enjoying your warm wet orifice for himself before pulling out, dragging his spit-covered cock across your face before leaping off you, exposing you to the elements around. Looking back toward the drake, he's already bounding off around some trees, disappearing from sight.";
	CreatureSexAftermath "Player" receives "OralCock" from "Frost Drake";

to say BeatTheFrostDrake:
	if "Frost Drake" is not listed in EncounteredEnemies of Player: [first encounter]
		say "     Knocking back the big drake he stumbles forward toward you before collapsing and sliding forward a few feet before coming to a stop right in front of you. He tries to get to his feet but is too dazed to accomplish that. You notice his member his still hard, it throbs in need slightly, leaving you with a choice on what to do next.";
		say "     [bold type]Should you show this apex predator who's in charge?[roman type][line break]";
		LineBreak;
		say "     ([link]Y[as]y[end link]) - Yes, show him who's boss.";
		say "     ([link]N[as]n[end link]) - No, not gonna happen.";
		if Player consents: [Decides to fuck Frost Drake]
			LineBreak;
			say "[Frost DrakeSexMenu]";
		else:
			LineBreak;
			say "     You think for a moment but decide against your licentious impulse and turn to leave.";
	else: [repeat encounters]
		say "     You've knocked the fight out of another of these draconic monsters and he collapses in front of you. The large white-scaled creature shifts and makes a low groan trying to stand but eventually just lays there in defeat and exhaustion. Unable to move he resigns to waiting for what you do next. His dark eyes glare at you with curiosity, a little malice... as well as a glint of intelligence. Maybe you can talk to him?";
		LineBreak;
		say "     [bold type]What do you do now?[roman type][line break]";
		say "     [link](1)[as]1[end link] - Try to have a conversation with the frost drake.";
		say "     [link](2)[as]2[end link] - Just go ahead and fuck him.";
		say "     [link](3)[as]3[end link] - Leave.";
		now calcnumber is 0;
		while calcnumber < 1 or calcnumber > 3:
			say "Choice? (1-3)>[run paragraph on]";
			get a number;
			if calcnumber is 1 or calcnumber is 2 or calcnumber is 3:
				break;
			else:
				say "Invalid choice. Type [link]1[end link] to chat him up, [link]2[end link] to fuck or [link]3[end link] to leave.";
		if calcnumber is 1:
			say "     You ask the creature if he's alright, and calm enough to talk now. He groans and attempts to sit up to face you directly. He rumbles with a low growly but nods his head in understanding. Nodding your head for him to speak, you raise an eyebrow and wait for a reply. '...What do you want creature?' he huffs out.";
			say "[FrostDrakeTalkMenu]";
		else if calcnumber is 2:
			say "[Frost DrakeSexMenu]";
		else:
			say "     It's probably best to move on and not risk provoking the big defeated beast into round two. With a shrug, you move on and leave the drake behind.";

to say Frost DrakeSexMenu:
	say "     What shall you do with the big draconic being?";
	LineBreak;
	now sextablerun is 0;
	blank out the whole of table of fucking options;
	[]
	choose a blank row in table of fucking options;
	now title entry is "Suck him off";
	now sortorder entry is 1;
	now description entry is "Give the frost drake a blowjob";
	[]
	choose a blank row in table of fucking options;
	now title entry is "Demand oral";
	now sortorder entry is 2;
	now description entry is "Have the big drake service you";
	[]
	if Player is male:
		choose a blank row in table of fucking options;
		now title entry is "Fuck his ass";
		now sortorder entry is 3;
		now description entry is "Fuck the drake's ass raw";
	[]
	sort the table of fucking options in sortorder order;
	repeat with y running from 1 to number of filled rows in table of fucking options:
		choose row y from the table of fucking options;
		say "[link][y] - [title entry][as][y][end link][line break]";
	say "[link]0 - Nevermind[as]0[end link][line break]";
	while sextablerun is 0:
		say "Pick the corresponding number> [run paragraph on]";
		get a number;
		if calcnumber > 0 and calcnumber <= the number of filled rows in table of fucking options:
			now current menu selection is calcnumber;
			choose row calcnumber in table of fucking options;
			say "[title entry]: [description entry]?";
			if Player consents:
				let nam be title entry;
				now sextablerun is 1;
				if (nam is "Suck him off"):
					say "[SuckFrostDrake]";
				if (nam is "Demand oral"):
					say "[OralFrostDrake]";
				if (nam is "Fuck his ass"):
					say "[FuckFrostDrake]";
				wait for any key;
		else if calcnumber is 0:
			now sextablerun is 1;
			say "     You back away and shake your head.";
			wait for any key;
		else:
			say "Invalid Option. Pick between 1 and [the number of filled rows in the table of fucking options] or 0 to exit.";
	clear the screen and hyperlink list;

to say SuckFrostDrake:
	say "     You smile lewdly and walk forward, circling behind the draconic beast. He rests on his side and breathes heavily with anticipation, and from your earlier scuffle. You reach out and grip his limp, but still very solid, drake meat and squeeze it gently. The once ferocious predator lets out a gentle whine as his member grows thicker and longer, hardening in your grip. You smile and lean down to kiss the tip of the reptilian cock, giving him a smile before trailing your tongue down his length and back up again. You suckle his tip and fondle his tight, scaly sack before engulfing the head fully between your lips.";
	say "     You pull your head further down his length, swallowing it eagerly as you work for your treat. You begin to bob your head up and down the salty, slightly brimstone-scented manhood. Moaning around the foot long dragon cock, you pull yourself down so nearly every inch is down your gullet and your nose is pressed into his musky crotch. Letting out a loud somewhat undignified whine, the drake cums down your throat, filling your stomach with tasty fluids that spill back out of your throat into your mouth and around the drake's massive cock. You slowly pull yourself from his member letting it slide from your throat, followed shortly by a wave of pearly white cum that covers your chest. You look up to find the drake unconscious and snoring. Shaking your head and smacking your lips, you give the musky cock a final kiss before walking off, wiping thick seed from your face and chest and slurping it down.";
	CreatureSexAftermath "Player" receives "OralCock" from "Frost Drake";

to say OralFrostDrake:
	if Player is herm: 			  [Yes = HERM Identified!]
		say "     Grabbing hold of the frost drake's head, you stand victorious before the creature and bare your hard member to him. You pointedly remind him of the pain he's in for if he bites, and surprisingly he nods to you. You grin down at him and push his maw towards your crotch. His tongue lashes out and coats your cock in a thin layer of saliva before wrapping it tightly around your throbbing member. Your legs buckle and you struggle briefly to stay standing as the drake eagerly sucks you off with nothing but an incredibly flexible tongue and pushes forward against your crotch. You're pushed back a foot before stopping yourself and holding his head back firmly, ordering him to go slower. He complies, unwrapping nearly half his tongue and starting to gently flick it around your tip, tickling your glans with his slippery muscle and causing you to thrust forward. You then order him to go faster, then to push harder with his nose.";
		say "     For nearly twenty minutes you have this drake at your beck and call, having him service your spit-soaked member any and every which-way you like. Staring down at the burning embers of lust that is the drake's eyes, you smile and begin to push and hump the fuck-drake's face. You then throw your head back and allow yourself release. Your reptilian lover tightens his tongue-grip on your phallus until it's nearly painfully tight and your jism is squirting out like a small fountain. Your cum spurts out and around his slick tongue and across his draconic snout as you climax, your toes curling and your fingers clenched tightly. Coming down from your high, you smile affectionately down at the big lizard with the impressive tongue and cum-covered face before patting him on the head, gathering your stuff and moving on with your apocalypse.";
		CreatureSexAftermath "Frost Drake" receives "OralCock" from "Player";
	else if Player is female: 	  [Yes = FEMALE Identified!]
		say "     Grabbing hold of the frost drake's head, you stand victorious before the creature and bare your damp sex to him. You pointedly remind him of the pain he's in for if he bites, and surprisingly he nods to you. You grin down at him and push his maw towards your crotch. His tongue lashes out and coats your cunt in a thin layer of saliva before pushing into your lips. Your legs buckle and you struggle briefly to stay standing as the drake eagerly pushes further into your legs. You're pushed back a foot before stopping yourself and holding his head back firmly, ordering him to go slower. He complies, lapping at your sensitive lips gently and with great precision against your soft spots. You then order him to go faster, then to push harder with his nose.";
		say "     For nearly twenty minutes you have this drake at your beck and call, having him service your spit-soaked cunt any and every which-way you like. Staring down at the burning embers of lust that is the drake's eyes, you smile and begin to push and hump the fuck-drake's face. You then throw your head back and allow yourself release. Your reptilian lover thrusts up, hitting your most sensitive places in rapid succession and you clamp down around his slick tongue. Your juices squirt out and around his tooth-filled maw as you climax, your toes curling and your fingers clenched tightly. Coming down from your high, you smile affectionately down at the big lizard with the impressive tongue before patting him on the head, gathering your stuff and moving on with your apocalypse.";
		CreatureSexAftermath "Frost Drake" receives "OralPussy" from "Player";
	else if Player is male: 	  [Yes = MALE Identified!]
		say "     Grabbing hold of the frost drake's head, you stand victorious before the creature and bare your hard member to him. You pointedly remind him of the pain he's in for if he bites, and surprisingly he nods to you. You grin down at him and push his maw towards your crotch. His tongue lashes out and coats your cock in a thin layer of saliva before wrapping it tightly around your throbbing member. Your legs buckle and you struggle briefly to stay standing as the drake eagerly sucks you off with nothing but an incredibly flexible tongue and pushes forward against your crotch. You're pushed back a foot before stopping yourself and holding his head back firmly, ordering him to go slower. He complies, unwrapping nearly half his tongue and starting to gently flick it around your tip, tickling your glans with his slippery muscle and causing you to thrust forward. You then order him to go faster, then to push harder with his nose.";
		say "     For nearly twenty minutes you have this drake at your beck and call, having him service your spit-soaked member any and every which-way you like. Staring down at the burning embers of lust that is the drake's eyes, you smile and begin to push and hump the fuck-drake's face. You then throw your head back and allow yourself release. Your reptilian lover tightens his tongue-grip on your phallus until it's nearly painfully tight and your jism is squirting out like a small fountain. Your cum spurts out and around his slick tongue and across his draconic snout as you climax, your toes curling and your fingers clenched tightly. Coming down from your high, you smile affectionately down at the big lizard with the impressive tongue and cum-covered face before patting him on the head, gathering your stuff and moving on with your apocalypse.";
		CreatureSexAftermath "Frost Drake" receives "OralCock" from "Player";

To say FuckFrostDrake:
	if Player is herm: 			  [Yes = HERM Identified!]
		say "     You shove your large prey onto his scaly stomach and slap his muscled draconic ass. The drake lets out an undignified hiss, but after another slap to his ass, he quiets down. You caress the pale white scales of his ass before feeling under his tail for his clenching asshole. You finger and diddle his anal passage, fishing out your member while you do. You lick your finger and stick it deep into the drake's anal passage, and the drake lets out a groan as you stroke yourself to readiness. You withdraw your finger from his tight confines and align your cock with his pronounced anus. Without any delay, you thrust into the draconic drake. Your drake prey lets out another hiss, this one in raw delight.";
		say "     Pushing as far as you can go into his tight cavity, you pull back until just the tip remains before slamming back into the warm confines of the drake's ass. You hammer back and forth, holding the tail of the drake as an anchor while your hips slam into his. You squeeze at the shaking, muscled asscheeks you're currently pounding into and feel an unnatural warmth flow over yourself. With a jolt of energy, you speed up, and before you realize it, you're bottoming out in the drake's tight, stretched ass and emptying your entire load into his guts. He lets out a squeal and collapses downward, clenching around your thrusting member. You hear the dribble of seed spilling to the ground as the drake lets out a few last humps before he stops moving. You smile down at your unconscious drake before withdrawing your meat from the dragon's ass and tucking your slimy member away. You watch as your cum leaks from the drake's dominated ass before you turn and walk off.";
	else if Player is male: 	  [Yes = MALE Identified!]
		say "     You shove your large prey onto his scaly stomach and slap his muscled draconic ass. The drake lets out an undignified hiss, but after another slap to his ass, he quiets down. You caress the pale white scales of his ass before feeling under his tail for his clenching asshole. You finger and diddle his anal passage, fishing out your member while you do. You lick your finger and stick it deep into the drake's anal walls, and the drake lets out a groan as you stroke yourself to readiness. You withdraw your finger from his tight confines and align your cock with his pronounced anus. Without any delay, you thrust into the draconic drake. Your drake prey lets out another hiss, this one in raw delight.";
		say "     Pushing as far as you can go into his tight cavity, you pull back until just the tip remains before slamming back into the warm confines of the drake's ass. You hammer back and forth, holding the tail of the drake as an anchor while your hips slam into his. You squeeze at the shaking, muscled asscheeks you're currently pounding into and feel an unnatural warmth flow over yourself. With a jolt of energy, you speed up, and before you realize it, you're bottoming out in the drake's tight, stretched ass and emptying your entire load into his guts. He lets out a squeal and collapses downward, clenching around your thrusting member. You hear the dribble of seed spilling to the ground as the drake lets out a few last humps before he stops moving. You smile down at your unconscious drake before withdrawing your meat from the dragon's ass and tucking your slimy member away. You watch as your cum leaks from the drake's dominated ass before you turn and walk off.";
	CreatureSexAftermath "Frost Drake" receives "AssFuck" from "Player";

to say FrostDrakeRide:
	if Player is female: [female+herm]
		say "     Knocking the strong draconic beast to the ground certainly gives you an ego boost. He lands on his back as you stand before him victorious. He squirms a bit but seems incapable of getting himself up, and so he just groans and rolls about a bit on the ground. He's quite exposed like this, his scaly sheath on full display, as well as his full, heavy testicles and half chubbed reptilian member. You can't help but grin with mischief. And that twinkle in your eye seems to reach the downed beast. He squirms a little more but his legs just thrash about a bit, it actually looks quite humorous.";
		say "     Giggling at the sight you make your decision. You stride right up to the drake's downed lower body and straddle him slowly. Shedding your gear along the way. Sitting yourself atop his now slightly stunned form. His wide, burning eyes look up at you and you smile down at him, running a hand down your body and onto his. His foot long cock now unwillingly fully erect under your touch. You grip around the thick member and rub the shaft up and down your cunt. Conquering the drake like this certainly fills your head with dominant, lusty thoughts and wettens your womanly lips. Of which you smear up and down his pulsing member.";
		WaitLineBreak;
		say "     The drake groans below you, but it seems he can't help but gently thrust upward. You tease his tip with careful caresses and grind against him, every now and again nearly pressing the tip to your opening. But not quite penetrating. You tease your would-be conqueror until you yourself crave something more. And only then do you rise up atop the drake's member, wink down at him, and drop your hips down, spearing yourself on his fuck pole. You moan out, staring down with a lust crazed smile at the now drooling drake, gently humping up and down. But your in charge here, with one hand on the drake's chest and the other on your chest, you start to happily bounce on his cock. Rough slapping sounds echo around you as you take his foot-long in and out of your gripping sex.";
		say "     The drake huffs and puffs while you moan and chuckle at the sensation of riding your monstrous toy. Nearing your peak you drop to where your slamming into him and you strum your clit in time with your hilting of him inside you. That sends him over the edge. A torrent of burning hot spunk drowns your womb, filling you up and gushing out of your flooding cunt. The feeling of the drake climaxing beneath you, filling you with waves of hot seed has you clamping and cumming around the scaly prick with glee. [if Player is herm]You aim your raw cock, barely needing to be touched as it shoots its load all over the drake's chest. [end if]Throwing your head back your thighs squeeze tightly against the drake, your hips pressed to his as your moans fill the woods. You think you see stars briefly from the intense pleasure and heat shooting through you.";
		WaitLineBreak;
		say "     Your galloping of the drake's hips eventually come to an end. You slow to a stop and again look down with a smile at the passed out drake, dark tongue lolled out of his toothy maw. You withdraw even slower, letting the spunk slowly ooze out of your sex, sending little shivers down your back that then drip out of you. Standing above the beaten draconic monster you give a stretch and step away from his warm fuck-mass. Collecting your things and cleaning yourself off as best you can you walk off, thinking of warm scaly lovers writhing beneath your pussy while you do.";
		CreatureSexAftermath "Player" receives "PussyFuck" from "Frost Drake";
	else:
		say "     Knocking the strong draconic beast to the ground certainly gives you an ego boost. He lands on his back as you stand before him victorious. He squirms a bit but seems incapable of getting himself up, and so he just groans and rolls about a bit on the ground. He's quite exposed like this, his scaly sheath on full display, as well as his full, heavy testicals and half chubbed reptilian member. You can't help but grin with mischief. And that twinkle in your eye seems to reach the downed beast. He squirms a little more but his legs just thrash about a bit, it actually looks quite humorous.";
		say "     Giggling at the sight you make your decision. You stride right up to the drake's downed lower body and straddle him slowly. Shedding your gear along the way. Sitting yourself atop his now slightly stunned form. His wide, burning eyes look up at you and you smile down at him, running a hand down your body and onto his. His foot long cock now unwillingly fully erect under your touch. [if Player is male]You grip around the thick member and rub the shaft up and down, pressing it against your own hard cock and squeezing both together tightly. [end if]Conquering the drake like this certainly fills your head with dominant, lusty thoughts and wettens your appetite for his cock.";
		WaitLineBreak;
		say "     The drake groans below you, but it seems he can't help but gently thrust upward. You tease his tip with careful caresses and grind against him, every now and again nearly pressing the tip to the opening of your ass. But not quite penetrating. You tease your would-be conqueror until you yourself crave something more. And only then do you rise up atop the drake's member, wink down at him, and drop your hips down, spearing yourself on his fuck pole. You moan out, staring down with a lust crazed smile at the now drooling drake, gently humping up and down. But your in charge here, with one hand on the drake's chest and the other on your chest, you start to happily bounce on his cock. Rough slapping sounds echo around you as you take his foot-long in and out of your gripping back door.";
		say "     The drake huffs and puffs while you moan and chuckle at the sensation of riding your monstrous toy. Nearing your peak you drop to where your slamming into him once more. [if Player is male]You start jerking yourself off, slowly at first then going faster and faster as the sensitivity of your ass brings you close to orgasm. [end if]That gripping and sensation sends him over the edge. A torrent of burning hot spunk drowns your ass as deep as possible, filling you up and gushing out of your flooding anus. The feeling of the drake climaxing beneath you, filling you with waves of hot seed has you clamping and cumming around the scaly prick with glee. [if Player is male]You aim your raw cock, barely needing to be touched as it shoots its load all over the drake's chest. [end if]Throwing your head back your thighs squeeze tightly against the drake, your hips pressed to his as your moans fill the woods. You think you see stars briefly from the intense pleasure and heat shooting through you.";
		WaitLineBreak;
		say "     Your galloping of the drake's hips eventually come to an end. You slow to a stop and again look down with a smile at the passed out drake, dark tongue lolled out of his toothy maw. You withdraw even slower, letting the spunk slowly ooze out of your ass, sending little shivers down your back that then drip out of you. Standing above the beaten draconic monster you give a stretch and step away from his warm fuck-mass. Collecting your things and cleaning yourself off as best you can you walk off, thinking of warm scaly lovers writhing beneath your body while you do.";
		CreatureSexAftermath "Player" receives "AssFuck" from "Frost Drake";

Table of Random Critters (continued)
NewTypeInfection (truth state)	Species Name	Name	Enemy Title	Enemy Name	Enemy Type	Attack	Defeated	Victory	Desc	Face	Body	Skin	Tail	Cock	Face Change	Body Change	Skin Change	Ass Change	Cock Change	str	dex	sta	per	int	cha	sex	HP	lev	wdam	area	Cock Count	Cock Length	Ball Size	Nipple Count	Breast Size	Male Breast Size	Cunt Count	Cunt Depth	Cunt Tightness	Libido	Loot	Lootchance	Scale (number)	Body Descriptor (text)	Type (text)	Magic (truth state)	Resbypass (truth state)	non-infectious (truth state)	Cross-Infection (text)	DayCycle	Altcombat (text)	BannedStatus (truth state)
--	--	--	--	--	--	--	--	--	--	--	--	--	--	--	--	--	--	--	--	--	--	--	--	--	--	--	--	--	--	--	--	--	--	--	--	--	--	--	--	--	--	--	--	--	--	--	--	--	--	--;

When Play begins:
	Choose a blank row from Table of Random Critters;
	now NewTypeInfection entry is false;
	now Species Name entry is "Frost Drake"; [name of the overall species of the infection, used for children, ...]
	add "Frost Drake" to infections of ReptileList;
	add "Frost Drake" to infections of FurryList;
	add "Frost Drake" to infections of MythologicalList;
	add "Frost Drake" to infections of MaleList;
	add "Frost Drake" to infections of TaperedCockList;
	add "Frost Drake" to infections of InternalCockList;
	add "Frost Drake" to infections of BipedalList;
	add "Frost Drake" to infections of TailList;
	add "Frost Drake" to infections of TailweaponList;
	now Name entry is "Frost Drake";
	now enemy title entry is ""; [name of the encountered creature at combat start - Example: "You run into a giant collie." instead of using "Smooth Collie Shemale" infection name]
	now enemy Name entry is ""; [specific name of unique enemy]
	now enemy type entry is 0; [0 = non unique enemy; 1 = unique (unknown name); 2 = unique (known name) | Used to disqualify unique enemies from Vore/UB and showing the enemy name in encounters]
	now attack entry is "[one of]The drake bites at you and wounds you with his teeth![or]The drake leaps on you and slices you with its talons.[or]The drake slams into you.[at random]";
	now defeated entry is "[BeatTheFrostDrake]";
	now victory entry is "[LoseToFrostDrake]";
	now desc entry is "[FrostDrakeDesc]";
	now face entry is "";
	now body entry is "";
	now skin entry is "";
	now tail entry is "";
	now cock entry is "";
	now face change entry is "";
	now body change entry is "";
	now skin change entry is "";
	now ass change entry is "";
	now cock change entry is "";
	now str entry is 20;
	now dex entry is 12;
	now sta entry is 16;
	now per entry is 14;
	now int entry is 8;
	now cha entry is 10;
	now sex entry is "Male"; [ Infection will move the player towards this gender. Current: 'Male' 'Female' 'Both' ]
	now HP entry is 80; [ The monster's starting HP. ]
	now lev entry is 9; [ Monster level. (Level x 2) XP for victory. (Level / 2) XP for losing. ]
	now wdam entry is 10; [ Monster's average damage when attacking. ]
	now area entry is "Forest"; [ Case sensitive]
	now Cock Count entry is 1; [ number of cocks if sex is 'Male' or 'Both' ]
	now Cock Length entry is 12;
	now Ball Size entry is 3; [ Size of balls ]
	now Nipple Count entry is 2; [ Number of nipples. ]
	now Breast Size entry is 4; [cup size as number, counting Flat Pecs = 0, A = 1, B = 2, ...]
	now Male Breast Size entry is 0;   [ Breast size for if Sex="Male", usually zero. ]
	now Cunt Count entry is 0; [ number of pussies if sex is 'Female' or 'Both' ]
	now Cunt Depth entry is 0; [penetratable length in inches; some minor stretching allowed, or more with Twisted Capacity]
	now Cunt Tightness entry is 0; [size 1-5, generates adjectives of extremely tight/tight/receptive/open/gaping]
	now libido entry is 70; [ Amount player Libido will go up if defeated ]
	now loot entry is ""; [ Loot monster drops, usually infective with the monster's _own_ strain (for example if there is a Cross-Infection from sex)]
	now lootchance entry is 0; [ Chance of loot dropping 0-100 ]
	now scale entry is 4; [ Number 1-5, approx size/height of infected PC body: 1=tiny, 3=avg, 5=huge ]
	now body descriptor entry is "draconic";
	now type entry is "drake";
	now magic entry is false;
	now resbypass entry is false;
	now non-infectious entry is true;
	now Cross-Infection entry is ""; [infection that this infection will give the player when they lose; can be left empty if they infect with the monster's own]
	now DayCycle entry is 0; [ 0 = Up at all times; 1 = Diurnal (day encounters only); 2 = Nocturnal (night encounters only);]
	now altcombat entry is "default";
	now BannedStatus entry is false;

[
Table of New Infection Parts (continued)
Species Name	Name	Body Weight	Body Definition	Androginity	Head Change	Head Description	Head Adjective	Head Skin Adjective	Head Color	Head Adornments	Hair Length	Hair Shape	Hair Color	Hair Style	Beard Style	Body Hair Length	Eye Color	Eye Adjective	Mouth Length	Mouth Circumference	Tongue Adjective	Tongue Color	Tongue Length	Torso Change	Torso Description	Torso Adjective	Torso Skin Adjective	Torso Adornments	Torso Color	Torso Pattern	Breast Adjective	Breast Size	Male Breast Size	Nipple Count	Nipple Color	Nipple Shape	Back Change	Back Adornments	Back Skin Adjective	Back Color	Arms Change	Arms Description	Arms Skin Adjective	Arms Color	Locomotion	Legs Change	Legs Description	Legs Skin Adjective	Legs Color	Ass Change	Ass Description	Ass Skin Adjective	Ass Color	Ass Width	Tail Change	Tail Description	tail skin adjective	Tail Color	Asshole Depth	Asshole Tightness	Asshole Color	Cock Change	Cock Description	Cock Adjective	Cock Color	Cock Count	Cock Girth	Cock Length	Ball Description	Ball Count	Ball Size	Cunt Change	Cunt Description	Cunt Adjective	Cunt Color	Cunt Count	Cunt Depth	Cunt Tightness	Clit Size
--	--	--	--	--	--	--	--	--	--	--	--	--	--	--	--	--	--	--	--	--	--	--	--	--	--	--	--	--	--	--	--	--	--	--	--	--	--	--	--	--	--	--	--	--	--	--	--	--	--	--	--	--	--	--	--	--	--	--	--	--	--	--	--	--	--	--	--	--	--	--	--	--	--	--	--	--	--	--;

When Play begins:
	Choose a blank row from Table of New Infection Parts;
	now Species Name entry is ""; [name of the overall species of the infection, used for children, ...]
	now Name entry is ""; [matching infection name to Table of Random Critters]
	now Body Weight entry is 5; [scale of 1-9 for body weight, grouped into low weight (1-3), mid weight (4-6) and high weight (7-9)]
	now Body Definition entry is 5; [scale of 1-9 for body definition, grouped into low muscle (1-3), mid muscle (4-6), high muscle (7-9)]
	[Body Adjective is generated out of the body weight and body definition and can be used in scenes - one word descriptive adjective depending on weight and definition groups: low weight group: skinny/slender/lithe; mid weight group: average/fit/muscled; high weight group: pudgy/husky/jacked]
	now Androginity entry is 5; [1-9 scale of hypermasculine to hyperfeminine]
	[Gender Adjective is generated out of androginity 1-9: hypermasculine/masculine/effeminate/somewhat effeminate/androgynous/feminine butch/tomboyish/feminine/hyperfeminine]
	now Head Change entry is ""; [partial sentence that fits in: "Your head and face [one of]tingle[or]go flush[or]vibrate with odd pleasure[or]go cold[or]feel oily[at random] as [head change entry]."]
	now Head Description entry is ""; [partial sentence that fits in "Your face and head resemble that of [Head Description of Player]. You have [Eye Adjective of Player], [Eye Color of Player] eyes and an overall [Gender Adjective of Player] appearance."]
	now Head Adjective entry is ""; [one word descriptive adjective (avian/canine/...)]
	now Head Skin Adjective entry is ""; [one word descriptive adjective]
	now Head Color entry is ""; [single word color adjective for the dominant color of the skin/fur/feathers/scales]
	now Head Adornments entry is "";[partial sentence that fits in "Before moving on from your head, you give your [head adornments of Player] a proud glance followed by a light caress."]
	now Hair Length entry is 2; [hair length in inches]
	now Hair Shape entry is ""; [one word shape descriptor (curly/straight/...)]
	now Hair Color entry is ""; [one word color descriptor]
	now Hair Style entry is ""; [one word style descriptor (ponytail/mohawk/buzzcut/...) to fit "On top of your head you have [Hair Length of Player] inch long, [Hair Shape of Player] [Hair Color of Player] hair in the [Hair Style of Player] style."]
	now Beard Style entry is ""; [short beard style (goatee/3-day stubble beard/porn stache/mutton chops beard/...) to go into "You have a [Hair Color of Player] [Beard Style of Player]."]
	now Body Hair Length entry is 0; [numerical value, 0-4 (no body hair/light/moderate/heavy/furry) - only set to > 0 if the infection does not have fur/scales/etc. !]
	now Eye Color entry is ""; [one word color descriptor]
	now Eye Adjective entry is ""; [one word descriptive adjective (slitted/round/...)]
	now Mouth Length entry is 3; [inches deep for face fucking; maximum possible will be double this number (when deep throating)]
	[Mouth Length Adjective is generated by a function and can be used in scenes too - "petite, shallow, average, deep, bottomless"]
	now Mouth Circumference entry is 3; [mouth circumference 1-5, see Mouth Circumference Adjective]
	[Mouth Circumference Adjective is generated by a function and can be used in scenes too - "tiny, small, normal, wide, gaping"]
	now Tongue Adjective entry is ""; [one word descriptive adjective (wide/slobbery/...)]
	now Tongue Color entry is ""; [one word color descriptor]
	now Tongue Length entry is 3; [length in inches]
	now Torso Change entry is ""; [partial sentence that fits in: "Your torso [one of]tingles[or]goes flush[or]vibrates with odd pleasure[or]goes cold[or]feels oily[at random] as [Torso Change entry]."]
	now Torso Description entry is ""; [partial sentence, fitting in "Looking down at yourself, you appear [Gender Adjective of Player] with a [Body Adjective of Player] build. Your torso is [Torso Description of Player][if Body Hair Length of Player > 1], covered in [Torso Color of Player] skin and [Body Hair Description of Player][else if Body Hair Length of Player is 1], covered in smooth, [Torso Color of Player] skin[end if]."]
	now Torso Adjective entry is ""; [one word descriptive adjective (avian/canine/...)]
	now Torso Adornments entry is ""; [(pouch/udders/...); partial sentence to fit: "You take a moment to feel your [torso adornments of Player]."]
	now Torso Skin Adjective entry is ""; [one word adjective (feathered/furred/scaly/...); EMPTY "" for creatures with just skin]
	now Torso Color entry is ""; [single word color adjective for the dominant color of the skin/fur/feathers/scales]
	now Torso Pattern entry is ""; [single word color adjective for the dominant pattern of the skin/fur/feathers/scales]
	now Breast Adjective entry is ""; [adjective(s) example: round, pointy, perky, saggy, bouncy. This would serve as either a general appearance of a infections breasts or possibly something that may be effected by a item or NPC.]
	now Breast Size entry is 0; [cup size as number, counting Flat Pecs = 0, A = 1, B = 2, ...]
	now Male Breast Size entry is 0; [cup size as number, counting Flat Pecs = 0, A = 1, B = 2, ...]
	now Nipple Count entry is 2; [count of nipples]
	now Nipple Color entry is ""; [one word color descriptor]
	now Nipple Shape entry is ""; [shape example: any shape will do as long as it has a baseline with a current infection or item]
	now Back Change entry is ""; [partial sentence that fits in: "Your back [one of]tingles[or]goes flush[or]vibrates with odd pleasure[or]goes cold[or]feels oily[at random] as [Back Change entry]."]
	now Back Adornments entry is ""; [partial sentence to fit: "Your back tickles with the feeling of movement caused by [back adornments of Player]."]
	now Back Skin Adjective entry is ""; [one word adjective (feathered/furred/scaly/...); EMPTY "" for creatures with just skin]
	now Back Color entry is ""; [single word color adjective for the dominant color of the skin/fur/feathers/scales]
	[Limbs Adjective is generated by a function and can be used in scenes too - "rail-thin, slender, sinewy, average, firm, muscular, flabby, meaty, rippling"]
	now Arms Change entry is ""; [partial sentence that fits in: "Your arms [one of]tingle[or]go flush[or]vibrate with odd pleasure[or]go cold[or]feel oily[at random] as [Arms Change entry]."]
	now Arms Description entry is ""; [partial sentence to fit: "Your [Limbs Adjective of Player] arms are [Arms Description of Player]."]
	now Arms Skin Adjective entry is ""; [one word adjective (feathered/furred/scaly/...); EMPTY "" for creatures with just skin]
	now Arms Color entry is ""; [single word color adjective for the dominant color of the skin/fur/feathers/scales]
	now Locomotion entry is ""; [one word adjective: (bipedal/quadrupedal/octapedal/serpentine/sliding)]
	now Legs Change entry is ""; [partial sentence that fits in: "Your legs [one of]tingle[or]go flush[or]vibrate with odd pleasure[or]go cold[or]feel oily[at random] as [Legs Change entry]."]
	now Legs Description entry is ""; [partial sentence to fit: "As your inspection goes even lower, you come to the two [Body Adjective of Player] legs supporting you. They are [legs description of Player]."]
	now Legs Skin Adjective entry is ""; [one word adjective (feathered/furred/scaly/...); EMPTY "" for creatures with just skin]
	now Legs Color entry is ""; [single word color adjective for the dominant color of the skin/fur/feathers/scales]
	now Ass Change entry is ""; [partial sentence that fits in: "Your ass [one of]tingles[or]goes flush[or]vibrates with odd pleasure[or]goes cold[or]feels oily[at random] as [Ass Change entry]."]
	now Ass Description entry is ""; [partial sentence to fit: "Using your hands you feel your behind enjoying the sensation of your [Ass Width Adjective of Player], [Ass Shape Adjective of Player] [Ass Description of Player]." (For players with skin, instead of the period: ", covered in [Ass Color of Player] skin and [Body Hair Description of Player]"]
	now Ass Skin Adjective entry is "";  [one word adjective (feathered/furred/scaly/...); EMPTY "" for creatures with just skin]
	now Ass Color entry is ""; [single word color adjective for the dominant color of the skin/fur/feathers/scales]
	now Ass Width entry is 3; [ass width from 1-5]
	[Ass Width Adjective generated by function out of ass width: dainty/small/round/huge/enormous]
	[Ass Adjective generated by function out of body definition and ass width]
	now Tail Change entry is ""; [partial sentence that fits in: "Your rear [one of]tingles[or]goes flush[or]vibrates with odd pleasure[or]goes cold[or]feels oily[at random] as [if HasTail of Player is true]your existing tail is changed into a [Tail Description entry][else][Tail Change entry][end if]."]
	now Tail Description entry is ""; [partial sentence to fit: "Just below your lower back sprouts a [tail description of Player], which you move back and forth with glee."]
	now Tail Skin Adjective entry is ""; [one word adjective (feathered/furred/scaly/...); EMPTY "" for creatures with just skin]
	now Tail Color entry is ""; [single word color adjective for the dominant color of the skin/fur/feathers/scales]
	now Asshole Depth entry is 7; [inches deep for anal fucking]
	[Asshole Depth Adjective is generated by a function and can be used in scenes too - "petite (< 3), shallow (< 5), average (< 9), deep (< 15), bottomless (15+)"]
	now Asshole Tightness entry is 3; [asshole tightness 1-5, "extremely tight, tight, receptive, open, gaping"]
	[Asshole Tightness Adjective is generated by a function and can be used in scenes too - "extremely tight, tight, receptive, open, gaping"]
	now Asshole Color entry is ""; [one word color descriptor]
	now Cock Count entry is 0;
	now Cock Girth entry is 0; [thickness 1-5, generates the Cock Girth Adjective]
	[Cock Girth Adjective is generated by a function and can be used in scenes too: thin/slender/average/thick/monstrous]
	now Cock Length entry is 0; [length in inches]
	now Cock Adjective entry is ""; [one word adjective: avian/canine/...]
	now Cock Change entry is ""; [partial sentence that fits in: "Your cock [one of]tingles[or]goes flush[or]vibrates with odd pleasure[or]goes cold[or]feels oily[at random] as [Cock Change entry]."]
	now Cock Description entry is ""; [partial sentence to fit: "You have a [Cock Girth Adjective of Player], [Cock Length of Player]-inch-long [cock adjective of Player] [one of]cock[or]penis[or]shaft[or]maleness[at random] that [cock description of Player]."]
	now Cock Color entry is ""; [one word color descriptor]
	now Ball Count entry is 0; [allowed numbers: 1 (uniball), 2 or 4]
	now Ball Size entry is 0; [size of balls 1-7: "acorn-sized", "dove egg-sized", "chicken egg-sized" "goose-egg sized", "ostrich-egg sized", "basketball-sized", "beachball-sized"]
	[Ball Size Adjective is generated by a function and can be used in scenes too]
	now Ball Description entry is ""; [partial sentence to fit: "Underneath it hangs a pair of [Ball Size Adjective of Player] [ball description of Player]."]
	now Cunt Count entry is 0;
	now Cunt Depth entry is 0; [penetratable length in inches; some minor stretching allowed, or more with Twisted Capacity]
	now Cunt Tightness entry is 0; [size 1-5, generates adjectives of extremely tight/tight/receptive/open/gaping]
	[Cunt Tightness Adjective is generated by a function and can be used in scenes too: extremely tight/tight/well-used/open/gaping]
	now Cunt Adjective entry is ""; [one word adjective: avian/canine/...]
	now Cunt Change entry is ""; [partial sentence that fits in: "Your pussy [one of]tingles[or]goes flush[or]vibrates with odd pleasure[or]goes cold[or]feels oily[at random] as [Cunt change entry]."]
	now Cunt Description entry is ""; [partial sentence to fit: "You have a [Cunt Tightness Adjective of Player] [one of]cunt[or]pussy[or]vagina[or]cleft[at random] that [cunt description of Player]."]
	now Cunt Color entry is ""; [one word color descriptor]
	now Clit Size entry is 0; [size 1-5, see Clit Size Adjective]
	[Clit Size Adjective is generated by a function and can be used in scenes: very small/small/average/large/very large]
]


to say FrostDrakeTalkMenu:
	say "     What do you want to talk about?";
	LineBreak;
	now sextablerun is 0;
	blank out the whole of table of fucking options;
	[]
	choose a blank row in table of fucking options;
	now title entry is "His species";
	now sortorder entry is 1;
	now description entry is "Ask him about frost drakes in general";
	[]
	choose a blank row in table of fucking options;
	now title entry is "His origin";
	now sortorder entry is 2;
	now description entry is "Where did the frost drakes even come from all of a sudden";
	[]
	choose a blank row in table of fucking options;
	now title entry is "His plans";
	now sortorder entry is 3;
	now description entry is "What does the frost drake want";
	[]
	sort the table of fucking options in sortorder order;
	repeat with y running from 1 to number of filled rows in table of fucking options:
		choose row y from the table of fucking options;
		say "[link][y] - [title entry][as][y][end link][line break]";
	say "[link]0 - Nevermind[as]0[end link][line break]";
	while sextablerun is 0:
		say "Pick the corresponding number> [run paragraph on]";
		get a number;
		if calcnumber > 0 and calcnumber <= the number of filled rows in table of fucking options:
			now current menu selection is calcnumber;
			choose row calcnumber in table of fucking options;
			say "[title entry]: [description entry]?";
			if Player consents:
				let nam be title entry;
				now sextablerun is 1;
				if (nam is "His species"):
					say "[FrostDrakeTalk1]";
				if (nam is "His origin"):
					say "[FrostDrakeTalk2]";
				if (nam is "His plans"):
					say "[FrostDrakeTalk3]";
				wait for any key;
				say "[FrostDrakeTalkMenu]";
		else if calcnumber is 0:
			now sextablerun is 1;
			say "     As you are about to wave him off and conclude your little talk, the frost drake clears his throat and says, 'You are indeed a strange creature, very curious. Why is that exactly?'";
			LineBreak;
			say "     [bold type]Just how curious were you planning on being?[roman type][line break]";
			LineBreak;
			say "     ([link]Y[as]y[end link]) - Just some casual interest in strange creatures.";
			say "     ([link]N[as]n[end link]) - You'd like to gain some first-hand intimate knowledge of him.";
			if Player consents:
				say "     You shrug your shoulders and tell him you were just curious and wanted to ask some questions.' He looks at you a long while before slowly nodding and speaking, 'Ah... very well.' The two of you stare silently at one another for an uncomfortable amount of time before the drake simply stands up, nods again at you, turns, and walk away. You give a half hearted wave and turn back to the matter of surviving in this fallen city.";
			else:
				say "     Looking over the drake you can't help but appreciate his size, and his exotic nature. You've beaten back enough of these big guys to know what they're packing. And that makes your mind wander to the possibilities of what this big, scary brute can do. You pause, looking him up and down exaggeratedly, then tell him that he's quite an impressive specimen of his kind and you'd like to gain more intimate knowledge of him personally. The white-scaled drake grins, flashing rows of sharp draconic teeth at you, ember set eyes burning into your body, clearly undressing you visually already. You give him a coy smile in return and stride closer to the drake.";
				say "[FrostDrakeTalkSex]";
			wait for any key;
		else:
			say "Invalid Option. Pick between 1 and [the number of filled rows in the table of fucking options] or 0 to exit.";
	clear the screen and hyperlink list;

to say FrostDrakeTalk1:
	say "     You ask the drake what he is exactly, you've never seen a beast quite like him before. His eyes visibly squint at you, almost in a haughty, prideful way. His voice grumbles lowly but when he speaks that voice is strong and confident. 'I... am one of the few frost drakes remaining...' He answers reluctantly, however you won the fight, even he can see that. He pauses as if he's done speaking before starting up again. 'We were thrown into this new world, there can't be more than a few dozen of us now. We are too few to focus on anything but breeding now.' With how the licentious the city has become, filled to the brim with willing and unwilling breeders, you can't help but wonder how that can be. There should be numerous drakes by now, with the reproductive rate that the nanites bring with them.";
	say "     He shuffles to all fours as if to speak to you with more dignity. 'We... have lost much of our fertility after waking, I know not why, I have not even witnessed a drake birth after arriving, let alone born any wyrmlings myself.' He pauses again, looking around at your environment, slightly awkwardly. 'I worry what will become of my people, so few of us around, and so little to do except attempt to breed.' His head dips slightly, almost sadly, if that's even possible for a huge drake creature like himself, and you can't help but pity him just a little. 'We are proud and strong draconics, ancient, glorious history and culture in our world.' He pauses, 'we've lost much when we were forcefully thrown here. Whether we recover or not is... yet to be seen.'";

to say FrostDrakeTalk2:
	say "     You ask the big white-scaled drake where he hails from, he certainly doesn't look native to this world. The large creature shifts from claw to claw looking you up and down before answering. 'We come from the plane of winter, it is... much colder than any place I've seen here. It has been hard to adapt for us but we will live on, one way or another.' He grumbles, you tentatively ask if there are other creatures that live in his home world. 'White dragons and frost giants roam the lands there as well. They're also the snobolds, diminutive dog-like creatures, and the ice elementals that wander aimlessly. Conflicts are rare, mainly due to the vast space we have to ourselves, but ancient battles have been raged there, usually for the favor of a mate.'";
	say "     The drake shifts his weight to his hind quarters, moving to sit up while talking. 'Most of this climate is torture for our burning scales, but we will adapt where and when needed.' You nod and mention you'll keep an eye out for any frozen wastelands you see. His reptilian maw stretches into a grin and he nods solemnly. 'Is there something else you wanted to know? You won our battle so you have victor rights but I do need to find a fertile mate if the drakes are to survive.' He shifts again, exposing his lower belly... and bulging draconic sheath briefly before he settles again and his crotch is once again blocked from sight.";

to say FrostDrakeTalk3:
	say "     You ask the great beast what he wants exactly, well aside from the obvious. You hear a low rumbling coming from the chest of the drake, almost like a chuckle. 'The obvious comes first, we have no other current recourse except to breed virile mates in hope of fruit, and to find a more appropriately temperate home. Preferably we'd like to return to the land of winter but I see no obvious way at the point. And with so few of us now and with the strange effects of this new world.' Effects? You ask what he means. Again looking slightly awkward (for a large monstrous drake) his chest rumbles in thought, or possibly annoyance.";
	say "     'It has been... difficult to handle our urges here. Aside from the need to breed more for practical purposes, the burning heat has been hard to cope with. Without a mate or a fallen foe to satisfy us with we grow ravenous, thought becomes difficult and eventually you only see red, red and pure unhinged lust.' He rumbles again, casting his icy gaze towards the ground. He looks almost shameful for a moment before looking back to you. 'You were strong enough.' He says simply before going quiet, staring pensively at you.";

to say FrostDrakeTalkSex:
	if Player is female: [female+herm]
		say "     Striding up to the large draconic-like creature you run a hand delicately across his scales, they're surprisingly warm for a drake whose natural habitat is cold. And it only get hotter as you run it down his side all the while the drake looks on at you pensively. You suppose now that your on talking terms you can move on to more... pleasant terms. And your eyes locked on his transmit just that. Then they flicker down to his lower belly, searching for his familiar member. Sure enough, it's there, nearly at its full size, clearly excited by your suggestive language and movements.";
		say "     The drake flicks a long draconic tongue out, briefly lapping at your neck before reeling back and licking his lips. 'If we're to do this-' he growls lustfully. 'We'll be making sure it's a proper mating.' Again he grins, and this time you're certain its a smile that flashes your way. Your about to ask what he means when suddenly his strength returns to him and then big drake leaps at you. He hits you with his full weight, pushing you down to the ground below yet not landing on you. A long dark tongue rolls out of his maw and licks you efficiently across the face. His sharp claws hold you at your shoulders while the dominant drake's long tongue travels down your neck and across your upper body.";
		WaitLineBreak;
		say "     You're momentarily startled, but also further aroused by his sudden sexual aggression. Your hands reach up to grip his brawny, tough scales atop his clawed fore-legs for support while his tongue works its magic on your body, giving the horny beast a proper taste of you. Urging him to continue with little moans of approval when his tongue runs over a sensitive place you strip yourself so your made totally bare to your new found draconic lover. The drake clearly approves, as does his tongue as it once again laps across your face, his lustful growls and hisses clearly euphoric at the taste of you. The dark tongue grazes and flicks across your lips, and in response you open your own saliva glazed lips and lick back, getting quite into the intimate mating and kissing yourself.";
		say "     Your mouth opens wide, accepting the thick, slimy organ with lusty eagerness. The warm length lashes around in your mouth, exploring while your own tongue struggles to keep up. Suddenly it's withdrawn back, leaving behind a trail of saliva as it slurps back into his mouth. The drake growls near your ear, 'I am going to breed you, place a great egg in your womb.' You pat him on the side of the scaly head, correcting him by stating 'we're going to breed.' Before wrapping your lower half around his torso, and urging him to continue with a moan.";
		WaitLineBreak;
		say "     That rock hard, burning hot protrusion pokes at your tummy, eliciting a small giggle from you as you use your lower half to pull the drake closer to you. The drake has a similar idea, he lurches forward until the tip of his reptilian-like member presses into your womanhood. It penetrates you ever so slightly, just enough to send a shockwave of pleasure up your spine. His growls intensify, just as he thrusts forward fully, embedding his entire nearly foot long, scaly member into your weeping sex.";
		say "     You pull your head back and moan as he slides deep into you, stretching you in a most wonderous way. His scaly penis tickles at your sensitive pussy as you wrap your limbs around your draconic lover. The frost drake humps at your prone form, his growls and hisses fill your ear just like his scale-bumped member sawing in and out of your sex. The heat of his underside washes over you like a blanket of sex, his claws dig into the ground below while he hilts himself inside you, now over eager to screw your willing body into pregnancy. You tighten your hold on him, gripping onto his warm body as an anchor to ground yourself on as he fucks you into oblivion.";
		WaitLineBreak;
		say "     It doesn't take much longer for you to come to a screaming climax. The drake moves methodically in and out of you until his growls turn into a roar as you clamp down around his hilted member. Keeping it buried inside you as he unloads a torrent of draconic jism inside your hungry cunt. [if Player is herm]Your other male member pulses and shoots jets of spooge all over your own chest as your brought to various amounts of ecstasy.[end if] White hot cum paints your womb in sticky spunk, sending warm ecstasy through your body as the thrusts slowly calm to a gentle hump. Globs of thick seed oozes from your quim and drips onto the ground below. He pauses all together, embedded deeply inside you as his weight rests atop you enough to press tight against your form but not enough to crush you. The brief cuddle respite is soon ended as the drake starts to move again.";
		say "     Your cum slicked tunnel makes low slurping sounds as you mewl in pleasure and he starts to pull out, only to slam back into your sloppy cunt. You pitch your head back and moan loudly into the open sky, your limbs desperately clawing at iron hard scales. His rhythm is sporadic and lust fueled, his hips slam into yours in the most painfully appealing way, sending jolts up your body with every thrust. And sending spurts of cum splattering over yours and his form. Your sent into a haze of orgasms, one after the other. The exploding bliss has you nearly drooling all over yourself, while droplets of warm saliva drip onto your face from the lust-filled beast.";
		WaitLineBreak;
		say "     And again he's hilting himself inside you. Shooting another potent load of jism into your womb, turning your sex tunnel into a frothy mess of draconic cum. Your vision goes black and blurry as every sense you have at that moment is overtaken by this powerful drake mating your cunt better than he has the right to. Between blacking out from overwhelming sensitivity and moaning like the ready mate you are. Your last thought before the drake starts up again, hammering deeper than most have ever into you. Are of how full you are, how utterly filled and fucked you must look right now.";
		say "     You awaken sometime later, cover in head to toe in cum and sweat. The handsome Frost Drake has fucked you properly like he said. Looking down you see he made good on that word, your tummy is slightly bloated from the sheer amount of cum pumped into your womb. Your thighs are caked in cum and are shaking slightly from your orgasmic high. Your sexy dragon mate it nowhere in sight though, he must have fucked you like the hardy breeder he is then took off. Perhaps you'll see the drake again one day, and perhaps this little union really will bare something, despite the drake's word on his kind's fertility. Regardless you get to shaky feet and clean yourself off as best you can before continuing your journey.";
		CreatureSexAftermath "Player" receives "PussyFuck" from "Frost Drake";
	else:	 [male/neuter]
		say "     Striding up to the large draconic-like creature you run a hand delicately across his scales, they're surprisingly warm for a drake whose natural habitat is cold. And it only get hotter as you run it down his side all the while the drake looks on at you pensively. You suppose now that your on talking terms you can move on to more... pleasant terms. And your eyes locked on his transmit just that. Then they flicker down to his lower belly, searching for his familiar member. Sure enough, it's there, nearly at its full size, clearly excited by your suggestive language and movements.";
		say "     The drake flicks a long draconic tongue out, briefly lapping at your neck before reeling back and licking his lips. 'If we're to do this-' he growls lustfully. 'We'll be making sure it's a proper mating, ass or not.' Again he grins, and this time you're certain its a smile that flashes your way. Your about to ask what he means when suddenly his strength returns to him and then big drake leaps at you. He hits you with his full weight, pushing you down to the ground below yet not landing on you. A long dark tongue rolls out of his maw and licks you efficiently across the face. His sharp claws hold you at your shoulders while the dominant drake's long tongue travels down your neck and across your upper body.";
		WaitLineBreak;
		say "     Your startled, if not further aroused by his sudden sexual aggression. Your hands reach up to grip his brawny, tough scales atop his clawed fore-legs for support while his tongue works its magic on your body, giving the horny beast a proper taste of you. Urging him to continue with little moans of approval when his tongue runs over a sensitive place you strip yourself so your made totally bare to your new found draconic lover. The drake clearly approves, as does his tongue as it once again laps across your face, his lustful growls and hisses clearly euphoric at the taste of you. The dark tongue grazes and flicks across your lips, and in response you open your own saliva glazed lips and lick back, getting quite into the intimate mating and kissing yourself.";
		say "     Your mouth opens wide, accepting the thick, slimy organ with lusty eagerness. The warm length lashes around in your mouth, exploring while your own tongue struggles to keep up. Suddenly it's withdrawn back, leaving behind a trail of saliva as it slurps back into his mouth. The drake growls near your ear, 'I am going to fuck you, place a great egg in your ass if I can.' You pat him on the side of the scaly head, correcting him by stating 'we're going to fuck.' Before wrapping your lower half around his torso, and urging him to continue with a moan.";
		WaitLineBreak;
		say "     That rock hard, burning hot protrusion pokes at your tummy. [if Player is male]It bumps the tip of your own member, sending a spark of pleasure up your own groin. [end if]The eliciting a small giggle from you as you use your lower half to pull the drake closer to you. The drake has a similar idea, he lurches forward until the tip of his reptilian-like member presses into your ass. It penetrates you ever so slightly, just enough to send a shockwave of pleasure up your spine. His growls intensify, just as he thrusts forward fully, embedding his entire nearly foot long, scaly member into your clenching hole.";
		say "     You pull your head back and moan as he slides deep into you, stretching you in a most wonderous way. His scaly penis tickles at your sensitive asshole as you wrap your limbs around your draconic lover. The frost drake humps at your prone form, his growls and hisses fill your ear just like his scale-bumped member sawing in and out of your butt. The heat of his underside washes over you like a blanket of sex, his claws dig into the ground below while he hilts himself inside you, now over eager to screw your willing body into a fucked-happy mess. You tighten your hold on him, gripping onto his warm body as an anchor to ground yourself on as he fucks you into oblivion.";
		WaitLineBreak;
		say "     It doesn't take much longer for you to come to a screaming climax. The drake moves methodically in and out of you until his growls turn into a roar as you clamp down around his hilted member. Keeping it buried inside you as he unloads a torrent of draconic jism inside your hungry gripping colon. [if Player is male]Your own cock throbs and pulses, shooting forth and draining its contents between you and the drake, painting both of you. [end if] White hot cum paints your innards in sticky spunk, sending warm ecstasy through your body as the thrusts slowly calm to a gentle hump. Globs of thick seed oozes from your stretched hole and drips onto the ground below. He pauses all together, embedded deeply inside you as his weight rests atop you enough to press tight against your form but not enough to crush you. The brief cuddle respite is soon ended as the drake starts to move again.";
		say "     Your cum slicked tunnel makes low slurping sounds as you mewl in pleasure and he starts to pull out, only to slam back into your sloppy ass. You pitch your head back and moan loudly into the open sky, your limbs desperately clawing at iron hard scales. His rhythm is sporadic and lust fueled, his hips slam into yours in the most painfully appealing way, sending jolts up your body with every thrust. And sending spurts of cum splattering over yours and his form. Your sent into a haze of orgasms, one after the other. The exploding bliss has you nearly drooling all over yourself, while droplets of warm saliva drip onto your face from the lust-filled beast.";
		WaitLineBreak;
		say "     And again he's hilting himself inside you. Shooting another potent load of jism into your ass, turning your anus into a frothy mess of draconic cum. Your vision goes black and blurry as every sense you have at that moment is overtaken by this powerful drake mating your sensitive ass better than he has the right to. Between blacking out from overwhelming sensitivity and moaning like the ready mate you are. Your last thought before the drake starts up again, hammering deeper than most have ever into you. Are of how full you are, how utterly filled and fucked you must look right now.";
		say "     You awaken sometime later, cover in head to toe in cum and sweat. The handsome Frost Drake has fucked you properly like he said. Looking down you see he made good on that word, your tummy is slightly bloated from the sheer amount of cum pumped into your ass. Your thighs are caked in cum and are shaking slightly from your orgasmic high. Your sexy dragon mate it nowhere in sight though, he must have fucked you like the hardy breeder he is then took off. Perhaps you'll see the drake again one day. Regardless you get to shaky feet and clean yourself off as best you can before continuing your journey.";
		CreatureSexAftermath "Player" receives "AssFuck" from "Frost Drake";

Frost Drake ends here.
