Version 1 of Werewolf by CrimsonAsh begins here.
[ Version 1 - new file              ]

[ WerewolfRelationship                               ]
[   0: not met                                       ]
[   1: submitted                                     ]
[   2: submitted + bred her                          ]
[  50: fought and lost                               ]
[  80: fought off, fucked                            ]
[  81: fought off, fucked + bred                     ]
[  90: fought off, not fucked                        ]

LastWerewolfFuck is a number that varies. LastWerewolfFuck is usually 10000.
WerewolfWatching is a truth state that varies. WerewolfWatching is usually false.
WerewolfRelationship is a number that varies.

Table of GameEventIDs (continued)
Object	Name
Werewolf Surprise	"Werewolf Surprise"

Werewolf Surprise is a situation.
The sarea of Werewolf Surprise is "Nowhere".

when play begins:
	add Werewolf Surprise to BadSpots of FemaleList;
	add Werewolf Surprise to BadSpots of FurryList;

Section 1 - Meeting Event

instead of resting while (player is in Urban Forest and WerewolfWatching is true and WerewolfRelationship is 0 and Werewolf Surprise is not resolved):
	project the Figure of Werewolf_female_icon;
	say "     Finding a comfortable enough spot under a large oak, you lay down to rest and slowly begin to drift off to sleep. All of a sudden, a heavy weight is thrown against you, and your eyes shoot open to the darkness around you. Finding yourself pinned down, you realize that what is on top of you is furry, warm, and... very well muscled as it presses against you. Your face is buried in that fuzzy warmth, and as you pull your head up to identify your assailant, your gaze is met by two yellow, wolf-like eyes, burning brightly with a ferocious need that is obvious even without any words. You can feel two large mounds pressing against your body, also covered in soft fur, as well as the two hard nubs of your assailant's nipples. Further down your body, a warm wetness drips on and soaks your leg.";
	say "     As your eyes adjust to the darkness around you, you can make out more of the creature on top of you than just the glowing eyes and their intense look. You see the canine features of a she-wolf, a snarling muzzle dripping saliva down her furred chin an onto your neck, with two furry wolf ears atop her black-coated head. With her pressed right up against your form, you are enveloped in the strong, musky aroma that emanates from the wolf. The scent of her feral heat almost overwhelms your senses, and you can feel your body start to warm up. Her two muscular arms are at your side, holding you in place with long, sharp claws which prod and poke into your prone form. Having studied you while you did the same, the werewolf decides to make her move in that moment. Her powerful hind legs spread your own while her right claw begins to pull and wrench at your clothes and equipment to strip you naked. If you're going to stop her, now is the time, although she likely won't take it well.";
	say "     [bold type]What do you do?[roman type][line break]";
	LineBreak;
	say "     ([link]Y[as]y[end link]) - Submit to her affections.";
	say "     ([link]N[as]n[end link]) - Fight her off.";
	if Player consents:
		LineBreak;
		say "     You lay your head back, signaling submission to the feral wolf woman. She grins widely at seeing her prey's surrender, baring sharp canines. Still pressing atop your form, in between your legs now, she opens her large maw wide and lets loose her long, flat, lupine-like tongue. She drags it across your face slowly at first, but as she tastes you, she gradually speeds up. Soon you entire face is being licked, smothered with the wet muscle, leaving warm drool all over your face. You notice her starting to pant and breathe heavily, her hips humping the air for a moment before she throws a leg over yours and begins to grind against you. A warm torrent of liquid coats your lower half immediately as the she-wolf in heat whines with need. She continues to lap at your face, licking across your cheeks and lips, then slips into them briefly, giving you a small taste of her before pulls back out and down your head, diving into your neck and biting down.";
		say "     She bites firmly enough to hold you steady but not enough to choke or pierce your skin. You can see her ass bouncing up and down, her furry tail flailing as the bitch humps your leg wildly. Her rough claws grasp possessively at your sides while she presses closer against your willing form. Her impressive double-D mammaries press into your own chest. There's a shlicking, smacking sound that echoes through the dark forest as her breathing speeds up, and she lets go of your neck while her hindquarters hump you like the dog in heat that she is. Letting out a sudden growl against your neck, she shoves her entire lower half down against your leg. You feel a wave of warm climax wash over your whole lower half while the werewolf bites at your neck, nipping and lapping as she rides out her climax.";
		WaitLineBreak;
		if Player is herm: [herm]
			say "     Still unresisting but pinned beneath the massive furry weight that is a horny werewolf, her panting slows as her soaked crotch rests on your leg. She pulls your head up to once again meet her gaze, she doesn't need to say anything, you know she's not done with you. With a big lick across your spit-slicked face she stands up. Now prone beneath her you can now get a measure of her full stature. Nearly eight feet tall of what you rightly assumed to be a very well-muscled werewolf woman. She stands before you in her thick yet surprising soft black fur, her canine muzzle snarling at your prone form before she reaches down toward you, razor sharp claws very apparent.";
			say "     She grabs your shoulders and straddles you, placing her powerful furry legs on either side of you. Feeling the burning heat of her sex warm your groin as she settles on top of you. You see her bare sharp canines and give you a wide feral grin while her claws dig into your shoulders in anticipation. She reaches one claw back to fish out your stiffening manhood. It pulses in her strong grip and you let out a short moan as she squeezes hard. You can hear her panting speed up, it seems like she immensely enjoys goading reactions from you. Still straddled atop you, she lets loose her long dog tongue and licks up from your chest to your neck, trailing warm saliva over your body, making your member jump up from its flaccid position to brush against the wolf's burning sex.";
			WaitLineBreak;
			say "     Her slick juices cover your cock on the first caress, some of it leaking down your member and onto the cold ground below. She soon gets tired of the foreplay and moves her hips up to align her canine cunt with your [cock size desc of Player] length. She plants her claws in the ground on either side of your head, digging into the earth deeply while she presses the crown of your head into her dripping snatch. Suddenly, she drops down, engulfing your entire member in her fiery hot box. The werewoman riding you lets out a loud howl as you penetrate her, it echoes through the quiet woods and you can see some birds fly off from the trees above you. Her claws only inches from your ears dig deeper into the ground while she rotates her hips grinding your cock against her most sensitive spots. She lets out whines of pleasure and pulls her hips back up, leaving just the head inside her before she slams back down.";
			say "     Now foreplay and play done with the powerful werewoman riding you starts to well and truly pound you. Humping down and hilting herself on your manhood before pulling back up and slamming back down. She continues this for what feels like a while, until your groin is sore and soaked with canine pussy and your babbling your pleasure to the werewoman. You barely realize your cumming until you jolt upwards grabbing onto the werewolf's hips and groaning out loud as you start to fill her. The wolf woman lets out another forest shaking howl as she feels your ropes of thick, creamy jism shoot into her. She in turn clamps down around your spasming member, musky juices spray out and around your cock, further soaking you.";
			WaitLineBreak;
			say "     She rides you until both your orgasms settle down. Still bottomed out inside her she laps at your face affectionately, her tail wagging behind her as she once again coats your face in slobber. Once she's done she rests her weight atop yours, her breath next to your ears while her clawed hands grasp possessively at your shoulders. Minutes past and eventually she slowly stands up, letting your softening member slip from her sex with a low whine, her satisfied cunt now dripping with your cum, it slowly drooling down her thighs. She stands above you gazing down at you for another moment before bounding off into the dark forest, leaving you sore and smelling like a dog in heat.";
			now WerewolfRelationship is 2; [submitted + bred her]
		else if Player is male: [male]
			say "     Still unresisting but pinned beneath the massive furry weight that is a horny werewolf, her panting slows as her soaked crotch rests on your leg. She pulls your head up to once again meet her gaze, she doesn't need to say anything, you know she's not done with you. With a big lick across your spit-slicked face she stands up. Now prone beneath her you can now get a measure of her full stature. Nearly eight feet tall of what you rightly assumed to be a very well-muscled werewolf woman. She stands before you in her thick yet surprising soft black fur, her canine muzzle snarling at your prone form before she reaches down toward you, razor sharp claws very apparent.";
			say "     She grabs your shoulders and straddles you, placing her powerful furry legs on either side of you. Feeling the burning heat of her sex warm your groin as she settles on top of you. You see her bare sharp canines and give you a wide feral grin while her claws dig into your shoulders in anticipation. She reaches one claw back to fish out your stiffening manhood. It pulses in her strong grip and you let out a short moan as she squeezes hard. You can hear her panting speed up, it seems like she immensely enjoys goading reactions from you. Still straddled atop you, she lets loose her long dog tongue and licks up from your chest to your neck, trailing warm saliva over your body, making your member jump up from its flaccid position to brush against the wolf's burning sex.";
			WaitLineBreak;
			say "     Her slick juices cover your cock on the first caress, some of it leaking down your member and onto the cold ground below. She soon gets tired of the foreplay and moves her hips up to align her canine cunt with your [cock size desc of Player] length. She plants her claws in the ground on either side of your head, digging into the earth deeply while she presses the crown of your head into her dripping snatch. Suddenly, she drops down, engulfing your entire member in her fiery hot box. The werewoman riding you lets out a loud howl as you penetrate her, it echoes through the quiet woods and you can see some birds fly off from the trees above you. Her claws only inches from your ears dig deeper into the ground while she rotates her hips grinding your cock against her most sensitive spots. She lets out whines of pleasure and pulls her hips back up, leaving just the head inside her before she slams back down.";
			say "     Now foreplay and play done with the powerful werewoman riding you starts to well and truly pound you. Humping down and hilting herself on your manhood before pulling back up and slamming back down. She continues this for what feels like a while, until your groin is sore and soaked with canine pussy and your babbling your pleasure to the werewoman. You barely realize your cumming until you jolt upwards grabbing onto the werewolf's hips and groaning out loud as you start to fill her. The wolf woman lets out another forest shaking howl as she feels your ropes of thick, creamy jism shoot into her. She in turn clamps down around your spasming member, musky juices spray out and around your cock, further soaking you.";
			WaitLineBreak;
			say "     She rides you until both your orgasms settle down. Still bottomed out inside her she laps at your face affectionately, her tail wagging behind her as she once again coats your face in slobber. Once she's done she rests her weight atop yours, her breath next to your ears while her clawed hands grasp possessively at your shoulders. Minutes past and eventually she slowly stands up, letting your softening member slip from her sex with a low whine, her satisfied cunt now dripping with your cum, it slowly drooling down her thighs. She stands above you gazing down at you for another moment before bounding off into the dark forest, leaving you sore and smelling like a dog in heat.";
			now WerewolfRelationship is 2; [submitted + bred her]
		else if Player is female: [female]
			say "     Still unresisting but pinned beneath the massive furry weight that is a horny werewolf, her panting slows as her soaked crotch rests on your leg. She pulls your head up to once again meet her gaze, she doesn't need to say anything, you know she's not done with you. With a big lick across your spit-slicked face she stands up. Now prone beneath her you can now get a measure of her full stature. Nearly eight feet tall of what you rightly assumed to be a very well-muscled werewolf woman. She stands before you in her thick yet surprising soft black fur, her canine muzzle snarling at your prone form before she reaches down toward you, razor sharp claws very apparent.";
			say "     She grips your legs and spreads them wide before yanking you forward and up. You gasp in surprise as you're lifted in the air and held upside down. Your crotch is jammed directly against the were beast's snout. Feeling her sharp canine teeth poke into your sensitive sex, you let out a little yelp. You're sure you can feel a grin form on that muzzle pressing into your slowly dampening lips. The wolf woman opens her maw wide and takes your entire crotch into her jaws, raking her teeth over your sensitive abdomen and ass cheeks. A shiver runs down your spine as your hit with a wave of warm breath and shortly after a rough yet very wet tongue which laps over your cunt. Keeping one claw on your leg the other moves down to grip your side while her tongue works dutifully at your now very wet womanhood.";
			WaitLineBreak;
			say "     Running her tongue up and down your slit she soaks your lips in warm saliva before slipping the tip of her course tongue into your sex. You throw your head back bumping into her back paws as you brush against them. Her tongue works in and out of you, lapping at your quim like a thirsty dog. Her jaw starts moving and at first you snap forward suddenly worried for your health. But she just presses down on your fleshes lightly, nibbling on tender skin as her tongue continues to expertly drink at your cunny. It's only when her teeth scrape against your clit that you buck your hips forward and cum.";
			say "     With the surprising skill of the wolf woman's tongue working on your lips, you climax hard. Your feminine juices squirt out and around the slurping maw of the Werewolf eating you out. You see stars briefly as your hips spasm back and forth uncontrollably with your orgasm. A few parting licks shock through you before you feel it and the warm maw over your crotch release. You can feel yourself gently lowered to the cold forest below as you come down from your intense finish. The wolf woman kneels down and brings her claw forward to stroke your cheek softly, trailing down to brush against your collar and then retracting. The tall wolf woman with the talented tongue looks down at you a moment before bounding off into the dark woods at breakneck speed. You take a moment to stand on shaky feet, a little more aware of where you sleep for now on.";
			now WerewolfRelationship is 1; [submitted]
		else:
			say "     Now that she has taken care of her immediate need, the she-wolf checks out the rest of you, eager to have more fun. Yet as she sees with disappointment that you lack any proper equipment to go further, she simply gets off you and pads away, disappearing behind some brush.";
			now WerewolfRelationship is 1; [submitted]
		now Resolution of Werewolf Surprise is 1; [submitted]
	else:
		LineBreak;
		say "     You attempt to halt the werewolf molesting you and push against her chest to get her off - resulting in the expected violent reaction to your resistance. With a snarl, she slams you down and moves to pin your arms to the ground. You manage to kick the wolf woman off, sending her scrambling to her feet and growling menacingly at you. She circles you for a moment allowing you to get your bearings and stand up, before charging forward with claws extended and teeth bared.";
		challenge "Werewolf";
		now Resolution of Werewolf Surprise is 2; [fought]
	now Werewolf Surprise is resolved;

Section 2 - Scenes

to say BeatWerewolf:
	say "     As you strike a final blow against the werewolf assailing you, she stumbles back and falls on her muscular ass. She lets out a whine of need and tries to get up, but can't seem to find the energy to satiate her heat. The strong predator before you has been reduced to a bitch in desperate heat. You must admit, seeing the feral beauty splayed out before you and the adrenaline of the fight has gotten you more than a little hot and bothered.";
	say "     [bold type]Should you satisfy both your needs?[roman type][line break]";
	LineBreak;
	say "     ([link]Y[as]y[end link]) - Have sex with her.";
	say "     ([link]N[as]n[end link]) - Just leave.";
	if Player consents:
		LineBreak;
		if Player is herm: [herm]
			say "     The feral lycanthrope before you crawls back a few feet before rolling over and spreading her legs wide for you. Her sex glistens with moisture and you can feel her heat from where you're standing. Her folds are black but seem to fade to pink further in. You smile widely at her temptation and decide to take her up on it. You stride up to the werewolf with randy intention, kneeling down you spread her legs wide and begins to pant heavily. Clearly very much looking forward to a hard dicking your more than happy to comply, on your own terms. You take out your stiffening member and rub it against her burning hot lips eliciting a whine of need from the wolf turned bitch before you.";
			say "     Grinning, you give her what she wants, leaning over her and slamming into her body, bottoming out inside her. She lets out a loud growl that echoes through the forest. It's quickly replaced however by more heavy panting and whining as you begin to move in and out of the beastess. You saw into her, your left hugged by two large claws, one pushing into your back, the other pushing into your hip, both poking sharp claws into you but more intent on holding you as an anchor rather than a meal. Your face is brought bare with two large furry breasts, capped with midnight black nipples that poke upwards.";
			WaitLineBreak;
			say "     You dive in between her furry mounds as you hump against her hips. Driving your manhood in and out of her canine cunt juices spray over yours and hers thighs and coat the ground below in musky liquid. Her head lolls back as she surrenders to you, her cunt spasming around your throbbing member. Grabbing you like a vice she climaxes, further soaking your groin with wolf climax. Still pumping in and out of her you feel her clamp down, triggering your own intense orgasm. You fill her, shot after shot of potent white jism shoot forth and into the werewolf's womb filling her cunt up nicely.";
			say "     She twitches under you while you find a nipple to bite down in as you ride the rest of your climax through. Your lips flush with hers she squeezes her every drop of seed you have before she has another small orgasm of her own, the shocks of which knock her out for the count. Finished with you climax you slowly pull back, prompting a moan from the lycanthrope passed out below. You pull out of her well-fucked snatch and stand to admire your trophy splayed out with cum leaking from her wild slit before walking off.";
			now WerewolfRelationship is 81; [fought off, fucked + bred]
		else if Player is male: [male]
			say "     The feral lycanthrope before you crawls back a few feet before rolling over and spreading her legs wide for you. Her sex glistens with moisture and you can feel her heat from where you're standing. Her folds are black but seem to fade to pink further in. You smile widely at her temptation and decide to take her up on it. You stride up to the werewolf with randy intention, kneeling down you spread her legs wide and begins to pant heavily. Clearly very much looking forward to a hard dicking your more than happy to comply, on your own terms. You take out your stiffening member and rub it against her burning hot lips eliciting a whine of need from the wolf turned bitch before you.";
			say "     Grinning, you give her what she wants, leaning over her and slamming into her body, bottoming out inside her. She lets out a loud growl that echoes through the forest. It's quickly replaced however by more heavy panting and whining as you begin to move in and out of the beastess. You saw into her, your left hugged by two large claws, one pushing into your back, the other pushing into your hip, both poking sharp claws into you but more intent on holding you as an anchor rather than a meal. Your face is brought bare with two large furry breasts, capped with midnight black nipples that poke upwards.";
			WaitLineBreak;
			say "     You dive in between her furry mounds as you hump against her hips. Driving your manhood in and out of her canine cunt juices spray over yours and hers thighs and coat the ground below in musky liquid. Her head lolls back as she surrenders to you, her cunt spasming around your throbbing member. Grabbing you like a vice she climaxes, further soaking your groin with wolf climax. Still pumping in and out of her you feel her clamp down, triggering your own intense orgasm. You fill her, shot after shot of potent white jism shoot forth and into the werewolf's womb filling her cunt up nicely.";
			say "     She twitches under you while you find a nipple to bite down in as you ride the rest of your climax through. Your lips flush with hers she squeezes her every drop of seed you have before she has another small orgasm of her own, the shocks of which knock her out for the count. Finished with you climax you slowly pull back, prompting a moan from the lycanthrope passed out below. You pull out of her well-fucked snatch and stand to admire your trophy splayed out with cum leaking from her wild slit before walking off.";
			now WerewolfRelationship is 81; [fought off, fucked + bred]
		else if Player is female: [female]
			say "     The feral lycanthrope flutters her glowing eyes and looks your way, her tongue lolls from her maw and she raises a shaky claw down to her sex and begins fingering herself slowly. You stride up to her and bite your lip feeling awfully randy with anticipation at laying with such a beastess. After disrobing, you stand before the werewoman and part your lips before her. 'Lick,' you say simply. Her tongue rolls back into her mouth and she nods in understanding, intelligence glinting in her eyes. You get on your knees with her head in between your thighs, her large maw and wet nose pressed into your crotch.";
			say "     To your surprise, her two clawed hands come up to grab your legs. At first you think she may be trying to overpower you, but one claw simply strokes your leg while the other squeezes your ass, holding you firm. Her tongue lashes out as her sharp maw envelops your sex. While her teeth brush your folds, her tongue thrusts into your cunt, sliding her long, flat tongue in and out of your sensitive lips. You look down and grab her soft, furry ears and hold her head against your womanhood, throwing your head back and moaning as you do.";
			WaitLineBreak;
			say "     You pull your head back to look down into the golden eyes of the she beast eating your pussy out with expert tongue work. Her maw bites softly at your groin, sending shivers down your spine while her tongue works up and over your crotch, covering most of your lower half in wolf slobber. Suddenly you yelp slightly as a claw pokes at your back door. You glare down at her and you swear she grins at you. But before anything can be done she speeds up her tongue work, the claw grasping your ass gropes and fingers at your sensitive behind and you feel yourself hit with a sudden explosive orgasm brought up by this wolf woman.";
			say "     You squirt your climax in and around her lapping lips while your head lashes back and forth. The wolf girl's hands grope possessively at your ass while your hips buck into her canine muzzle. Coming down from your orgasm with shaky legs the werewolf uses this time to lift you gently off her and stand up. She gazes down at you a moment bringing her muzzle to your lips and giving them a long affectionate lick. She then spins around on all fours and bounds off into the forest leaving you to your aftermath.";
			now WerewolfRelationship is 80; [fought off, fucked]
		else:
			say "     <Neuter Scene WIP>";
			now WerewolfRelationship is 80; [fought off, fucked]
	else:
		LineBreak;
		say "     You decide against trying anything with the wolf woman and decide to just back away and leave once you're a comfortable distance away. Her needy whines are the last thing you hear as you leave.";
		now WerewolfRelationship is 90; [fought off, not fucked]


to say LoseToWerewolf:
	say "     The wolf woman slashes again with her claw, ripping whatever shirt you had and knocking you to the ground. You don't have time to recover this time before she leaps on you and lets out a terrifying dominant roar in your face, spitting and washing warm breath across your cheeks. As her body flushes against yours you notice it's damp and unnaturally warm, the werewolf herself is panting heavily with her tongue out, like a dog on a hot day. Her long claws scrap your shoulders and she tears back before lurching forward and biting into your shoulder. You feel blood stream down your back from the wound and as you begin to fear for your life she pulls back. She licks her blood stained lips and howls to the sky, declaring her victory in the most primal way.";
	say "     Without wasting anymore time, she gets up off you and turns around, showing off her impressively muscular ass and fine, fluffy tail. And then drops it on your face. You feel your head slam into the ground as you're overcome by the wolf woman's musk. She smells feral and of sexual heat that draws out your own lust. She grinds her canine muff into your mouth while her tail hole presses against your nose. Suffocated by her ass and cunt you sigh and submit to your current state. Retracting your tongue you start to lap at her fiery lips while one of your hands strokes her firm ass cheek. She growls, letting out whines of approval as her quivering pussy squirts more juices into your lapping lips.";
	WaitLineBreak;
	if Player is herm: [herm]
		say "     The werewoman starts to hump up and down on your face, undoubtedly bruising your nose while also giving you much needed air to breath. As she pulls downward onto your head she shoves it between her ass cheeks. Forcing you to take in her intoxicating scent that only serves to further your own excitement. Her large claws trace up your thighs to your own member while her other grasps your head and uses it to grind into her soft ass cheeks. She takes ahold of your nearly fully engorged Johnson and strokes up before rubbing back down. Her claw, while sinister and rough looking, can be surprisingly gentle when giving a handjob. You can't help but hump your hips upward into her hand, causing a large, toothy grin to appear across her maw.";
		say "     The wolf woman's tongue hangs from her mouth as she rides your face and jerks you off with increasing speed and enthusiasm. You can see as she pulls up from her constant humping that drool is running down the side of her face and her glowing yellow eyes are wide open. Speeding up with her hand she drops all her weight onto your face and stays there. Leaning forward she licks at the top of your pulsating cock as she jerks it off with impressive speed. Her cunt, now smashed against your lips with you eagerly eating her canine cunt out, drooling fem-cum down your face.";
		say "     While her cunt rest on your mouth your nose is enveloped in her asshole. Forcing you take more of her wild addicting scent while cutting off your breathing. As you run low on oxygen you can feel yourself approaching climax, and if the wolf woman writhing above you is any indication so is she. She squeezes your cock like a vice and your thrown into a sudden orgasm, your seed shooting out and around her jerking paw. Meanwhile her ass cheeks and cunt squeeze your head and tongue just as hard. You see blackness through the fur of the wolf's ass cheeks and that blackness turns to blissful unconsciousness as you pass out from the lack of air.";
		say "     When you awake some time later your alone. Your shoulder and groin aches badly but you notice your wound has been licked over, same as your crotch. It seem she rode your face then licked you and your wound clean before leaving...";
	else if Player is male: [male]
		say "     The werewoman starts to hump up and down on your face, undoubtedly bruising your nose while also giving you much needed air to breath. As she pulls downward onto your head she shoves it between her ass cheeks. Forcing you to take in her intoxicating scent that only serves to further your own excitement. Her large claws trace up your thighs to your own member while her other grasps your head and uses it to grind into her soft ass cheeks. She takes ahold of your nearly fully engorged Johnson and strokes up before rubbing back down. Her claw, while sinister and rough looking, can be surprisingly gentle when giving a handjob. You can't help but hump your hips upward into her hand, causing a large, toothy grin to appear across her maw.";
		say "     The wolf woman's tongue hangs from her mouth as she rides your face and jerks you off with increasing speed and enthusiasm. You can see as she pulls up from her constant humping that drool is running down the side of her face and her glowing yellow eyes are wide open. Speeding up with her hand she drops all her weight onto your face and stays there. Leaning forward she licks at the top of your pulsating cock as she jerks it off with impressive speed. Her cunt, now smashed against your lips with you eagerly eating her canine cunt out, drooling fem-cum down your face.";
		WaitLineBreak;
		say "     While her cunt rest on your mouth your nose is enveloped in her asshole. Forcing you take more of her wild addicting scent while cutting off your breathing. As you run low on oxygen you can feel yourself approaching climax, and if the wolf woman writhing above you is any indication so is she. She squeezes your cock like a vice and your thrown into a sudden orgasm, your seed shooting out and around her jerking paw. Meanwhile her ass cheeks and cunt squeeze your head and tongue just as hard. You see blackness through the fur of the wolf's ass cheeks and that blackness turns to blissful unconsciousness as you pass out from the lack of air.";
		say "     When you awake some time later your alone. Your shoulder and groin aches badly but you notice your wound has been licked over, same as your crotch. It seem she rode your face then licked you and your wound clean before leaving...";
	else if Player is female: [female]
		say "     The werewoman starts to hump up and down on your face, undoubtedly bruising your nose while also giving you much needed air to breath. As she pulls downward onto your head she shoves it between her ass cheeks. Forcing you to take in her intoxicating scent that only serves to further your own excitement. Her large claws trace up your thighs to your own sensitive lips while her other grasps your head and uses it to grind into her soft ass cheeks. She slips a clawed finger into your lips taking care not to wound her fun. Her claw, while sinister and rough looking, can be surprisingly gentle when fingering a girl. You can't help but hump your hips upward into her finger, causing a large, toothy grin to appear across her maw.";
		say "     The wolf woman's tongue hangs from her mouth as she rides your face with increasing speed and enthusiasm. You can see as she pulls up from her constant humping that drool is running down the side of her face and her glowing yellow eyes are wide open. Speeding up with her fingering she twists and curls in your womanhood making you squirm and writhe beneath her. She drops all her weight onto your face and stays there, leaning forward she licks at your engorged clit running a rough tongue up and down it with impressive speed. Her cunt, now smashed against your lips with you eagerly eating her canine cunt out, drooling fem-cum down your face.";
		WaitLineBreak;
		say "     While her cunt rest on your mouth your nose is enveloped in her asshole. Forcing you take more of her wild addicting scent while cutting off your breathing. As you run low on oxygen you can feel yourself approaching climax, and if the wolf woman writhing above you is any indication so is she. She thrusts two more fingers in you and twists them roughly and you can feel your entire body spasm in pleasure and a small bit of pain as you climax. Your hips push into her wet maw leaking saliva down your legs. Meanwhile her ass cheeks and cunt squeeze your head and tongue just as rough. You see blackness through the fur of the wolf's ass cheeks and that blackness turns to blissful unconsciousness as you pass out from the lack of air.";
		say "     When you awake some time later your alone. Your shoulder and groin aches badly but you notice your wound has been licked over, same as your crotch. It seem she rode your face then licked you and your wound clean before leaving...";
	else:
		say "     The werewoman starts to hump up and down on your face, undoubtedly bruising your nose while also giving you much needed air to breath. As she pulls downward onto your head she shoves it between her ass cheeks. Forcing you to take in her intoxicating scent that only serves to further your own excitement. Her large claws trace up your thighs but she growls in frustration when she finds nothing, her other grasps your head and uses it to grind into her soft ass cheeks. As the werewoman rides your face her tongue hangs from her maw. You can see as she pulls up from her constant humping that drool is running down the side of her face and her glowing yellow eyes are wide open. Speeding up with her hand she drops all her weight onto your face and stays there. Her cunt, now smashed against your lips with you eagerly eating her canine cunt out, drooling fem-cum down your face.";
		say "     While her cunt rest on your mouth your nose is enveloped in her asshole. Forcing you take more of her wild addicting scent while cutting off your breathing. As you run low on oxygen you can feel the wolf woman writhing above you seemingly on the verge of climax. Meanwhile her ass cheeks and cunt squeeze your head and tongue hard. You see blackness through the fur of the wolf's ass cheeks and that blackness turns to blissful unconsciousness as you pass out from the lack of air.";
		WaitLineBreak;
		say "     When you awake some time later your alone. Your shoulder and face aches pretty badly but otherwise your unharmed. It seemed she licked your face clean before leaving you there...";
	now WerewolfRelationship is 90; [fought & lost]

to say WerewolfDesc:
	setmongender 4;
	if inasituation is true:
		say ""; [dealt with elsewhere]
	else:
		say ""; [currently unused, only event encounters with her]

Section 3 - Creature Insertion

Table of Random Critters (continued)
NewTypeInfection (truth state)	Species Name	Name	Enemy Title	Enemy Name	Enemy Type	Attack	Defeated	Victory	Desc	Face	Body	Skin	Tail	Cock	Face Change	Body Change	Skin Change	Ass Change	Cock Change	str	dex	sta	per	int	cha	sex	HP	lev	wdam	area	Cock Count	Cock Length	Ball Size	Nipple Count	Breast Size	Male Breast Size	Cunt Count	Cunt Depth	Cunt Tightness	Libido	Loot	Lootchance	Scale (number)	Body Descriptor (text)	Type (text)	Magic (truth state)	Resbypass (truth state)	non-infectious (truth state)	Cross-Infection (text)	DayCycle	Altcombat (text)	BannedStatus (truth state)
--	--	--	--	--	--	--	--	--	--	--	--	--	--	--	--	--	--	--	--	--	--	--	--	--	--	--	--	--	--	--	--	--	--	--	--	--	--	--	--	--	--	--	--	--	--	--	--	--	--	--;

When Play begins:
	Choose a blank row from Table of Random Critters;
	now NewTypeInfection entry is false;
	now Species Name entry is "Werewolf"; [name of the overall species of the infection, used for children, ...]
	add "Werewolf" to infections of CanineList;
	add "Werewolf" to infections of FurryList;
	add "Werewolf" to infections of NatureList;
	add "Werewolf" to infections of MaleList;
	add "Werewolf" to infections of TaperedCockList;
	add "Werewolf" to infections of KnottedCockList;
	add "Werewolf" to infections of SheathedCockList;
	add "Werewolf" to infections of BipedalList;
	add "Werewolf" to infections of TailList;
	now Name entry is "Werewolf";
	now enemy title entry is ""; [name of the encountered creature at combat start - Example: "You run into a giant collie." instead of using "Smooth Collie Shemale" infection name]
	now enemy Name entry is ""; [specific name of unique enemy]
	now enemy type entry is 0; [0 = non unique enemy; 1 = unique (unknown name); 2 = unique (known name) | Used to disqualify unique enemies from Vore/UB and showing the enemy name in encounters]
	now attack entry is "[one of]The werewolf bites at you, wounding you with razor sharp teeth![or]Leaping at you the werewoman slices her claws into you.[or]The wolf woman batters you with her claws.[at random]";
	now defeated entry is "[BeatWerewolf]";
	now victory entry is "[LoseToWerewolf]";
	now desc entry is "[WerewolfDesc]";
	now face entry is "";
	now body entry is "";
	now skin entry is "";
	now tail entry is "";
	now cock entry is "";
	now face change entry is "";
	now body change entry is "";
	now skin change entry is "";
	now ass change entry is "";
	now cock change entry is "";
	now str entry is 18;
	now dex entry is 14;
	now sta entry is 18;
	now per entry is 14;
	now int entry is 6;
	now cha entry is 8;
	now sex entry is "Female"; [ Infection will move the player towards this gender. Current: 'Male' 'Female' 'Both' ]
	now HP entry is 80; [ The monster's starting HP. ]
	now lev entry is 8; [ Monster level. (Level x 2) XP for victory. (Level / 2) XP for losing. ]
	now wdam entry is 10; [ Monster's average damage when attacking. ]
	now area entry is "Nowhere"; [ Case sensitive]
	now Cock Count entry is 0; [ number of cocks if sex is 'Male' or 'Both' ]
	now Cock Length entry is 0;
	now Ball Size entry is 0; [ Size of balls ]
	now Nipple Count entry is 2; [ Number of nipples. ]
	now Breast Size entry is 0; [cup size as number, counting Flat Pecs = 0, A = 1, B = 2, ...]
	now Male Breast Size entry is 0;   [ Breast size for if Sex="Male", usually zero. ]
	now Cunt Count entry is 1; [ number of pussies if sex is 'Female' or 'Both' ]
	now Cunt Depth entry is 0; [penetratable length in inches; some minor stretching allowed, or more with Twisted Capacity]
	now Cunt Tightness entry is 4;
	now libido entry is 80; [ Amount player Libido will go up if defeated ]
	now loot entry is ""; [ Loot monster drops, usually infective with the monster's _own_ strain (for example if there is a Cross-Infection from sex)]
	now lootchance entry is 0; [ Chance of loot dropping 0-100 ]
	now scale entry is 3; [ Number 1-5, approx size/height of infected PC body: 1=tiny, 3=avg, 5=huge ]
	now body descriptor entry is "werewolf";
	now type entry is "werewolf";
	now magic entry is false;
	now resbypass entry is false;
	now non-infectious entry is true;
	now Cross-Infection entry is ""; [infection that this infection will give the player when they lose; can be left empty if they infect with the monster's own]
	now DayCycle entry is 0; [ True=Nocturnal (night encounters only) ]
	now altcombat entry is "default";
	now BannedStatus entry is false;

[
Table of New Infection Parts (continued)
Species Name	Name	Body Weight	Body Definition	Androginity	Head Change	Head Description	Head Adjective	Head Skin Adjective	Head Color	Head Adornments	Hair Length	Hair Shape	Hair Color	Hair Style	Beard Style	Body Hair Length	Eye Color	Eye Adjective	Mouth Length	Mouth Circumference	Tongue Adjective	Tongue Color	Tongue Length	Torso Change	Torso Description	Torso Adjective	Torso Skin Adjective	Torso Adornments	Torso Color	Torso Pattern	Breast Adjective	Breast Size	Male Breast Size	Nipple Count	Nipple Color	Nipple Shape	Back Change	Back Adornments	Back Skin Adjective	Back Color	Arms Change	Arms Description	Arms Skin Adjective	Arms Color	Locomotion	Legs Change	Legs Description	Legs Skin Adjective	Legs Color	Ass Change	Ass Description	Ass Skin Adjective	Ass Color	Ass Width	Tail Change	Tail Description	tail skin adjective	Tail Color	Asshole Depth	Asshole Tightness	Asshole Color	Cock Change	Cock Description	Cock Adjective	Cock Color	Cock Count	Cock Girth	Cock Length	Ball Description	Ball Count	Ball Size	Cunt Change	Cunt Description	Cunt Adjective	Cunt Color	Cunt Count	Cunt Depth	Cunt Tightness	Clit Size
--	--	--	--	--	--	--	--	--	--	--	--	--	--	--	--	--	--	--	--	--	--	--	--	--	--	--	--	--	--	--	--	--	--	--	--	--	--	--	--	--	--	--	--	--	--	--	--	--	--	--	--	--	--	--	--	--	--	--	--	--	--	--	--	--	--	--	--	--	--	--	--	--	--	--	--	--	--	--;

When Play begins:
	Choose a blank row from Table of New Infection Parts;
	now Species Name entry is ""; [name of the overall species of the infection, used for children, ...]
	now Name entry is ""; [matching infection name to Table of Random Critters]
	now Body Weight entry is 5; [scale of 1-9 for body weight, grouped into low weight (1-3), mid weight (4-6) and high weight (7-9)]
	now Body Definition entry is 5; [scale of 1-9 for body definition, grouped into low muscle (1-3), mid muscle (4-6), high muscle (7-9)]
	[Body Adjective is generated out of the body weight and body definition and can be used in scenes - one word descriptive adjective depending on weight and definition groups: low weight group: skinny/slender/lithe; mid weight group: average/fit/muscled; high weight group: pudgy/husky/jacked]
	now Androginity entry is 5; [1-9 scale of hypermasculine to hyperfeminine]
	[Gender Adjective is generated out of androginity 1-9: hypermasculine/masculine/effeminate/somewhat effeminate/androgynous/feminine butch/tomboyish/feminine/hyperfeminine]
	now Head Change entry is ""; [partial sentence that fits in: "Your head and face [one of]tingle[or]go flush[or]vibrate with odd pleasure[or]go cold[or]feel oily[at random] as [head change entry]."]
	now Head Description entry is ""; [partial sentence that fits in "Your face and head resemble that of [Head Description of Player]. You have [Eye Adjective of Player], [Eye Color of Player] eyes and an overall [Gender Adjective of Player] appearance."]
	now Head Adjective entry is ""; [one word descriptive adjective (avian/canine/...)]
	now Head Skin Adjective entry is ""; [one word descriptive adjective]
	now Head Color entry is ""; [single word color adjective for the dominant color of the skin/fur/feathers/scales]
	now Head Adornments entry is "";[partial sentence that fits in "Before moving on from your head, you give your [head adornments of Player] a proud glance followed by a light caress."]
	now Hair Length entry is 2; [hair length in inches]
	now Hair Shape entry is ""; [one word shape descriptor (curly/straight/...)]
	now Hair Color entry is ""; [one word color descriptor]
	now Hair Style entry is ""; [one word style descriptor (ponytail/mohawk/buzzcut/...) to fit "On top of your head you have [Hair Length of Player] inch long, [Hair Shape of Player] [Hair Color of Player] hair in the [Hair Style of Player] style."]
	now Beard Style entry is ""; [short beard style (goatee/3-day stubble beard/porn stache/mutton chops beard/...) to go into "You have a [Hair Color of Player] [Beard Style of Player]."]
	now Body Hair Length entry is 0; [numerical value, 0-4 (no body hair/light/moderate/heavy/furry) - only set to > 0 if the infection does not have fur/scales/etc. !]
	now Eye Color entry is ""; [one word color descriptor]
	now Eye Adjective entry is ""; [one word descriptive adjective (slitted/round/...)]
	now Mouth Length entry is 3; [inches deep for face fucking; maximum possible will be double this number (when deep throating)]
	[Mouth Length Adjective  is generated by a function and can be used in scenes too - "petite, shallow, average, deep, bottomless"]
	now Mouth Circumference entry is 3; [mouth circumference 1-5, see Mouth Circumference Adjective]
	[Mouth Circumference Adjective is generated by a function and can be used in scenes too - "tiny, small, normal, wide, gaping"]
	now Tongue Adjective entry is ""; [one word descriptive adjective (wide/slobbery/...)]
	now Tongue Color entry is ""; [one word color descriptor]
	now Tongue Length entry is 3; [length in inches]
	now Torso Change entry is ""; [partial sentence that fits in: "Your torso [one of]tingles[or]goes flush[or]vibrates with odd pleasure[or]goes cold[or]feels oily[at random] as [Torso Change entry]."]
	now Torso Description entry is ""; [partial sentence, fitting in "Looking down at yourself, you appear [Gender Adjective of Player] with a [Body Adjective of Player] build. Your torso is [Torso Description of Player][if Body Hair Length of Player > 1], covered in [Torso Color of Player] skin and [Body Hair Description of Player][else if Body Hair Length of Player is 1], covered in smooth, [Torso Color of Player] skin[end if]."]
	now Torso Adjective entry is ""; [one word descriptive adjective (avian/canine/...)]
	now Torso Adornments entry is ""; [(pouch/udders/...); partial sentence to fit: "You take a moment to feel your [torso adornments of Player]."]
	now Torso Skin Adjective entry is ""; [one word adjective (feathered/furred/scaly/...); EMPTY "" for creatures with just skin]
	now Torso Color entry is ""; [single word color adjective for the dominant color of the skin/fur/feathers/scales]
	now Torso Pattern entry is ""; [single word color adjective for the dominant pattern of the skin/fur/feathers/scales]
	now Breast Adjective entry is ""; [adjective(s) example: round, pointy, perky, saggy, bouncy. This would serve as either a general appearance of a infections breasts or possibly something that may be effected by a item or NPC.]
	now Breast Size entry is 0; [cup size as number, counting Flat Pecs = 0, A = 1, B = 2, ...]
	now Male Breast Size entry is 0; [cup size as number, counting Flat Pecs = 0, A = 1, B = 2, ...]
	now Nipple Count entry is 2; [count of nipples]
	now Nipple Color entry is ""; [one word color descriptor]
	now Nipple Shape entry is ""; [shape example: any shape will do as long as it has a baseline with a current infection or item]
	now Back Change entry is ""; [partial sentence that fits in: "Your back [one of]tingles[or]goes flush[or]vibrates with odd pleasure[or]goes cold[or]feels oily[at random] as [Back Change entry]."]
	now Back Adornments entry is ""; [partial sentence to fit: "Your back tickles with the feeling of movement caused by [back adornments of Player]."]
	now Back Skin Adjective entry is ""; [one word adjective (feathered/furred/scaly/...); EMPTY "" for creatures with just skin]
	now Back Color entry is ""; [single word color adjective for the dominant color of the skin/fur/feathers/scales]
	[Limbs Adjective is generated by a function and can be used in scenes too - "rail-thin, slender, sinewy, average, firm, muscular, flabby, meaty, rippling"]
	now Arms Change entry is ""; [partial sentence that fits in: "Your arms [one of]tingle[or]go flush[or]vibrate with odd pleasure[or]go cold[or]feel oily[at random] as [Arms Change entry]."]
	now Arms Description entry is ""; [partial sentence to fit: "Your [Limbs Adjective of Player] arms are [Arms Description of Player]."]
	now Arms Skin Adjective entry is ""; [one word adjective (feathered/furred/scaly/...); EMPTY "" for creatures with just skin]
	now Arms Color entry is ""; [single word color adjective for the dominant color of the skin/fur/feathers/scales]
	now Locomotion entry is ""; [one word adjective: (bipedal/quadrupedal/octapedal/serpentine/sliding)]
	now Legs Change entry is ""; [partial sentence that fits in: "Your legs [one of]tingle[or]go flush[or]vibrate with odd pleasure[or]go cold[or]feel oily[at random] as [Legs Change entry]."]
	now Legs Description entry is ""; [partial sentence to fit: "As your inspection goes even lower, you come to the two [Body Adjective of Player] legs supporting you. They are [legs description of Player]."]
	now Legs Skin Adjective entry is ""; [one word adjective (feathered/furred/scaly/...); EMPTY "" for creatures with just skin]
	now Legs Color entry is ""; [single word color adjective for the dominant color of the skin/fur/feathers/scales]
	now Ass Change entry is ""; [partial sentence that fits in: "Your ass [one of]tingles[or]goes flush[or]vibrates with odd pleasure[or]goes cold[or]feels oily[at random] as [Ass Change entry]."]
	now Ass Description entry is ""; [partial sentence to fit: "Using your hands you feel your behind enjoying the sensation of your [Ass Width Adjective of Player], [Ass Shape Adjective of Player] [Ass Description of Player]." (For players with skin, instead of the period: ", covered in [Ass Color of Player] skin and [Body Hair Description of Player]"]
	now Ass Skin Adjective entry is "";  [one word adjective (feathered/furred/scaly/...); EMPTY "" for creatures with just skin]
	now Ass Color entry is ""; [single word color adjective for the dominant color of the skin/fur/feathers/scales]
	now Ass Width entry is 3; [ass width from 1-5]
	[Ass Width Adjective generated by function out of ass width: dainty/small/round/huge/enormous]
	[Ass Adjective generated by function out of body definition and ass width]
	now Tail Change entry is ""; [partial sentence that fits in: "Your rear [one of]tingles[or]goes flush[or]vibrates with odd pleasure[or]goes cold[or]feels oily[at random] as [if HasTail of Player is true]your existing tail is changed into a [Tail Description entry][else][Tail Change entry][end if]."]
	now Tail Description entry is ""; [partial sentence to fit: "Just below your lower back sprouts a [tail description of Player], which you move back and forth with glee."]
	now Tail Skin Adjective entry is ""; [one word adjective (feathered/furred/scaly/...); EMPTY "" for creatures with just skin]
	now Tail Color entry is ""; [single word color adjective for the dominant color of the skin/fur/feathers/scales]
	now Asshole Depth entry is 7; [inches deep for anal fucking]
	[Asshole Depth Adjective is generated by a function and can be used in scenes too - "petite (< 3), shallow (< 5), average (< 9), deep (< 15), bottomless (15+)"]
	now Asshole Tightness entry is 3; [asshole tightness 1-5, "extremely tight, tight, receptive, open, gaping"]
	[Asshole Tightness Adjective is generated by a function and can be used in scenes too - "extremely tight, tight, receptive, open, gaping"]
	now Asshole Color entry is ""; [one word color descriptor]
	now Cock Count entry is 0;
	now Cock Girth entry is 0; [thickness 1-5, generates the Cock Girth Adjective]
	[Cock Girth Adjective is generated by a function and can be used in scenes too: thin/slender/average/thick/monstrous]
	now Cock Length entry is 0; [length in inches]
	now Cock Adjective entry is ""; [one word adjective: avian/canine/...]
	now Cock Change entry is ""; [partial sentence that fits in: "Your cock [one of]tingles[or]goes flush[or]vibrates with odd pleasure[or]goes cold[or]feels oily[at random] as [Cock Change entry]."]
	now Cock Description entry is ""; [partial sentence to fit: "You have a [Cock Girth Adjective of Player], [Cock Length of Player]-inch-long [cock adjective of Player] [one of]cock[or]penis[or]shaft[or]maleness[at random] that [cock description of Player]."]
	now Cock Color entry is ""; [one word color descriptor]
	now Ball Count entry is 0; [allowed numbers: 1 (uniball), 2 or 4]
	now Ball Size entry is 0; [size of balls 1-7: "acorn-sized", "dove egg-sized", "chicken egg-sized" "goose-egg sized", "ostrich-egg sized", "basketball-sized", "beachball-sized"]
	[Ball Size Adjective is generated by a function and can be used in scenes too]
	now Ball Description entry is ""; [partial sentence to fit: "Underneath it hangs a pair of [Ball Size Adjective of Player] [ball description of Player]."]
	now Cunt Count entry is 0;
	now Cunt Depth entry is 0; [penetratable length in inches; some minor stretching allowed, or more with Twisted Capacity]
	now Cunt Tightness entry is 0; [size 1-5, generates adjectives of extremely tight/tight/receptive/open/gaping]
	[Cunt Tightness Adjective is generated by a function and can be used in scenes too: extremely tight/tight/well-used/open/gaping]
	now Cunt Adjective entry is ""; [one word adjective: avian/canine/...]
	now Cunt Change entry is ""; [partial sentence that fits in: "Your pussy [one of]tingles[or]goes flush[or]vibrates with odd pleasure[or]goes cold[or]feels oily[at random] as [Cunt change entry]."]
	now Cunt Description entry is ""; [partial sentence to fit: "You have a [Cunt Tightness Adjective of Player] [one of]cunt[or]pussy[or]vagina[or]cleft[at random] that [cunt description of Player]."]
	now Cunt Color entry is ""; [one word color descriptor]
	now Clit Size entry is 0; [size 1-5, see Clit Size Adjective]
	[Clit Size Adjective is generated by a function and can be used in scenes: very small/small/average/large/very large]
]


Werewolf ends here.
